abandon: abandoned,abandons
abbots: abbots
aberdeen: aberdeen
abhorrent: abhorrent
abide: abide,abiding
abjure: abjure
abnormal: abnormal
abnormally: abnormally
abode: abode
abominable: abominable
abomination: abomination
abound: abound
abrupt: abrupt
abruptly: abruptly
absence: absence
absent: absent
absolute: absolute
absolutely: absolutely
absolve: absolved
absorb: absorb,absorbed
absorbing: absorbing
abstract: abstracted
abstracted: abstracted
absurd: absurd
absurdly: absurdly
abuse: abuse
abusive: abusive
abut: abutted
accent: accent
accept: accept,accepted,accepting
acceptance: acceptance
access: access,accessed
accessible: accessible
accessory: accessory
accident: accident,accidents
accidental: accidental
accommodate: accommodate
accompany: accompanied,accompany,accompanying
accompli: accompli
accomplice: accomplice
accomplish: accomplish,accomplished
accomplishment: accomplishment,accomplishments
account: account,accounts
accountant: accountant
accumulate: accumulated
accumulation: accumulation
accurate: accurate
accurately: accurately
accuse: accused
accuser: accuser
accustom: accustomed
accustomed: accustomed
acetone: acetones
achieve: achieved
acid: acid
acknowledge: acknowledge,acknowledges
acquaintance: acquaintance
acquiesce: acquiesce
acquire: acquire,acquired
acquirement: acquirement
acquit: acquitted
acre: acres
acting: acting
action: action,actions
actionable: actionable
active: active
activity: activity
actor: actor
actress: actress
actual: actual
acute: acute
adapt: adapt,adapted
add: add,adding,adds
adder: adder
addict: addicted
addition: addition,additions
additional: additional
address: address,addressed,addresses,addressing
adhesive: adhesive
adjective: adjective
adjust: adjusted
administration: administration
admirable: admirable
admirably: admirably
admiration: admiration
admire: admire,admiring
admirer: admirers
admit: admit,admitted
ado: ado
advance: advance,advanced,advancing
advantage: advantage,advantages
adventure: adventure,adventures
adventures: adventures
adventuress: adventuress
advertise: advertise,advertised,advertising
advertisement: advertisement,advertisements
advertising: advertising
advice: advice
advise: advise,advised
adviser: adviser
advocate: advocate
affair: affair,affairs
affaire: affaire
affairs: affairs
affect: affect
affectation: affectation
affection: affection,affections
affectionate: affectionate
affliction: affliction
afford: afford,afforded
afghan: afghan
afghanistan: afghanistan
afraid: afraid
afternoon: afternoon
age: age
aged: aged
agency: agency
agent: agent
agitate: agitated
agitated: agitated
agitation: agitation
agony: agonies,agony
agra: agra
agree: agree,agreed,agrees
agreement: agreement
agricultural: agricultural
aid: aid,aided
air: air
aisle: aisle
ajar: ajar
akimbo: akimbo
akin: akin
alarm: alarm
alas: alas
albert: albert
alert: alert
alexander: alexander
alias: alias
alice: alice
alicia: alicia
alike: alike
alive: alive
allege: alleging
allegro: allegro
alley: alley,alleys
alliance: alliance
allowance: allowance
allude: allude,alluded
allusion: allusion,allusions
ally: allied,ally
aloud: aloud
aloysius: aloysius
alpha: alpha
altar: altar
alter: alter,altered
alteration: alteration,alterations
alternate: alternate,alternating
alternately: alternately
alternation: alternation
altogether: altogether
amalgam: amalgam
amateur: amateur
amazement: amazement
amazing: amazing
ambition: ambition
ambitious: ambitious
america: america
american: american,americans
amethyst: amethyst
amiable: amiable
amiss: amiss
amoy: amoy
ample: ample
amplify: amplifying
amply: amply
amuse: amuse,amused
amused: amused
amusement: amusement
amusing: amusing
analysis: analysis
analytical: analytical
anatomy: anatomy
ancestral: ancestral
ancient: ancient
anderson: anderson
angel: angel
anger: anger
angle: angle
angry: angry
animal: animal,animals
animate: animated
animated: animated
ankle: ankles
announcement: announcement
annoyance: annoyance
annoyed: annoyed
annual: annual
anoint: anoints
anonymous: anonymous
answer: answer,answered,answering,answers
antagonist: antagonist
antecedent: antecedents
anteroom: anteroom
antic: antics
anxiety: anxiety
anxious: anxious
anxiously: anxiously
apache: apache
apaches: apaches
apartment: apartment
aperture: aperture
apiece: apiece
apologise: apologise
apology: apology
apparel: apparelled
apparent: apparent
apparition: apparition
appeal: appeal,appeals
appearance: appearance
applicable: applicable
applicant: applicant
apply: apply,applying
appointment: appointment
apprentice: apprenticed
approach: approach,approached,approaching
approvingly: approvingly
april: april
aproned: aproned
apt: apt
aquiline: aquiline
arabian: arabian
arc: arc
archery: archery
archie: archie
architect: architects
architecture: architecture
archive: archive
arduous: arduous
argue: argue
argument: argument,arguments
aright: aright
aristocratic: aristocratic
arizona: arizona
arm: arm,arms
armchair: armchair,armchairs
armed: armed
armour: armour
army: army
arouse: aroused
arrange: arrange,arranged
arrangement: arrangements
array: array
arrest: arrest,arrested,arresting
arrival: arrival
arrive: arrive,arrived
arrow: arrows
art: art
artery: arteries
arthur: arthur
article: article,articles
artificial: artificial
artillery: artillery
artist: artist
artistic: artistic
ascend: ascend,ascended
ascertain: ascertain,ascertained,ascertaining
ascii: ascii
ash: ash,ashes
ashamed: ashamed
ashen: ashen
askance: askance
asleep: asleep
aspect: aspect
aspire: aspired
assailant: assailants
assault: assault,assaulted
assemble: assembled
assert: assert,asserted
assertion: assertion
assist: assist,assisted,assisting
assistance: assistance
assistant: assistant,assistants
assizes: assizes
associate: associate
association: association
assume: assume,assumed
assurance: assurance
assure: assure,assured,assures,assuring
assuredly: assuredly
astir: astir
astonished: astonished
astonishment: astonishment
astrakhan: astrakhan
astronomy: astronomy
astute: astute
astuteness: astuteness
asylum: asylum
atlantic: atlantic
atmosphere: atmosphere
atone: atone
attach: attached
attack: attack,attacked
attain: attain,attained
attainment: attainments
attempt: attempt,attempted,attempting,attempts
attend: attend,attended
attendant: attendant
attention: attention,attentions
attic: attic,attics
attire: attired
attitude: attitude
attract: attract,attracted
attraction: attractions
auckland: auckland
audible: audible
august: august
augustine: augustine
aunt: aunt
australia: australia
australian: australian,australians
authenticity: authenticity
author: author
authoritative: authoritative
authority: authorities,authority
autumn: autumn
autumnal: autumnal
avail: avail
avenue: avenue
average: average
averse: averse
aversion: aversion
avert: avert,averted
avoid: avoid,avoided,avoiding
await: await,awaited,awaiting
awake: awake,awoke
awaken: awakened
aware: aware
awful: awful
awkward: awkward
axiom: axiom
ay: ay
azure: azure
baboon: baboon
baby: baby
bachelor: bachelor,bachelors
backgammon: backgammon
background: background
backwater: backwater
bad: bad,worse,worst
badge: badge
badly: badly
baffle: baffled
bag: bag,bags
baggy: baggy
bait: baits
baker: baker,bakers
balance: balance,balancing
balanced: balanced
bald: bald
baleful: baleful
ball: ball,balls
balmoral: balmoral
balustraded: balustraded
band: band,bands
bandage: bandage,bandaged,bandages
bandy: bandy
bang: bang,banged
bank: bank,banks
banker: banker,bankers
banking: banking
bar: bar,barred,bars
barbaric: barbaric
barber: barber
bare: bare
bargain: bargain
bark: bark
barmaid: barmaid
barometric: barometric
barque: barque
barrel: barrel
barricade: barricade,barricaded
barrow: barrow
barton: barton
baryta: baryta
base: base,based
bashful: bashful
basin: basin
basis: basis
basket: basket
basketful: basketful
bath: bath
bathroom: bathroom
battered: battered
battle: battle
baxter: baxter
baying: baying
bead: beads
beam: beam,beamed
bean: bean
bear: bear,bearing,bears,bore,born,borne
beard: beard
bearded: bearded
bearing: bearing,bearings
beast: beast,beasts
beat: beat,beaten,beating
beautiful: beautiful
beautifully: beautifully
beauty: beauties,beauty
becher: becher
beckon: beckoned,beckoning
bed: bed,beds
bedded: bedded
bedroom: bedroom,bedrooms
bedside: bedside
bedtime: bedtime
bee: bee
beech: beech,beeches
beef: beef
beer: beer
befall: befall,befallen
beg: beg,begged,begging
beget: beget
beggar: beggar
beggarman: beggarman
beggary: beggary
beige: beige
belated: belated
belief: belief
bell: bell
belong: belonged,belonging,belongs
beloved: beloved
belt: belt
bend: bend,bending,bent
beneath: beneath
benefactor: benefactor
benevolent: benevolent
bengal: bengal
bent: bent
bequeath: bequeathed
bequest: bequest
berkshire: berkshire
bermuda: bermuda
berth: berth,berths
beryl: beryl,beryls
bet: bet
betray: betray,betrayed,betraying
betrothal: betrothal
bewilderment: bewilderment
bible: bible
bicycling: bicycling
bid: bade
bijou: bijou
bile: bile
billet: billet
billycock: billycock
binary: binary
bind: bind,binding,bound
biography: biographies,biography
bird: bird,birds
bisulphate: bisulphate
bit: bit
bite: bit,bite,bitten
bitter: bitter
bitterly: bitterly
bitterness: bitterness
bizarre: bizarre
black: black,blackest
blackguard: blackguard
blackmail: blackmailing
blacksmith: blacksmith
blame: blame
blanch: blanched
blanche: blanche
bland: bland
blandly: blandly
blast: blasted
blaze: blaze,blazing
bleak: bleak
bleed: bled,bleeding
bleeding: bleeding
blend: blend
bless: bless
blind: blind,blinds
blink: blinked
bloc: bloc
block: block,blocked
blockade: blockaded
blonde: blonde
blood: blood
blooded: blooded
bloodless: bloodless
bloodstain: bloodstains
bloody: bloody
bloomsbury: bloomsbury
blot: blot,blotted
blotch: blotched,blotches
blotting: blotting
blow: blew,blow,blowing,blown,blows
blowing: blowing
blue: blue
bluff: bluff
blunder: blundering,blunders
blunt: blunt
blur: blur,blurs
blush: blush
bluster: bluster
boa: boa
board: board,boards
boarding: boarding
boast: boasting
boat: boat
bob: bob
bode: bodes
body: bodies,body
bohemia: bohemia
bohemian: bohemian
boil: boiling
boisterous: boisterous
bold: bold
bolt: bolted
bond: bond
bone: bone,bones
bonnet: bonnet
bonny: bonniest,bonny
book: book,books
boom: boomed
boone: boone
boot: boot,booted,boots
bordeaux: bordeaux
border: border,bordered,borders
bore: bored
bored: bored
borrow: borrow,borrowed
bosom: bosom
boswell: boswell
botany: botany
bottle: bottle,bottles
bound: bound,bounded,bounds
boundary: boundary
bouquet: bouquet
bow: bow,bowed,bowing
bowl: bowls
box: box,boxed,boxes
boxer: boxer
boy: boy,boys
boyish: boyish
brace: brace,braced
bracelet: bracelets
bradshaw: bradshaw
brain: brain,brains
bramble: bramble
branch: branch,branches
brand: branded
brandy: brandy
brass: brass
brassy: brassy
brave: brave,braved,braving
brawl: brawls
brazen: brazen
brazier: brazier
breach: breach,breaches
bread: bread
breadth: breadth
break: break,breaking,breaks,broke,broken
breakfast: breakfast,breakfasts
breaking: breaking
breast: breast
breasted: breasted
breastpin: breastpin
breath: breath
breathe: breathe,breathed,breathing
breathing: breathing
breathlessly: breathlessly
breed: bred
brewer: brewer
briar: briar
brick: brick,bricks
brickish: brickish
bridal: bridal
bride: bride
bridegroom: bridegroom
bridge: bridge
bright: bright,brighter,brightest
brightly: brightly
brightness: brightness
brilliant: brilliant
brilliantly: brilliantly
brim: brim,brimmed,brims
bring: bring,bringing,brings,brought
briony: briony
brisk: brisk
briskly: briskly
bristol: bristol
britain: britain
britannica: britannica
british: british
broad: broad,broader,broadest
broaden: broadened
broke: broke
broken: broken
brooch: brooch
brother: brother,brothers
brougham: brougham
brow: brow,brows
brown: brown
brownish: brownish
bruise: bruise
brush: brush,brushed
brute: brute
buckle: buckles
budge: budge
buffalo: buffalo
build: build,built
builder: builder
building: building,buildings
bulge: bulge
bulky: bulky
bull: bull
bulldog: bulldog
bullet: bullet
bullion: bullion
bump: bumping
bunch: bunch
bundle: bundle,bundles
burden: burden
bureau: bureau
burglar: burglar,burglars
burgle: burgled
burly: burly
burn: burned,burning
burnish: burnished
burrow: burrowing
burst: burst
bury: buried
bush: bush,bushes
bushy: bushy
business: business
businesslike: businesslike
bustle: bustled,bustling
busy: busier,busy
busybody: busybody
butcher: butcher
butler: butler
butt: butt
button: buttoned,buttoning,buttons
buzz: buzz
buzzing: buzzing
bye: bye
cab: cab,cabs
cabby: cabby
cabinet: cabinet
cable: cable
cabman: cabman
cadaverous: cadaverous
cage: cage,caged
cake: cake
calamity: calamity
calculate: calculate,calculated
calcutta: calcutta
calf: calf,calves
california: california
californian: californian
calling: calling
calmly: calmly
caltrop: caltrops
camera: camera
camp: camp
campaign: campaign
campaigner: campaigner
candid: candid
candidate: candidate
candle: candle
cane: cane
cannon: cannon
canvas: canvas
cap: cap,caps
capable: capable
capacity: capacity
capital: capital
captain: captain
capture: capture,captured
carbolise: carbolised
carbuncle: carbuncle
card: card,cards
cardboard: cardboard
care: care,cared,cares
career: career
careful: careful
carefully: carefully
careless: careless
carelessly: carelessly
caress: caress
caressing: caressing
cargo: cargo
carlo: carlo
carolinas: carolinas
carpenter: carpenter
carpet: carpet,carpets
carriage: carriage
carry: carried,carries,carry,carrying
cart: cart,carts
carte: carte
carve: carved
cascade: cascade
caseful: caseful
cashbox: cashbox
cashier: cashier
casket: casket
cast: cast
casting: casting
castle: castle
cat: cat
catastrophe: catastrophe
catch: catch,catching,caught
category: category
cathedral: cathedral
catherine: catherine
catlike: catlike
caution: caution
cave: cave,caved
cease: cease,ceased,ceases
ceaseless: ceaseless
cedars: cedars
ceiling: ceiling
celebrate: celebrated
celebrated: celebrated
cell: cell,cells
cellar: cellar
cent: cent
central: central
centre: centre
centred: centred
century: centuries,century
ceremony: ceremony
certainty: certainty
certificate: certificates
chaff: chaff,chaffed
chaffer: chaffering
chagrin: chagrin
chagrined: chagrined
chain: chain,chains
chair: chair,chairs
chairman: chairman
chalk: chalk
chamber: chamber,chambers
chamois: chamois
chance: chance,chanced,chances
change: change,changed,changing
chap: chap
chapter: chapter
character: character,characters
characteristic: characteristic,characteristics
charcoal: charcoal
charge: charge,charged,charges
charing: charing
charitable: charitable
charity: charities,charity
charles: charles
charm: charm
charming: charming
charred: charred
chase: chase,chased
chasing: chasing
chat: chat,chatted,chatting
cheap: cheap
cheat: cheating
check: check,checks
checkmate: checkmate
cheek: cheeks
cheekbone: cheekbones
cheer: cheer
cheerful: cheerful
cheerily: cheerily
cheerless: cheerless
cheery: cheery
cheetah: cheetah
chemical: chemical
chemistry: chemistry
cheque: cheque
cherry: cherry
chest: chest
chesterfield: chesterfield
chestnut: chestnut
chew: chewing
chief: chief
chiffon: chiffon
child: child,children
childish: childish
chill: chill
chimney: chimney,chimneys
chin: chin,chins
china: china
chinchilla: chinchilla
chinese: chinese
chink: chink
chisel: chisel
chivalrous: chivalrous
choke: choked
choose: choose,choosing,chose,chosen
christ: christ
christmas: christmas
chronic: chronic
chronicle: chronicle
chronicler: chronicler
chubb: chubb
chuck: chucked
chuckle: chuckled,chuckling
church: church
cigar: cigar,cigars
cigarette: cigarette,cigarettes
cinder: cinder
circle: circle,circles
circulation: circulation
circumspect: circumspect
circumstance: circumstances
circumstantial: circumstantial
citizen: citizens
city: city
civil: civil
civilisation: civilisation
civilised: civilised
claim: claim
clair: clair
clamber: clambered
clamped: clamped
clang: clang
clanging: clanging
clank: clank,clanking
clap: clapped
clara: clara
claret: claret
clark: clark
clasped: clasped
clasping: clasping
class: class,classes
clatter: clatter,clattered
claw: claws
clay: clay
clean: clean,cleaned
cleanly: cleanly
clearing: clearing
cleaver: cleaver
clenched: clenched
clergyman: clergyman
clerk: clerk,clerks
clever: clever
cleverness: cleverness
client: client,clients
climate: climate
climb: climbed,climbing
clinch: clinched
clink: clink,clinked
cloak: cloak
clock: clock
close: close,closed,closing
closed: closed
closely: closely
cloth: cloth
clothe: clad
clothes: clothes
cloud: cloud,clouded,clouds
cloudless: cloudless
club: club
clue: clue,clues
clump: clump,clumps
clumsy: clumsy
cluster: cluster
clutch: clutched,clutches,clutching
coach: coach
coachman: coachman
coarse: coarse
coarsely: coarsely
coat: coat
coax: coaxing
cobb: cobb
cobbler: cobbler
coburg: coburg
cobwebby: cobwebby
cocaine: cocaine
cock: cock,cocking
cocked: cocked
cockroach: cockroaches
cocksure: cocksure
cocktail: cocktail
code: codes
coffee: coffee
coil: coil
coin: coin,coins
coincidence: coincidence,coincidences
coincident: coincident
coiner: coiners
cold: cold
coldly: coldly
coldness: coldness
collapse: collapse,collapsed
collar: collar
colleague: colleague
collect: collected,collecting
collection: collection
college: college
colonel: colonel
colony: colonies,colony
colour: colour,coloured
coloured: coloured
colourless: colourless
column: column,columns
combination: combination,combinations
combine: combine,combined
comely: comely
comfort: comfort,comforted
comfortable: comfortable
comfortably: comfortably
comic: comic
comical: comical
command: command,commanding,commands
commander: commander
commence: commence
commencement: commencement
comment: comment,commenting
commerce: commerce
commercial: commercial
commission: commission,commissions
commissionaire: commissionaire
commit: commit,committed
common: common
commonly: commonly
commonplace: commonplace,commonplaces
commons: commons
communicate: communicate,communicated
communication: communication
communicative: communicative
community: community
commute: commuting
companion: companion,companions
company: companies,company
comparatively: comparatively
compare: compared,comparing
compass: compass,compasses
compel: compelled
compensate: compensated
competence: competence
competition: competition
compilation: compilation
complain: complain,complained
complaint: complaint
complete: complete,completed
completely: completely
complex: complex
complexion: complexion
compliance: compliance
complicate: complicates
compliment: compliment,complimented,compliments
complimentary: complimentary
comply: comply,complying
compose: compose,composed
composer: composer
compositor: compositor
comprehensive: comprehensive
compress: compress,compressed
compressed: compressed
compromise: compromise,compromised,compromising
compunction: compunction
comrade: comrade
conceal: conceal,concealed
concealment: concealment
conceit: conceit
conceivable: conceivable
conceive: conceive,conceives
concentrate: concentrate,concentrated
concentration: concentration
concept: concept
conception: conception
concern: concern,concerned
concerned: concerned
concert: concert,concerts
concise: concise
concisely: concisely
conclude: concluded,concluding
conclusion: conclusion,conclusions
conclusive: conclusive
condemn: condemned
condescend: condescend
condition: condition,conditions
conduct: conduct,conducted,conducting
confectioner: confectioner
confederate: confederate,confederates
confess: confess,confessed
confession: confession
confidant: confidant
confide: confide,confided
confidence: confidence
confidential: confidential
confine: confine,confined,confining
confirm: confirm,confirmed
confirmation: confirmation
confound: confound
confront: confronted
confused: confused
confusion: confusion
congenial: congenial
congratulate: congratulate,congratulated
conjecture: conjecture,conjectured
conjunction: conjunction
connect: connected
connection: connection
connivance: connivance
conscience: conscience
conscious: conscious
consciousness: consciousness
consent: consented
consequence: consequence,consequences
consequential: consequential
considerable: considerable
considerably: considerably
consideration: consideration,considerations
consist: consisted
console: consoled
conspicuous: conspicuous
conspire: conspiring
constable: constable,constables
constabulary: constabulary
constant: constant
consternation: consternation
constitution: constitution
constraint: constraint
construct: constructed
construction: construction
consult: consult,consulted,consulting,consults
consultation: consultations
consulting: consulting
consume: consumed,consuming
contact: contact
contemplation: contemplation
contemplative: contemplative
contemptuous: contemptuous
contents: contents
continent: continent,continents
continental: continental
continually: continually
continue: continue,continued,continues
continuously: continuously
contortion: contortions
contract: contract
contraction: contraction
contradict: contradict
contralto: contralto
contrary: contrary
contrast: contrast
contribute: contributed
contribution: contributions
contrition: contrition
control: control,controlled
conundrum: conundrums
convenience: convenience
convenient: convenient
conveniently: conveniently
convention: conventions
conventionality: conventionalities
conversation: conversation
converse: converse
convert: convert
convey: conveyed
conviction: conviction
convince: convince,convinced,convincing
convinced: convinced
convincing: convincing
convoy: convoy
convulse: convulse,convulsed
convulsion: convulsion
convulsive: convulsive
cooee: cooee
cook: cook
cooking: cooking
cool: cool,coolest
coolness: coolness
coop: cooped
copier: copier
copper: copper,coppers
copying: copying
copyright: copyright
coquettish: coquettish
cord: cord
cordially: cordially
corner: corner,corners
cornwall: cornwall
coroner: coroner
coronet: coronet
corporation: corporation
correct: correct
correctly: correctly
correspond: corresponded,corresponds
correspondence: correspondence
correspondent: correspondent
corridor: corridor,corridors
corroborate: corroborate
corroboration: corroboration
corrupt: corrupt
cosmopolitan: cosmopolitan
cost: cost,costs
coster: coster
costume: costume
cosy: cosy
cotton: cotton
couch: couch
cough: cough
counsel: counsel
counsellor: counsellor
count: count,counts
counterpaned: counterpaned
countess: countess
counties: counties
country: countries,country
countryman: countryman
countryside: countryside
county: counties,county
couple: couple,coupled,couples
courage: courage
court: court
courtesy: courtesy
cousin: cousin,cousins
covent: covent
coventry: coventry
cover: cover,covered
covered: covered
crab: crab
crack: crack,cracked,cracks
cracked: cracked
crackle: crackling
crackling: crackling
craggy: craggy
crane: crane
crash: crash
crate: crate,crates
cravat: cravat,cravats
crawl: crawl,crawled
creak: creaking
cream: cream
crease: creases
create: created,creating
creation: creation
creature: creature,creatures
credit: credit
creditable: creditable
creditor: creditor
creep: creeping
crest: crest
crewe: crewe
crib: crib
crime: crime,crimes
criminal: criminal,criminals
cringe: cringe
cringing: cringing
crinkle: crinkled
cripple: cripple
crippled: crippled
crisis: crisis
crisp: crisp
crisply: crisply
critical: critical
crocus: crocuses
crony: crony
crop: crop
cross: cross,crossed
crouch: crouched
crowd: crowd,crowded
crowded: crowded
crowder: crowder
crown: crown,crowns
crucial: crucial
crude: crude,crudest
cruel: cruel
cruelly: cruelly
cruelty: cruelty
crumbly: crumbly
crumple: crumpled
crumpled: crumpled
crush: crushed,crushing
crust: crust,crusted
crystal: crystals
crystallise: crystallised
cub: cub
cubic: cubic
cudgel: cudgelled
cuff: cuff
culprit: culprit
culture: cultured
cumbrous: cumbrous
cunning: cunning
cup: cup
cupboard: cupboard
curb: curb
cure: cure,cured
curiosity: curiosity
curious: curious
curl: curled,curling
curly: curly
current: current
curse: curse,curses
cursed: cursed
curt: curt
curtain: curtain
curve: curve,curves,curving
cushion: cushion,cushioned,cushions
custody: custody
custom: custom
customary: customary
customer: customer
cut: cut,cuts
cutting: cuttings
cylinder: cylinder,cylinders
cynical: cynical
dad: dad
daily: daily
dainty: daintiest
damage: damage
damaged: damaged
damages: damages
damning: damning
damp: damp
dane: dane
danger: danger,dangers
dangerous: dangerous
dangerously: dangerously
dangle: dangling
dank: dank
danseuse: danseuse
daresay: daresay
daring: daring
dark: dark,darker
darken: darkened
darkness: darkness
dart: darted,darting
dash: dash,dashed,dashing
datum: data
daub: daubing
daughter: daughter
dawdling: dawdling
dawn: dawn
day: day,days
daylight: daylight
daytime: daytime
daze: dazed
dazed: dazed
dead: dead
deadly: deadliest,deadly
deal: deal,dealing
dealer: dealer
dealings: dealings
dearest: dearest
dearly: dearly
death: death,deaths
deathbed: deathbeds
debt: debt,debts
deceased: deceased
deceive: deceive,deceived
december: december
deception: deception
deceptive: deceptive
decide: decide,decided
decidedly: decidedly
decision: decision
declare: declared
decline: decline
decorate: decorated
decoy: decoyed
decrepit: decrepit
decrepitude: decrepitude
deduce: deduce,deduced
deductible: deductible
deduction: deduction,deductions
deductive: deductive
deed: deed,deeds
deep: deep,deeper,deepest
deeply: deeply
defeat: defeated
defect: defect,defects
defective: defective
defence: defence
defend: defend,defending
deference: deference
defiantly: defiantly
deficiency: deficiencies
define: define,defined
definite: definite
defray: defray
degenerate: degenerating
degrade: degraded
degree: degree,degrees
dejected: dejected
delay: delay,delayed
deletion: deletions
delicacy: delicacy
delicate: delicate
delicately: delicately
delight: delight
delighted: delighted
delirious: delirious
delirium: delirium
delude: deluded
delusion: delusion
demand: demand
demeanour: demeanour
demon: demon
demurely: demurely
den: den
denial: denial
dense: dense
deny: denied,deny,denying
depart: departed
departure: departure
depend: depend,depended,depends
dependent: dependent
depict: depicted
deportment: deportment
depose: depose,deposed,deposes
deposit: deposit
deposition: deposition
depositor: depositors
depot: depot
depressed: depressed
depressing: depressing
depression: depression
deprive: deprived
derange: deranged
derby: derbies
derivative: derivative
derive: derive,derived,derives
descend: descend,descended,descending,descends
descent: descent
description: description
desert: deserted,deserting,deserts
deserted: deserted
deserve: deserve,deserved
design: designed
desire: desire,desired,desires
desirous: desirous
desk: desk
despair: despair
despaired: despaired
despairing: despairing
desperate: desperate
desperation: desperation
destine: destined
destiny: destiny
destitute: destitute
destroy: destroy,destroyed
destruction: destruction
desultory: desultory
detach: detach
detain: detain,detained
detect: detected
detective: detective
determination: determination
determine: determine,determined
determined: determined
detour: detour
detract: detracted
deuce: deuce
develop: develop,developed
developed: developed
development: developments
device: device
devil: devil,devils
devilish: devilish
devise: devised
devoid: devoid
devonshire: devonshire
devote: devote,devoted
devoted: devoted
devotedly: devotedly
devour: devoured,devouring
dew: dew
diabetes: diabetes
diadem: diadem
diamond: diamond
diary: diary
die: die,died,dies,dying
difference: difference
difficult: difficult
difficulty: difficulties,difficulty
dig: dig,digs,dug
digest: digesting
digging: diggings
dignity: dignity
dilate: dilate
diligence: diligence
diligently: diligently
dim: dim
dimly: dimly
dine: dine
dingy: dingy
dining: dining
dinner: dinner
dint: dint
dip: dipped,dipping
direct: direct,directed
direction: direction,directions
director: director,directors
dirt: dirt
dirty: dirty
disadvantage: disadvantage,disadvantages
disagreeable: disagreeable
disagreement: disagreements
disappear: disappeared,disappearing
disappearance: disappearance
disappoint: disappoint,disappointed
disappointed: disappointed
disappointment: disappointment
disc: disc
disclaim: disclaim
disclaimer: disclaimer,disclaimers
disclose: discloses
discolour: discoloured
disconnected: disconnected
discontent: discontent
discontinue: discontinue
discourage: discourage
discover: discover,discovered,discovering
discovery: discovery
discreet: discreet
discrepancy: discrepancy
discretion: discretion
discriminate: discriminate
discuss: discuss
disease: disease
disentangle: disentangled
disfigured: disfigured
disgrace: disgrace
disgraceful: disgraceful
disguise: disguise,disguised,disguises
disgust: disgust
dishonour: dishonoured
dishonourable: dishonourable
dishonoured: dishonoured
disk: disk
dislike: dislike,disliked
dismantle: dismantled
dismay: dismay
dismiss: dismissed
disown: disown
dispatch: dispatched
dispel: dispel
display: display,displayed,displaying
disposal: disposal
dispose: dispose
disposition: disposition
disproportionately: disproportionately
disputatious: disputatious
disqualify: disqualify
disregard: disregard,disregarded,disregarding
disreputable: disreputable
dissatisfied: dissatisfied
dissolute: dissolute
dissolve: dissolved
distaff: distaff
distance: distance
distant: distant
distinct: distinct
distinction: distinction
distinctive: distinctive
distinctly: distinctly
distinguish: distinguish
distorted: distorted
distracting: distracting
distribute: distribute,distributed,distributing
distribution: distribution
distributor: distributor
district: district
distrust: distrusted
disturb: disturb,disturbed
disturbance: disturbance
disturbed: disturbed
disturbing: disturbing
divan: divan
dive: dived
diversity: diversity
divert: diverted
divine: divined
diving: diving
division: division
dizziness: dizziness
dock: dock,docks
docket: docketing
dockyard: dockyard
doctor: doctor,doctors
document: document
doddering: doddering
dog: dog
doings: doings
dollar: dollars
domain: domain
donate: donate
donation: donation,donations
donna: donna
donor: donors
door: door,doors
doorway: doorway
dottle: dottles
double: double,doubled
doubly: doubly
doubt: doubt,doubted,doubting,doubts
doubtless: doubtless
download: downloading
downstairs: downstairs
downward: downward
dowry: dowry
doyle: doyle
dozen: dozen
drab: drab
drag: dragged,dragging
drama: drama
dramatic: dramatic
draught: draught,draughts
draw: draw,drawing,drawn,draws,drew
drawback: drawback
drawer: drawer,drawers
drawing: drawing
drawl: drawled
dread: dread
dreadful: dreadful
dreadfully: dreadfully
dream: dream,dreaming,dreams
dreamy: dreamy
dreary: dreary
dregs: dregs
drench: drenched
dress: dress,dressed,dressing
dressed: dressed
dressing: dressing
drift: drifted,drifting
drink: drank,drink,drinking,drunk
drive: drive,driven,drives,driving,drove
driver: driver
driving: driving
drone: droning
droop: drooping
drop: drop,dropped,dropping,drops
dropping: dropping
drown: drowned
drowsiness: drowsiness
drug: drug
drunk: drunk
drunkard: drunkard
drunken: drunken
dry: dried,dry
dryly: dryly
dual: dual
dubious: dubious
duchess: duchess
duke: duke
dull: dull
duly: duly
dummy: dummy
dun: dun
duncan: duncan
dundee: dundee
duplicate: duplicate,duplicates
dusk: dusk
dust: dust
dustcoat: dustcoat
dusty: dusty
duty: duties,duty
dwell: dwell
dweller: dweller
dwelling: dwelling
eager: eager
eagerly: eagerly
eagerness: eagerness
ear: ear,ears
earn: earn,earned,earning
earnest: earnest
earnestly: earnestly
earring: earrings
earshot: earshot
earth: earth
ease: ease
easily: easily
east: east
easterly: easterly
eastern: eastern
eastward: eastward
easy: easier,easy
eat: ate,eat,eaten
eaves: eaves
eavesdropper: eavesdroppers
ebb: ebbing
eccentric: eccentric
eccentricity: eccentricity
echo: echo,echoes
eclipse: eclipsed,eclipses
eddy: eddy
edge: edge,edged,edges
edged: edged
edition: edition,editions
editor: editor
education: education
educational: educational
edward: edward
eerie: eerie
effective: effective
effort: effort,efforts
effusive: effusive
egg: egg,eggs
egotism: egotism
eighteen: eighteen
ejaculate: ejaculated
ejaculation: ejaculation
eject: ejected
elaborate: elaborate
elapse: elapsed
elastic: elastic
elbow: elbow,elbowed,elbows
elder: elder
elderly: elderly
elect: elect
electric: electric
electronic: electronic
electronically: electronically
element: element,elements
elemental: elemental
elementary: elementary
elias: elias
eligible: eligible
eliminate: eliminated
emaciation: emaciation
email: email
embankment: embankment
embarrass: embarrassed
embellish: embellish
emerald: emerald
emerge: emerge,emerged
emigrant: emigrant
emigrate: emigrated
emotion: emotion,emotions
empire: empire
employ: employ,employed,employing,employs
employee: employee,employees
employer: employer,employers
employment: employment
en: en
enable: enable,enabled,enables
encamp: encamp
encircle: encircled
enclosure: enclosure
encode: encoding
encompass: encompass
encourage: encourage
encouraging: encouraging
endeavour: endeavour,endeavoured,endeavouring
endless: endless
endure: endured
enemy: enemies,enemy
energetic: energetic
energy: energy
engage: engage,engaged,engaging
engaged: engaged
engagement: engagement
engine: engine,engines
engineer: engineer,engineers
england: england
english: english
englishman: englishman
engrave: engraved
enigmatical: enigmatical
enjoy: enjoy,enjoyed
enlarge: enlarged
ennui: ennui
enormous: enormous
ensue: ensue,ensued
ensure: ensuring
entail: entailed
entangle: entangled
enter: enter,entered,entering,enters
enterprise: enterprise
entertaining: entertaining
enthusiasm: enthusiasm
enthusiastic: enthusiastic
entire: entire
entitle: entitles
entity: entity
entrance: entrance
entreat: entreated
entreaty: entreaties
entry: entries,entry
envelope: envelope
enwrapped: enwrapped
epicurean: epicurean
episode: episode,episodes
epistle: epistle
equal: equal,equalled
equality: equality
equally: equally
equinoctial: equinoctial
equipment: equipment
ere: ere
erect: erect,erected
err: erred
errand: errand
erroneous: erroneous
error: error,errors
escapade: escapade
escape: escape,escaped,escaping
escort: escort,escorted
essence: essence
essential: essential
establish: establish,established
establishment: establishment
estate: estate,estates
estimate: estimate
eton: eton
europe: europe
european: european
eustace: eustace
evening: evening,evenings
event: event,events
eventually: eventually
everyday: everyday
evidence: evidence
evident: evident
evidently: evidently
evil: evil
evolve: evolve,evolved
exact: exact,exacted
exacting: exacting
exactness: exactness
exaggerated: exaggerated
exalt: exalted
examination: examination
examine: examine,examined,examining
excavate: excavating
exceed: exceeded,exceeding
exceedingly: exceedingly
excellent: excellent
exception: exception
exceptional: exceptional
exceptionally: exceptionally
excessive: excessive
exchange: exchange,exchanged,exchanging
excitable: excitable
excited: excited
excitedly: excitedly
excitement: excitement
exciting: exciting
exclaim: exclaimed
exclamation: exclamation
exclude: exclude,excluded
exclusion: exclusion
excursion: excursion
excuse: excuse,excuses
execution: execution
exempt: exempt
exercise: exercise,exercising
exert: exert
exhibit: exhibited
exhilarate: exhilarating
exist: exists
existence: existence
exit: exit
expect: expect,expected,expecting
expectancy: expectancies,expectancy
expedition: expedition
expend: expend
expenditure: expenditure
expense: expense,expenses
expensive: expensive
experience: experience,experienced,experiences
expire: expired,expiring
explain: explain,explained,explaining,explains
explanation: explanation,explanations
explore: explore
export: exporting
expose: exposed
expostulate: expostulating
exposure: exposure
expound: expound
express: express,expressed
expression: expression,expressions
expressive: expressive
expressly: expressly
exquisite: exquisite
extend: extend,extended,extending
extended: extended
extent: extent
extinguish: extinguished,extinguishes
extra: extra
extract: extracts
extraordinary: extraordinary
extreme: extreme
extremely: extremely
extremity: extremity
eye: eye,eyes
eyebrow: eyebrows
eyed: eyed
eyeglass: eyeglasses
fabrication: fabrication
faced: faced
facet: facet
facilitate: facilitate
facility: facility
factor: factor
factory: factories,factory
faculty: faculties
fad: fad,fads
faddy: faddy
fade: fade,faded
fag: fagged
fail: fail,failed,failing
fain: fain
faint: faint,fainted,fainting
fainting: fainting
faintly: faintly
fair: fair,fairer
fait: fait
faith: faith
faithfully: faithfully
fall: fall,fallen,falling,falls,fell
false: false
familiar: familiar
family: families,family
famished: famished
famous: famous
fanciful: fanciful
fancy: fancier,fancies,fancy
fang: fangs
fanlight: fanlight
fantastic: fantastic
fare: fare
farewell: farewell
farm: farm,farms
farmhouse: farmhouse
farth: farthest
farthing: farthing
fascinating: fascinating
fascination: fascination
fashion: fashion
fashionable: fashionable
fashioned: fashioned
fast: fast,faster
fasten: fasten,fastened,fastening
fastener: fasteners
fat: fat,fattest
fatal: fatal
fatally: fatally
fate: fate
father: father
fathom: fathom,fathomed
fatigued: fatigued
fatten: fattened
fault: fault,faults
favour: favour,favoured
favourable: favourable
favourably: favourably
fear: fear,feared,fears
fearless: fearless
feasible: feasible
feat: feat
feather: feather,feathers
feature: feature,features
featureless: featureless
february: february
federal: federal
fee: fee,fees
feeble: feeble
feed: fed,feed
feel: feel,feeling
feeling: feeling,feelings
feign: feigned
fellow: fellow,fellows
felony: felony
feminine: feminine
ferguson: ferguson
ferocious: ferocious
ferret: ferret
fess: fess
festivity: festivities
fetch: fetch
fever: fever
fiction: fiction
fidelity: fidelity
fidget: fidgeted
field: field,fields
fierce: fierce
fiercely: fiercely
fiery: fiery
fight: fight,fighting,fought
figure: figure,figured,figures
file: file,filed,files
filial: filial
filthy: filthy
final: final
finally: finally
financial: financial
financier: financier
finder: finder
fine: fine,finer,finest
finely: finely
finger: finger,fingers
fingertip: fingertips
finish: finish,finished
finns: finns
firelight: firelight
fireman: firemen
fireplace: fireplace
firm: firm
firmly: firmly
firmness: firmness
fish: fish,fished,fishes
fist: fists
fit: fit,fits,fitted
fitness: fitness
fitting: fitting
fiver: fiver
flag: flag,flagged,flags
flame: flame,flames,flaming
flaming: flaming
flap: flap,flapped
flare: flare,flaring
flash: flash,flashed,flashing
flat: flat,flatter
flatten: flattened,flattening
flatter: flattered
flattered: flattered
flaubert: flaubert
flaw: flaw
fleck: flecked
flee: fled
fleecy: fleecy
fleet: fleet
fleeting: fleeting
flesh: flesh
fleshless: fleshless
flick: flicked,flicking
flicker: flickering
flight: flight
fling: flung
flirt: flirting
flit: flitted
float: floating
flock: flock
flood: flood
floor: floor
flooring: flooring
flora: flora
florid: florid
florida: florida
flourish: flourished
flow: flowing
flower: flowers
fluffy: fluffy
flurried: flurried
flush: flush,flushed,flushing
flutter: fluttered
fly: flew,flies,fly,flying
focus: focus
fog: fog,fogs
foil: foil
fold: fold,folded,folding
foliage: foliage
folk: folk,folks
follow: follow
folly: folly
fond: fond,fonder
fondness: fondness
food: food
fool: fool,fools
foolish: foolish
foolishly: foolishly
foolscap: foolscap
foot: feet,foot
footfall: footfall,footfalls
footing: footing
footman: footman,footmen
footmark: footmarks
footpath: footpath,footpaths
footstep: footsteps
foppishness: foppishness
forbid: forbid,forbidden,forbidding
force: force,forced,forces
forceps: forceps
forearm: forearm
foreboding: forebodings
forecastle: forecastle
forefinger: forefinger,forefingers
forehead: forehead
foreign: foreign
foreigner: foreigner
foreman: foreman
foremost: foremost
foresee: foresaw,foresee,foreseen
foresight: foresight
forestall: forestalling
foretell: foretold
forfeit: forfeit
forger: forger
forgery: forgery
forget: forget,forgot,forgotten
forgetfulness: forgetfulness
forgive: forgive,forgiven
forgiveness: forgiveness
forgo: forgo
form: form,formed,forming
formality: formalities
format: format,formats
formidable: formidable
fort: forts
fortnight: fortnight
fortunate: fortunate
fortunately: fortunately
fortune: fortune,fortunes
foul: foul
foundation: foundation
founder: founder
fountain: fountain
fourteen: fourteen
fourteenth: fourteenth
fourth: fourth
fowl: fowl,fowls
fowler: fowler
fragment: fragment
frame: frame,framed
framework: framework
france: france
franchise: franchise
francis: francis
francisco: francisco
franco: franco
frank: frank
frankly: frankly
frantic: frantic
frantically: frantically
fraud: fraud
fray: frayed
freak: freak
freckle: freckled
freedom: freedom
freely: freely
freemason: freemason
freemasonry: freemasonry
french: french
frenchman: frenchman
frenzy: frenzy
frequent: frequent
frequently: frequently
fresh: fresh
fresno: fresno
friday: friday
friend: friend,friends
friendly: friendly
friendship: friendship
fright: fright
frighten: frighten,frightened
frightened: frightened
frightful: frightful
frill: frill
fringe: fringe,fringed
frisco: frisco
fritz: fritz
fro: fro
frock: frock
frog: frogged
frost: frost
frosted: frosted
frosty: frosty
frown: frowning
fruit: fruits
fruitless: fruitless
fugitive: fugitives
fulfil: fulfil,fulfilled
fulfilment: fulfilment
fumble: fumbled
fume: fumes
fund: fund,funds
funniest: funniest
funny: funny
fur: fur
furiously: furiously
furnish: furnish,furnished,furnishes
furnished: furnished
furniture: furniture
furtive: furtive
fury: fury
fuss: fuss
future: future
gable: gables
gain: gain,gained,gaining
gainer: gainer
gaiter: gaiters
gale: gale,gales
gallop: gallop
gallows: gallows
galvanise: galvanised
gambler: gambler
game: game
gang: gang
gaol: gaol
gap: gap
gape: gaped,gaping
garden: garden
garment: garment,garments
gas: gas
gash: gash
gaslight: gaslight
gasogene: gasogene
gasp: gasped
gate: gate,gates
gather: gather,gathered,gathering
gathering: gathering
gaunt: gaunt
gaunter: gaunter
gaze: gaze,gazed,gazing
gazette: gazette
gazetteer: gazetteer
gear: gear
gem: gem,gems
generation: generation,generations
generous: generous
genial: genial
geniality: geniality
genii: genii
genteel: genteel
gentle: gentle
gentleman: gentleman,gentlemen
gentlemanly: gentlemanly
gently: gently
geology: geology
george: george
georgia: georgia
german: german,germans
gesellschaft: gesellschaft
gesticulate: gesticulating
gesture: gesture
ghastly: ghastly
ghost: ghost
giant: giant
gibe: gibe
gift: gift
gigantic: gigantic
gilt: gilt
gin: gin
gipsy: gipsies,gipsy
girl: girl,girls
girt: girt
glad: glad
glade: glade
gladstone: gladstone
glamour: glamour
glance: glance,glanced,glances,glancing
gland: glands
glare: glare,glared,glaring
glass: glass,glasses
gleam: gleam,gleaming
glide: glided
glimmer: glimmer,glimmered
glimpse: glimpse,glimpses
glint: glint,glints
glisten: glisten
glitter: glitter
globe: globe
gloom: gloom
gloomily: gloomily
gloomy: gloomy
gloss: gloss
glossy: glossy
glove: glove,gloves
glow: glow,glowing
goad: goading
goal: goals
god: god
godfrey: godfrey
gold: gold
golden: golden
gong: gong
goodness: goodness
goodwill: goodwill
goose: geese,goose
gordon: gordon
gospel: gospel
gossip: gossip,gossiping,gossips
govern: govern
governess: governess,governesses
government: government
gown: gown
grab: grabs
grace: grace
graceful: graceful
gracious: gracious
gradually: gradually
grain: grain
grand: grand
grandfather: grandfather
grant: granted,granting
gras: gras
grasp: grasp,grasped,grasping
grass: grass
grate: grate,grating
grateful: grateful
gratefully: gratefully
gratitude: gratitude
grave: grave,graver
gravel: gravel
gravely: gravely
gravity: gravity
greasy: greasy
greatcoat: greatcoat
green: green
greengrocer: greengrocer
greenwich: greenwich
greet: greet,greeting
greeting: greeting
grey: grey
greyish: greyish
grice: grice
grief: grief
grievance: grievance
grieve: grieved
grievous: grievous
grim: grim
grime: grime
grimly: grimly
grin: grin,grinned,grinning
grind: grind
grinder: grinder
grip: grip,gripping
grit: grit
gritty: gritty
grizzle: grizzled
grizzled: grizzled
groan: groan,groaned
groom: groom,groomed
grope: groping
gross: gross
grotesque: grotesque
ground: ground
grounds: grounds
grove: grove
grow: grew,grow,growing,grown
grown: grown
gruff: gruff
guard: guard
guardianship: guardianship
guardsman: guardsmen
guess: guess,guessed
guidance: guidance
guide: guide
guilt: guilt
guilty: guilty
guinea: guinea,guineas
gullet: gullet
gulp: gulp
gum: gum
gummed: gummed
gun: gun
gush: gush,gushes
gutter: guttering
ha: ha
habit: habit,habits
hack: hacked
hafiz: hafiz
haggard: haggard
hague: hague
hail: hail,hailed
hair: hair
haired: haired
halfway: halfway
halifax: halifax
hall: hall
hammer: hammered
hampshire: hampshire
hand: hand,handed,handing,hands
handcuffs: handcuffs
handed: handed
handedness: handedness
handkerchief: handkerchief,handkerchiefs
handle: handle,handled,handling
handling: handling
handsome: handsome
handwriting: handwriting
handy: handy
hang: hang,hanged,hanging,hangs,hung
hanover: hanover
hansom: hansom,hansoms
happen: happen,happened,happening
happily: happily
happiness: happiness
happy: happy
hard: hard,hardest
harden: hardened
hardened: hardened
hardihood: hardihood
hardy: hardy
hare: hare
harm: harm
harmless: harmless
harmonium: harmonium
harmony: harmony
harness: harness
harris: harris
harrow: harrow
harsh: harsh
harshly: harshly
hart: hart
harvest: harvest
hasp: hasp
haste: haste
hasten: hastened,hastening
hastily: hastily
hat: hat,hats
hate: hate,hated
hatty: hatty
haul: hauling
hawk: hawk
hay: hay
hazard: hazarded
haze: haze
head: head,headed,heading,heads
headache: headache
headed: headed
headgear: headgear
heading: heading,headings
headstrong: headstrong
health: health
healthy: healthy
heap: heap,heaped
hear: hear,heard,hearing,hears
hearing: hearing
heart: heart,hearts
hearted: hearted
heartily: heartily
heartless: heartless
hearty: hearty
heated: heated
heather: heather
heaven: heaven,heavens
heavily: heavily
heaving: heaving
heavy: heavier,heavy
hebrew: hebrew
hedge: hedge,hedges
heed: heed
heel: heel,heels
heelless: heelless
heh: heh
height: height
heinous: heinous
heir: heirs
heiress: heiress
helen: helen
hellish: hellish
helper: helper
helpless: helpless
henry: henry
herald: herald
hercules: hercules
herd: herd
hereditary: hereditary
hereford: hereford
heroic: heroic
hesitate: hesitate,hesitated,hesitating
hesitation: hesitation
hidden: hidden
hide: hide
hideous: hideous
highly: highly
highness: highness
highway: highway
hill: hill,hills
hinder: hinders
hindrance: hindrance
hinge: hinges
hint: hint,hinted,hinting
hire: hired
hiss: hiss
history: history
hit: hit
hitherto: hitherto
hoard: hoard
hoarse: hoarse
hoarsely: hoarsely
hoax: hoax
hobby: hobbies,hobby
hold: held,hold,holding
holder: holder
hole: hole,holes
holiday: holiday
holland: holland
hollow: hollow,hollowed
holmes: holmes
homely: homely
homestead: homesteads
homeward: homeward
honest: honest
honeymoon: honeymoon
honour: honour
honourable: honourable
hood: hood
hoof: hoofs
hook: hook
hope: hope,hoped,hopes,hoping
hopeful: hopeful
hopeless: hopeless
horace: horace
horner: horner
horrible: horrible
horribly: horribly
horrid: horrid
horrify: horrify
horror: horror,horrors
horse: horse,horses
horsey: horsey
hospital: hospital
hospitality: hospitality
host: host
hot: hot
hotel: hotel,hotels
hound: hound
hour: hour,hours
house: house,houses
household: household
housekeeper: housekeeper
housemaid: housemaid
hover: hover
howl: howl,howling
hubbub: hubbub
huddle: huddled
hudson: hudson
huffed: huffed
hug: hugged
huge: huge
hugh: hugh
hullo: hullo
hum: hum,humming
human: human
humanity: humanity
humble: humble,humbler
humdrum: humdrum
humiliation: humiliation
humour: humour,humours
humoured: humoured
hungrily: hungrily
hungry: hungry
hunt: hunt,hunted,hunting
hunter: hunter
hunting: hunting
hurl: hurled,hurling
hurried: hurried
hurriedly: hurriedly
hurry: hurried,hurry,hurrying
hurt: hurt,hurts
husband: husband
hush: hush,hushing
hyde: hyde
hydraulic: hydraulic
hydraulics: hydraulics
hydrochloric: hydrochloric
hypothesis: hypothesis
hysterical: hysterical
ice: ice
idea: idea,ideas
ideal: ideal
identical: identical
identification: identification
identify: identified,identify
identity: identity
idiot: idiot
idle: idle
idler: idler
ignorance: ignorance
ignorant: ignorant
iii: iii
illegal: illegal
illegally: illegally
illness: illness
illuminate: illuminated
illustrate: illustrate,illustrated
illustrious: illustrious
imagination: imagination
imagine: imagine
imbecile: imbecile
imbecility: imbecility
imbed: imbedded
imitate: imitate,imitated
immense: immense
immensely: immensely
imminent: imminent
impassable: impassable
impatience: impatience
impatient: impatient
impatiently: impatiently
impending: impending
imperial: imperial
imperil: imperilled
impersonal: impersonal
impertinent: impertinent
imperturbably: imperturbably
impetuous: impetuous
implacable: implacable
implicate: implicate,implicated,implicates,implicating
implicit: implicit
implore: implore,implored,imploring
imply: implied,implies,imply
importer: importers
impose: imposed,imposing
impossibility: impossibility
impossible: impossible
impress: impressed
impressed: impressed
impression: impression,impressions
impressive: impressive
imprison: imprisoned
imprisonment: imprisonment
improbability: improbabilities
improbable: improbable
improve: improved,improving
improvisation: improvisations
imprudence: imprudence
imprudently: imprudently
impulse: impulse
impulsive: impulsive
impulsively: impulsively
impunity: impunity
inaccurate: inaccurate
inadequate: inadequate
inarticulate: inarticulate
incalculable: incalculable
incapable: incapable
incarnate: incarnate
inception: inception
inch: inches
incident: incident,incidents
incidental: incidental
incisive: incisive
incite: incites
incline: inclined
inclined: inclined
include: include,included,includes,including
including: including
incognito: incognito
incoherent: incoherent
income: income
incomplete: incomplete
inconsequential: inconsequential
inconvenience: inconvenience
incorrigible: incorrigible
increase: increased,increasing
incredible: incredible
incredulity: incredulity
incriminate: incriminate
indebted: indebted
indemnify: indemnify
indemnity: indemnity
independent: independent
india: india
indian: indian,indians
indication: indication,indications
indifferent: indifferent
indignation: indignation
indirect: indirect
indirectly: indirectly
indiscreetly: indiscreetly
indiscretion: indiscretion
indisposition: indisposition
indistinguishable: indistinguishable
individual: individual
individuality: individuality
indoor: indoors
indoors: indoors
induce: induce
indulge: indulge,indulged
indulgently: indulgently
inexorable: inexorable
inexplicable: inexplicable
inextricable: inextricable
infer: infer,inferred
inference: inference,inferences
infernal: infernal
infinite: infinite
infinitely: infinitely
infirmity: infirmity
inflamed: inflamed
inflict: inflicted
influence: influence
inform: inform,informed,informing
informality: informality
infringement: infringement
ingenious: ingenious
ingenuity: ingenuity
inhabit: inhabited
inherit: inherit
inheritance: inheritance
inimitably: inimitably
initial: initials
injection: injections
injunction: injunction
injure: injured,injuring
injured: injured
injury: injuries,injury
injustice: injustice
ink: ink
inn: inn
innocence: innocence
innocent: innocent
inquest: inquest
inquire: inquire,inquired,inquiring
inquirer: inquirer
inquiry: inquiries,inquiry
insane: insane
insanely: insanely
inscrutable: inscrutable
insect: insects
insensibility: insensibility
insensibly: insensibly
insight: insight
insinuate: insinuating
insist: insist,insisted,insists
insolence: insolence
inspect: inspect
inspection: inspection
inspector: inspector
inspire: inspiring
instance: instance
instant: instant
instantly: instantly
instep: instep
instinct: instinct,instincts
institute: instituted
instruction: instruction,instructions
instructive: instructive
instrument: instrument
insufficient: insufficient
insult: insult
intellectual: intellectual
intelligence: intelligence
intelligent: intelligent
intend: intend,intended
intense: intense
intensify: intensified
intensity: intensity
intention: intention,intentions
intently: intently
interfere: interfere
interim: interim
interject: interjected
internal: internal
international: international
interpose: interposed
interpret: interpreted
interrupt: interrupt,interrupted
interruption: interruption
interval: intervals
interview: interview
intimacy: intimacy
intimate: intimate
intricate: intricate
intrigue: intrigue
introduce: introduce,introduced,introducing
introduction: introduction
introspect: introspect
introspective: introspective
intrude: intruding
intruder: intruder
intrusion: intrusion,intrusions
intrust: intrusted
intuition: intuition,intuitions
invader: invaders
invalidity: invalidity
invaluable: invaluable
invariable: invariable
invariably: invariably
invent: invent
invest: invested
investigate: investigate,investigated
investigation: investigation,investigations
investment: investment,investments
inviolate: inviolate
invisible: invisible
invite: invited
involve: involved
iodoform: iodoform
iota: iota
irene: irene
irish: irish
iron: iron
irresistible: irresistible
irs: irs
island: island
isle: isle
isolate: isolated
isolation: isolation
issue: issue,issues
italian: italian
item: item,items
iv: iv
ivory: ivory
ix: ix
jack: jack
jacket: jacket
jackson: jackson
jagged: jagged
james: james
jane: jane
january: january
jaw: jaw
jealously: jealously
jealousy: jealousy
jem: jem
jeremiah: jeremiah
jerk: jerked,jerking
jerkily: jerkily
jersey: jersey
jest: jest
jesting: jesting
jet: jet
jewel: jewel,jewels
jeweller: jeweller
jewellery: jewellery
jezail: jezail
job: job
john: john
joint: joint
joke: joke,jokes,joking
jollification: jollification
jolt: jolted
jones: jones
jose: jose
joseph: joseph
jostle: jostling
jot: jot
journey: journey,journeyed,journeys
jove: jove
jovial: jovial
jowl: jowl
joy: joy
judge: judge,judged
judgment: judgment
judicial: judicial
jug: jug
julia: julia
jump: jump,jumped,jumping
june: june
junior: junior
jury: jury
juryman: juryman
justice: justice
justified: justified
jut: jutted,jutting
kate: kate
keen: keen,keenest
keener: keener
keenly: keenly
keeper: keeper
keeping: keeping
kempt: kempt
kensington: kensington
kent: kent
kettle: kettle
key: key
keyhole: keyhole
kick: kicked,kicks
kill: kill,killed,killing
kindle: kindled
kindliness: kindliness
kindly: kindly
kindness: kindness
king: king,kings
kingdom: kingdom
kiss: kissed
kitchen: kitchen
klan: klan
knee: knee,knees
kneel: kneeling,knelt
knife: knife
knit: knitted
knock: knock,knocked
knot: knot,knots
knowledge: knowledge
label: label
labour: labour
labyrinth: labyrinth
lace: lace
lack: lack
lad: lad
ladder: ladder
laden: laden
lady: ladies,lady
ladyship: ladyship
lake: lake
lame: lame
lameness: lameness
lamp: lamp,lamps
lancaster: lancaster
land: land,landed
landau: landau
landing: landing
landlady: landlady
landlord: landlord
landowner: landowner
landscape: landscape
lane: lane,lanes
language: language
languid: languid
languor: languor
lank: lank
lantern: lantern,lanterns
lap: lap
lapse: lapse
lascar: lascar
lash: lash,lashed
lassitude: lassitude
latch: latch
late: late
lateness: lateness
lateral: lateral
laudanum: laudanum
laugh: laugh,laughed,laughing
laughter: laughter
laurel: laurel
law: law,laws
lawn: lawn
lawyer: lawyer
lay: laid,lay,laying,lays
layer: layers
lazily: lazily
lead: lead,leading,leads,led
leader: leader
leaf: leaf,leaves
league: league
leak: leaking
leakage: leakage
lean: lean,leaned,leaning
leap: leaped,leaps
learn: learn,learned
learning: learning
leather: leather
leatherhead: leatherhead
leave: leave,leaves,leaving,left
lebanon: lebanon
lecture: lecture,lectures
ledger: ledger,ledgers
lee: lee
left: left
leg: leg,legs
legal: legal
legally: legally
legged: legged
leggings: leggings
legible: legible
lemon: lemon
lend: lent
lengthen: lengthen,lengthened
lengthy: lengthy
lenient: lenient
lens: lens,lenses
lethargy: lethargy
letter: letter,letters
letters: letters
level: level
lever: levers
liability: liability
liable: liable
liar: liar
liberate: liberated
liberty: liberties,liberty
library: libraries,library
license: license
licensed: licensed
lichen: lichen
lid: lid,lids
lidded: lidded
lie: lain,lie,lies,lying
lieu: lieu
life: life,lives
lifeless: lifeless
lift: lifted
light: light,lighted,lighter,lighting,lights,lit
lighten: lighten,lightened
lighthouse: lighthouse
lighting: lighting
lightning: lightning
limb: limb,limbs
lime: lime
limit: limit,limited,limits
limitation: limitation
limited: limited
limp: limp,limped,limping,limps
linen: linen
linger: lingering
lining: lining
link: link,linked,links
linoleum: linoleum
lip: lip,lips
lipped: lipped
list: list
listen: listen,listened,listening
listless: listless
literary: literary
literature: literature
lithe: lithe
litter: litter
live: live,lived,lives,living
liver: liver
livid: livid
living: living
lloyd: lloyd
load: loading
loaf: loaf
loafer: loafer
loafing: loafing
loan: loans
loathe: loathed
loathing: loathing
loathsome: loathsome
lobster: lobster
local: local
locality: locality
locate: located
location: locations
lock: lock,locked
locket: locket
locus: locus
lodge: lodge
lodger: lodger
lodging: lodging
lodgings: lodgings
loftily: loftily
logic: logic
logical: logical
logician: logician
loitering: loitering
london: london
londoners: londoners
lone: lone
lonely: lonelier,lonely
lookout: lookout
loom: loomed,looming
loop: loop
loophole: loophole
loose: loose,loosed
loosen: loosened
lord: lord,lords
lordship: lordship
lose: lose,losing,lost
loss: loss
lost: lost
lot: lot
loud: loud,louder
loudly: loudly
louisiana: louisiana
lounge: lounged,lounging
lounger: loungers
love: love,loved,loves
lovely: lovely
lover: lover,lovers
loving: loving
lowly: lowliest
lucid: lucid
luck: luck
lucky: lucky
lucrative: lucrative
lucy: lucy
luggage: luggage
lumber: lumber
lunatic: lunatic
lunch: lunch
luncheon: luncheon
lurch: lurched
lure: lure,lured
lurid: lurid
lurk: lurking
lust: lust
lustre: lustre
lustrous: lustrous
luxuriant: luxuriant
luxurious: luxurious
luxury: luxuries
lyon: lyon
lysander: lysander
machine: machine
machinery: machinery
mad: mad
madam: madam
madame: madame
maddening: maddening
mademoiselle: mademoiselle
madly: madly
madman: madman
madness: madness
maggie: maggie
magician: magician
magistrate: magistrate,magistrates
magnificent: magnificent
magnifico: magnifico
magnify: magnifying
mahogany: mahogany
maid: maid,maids
maiden: maiden
mail: mail
main: main
maintain: maintaining
maintenance: maintenance
majesty: majesty
major: major
maker: maker
makings: makings
malay: malay
male: male
malignant: malignant
mall: mall
manage: manage,managed,managing
management: management
manager: manager
manageress: manageress
mangled: mangled
mania: mania
manifest: manifested
manifestation: manifestations
manifold: manifold
mankind: mankind
manner: manner
manners: manners
manor: manor
mansion: mansion
mansions: mansions
mantelpiece: mantelpiece
manual: manual
manufactory: manufactory
map: map
marble: marble
march: march
margin: margin,margins
marine: marines
mark: mark,marked,marks
marked: marked
market: market
marm: marm
marriage: marriage
married: married
marry: married,marry,marrying
marseilles: marseilles
marshy: marshy
martyrdom: martyrdom
mary: mary
masculine: masculine
mask: mask,masked
masonry: masonry
mass: mass,masses
massive: massive
master: master
masterly: masterly
mastery: mastery
mastiff: mastiff
mat: mat
match: match,matches
mate: mates
material: material
matter: matter,matters
mature: mature
maxim: maxim
maximum: maximum
meadow: meadow,meadows
meal: meal
meaning: meaning
meanly: meanly
measure: measure,measured,measures
meddle: meddle
meddler: meddler
medical: medical
meditation: meditation
meditative: meditative
medium: medium
meet: meet,meeting,meets,met
meeting: meetings
melbourne: melbourne
melon: melon
memoir: memoir
memorandum: memoranda
memory: memory
menaced: menaced
mendicant: mendicant,mendicants
mental: mental
mention: mention,mentioned
merchant: merchant
merchantability: merchantability
mercifully: mercifully
mercy: mercy
mere: mere,merest
merit: merit
merry: merry
mesh: meshes
mess: mess
message: message
messenger: messenger
metal: metal
metallic: metallic
method: method,methods
metropolis: metropolis
metropolitan: metropolitan
mew: mews
mews: mews
mexico: mexico
michael: michael
midday: midday
middle: middle
midnight: midnight
midst: midst
midway: midway
mile: mile,miles
military: military
milk: milk
millionaire: millionaire
mind: mind,minds
minded: minded
miner: miners
mingle: mingled
miniature: miniature
mining: mining
minister: minister
minor: minor
minute: minute,minutes
minutely: minutely
mirror: mirror
mischance: mischance
mischief: mischief
miserable: miserable
misfortune: misfortune
misgiving: misgivings
misjudge: misjudged
missing: missing
mission: mission
mississippi: mississippi
mistake: mistake
mistaken: mistaken
mister: mister
mistress: mistress
mix: mixed
mixed: mixed
mixture: mixture
modern: modern
modest: modest
modification: modification
modify: modified
moist: moist
moisten: moistened
moisture: moisture
mole: mole
moment: moment,moments
momentary: momentary
monarch: monarch
monday: monday
money: money
monger: monger
monica: monica
monogram: monogram
monograph: monograph
monomaniac: monomaniac
monosyllable: monosyllable,monosyllables
monotonous: monotonous
monotony: monotony
montague: montague
montana: montana
month: month,months
mood: mood,moods
moodily: moodily
moody: moody
moon: moon
moonless: moonless
moonlight: moonlight
moonshine: moonshine
mop: mopping
moral: moral
moran: moran
morning: morning,mornings
morocco: morocco
morose: morose
morris: morris
morrow: morrow
mortal: mortal,mortals
mortar: mortar
mortgage: mortgage
mortimer: mortimer
moss: moss
mother: mother
motion: motion,motioned
motionless: motionless
motive: motive,motives
mottled: mottled
mould: mould
mountain: mountains
mouse: mice
mousseline: mousseline
moustache: moustache
mouth: mouth,mouths
mouthed: mouthed
movement: movement
mud: mud
muff: muff
multiply: multiply
mumble: mumbled
mumbling: mumbling
munich: munich
munificent: munificent
murder: murder,murdered,murders
murderer: murderer,murderers
murdering: murdering
murderous: murderous
murky: murky
murmur: murmured
muscle: muscles
museum: museum
music: music
musician: musician
mustard: mustard
muster: muster
mutter: muttered,muttering
muzzle: muzzle
mysterious: mysterious
mystery: mysteries,mystery
myth: myth
nail: nail,nails
naked: naked
napoleon: napoleons
narrate: narrated
narrative: narrative,narratives
narrow: narrow,narrowed
narrowly: narrowly
nation: nation
national: national
native: native
natural: natural
naturally: naturally
nature: nature
natured: natured
nautical: nautical
nearer: nearer
neat: neat
neatly: neatly
neatness: neatness
necessitate: necessitate
necessity: necessity
neck: neck
necktie: necktie
ned: ned
needle: needle
negligence: negligence
negro: negro,negroes
neighbour: neighbour,neighbouring,neighbours
neighbourhood: neighbourhood
nerve: nerve,nerves
nervous: nervous
nervously: nervously
nest: nest
network: network
neutral: neutral
neville: neville
newcomer: newcomer,newcomers
newly: newly
news: news
newsletter: newsletter
newspaper: newspaper,newspapers
nice: nice
nicely: nicely
nickel: nickel
niece: niece
nigh: nigh
night: night,nights
nights: nights
nip: nip
nipper: nipper
nitrate: nitrate
noble: noble,noblest
nobleman: nobleman
nocturnal: nocturnal
nod: nod,nodded,nodding
noise: noise
noised: noised
noiseless: noiseless
noiselessly: noiselessly
nominal: nominal
nonconformist: nonconformist
nonentity: nonentity
nonproprietary: nonproprietary
nonsense: nonsense
noose: noose
normal: normal
north: north
nose: nose
nosed: nosed
nostril: nostrils
notable: notable
notably: notably
note: note,notes,noting
notepaper: notepaper
notice: notice,noticed,notices
notify: notifies
notion: notion
notorious: notorious
nous: nous
nova: nova
november: november
nucleus: nucleus
numerous: numerous
nurse: nurse
nursery: nursery
nurture: nurtured
nut: nut
nutshell: nutshell
oak: oak
oath: oath,oaths
obedience: obedience
obese: obese
obey: obey,obeyed
object: object
objection: objection,objections
obligation: obligations
oblige: obliged,obliging
observant: observant
observation: observation
observe: observe,observed,observing
observer: observer
obsolete: obsolete
obstacle: obstacle
obstinacy: obstinacy
obstinate: obstinate
obtrude: obtruded
obvious: obvious
occasion: occasion
occasional: occasional
occasionally: occasionally
occipital: occipital
occupant: occupant
occupation: occupation,occupations
occupy: occupied,occupy
occur: occur,occurred
occurrence: occurrence,occurrences
octavo: octavo
october: october
odd: odd
odessa: odessa
odour: odour
offence: offence
offended: offended
offensive: offensive
offer: offer,offered,offers
offering: offering
offhand: offhand
office: office,offices
officer: officers
official: official,officials
oil: oil
oily: oily
ominous: ominous
online: online
opal: opal
openly: openly
openness: openness
opera: opera
operatic: operatic
operation: operations
opinion: opinion
opium: opium
opponent: opponent
opportunity: opportunities,opportunity
oppose: opposed,opposing
opposition: opposition
oppress: oppressed
oppressively: oppressively
opulence: opulence
orange: orange
ordinary: ordinary
ordnance: ordnance
organisation: organisation
organize: organized
orgy: orgies
origin: origin
original: original
originality: originality
originator: originator
ornament: ornament,ornaments
orphan: orphan
orphanage: orphanage
oscillate: oscillated,oscillates
oscillation: oscillation
ostensibly: ostensibly
ostler: ostlers
ostrich: ostrich
ounce: ounce
outbreak: outbreak,outbreaks
outburst: outbursts
outcry: outcry
outdated: outdated
outdoor: outdoor
outer: outer
outhouse: outhouse
outline: outline,outlined
outrage: outrages
outset: outset
outskirts: outskirts
outstanding: outstanding
outstretched: outstretched
outward: outward
outweigh: outweigh
overcoat: overcoat
overcome: overcome
overdo: overdid
overhaul: overhauled
overhead: overhead
overhear: overhear,overhearing
overjoy: overjoyed
overlook: overlook
overpowering: overpowering
oversee: overseen
oversight: oversight
overstrung: overstrung
overtake: overtaken,overtook
overtop: overtopped
overwhelm: overwhelmed
owe: owe,owed
owner: owner
oxford: oxford
pace: paced,paces
pacific: pacific
pacing: pacing
pack: pack,packed
packet: packet
padlock: padlocked
pain: pain,pains
pained: pained
painful: painful
painfully: painfully
paint: paint,painted
pair: pair
pal: pal,pals
pale: pale
paleness: paleness
pall: pall
pallet: pallet
pallor: pallor
palm: palm
palmer: palmer
palpitate: palpitating
panel: panel,panelled
panelling: panelling
panoply: panoply
pant: panted
paper: paper,papers
paperwork: paperwork
papier: papier
paradoxical: paradoxical
paragraph: paragraph,paragraphs
parallel: parallel
paramount: paramount
parapet: parapet
parcel: parcel
parched: parched
pardon: pardon
parent: parents
parietal: parietal
paris: paris
parish: parish
park: park
parlance: parlance
parley: parley
parr: parr
parsonage: parsonage
partially: partially
particulars: particulars
partie: partie
partly: partly
partner: partner
party: parties,party
pass: pass,passed,passing
passage: passage,passages
passenger: passenger,passengers
passer: passers
passion: passion,passions
passionate: passionate
passionately: passionately
pasty: pasty
pat: patted,patting
patch: patch,patches
patent: patent
patentee: patentee
paternal: paternal
path: path
pathway: pathway
patience: patience
patient: patient,patients
patron: patron
patter: pattered
paul: paul
pauper: pauper
pause: pause,paused,pausing
pavement: pavement
pawnbroker: pawnbroker
pay: paid,pay,paying,pays
payment: payment,payments
pea: pea
peace: peace
peaceful: peaceful
peaked: peaked
pearl: pearl
peasant: peasant
peculiar: peculiar
peculiarity: peculiarities
peculiarly: peculiarly
pedestrian: pedestrians
peel: peeled,peeling
peep: peep,peeped,peeping
peeped: peeped
peer: peering
peeress: peeress
pen: pen,pens
penal: penal
pence: pence
pencil: pencil,pencils
pend: pending
penetrate: penetrating
pennsylvania: pennsylvania
penny: pennies,penny
pensioner: pensioners
perceive: perceive,perceived
perch: perch,perched
percy: percy
perfect: perfect
perfection: perfection
perfectly: perfectly
perform: perform,performed,performing
performance: performance,performances
performer: performer
peril: perils
periodic: periodic
permanent: permanent
permission: permission
permit: permit,permitted
perpetrate: perpetrated
perpetrator: perpetrators
perpetual: perpetual
perplexed: perplexed
perplexing: perplexing
perplexity: perplexity
persecution: persecution
persevere: persevering
persian: persian
persistence: persistence
persistently: persistently
person: people,person,persons
personal: personal
personality: personality
personally: personally
personate: personate
perspire: perspired
persuade: persuade,persuaded
persuasion: persuasions
perturb: perturbed
pester: pestered,pestering
pet: pet,pets
peter: peter,petered
petrified: petrified
petty: petty
petulance: petulance
pew: pew
pheasant: pheasant
philadelphia: philadelphia
philanthropist: philanthropist
philosophy: philosophy
photograph: photograph
photography: photography
phrase: phrase
physical: physical
pick: pick,picked,picking
picture: picture,pictured,pictures
pie: pie
piece: piece,pieces
pierce: pierce,pierced
pierced: pierced
pigment: pigments
pikestaff: pikestaff
pile: pile,piled,piling
pillow: pillow,pillows
pilot: pilot
pin: pin
pinch: pinch,pinched
pink: pink
pinnacle: pinnacles
pip: pips
pipe: pipe,pipes
piping: piping
pips: pips
piquant: piquant
pirate: pirates
pistol: pistol
piston: piston
pit: pit,pits
pitch: pitch
piteous: piteous
pitiable: pitiable
pitiful: pitiful
pittance: pittance
pity: pity
plaid: plaid
plain: plain,plainer
plainly: plainly
plan: plan,planned,planning,plans
planet: planet
plank: planked,planks
planking: planking
planning: plannings
plant: planted
plantagenet: plantagenet
plantation: plantation
planter: planter
plaster: plaster
plate: plate
platform: platform
platitude: platitudes
plausible: plausible
play: play,played,playing,plays
player: player
plead: pleading
pleasant: pleasant
pleased: pleased
pleasure: pleasure
pledge: pledge,pledged
plentiful: plentiful
plenty: plenty
plot: plot
plough: ploughed
plover: plover
pluck: pluck,plucked
plucking: plucking
plug: plugs
plumber: plumber
plump: plumped
plunge: plunge,plunged,plunging
plush: plush
ply: plied
pocket: pocket,pockets
poetic: poetic
poetry: poetry
poison: poison
poisoner: poisoner
poisoning: poisoning
poker: poker,pokers
poky: poky
police: police
policeman: policeman
policy: policy
political: political
politician: politicians
politics: politics
pomposity: pomposity
pompous: pompous
pon: pon
ponder: pondered
ponderous: ponderous
pooh: pooh
pool: pool
poor: poor,poorer
pope: pope
popular: popular
populous: populous
porch: porch
port: port
porter: porter
portion: portion
portly: portly
pose: poses
position: position,positions
positive: positive
positively: positively
possess: possess,possessed
possession: possession,possessions
possibility: possibility
post: post,posted
posterior: posterior
postmark: postmark,postmarks
postpone: postpone
poultry: poultry
pound: pound,pounds
pour: poured,pouring
power: power,powers
powerful: powerful
practical: practical
practically: practically
practice: practice
prague: prague
prank: prank
pray: pray
preach: preach
precaution: precaution,precautions
precede: preceded,preceding
precious: precious
precise: precise
precisely: precisely
precursor: precursor
prediction: prediction
predominate: predominated,predominates
prefer: prefer,prefers
preference: preference
prejudice: prejudice
preliminary: preliminary
premature: premature
premise: premises
preoccupy: preoccupied
preparation: preparations
prepare: prepare,prepared,preparing
prepared: prepared
preposterous: preposterous
presence: presence
presently: presently
preserve: preserve,preserved,preserves,preserving
preserver: preserver
press: press,pressed,presses,pressing
pressing: pressing
pressure: pressure
presume: presume,presuming
presumption: presumption
pretence: pretence
pretend: pretended,pretends
pretext: pretext
pretty: pretty
prevent: prevent,preventing
previous: previous
prey: prey
price: price,prices
prick: prick
pride: pride
prima: prima
prime: prime
prince: prince
princess: princess
principal: principal
principally: principally
principle: principle,principles
print: print,printed,prints
prior: prior
prison: prison
prisoner: prisoner
privacy: privacy
private: private
prize: prize,prizes
pro: pro
probability: probability
probable: probable
probe: probed,probing
proceed: proceed,proceeded
proceedings: proceedings
process: process,processes
processing: processing
proclaim: proclaimed
prodigiously: prodigiously
produce: produce,produced,producing
product: product
production: production
profession: profession
professional: professional
professionally: professionally
professor: professor
proficient: proficient
profit: profited,profits
profound: profound
profoundly: profoundly
programme: programme
progress: progress
prohibition: prohibition
project: project,projecting
prolong: prolong
prolonged: prolonged
prominence: prominence
prominently: prominently
promise: promise,promised,promises,promising
promote: promoting
promotion: promotion
prompt: prompt,prompted
pronounce: pronounce
proof: proof,proofs
proofread: proofread
propagation: propagation
proper: proper
property: property
proportion: proportion
proposal: proposal
propose: propose,proposed
proposition: proposition
propound: propound
proprietary: proprietary
proprietor: proprietor
propriety: propriety
prosecute: prosecuted
prosecution: prosecution
prospect: prospect,prospecting
prosper: prosper
prosperity: prosperity
prosperous: prosperous
protect: protect,protected
protection: protection
protest: protested,protesting
protestation: protestation
protrude: protruded,protruding
prove: prove,proved,proves,proving
provide: provide,providing
province: province,provinces
provincial: provincial
provision: provision,provisions
provoke: provoked
prussian: prussian
pry: prying
pshaw: pshaw
public: public
publicity: publicity
publicly: publicly
puckered: puckered
puff: puffed,puffing
puffing: puffing
pull: pull,pulled,pulling
pulp: pulp
puncture: punctures
pungent: pungent
punish: punish
punishment: punishment
punitive: punitive
puny: puny
pupil: pupils
purchase: purchase,purchasing
pure: pure,purest
purely: purely
purity: purity
purple: purple
purport: purport
purpose: purpose,purposes
purse: purse,purses
pursue: pursue,pursued
pursuer: pursuers
purveyor: purveyor
push: push,pushed,pushing
putty: putty
puzzle: puzzle,puzzled
puzzled: puzzled
puzzling: puzzling
qualification: qualifications
quality: qualities,quality
quarrel: quarrel,quarrelling,quarrels
quarter: quarter,quarters
quartering: quartering
quaver: quavering
queen: queen
queer: queer
quench: quench
quest: quest
question: question,questioning,questions
questionable: questionable
questioning: questioning
quick: quick,quicker
quiet: quiet
quietly: quietly
quill: quill
quinsy: quinsy
quit: quitted
quiver: quivered,quivering
quote: quote,quotes
rabbi: rabbi
rabbit: rabbit,rabbits
race: race
rack: rack
radiance: radiance
radius: radius
rage: rage
ragged: ragged
rail: railed,rails
railing: railings
railway: railway
rain: rain
raise: raise,raised,raising
rake: rake
rambling: rambling,ramblings
random: random
rank: rank
ransack: ransacked
rapid: rapid
rapidity: rapidity
rapidly: rapidly
rapt: rapt
rare: rare
rascally: rascally
rasher: rashers
rashness: rashness
rat: rat
rate: rate
rattle: rattle,rattled,rattling
rattling: rattling
rave: raved
ray: ray
reabsorb: reabsorbed
reach: reach,reached,reaches,reaching
reaction: reaction
read: read,reading
readable: readable
reader: readers
reading: reading
ready: ready
real: real
realise: realise,realised,realising
realism: realism
realistic: realistic
reap: reaped
rear: reared
rearing: rearing
rearrange: rearranging
reason: reason,reasoned,reasons
reasonable: reasonable
reasoner: reasoner
reasoning: reasoning
recall: recall,recalled
recede: receded
receipt: receipt,receipts
receive: receive,received,receiving
receiver: receiver
reception: reception
recess: recess,recesses
reckless: reckless
reclaim: reclaim
recognise: recognise,recognised,recognising
recoil: recoil,recoiled
recollect: recollect
recommence: recommence
recommend: recommend,recommended
recompense: recompense
reconsider: reconsider,reconsidered
reconstruction: reconstruction
record: record,recorded,records
recourse: recourse
recover: recover,recovered,recovering
rectify: rectify
red: red,redder
redistribute: redistribute,redistributing
redistributing: redistributing
redistribution: redistribution
reduce: reduced
reed: reed,reeds
refer: refer,referred,refers
reference: reference,references
refined: refined
refinement: refinement
refrain: refrain
refresh: refreshed
refreshingly: refreshingly
refund: refund
refusal: refusal
refuse: refuse,refused
regain: regain,regained
regard: regard
regency: regency
regent: regent
region: region
register: register,registered,registers
registry: registry
regret: regret,regretted
regular: regular
regulate: regulating
regulation: regulations
regurgitation: regurgitation
reign: reigning
reject: rejected
rejoice: rejoiced
rejoin: rejoin
relapse: relapsed,relapsing
relate: relate
relation: relation,relations
relative: relative,relatives
relax: relaxed
release: release,released
relentless: relentless
relevant: relevant
reliability: reliability
reliance: reliance
relic: relic,relics
relief: relief
relieve: relieve
relish: relish
rely: rely
remain: remain,remained,remaining,remains
remainder: remainder
remand: remanded
remark: remark,remarked,remarking,remarks
remarkable: remarkable
remarkably: remarkably
remedy: remedied,remedies
remember: remember,remembered
remembrance: remembrance
remonstrance: remonstrance
remorseless: remorseless
remove: remove,removed,removing
remunerative: remunerative
rename: renamed
rend: rending
renew: renew,renewed
rent: rent
reopen: reopened,reopening
repair: repair,repairs
reparation: reparation
repartee: repartee
repay: repaid,repay
repeat: repeat,repeated
repeatedly: repeatedly
repel: repelled
repent: repented
replace: replace,replaced
replacement: replacement
reply: replied,reply
report: report,reported,reporting,reports
reporter: reporter
represent: represent,represented,represents
representation: representations
representative: representative
reproach: reproach
reproachfully: reproachfully
reptile: reptile
republican: republican
repugnant: repugnant
repulsion: repulsion
repulsive: repulsive
reputation: reputation
repute: repute
request: request,requested,requests
require: require,required
requirement: requirement,requirements
rescue: rescue
resemblance: resemblance
resemble: resembling
resentment: resentment
reserve: reserve
reside: resided,residing
residence: residence
resist: resist
resistance: resistance
resistless: resistless
resolute: resolute
resolution: resolution,resolutions
resolve: resolve,resolved
resort: resort
resound: resounded
resource: resource,resources
respect: respect
respectable: respectable
respects: respects
respond: respond,responded
response: responses
responsibility: responsibility
responsible: responsible
rest: rest,rested,resting,rests
restaurant: restaurant
restive: restive
restless: restless
restore: restore,restored
restrain: restrain
restraint: restraint
restriction: restrictions
result: result
retain: retain,retained
retire: retire,retired,retiring
retired: retired
retort: retort,retorted
retreat: retreat
retrogression: retrogression
return: return,returned,returning,returns
reveal: reveal,revealed,revealing
reveller: revellers
revenge: revenge
revenue: revenue
reverie: reverie
reverse: reverse
revolve: revolved
revolver: revolver
reward: reward
rib: ribbed
rich: rich,richer,richest
richness: richness
rickety: rickety
rid: rid
ridiculously: ridiculously
rifle: rifle,rifled
rifled: rifled
rift: rift,rifts
rightly: rightly
rigid: rigid
rise: rise,risen,rising,rose
riser: riser,risers
risk: risk,risks
rival: rival
river: river
riverside: riverside
rivet: riveted
road: road,roads
roadway: roadway
roar: roar,roared
roast: roasting
robber: robber
robbery: robberies,robbery
robert: robert
robinson: robinson
rock: rocked
rocket: rocket
rockies: rockies
rod: rod
rogue: rogue
role: role
roll: roll,rolled
rolling: rolling
romper: romper
roof: roof,roofed,roofs
root: roots
rope: rope,ropes
rose: rose
ross: ross
rotterdam: rotterdam
rough: rough,roughs
roughly: roughly
rounded: rounded
rouse: rouse,roused
routine: routine
row: row
royal: royal
royalty: royalties,royalty
rub: rubbed,rubbing
rubber: rubber
ruby: ruby
ruddy: ruddy
rude: rude
rueful: rueful
ruefully: ruefully
ruffian: ruffian,ruffians
rug: rug
ruin: ruin,ruined
rule: rule,rules
rumble: rumble
rummage: rummaged
rumour: rumour,rumours
rural: rural
ruse: ruse
rush: rush,rushed,rushes,rushing
russell: russell
russian: russian
rustic: rustic
rusty: rusty
ruthless: ruthless
ryder: ryder
sable: sable
sacrifice: sacrifice,sacrificed,sacrificing
sad: sad,saddest
saddle: saddles
sadly: sadly
safe: safe,safer,safes
safeguard: safeguard
safely: safely
safety: safety
sail: sailed
sailing: sailing
sailor: sailor
sake: sake
salary: salary
salesman: salesman
sallow: sallow
sally: sallies,sally
salt: salt
salute: saluted
sample: sample
san: san
sand: sand
sandwich: sandwich,sandwiched
sardonic: sardonic
satin: satin
satisfaction: satisfaction
satisfactory: satisfactory
satisfied: satisfied
satisfy: satisfied,satisfy,satisfying
saturate: saturated
saturday: saturday
saucer: saucer
savage: savage
savagely: savagely
savannah: savannah
save: save,saved,saving
saviour: saviour
saxe: saxe
saxon: saxon
scaffolding: scaffolding
scala: scala
scale: scale,scales
scandal: scandal,scandals
scandinavia: scandinavia
scar: scar
scared: scared
scarlet: scarlet
scatter: scattered
scattered: scattered
scene: scene,scenes
scenery: scenery
scent: scent
sceptic: sceptic
schemer: schemer
scheming: scheming
school: school,schools
schoolmaster: schoolmaster
science: science
scintillate: scintillating
scissors: scissors
score: scored,scores
scorn: scorn
scotch: scotch
scotia: scotia
scotland: scotland
scott: scott
scoundrel: scoundrel
scrape: scraped,scraping
scratch: scratch,scratching
scrawl: scrawl,scrawled
scream: scream,screamed,screaming,screams
screen: screen,screening
scribble: scribble,scribbled
scruple: scruples
scrupulous: scrupulous
scuffle: scuffle
scummed: scummed
sea: sea
seal: seal,sealed
seam: seamed
seaman: seaman
seaport: seaports
sear: seared
search: search,searched,searching
season: season
seasonable: seasonable
seat: seat,seated,seats
secluded: secluded
secrecy: secrecy
secret: secret,secrets
secretary: secretary
secrete: secreted,secreting
secretive: secretive
secretly: secretly
secure: secure,secured,securing
securer: securer
security: security
sedentary: sedentary
seed: seeds
seedy: seedy
seek: seek,seeking,sought
seize: seize,seized
seldom: seldom
select: select
selection: selection,selections
selfish: selfish
selfishness: selfishness
sell: sell,sold
seller: seller
semicircle: semicircle
send: send,sending,sends
sender: senders
senility: senility
senior: senior
sensation: sensation,sensations
sensational: sensational
sensationalism: sensationalism
sense: sense
senseless: senseless
sensitive: sensitive
sentence: sentence
sentimental: sentimental
sentinel: sentinel
separate: separate,separated
separation: separation
september: september
sequel: sequel
sequence: sequence
serenely: serenely
series: series
serpent: serpent
serpentine: serpentine
servant: servant,servants
serve: serve,served,serves,serving
service: service,services
serving: serving
servitude: servitude
set: set
settee: settee
setter: setter
setting: setting
settle: settle,settled,settles,settling
settled: settled
seventeen: seventeen
sever: severed
severe: severe
severely: severely
sew: sewn
sewing: sewing
sex: sex
sha: sha
shabbily: shabbily
shabby: shabby
shade: shade,shading
shades: shades
shadow: shadow,shadows
shag: shag
shake: shake,shaken,shaking,shook
shamefaced: shamefaced
shamefully: shamefully
shape: shape,shaped
shapeless: shapeless
share: share,shared,sharing
sharp: sharp
sharpen: sharpened
sharply: sharply
shatter: shattered
shattered: shattered
shave: shave
shaven: shaven
shaving: shaving
shawl: shawl
sheep: sheep
sheer: sheer
sheet: sheet,sheets
shelf: shelf,shelves
shelter: shelter
shepherd: shepherd
sherlock: sherlock
sherry: sherry
shift: shift
shilling: shilling,shillings
shimmering: shimmering
shine: shining,shone
shiny: shiny
ship: ship,ships
shipping: shipping
shipwreck: shipwreck
shirt: shirt
shiver: shiver,shivering
shock: shock,shocked
shocked: shocked
shoe: shoe,shoes
shoot: shooting,shoots,shot
shooting: shooting
shop: shop,shops
shopping: shopping
short: short,shorter
shortcoming: shortcomings
shortly: shortly
shot: shot,shots
shoulder: shoulder,shoulders
shout: shouted,shouting,shouts
shouting: shouting
shove: shoves,shoving
shriek: shriek,shrieked
shrilly: shrilly
shrimp: shrimp
shrink: shrunk
shrug: shrug,shrugged
shudder: shudder,shuddered
shuffle: shuffled
shut: shut,shutting
shutter: shutter,shuttered,shutters
shy: shy
sick: sick
sickness: sickness
sideboard: sideboard
sided: sided
sidelight: sidelights
sidelong: sidelong
sideways: sideways
sidle: sidled
sigh: sigh,sighing
sight: sight
sign: sign,signed,signs
signal: signal,signalled
signature: signature
signet: signet
silence: silence
silent: silent
silently: silently
silhouette: silhouette
silk: silk
sill: sill
silly: silly
silver: silver,silvered
simon: simon
simple: simple,simpler,simplest
simplicity: simplicity
simplify: simplifies,simplify
simply: simply
sin: sin,sinned,sins
sinewy: sinewy
sing: sings
single: single
singular: singular
singularity: singularity
singularly: singularly
sinister: sinister
sink: sank,sink,sinking,sunk
sinking: sinking
sir: sir
sister: sister
sit: sat,sit,sits,sitting
sitting: sitting
situate: situated
situation: situation
sixteen: sixteen
size: size
sized: sized
sketch: sketch,sketched
skill: skill
skin: skin
skinned: skinned
skirmish: skirmishes
skirt: skirt,skirts
skull: skull
sky: sky
skylight: skylight
slab: slab,slabs
slam: slam,slammed
slang: slang
slap: slapped
slash: slashed
slate: slate
slave: slave
slavey: slavey
sleep: sleep,sleeping,sleeps,slept
sleeper: sleeper,sleepers
sleepily: sleepily
sleepless: sleepless
sleepy: sleepy
sleeve: sleeve,sleeves
sleuth: sleuth
slice: slice
slide: slide,sliding
slight: slight,slighted,slighter
slim: slim
sling: slung
slink: slink
slip: slip,slipped,slipping
slipper: slipper,slippers
slippery: slippery
slit: slit,slits,slitting
slop: slop
slope: slope,slopes,sloping
slovenly: slovenly
slow: slow
slowly: slowly
sluggishly: sluggishly
slum: slums
slumber: slumber
slur: slurred
slurring: slurring
slut: slut
sly: sly
smack: smack
smart: smart,smarter,smartest,smarting
smash: smashed
smasher: smasher
smear: smear,smearing
smell: smell,smelling
smile: smile,smiled,smiles,smiling
smoke: smoke,smoked,smokes,smoking
smokeless: smokeless
smoking: smoking
smooth: smooth,smoothed,smoothing
smoothness: smoothness
smudge: smudge
snake: snake
snakish: snakish
snap: snap,snapped,snapping
snarl: snarl,snarled
snatch: snatched,snatches
sneer: sneer
snigger: snigger
snore: snoring
snow: snow
snuff: snuff
snuffbox: snuffbox
snug: snug
soak: soaked
sob: sob,sobbed,sobbing
sober: sober,sobered
social: social
society: society
sock: socks
socket: socket
soda: soda
sodden: sodden
sofa: sofa
soft: soft,softer
soften: softened
softly: softly
solder: solder
soldier: soldier,soldiers
sole: sole,soles
soled: soled
solely: solely
solemn: solemn
solemnly: solemnly
solicit: solicit
solicitation: solicitation
solicitor: solicitor
solid: solid
solitude: solitude
solution: solution
solve: solve,solved
sombre: sombre
son: son,sons
song: songs
soothe: soothed,soothing
soothing: soothing
soothingly: soothingly
sophy: sophy
sore: sore
sorely: sorely
sorrow: sorrow
sort: sort
sot: sots
sottish: sottish
soul: soul,souls
sound: sound,sounded,sounding,sounds
sour: sour
source: source
south: south
southern: southern
souvenir: souvenir
sovereign: sovereign,sovereigns
space: space
span: span
spare: spare,spared
spark: spark
sparkle: sparkled,sparkles
spatter: spattered
speak: speak,speaking,speaks,spoke,spoken
special: special
specialist: specialist
specimen: specimen
speciously: speciously
speckle: speckles
speckled: speckled
spectacle: spectacle
spectacles: spectacles
spectator: spectators
speech: speech
speed: speed,speeding
speedily: speedily
speedy: speedy
spell: spell
spellbound: spellbound
spence: spence
spend: spend,spent
spin: spinning,spun
spine: spine
spinster: spinster
spirit: spirit,spirits
spite: spite
splash: splash,splashed,splashing
splendid: splendid
splendidly: splendidly
splendour: splendour
spoil: spoiled,spoils
spoiled: spoiled
sponge: sponge,sponged
spongy: spongy
sporadic: sporadic
sport: sport
spot: spot,spots,spotted
spotted: spotted
spout: spouting
spread: spread,spreading
sprig: sprig
spring: sprang,spring,springing,springs,sprung
spy: spies
squalid: squalid
squander: squander
square: square
squat: squat,squatted
squeeze: squeezed
squire: squire
stab: stabbed
stable: stable,stables
staccato: staccato
staff: staff
stage: stage,stages
stagger: stagger,staggered,staggering
stagnant: stagnant
stain: stain,stained,staining,stains
stair: stair,stairs
staircase: staircases
stake: stake
stale: stale
stalk: stalked
stall: stall,stalls
stammer: stammered
stamp: stamp,stamped,stamping
stand: stand,standing,stands,stood
standard: standard
standpoint: standpoint
staple: staples
star: star,stars
stare: stare,stared,stares,staring
stark: stark
stars: stars
start: start,started,starting
startle: startled
startled: startled
startling: startling
starve: starving
stately: stately
statement: statement,statements
station: station
status: status
stay: stay,staying
steadily: steadily
steading: steadings
steady: steady
steal: steal,stole,stolen
stealthily: stealthily
steam: steam,steamed,steaming
steamboat: steamboats
steamer: steamer
steel: steel
steely: steely
steep: steep
step: step,stepped,stepping,steps
stepdaughter: stepdaughter
stepfather: stepfather
stepmother: stepmother
stern: stern,sterner
sternly: sternly
stethoscope: stethoscope
stevedore: stevedore
stick: stick,sticking,sticks,stuck
stiff: stiff
stiffness: stiffness
stile: stile
stillness: stillness
stimulant: stimulant
stir: stirred,stirring
stock: stock,stocked
stoke: stoke
stolen: stolen
stone: stone,stones
stoner: stoner
stool: stool
stoop: stoop,stooped,stooping
stoper: stoper
store: stored
storied: storied
storm: storm
stormy: stormy
story: stories,story
stout: stout
stoutly: stoutly
straggling: straggling
straight: straight
straighten: straighten,straightened
strain: strain,straining
strand: strand
strange: strange,stranger,strangest
stranger: stranger,strangers
straw: straw
stray: strayed
streak: streaked
stream: stream,streamed
streaming: streaming
street: street,streets
strength: strength
strengthen: strengthen
strenuously: strenuously
stress: stress
stretch: stretch,stretched,stretching
stricken: stricken
strict: strict
stride: stride,striding,strode
strike: strike,strikes,striking,struck
striking: striking
strip: strip,stripped
stripes: stripes
strive: striving
stroke: stroke
stroll: stroll,strolled
strong: strong,stronger,strongest
stroud: stroud
struggle: struggle,struggled,struggling
study: studied,studies,study,studying
stuff: stuff,stuffed,stuffs
stumble: stumbled
stump: stump
stupefy: stupefying
stupid: stupid
stupidity: stupidity
sturdy: sturdy
style: style
suavely: suavely
subdue: subdued,subduing
subdued: subdued
subject: subject,subjected
submit: submit,submitted
subscribe: subscribe
subside: subsided
substitution: substitution
subtle: subtle
suburb: suburb
suburban: suburban
succeed: succeed,succeeded
success: success,successes
successful: successful
succession: succession
successive: successive
successor: successors
succinct: succinct
suck: sucked
sudden: sudden
suddenly: suddenly
suffer: suffer,suffered,suffering
sufferer: sufferer
suffice: sufficed
sufficient: sufficient
suggestive: suggestive
suggestiveness: suggestiveness
suicide: suicide
suit: suit,suited,suits
suite: suite
suited: suited
suitor: suitor
sulk: sulking
sullenly: sullenly
sum: sum,sums
summarily: summarily
summarise: summarise
summer: summer
summon: summoned
summons: summons,summonses
sun: sun
sunbeam: sunbeam
sunburnt: sunburnt
sunday: sunday
sundial: sundial,sundials
sunlight: sunlight
sunset: sunset
sunshine: sunshine
superb: superb
superior: superior
superscribe: superscribed
superscription: superscription
supper: supper
supplement: supplementing
supplier: supplier,suppliers
supply: supplied,supply
support: support,supporting
supporter: supporters
suppose: suppose,supposed,supposing
supposition: supposition
suppress: suppressing
surely: surely
surface: surface
surgeon: surgeon
surly: surly
surmise: surmise
surpliced: surpliced
surprise: surprise,surprised
surprised: surprised
surrey: surrey
surround: surrounded,surrounds
surroundings: surroundings
survey: surveyed
survive: survive,survived
survivor: survivor
suspect: suspect,suspected,suspecting
suspend: suspended
suspicion: suspicion,suspicions
suspicious: suspicious
sussex: sussex
swag: swag
swain: swain
swamp: swamp
swan: swan
swarm: swarm
swash: swash
sway: swayed,swaying
swear: swear,swore,sworn
sweat: sweat,sweating
sweating: sweating
sweep: sweep,swept
sweeping: sweeping
sweet: sweet
sweetheart: sweetheart
sweetly: sweetly
sweetness: sweetness
swell: swelled
swift: swift
swiftly: swiftly
swim: swim
swimmer: swimmer
swimming: swimming
swing: swing,swung
swinging: swinging
swish: swish
swollen: swollen
swordsman: swordsman
syllable: syllables
sympathetic: sympathetic
sympathy: sympathy
symptom: symptom,symptoms
synonymous: synonymous
synthesis: synthesis
systematic: systematic
table: table
tack: tack
tackle: tackle
tag: tags
tail: tail,tailed,tailing,tails
tailless: tailless
taketh: taketh
takings: takings
tale: tale,tales
talent: talent
talk: talk,talked,talking
talker: talker
tall: tall,taller
tallish: tallish
tallow: tallow
tally: tallied
tangible: tangible
tangle: tangle,tangled
tangled: tangled
tap: tap,tapped,tapping
task: task
tassel: tassel
taste: taste
tattered: tattered
tattoo: tattoo,tattooed
tawny: tawny
tax: tax,taxes
tea: tea
teach: teach
tear: tear,tearing,tears,tore,torn
technical: technical
teetotaler: teetotaler
telegram: telegram
telegraph: telegraph
telephone: telephone
teller: teller
temper: temper,tempered
temperament: temperament
temperate: temperate
temple: temple,temples
temporary: temporary
tempt: tempted
temptation: temptation
tenable: tenable
tenacious: tenacious
tenant: tenant
tend: tend,tended
tendency: tendencies
tender: tender
tenfold: tenfold
tennessee: tennessee
tense: tense
tension: tension
tent: tents
term: term,terms
terminate: terminated
termination: termination
terrace: terraced
terrible: terrible
terribly: terribly
terrified: terrified
terror: terror
terrorising: terrorising
terse: terse
testament: testament
texas: texas
texture: texture
thames: thames
theft: theft
theological: theological
theoretical: theoretical
theorise: theorise
theory: theories,theory
thickening: thickening
thicket: thicket
thickly: thickly
thickness: thickness
thief: thief,thieves
thinker: thinker
thinking: thinking
thinness: thinness
thither: thither
thoroughfare: thoroughfare
thoughtful: thoughtful
thoughtfully: thoughtfully
thoughtless: thoughtless
thread: thread
threat: threat,threats
threaten: threaten,threatened,threatening,threatens
threshold: threshold,thresholds
thrill: thrill
thrilling: thrilling
throat: throat,throats
throb: throbbed,throbbing
throw: threw,throw,throwing,thrown,throws
throwing: throwing
thrust: thrust,thrusting
thud: thud
thudding: thudding
thumb: thumb
thump: thumped
thursday: thursday
tiara: tiara
tick: ticking
ticket: ticket,tickets
tide: tide
tidy: tidy
tie: tie,tied,tying
tiger: tiger
tight: tight
tightly: tightly
tilt: tilted
timbered: timbered
time: time,times
times: times
timid: timid
tin: tin
tinge: tinge,tinged
tinker: tinker
tint: tint
tinted: tinted
tiny: tiniest,tiny
tiptoe: tiptoes
tire: tire
tired: tired
tissue: tissue
title: title
toast: toast
tobacco: tobacco
tobacconist: tobacconist
toe: toe
token: token
toller: toller
tollers: tollers
tomboy: tomboy
tomfoolery: tomfoolery
ton: tons
tone: tone,tones
tong: tongs
tongue: tongue
tonnage: tonnage
tool: tool,tools
tooth: teeth,tooth
topic: topic
tortured: tortured
toss: tossed,tossing
total: total
totter: tottering
touch: touch,touched,touching
tout: tout
tower: tower
town: town,towns
toy: toy
trace: trace,traced,traces
track: track,tracks
trade: trade
trademark: trademark
tradesman: tradesman,tradesmen
tradespeople: tradespeople
tradition: traditions
traffic: traffic
tragedy: tragedy
tragic: tragic
trail: trail
train: train,trained,trains
training: training
tramp: tramped
trample: trampled
trampled: trampled
transaction: transaction
transcribe: transcribe
transcription: transcription
transfer: transferred
transform: transform,transformed
transformer: transformer
transition: transition
transmit: transmit
transparent: transparent
transpire: transpired
transverse: transverse
trap: trap
travel: travel,travelled,travelling,travels
traveller: traveller,travellers
travelling: travelling
tray: tray
treachery: treachery
tread: tread
treasure: treasure
treat: treat,treated
treatise: treatises
treatment: treatment
treble: treble
tree: tree,trees
tremble: trembling
tremor: tremor
trespasser: trespasser
tress: tresses
trial: trials
triangular: triangular
trick: trick,tricked,tricks
tricky: tricky
trifle: trifle,trifles,trifling
trifling: trifling
trim: trim,trimmed
trimly: trimly
trip: trip
trite: trite
triumph: triumph
triumphant: triumphant
trivial: trivial
troop: trooped
trooper: troopers
trophy: trophy
tropics: tropics
trouble: trouble,troubled,troubles
troubling: troubling
trough: trough
trouser: trouser
trousers: trousers
trout: trout
trove: trove
true: true
trumpet: trumpet
trunk: trunk,trunks
trust: trust,trusted
trustee: trustees
trusty: trusty
truth: truth
tube: tube,tubes
tuck: tucked
tudor: tudor
tuesday: tuesday
tug: tug,tugged,tugging
tumble: tumbled
tumbler: tumbler
tumultuously: tumultuously
tune: tune,tunes
tunnel: tunnel,tunnels
turf: turf
turkish: turkish
turner: turner
tut: tut
tweed: tweed
twentieth: twentieth
twig: twig
twilight: twilight
twin: twins
twinkle: twinkle,twinkled,twinkling
twist: twist,twisted
twisted: twisted
twitch: twitch
twitching: twitching
twitter: twitter
twopence: twopence
type: type,types
typewrite: typewrite,typewriting,typewritten
typewriter: typewriter
typewriting: typewriting
typewritten: typewritten
ugliness: ugliness
ugly: ugly
ulster: ulster,ulsters
ultimate: ultimate
umbrella: umbrella
unable: unable
unacquainted: unacquainted
unapproachable: unapproachable
unavenged: unavenged
unbreakable: unbreakable
unburned: unburned
unbuttoned: unbuttoned
uncarpeted: uncarpeted
uncertain: uncertain
unclasping: unclasping
uncle: uncle
uncomfortable: uncomfortable
uncommon: uncommon
uncompromising: uncompromising
unconcerned: unconcerned
uncongenial: uncongenial
unconscious: unconscious
uncontrollable: uncontrollable
uncourteous: uncourteous
uncouth: uncouth
uncover: uncovered
undated: undated
undergo: undergo
underground: underground
understand: understand,understood
understanding: understanding
undertake: undertake
undertaking: undertaking
undo: undid,undo
undoubtedly: undoubtedly
undue: undue
uneasiness: uneasiness
uneasy: uneasy
unenforceability: unenforceability
unexpected: unexpected
unfailingly: unfailingly
unfeigned: unfeigned
unfenced: unfenced
unfettered: unfettered
unfinished: unfinished
unforeseen: unforeseen
unfortunate: unfortunate
ungenerously: ungenerously
ungovernable: ungovernable
ungrateful: ungrateful
unhappy: unhappy
unhealthy: unhealthy
unheeded: unheeded
uniform: uniform
unimpeachable: unimpeachable
unimportant: unimportant
union: union
unique: unique
united: united
unkempt: unkempt
unknown: unknown
unlink: unlink
unlock: unlocked,unlocking
unmarried: unmarried
unmistakable: unmistakable
unnatural: unnatural
unnecessary: unnecessary
unnoticed: unnoticed
unobservant: unobservant
unobserved: unobserved
unofficial: unofficial
unopened: unopened
unpack: unpack,unpacked
unpapered: unpapered
unpleasant: unpleasant
unpleasantness: unpleasantness
unprecedented: unprecedented
unprofitable: unprofitable
unprotected: unprotected
unravel: unravel,unravelled,unravelling
unreasoning: unreasoning
unrepaired: unrepaired
unseat: unseat
unsolicited: unsolicited
unsolved: unsolved
unsystematic: unsystematic
untame: untamed
unthinkable: unthinkable
untimely: untimely
unusual: unusual
unusually: unusually
unwelcome: unwelcome
unwind: unwound
unwise: unwise
upbraid: upbraided
update: updated
upper: upper
uppermost: uppermost
upraise: upraised
uproar: uproar
upset: upset
upstairs: upstairs
upward: upward
urge: urged,urging
urgency: urgency
urgent: urgent
usage: usage
useless: useless
user: user
usher: ushered,ushering
usual: usual
ut: ut
utilise: utilise
utmost: utmost
utter: utter,uttered,uttering
utterly: utterly
vacancy: vacancies,vacancy
vacant: vacant
vacantly: vacantly
vacuous: vacuous
vagabond: vagabond,vagabonds
vague: vague
vagueness: vagueness
vain: vain
vainly: vainly
valet: valet
valid: valid
valise: valise
valley: valley
valuable: valuable
van: van
vanilla: vanilla
vanish: vanish,vanished,vanishes,vanishing
variable: variable
varied: varied
variety: varieties,variety
vary: varied,vary
vault: vault
vegetable: vegetables
vegetarian: vegetarian
vehemence: vehemence
vehicle: vehicle
veil: veil,veiled
vein: veins
velvet: velvet
vengeance: vengeance
venner: venner
venomous: venomous
ventilate: ventilate
ventilator: ventilator,ventilators
venture: venture,ventured
verb: verbs
verbatim: verbatim
verdict: verdict
verge: verge
verify: verify
version: version
vessel: vessel,vessels
vesta: vestas
vestige: vestige
vestry: vestry
vex: vex
vice: vice
victim: victim
victor: victor
victoria: victoria
victory: victory
view: view,viewed,viewing,views
vigil: vigil
vigorously: vigorously
vii: vii
viii: viii
vile: vile,vilest
villa: villa,villas
village: village,villages
villager: villagers
villain: villain,villains
villainy: villainy
vincent: vincent
violate: violates
violence: violence
violent: violent
violet: violet
violin: violin
virtue: virtue,virtues
virus: virus
visible: visible
visit: visit,visited,visiting,visits
visitor: visitor,visitors
vital: vital
vitriol: vitriol
vivid: vivid
vizard: vizard
voice: voice,voices
void: void
volcanic: volcanic
volley: volley
volume: volume,volumes
volunteer: volunteer,volunteered,volunteers
von: von
voraciously: voraciously
vote: vote
voter: voters
vouch: vouching
vow: vows
vulgar: vulgar
vulnerable: vulnerable
wadding: wadding
waddle: waddling
wager: wager
wages: wages
waggle: waggled
wagon: wagon,wagons
waist: waist
waistcoat: waistcoat
wait: wait,waited,waiting
waiter: waiter
waiting: waiting
wake: wake,woke
walk: walk,walked,walking,walks
walking: walking
wall: wall,walls
wallow: wallowed
wander: wander,wandered,wandering
wane: waned
war: war
wardrobe: wardrobe
warehouse: warehouse
warm: warm,warmed,warmest
warmly: warmly
warmth: warmth
warn: warn,warned
warning: warning,warnings
warranty: warranties,warranty
warren: warren
warsaw: warsaw
wash: wash,washing
waste: waste,wasted
wasteful: wasteful
watch: watch,watched,watching
water: water,watered,waters
waterloo: waterloo
waterproof: waterproof
watson: watson
wave: wave,waved,waves,waving
waver: wavering
wax: wax,waxed
waylaid: waylaid
waylay: waylaid
wayside: wayside
wayward: wayward
weak: weak,weaker
weaken: weaken
weakening: weakening
weakness: weakness,weaknesses
wealth: wealth
wealthy: wealthy
weapon: weapon
wear: wear,wearing,wears,wore,worn
wearer: wearer
weariness: weariness
wearisome: wearisome
weary: weary
weather: weather
weave: weave,woven
weaver: weaver
wedding: wedding
wedge: wedged
wedlock: wedlock
wednesday: wednesday
wee: wee
weed: weed
weedy: weedy
week: week,weeks
weekly: weekly
weigh: weigh,weighed,weighing
weight: weight,weighted
weighted: weighted
weird: weird
wellington: wellington
west: west
westaway: westaway
western: western
westward: westward
wet: wet
wharf: wharf,wharves
whatsoever: whatsoever
wheal: wheal
wheel: wheel,wheeled,wheels
wheeler: wheeler
whereabouts: whereabouts
whimsical: whimsical
whine: whine,whined
whip: whip
whipcord: whipcord
whirl: whirling
whish: whishing
whisker: whiskers
whiskered: whiskered
whisky: whisky
whisper: whisper,whispered,whispering
whistle: whistle,whistled,whistles
white: white,whiter
whiten: whiten
whitewashed: whitewashed
whitney: whitney
whoa: whoa
wholesome: wholesome
whoso: whoso
wicked: wicked
wickedness: wickedness
wicker: wicker
wicket: wicket
wide: wide,widest
widen: widened
widespread: widespread
widow: widow
widower: widower
wife: wife,wives
wig: wig,wigs
wight: wight
wild: wild
wilderness: wilderness
wilful: wilful
wilhelm: wilhelm
william: william
willingly: willingly
willows: willows
wilson: wilson
wilton: wilton
win: win
wince: winced,wincing
winchester: winchester
wind: wind,winding,winds,wound
windfall: windfall
window: window,windows
windowsill: windowsill
wine: wine,wines
wing: wing,wings
wink: wink,winking
winter: winter
wintry: wintry
wire: wire,wired
wiry: wiry
wisdom: wisdom
wise: wiser
wisely: wisely
wisp: wisp
wit: wit,wits
withdraw: withdraw,withdrawn
witness: witness,witnesses
witted: witted
woman: woman,women
womanhood: womanhood
womanly: womanly
wonderful: wonderful
wonderfully: wonderfully
woo: wooing
wood: wood,woods
woodcock: woodcock
wooded: wooded
wooden: wooden
word: word
worker: worker
workman: workmen
worm: worm,worms
worn: worn
worry: worry,worrying
worrying: worrying
worth: worth
worthless: worthless
worthy: worthy
wound: wound
wounded: wounded
wrack: wrack
wrap: wrapped
wreath: wreath,wreaths
wreck: wreck
wrench: wrenching
wretch: wretch
wretched: wretched
wriggle: wriggled
wring: wrung
wrinkle: wrinkled,wrinkles
wrist: wrist,wrists
writ: writ
write: write,writes,writing,written,wrote
writer: writer,writers
writhe: writhed,writhing
writing: writing
writings: writings
wrong: wrong,wronged
wrongfully: wrongfully
xi: xi
xii: xii
yard: yard,yards
yawn: yawn,yawning
yell: yell,yelled
yellow: yellow
yesterday: yesterday
yonder: yonder
youngster: youngster
youth: youth
zealand: zealand
zest: zest
zigzag: zigzag
