aback: aback
abandon: abandon,abandoned,abandoning
abandonment: abandonment
abashed: abashed
abate: abate,abated
abbaye: abbaye
abed: abed
abhorrence: abhorrence
abide: abide,abided,abiding
ability: abilities,ability
abject: abject
ablaze: ablaze
abnegate: abnegating
aboard: aboard
abode: abode
abolish: abolished,abolishing
abolition: abolition
abominable: abominable
abound: abounding
abreast: abreast
abridge: abridge
abrupt: abrupt
abruptly: abruptly
absence: absence
absent: absent
absolute: absolute
absolutely: absolutely
absolve: absolving
absorb: absorbed
absorption: absorption
abstractedly: abstractedly
abstraction: abstraction
absurd: absurd
abundance: abundance
abundant: abundant
abuse: abuse,abused
abyss: abyss
abyssinia: abyssinia
accent: accent,accents
accept: accept,accepted,accepting
acceptable: acceptable
acceptation: acceptation
access: access,accessed
accessible: accessible
accessory: accessories
accident: accident
accidental: accidental
accidentally: accidentally
acclamation: acclamation,acclamations
accommodation: accommodation
accompaniment: accompaniment
accompany: accompanied,accompany,accompanying
accomplice: accomplices
accomplish: accomplished,accomplishing
accomplishment: accomplishments
accord: accord,accorded
accost: accost,accosted
account: account,accounts
accumulate: accumulated,accumulating
accurate: accurate
accurately: accurately
accurse: accursed
accursed: accursed
accusation: accusation
accuse: accused
accused: accused
accustom: accustomed
accustomed: accustomed
ace: ace
achieve: achieve,achieved,achieving
achievement: achievement,achievements
acknowledge: acknowledge,acknowledged
acknowledgment: acknowledgment,acknowledgments
acoustical: acoustical
acquaint: acquainted
acquaintance: acquaintance
acquiesce: acquiesced
acquiescence: acquiescence
acquire: acquired
acquirement: acquirements
acquisition: acquisition
acquit: acquit,acquitted
acquittal: acquittal
acre: acres
action: action,actions
active: active
actively: actively
actor: actor
actual: actual
acute: acute
acuteness: acuteness
adam: adam
add: add
addition: addition,additions
additional: additional
additionally: additionally
address: address,addressed,addresses,addressing
adequately: adequately
adieu: adieu
adjacent: adjacent
adjective: adjective
adjoining: adjoining
adjourn: adjourned
adjuration: adjuration
adjure: adjure,adjured
adjust: adjusted,adjusting
administer: administered
admirable: admirable
admiration: admiration
admire: admire,admired,admiring
admirer: admirers
admission: admission
admit: admit,admitted
admittance: admittance
admonish: admonish
admonitory: admonitory
adorable: adorable
adorn: adorn,adorned
adornment: adornments
adust: adust
advance: advance,advanced,advancing
advanced: advanced
advantage: advantage,advantages
adventurous: adventurous
advice: advice
advisable: advisable
advise: advise,advised
adviser: adviser
advocate: advocate
afar: afar
affably: affably
affair: affair,affairs
affect: affect
affectingly: affectingly
affection: affection,affections
affectionate: affectionate
affectionately: affectionately
affidavit: affidavit
affirmative: affirmative
afflict: afflicted
affliction: affliction
afford: afford,afforded
affrighted: affrighted
afire: afire
afoot: afoot
afore: afore
aforesaid: aforesaid
afraid: afraid
afresh: afresh
afternoon: afternoon
age: age,ages
aged: aged
agency: agency
agent: agent
aggravate: aggravated
aggravation: aggravation
agility: agility
agin: agin
agitated: agitated
agitation: agitation
agonised: agonised
agony: agony
agree: agree,agreed
agreeable: agreeable
agreement: agreement
aha: aha
aid: aid,aids
ail: ailing
aim: aiming,aims
air: air,airs
airily: airily
airy: airy
ajar: ajar
akin: akin
alacrity: alacrity
alarm: alarm,alarmed
alarmed: alarmed
alarming: alarming
alarmingly: alarmingly
alas: alas
albeit: albeit
alcove: alcove
ale: ale
alert: alert
alienated: alienated
alight: alight,alighted,alighting
alike: alike
alive: alive
alley: alley,alleys
allowance: allowance
allusion: allusion,allusions
alluvial: alluvial
ally: allied,ally
aloft: aloft
aloud: aloud
altar: altar
alter: alter,altered
alteration: alteration,alterations
altercation: altercation
altered: altered
alternate: alternate,alternating
altitude: altitude
altogether: altogether
amazed: amazed
amazement: amazement
amazingly: amazingly
ambassador: ambassadors
ambition: ambition
ambuscade: ambuscade
amend: amends
amendment: amendment
america: america
american: americans
amiable: amiable
amiably: amiably
amicably: amicably
amiss: amiss
ammunition: ammunition
ample: ample
amuse: amused
amused: amused
analyse: analyse
anathematise: anathematised
anatomise: anatomise
ancestor: ancestors
ancestral: ancestral
anchor: anchor
anchorage: anchorage
ancient: ancient
anew: anew
angel: angel,angels
angels: angels
anger: anger,angering
angle: angle
angrily: angrily
angry: angry
anguish: anguish
animal: animal,animals
animate: animated
animated: animated
animosity: animosity
aniseed: aniseed
ankle: ankles
anna: anna
annihilate: annihilated
annihilation: annihilation
anniversary: anniversary
anno: anno
announcement: announcement
annoy: annoyed
annoyed: annoyed
anon: anon
answer: answer,answered,answering,answers
antecedent: antecedents
anticipate: anticipate,anticipating
anticipation: anticipation
antipathy: antipathies,antipathy
antiquity: antiquity
anxiety: anxieties,anxiety
anxious: anxious
anxiously: anxiously
apartment: apartment,apartments
aphorism: aphorism
apocryphal: apocryphal
apologetic: apologetic
apology: apology
apostrophe: apostrophe
apostrophise: apostrophise,apostrophising
apparatus: apparatus
apparent: apparent
apparition: apparition,apparitions
appeal: appeal,appealed,appeals
appealing: appealing
appearance: appearance,appearances
appellation: appellation
applaud: applauding
applause: applause
apple: apple,apples
applicable: applicable
application: application
apply: applied,applies,apply
appoint: appointed
appointment: appointment,appointments
appreciative: appreciative
apprehend: apprehend
apprehension: apprehension,apprehensions
apprehensive: apprehensive
apprise: apprised
approach: approach,approached,approaches,approaching
approbation: approbation
approval: approval
approve: approve,approved
approvingly: approvingly
aquiline: aquiline
arabian: arabian
arch: arch,arches
arched: arched
architecture: architecture
archive: archive
ardent: ardent
ardour: ardour
argue: argued
argument: argument
argumentative: argumentative
aristocrat: aristocrat,aristocrats
aristocratic: aristocratic
arm: arm,armed,arms
armed: armed
armorial: armorial
armoury: armoury
army: army
arouse: arouse
arraign: arraigned
arrange: arrange,arranged,arranging
arrangement: arrangement,arrangements
array: array
arrears: arrears
arrest: arrest,arrested
arrival: arrival
arrive: arrive,arrived,arriving
art: art,arts
artful: artful
article: article,articles
articulate: articulate
artificially: artificially
artless: artless
ascend: ascended,ascending
ascent: ascents
ascertain: ascertain,ascertained
ascii: ascii
ash: ashes
ashamed: ashamed
ashantee: ashantee
ashy: ashy
asleep: asleep
aspect: aspect
aspiration: aspirations
aspire: aspired
assailant: assailant
assassin: assassins
assassinate: assassinated
assassination: assassination
assault: assault
assemblage: assemblage,assemblages
assemble: assemble,assembled,assembles
assent: assented
assert: assert,asserted
assertion: assertion
asseveration: asseveration
assiduously: assiduously
assign: assigned
assignation: assignation
assist: assist,assisted,assisting
assistance: assistance
associate: associating
association: association,associations
assorted: assorted
assume: assume,assumed,assuming
assumption: assumption
assurance: assurance,assurances
assure: assure,assured,assures
assuredly: assuredly
astern: astern
astir: astir
astonish: astonished
astonished: astonished
astonishment: astonishment
astounded: astounded
astounding: astounding
astray: astray
asunder: asunder
atheistical: atheistical
athirst: athirst
atmosphere: atmosphere
atmospheric: atmospheric
atomic: atomics
atonement: atonement
atop: atop
atrocious: atrocious
attach: attached
attachment: attachment
attack: attack
attain: attained
attainable: attainable
attainment: attainments
attempt: attempt,attempted,attempts
attend: attend,attended
attendance: attendance
attendant: attendant,attendants
attention: attention
attentive: attentive
attentively: attentively
attenuate: attenuated
attitude: attitude
attorney: attorney
attract: attract,attracted,attracting
attraction: attraction
attractive: attractive
attributable: attributable
attribute: attribute
audible: audible
audibly: audibly
audience: audience
auditory: auditory
augment: augment
august: august
auspicious: auspicious
author: author
authorise: authorised
authoritative: authoritative
authority: authorities,authority
autumn: autumn
avail: avail
avenge: avenge,avenged
avenue: avenue,avenues
aversion: aversion
avert: avert,averted
avocation: avocations
avoid: avoid,avoided,avoiding
avoidance: avoidance
avow: avow
avowal: avowal
await: awaited,awaiting
awake: awake,awoke
awaken: awaken,awakened
awakening: awakening
aware: aware
awe: awe
awful: awful
awfulness: awfulness
awkward: awkward
awry: awry
axe: axe
axis: axes
ay: ay
babble: babble
babel: babel
baby: babies,baby
bacchanalian: bacchanalian
bachelor: bachelor
backgammon: backgammon
background: background
bad: bad,worse,worst
badly: worse
baffle: baffled
bag: bag
bah: bah
bailey: bailey
bailiff: bailiff
baker: baker,bakers
balance: balance,balanced,balances
bald: bald
ball: ball
ballad: ballad
balustrade: balustrades
band: band
bandage: bandages
banish: banished,banishing
bank: bank,banking,banks
banker: banker
bankers: bankers
banking: banking
bankruptcy: bankruptcy
banquet: banquets
bar: bar,barred,bars
barbarian: barbarian
barbarous: barbarous
barber: barber
bare: bare,bared
barefoot: barefoot
barehead: bareheaded
barely: barely
bargain: bargain
barge: barges
bark: bark,barked
barmecide: barmecide
barrel: barrel,barrels
barren: barren
barricade: barricades
barrier: barrier,barriers
barrister: barrister
base: base,based
basement: basement
baseness: baseness
basin: basin
basket: basket,baskets
bastille: bastille
batch: batch
bath: bath,bathed
battered: battered
battle: battles
bawl: bawled,bawling
bay: bay
bayonet: bayonets
beach: beach
beacon: beacon
beam: beaming,beams
beamingly: beamingly
bean: beans
bear: bear,bearing,bears,bore,born,borne
beard: beard
bearded: bearded
bearer: bearer,bearers
bearing: bearing,bearings
beast: beast,beasts
beastly: beastly
beat: beat,beaten,beating,beats
beating: beating
beautiful: beautiful
beautifully: beautifully
beautify: beautified,beautifying
beauty: beauties,beauty
beckon: beckoned,beckoning
becomingly: becomingly
bed: bed,beds
bedlam: bedlam
bedroom: bedroom
bedside: bedside
beer: beer
beery: beery
befall: befall
befitting: befitting
befriend: befriend
beg: beg,begged
beggar: beggars
begirt: begirt
begrime: begrimed
beguile: beguile,beguiled
behalf: behalf
behead: beheaded
beheld: beheld
behold: beheld,behold
beholder: beholder,beholders
behove: behoved
belated: belated
belief: belief
believeth: believeth
bell: bell,bells
belligerent: belligerent
belong: belong,belonged,belonging
beloved: beloved
belt: belt
bench: bench
bend: bending,bent
beneath: beneath
benefactor: benefactor,benefactors
beneficial: beneficial
benefit: benefit
benevolence: benevolence
benevolent: benevolent
benighted: benighted
bent: bent
benumbed: benumbed
bereft: bereft
beseech: beseeching,besought
beset: beset
besetting: besetting
besiege: besieged
besmear: besmeared
besmirched: besmirched
besought: besought
bespatter: bespattered
bestow: bestow,bestowed,bestowing
bestowal: bestowal
bestrew: bestrewn
betake: betook
bethink: bethinking,bethought
betime: betimes
betray: betray
betroth: betrothed
betrothal: betrothal
betwixt: betwixt
beware: beware
bewilder: bewildered,bewildering
bewilderment: bewilderment
bid: bid,bidden
bide: biding
billet: billet,billets
billow: billows
billowy: billowy
binary: binary
bind: bind,bound
bird: bird,birds
birth: birth
birthday: birthday,birthdays
bit: bit
bite: bit,bite,biting
bitter: bitter
bitterly: bitterly
bitterness: bitterness
bl: blest
black: black
blacken: blackened
blackguard: blackguard
blacksmith: blacksmith
blade: blade,blades
blameless: blameless
blank: blank
blare: blaring
blasphemous: blasphemous
blast: blast
blatant: blatant
blaze: blaze,blazed,blazing
bleed: bleeding
bleeding: bleeding
blend: blended
blending: blending
bless: bless,blessed,blest
blessed: blessed
blessing: blessing
blight: blight,blighted
blind: blind,blinded,blinds
blinder: blinder
blindly: blindly
blindness: blindness
blink: blink
bliss: bliss
bloated: bloated
blood: blood
bloodless: bloodless
bloodshed: bloodshed
bloody: bloody
bloom: bloom,blooming
blossom: blossomed
blot: blot,blots,blotting
blotting: blotting
blouse: blouse
blow: blew,blow,blowing,blown,blows
blowing: blowings
blown: blown
blue: blue
bluff: bluff
blunderbuss: blunderbuss,blunderbusses
blunt: blunt
blur: blurred
blush: blush
boar: boar
board: board,boards
boast: boast
boastful: boastful
boastfully: boastfully
boastfulness: boastfulness
boasting: boasting
boat: boat
bode: boded
bodied: bodied
bodily: bodily
body: bodies,body
bodyguard: bodyguard
boil: boiled,boiling
bold: bold,boldest
boldface: boldface
boldly: boldly
bolt: bolt
bond: bond,bonds
bone: bones
bonfire: bonfires
bonnet: bonnet
bony: bony
book: book,booked,books
boom: boom
boot: boot,booted,boots
booting: booting
bootless: bootless
bordeaux: bordeaux
border: borders
bore: bore
borrow: borrow,borrowed
bosom: bosom
boss: boss
botheration: botheration
bottle: bottle,bottles
boundary: boundaries
boundless: boundless
bow: bow,bowed,bowing
bowl: bowl
box: box,boxes
boy: boy,boys
braced: braced
brain: brain,brains
branch: branch,branched,branches
brand: branded
branding: branding
brandy: brandy
brave: brave
bravely: bravely
bravery: bravery
bravo: bravo
brawling: brawling
brawny: brawny
brazen: brazen
breach: breach
bread: bread
breadless: breadless
breadth: breadth
break: break,breaking,broke,broken
breakfast: breakfast
breaking: breaking
breast: breast,breasts
breasted: breasted
breath: breath
breathe: breathe,breathed,breathing
breathing: breathing
breathless: breathless
breeches: breeches
breed: bred,breed
breeding: breeding
brethren: brethren
brevity: brevity
brewery: brewery
brick: brick,bricks
bride: bride
bridegroom: bridegroom
bridesmaid: bridesmaid
bridge: bridge
bridle: bridle,bridles
brigand: brigand
bright: bright,brighter
brighten: brightened
brightly: brightly
brightness: brightness
brilliant: brilliant
brilliantly: brilliantly
brim: brim
bring: bring,bringing,brings,brought
brink: brink
brisk: brisk
briskly: briskly
bristle: bristled
britain: britain
british: british
briton: briton
broach: broaching
broad: broad,broader
broadcast: broadcast
brocade: brocade
broken: broken
bronze: bronze
brood: brood,brooded,brooding
brooding: brooding
brother: brother,brothers
brotherhood: brotherhood
brothers: brothers
brow: brow,brows
brown: brown
bruise: bruised
brush: brushed
brutality: brutality
brute: brute
brutus: brutus
buckle: buckles
buffet: buffeted
build: building,built
building: building,buildings
bulk: bulk
bulky: bulky
bull: bull
bullet: bullets
bully: bully,bullying
bullying: bullying
bump: bump,bumped
bumper: bumper,bumpers
bunch: bunch,bunches
bundle: bundle
burden: burden,burdens
burglary: burglaries
burial: burial
burn: burn,burned,burning,burnt
burning: burning
burst: burst,bursting
bury: buried,burying
bushel: bushels
busily: busily
business: business
bust: bust
bustle: bustled
busy: busy
butcher: butcher
butchered: butchered
butcherly: butcherly
butchery: butchery
butt: butt
butter: butter
buzz: buzz,buzzed,buzzing
bye: bye
byway: byway,byways
cabin: cabin
cabinet: cabinet
cachet: cachet
cadaverous: cadaverous
cadence: cadence
cage: cage,cages
calais: calais
calamity: calamity
calculate: calculate,calculated
calculation: calculations
caldron: caldron
calendar: calendar
calling: calling,callings
calm: calm,calmed
calmly: calmly
calmness: calmness
cambridge: cambridge
canada: canada
candle: candle,candles
cane: cane
cannibal: cannibal
cannon: cannon
cannonier: cannonier
canonise: canonised
canter: canter
canvas: canvas
cap: cap,caps
capable: capable
capacity: capacity
capital: capital
capitulate: capitulated
capricious: capricious
capriciously: capriciously
captain: captain
captive: captive
captivity: captivity
capture: captured
car: car
card: card,cards
cards: cards
care: care,cared,cares,caring
career: career
careful: careful
carefully: carefully
careless: careless
carelessly: carelessly
carelessness: carelessness
caress: caresses,caressing
caressingly: caressingly
caricaturing: caricaturing
carmagnole: carmagnole
carnage: carnage
carol: carol
carouse: carousing
carpenter: carpenters
carpet: carpet
carriage: carriage,carriages
carrion: carrion
carry: carried,carries,carry,carrying
cart: cart,carts
carton: carton
cartridge: cartridges
carve: carved
carver: carver
casement: casement,casements
cashier: cashiers
cask: cask
cast: cast,casting
caste: caste
casual: casual
casually: casually
cat: cat
cataleptic: cataleptic
catch: catch,catching,caught
catechist: catechist
cathedral: cathedral
cattle: cattle
caution: caution,cautioned
cautionary: cautionary
cautious: cautious
cautiously: cautiously
cavalcade: cavalcade
cavalier: cavalier
cavalry: cavalry
cavernous: cavernous
cease: cease,ceased
ceiling: ceiling
celebration: celebration
celestial: celestial
cell: cell,cells
cellar: cellars
central: central
centre: centre,centres
century: centuries
ceremony: ceremonies,ceremony
certainty: certainty
certificate: certificate
cessation: cessation
cesspool: cesspools
chafe: chafed
chaff: chaff
chain: chain,chained,chains
chair: chair,chairs
chaise: chaise
chaldean: chaldean
chalk: chalk
challenge: challenged
chamber: chamber,chambers
chambers: chambers
champ: champing
chance: chance,chanced,chances,chancing
change: change,changed,changing
changeless: changeless
changing: changing
channel: channel
chapter: chapter
char: charred
character: character,characters
characterise: characterise,characterised
characteristic: characteristic,characteristics
charcoal: charcoal
charge: charge,charged,charges,charging
charger: charger
chariot: chariot
charitable: charitable
charity: charities,charity
charles: charles
charm: charm
charmed: charmed
charming: charming
charmingly: charmingly
chary: chary
chase: chase,chased
chaste: chaste
chat: chatting
chateau: chateau
chatter: chattered
cheap: cheapest
cheat: cheated,cheating
check: check,checked,checking,checks
cheek: cheek,cheeks
cheekbone: cheekbones
cheer: cheer,cheered,cheering
cheerful: cheerful
cheerfully: cheerfully
cheerfulness: cheerfulness
cheery: cheery
cheese: cheese
chemist: chemist
chemists: chemists
cheque: cheque
cherish: cherish,cherished,cherishing
chest: chest
chestnut: chestnuts
chew: chewing
chicken: chickens
chief: chief
child: child,children
childhood: childhood
chill: chill
chilled: chilled
chimney: chimney,chimneys
chin: chin
chink: chink,chinked,chinks
chip: chips
chisel: chisel,chiselled
chivalrous: chivalrous
chocolate: chocolate
choice: choice
choke: choke,choking
choose: choose,chosen
chop: chopped
chopper: chopper
chord: chord
chorus: chorus
chouse: choused
christian: christian
christmas: christmas
chronically: chronically
chronicle: chronicle
chubby: chubby
chum: chum
church: church,churches
churchyard: churchyard
cinderella: cinderella
cinderous: cinderous
circle: circle,circled,circling
circuit: circuit
circuitously: circuitously
circulate: circulated
circumference: circumference
circumstance: circumstance,circumstances
circumstantial: circumstantial
citizen: citizen,citizens
citizeness: citizeness
city: cities,city
civil: civil
claim: claim,claimed,claims
clammy: clammy
clamorous: clamorous
clang: clanged,clanging
clap: clapped
clapping: clapping
claptrap: claptrap
claret: claret
clash: clash,clashed,clashing
clasp: clasp,clasping,clasps
clasped: clasped
class: class,classes
clatter: clatter,clattered,clattering
clattering: clattering
clay: clay
clean: clean,cleaner
cleaning: cleaning
clearance: clearance
clearness: clearness
clemency: clemency
clench: clenched
clenched: clenched
clergy: clergy
clerk: clerk,clerks
client: client,clients
cliff: cliffs
climate: climate
climb: climbed,climbing
cling: clinging,clung
clink: clink
cloak: cloak,cloaks
clock: clock,clocks
close: close,closed,closer,closing
closed: closed
closely: closely
closeness: closeness
closet: closet
closing: closing
cloth: cloth
clothe: clothed
clothes: clothes
clothing: clothing
cloud: cloud,clouded,clouds
clouded: clouded
cloudy: cloudy
clumsily: clumsily
clumsy: clumsy
clung: clung
cluster: cluster,clustered
clutch: clutched,clutching
cly: cly
coach: coach,coaches
coachman: coachman
coal: coal,coals
coarse: coarse,coarsest
coast: coast
coat: coat,coats
coax: coaxed
cock: cock,cocking
cockade: cockade,cockades
cocked: cocked
code: code,codes
codger: codgers
coercion: coercion
coffee: coffee
coffin: coffin
cogitate: cogitated
cogitation: cogitation
cognac: cognac
coherently: coherently
coin: coin,coins
coinage: coinage
coincidence: coincidence,coincidences
coiner: coiner
cold: cold
coldly: coldly
collar: collar
collect: collect,collected,collecting
collectedly: collectedly
collection: collection
college: college
colonnade: colonnade
colour: colour,colours
comb: combed
combination: combination
combine: combined
comedy: comedy
comely: comely
comer: comer,comers
comfort: comfort,comforted,comforting
comfortable: comfortable
comforting: comforting
comically: comically
coming: coming
command: command,commanded,commands
commence: commence,commenced,commences
commencement: commencement
commend: commended
commendation: commendations
comment: comment,commenting
commercial: commercial
commiserate: commiserated
commiseration: commiseration
commission: commission,commissioned
commit: committed,committing
committee: committee,committees
common: common,commons
commonly: commonly
commune: communing
communicate: communicate,communicated
communication: communication,communications
compact: compact
companion: companion,companions
companionship: companionship
company: companies,company
comparatively: comparatively
compare: compared,comparing
comparison: comparison
compass: compass
compassion: compassion
compassionate: compassionate
compatriot: compatriot
compeer: compeers
compel: compelled
compelling: compelling
compensate: compensate
competitor: competitors
compilation: compilation
complacency: complacency
complacent: complacent
complacently: complacently
complain: complain,complaining
complaint: complaint,complaints
complete: complete,completed,completing
completely: completely
completeness: completeness
completion: completion
complexion: complexion,complexions
compliance: compliance
complicated: complicated
compliment: compliment,complimented,compliments
complimentary: complimentary
comply: complied,comply,complying
comportable: comportable
compose: compose,composed,composing
composedly: composedly
composition: composition
composure: composure
compound: compound
comprehend: comprehend,comprehended
compress: compressed
compressed: compressed
compression: compression,compressions
compromise: compromise,compromised,compromising
compunction: compunction
comrade: comrade,comrades
conceal: conceal,concealed
concealment: concealment
concede: conceded
conceit: conceited
conceivable: conceivable
conceive: conceive,conceived
concentrate: concentrated
concentrated: concentrated
concentration: concentration
concept: concept
conception: conception,conceptions
concert: concert
concession: concession
conclude: concluded,concluding
conclusion: conclusion
concoct: concocting
concord: concord
concourse: concourse
concussion: concussion
condemn: condemned,condemning
condemnation: condemnation
condemned: condemned
condescension: condescension
condition: condition,conditions
conditioned: conditioned
condole: condole,condoling
conduce: conduced
conducive: conducive
conduct: conduct,conducted,conducting
conducting: conducting
conductor: conductor,conductors
confer: confer,conferred,conferring
conference: conference,conferences
confess: confess
confide: confide,confided,confiding
confidence: confidence,confidences
confident: confident
confidential: confidential
confidentially: confidentially
confidingly: confidingly
confine: confined
confinement: confinement
confines: confines
confirm: confirm,confirmed,confirms
confirmable: confirmable
confirmation: confirmation
confiscate: confiscated
confiscation: confiscation
conflagration: conflagration
conflict: conflict
confound: confound
confront: confronted,confronting
confuse: confuse
confused: confused
confusedly: confusedly
confusion: confusion
congenial: congenial
congratulate: congratulate,congratulated,congratulating
congratulation: congratulations
congratulatory: congratulatory
congress: congress
conjunction: conjunction
conjuration: conjuration
connect: connected
connection: connection,connections
conquer: conquered
conscience: conscience
conscious: conscious
consciousness: consciousness
consecrate: consecrated
consent: consent
consequence: consequence,consequences
consequent: consequent
consequential: consequential
considerable: considerable
considerate: considerate
consideration: consideration,considerations
consign: consigned
consignment: consignment
consist: consisted
consistently: consistently
consolation: consolation
consolatory: consolatory
console: console
consolidation: consolidation
conspicuous: conspicuous
conspirator: conspirator
constancy: constancy
constant: constant
constantly: constantly
consternation: consternation
constitute: constituted
constrain: constraining
constraint: constraint
construction: construction
consultation: consultation
consulting: consulting
consume: consumed
consumption: consumption
contact: contact
contagion: contagion
contagious: contagious
contamination: contamination
contemplate: contemplating
contemplation: contemplation
contemporary: contemporaries
contempt: contempt
contemptuous: contemptuous
contemptuously: contemptuously
contend: contend,contended,contending
content: content
contention: contention
contentious: contentious
contents: contents
contest: contest
continually: continually
continue: continued,continuing
continuity: continuity
continuous: continuous
continuously: continuously
contraband: contraband
contract: contract,contracted
contradict: contradicted,contradicting
contradiction: contradiction
contradictory: contradictory
contrary: contrary
contrast: contrast,contrasted,contrasting
contribution: contributions
contrivance: contrivances
contrived: contrived
control: control
convenience: convenience
convenient: convenient
convent: convent
conventionally: conventionally
conversant: conversant
conversation: conversation,conversations
converse: converse,conversing
conversion: conversion
convert: convert
convey: convey,conveyed,conveying
conveyance: conveyance
conviction: conviction
convivial: convivial
convulsively: convulsively
cook: cook,cooked,cooks
cool: cool,coolest
coolly: coolly
cope: cope
coppice: coppice
copying: copying
copyright: copyright
coquetry: coquetry
coquette: coquette
cord: cords
cordial: cordial
corkscrew: corkscrew
corn: corn
corner: corner,corners
cornered: cornered
corporation: corporation
correct: correct,corrected,correcting
correction: correction
correctly: correctly
correctness: correctness
correspondence: correspondence
correspondingly: correspondingly
corridor: corridor,corridors
corroborate: corroborate
corroboration: corroborations
corrupt: corrupt,corrupted
corruption: corruption
cost: cost,costs
cottage: cottage,cottages
couch: couch
cough: cough,coughed,coughing
council: council
counsel: counsel
counsellor: counsellor
count: count,counted,counting
countenance: countenance,countenances
counter: counter,counters
counterfeit: counterfeit
countermine: countermined
counterpane: counterpane
counterpart: counterpart
countersign: countersigned
counterweight: counterweight
counting: counting
countless: countless
country: countries,country
countryman: countryman,countrymen
county: county
couple: couple,coupled
courage: courage
courageous: courageous
courier: courier
court: court,courts
courtesy: courtesies
courtly: courtly
courtyard: courtyard,courtyards
cousin: cousin
cover: cover,covered
covered: covered
covering: covering
coverlet: coverlet
cow: cow,cowed,cows
cowardice: cowardice
crack: cracked,cracking
cradle: cradle
craft: craft
craftily: craftily
crag: crag
cramped: cramped
crane: crane,craned
crash: crash,crashing
cravat: cravat
craven: craven
craving: craving
crawl: crawl,crawled,crawling
crazed: crazed
crazy: crazy
crease: creasing
create: created,creating
creation: creation
creator: creator
creature: creature,creatures
credentials: credentials
credit: credit
creditor: creditors
creep: creep,creeping,creeps,crept
crestfallen: crestfallen
crevice: crevice
crew: crew
crime: crime,crimes
criminal: criminal,criminals
crimson: crimson,crimsoned
cringing: cringing
cripple: cripples
crippling: crippling
crisis: crisis
crisp: crisp
crisply: crisply
critical: critical
croak: croak,croaked,croaking
crockery: crockery
crone: crones
crooked: crooked
crookedly: crookedly
crop: cropped,crops
cross: cross,crossed,crosses,crossing
crouch: crouching
crouching: crouching
crow: crow
crowbar: crowbar
crowd: crowd,crowded,crowds
crowded: crowded
crown: crown,crowns
crowning: crowning
cruel: cruel,cruelest
cruelly: cruelly
cruelty: cruelty
crumb: crumbs
crumble: crumble,crumbled,crumbling
crumple: crumpled
cruncher: cruncher
crunches: crunches
crush: crush,crushed
crystal: crystal
crystallisation: crystallisation
cud: cud
cuff: cuffs
culinary: culinary
culminate: culminated,culminating
culpability: culpability
cultivate: cultivated
cunning: cunning
cunningly: cunningly
cup: cup,cups
cupboard: cupboard,cupboards
cupid: cupid,cupids
curator: curator
cure: cure
curiosity: curiosity
curious: curious
curiously: curiously
curl: curling,curls
current: current
curse: curse,curses
cursed: cursed
curtain: curtain,curtained,curtains
curtained: curtained
curtly: curtly
curtsey: curtseyed,curtseys
curved: curved
cushion: cushion,cushions
custodian: custodian
custody: custody
custom: custom,customs
customary: customary
customer: customer,customers
cut: cut,cutting
cutlass: cutlass
cutler: cutler
cutter: cutter
cylinder: cylinder
dab: dab
dagger: dagger,daggers
daily: daily
dainty: dainty
dam: dammed
damage: damage
damaged: damaged
damages: damages
dame: dame
damned: damned
damp: damp
dance: dance,danced,dancing
dancing: dancing
danger: danger,dangers
dangerous: dangerous
dangling: dangling
dank: dank
daring: daring
dark: dark,darker,darkest
darken: darkened,darkening
darkly: darkly
darkness: darkness
darling: darling,darlings
dart: darted,darting
dash: dashed
datum: data
daughter: daughter,daughters
david: david
dawn: dawn,dawning
day: day,days
daybreak: daybreak
daylight: daylight
daze: dazed
dead: dead
deaden: deaden
deadly: deadly
deaf: deaf
deafen: deafened
deafening: deafening
deal: deal,deals,dealt
dearest: dearest
dearly: dearly
death: death
debate: debated,debating
debating: debating
debauch: debauched
debauchery: debauchery
debt: debt
debtor: debtors
decay: decayed
decayed: decayed
decease: decease
deceased: deceased
deceit: deceit
deceive: deceive,deceived
december: december
decent: decent
decently: decently
deception: deception
decide: decide,decided
decidedly: decidedly
decipher: decipher
decision: decision
deck: deck
declaim: declaiming
declare: declare,declared,declaring
decline: declined,declining
decompose: decomposing
decomposition: decomposition
decorate: decorated
decoration: decoration
decree: decree,decreed,decrees
deduce: deduce,deducing
deduct: deducting
deductible: deductible
deed: deed,deeds
deem: deem,deemed
deep: deep,deeper
deepen: deepened,deepening
deeply: deeply
deer: deer
deface: defaced
defeat: defeat,defeats
defect: defect,defects
defective: defective
defence: defence
defenceless: defenceless
defend: defend,defended
defendant: defendant
deference: deference
deferentially: deferentially
defiance: defiance
deficient: deficient
define: defined
definite: definite
deftly: deftly
defy: defy
degenerate: degenerate
degradation: degradation
degraded: degraded
degrading: degrading
degree: degree,degrees
deign: deigning
dejected: dejected
dejectedly: dejectedly
delay: delay,delayed
deletion: deletions
deliberate: deliberate,deliberating
deliberately: deliberately
delicacy: delicacy
delicate: delicate
delicately: delicately
delight: delight
delighted: delighted
delightful: delightful
deliver: deliver,delivered
deliverance: deliverance
deluge: deluge
delusion: delusion
delve: delve
demand: demand,demanded,demanding,demands
demean: demean
demeanour: demeanour
dement: demented
demon: demons
demonstration: demonstration,demonstrations
demonstrative: demonstrative
demur: demur
den: den,dens
denial: denial
denote: denote,denoted
denounce: denounce,denounced,denouncing
denouncer: denouncer
dense: dense
denunciation: denunciation
deny: denied,deny,denying
depart: depart,departed,departing
departure: departure
depend: depend,depended,depends
deplorable: deplorable
deplore: deplore
deportment: deportment
deposit: deposited
depositor: depositors
depository: depository
deprecate: deprecated
deprecatory: deprecatory
depressed: depressed
deprivation: deprivation
depth: depth
depths: depths
deride: deriding
derivative: derivative
derive: derive,derived
dervish: dervishes
descend: descend,descended,descending,descends
descendant: descendants
descent: descent
description: description
descry: descried
desert: desert,deserted
deserted: deserted
desertion: desertion
deserve: deserve,deserved,deserves
design: design,designed
designation: designation
designedly: designedly
desirable: desirable
desire: desire,desired
desirous: desirous
desk: desk
desolate: desolate
desolately: desolately
desolation: desolation
despair: despair
despatch: despatch,despatched
despatched: despatched
desperate: desperate
desperation: desperation
despise: despise
despoil: despoil,despoiled
despond: despond
despondency: despondency
despondent: despondent
destination: destination,destinations
destine: destined
destiny: destiny
destitute: destitute
destroy: destroy,destroyed
destruction: destruction
destructive: destructive
detach: detach,detached
detachment: detachment
detain: detain,detained
detect: detect,detected,detecting
detention: detention
determination: determination
determine: determine,determined
determined: determined
detest: detested
detestation: detestation
detriment: detriment
develop: developed
device: device,devices
devil: devil,devils
devilish: devilish
devilishly: devilishly
devilry: devilry
devils: devils
devise: devise
devonshire: devonshire
devote: devote,devoted
devoted: devoted
devotedly: devotedly
devotee: devotees
devotion: devotion
devour: devouring
devouring: devouring
devoutly: devoutly
dexterously: dexterously
diabolic: diabolic
dialect: dialect
dialogue: dialogue
diamond: diamond,diamonds
dice: dice
dickens: dickens
dictate: dictate,dictated,dictating
dictionary: dictionary
didst: didst
die: die,died,dies,dying
difference: difference
difficult: difficult
difficulty: difficulties,difficulty
diffidence: diffidence
dig: dig,digging,dug
digestive: digestive
digger: digger
dignity: dignity
dilate: dilated
dim: dim,dimmed,dimmer
dimension: dimensions
diminish: diminished,diminishing
dimly: dimly
dine: dine,dined,dining
dingiest: dingiest
dingy: dingier,dingy
dining: dining
dinner: dinner,dinners
dint: dints
dip: dipped
diplomacy: diplomacy
dire: dire
direct: direct,directed,directing
direction: direction,directions
directress: directress
dirt: dirt
dirty: dirtied,dirtier,dirty
disadvantage: disadvantage
disagreeable: disagreeable
disappear: disappear,disappeared
disappearance: disappearance
disappoint: disappointed
disappointed: disappointed
disappointing: disappointing
disappointment: disappointment
disapproving: disapproving
disarm: disarmed
discard: discarded
discern: discern
discernible: discernible
discharge: discharge,discharged,discharging
disciple: disciple,disciples
disclaim: disclaim
disclaimer: disclaimer,disclaimers
disclose: disclose,disclosed
disclosure: disclosure
discolour: discoloured
discomfited: discomfited
discomfort: discomfort
discompose: discomposed
disconcert: disconcerted
disconcerted: disconcerted
disconcerting: disconcerting
discontent: discontent
discontinue: discontinue
discourse: discourse,discoursing
discover: discover,discovered,discovering
discovery: discovery
discreditable: discreditable
discreet: discreet
discretion: discretion
discuss: discuss,discussed,discussing
discussion: discussion
disdainful: disdainful
disease: disease,diseases
disengage: disengaging
disfigure: disfiguring
disfigured: disfigured
disfigurement: disfigurement
disfiguring: disfiguring
disgrace: disgrace
disguise: disguise,disguised,disguises
dishonour: dishonour
disinclined: disinclined
disinherit: disinherit,disinherited
disinterestedly: disinterestedly
disjointed: disjointed
disk: disk
dislike: dislike,disliked
dismal: dismal
dismiss: dismiss,dismissed
dismissal: dismissal
dismount: dismount,dismounted
disobey: disobey
disorder: disorder,disorders
disordered: disordered
disorderly: disorderly
disorganised: disorganised
disparage: disparaging
disparagement: disparagement
dispense: dispense
dispersal: dispersal
disperse: dispersed,dispersing
displace: displace,displaced
displacement: displacements
display: display,displayed,displaying
displeased: displeased
displeasure: displeasure
dispose: disposed,disposing
disposed: disposed
disposition: disposition
disproportionate: disproportionate
disquiet: disquiet,disquieted
disreputable: disreputable
disrespectful: disrespectful
disrespectfully: disrespectfully
dissatisfaction: dissatisfaction
dissatisfied: dissatisfied
dissimulation: dissimulation
dissipate: dissipated
dissociate: dissociated
dissolute: dissolute
dissolve: dissolved
dissonance: dissonance
distance: distance
distant: distant
distasteful: distasteful
distinct: distinct
distinction: distinction,distinctions
distinctly: distinctly
distinctness: distinctness
distinguish: distinguish
distinguished: distinguished
distortedly: distortedly
distract: distracted,distracting
distracted: distracted
distracting: distracting
distraction: distractions
distress: distress
distressed: distressed
distressful: distressful
distressing: distressing
distribute: distribute,distributed,distributing
distribution: distribution
distributor: distributor
distrust: distrust,distrusted
distrustfully: distrustfully
disturb: disturb,disturbed,disturbing
disturbance: disturbance
disturbed: disturbed
disuse: disuse
disused: disused
ditch: ditch,ditches
diver: divers
diverge: diverging
diversify: diversified
diversion: diversion
diversity: diversity
divert: diverted
divide: divide,divided,dividing
divine: divine,divined
divinity: divinities
division: division
docile: docile
dock: dock
dockyard: dockyard
doctor: doctor,doctors
doctrine: doctrine,doctrines
document: document,documents
doer: doers
doff: doffed
dog: dog,dogs
dogged: dogged
doggedly: doggedly
doleful: doleful
doll: doll,dolls
dolorous: dolorous
dolt: dolt
domain: domain
domestic: domestic,domestics
domesticate: domesticated
domicile: domicile
dominant: dominant
dominate: dominated
domination: domination
domini: domini
dominion: dominion,dominions
domino: dominoes
dominoes: dominoes
donate: donate
donation: donation,donations
donor: donors
doom: doom,doomed
door: door,doors
doorpost: doorpost
doorway: doorway,doorways
dormant: dormant
dormer: dormer
dose: dose
double: double
doubly: doubly
doubt: doubt,doubted,doubting,doubts
doubtfully: doubtfully
doubtless: doubtless
dover: dover
download: downloading
downstairs: downstairs
downward: downward
doze: doze,dozing
dozen: dozen,dozens
draft: drafts
drag: drag,dragged,drags
dragon: dragon
dragoon: dragoon
drain: drained
drainage: drainage
drapery: drapery
draught: draught
draw: draw,drawing,drawn,drew
drawback: drawback
drawbridge: drawbridge,drawbridges
drawer: drawer,drawers
drawing: drawing
drawl: drawl
dread: dread,dreaded
dreaded: dreaded
dreadful: dreadful
dreadfully: dreadfully
dream: dream,dreaming,dreams
dreamlike: dreamlike
drearily: drearily
dreary: dreary
dregs: dregs
dress: dress,dressed,dresses,dressing
dressed: dressed
drift: drifted
drill: drill
drily: drily
drink: drank,drink,drinking
drinker: drinkers
drinking: drinking
drip: dripping
dripping: dripping
drive: drive,driven,drives,driving,drove
driver: driver
driving: driving
droll: droll
droop: drooped,drooping
drooping: drooping
drop: drop,dropped,dropping,drops
dropsical: dropsical
drown: drown,drowned,drowning
drudge: drudge
drum: drum,drums
drummer: drummer
drunk: drunk
drunken: drunken
drunkenness: drunkenness
dry: drier,dry,drying
dubious: dubious
dubiously: dubiously
duck: ducked
dull: dull
duly: duly
dumb: dumb
dumpling: dumpling
dungeon: dungeon
duration: duration
dusk: dusk
dusky: dusky
dust: dust
dusty: dusty
dutiful: dutiful
duty: duties,duty
dwarf: dwarf
dwell: dwell,dwelling,dwelt
dwelling: dwelling
dye: dye,dyed
dyed: dyed
dyeing: dyeing
eager: eager
eagerly: eagerly
eagerness: eagerness
eagle: eagles
ear: ear,ears
earn: earned,earning
earnest: earnest
earnestly: earnestly
earnestness: earnestness
earring: earrings
earth: earth
earthenware: earthenware
earthly: earthly
earthquake: earthquake
ease: ease,eased
easily: easily
east: east
easterly: easterly
eastward: eastward
easy: easier,easiest,easy
eat: ate,eat,eaten,eating
eavesdropper: eavesdropper
ebb: ebb,ebbing
eccentric: eccentric
eccentricity: eccentricities,eccentricity
ecclesiastic: ecclesiastic,ecclesiastics
echo: echo,echoed,echoes,echoing
echoes: echoes
echoless: echoless
ecod: ecod
economy: economy
eddy: eddy,eddying
eden: eden
edge: edge
edifice: edifice
edifying: edifying
edition: edition,editions
editor: editor
educational: educational
efficacy: efficacy
effort: effort,efforts
egress: egress
eighteen: eighteen
eighth: eighth
eightieth: eightieth
ejaculate: ejaculated
eke: eke
elastic: elastic
elate: elate
elbow: elbow,elbows
eld: elder
elder: elder
elderly: elderly
elect: elect
electronic: electronic
electronically: electronically
elegance: elegance
elegant: elegant
elegantly: elegantly
elephant: elephants
elevate: elevate,elevated
elevation: elevation
elicit: elicit,elicited
eligible: eligible
elongate: elongate
eloquent: eloquent
emaciated: emaciated
email: email
embankment: embankments
embarrass: embarrassing
embarrassed: embarrassed
embarrassment: embarrassment,embarrassments
embellish: embellished
embellishment: embellishment
ember: embers
emblem: emblem
embrace: embrace,embraced,embraces,embracing
embrasure: embrasure
embroider: embroidered
embroidering: embroidering
embroidery: embroidery
emerge: emerged,emerging
emergence: emergence
emergency: emergency
emigrant: emigrant,emigrants
emigrants: emigrants
eminence: eminence
eminent: eminent
emissary: emissaries,emissary
emotion: emotion,emotions
emotional: emotional
emphasis: emphasis
emphatic: emphatic
emphatically: emphatically
employ: employ,employed,employing
employee: employee,employees
employer: employers
employment: employment,employments
emulative: emulative
enable: enable,enables,enabling
encamp: encamped
encampment: encampment
enchanted: enchanted
enchanter: enchanter
enchantment: enchantment
encircle: encircled
enclose: encloses
encode: encoding
encompass: encompass,encompassed
encounter: encountered,encounters
encourage: encouraged
encouraged: encouraged
encouragement: encouragement
encouraging: encouraging
encumber: encumbered
endanger: endanger,endangered
endeavour: endeavour,endeavouring
endowment: endowments
endue: endued
endurance: endurance
endure: endure,endured,enduring
enemy: enemies,enemy
energetic: energetic
energy: energy
enfold: enfolded,enfolding
enforce: enforced,enforcing
engage: engaged
engaged: engaged
engagement: engagement
engaging: engaging
engender: engendered
engine: engine
england: england
english: english
englishman: englishman
englishwoman: englishwoman
engrain: engrained
engrossing: engrossing
enjoy: enjoy,enjoying
enjoyable: enjoyable
enjoyment: enjoyment
enlarge: enlarged
enrage: enraged
enrich: enriching
enshroud: enshrouded
ensure: ensured,ensuring
entangle: entangling
enter: enter,entered,entering
entertain: entertain,entertained
entertainment: entertainment,entertainments
enthrone: enthroned
enthusiastically: enthusiastically
entity: entity
entrance: entrance
entreat: entreat,entreated,entreating,entreats
entreaty: entreaties,entreaty
entrust: entrusted
entry: entries,entry
enumerate: enumerated
environ: environed,environing
envy: envy
epicure: epicure
episcopal: episcopal
epoch: epoch
equably: equably
equal: equal
equality: equality
equally: equally
equidistant: equidistant
equip: equipped
equipage: equipages
equipment: equipment
era: era
erase: erase
ernest: ernest
err: erring
errand: errand
error: errors
erst: erst
escape: escape,escaping
escort: escort,escorted
escutcheon: escutcheon
especial: especial
essence: essence
essential: essential
establish: established
establishment: establishment
estate: estate,estates
esteem: esteem
esteemed: esteemed
estimate: estimate
estranged: estranged
estrangement: estrangement
eternal: eternal
eternally: eternally
eternity: eternity
european: european
evade: evaded
evanescence: evanescence
evasively: evasively
evening: evening
event: event,events
eventide: eventide
everlasting: everlasting
evidence: evidence
evident: evident
evidently: evidently
evil: evil,evils
evince: evincing
evoke: evoke
exact: exact,exacted
exaggerate: exaggerated
exaggeration: exaggeration
exalt: exalted
exaltation: exaltation
examination: examination
examine: examine,examined,examining
exasperation: exasperation
exceed: exceeding
exceedingly: exceedingly
excellent: excellent
exception: exception,exceptions
exceptional: exceptional
exchange: exchange,exchanged
excite: excited
excited: excited
excitement: excitement
exclaim: exclaim,exclaimed
exclamation: exclamation
exclude: exclude,excluded
exclusion: exclusion
exclusive: exclusive
excursion: excursion
excuse: excuse,excused,excusing
execration: execrations
execute: execute,executed
execution: execution
executioner: executioner
exemplary: exemplary
exempt: exempt
exercise: exercise,exercised,exercises
exertion: exertion,exertions
exhaust: exhausted
exhausted: exhausted
exhaustion: exhaustion
exile: exile
exist: exist,existed,exists
existence: existence
exordium: exordium
expect: expect,expected
expectantly: expectantly
expectation: expectation,expectations
expeditiously: expeditiously
expend: expend
expense: expense,expenses
experience: experience,experiences
experiment: experiments
expert: expert
expiation: expiation
explain: explain,explained,explaining
explanation: explanation
explanatory: explanatory
explicit: explicit
explore: exploring
explosive: explosive
exponent: exponent
export: exporting
expose: exposed
expostulation: expostulation
expound: expounded
express: express,expressed,expressing
expression: expression,expressions
expressive: expressive
expressly: expressly
exquisite: exquisite
extemporise: extemporised
extend: extend,extended,extending
extended: extended
extensive: extensive
extent: extent
exterior: exterior
exterminate: exterminate,exterminated,exterminating
extermination: extermination
external: external
extinguish: extinguished
extinguisher: extinguisher
extortion: extortion
extra: extra
extract: extract,extracted,extracting
extraction: extraction
extraordinary: extraordinary
extravagant: extravagant
extravagantly: extravagantly
extreme: extreme,extremes
extremely: extremely
exude: exuding
exultant: exultant
exultation: exultation
eye: eye,eyeing,eyes
eyebrow: eyebrows
eyed: eyed
eyelid: eyelids
fabled: fabled
fabric: fabric
fabulous: fabulous
faced: faced
facilitate: facilitate
facility: facilities,facility
faculty: faculties,faculty
fade: faded
fag: fagged
fagot: fagots
fail: fail,failed,failing
failure: failure
fain: fain
faint: faint,fainter,fainting,faints
faintly: faintly
faintness: faintness
fair: fair
fairy: fairy
faith: faith
faithful: faithful
faithfully: faithfully
fall: fall,fallen,falling,falls,fell
false: false
falsely: falsely
falter: falter,faltered,faltering
familiar: familiar,familiars
family: families,family
famine: famine
famished: famished
famous: famous
fan: fan,fanned
fanciful: fanciful
fancy: fancied,fancies,fancy
fantastic: fantastic
fare: fare,fared,faring
farewell: farewell
farm: farms
farmer: farmer
farrier: farrier
farthing: farthing
fascinated: fascinated
fascinating: fascinating
fascination: fascination
fashion: fashion
fashioned: fashioned
fast: fast,faster,fastest,fasting
fasten: fastened,fastening
fastening: fastening
fat: fat
fatal: fatal
fatally: fatally
fate: fate
father: father,fathers
fatigue: fatigue
fatigued: fatigued
fault: fault,faults
favour: favour,favoured,favours
favourable: favourable
favoured: favoured
favourite: favourite
fawn: fawning
fear: fear,feared,fears
fearful: fearful
fearfully: fearfully
fearless: fearless
feasting: feasting
feather: feather,feathers
feathered: feathered
feathery: feathery
feature: feature,features
federal: federal
fee: fee,fees
feeble: feeble,feebler
feebly: feebly
feed: fed,feed
feel: feel,feeling,feels
feeling: feeling,feelings
feelingly: feelingly
feign: feigned
feint: feint
felicitously: felicitously
felicity: felicity
fell: fell
fellow: fellow,fellows
fellowship: fellowship
felon: felons
female: female
feminine: feminine
fence: fences
ferocious: ferocious
ferocity: ferocity
ferret: ferret,ferreted
fervent: fervent
fervently: fervently
fervour: fervour
festival: festival
fetch: fetch,fetched
fetter: fetters
feudal: feudal
fever: fever
feverish: feverish
fickleness: fickleness
fictitious: fictitious
fidelity: fidelity
fidget: fidget
field: field,fields
fields: fields
fiend: fiend
fierce: fierce,fiercer
fiercely: fiercely
fight: fight,fighting,fought
figure: figure,figures
filament: filaments
file: file,files
filing: filing
filter: filtered
filthy: filthy
final: final
finally: finally
finances: finances
financial: financial
fine: fine,finest
fineness: fineness
finesse: finesse
finger: finger,fingers
finish: finish,finished
finishing: finishing
firewood: firewood
firing: firing
firm: firm
firmly: firmly
firmness: firmness
firstly: firstly
fish: fish,fished,fishes,fishing
fisherman: fisherman,fishermen
fishing: fishing
fist: fist
fit: fit,fits,fitted
fitful: fitful
fitfully: fitfully
fitness: fitness
fitting: fitting
fixed: fixed
fixedly: fixedly
flag: flag
flambeau: flambeau
flambeaux: flambeaux
flame: flame,flamed,flames
flaming: flaming
flank: flanks
flap: flapped,flapping,flaps
flapped: flapped
flare: flare,flaring
flash: flash,flashed,flashes,flashing
flat: flat,flatter
flatten: flattened
flatter: flattered
flattered: flattered
flattering: flattering
flavour: flavour
flaxen: flaxen
flay: flay
flee: fled
fleet: fleet
flicker: flickered,flickering
flight: flight,flights
flinch: flinched
fling: flinging,flung
flint: flint,flints
flinty: flinty
flirt: flirting
float: floated
floating: floating
flock: flock,flocked
flood: flood
floor: floor,floors
flop: flop
flopping: flopping
florid: florid
flounder: floundering
flourish: flourish,flourished,flourishes,flourishing
flow: flow,flowed,flowing
flower: flower,flowers
flung: flung
flush: flush,flushed,flushing
flutter: flutter,fluttered,fluttering
fly: flew,flies,flown,fly,flying
foal: foaled
foam: foam
foe: foe
fog: fogs
foist: foisted
fold: fold,folded,folding
folk: folks
follow: follow
follower: follower,followers
folly: follies
fondly: fondly
food: food
fool: fool,fools
foolish: foolish
foolishness: foolishness
foot: feet,foot
footed: footed
footing: footing
footpace: footpace
footpath: footpath
footsore: footsore
footstep: footstep,footsteps
footsteps: footsteps
footstool: footstool
footway: footways
forage: forage
forasmuch: forasmuch
foray: forays
forbearance: forbearance
forbid: forbade,forbid,forbidden
forborne: forborne
force: force,forced,forces,forcing
forcible: forcible
forcibly: forcibly
fore: fore
foreboding: forebodings
forefather: forefathers
forefinger: forefinger
forehead: forehead,foreheads
foreign: foreign
foreigner: foreigner,foreigners
foreman: foreman
foremost: foremost
forenoon: forenoon
forensic: forensic
forensically: forensically
foresee: foresaw,foresee,foreseen
foreshadow: foreshadowed
forest: forest
forester: forester
forfeit: forfeit,forfeits
forge: forge,forged
forger: forger,forgers
forgery: forgeries,forgery
forget: forget,forgetting,forgot,forgotten
forgetful: forgetful
forgetfulness: forgetfulness
forgive: forgive,forgiven
forgiveness: forgiveness
fork: fork
forlorn: forlorn
forlorner: forlorner
forlornness: forlornness
form: form,formed,forming,forms
formal: formal
formally: formally
format: format,formats
fortify: fortified
fortitude: fortitude
fortnight: fortnight
fortnightly: fortnightly
fortress: fortress
fortunate: fortunate
fortunately: fortunately
fortune: fortune,fortunes
forwards: forwards
foul: foul
foundation: foundation,foundations
fountain: fountain,fountains
fourscore: fourscore
fourteenth: fourteenth
fourth: fourth,fourths
fowl: fowl
fragment: fragment,fragments
frame: frame
framework: framework
france: france
frantic: frantic
fraternal: fraternal
fraternity: fraternity
fraud: fraud
fraught: fraught
fray: frayed
freedom: freedom
freely: freely
french: french
frenchman: frenchman
frenchmen: frenchmen
frenzied: frenzied
frenzy: frenzy
frequent: frequent
frequently: frequently
fresh: fresh,fresher
freshness: freshness
fret: fretted
friday: friday
friend: friend,friends
friendliness: friendliness
friendly: friendliest,friendly
friendship: friendship
fright: fright
frighten: frightened
frightened: frightened
frightening: frightening
frightful: frightful
frightfully: frightfully
frill: frill
fringed: fringed
frivolity: frivolity
frizzle: frizzled
frizzling: frizzling
fro: fro
frock: frock
frog: frog,frogs
frolicsome: frolicsome
frontier: frontier
frost: frost
frosty: frosty
froth: frothed
frown: frown,frowned,frowning
frozen: frozen
frugal: frugal
fruit: fruit,fruits
fruitful: fruitful
fruitless: fruitless
frustrate: frustrate
fry: fried,frying
fuel: fuel
fulfilment: fulfilment
fulness: fulness
fumble: fumbled
function: function,functions
functionary: functionaries,functionary
funeral: funeral,funerals
funereal: funereal
fur: fur
furies: furies
furious: furious
furiously: furiously
furnace: furnace,furnaces
furnish: furnished
furniture: furniture
furrow: furrow
furtherance: furtherance
furtive: furtive
furtively: furtively
fury: furies,fury
fuse: fused
future: future
gabelle: gabelle
gag: gag
gaily: gaily
gain: gain,gained,gaining
gainsay: gainsay
gaiter: gaiters
gallant: gallant
gallantly: gallantly
gallantry: gallantries,gallantry
gallery: galleries
galley: galley
galling: galling
gallon: gallon
gallop: gallop,galloped
gallows: gallows
game: game,games
games: games
gamut: gamut
gander: gander
gaol: gaol,gaols
gaoler: gaoler,gaolers
garb: garb
garden: garden,gardens
gardens: gardens
garment: garment
garnering: garnering
garnish: garnished
garret: garret
garrison: garrison
gate: gate,gates
gateway: gateway
gather: gathered,gathering
gathering: gathering
gaul: gaul
gaunt: gaunt
gauze: gauze
gay: gay,gayest
gaze: gaze,gazing
gazette: gazette
gender: gender
generality: generality
generals: generals
generation: generation,generations
generosity: generosity
generous: generous
genial: genial
genius: genius
genteel: genteel
gentility: gentility
gentle: gentle,gentlest
gentleman: gentleman,gentlemen
gentleness: gentleness
gently: gently
genuine: genuine
george: george
germain: germain
german: german
gesticulation: gesticulation
gesture: gesture,gestures
ghastliness: ghastliness
ghastly: ghastly
ghost: ghost,ghosts
ghostly: ghostly
giant: giant,giants
giddily: giddily
gift: gifts
gigantically: gigantically
giles: giles
gin: gin
gird: girded
girdle: girdle
girl: girl,girls
girlhood: girlhood
girlish: girlish
glad: glad
gladden: gladden
gladness: gladness
glance: glance,glanced,glances,glancing
glare: glare,glaring
glaring: glaring
glass: glass,glasses
glassful: glassful
gleam: gleam,gleamed,gleaming,gleams
glean: gleaned
glib: glib
glide: glided,gliding
glimmer: glimmering
glimpse: glimpses
glint: glinted
glitter: glittering
gloom: gloom
gloomily: gloomily
gloomy: gloomy
glorious: glorious
glory: glory
gloss: gloss
glove: glove
glow: glow,glowing
gloweringly: gloweringly
glutinous: glutinous
gnashing: gnashing
gnat: gnats
gnaw: gnawed,gnawing
goal: goals
goblet: goblet
goblin: goblin
god: god
goddess: goddess
godmother: godmother
goer: goers
gold: gold
golden: golden
goodly: goodly
goodness: goodness
goodwill: goodwill
goose: goose
gore: gore
gorge: gorged
gorgeous: gorgeous
gorgon: gorgon
gory: gory
gossamer: gossamer
gossip: gossip,gossiping
govern: govern,governed
government: government
governor: governor
gown: gown
grace: grace,graced,graces
graceful: graceful
gracious: gracious
graciously: graciously
gradation: gradations
gradual: gradual
gradually: gradually
grain: grain,grains
grand: grand
grandchild: grandchildren
grandeur: grandeur
grandfather: grandfather
grant: grant,granted
grape: grape
grasp: grasp,grasped,grasping
grass: grass,grasses
grate: grate,grated,grates,grating
grateful: grateful
gratefully: gratefully
gratified: gratified
gratify: gratified
gratitude: gratitude
grave: grave,graves
gravel: gravel
gravely: gravely
gravestone: gravestones
gravity: gravity
greatly: greatly
greece: greece
greedily: greedily
greedy: greedy
greek: greek
green: green
greeting: greeting
gregarious: gregarious
grenadier: grenadier
grey: grey
gridiron: gridiron
grief: grief
grieve: grieve
grieving: grieving
grim: grim,grimmer
grimace: grimaces
grimly: grimly
grimness: grimness
grimy: grimy
grin: grin,grinning
grind: grind,grinding,grinds,ground
grindstone: grindstone
grip: grip,gripping
grisly: grisly
grist: grist
grizzled: grizzled
groan: groan,groaned,groaning
grocer: grocer
grocery: grocery
grope: groped
gross: gross
grossly: grossly
ground: ground
grounds: grounds
grove: grove
grovel: grovelling
grow: grew,grow,growed,growing,grown
growl: growled,growling
growlingly: growlingly
grudge: grudge
grudging: grudging
grudgingly: grudgingly
gruff: gruff
grumble: grumbled,grumbling
grunt: grunt
guard: guard,guarded
guardhouse: guardhouse
guards: guards
guess: guess,guesses
guest: guest
guidance: guidance
guide: guide,guided,guiding
guillotine: guillotine,guillotined
guilt: guilt
guilty: guilty
guinea: guinea,guineas
gulf: gulf
gun: gun,guns
gunmaker: gunmaker
gunpowder: gunpowder
gust: gusts
gutter: guttering
ha: ha
habit: habit,habits
habitation: habitation,habitations
habitual: habitual
habitually: habitually
hack: hacked
hackney: hackney
haggard: haggard
hah: hah
hail: hail,hailed,hailing
hair: hair,hairs
haired: haired
hairy: hairy
hall: hall,halls
hallo: hallo
halloa: halloa
hallowed: hallowed
halo: halo
halt: halting
hammer: hammer,hammering,hammers
hand: hand,handed,hands
handful: handful
handkerchief: handkerchief,handkerchiefs
handle: handle
handmaid: handmaid
handsome: handsome,handsomest
handsomely: handsomely
handwriting: handwriting
handy: handy
hang: hang,hanged,hanging,hung
hangdog: hangdog
hanging: hangings
hangman: hangman
happen: happen,happened,happening
happily: happily
happiness: happiness
happy: happier,happiest,happy
harass: harass
harbour: harbour,harboured
hard: hard,hardest
harden: hardened
hardihood: hardihood
hardship: hardship
hare: hare,hares
hark: hark
harlequin: harlequin
harm: harm,harming,harms
harmless: harmless
harness: harness,harnessed
harp: harping
harsh: harsh
harshly: harshly
hart: hart
harvest: harvest
hast: hast
haste: haste
hasten: hastened
hastily: hastily
hasty: hasty
hat: hat,hats
hatband: hatband
hatchet: hatchets
hate: hate,hated
hateful: hateful
hatred: hatred
haughtily: haughtily
haughty: haughty
haul: hauled,hauling
haunch: haunches
haunt: haunt,haunted
haunted: haunted
haunting: haunting
hawthorn: hawthorn
hay: hay
hazard: hazard,hazarded
head: head,headed,heading,heads
headache: headache
headed: headed
headgear: headgear
headless: headless
headlong: headlong
healer: healer
healing: healing
health: health,healths
healthy: healthy
heap: heap,heaps
hear: hear,heard,hearing
hearer: hearers
hearing: hearing
hearse: hearse
heart: heart,hearts
hearted: hearted
hearth: hearth,hearths
heartily: heartily
heartless: heartless
heat: heat,heated
heated: heated
heathen: heathen
heave: heave,heaved
heaven: heaven,heavens
heavens: heavens
heavily: heavily
heaving: heaving
heavy: heavier,heavy
hebrew: hebrew
hedge: hedge
heed: heed
heedful: heedful
heedless: heedless
heel: heels
heigh: heigh
height: height
heighten: heightened
held: held
helpful: helpful
helpless: helpless
hem: hem,hemmed
henceforth: henceforth
herald: heralded
herb: herbs
herd: herd
heresy: heresy
heretofore: heretofore
heroism: heroism
hesitate: hesitated,hesitating
hesitation: hesitation
hew: hew,hewed
hey: hey
hidden: hidden
hide: hidden,hide,hiding
hideous: hideous
hiding: hiding
highly: highly
highway: highway,highways
highwayman: highwayman,highwaymen
hilary: hilary
hill: hill
hilt: hilt
hind: hinds
hinge: hinges
hint: hint,hinted
hip: hips
hire: hire,hired,hiring
hiss: hissing
history: history
hit: hit,hitting
hitherto: hitherto
ho: ho
hoarse: hoarse
hoarsely: hoarsely
hoarser: hoarser
hoarsest: hoarsest
hob: hob
hoist: hoisted
hoisting: hoisting
hold: held,hold,holding,holds
holden: holden
holder: holder
hole: hole,holes
hollow: hollow,hollows
hollowness: hollowness
holster: holsters
holy: holiest,holy
homage: homage
homely: homeliest
honest: honest
honester: honester
honour: honour,honoured,honouring
honourable: honourable
honoured: honoured
hoof: hoofs
hook: hook
hoop: hoops
hooray: hooray
hop: hopping
hope: hope,hoped,hopes,hoping
hopeful: hopeful
hopefulness: hopefulness
hopeless: hopeless
horizon: horizon
horizontal: horizontal
horn: horn
horrible: horrible
horribly: horribly
horrified: horrified
horror: horror,horrors
horse: horse,horses
horseback: horseback
horsehair: horsehair
horseman: horseman,horsemen
hospital: hospital
host: host
hostile: hostile
hot: hot
hotel: hotel
hour: hour,hours
house: house,houses
housebreaker: housebreaker
household: household
housekeep: housekeeping
housekeeping: housekeeping
houses: houses
housetop: housetop
hovel: hovel
hover: hovering
howl: howling
howsoever: howsoever
hue: hue
huge: huge
hum: hum,hummed
human: human
humane: humane
humanising: humanising
humanity: humanity
humble: humble
humbly: humbly
humiliation: humiliation
humility: humility
humour: humour
humoured: humoured
humph: humph
hunger: hunger,hungered
hungry: hungry
hunt: hunted,hunting
hunter: hunters
hurdle: hurdle
hurricane: hurricane
hurried: hurried
hurriedly: hurriedly
hurry: hurried,hurries,hurry,hurrying
hurt: hurt
husband: husband,husbands
hush: hush,hushed,hushing
husky: husky
hustle: hustled
hut: hut,huts
hutch: hutches
ice: ice
idea: idea,ideas
identical: identical
identification: identification
identify: identified,identify
idiomatic: idiomatic
idiot: idiots
idiotic: idiotic
idle: idle,idling
idleness: idleness
idlest: idlest
idly: idly
ignobly: ignobly
ignorance: ignorance
ignorant: ignorant
iii: iii
illness: illness
illuminate: illuminated,illuminating
illusion: illusion
illustration: illustration,illustrations
illustrious: illustrious
image: image
imaginary: imaginary
imagination: imagination
imagine: imagine,imagined,imagining
imagining: imaginings
imbecile: imbecile
imbue: imbued
imitate: imitated
imitation: imitation,imitations
immaculate: immaculate
immature: immature
immeasurably: immeasurably
immemorial: immemorial
immense: immense
immersion: immersion
immolate: immolate
immolation: immolations
immortal: immortal
immovable: immovable
immunity: immunities
impair: impaired
impart: impart,imparted,imparts
impartially: impartially
impassable: impassable
impassive: impassive
impatience: impatience
impatient: impatient
impatiently: impatiently
impeach: impeach,impeaching
impeachment: impeachment
impediment: impediments
impel: impelled,impelling
impend: impended
impending: impending
impenitently: impenitently
imperative: imperative
imperfect: imperfect
imperfectly: imperfectly
imperil: imperil
imperious: imperious
impertinence: impertinence
imperturbable: imperturbable
impetuous: impetuous
implacable: implacable
implacably: implacably
implement: implements
implicitly: implicitly
implore: implore,implored,imploring
imploringly: imploringly
imply: implied,imply
importunity: importunity
impose: imposed,imposes,imposing
imposition: impositions
impossibility: impossibility
impossible: impossible
impost: imposts
impostor: impostors
impoverished: impoverished
impracticable: impracticable
impress: impress,impressed,impressing
impressed: impressed
impressible: impressible
impression: impression
impressive: impressive
impressively: impressively
imprint: imprinted
imprison: imprisoned
imprisonment: imprisonment
improbable: improbable
improve: improved,improving
improvement: improvement,improvements
impulse: impulse,impulses
impure: impure
impurity: impurities
imputation: imputation
inaccurate: inaccurate
inanimate: inanimate
inappropriate: inappropriate
inarticulately: inarticulately
inaudible: inaudible
inaugurate: inaugurated
incapable: incapable
incessant: incessant
incessantly: incessantly
inch: inch
incident: incident,incidents
incidental: incidental
inclement: inclement
inclination: inclination
inclined: inclined
include: include,included,includes,including
including: including
incoherence: incoherences
income: income
incommode: incommode
incommodious: incommodious
incommodiousness: incommodiousness
incomplete: incomplete
incompleteness: incompleteness
incomprehensible: incomprehensible
inconsistency: inconsistencies,inconsistency
inconsistent: inconsistent
inconvenience: inconvenience,inconveniences
inconvenient: inconvenient
incorrigible: incorrigible
increase: increase,increasing
incredulity: incredulity
incumbent: incumbent
incumbrance: incumbrance
incur: incur
indebt: indebted
indecision: indecision
indefinitely: indefinitely
indemnify: indemnify
indemnity: indemnity
independent: independent
indescribable: indescribable
indication: indication
indictment: indictment
indifference: indifference
indifferent: indifferent
indifferently: indifferently
indignant: indignant
indignantly: indignantly
indignation: indignation
indignity: indignity
indirect: indirect
indirectly: indirectly
indispensable: indispensable
indistinct: indistinct
individual: individual
individuality: individuality
individually: individually
indivisible: indivisible
indoor: indoor
induce: induce,induced
inducement: inducement
industrious: industrious
industry: industry
inevitable: inevitable
inevitably: inevitably
inexorable: inexorable
inexperienced: inexperienced
infallible: infallible
infallibly: infallibly
infamous: infamous
infamy: infamy
infancy: infancy
infant: infants
infect: infected
infection: infection
infer: infer,inferred
inference: inference
infernal: infernal
infinite: infinite
infinitely: infinitely
infirmity: infirmity
inflate: inflating
inflict: inflict,inflicted,inflicting
influence: influence
influential: influential
inform: inform,informed,informing
informant: informant
informer: informer
infraction: infraction
infringement: infringement
infuse: infused
ingenious: ingenious
ingenuity: ingenuity
ingress: ingress
inhabit: inhabited
inhabitant: inhabitants
inherit: inherited
inheritance: inheritance
inheritor: inheritor
inhuman: inhuman
initial: initial,initials
injunction: injunction,injunctions
injure: injured,injuring
injured: injured
injurious: injurious
injury: injuries,injury
ink: ink
inmate: inmate,inmates
inn: inn,inns
innately: innately
innermost: innermost
innocent: innocent
inoffensive: inoffensive
inquire: inquire,inquired,inquiring
inquiringly: inquiringly
inquiry: inquiries,inquiry
inquisitive: inquisitive
inquisitively: inquisitively
insatiate: insatiate
inscribe: inscribed
inscription: inscription,inscriptions
inscrutability: inscrutability
inscrutable: inscrutable,inscrutables
insensate: insensate
insensible: insensible
inseparable: inseparable
insinuation: insinuation
insist: insisted
insolent: insolent
insomuch: insomuch
inspect: inspected,inspecting
inspection: inspection
inspiration: inspiration
inspire: inspire,inspired,inspiring
inspiring: inspiring
install: installed
instalment: instalment
instance: instance
instant: instant
instantly: instantly
instinct: instinct
instinctive: instinctive
instinctively: instinctively
institution: institution
instruct: instructed,instructs
instruction: instruction,instructions
instrument: instrument,instruments
insufferable: insufferable
insufficient: insufficient
insult: insults
insulter: insulters
insupportable: insupportable
intangible: intangible
integrity: integrity
intellectual: intellectual
intelligence: intelligence,intelligences
intelligent: intelligent
intelligible: intelligible
intelligibly: intelligibly
intend: intend,intended,intending
intense: intense
intensely: intensely
intensify: intensified
intensity: intensity
intent: intent
intention: intention,intentions
intently: intently
interchange: interchange,interchanged
interfere: interfere,interfering
interior: interior
intermediate: intermediate
interment: interment
intermission: intermission
internal: internal
internally: internally
international: international
interpose: interpose,interposed
interpret: interpreted
interpreter: interpreter
interrogate: interrogate
interrupt: interrupt,interrupted,interrupting
interrupted: interrupted
interruption: interruption
intersect: intersect
interval: interval,intervals
intervene: intervening
interview: interview,interviews
intimacy: intimacy
intimate: intimate
intolerable: intolerable
intoxicated: intoxicated
intoxication: intoxication
intricate: intricate
intrigue: intrigue
introduce: introduce
introduction: introduction
inundation: inundation
invalidity: invalidity
invariably: invariably
inversion: inversion
invest: invested
inveteracy: inveteracy
inveterate: inveterate
invigorate: invigorated
inviolate: inviolate
invisible: invisible
invite: invite,invited
involuntary: involuntary
involve: involve,involved,involving
involved: involved
iron: iron
ironical: ironical
irregular: irregular
irreligious: irreligious
irrepressible: irrepressible
irresolute: irresolute
irresolutely: irresolutely
irruption: irruption
irs: irs
island: island
isolate: isolated
issue: issue,issued,issuing
iv: iv
ivy: ivy
ix: ix
jack: jack
jackal: jackal
jacobin: jacobin
jacquerie: jacquerie
jacques: jacques
jaggedly: jaggedly
jalousie: jalousie
jangle: jangle
january: january
jar: jar,jarring
jargon: jargon
jarvis: jarvis
jaw: jaw,jaws
jealous: jealous
jealously: jealously
jeremiah: jeremiah
jerk: jerked,jerks
jerry: jerry
jest: jest,jests
jesting: jesting
jewel: jewels
jezebels: jezebels
jingle: jingle,jingling
job: job
jobbing: jobbing
jocosely: jocosely
joe: joe
john: john
joint: joint,joints
joke: joke
joker: joker
jolt: jolt,jolted
jostle: jostling
jostlement: jostlement
journal: journal
journey: journey
joy: joy
joyfully: joyfully
judas: judas
judge: judge,judged,judges
judges: judges
judgment: judgment
judicious: judicious
judiciously: judiciously
judith: judith
jug: jug
july: july
jumbled: jumbled
juncture: juncture
june: june
junior: junior
jupiter: jupiter
jury: jury
juryman: juryman
jurymen: jurymen
justice: justice
justify: justified,justify
justly: justly
keen: keen
keener: keener
keenly: keenly
keenness: keenness
keeper: keeper,keepers
keeping: keeping
kennel: kennel
kep: kep
kettle: kettle
key: key
kick: kick,kicked,kicking
kill: kill,killed
kindle: kindled
kindly: kindly
kindness: kindness
kindred: kindred
kine: kine
king: king,kings
kiss: kiss,kissed,kisses,kissing
kitchen: kitchen,kitchens
kite: kite
knavish: knavish
knee: knee,knees
kneel: kneel,kneeled,kneeling
knife: knife,knives
knit: knit,knitted,knitting
knitted: knitted
knitting: knitting
knock: knock,knocked,knocking
knot: knot,knots,knotted
knotted: knotted
knotting: knotting
knotty: knotty
knowledge: knowledge
knuckle: knuckle,knuckled,knuckles
laboriously: laboriously
labour: labour,laboured,labouring
labourer: labourer
lace: lace,laced
laconic: laconic
lacquey: lacquey
ladder: ladder
laden: laden
lady: ladies,lady
ladybird: ladybird
lag: lagged
lake: lake
lame: lame
lament: lamenting
lamentation: lamentation
lamenting: lamenting
lamp: lamp,lamps
lamplight: lamplight
lamplighter: lamplighter
lamps: lamps
land: land,landed,lands
landing: landing
landlady: landlady
landlord: landlord
landscape: landscape
lane: lane
language: language,languages
languidly: languidly
languish: languished,languishing
lantern: lantern,lanterns
lap: lap
lapse: lapsed
lash: lashed,lashes
lastly: lastly
late: late
latent: latent
lath: lath
latin: latin
latitudes: latitudes
lattice: lattice
laudable: laudable
laudanum: laudanum
laugh: laugh,laughed,laughing
laughingly: laughingly
laughter: laughter
lave: laving
lavish: lavished
law: law,laws
lawful: lawful
lawless: lawless
lawyer: lawyer
lay: laid,lay,laying
lazy: lazy
lead: lead,leading,leads,led
leader: leader
leaf: leaf,leaves
leafless: leafless
league: league,leagues
lean: lean,leaned,leanest,leaning
leaning: leaning
leap: leap,leaped
learn: learn,learned,learnt
leather: leather
leathern: leathern
leave: leave,leaves,leaving,left
ledge: ledge,ledges
ledger: ledgers
lee: lee
lees: lees
left: left
leg: leg,legs
legal: legal
legally: legally
legend: legend
legged: legged
legibly: legibly
legislation: legislation
leisure: leisure
leisurely: leisurely
lemon: lemons
lend: lend
lengthen: lengthen,lengthening
lengthening: lengthening
lenient: lenient
leonora: leonora
leprosy: leprosy
lessen: lessened
lethargic: lethargic
lethargy: lethargy
letter: letter,letters
level: level
levity: levity
lewis: lewis
liability: liability
liable: liable
liar: liar
liberal: liberal
liberality: liberality
liberty: liberty
library: library
license: license
licensed: licensed
licking: licking
lid: lid,lids
lie: lain,lie,lies,lying
lies: lies
lieu: lieu
lieutenant: lieutenant
life: life,lives
lifeless: lifeless
lifetime: lifetime
lift: lift,lifted,lifting
lifting: lifting
ligature: ligatures
light: light,lighted,lighter,lightest,lighting,lights
lighted: lighted
lighten: lightened
lighting: lighting
lightly: lightly
lightning: lightning
likelihood: likelihood
likeness: likeness
limb: limb,limbs
limit: limited
limitation: limitation
limited: limited
limp: limp,limped
linen: linen
linger: lingered,lingering
link: link,linked,links
linstock: linstock
lion: lion,lions
lip: lip,lips
liquor: liquor
list: list,lists
listen: listen,listened,listening
listener: listener
listening: listening
literary: literary
literature: literature
litter: litter,littered
live: live,lived,lives,living
livelihood: livelihood
lively: livelier,liveliest,lively
liver: liver,livers
liveth: liveth
livid: livid
living: living
lo: lo
load: load,loaded,loads
loaded: loaded
loadstone: loadstone
loaf: loaf,loaves
loathsome: loathsome
local: local
locality: locality
locate: located
location: locations
lock: lock,locked,locking,locks
lodge: lodge
lodger: lodger,lodgers
lodging: lodging
lodgings: lodgings
loft: loft
lofty: loftiest,lofty
log: log,logs
loiter: loitered,loitering
loitering: loitering
lombard: lombard
london: london
loneliness: loneliness
lonely: lonely
longevity: longevity
longing: longing
loo: loo
looker: looker,lookers
loose: loose,loosed,looser
loosely: loosely
loosen: loosen,loosened,loosening
lop: lopped
lord: lord,lords
lorry: lorry
lose: lose,losing,lost
loss: loss
lost: lost
lot: lot
lottery: lottery
loud: loud,louder
loudly: loudly
louis: louis
lounge: lounge,lounged,lounging
lounger: lounger,loungers
love: love,loved,loves,loving
lovely: lovely
lover: lover,lovers
loving: loving
lovingly: lovingly
loyal: loyal
loyalty: loyalty
lucifer: lucifer
luck: luck
lucky: luckier,lucky
lucrative: lucrative
ludgate: ludgate
ludicrous: ludicrous
luggage: luggage
lull: lulled
lumber: lumber,lumbered,lumbering
luminous: luminous
lump: lumps
lunch: lunch
lure: lured
lurk: lurking,lurks
luxurious: luxurious
luxury: luxuries,luxury
machine: machine
mad: mad
madam: madam
madame: madame
madly: madly
madman: madmen
madness: madness
magic: magic
magician: magician
magnanimous: magnanimous
magnificent: magnificent
magnificently: magnificently
mahogany: mahogany
maid: maids
maidenly: maidenly
mail: mail
maim: maimed
main: main
maintain: maintaining
majestically: majestically
majesty: majesty
majority: majority
maker: maker
makings: makings
malady: malady
male: male
malevolent: malevolent
malice: malice
malign: maligned
maltreat: maltreated
mamma: mamma
manager: manager
manful: manful
manfully: manfully
mangle: mangle
mangled: mangled
mangy: mangy
mania: mania
maniacal: maniacal
manifest: manifest
mankind: mankind
manner: manner
manners: manners
mantle: mantle
mar: mar
marble: marble
march: march,marched
mare: mare
marine: marine
mariner: mariner
mark: mark,marked,marking,marks
marked: marked
market: market
marketing: marketing
marking: markings
marquis: marquis
marriage: marriage
married: married
marrow: marrow
marry: married,marry
marrying: marrying
marshy: marshy
martial: martial
marvel: marvel
marvellous: marvellous
marvellously: marvellously
mash: mashed
mask: mask
mass: mass,masses,massing
massacre: massacre,massacred
massive: massive
master: master,masters
mastery: mastery
mat: matted
match: match
material: material
maternal: maternal
mathematics: mathematics
matrimonial: matrimonial
matted: matted
matter: matter,matters
mattress: mattress
mature: mature
maturely: maturely
maturity: maturity
maxim: maxim
maximum: maximum
mayor: mayor
meagre: meagre
meagreness: meagreness
meal: meal,meals
meaning: meaning
measure: measure,measured,measures,measuring
measurement: measurement
meat: meat
mechanical: mechanical
mechanically: mechanically
meddlesome: meddlesome
mediation: mediation
medical: medical
medicine: medicine,medicines
meditate: meditate,meditated,meditating
meditation: meditations
meditative: meditative
medium: medium
medley: medley
meekness: meekness
meet: meet,meeting,met
meeting: meeting
melancholy: melancholy
melt: melted,melting
memorable: memorable
memorandum: memoranda
memorial: memorials
memory: memory
menace: menace,menaced
menacing: menacing
menacingly: menacingly
menagerie: menagerie
mend: mended
mender: mender
mental: mental
mentally: mentally
mention: mention,mentioned,mentioning
mercenary: mercenary
merchant: merchant
merchantability: merchantability
merciful: merciful
mercifully: mercifully
mercy: mercies,mercy
mere: mere
merge: merged
merit: merit,merited,merits
merry: merry
message: message,messages
messenger: messenger,messengers
metal: metals
metempsychosis: metempsychosis
method: method,methods
methodical: methodical
methodically: methodically
michael: michael
michaelmas: michaelmas
midday: midday
middle: middle
midnight: midnight
midst: midst
mightily: mightily
mild: milder
mildewy: mildewy
mildly: mildly
mile: mile,miles
military: military
milk: milk
miller: miller
mince: mincing
mincing: mincing
mind: mind,minding,minds
minded: minded
mindful: mindful
mingle: mingle,mingled
minister: minister,ministers
minority: minority
minute: minute,minutes
minutely: minutely
miraculous: miraculous
mirage: mirage
mire: mire
mirror: mirror,mirrors
miscellaneous: miscellaneous
mischance: mischance
mischief: mischief
miscreant: miscreant
misdirect: misdirected
misdoubt: misdoubted
miserable: miserable
miserably: miserably
misery: miseries,misery
misfortune: misfortune,misfortunes
misgive: misgives
misgiving: misgiving,misgivings
mismanagement: mismanagement
mission: mission,missions
missionary: missionary
mississippi: mississippi
misspend: misspent
mist: mist,mists
mistake: mistake,mistakes
mistaken: mistaken
mistrust: mistrust
mistrustful: mistrustful
misty: misty
misuse: misuse,misused
mix: mix,mixed,mixing
mixed: mixed
moan: moaning,moans
moaningly: moaningly
mob: mob,mobbed
mock: mock
mode: mode
model: models
moderate: moderate
modern: modern
modest: modest
modestly: modestly
modesty: modesty
modicum: modicum
modification: modification
modify: modified
moist: moist
moister: moister
moisture: moisture
mole: mole
molten: molten
moment: moment,moments
momentarily: momentarily
momentary: momentary
monarch: monarchs
monday: monday
money: money,moneys
monk: monks
monkey: monkeys
monotonously: monotonously
monseigneur: monseigneur
monsieur: messieurs,monsieur
monster: monster,monsters
monstrous: monstrous
monstrously: monstrously
month: month,months
mood: mood
moody: moody
moon: moon
moonlight: moonlight
moral: moral
morality: morality
morally: morally
morn: morn
morning: morning
morose: morose
moroseness: moroseness
morrow: morrow
morsel: morsel,morsels
mortal: mortal,mortals
mortality: mortality
mortally: mortally
mortar: mortar
mortgage: mortgage
moss: moss
mote: mote
mother: mother,mothers
motion: motion,motioned,motioning
motionless: motionless
motive: motive,motives
mould: mould
mount: mount,mounted,mounting
mourn: mourn,mourned,mourning
mourner: mourner
mournful: mournful
mournfully: mournfully
mourning: mourning
mouse: mouse
moustache: moustaches
mouth: mouth,mouths
mouthful: mouthful
movable: movable
movement: movement
mud: mud
muddy: muddy
muffle: muffled
muffled: muffled
muffler: muffler
multitude: multitude,multitudes
munch: munching
munificent: munificent
murder: murder,murdered,murdering
murderer: murderer
murderous: murderous
murky: murky
murmur: murmur,murmured,murmuring
murmuring: murmuring
muscle: muscle
muse: mused
music: music
musical: musical
musing: musing
musingly: musingly
musket: musket,muskets
musketeer: musketeers
mustard: mustard
musty: musty
mutilate: mutilated
mutilation: mutilation
mutinous: mutinous
mutter: mutter,muttered
mutton: mutton
mutual: mutual
myriad: myriads
mysterious: mysterious
mystery: mysteries,mystery
nail: nail,nailed,nails
naked: naked
nakedness: nakedness
namesake: namesake
naming: naming
napkin: napkin
narcotic: narcotic
narrative: narrative
narrator: narrator
narrow: narrow,narrowing
nation: nation
national: national
native: native,natives
natural: natural
naturally: naturally
nature: nature
natured: natured
naught: naught
naval: naval
nearer: nearer
neat: neat
necessitate: necessitated
necessity: necessity
neck: neck,necks
necked: necked
needful: needful
needle: needle
needless: needless
needy: needy
negative: negative
neglect: neglect,neglected,neglects
negligence: negligence
negligent: negligent
negligently: negligently
negro: negro
neighbour: neighbour,neighbouring,neighbours
neighbourhood: neighbourhood
nephew: nephew
nerve: nerve,nerves
nervous: nervous
nervously: nervously
nervousness: nervousness
nest: nest
nestle: nestled
nettle: nettled
network: network
neutral: neutral
newgate: newgate
newly: newly
news: news
newsletter: newsletter
nice: nice
nicely: nicely
nicety: nicety
nick: nick
nigh: nigh
night: night,nights
nightcap: nightcap,nightcaps
nightfall: nightfall
nightly: nightly
nightmare: nightmare
nimble: nimble
nimbly: nimbly
ninepence: ninepence
ninth: ninth
nobility: nobility
noble: noble,nobles
nobleman: nobleman
nod: nod,nodded,nodding
noise: noise,noises
noisiest: noisiest
noisily: noisily
noisome: noisome
nonproprietary: nonproprietary
nonsense: nonsense
nonsensical: nonsensical
nook: nook
noon: noon
noontide: noontide
north: north
northward: northward
norway: norway
nose: nose
nostril: nostril,nostrils
notability: notabilities
notable: notable
note: note,notes
notice: notice,noticed,noticing
noticeable: noticeable
notify: notifies,notifying
notion: notion
notoriety: notoriety
notorious: notorious
notre: notre
noun: noun
nourishment: nourishment
novelty: novelty
november: november
nowise: nowise
numerous: numerous
numskull: numskulls
nurse: nurse,nursed
nurture: nurtured
oath: oath
obedient: obedient
obey: obey,obeyed,obeying
object: object,objects
objection: objection
objectionable: objectionable
obligation: obligation
oblige: obliged,obliging
obliterate: obliterated,obliterating
oblivion: oblivion
oblivious: oblivious
obnoxious: obnoxious
obscure: obscure,obscured
obscurity: obscurity
obsequiousness: obsequiousness
observable: observable
observant: observant
observantly: observantly
observation: observation,observations
observatory: observatory
observe: observe,observed,observing
observer: observers
obsolete: obsolete
obstacle: obstacle,obstacles
obstinacy: obstinacy
obstinate: obstinate
obstinately: obstinately
obtrude: obtruded
obvious: obvious
occasion: occasion,occasioned,occasions
occasional: occasional
occasionally: occasionally
occupant: occupant,occupants
occupation: occupation,occupations
occupy: occupied,occupy
occur: occur,occurred
occurrence: occurrence,occurrences
ocean: ocean
odd: odd,oddest
oddly: oddly
odds: odds
odour: odour,odours
offal: offal
offence: offence,offences
offender: offender
offensive: offensive
offer: offer,offered,offering,offers
office: office,offices
officer: officer,officers
official: official,officials
officiate: officiate,officiating
offspring: offspring
oftener: oftener
oftentimes: oftentimes
ogle: ogled
ogre: ogre
ogreish: ogreish
oil: oil,oiled
olfactory: olfactory
olive: olive
omened: omened
ominous: ominous
ominously: ominously
onion: onions
oniony: oniony
online: online
onward: onward
opener: opener
openly: openly
openness: openness
opera: opera
operation: operations
opiate: opiate
opinion: opinion,opinions
opportunity: opportunities,opportunity
oppose: oppose,opposed,opposing
opposition: opposition
oppress: oppressed,oppresses
oppressed: oppressed
oppression: oppression
oppressive: oppressive
oppressor: oppressor,oppressors
orange: orange
orator: orator
orbit: orbits
orderly: orderly
ordinance: ordinance
ordinary: ordinary
organ: organs
organisation: organisation
organize: organized
orgy: orgies
original: original
originality: originality
originally: originally
originate: originate,originated,originating
originator: originator
orleans: orleans
ornament: ornament
ornamented: ornamented
orphan: orphan
orthodoxy: orthodoxy
ostensible: ostensible
ostentatious: ostentatious
ostentatiously: ostentatiously
ostrich: ostrich
outdated: outdated
outdo: outdone
outer: outer
outermost: outermost
outhouse: outhouses
outlandish: outlandish
outlive: outlive
outnumber: outnumbering
outrage: outrage
outrageous: outrageous
outskirts: outskirts
outspoken: outspoken
outstrip: outstrip
outward: outward
outwardly: outwardly
outwards: outwards
outwatch: outwatched
outweigh: outweigh
overbearing: overbearing
overborne: overborne
overcast: overcast
overcloud: overclouded
overcome: overcoming
overflow: overflowed,overflowing
overfraught: overfraught
overhang: overhanging
overhead: overhead
overhear: overheard
overladen: overladen
overlay: overlay
overload: overloading
overlook: overlooked,overlooking
overpower: overpowered
overset: overset
overshadow: overshadowed
overspread: overspread
overstay: overstay
overstep: overstepping
overtake: overtake,overtaken,overtaking
overthrow: overthrown
overwhelm: overwhelm
overwork: overworked
owe: owed
owl: owl
owner: owner,owners
ox: ox
oxford: oxford
oyster: oyster
pace: pace,paced,paces
pacifically: pacifically
pacing: pacing
packet: packet,packets
packing: packing
pad: pads
pagan: pagan
pain: pain,pains
painful: painful
painfully: painfully
paint: painted
painter: painter
pair: pair,pairs
palace: palace
pale: pale
paleness: paleness
paler: paler
palest: palest
pallet: pallet
palpable: palpable
paltering: paltering
pamphlet: pamphlets
pane: pane
pant: panted
panting: panting
papa: papa
paper: paper,papers
papers: papers
paperwork: paperwork
par: par
parade: parade
paragraph: paragraph,paragraphs
parallel: parallels
parapet: parapet
parcel: parcelled,parcels
parchment: parchment,parchments
pardon: pardon
parent: parent,parents
paris: paris
parish: parish
parley: parley
parricide: parricide
partial: partial
partially: partially
participate: participate
particle: particle,particles
particulars: particulars
partly: partly
partner: partner,partners
party: parties,party
pass: pass,passed,passes,passing
passage: passage,passages
passenger: passenger,passengers
passer: passers
passerby: passerby
passersby: passersby
passing: passing
passion: passion,passions
passionate: passionate
passionately: passionately
passive: passive
pastime: pastime
pastor: pastors
pasture: pasture,pasturing
pat: patting
patch: patch,patched,patches
patchwork: patchwork
path: path
pathetic: pathetic
patience: patience
patient: patient,patients
patiently: patiently
patrician: patrician
patriot: patriot,patriots
patriotic: patriotic
patriotism: patriotism
patriots: patriots
patrol: patrols
patron: patron
patronage: patronage
pattern: pattern
paul: paul
paunch: paunch
pauper: paupers
pause: pause,paused,pauses,pausing
pave: paved,paving
pavement: pavement,pavements
paw: pawing
pay: paid,pay,paying
payment: payment,payments
pea: peas
peace: peace
peaceful: peaceful
peacefullest: peacefullest
peach: peaches
peal: peal
peasant: peasant,peasants
peck: peck
peculiar: peculiar
peculiarity: peculiarity
pecuniary: pecuniary
peep: peep,peeped,peeping
peer: peered,peering
peevish: peevish
pen: pen
penalty: penalty
pencil: pencil
pendent: pendent
pendulum: pendulum
penetrate: penetrate,penetrated
penitential: penitential
pensive: pensive
people: peopled
peppercorn: peppercorn
perceive: perceive,perceived
perceptible: perceptible
perceptibly: perceptibly
perception: perception
perch: perch,perched,perches
peremptory: peremptory
perfect: perfect
perfection: perfection
perfectly: perfectly
perforce: perforce
perform: perform,performed,performing
performance: performance,performances
peril: peril,perils
period: period,periods
periodic: periodic
periodical: periodical
perish: perish,perished,perishing
permanent: permanent
permission: permission
permit: permitted
pernicious: pernicious
peroration: peroration
perpendicular: perpendicular
perpetually: perpetually
perpetuate: perpetuate,perpetuating
perpetuation: perpetuation
perplex: perplexed
perplexed: perplexed
perplexedly: perplexedly
perplexity: perplexity
perseverance: perseverance
persevere: persevering
perseveringly: perseveringly
persist: persisted
persistent: persistent
person: people,person,persons
personage: personage,personages
personal: personal
personality: personality
perspective: perspective
perspiration: perspiration
persuade: persuade,persuaded
persuasion: persuasion
perturbation: perturbation
pervade: pervaded
pervert: perverted
pestilence: pestilence
pestilent: pestilent
pet: pet
petition: petition,petitions
petitioner: petitioner
petrified: petrified
petrify: petrify
petulantly: petulantly
phantom: phantom
phenomenon: phenomenon
philosopher: philosopher,philosophers
philosophy: philosophy
phrase: phrase,phrases
physical: physical
physically: physically
physician: physician
pick: pick,picked,picking
pickle: pickle
picnic: picnic
picture: picture,pictured,pictures
picturesque: picturesque
pie: pies
piece: piece,pieces
pieman: pieman
pier: pier
pierce: pierced,piercing
piety: piety
pig: pig,pigs
pigmy: pigmy
pike: pike,pikes
pile: pile
pilferer: pilferer
pilgrimage: pilgrimages
pill: pill
pillage: pillaged
pillar: pillar,pillars
pillory: pillory
pillow: pillow,pillows
pilotage: pilotage
pin: pin
pincers: pincers
pinch: pinch,pinched
pine: pined
pinion: pinioned
pint: pint
pipe: pipe,pipes
piscatory: piscatory
pistol: pistol,pistols
pit: pitted
pitch: pitch
pith: pith
pitiable: pitiable
pity: pitied,pity,pitying
placid: placid
placidity: placidity
plain: plain,plainer,plains
plainly: plainly
plaintiff: plaintiff
plaintive: plaintive
plait: plaiting
plan: plan,planned,plans
plane: plane
plant: plant
plaster: plastered
plate: plate,plated
platform: platform
play: play,played,playing
player: players
playfully: playfully
playfulness: playfulness
plaything: plaything
plea: plea
plead: pleaded,pleading
pleasant: pleasant
pleasantly: pleasantly
pleased: pleased
pleasure: pleasure,pleasures
pledge: pledge,pledged
plentiful: plentiful
plenty: plenty
plight: plight
plod: plodding
plodding: plodding
plot: plot,plots,plotting
plotter: plotter
plough: plough,ploughed,ploughs
pluck: pluck
plump: plump
plunder: plunder,plundered,plundering
plunderer: plunderers
plunge: plunge,plunged,plunges,plunging
ply: plied
pocket: pocket,pockets
poet: poet,poets
poetical: poetical
pointedly: pointedly
poison: poison,poisoned,poisoning,poisons
pole: poles
police: police
polish: polish
polished: polished
polite: polite
politely: politely
politeness: politeness
politic: politic
political: political
politics: politics
pollute: polluted
polluted: polluted
poltroon: poltroon
ponder: pondering
poniard: poniarded
pont: pont
pooh: pooh
pool: pools
poor: poor,poorer
populace: populace
popular: popular
popularity: popularity
popularly: popularly
population: population
pore: pore,poring
porkman: porkman
porringer: porringer
port: port
portend: portend,portended
portentously: portentously
porter: porter,porters
porterage: porterage
portion: portion,portions
portly: portly
portrait: portrait,portraits
position: position,positions
positively: positively
possess: possess,possessed,possesses,possessing
possession: possession,possessions
possessor: possessor
possibility: possibility
post: post,posted
poster: poster
postilion: postilion,postilions
posting: posting
postmaster: postmaster
postpone: postponed
posture: posture
pot: pot
potato: potato
potent: potent
potentate: potentate
poultry: poultry
pound: pound,pounding
pour: poured,pouring
poverty: poverty
powder: powder,powdered
powdering: powdering
power: power,powers
powerful: powerful
powerfully: powerfully
powerless: powerless
practicable: practicable
practical: practical
practically: practically
practice: practice,practices
practise: practise,practised
practised: practised
prattling: prattling
pray: pray,prayed,praying
prayer: prayer,prayers
preach: preach
precaution: precaution,precautions
precede: preceded,preceding
precept: precept
precious: precious
precipitate: precipitate,precipitated,precipitating
precipitation: precipitation
precise: precise
precisely: precisely
precision: precision
precocious: precocious
predicate: predicated
prediction: prediction
predominate: predominate
predominating: predominating
preface: preface
prefer: prefer,preferred
prejudge: prejudged
preliminary: preliminaries
prematurely: prematurely
preoccupied: preoccupied
preparation: preparation,preparations
prepare: prepare,prepared,preparing
prepared: prepared
prescribe: prescribed
presence: presence
presentiment: presentiment
presently: presently
preservation: preservation
preserve: preserve,preserved,preserves
preside: presided,presiding
president: president
press: press,pressed,presses,pressing
pressed: pressed
pressure: pressure
presume: presume,presumed
presumption: presumption
pretence: pretence
pretend: pretend,pretended,pretending
pretty: pretty
prevail: prevail,prevailing
prevalent: prevalent
prevaricate: prevaricate
prevent: prevent,prevented
prevention: prevention
previous: previous
prey: prey
price: price
prick: pricked
pride: pride
priestly: priestly
prime: prime
prince: prince,princes
principal: principal
principally: principally
principle: principle
print: print,printed
prise: prised
prison: prison,prisons
prisoner: prisoner,prisoners
prisoners: prisoners
private: private
privately: privately
privilege: privilege,privileges
privileged: privileged
privy: privy
prize: prize
probable: probable
procedure: procedure
proceed: proceed,proceeded,proceeding
proceedings: proceedings
process: process
processing: processing
procession: procession,processions
procure: procured
prodigious: prodigious
produce: produce,produced
production: production
profess: professed,professing
profession: profession,professions
professional: professional
professionally: professionally
professor: professor
professors: professors
profit: profit,profits
profitable: profitable
profligate: profligates
profound: profound,profounder
profoundly: profoundly
progress: progress
prohibition: prohibition
project: project,projected,projecting,projects
projectile: projectile
projector: projector,projectors
prolong: prolonged
prolonged: prolonged
promenade: promenading
prominent: prominent
prominently: prominently
promise: promise,promised,promises
promising: promising
promote: promoting
promotion: promotion
pronoun: pronoun
pronounce: pronounced
pronunciation: pronunciation
proof: proof,proofs
proofread: proofread
propensity: propensities
proper: proper
property: properties,property
prophetic: prophetic
propitiate: propitiate
proposal: proposal
propose: propose,proposed
proposition: proposition
proprietary: proprietary
proscribe: proscribed
proscription: proscription
prosecution: prosecution
prosecutor: prosecutor
prospect: prospect
prospects: prospects
prosper: prosper,prospered,prospering
prosperity: prosperity
prosperous: prosperous
pross: pross
prostrate: prostrated
protect: protect,protected
protection: protection
protector: protector
protest: protest,protested,protesting
protestation: protestations
protract: protracted
prove: prove,proved
provender: provender
provide: provide,providing
providence: providence
provident: provident
province: province,provinces
provincial: provincial
provision: provision,provisions
proviso: proviso
provocation: provocation
prowl: prowl
proxy: proxy
public: public
publicly: publicly
puddle: puddles
puff: puff
pull: pull,pulled
pulley: pulley,pulleys
pulpit: pulpit
pulsation: pulsation
pulse: pulse,pulses
pump: pumped,pumps
punch: punch
punishment: punishment
punitive: punitive
pupil: pupil,pupils
purchase: purchase,purchased,purchases
pure: pure
purely: purely
purify: purified
purity: purity
purloiner: purloiner
purple: purple
purport: purported
purpose: purpose,purposes
purposeless: purposeless
purposely: purposely
purse: purse,purses
pursuance: pursuance
pursue: pursue,pursued,pursuing
pursuer: pursuer
pursuit: pursuit,pursuits
purveyor: purveyors
push: pushed,pushing
puzzle: puzzle,puzzling
quaint: quaint
quainter: quainter
qualified: qualified
quality: qualities,quality
qualm: qualms
quantity: quantities,quantity
quarrel: quarrel
quarter: quarter,quartered,quartering,quarters
quartering: quartering
quash: quash
quaver: quavering
quay: quay
queen: queen
queer: queer
quench: quench
quest: quest
question: question,questioned,questions
questionable: questionable
questioner: questioner
quick: quick,quicker,quickest
quicken: quickened,quickening
quickness: quickness
quiet: quiet,quieted,quieter,quieting
quietly: quietly
quit: quit,quitted
quiver: quivered
quoth: quoth
rabbit: rabbit
rabble: rabble
race: race
rack: rack,racks
radiance: radiance
radiant: radiant
rag: rag,rags
rage: rage,raging
ragged: ragged,raggedest
raggedly: raggedly
railing: railing,railings
rain: rain,rains
rainy: rainy
raise: raise,raised,raising
rake: raked
rally: rally
random: random
range: range,ranged,ranging
rank: rank,ranks
rap: rapped,rapping
rapacious: rapacious
rapid: rapid
rapidly: rapidly
rapturous: rapturous
rapturously: rapturously
rare: rare
rarely: rarely
rarity: rarity
rascal: rascal
rashness: rashness
rat: rats
rate: rate
rational: rational
rattle: rattle,rattled
rattling: rattling
ravage: ravaged
rave: rave
raving: raving
raw: raw
ray: ray,rays
raze: razed
razor: razor
reach: reach,reached,reaching
read: read,reading
readable: readable
reader: reader
readiness: readiness
reading: reading
ready: ready
real: real
realisation: realisation
realise: realise,realised
reality: reality
reap: reaping
reappear: reappear,reappeared
rear: rear,reared,rearing
reason: reason,reasoned,reasons
reasonable: reasonable
reassurance: reassurance,reassurances
reassuring: reassuring
rebuild: rebuilding
rebuke: rebuke
recall: recall,recalled,recalling,recalls
receipt: receipt
receive: receive,received,receiving
reception: reception
recipe: recipe
reckless: reckless
recklessly: recklessly
recklessness: recklessness
reckoning: reckoning,reckonings
reclaim: reclaim,reclaimed
recline: reclining
recognise: recognise,recognised
recognition: recognition
recoil: recoiled
recollect: recollect,recollected
recollection: recollection
recommend: recommend,recommended,recommends
recompense: recompense,recompensed
reconcile: reconcile
reconcilement: reconcilement
record: record,recorded
records: records
recount: recounted
recourse: recourse
recover: recover,recovered,recovering
recovery: recovery
recross: recrossed
recruit: recruited,recruiting
red: red
redden: reddened,reddening
redeem: redeemed
redhead: redheads
redistribute: redistribute,redistributing
redistributing: redistributing
redistribution: redistribution
redress: redress
reduce: reduced
redundancy: redundancy
reek: reek
refection: refection
refer: refer,referred,referring
referable: referable
reference: reference,references
refill: refilled
refined: refined
refinement: refinement,refinements
reflect: reflect,reflected,reflecting
reflection: reflection,reflections
reflectively: reflectively
refold: refolded
refractory: refractory
refresh: refresh,refreshed
refreshment: refreshment
refuge: refuge
refugee: refugee
refund: refund
refusal: refusal
refuse: refuse
regain: regained
regard: regard,regarded
regeneration: regeneration
region: region,regions
register: register,registered,registers
regret: regret,regretted
regrind: regrinding
regular: regular
regularly: regularly
regulate: regulating
rehearse: rehearsed
reign: reigned,reigning
rein: rein,reining
reins: reins
reiterate: reiterate,reiterated
rejection: rejection
rejoice: rejoice,rejoiced
rejoicing: rejoicing
rejoin: rejoined,rejoining
rejoinder: rejoinder
relapse: relapse,relapses
relate: relate
relation: relation,relations
relationship: relationship
relative: relative
relay: relays
release: release,released,releases,releasing
relent: relent,relenting
reliance: reliance
relic: relics
relief: relief,reliefs
relieve: relieve,relieved,relieving
relieved: relieved
religious: religious
religiously: religiously
relinquish: relinquish,relinquished
relish: relish
reluctance: reluctance
reluctant: reluctant
reluctantly: reluctantly
rely: relied,rely,relying
remain: remain,remained,remaining,remains
remainder: remainder
remains: remains
remark: remark,remarked,remarking,remarks
remarkable: remarkable
remedy: remedies,remedy
remember: remember,remembered,remembering
remembrance: remembrance,remembrances
remind: reminded
reminder: reminder
remit: remitted
remittance: remittances
remodel: remodelling
remodelled: remodelled
remonstrance: remonstrance
remonstrate: remonstrated
remorse: remorse
remorseless: remorseless
remote: remote
remotely: remotely
removal: removal
remove: remove,removed,removing
removed: removed
rename: renamed
rend: rend
render: render,rendered,rendering
renew: renew
renewal: renewal
renounce: renounce,renouncing
rent: rent,rents
renunciation: renunciation
repair: repair
reparable: reparable
repass: repassing
repast: repast
repay: repay,repaying
repeat: repeat,repeated,repeating
repent: repent,repented
repentance: repentance
repeople: repeople
repetition: repetition
replace: replace,replaced
replacement: replacement
replenish: replenished
reply: replied,reply,replying
report: reported,reports
repose: repose,reposed
represent: represent,represented,representing,represents
representation: representations
repress: repressed,repressing
repression: repression
reproach: reproach,reproaching
reproachful: reproachful
reproachfully: reproachfully
republic: republic
republican: republican,republicans
repudiate: repudiated
reputation: reputation
repute: repute
request: request,requested
require: require,required,requiring
required: required
requirement: requirements
requisition: requisition
rescue: rescue,rescued
resemblance: resemblance
resemble: resemble,resembles
resent: resented
resentful: resentful
reservation: reservation
reserve: reserve
reservoir: reservoirs
reside: resided,resides
residence: residence
resident: resident
resign: resigned,resigning
resignation: resignation
resignedly: resignedly
resin: resin
resistance: resistance
resistless: resistless
resolute: resolute
resolutely: resolutely
resolution: resolution
resolve: resolve,resolved
resonance: resonance
resort: resort,resorted
resound: resound,resounded
resounding: resounding
resoundingly: resoundingly
resource: resource,resources
respect: respect,respected,respecting
respectability: respectability
respectable: respectable
respectfully: respectfully
respective: respective
respects: respects
respond: responded,responding
response: response
responsibility: responsibility
responsible: responsible
responsive: responsive
rest: rest,rested,resting,rests
restless: restless
restlessly: restlessly
restlessness: restlessness
restoration: restoration
restorative: restorative,restoratives
restore: restore,restored,restoring
restrain: restrain,restrained,restraining
restraint: restraint,restraints
restriction: restrictions
result: result
resume: resume,resumed,resuming
resumption: resumption
resurrection: resurrection
retain: retain,retained
retainer: retainer
retake: retaken
retaliative: retaliative
retard: retarded
retention: retention
reticule: reticule
retinue: retinue
retire: retire,retired
retired: retired
retirement: retirement
retort: retorted
retrace: retraced
retreat: retreated,retreating,retreats
retribution: retribution
retributive: retributive
retrospect: retrospect
retrospectively: retrospectively
return: return,returned,returning,returns
reunite: reunited
reveal: reveal,revealed,revealing,reveals
revelation: revelations
revenge: revenge
revengeful: revengeful
revenue: revenue
reverence: reverence
reverently: reverently
reverse: reverse,reversed,reverses
reversionary: reversionary
revert: reverted,reverting
review: reviewed
revival: revival
revive: revive,revived,reviving
revolution: revolution
revolutionary: revolutionary
revolve: revolved
revulsion: revulsion
reward: reward
ribbon: ribbon,ribbons
rich: rich,richest
riches: riches
rickety: rickety
rid: rid
ride: ride,riding,rode
rider: rider,riders
ridge: ridge,ridges
ridiculous: ridiculous
riding: riding
rift: rifting
rightly: rightly
rights: rights
ringer: ringer
rip: rip
ripen: ripened
ripening: ripening
ripple: ripples
rise: rise,risen,rises,rising,rose
rising: rising,risings
risk: risk
rive: riving
river: river,rivers
road: road,roads
roadside: roadside
roadway: roadway
roam: roamed
roar: roar,roared,roaring
roast: roast,roasting
rob: robbed
robber: robber,robbers
robbery: robberies
robe: robe
robed: robed
robing: robing
rock: rock,rocked,rocking
rod: rod,rods
roger: roger
roll: roll,rolled,rolling
rolling: rolling
romance: romance
rome: rome
roof: roof,roofed
roost: roosted
root: root,rooted,rooting
rooted: rooted
rope: rope,ropes
rose: rose,roses
rosy: rosy
rot: rot,rotted
rotten: rotten
rough: rough
roughen: roughened
roughly: roughly
roughness: roughness
rouleau: rouleau
rouse: rouse,roused
rousing: rousing
routine: routine
row: row,rows
royal: royal
royalty: royalties,royalty
rub: rub,rubbed,rubbing
rude: rude
rudely: rudely
rue: rue
ruffian: ruffian,ruffians
ruffle: ruffle,ruffled
rugged: rugged
ruin: ruin,ruined
ruinate: ruinating
ruinating: ruinating
ruinous: ruinous
rule: rule,ruled,rules
ruler: ruler
rum: rum
rumble: rumble,rumbled,rumbling
ruminate: ruminated,ruminating
rumour: rumour,rumoured
running: running
rush: rush,rushed,rushes,rushing
rust: rust,rusted
rustic: rustic
rustle: rustle,rustled,rustling
rustling: rustling
rusty: rusty
rut: ruts
ruthless: ruthless
rye: rye
sabre: sabres
sack: sack,sacked
sacred: sacred
sacrifice: sacrifice,sacrificed,sacrifices
sacristan: sacristan
sad: sad,sadder
sadden: saddened
saddle: saddle,saddles
saddling: saddling
sadly: sadly
sadness: sadness
safe: safe,safest
safely: safely
safety: safety
sagacious: sagacious
sagacity: sagacity
sail: sail,sailing
sailing: sailing
saint: saint
sainte: sainte
saintly: saintly
saith: saith
sake: sake,sakes
sale: sale
sallow: sallow
salt: salt,salts
salutation: salutation
salute: salute,saluted
samaritan: samaritans
sample: sample,samples
samson: samson
sanction: sanction
sanctuary: sanctuaries,sanctuary
sand: sand,sanded
sandy: sandy
sane: sane
sanguine: sanguine
sarcasm: sarcasm
sarcastic: sarcastic
sardanapalus: sardanapalus
sash: sashes
satellite: satellite
satisfaction: satisfaction
satisfied: satisfied
satisfy: satisfied,satisfy
saturday: saturday
sauce: sauce
saucer: saucer,saucers
saunter: saunter
sausage: sausage
savage: savage,savages
save: save,saved,saving
saving: saving
saviour: saviour
savoury: savoury
sawyer: sawyer
scaffold: scaffold
scale: scale,scaling
scantily: scantily
scanty: scanty
scarce: scarce
scarcely: scarcely
scarcity: scarcity
scarecrow: scarecrows
scared: scared
scarf: scarf
scatter: scatter,scattered
scavenger: scavenger
scene: scene,scenes
scent: scent,scents
scheme: scheme,schemes
scholar: scholar
school: school
scientific: scientific
scoop: scoops
scorch: scorched
score: score,scores
scorn: scorn,scorned
scornfully: scornfully
scoundrel: scoundrel,scoundrels
scour: scouring
scowling: scowling
scrag: scrags
scramble: scramble,scrambled
scrap: scrap,scraps
scrapings: scrapings
scratch: scratch,scratched
scrawl: scrawl,scrawled
scream: scream,screaming
screech: screeched,screeching
screen: screen
screw: screw,screwed
screwing: screwing
scripture: scripture
scrub: scrubbed
scruple: scruple
scuffle: scuffle,scuffled
scullery: sculleries
sculptured: sculptured
scum: scum
sea: sea
seacoast: seacoast
seal: sealed
seamstress: seamstress
sear: seared
search: search
season: season,seasons
seat: seat,seated,seats
seaward: seaward
seclusion: seclusion
secrecy: secrecy
secret: secret,secrets
secretary: secretary
secrete: secrete,secreted
secretly: secretly
sect: sect
secure: secure,secured
securely: securely
security: security
sediment: sediment
seed: seed,seeds
seek: seek,seeking,seeks,sought
seeking: seeking
seer: seers
seesaw: seesaw
seine: seine
seize: seize,seized,seizing
seldom: seldom
selection: selection,selections
selfish: selfish
sell: selling,sold
semblance: semblance
send: send,sending
sensation: sensation
sense: sense
senseless: senseless
sensibility: sensibilities,sensibility
sensibly: sensibly
sensitive: sensitive
sensitiveness: sensitiveness
sensual: sensual
sensuality: sensuality
sentence: sentence,sentenced,sentences
sentencing: sentencing
sentiment: sentiment
sentimental: sentimental
sentinel: sentinel
separate: separate,separated
separately: separately
separation: separation
september: september
sequestrated: sequestrated
sequestration: sequestration
serene: serene
serf: serf,serfs
series: series
sermon: sermon
servant: servant,servants
serve: serve,served,serving
service: service,services
serviceable: serviceable
servility: servility
sessions: sessions
set: set,sets,setting
setting: setting
settle: settle,settled,settles,settling
settled: settled
settlement: settlement
seventeen: seventeen
severe: severe
severity: severity
sewing: sewing
sex: sexes
sexton: sextons
shade: shade,shaded
shades: shades
shadow: shadow,shadows
shadows: shadows
shadowy: shadowy
shady: shady
shaft: shaft
shaggy: shaggy
shake: shake,shaken,shakes,shaking,shook
shallow: shallow
sham: sham
shame: shame,shaming
shameful: shameful
shamefully: shamefully
shape: shape,shaped,shapes,shaping
share: share,shared,sharing
sharp: sharp
sharpen: sharpened,sharpening
sharpened: sharpened
sharply: sharply
sharpness: sharpness
shatter: shattered
shattered: shattered
shave: shave,shaved
shawl: shawl
shear: sheared
sheep: sheep
sheer: sheer
sheet: sheet,sheets
shelf: shelves
shelter: shelter,sheltered,sheltering
shelving: shelving
shield: shield
shift: shifted
shilling: shilling,shillings
shine: shine,shining,shone
ship: ship
shirt: shirt
shiver: shiver,shivered,shivering
shock: shock
shocked: shocked
shoe: shoe,shoes
shoemaker: shoemaker
shoemaking: shoemaking
shoot: shot
shooter: shooter
shop: shop,shops
shopkeeper: shopkeeper
shore: shore
short: short,shortest
shorten: shortened
shortly: shortly
shortness: shortness
shot: shot
shoulder: shoulder,shouldered,shouldering,shoulders
shout: shout,shouted,shouting,shouts
shove: shoved
shower: shower,showering,showers
shred: shred,shredding
shrewd: shrewd
shrewsbury: shrewsbury
shriek: shriek,shrieked,shrieking,shrieks
shrill: shrill
shrink: shrink
shrivel: shrivelled
shroud: shrouds
shrug: shrug,shrugging,shrugs
shudder: shudder,shuddered,shuddering
shun: shun,shunned
shut: shut,shuts,shutting
shutter: shutters
shutting: shutting
shy: shied,shy
sick: sick
sickening: sickening
sickliest: sickliest
sickly: sickly
sickness: sickness
sideways: sideways
sigh: sigh,sighed,sighing,sighs
sight: sight,sights
sighted: sighted
sign: sign,signs
signal: signal,signalling,signals
signalling: signalling
signally: signally
signature: signature
significance: significance
signify: signified
signing: signing
silence: silence,silences
silent: silent
silently: silently
silk: silk,silks
sill: sill
silver: silver
simple: simple
simplicity: simplicity
simply: simply
simultaneously: simultaneously
sin: sin,sins
sing: sang,sing,singing,sings
singing: singing
single: single
singly: singly
singular: singular
sinister: sinister
sink: sank,sink,sinking,sunk,sunken
sinner: sinner
sip: sip,sipped,sipping
sir: sir
sister: sister,sisters
sisterhood: sisterhood
sit: sat,sit,sits,sitting
sitting: sitting
situation: situation
sixpence: sixpence
sixth: sixth
size: size
skid: skid
skilful: skilful
skill: skill
skin: skins
skinny: skinny
skirt: skirt,skirting,skirts
sky: skies,sky
slab: slab
slacken: slackened
slackened: slackened
slake: slake
slap: slapping
slave: slave,slaves
slavery: slavery
slay: slain
sleek: sleek
sleep: sleep,sleeping,sleeps,slept
sleeper: sleeper
sleepy: sleepy
sleeve: sleeve,sleeves
slender: slender
slice: sliced
slide: slid
slight: slight,slightest,slighting
sling: slung
slink: slinking,slunk
slip: slip,slipped
slipper: slippers
slippered: slippered
sloth: sloth
slough: slough,sloughs
slovenly: slovenly
slow: slow
slowly: slowly
slowness: slowness
slumber: slumber,slumbering
slumbering: slumbering
slunk: slunk
sly: sly
smack: smacked
smallness: smallness
smash: smash
smear: smear,smeared
smell: smell,smelling,smelt
smile: smile,smiled,smiles,smiling
smilingly: smilingly
smite: smite,smiting,smote
smith: smith,smiths
smithy: smithy
smoke: smoke,smoked,smoking
smokeless: smokeless
smoking: smoking
smoky: smoky
smooth: smooth,smoothed,smoother,smoothing
smoothing: smoothing
smoothly: smoothly
smoothness: smoothness
smote: smote
smother: smothered
smoulder: smouldering
smuggler: smuggler
snake: snake
snap: snap,snapping
snatch: snatched,snatches
sneak: sneak,sneaking
sneer: sneers
sneeze: sneezed
snip: snipped
snooks: snooks
snort: snorting
snow: snow,snowing
snowy: snowy
snuff: snuff,snuffed
soar: soared
sob: sob,sobbed,sobbing
sober: sober,soberer
sobriety: sobriety
sobs: sobs
social: social
society: society
sodden: sodden
sofa: sofa
soft: soft,softer
soften: soften,softened,softening
softened: softened
softening: softening
softly: softly
soho: soho
soil: soil,soiled,soils
soiled: soiled
soldier: soldier,soldiers
soldiery: soldiery
sole: sole
solely: solely
solemn: solemn
solemnity: solemnity
solemnly: solemnly
solicit: solicit
solicitation: solicitation
solicitor: solicitor
solicitude: solicitude
solid: solid
soliloquy: soliloquy
solitary: solitary
solitude: solitude
solomon: solomon
solve: solve,solved,solving
sombre: sombre
son: son,sons
song: song
sonorous: sonorous
sooner: sooner
soot: soot
soothe: soothed
soothing: soothing
soothingly: soothingly
sorceress: sorceress
sore: sore,sores
sorely: sorely
sorrow: sorrow,sorrows
sorrowful: sorrowful
sorrowing: sorrowing
sort: sort,sorts
soul: soul,souls
sound: sound,sounded,sounding,sounds
sounder: sounders
soundly: soundly
soundness: soundness
soup: soup
sour: sour,soured
source: source,sources
souring: souring
south: south
southern: southern
sow: sow,sown
space: space,spaces
spade: spade
span: span
spare: spare,spared,sparing
spark: spark,sparks
sparkle: sparkled
sparkling: sparkling
sparrow: sparrows
speak: speak,speaking,speaks,spoke,spoken
speaker: speaker
spear: spear,spears
special: special
specially: specially
species: species
specimen: specimens
speck: speck,specks
speckled: speckled
spectacle: spectacle
spectacles: spectacles
spectacularly: spectacularly
spectator: spectators
spectral: spectral
spectre: spectre
speculate: speculate,speculating
speech: speech
speed: speed,speeding
speedy: speedy
spell: spell,spells,spelt
spencer: spencer
spend: spend,spending,spent
sphere: sphere
spike: spikes
spiked: spiked
spiky: spiky
spile: spile
spill: spilled
spilt: spilt
spin: spin,spun
spinning: spinning
spire: spires
spirit: spirit,spirited,spirits
spiritual: spiritual
spit: spat
spite: spite
spittoon: spittoon
splash: splashed,splashing
splendour: splendour
splinter: splinter
split: split,splits
splutter: spluttered
spoil: spoiling,spoils,spoilt
spoilt: spoilt
spoke: spoke
spoken: spoken
spoon: spoon
sport: sport,sports
spot: spot,spots
spray: spray
spread: spread,spreading
spreading: spreading
sprig: sprig
spring: sprang,spring,springing,sprung
springing: springing
sprinkle: sprinkled
sprinkling: sprinkling
sprite: sprites
spur: spurring
spurn: spurning
sputtering: sputtering
spy: spies,spy
squalid: squalid
squalor: squalor
square: square,squares,squaring
squash: squashing
squeeze: squeeze,squeezed,squeezing
stab: stabs
stable: stable,stables
stack: stack
staff: staff
stage: stage
stagger: staggering
staid: staid
stain: stain,stained
staining: staining
stair: stair,stairs
staircase: staircase,staircases
stake: stake,stakes
stalwart: stalwart
stammer: stammered
stamp: stamped,stamping
stand: stand,standing,stands,stood
standard: standard
standing: standing
star: star,stars
stare: stare,stared,staring
starer: starers
stark: stark
starlight: starlight
start: start,started,starting
starting: starting
startle: startled,startles
startled: startled
starve: starved,starving
stateliness: stateliness
stately: stately
statement: statement,statements
station: station,stationed
statue: statue,statues
stature: stature
status: status
staunch: staunch
stave: staves
stay: stay,stayed,staying
stead: stead
steadfastly: steadfastly
steadfastness: steadfastness
steadily: steadily
steady: steady
steal: stealing,stole,stolen
stealth: stealth
stealthily: stealthily
steam: steamed,steaming
steel: steel,steeling
steep: steep,steeped,steeper,steepest,steeping
steeple: steeple
steepness: steepness
steering: steering
stem: stem
stench: stench
step: step,stepped,steps
stern: stern
sterner: sterner
sternly: sternly
stew: stew
stick: stick,sticking,stuck
stiff: stiff
stiffen: stiffening
stifle: stifled
stillness: stillness
stilton: stilton
stimulate: stimulate,stimulating
sting: stung
stink: stinking
stint: stint
stipulation: stipulations
stir: stir,stirred,stirring
stitch: stitches
stock: stock
stockade: stockades
stocking: stockings
stolid: stolid
stomach: stomachs
stone: stone,stones
stony: stony
stool: stool
stoop: stooped,stooping
stoppage: stoppage,stoppages
stopper: stoppers
store: store,stored,stores
storm: storm,stormed,storms
stormy: stormy
story: stories,story
stout: stout
stow: stowed
straggle: straggling
straight: straight
straightforward: straightforward
straightway: straightway
strain: strain,strained,straining
strained: strained
strait: strait
strand: strand
strange: strange,strangest
strangely: strangely
stranger: stranger,strangers
strangle: strangled
strap: strap
straw: straw
stray: stray,strayed,straying
streak: streak,streaks
stream: stream,streaming,streams
streaming: streaming
street: street,streets
strength: strength
strengthen: strengthen,strengthened
stress: stress
stretch: stretch,stretched,stretching
strew: strew,strewn
stricken: stricken
strict: strict
stride: striding
strife: strife
strike: strike,strikes,striking,struck
striking: striking
strikingly: strikingly
string: string,stringing,strings,strung
strip: strip,stripped,strips
strive: striven,striving,strove
striving: strivings
stroke: stroke
stroll: stroll,strolled,strolling
strong: strong,stronger,strongest
struck: struck
structure: structure
struggle: struggle,struggled,struggles,struggling
stuart: stuart
stubble: stubble
stubbornness: stubbornness
stuck: stuck
student: student,students
studious: studious
study: studied,study,studying
stuff: stuff,stuffed
stumble: stumbled,stumbling
stun: stunned
stupefied: stupefied
stupidly: stupidly
stupor: stupor
style: style
subdue: subdued
subdued: subdued
subject: subject,subjects
sublime: sublime
sublimer: sublimer
submerge: submerged
submission: submission
submissive: submissive
submit: submit,submitted,submitting
subordinate: subordinates
subornation: subornation
subscribe: subscribe
subside: subsided
substance: substance
substantial: substantial
substantive: substantive
substitute: substitute,substitutes,substituting
substratum: substratum
subtle: subtle
suburb: suburb
succeed: succeed,succeeded
success: success
succession: succession
successor: successor
succour: succour
suck: suck,sucked,sucking
suction: suction
sudden: sudden
suddenly: suddenly
suddenness: suddenness
suffer: suffer,suffered
sufferer: sufferer,sufferers
suffering: suffering,sufferings
sufficient: sufficient
suffocate: suffocated
suffocation: suffocation
sugar: sugar
suggestion: suggestion,suggestions
suicidal: suicidal
suit: suit,suited,suits
suitable: suitable
suitably: suitably
suite: suite
suitor: suitor
sulky: sulky
sullen: sullen
sullenly: sullenly
sulphur: sulphur
sultry: sultry
sum: sum,summed
summer: summer
summit: summit,summits
summon: summon,summoned
summons: summons
sumptuous: sumptuous
sun: sun
sunburnt: sunburnt
sunday: sunday
sundays: sundays
sundry: sundry
sunflower: sunflower
sunken: sunken
sunlight: sunlight
sunny: sunny
sunrise: sunrise
sunset: sunset
sunshine: sunshine
superb: superb
superciliously: superciliously
superintendence: superintendence
superior: superior
superiority: superiority
superlative: superlative
supernatural: supernatural
supernaturally: supernaturally
superscribe: superscribed
supersede: superseded
superstition: superstition
superstitious: superstitious
supervise: supervised
supper: supper,suppers
supple: supple
supplementary: supplementary
suppliant: suppliant
supplicate: supplicate
supplication: supplication
supplicatory: supplicatory
supply: supplied,supplies,supply
support: support,supported,supporting
suppose: suppose,supposed,supposing
supposition: supposition
suppress: suppressed
suppression: suppression
supreme: supreme
surely: surely
surf: surf
surface: surface,surfaces
surge: surge,surging
surgeon: surgeon
surmise: surmise
surmount: surmounted
surname: surname
surprise: surprise,surprised,surprises
surprised: surprised
surprising: surprising
surprisingly: surprisingly
surrender: surrender,surrendered
surround: surrounded,surrounding
survey: survey,surveyed,surveying
survive: survive,surviving
susceptibility: susceptibility
suspect: suspect,suspected
suspected: suspected
suspend: suspended
suspense: suspense
suspicion: suspicion,suspicions
suspicious: suspicious
sustain: sustain,sustained
sustaining: sustaining
swallow: swallow,swallowed,swallowing
swamp: swamp,swamped
swarm: swarmed,swarming
swart: swart
swarthy: swarthy
sway: swaying
swear: swear,swearing,swore,sworn
swearer: swearers
swearing: swearing
sweat: sweat
sweaty: sweaty
sweep: sweep,sweeps,swept
sweet: sweet,sweetest
sweetly: sweetly
swell: swell,swelled,swelling,swells,swollen
swift: swift
swiftly: swiftly
swing: swing,swung
swinging: swinging
swollen: swollen
swoon: swoon,swooned,swoons
swoop: swooped,swooping
sword: sword,swords
syd: syd
sydney: sydney
syllable: syllable,syllables
symbol: symbols
symbolical: symbolical
sympathise: sympathise,sympathised
sympathy: sympathy
symptom: symptoms
synonymous: synonymous
systematically: systematically
table: table,tables
taciturn: taciturn
tackle: tackle
tact: tact
tactician: tactician
tail: tail,tails
taint: taint,tainted
tainted: tainted
takin: takin
tale: tale
talent: talents
talisman: talisman
talk: talk,talked,talking
talker: talkers
tall: tall
tame: tame,tamed
tamper: tamper
tangle: tangle
tannery: tanneries,tannery
tap: tapped,tapping
tarnish: tarnish
task: task
taste: taste,tasted,tastes
tattered: tattered
tatters: tatters
tavern: tavern
tax: tax,taxed,taxes,taxing
taxer: taxers
taxing: taxing
tea: tea
teaboard: teaboard
teach: taught,teach
teacher: teacher
team: team
tear: tear,tearing,tears,tore,torn
tedious: tedious
teem: teems
telegraph: telegraph
telling: telling
temper: temper
temperament: temperament
tempest: tempest
temple: temple
temporarily: temporarily
temporary: temporary
tempt: tempt,tempted
tempter: tempter
tenacity: tenacity
tenant: tenant,tenants
tend: tend,tended,tending
tendency: tendency
tender: tender
tenderer: tenderer
tenderly: tenderly
tenderness: tenderness
tenth: tenth
tergiversation: tergiversation
term: term,terms
terminate: terminate,terminated
terrace: terrace,terraces
terrestrial: terrestrial
terrible: terrible
terrific: terrific
terrified: terrified
terrify: terrified
terror: terror,terrors
testament: testaments
testify: testified,testify
testimony: testimony
tether: tethered
texture: texture
thames: thames
thankful: thankful
thankless: thankless
thatch: thatched
theatre: theatre,theatres
theatrical: theatrical
thee: thee
theme: theme
thenceforth: thenceforth
theophile: theophile
theory: theory
thereabout: thereabouts
thicken: thicken,thickened
thickness: thickness
thief: thief,thieves
thine: thine
thinking: thinking
thinness: thinness
thinning: thinning
thirdly: thirdly
thirst: thirst
thirsting: thirsting
thirsty: thirsty
thorn: thorns
thoroughfare: thoroughfare,thoroughfares
thoughtful: thoughtful
thoughtfully: thoughtfully
thread: thread,threaded
threat: threat
threaten: threatened,threatening
threatening: threatening
threescore: threescore
threshold: threshold
thrice: thrice
thrift: thrift
thrill: thrill,thrilled
thrive: thrive
throat: throat,throats
throne: throne
throng: throng,thronging
throttle: throttle,throttled
throw: threw,throw,throwing,thrown,throws
thrust: thrust
thumb: thumb,thumbs
thump: thump
thunder: thunder,thundered,thundering
thy: thy
tick: ticking
tickle: tickle
tide: tide,tides
tiding: tidings
tie: tie,tied,ties,tying
tiger: tiger
tigerish: tigerish
tight: tight,tighter
tightly: tightly
tigress: tigress
tile: tile,tiled
tiller: tillers
timber: timber
time: time,timed,times
timely: timely
timid: timid
timidity: timidity
timidly: timidly
timorous: timorous
tinder: tinder
tinge: tinged
tiny: tiny
tiptoe: tiptoe
tired: tired
tiresome: tiresome
tissue: tissue
title: title
toast: toast,toasts
tobacco: tobacco
tocsin: tocsin
toe: toes
toil: toil,toiled
toilet: toilet
toilette: toilette,toilettes
tolerable: tolerable
tolerate: tolerate,tolerated
tom: tom
tomb: tomb
tomorrow: tomorrow
tone: tone,toned,tones
tongue: tongue,tongues
tool: tools
tooth: teeth
toothache: toothache
toothpick: toothpick
topic: topic,topics
topmost: topmost
torch: torch,torches
torment: torment
torn: torn
tortuous: tortuous
torture: torture,tortured,tortures
tortured: tortured
toss: tossed,tossing
total: total
totally: totally
touch: touch,touched,touches,touching
touching: touching
tow: towed
towel: towel,towels
towelling: towelling
tower: tower,towers
town: town,towns
townspeople: townspeople
toy: toy
trace: trace,traced,traces,tracing
track: track,tracked,tracks
trade: trade,trades
trademark: trademark
tradesman: tradesman,tradesmen
tradesmen: tradesmen
trading: trading
traffic: traffic
trafficker: trafficker,traffickers
trail: trailing
train: train
training: training
traitor: traitor
traitorous: traitorous
traitorously: traitorously
tramp: tramp,tramping
trample: trampled
tranquil: tranquil
tranquilly: tranquilly
transact: transact,transacted
transaction: transactions
transcribe: transcribe
transcription: transcription
transfer: transferred
transformation: transformation,transformations
transition: transition
transitory: transitory
translator: translator
transmutation: transmutation
transparent: transparent
transparently: transparently
transport: transport
trap: trap,traps
trappings: trappings
travel: travel,travelled,travelling
traveller: traveller,travellers
travelling: travelling
traverse: traversed,traversing
tray: tray
treacherous: treacherous
treachery: treachery
tread: tread,trod
treading: treading
treason: treason
treasonable: treasonable
treasure: treasure
treat: treated
treatment: treatment
treble: treble
trebly: trebly
tree: tree,trees
tremble: tremble,trembled,trembling
tremendous: tremendous
tremulous: tremulous
tremulously: tremulously
trench: trenches
trenchant: trenchant
trepidation: trepidation
trial: trial,trials
tribe: tribe
tribunal: tribunal
tribunals: tribunals
trick: tricks
trickle: trickled
trident: trident
trifle: trifle,trifles
trifling: trifling
trim: trim,trimming
trimming: trimming
trinket: trinkets
trip: trip
triumph: triumph,triumphs
triumphant: triumphant
triumvirate: triumvirate
trivial: trivial
trod: trod
trodden: trodden
troop: trooping
troops: troops
trot: trot,trotted,trotting
trouble: trouble,troubled,troubles,troubling
troubled: troubled
troublesome: troublesome
trudge: trudged
true: true,truest
trust: trust,trusted,trusting
trusted: trusted
trustee: trustee,trustees
trustfulness: trustfulness
trustworthy: trustworthy
trusty: trusty
truth: truth
truthfully: truthfully
tst: tst
tuesday: tuesday
tumble: tumbled,tumbling
tumbril: tumbril,tumbrils
tumult: tumult
tumultuous: tumultuous
tune: tune
turban: turban
turbid: turbid
turbulent: turbulent
turbulently: turbulently
turkey: turkey
turnkey: turnkey,turnkeys
tut: tut
tutor: tutor
twentieth: twentieth
twilight: twilight
twin: twin
twine: twined
twinkle: twinkle,twinkled,twinkling
twinkling: twinkling
twist: twist,twisted
twitching: twitching
twopence: twopence
tyburn: tyburn
type: types
typify: typified
tyranny: tyranny
tyrant: tyrant,tyrants
ubiquitous: ubiquitous
ud: ud
ugh: ugh
ugliness: ugliness
ugly: uglier,ugly
ultimate: ultimate
unable: unable
unaccountable: unaccountable
unaccountably: unaccountably
unaccused: unaccused
unaccustomed: unaccustomed
unacquainted: unacquainted
unaltered: unaltered
unanimously: unanimously
unattainable: unattainable
unattended: unattended
unavailing: unavailing
unavenged: unavenged
unbarred: unbarred
unbearable: unbearable
unbecoming: unbecoming
unbeliever: unbeliever
unbelieving: unbelieving
unbent: unbent
unbidden: unbidden
unblushing: unblushing
unborn: unborn
unbrutalised: unbrutalised
unbuilt: unbuilt
uncarpeted: uncarpeted
unceasingly: unceasingly
uncertain: uncertain
uncertainty: uncertainties,uncertainty
unchangeable: unchangeable
unchanged: unchanged
uncle: uncle
uncleansed: uncleansed
unclose: unclosed
uncomfortable: uncomfortable
uncomfortably: uncomfortably
uncommon: uncommon
uncomplaining: uncomplaining
uncompromising: uncompromising
unconnected: unconnected
unconscious: unconscious
unconsciously: unconsciously
unconsciousness: unconsciousness
uncontrollable: uncontrollable
uncorrupted: uncorrupted
undergo: undergo,undergone,underwent
undergraduate: undergraduates
underground: underground
understand: understand,understanding,understood
understanding: understanding
undertake: undertake,undertook
undertaker: undertakers
undertaking: undertaking
undeserved: undeserved
undeserving: undeserving
undirected: undirected
undisclosed: undisclosed
undiscovered: undiscovered
undisguised: undisguised
undistinguishable: undistinguishable
undisturbed: undisturbed
undoubted: undoubted
undoubtedly: undoubtedly
undress: undressing
undug: undug
undutiful: undutiful
unearthly: unearthly
uneasily: uneasily
uneasiness: uneasiness
uneasy: uneasy
unencumbered: unencumbered
unenforceability: unenforceability
unenlightened: unenlightened
unequal: unequal
uneven: uneven
unexpected: unexpected
unexpectedly: unexpectedly
unexplained: unexplained
unfailing: unfailing
unfair: unfair
unfashionable: unfashionable
unfasten: unfastened
unfathomable: unfathomable
unfathomed: unfathomed
unfavourable: unfavourable
unfeeling: unfeeling
unfinished: unfinished
unfit: unfit
unforeseen: unforeseen
unformed: unformed
unfortunate: unfortunate
unfounded: unfounded
unfrequently: unfrequently
unfruitful: unfruitful
ungenerous: ungenerous
ungently: ungently
unglaze: unglazed
unglazed: unglazed
ungrateful: ungrateful
unhandsomely: unhandsomely
unhappily: unhappily
unhappy: unhappy
unhardened: unhardened
unhealthy: unhealthy
unheard: unheard
unheeded: unheeded
uniform: uniform
uniformity: uniformity
uniformly: uniformly
unimagined: unimagined
unimpaired: unimpaired
unimpeachable: unimpeachable
unintelligible: unintelligible
uninvited: uninvited
unison: unison
unit: units
unite: united
united: united
universal: universal
universe: universe
unjust: unjust
unjustly: unjustly
unkempt: unkempt
unkind: unkind
unknown: unknown
unlawful: unlawful
unlink: unlink
unluckily: unluckily
unlucky: unlucky
unmixed: unmixed
unmoved: unmoved
unnatural: unnatural
unnaturally: unnaturally
unnecessarily: unnecessarily
unnecessary: unnecessary
unopened: unopened
unornamental: unornamental
unpopular: unpopular
unpopularity: unpopularity
unprecedented: unprecedented
unprepared: unprepared
unpromising: unpromising
unprosperous: unprosperous
unprotected: unprotected
unquestionably: unquestionably
unreal: unreal
unreality: unreality
unreasonable: unreasonable
unrelenting: unrelenting
unreserved: unreserved
unreservedly: unreservedly
unrobed: unrobed
unruly: unruly
unsafe: unsafe
unscrupulous: unscrupulous
unseen: unseen
unselfish: unselfish
unselfishness: unselfishness
unsettled: unsettled
unshade: unshaded
unshaken: unshaken
unshaped: unshaped
unsolicited: unsolicited
unspeakable: unspeakable
unsteadily: unsteadily
unsteady: unsteady
unsubstantial: unsubstantial
unsuccessful: unsuccessful
unsuitable: unsuitable
unsuspicious: unsuspicious
unswallowed: unswallowed
untidy: untidy
untimely: untimely
untiring: untiring
untold: untold
untouched: untouched
untracked: untracked
untrimmed: untrimmed
untroubled: untroubled
unusual: unusual
unusually: unusually
unwholesome: unwholesome
unwholesomely: unwholesomely
unwilling: unwilling
unwillingly: unwillingly
unwillingness: unwillingness
unwonted: unwonted
unworthily: unworthily
unyoke: unyoked
update: updated
upheaving: upheaving
uphold: uphold
upholsterer: upholsterers
uplift: uplifted
upper: upper
uppermost: uppermost
upright: upright
uproar: uproar
upshot: upshot
upstairs: upstairs
upturning: upturning
upward: upward
urchin: urchin
urge: urge,urged,urging
urgent: urgent
urn: urns
usage: usage
useless: useless
user: user
usual: usual
ut: ut
utmost: utmost
utter: utter,uttered,uttering
utterance: utterance
utterer: utterer
utterly: utterly
vacant: vacant
vacantly: vacantly
vacation: vacation
vagabond: vagabond
vagrancy: vagrancy
vague: vague
vaguely: vaguely
vain: vain,vainest
vainly: vainly
valet: valet
valise: valise
valuable: valuable
vanilla: vanilla
vanish: vanished
vanity: vanities,vanity
vapour: vapour,vapouring
vapouring: vapouring
vapours: vapours
variation: variation
variety: varieties,variety
variously: variously
vary: varying
vassal: vassal
vast: vast
vault: vaulted,vaults
vaunt: vaunting
vaunted: vaunted
vauxhall: vauxhall
vegetable: vegetable
vegetate: vegetating
vehemence: vehemence
vehement: vehement
vehicle: vehicle,vehicles
veil: veil
vein: veins
veinous: veinous
vendor: vendor
venerable: venerable
vengeance: vengeance
venture: ventured
verbal: verbal
verdict: verdict
verge: verging
vermin: vermin
versailles: versailles
version: version
vessel: vessel,vessels
vestige: vestige
vex: vexed
vexation: vexation
viand: viands
vice: vice,vices
vicious: vicious
victim: victim,victims
victorious: victorious
victory: victory
vie: vied
view: view,viewed,viewing,views
vigilance: vigilance
vigilant: vigilant
vigorous: vigorous
vigour: vigour
vii: vii
viii: viii
vile: vile,vilest
village: village,villages
villager: villagers
villain: villain
villainy: villainy
ville: ville
vindicate: vindicating
vinegar: vinegar
vineyard: vineyards
vinous: vinous
violate: violates
violence: violence
violent: violent
violently: violently
virtually: virtually
virtue: virtue,virtues
virtuous: virtuous
virus: virus
visage: visage,visages
visible: visible
visibly: visibly
vision: vision
visit: visit,visited
visitation: visitation
visitor: visitor,visitors
vista: vista
vivacious: vivacious
vivacity: vivacity
vivid: vivid
vividly: vividly
vociferate: vociferating
vogue: vogue
voice: voice,voices
void: void
volley: volleys
voluble: voluble
voluntarily: voluntarily
voluntary: voluntary
volunteer: volunteer,volunteers
voluptuous: voluptuous
vortex: vortex
vote: vote,voted,votes
vow: vow
voyage: voyage
vulgar: vulgar
wager: wager
wages: wages
waif: waifs
wail: wail,wailing
waist: waist
waistband: waistband
waistcoat: waistcoat
wait: wait,waited,waiting
waiter: waiter,waiters
waiting: waiting
wake: wake,waking
waken: wakened
wales: wales
walk: walk,walked,walking,walks
walking: walking
wall: wall,walls
walnut: walnut
wander: wander,wandered,wandering
wanderer: wanderer
wane: waning
wantonly: wantonly
war: war,wars
warble: warbled
ward: ward
warehouse: warehouses
warm: warm,warmed,warmer,warming
warmly: warmly
warmth: warmth
warn: warned
warning: warning,warnings
warped: warped
warranty: warranties,warranty
wary: wary
wash: washed,washing
washington: washington
waste: waste,wasted
watch: watch,watched,watches,watching
watchful: watchful
watchfully: watchfully
watchfulness: watchfulness
watching: watching
watchman: watchman,watchmen
watchtower: watchtower
water: water,waters
waterfall: waterfalls
waterspout: waterspout
watery: watery
wave: wave,waved,waves
wax: wax
wayfarer: wayfarer
waylay: waylaid
wayside: wayside
weak: weak,weaker,weakest
weaken: weaken,weakened
weakness: weakness,weaknesses
weapon: weapon,weapons
wear: wear,wearing,wore,worn
wearer: wearer
weary: wearied,weary
weather: weather,weathers
weave: weaving,woven
wednesday: wednesday
weed: weeds
week: week,weeks
weekly: weekly
weep: weep,weeping,wept
weigh: weigh,weighs
weight: weight
weird: weird
wend: wending
west: west
westminster: westminster
westward: westward
wet: wet,wetted
whatsoever: whatsoever
wheat: wheat
wheel: wheel,wheeled,wheels
whereat: whereat
whereof: whereof
whereunto: whereunto
whet: whet
whew: whew
whiff: whiffed
whimper: whimpering
whip: whip,whips
whipping: whipping
whirl: whirled,whirling
whirlpool: whirlpool
whirr: whirrs
whisper: whisper,whispered,whispering,whispers
whistle: whistled,whistling
white: white,whiter
whiteness: whiteness
whitewash: whitewashed
wholesale: wholesale
wholesome: wholesome
wholly: wholly
whoop: whoop
whosoever: whosoever
wick: wicks
wicked: wicked
wickedly: wickedly
wickedness: wickedness
wicket: wicket
wide: wide,wider,widest
widespread: widespread
widow: widow
widowhood: widowhood
wielder: wielders
wife: wife,wives
wig: wig,wigged,wigs
wigged: wigged
wild: wild
wilderness: wilderness
wildest: wildest
wildly: wildly
wildness: wildness
wilfully: wilfully
willingly: willingly
win: win,winning
winch: winches
wind: wind,winding,winds,wound
windmill: windmill
window: window,windows
windy: windy
wine: wine
wing: wing,wings
wink: wink,winking
winnowing: winnowing
winter: winter
wintry: wintry
wipe: wipe,wiped,wiping
wiry: wiry
wisdom: wisdom
wise: wise,wiser,wisest
wisely: wisely
wistfully: wistfully
wit: wit
withal: withal
withdraw: withdrawing,withdrawn,withdraws,withdrew
wither: wither,withered
withered: withered
withhold: withheld
witness: witness,witnessed,witnesses
wo: wos
woe: woe
wolf: wolf
wolfishly: wolfishly
woman: woman,women
womanly: womanly
wonderful: wonderful
wood: wood,woods
wooden: wooden
woodman: woodman
woollen: woollen
word: word
worker: workers
workings: workings
workman: workman,workmen
workshop: workshop
worldly: worldly
worm: worm
wormy: wormy
worn: worn
worried: worried
worry: worried
worshipper: worshippers
worth: worth
worthless: worthless
worthlessness: worthlessness
worthy: worthier,worthy
wot: wot
wouldst: wouldst
wound: wound,wounded,wounds
wounded: wounded
wow: wows
wrap: wrap,wrapped
wrapper: wrapper,wrappers
wrapping: wrappings
wrath: wrath
wrathfully: wrathfully
wreak: wreaking
wreath: wreaths
wreck: wreck,wrecked,wrecks
wrench: wrench
wrest: wrested
wretch: wretch,wretches
wretched: wretched
wretchedest: wretchedest
wretchedly: wretchedly
wring: wring,wrung
wringing: wringing
wrist: wrist,wrists
write: write,writing,written,wrote
writer: writer
writing: writing
wrong: wrong,wronged,wrongs
wrongfully: wrongfully
wrung: wrung
xi: xi
xii: xii
xiii: xiii
xiv: xiv
xix: xix
xvi: xvi
xvii: xvii
xviii: xviii
xx: xx
xxi: xxi
xxii: xxii
xxiii: xxiii
xxiv: xxiv
yah: yah
yard: yard,yards
yawn: yawned
yearn: yearned
yearning: yearning
yell: yells
yellow: yellow
yesterday: yesterday
yield: yield,yielded,yielding
yo: yo
yoke: yoked
yonder: yonder
yore: yore
yourn: yourn
youth: youth,youths
youthful: youthful
youthfulness: youthfulness
zealous: zealous
