abandon: abandon,abandoned
abandonment: abandonment
abate: abate
abe: abe
abide: abide
ability: ability
ablaze: ablaze
abode: abodes
abomination: abomination
abortive: abortive
abound: abound,abounded
abreast: abreast
abruptly: abruptly
absence: absence
absent: absent
absentee: absentee
absolute: absolute
absolutely: absolutely
absorb: absorb,absorbed,absorbing,absorbs
abundance: abundance
abundant: abundant
abuse: abuse
abused: abused
abutment: abutments
accept: accept,accepted,accepting,accepts
acceptance: acceptance
access: access
accident: accident
accidental: accidental
accommodate: accommodate,accommodated,accommodates
accommodation: accommodation,accommodations
accompany: accompanied
accomplish: accomplish,accomplished
accord: accord,accorded
accost: accosted
account: account,accounted,accounting,accounts
accountability: accountability
accounting: accounting
accumulate: accumulating
accurate: accurate
accursed: accursed
accusation: accusation
accuse: accused
accuser: accuser
achieve: achieve,achieved
achievement: achievements
acid: acid
acknowledge: acknowledging
acme: acme
acquaintance: acquaintance,acquaintances
acquire: acquire,acquired
acre: acre,acres
action: action
active: active
activity: activity
actual: actual
adapt: adapt,adapted,adapts
adaptability: adaptability
add: add,adding,adds
addict: addicted
addition: addition
additional: additional
address: address,addressed
adept: adept
adequate: adequate
adjoin: adjoining
adjoining: adjoining
adjourn: adjourns
admirable: admirable
admiration: admiration
admire: admiring
admission: admission,admissions
admit: admit,admits,admitted
adopt: adopt,adopts
adoption: adoption
adorn: adorn
adornment: adornments
adult: adult,adults
advance: advance,advanced,advancing
advancement: advancement
advantage: advantage,advantages
advent: advent
adventurer: adventurers
adventurous: adventurous
advertise: advertise
advertising: advertising
advice: advice
advisable: advisable
advisedly: advisedly
advocate: advocate
affair: affair,affairs
affection: affection,affections
affinity: affinity
affirm: affirm
afflict: afflicted
affliction: afflictions
afford: afford,affords
affray: affray,affrays
afraid: afraid
africa: africa
african: african
afternoon: afternoon
afterward: afterward
age: age,ages
aged: aged
agency: agencies,agency
agent: agent,agents
ages: ages
aggravate: aggravate
aggregate: aggregating
aggressive: aggressive
aghast: aghast
agin: agin
agitator: agitator,agitators
agony: agony
agree: agree,agreeing
agreement: agreement
aid: aid
aim: aim,aimed,aims
aimless: aimless
air: air
akin: akin
alacrity: alacrity
alarm: alarm
alas: alas
albany: albany
alcoholic: alcoholic
alcove: alcove
alderman: alderman
aldermen: aldermen
ale: ale
alert: alert
alike: alike
alive: alive
allege: alleged
alleged: alleged
allegiance: allegiance
allen: allen
alleviate: alleviate
alley: alley,alleys
allot: allotting
allotment: allotment
allowable: allowable
allowance: allowance
allude: alluded
ally: allied,allies,ally
almighty: almighty
almond: almond
almoner: almoner
alms: alms
almshouse: almshouse
altar: altar
alternative: alternative
altogether: altogether
amateur: amateur
amazement: amazement
amazingly: amazingly
amber: amber
ambition: ambition,ambitions
ambitious: ambitious
ambulance: ambulance
america: america
american: american
ammunition: ammunition
ample: ample
amply: amply
amusement: amusement
amusing: amusing
anarchism: anarchism
anarchist: anarchist,anarchists
anarchists: anarchists
ancient: ancient
angels: angels
anger: anger
angle: angle,angles
angry: angry
anguish: anguish
animal: animal,animals
ankle: ankle
ann: ann
annex: annex,annexed
annoyance: annoyance
annual: annual
annually: annually
annum: annum
answer: answer,answered,answering,answers
antagonism: antagonism
antecedent: antecedents
anticipate: anticipated
antonia: antonia
anxious: anxious
apartment: apartment,apartments
apex: apex
apiece: apiece
apologetically: apologetically
apologize: apologizing
apology: apology
apostle: apostles
appalling: appalling
apparent: apparent
appeal: appeal,appeals
appeals: appeals
appearance: appearance,appearances
appendix: appendix
appetite: appetite
appetizing: appetizing
applause: applause
apple: apple
application: application
apply: applied,apply,applying
appoint: appointed
apportion: apportioned
appreciable: appreciable
apprehension: apprehension
apprenticeship: apprenticeship
approach: approach,approached,approaching
appropriately: appropriately
appropriation: appropriation,appropriations
approval: approval
apron: apron,aprons
apt: apt
aptly: aptly
aqueduct: aqueduct
arab: arab,arabs
arabia: arabia
arbitrary: arbitrary
arbitration: arbitration
arched: arched
architectural: architectural
argue: argue,argues,arguing
argument: argument,arguments
aristocracy: aristocracy
aristocratic: aristocratic
arithmetic: arithmetic
arm: arm,arms
armed: armed
armful: armful
army: armies,army
arouse: aroused,arouses
arraign: arraigned
arraignment: arraignment
arrangement: arrangement
arrant: arrant
array: array
arrest: arrest,arrested,arresting,arrests
arrival: arrival,arrivals
art: art
article: article,articles
artificial: artificial
artisan: artisan
artist: artist
artlessly: artlessly
ascribe: ascribed
ash: ash,ashes
ashore: ashore
asleep: asleep
aspect: aspect
aspiration: aspiration
aspire: aspiring
assault: assault,assaults
assert: assert,asserts
assertion: assertion,assertions
assign: assigns
assimilation: assimilation
assist: assisted
assistance: assistance
associate: associates,associating
association: association,associations
assorted: assorted
assume: assume,assumed,assumes,assuming
assumption: assumption
assurance: assurance
assure: assured,assuring
assuredly: assuredly
astonished: astonished
astonishing: astonishing
astonishment: astonishment
astor: astor
astray: astray
asylum: asylum,asylums
athwart: athwart
atlantic: atlantic
atmosphere: atmosphere
atonement: atonement
atrocious: atrocious
attach: attached,attaches
attachment: attachment
attack: attack,attacked
attain: attain,attained,attaining
attainment: attainments
attempt: attempt,attempted,attempts
attend: attend,attended,attending
attendance: attendance
attendant: attendant
attention: attention
attentively: attentively
attic: attic
attire: attire
attitude: attitude
attract: attract,attracting,attracts
attribute: attribute
attuned: attuned
audience: audience
augur: augurs
august: august
auspices: auspices
author: author
authority: authorities,authority
autocratic: autocratic
avail: avail,availed
avarice: avarice
avenge: avenge,avenging
avenue: avenue,avenues
avenues: avenues
aver: aver
average: average,averaged,averages,averaging
avert: averted
avoid: avoid,avoided
await: await,awaited,awaiting,awaits
awake: awake
awaken: awaken
awakening: awakening
award: awarded
aware: aware
awful: awful
awkward: awkward
axe: axe
aye: aye
babble: babbling
babe: babe,babes
babel: babel
baby: babies,baby
backbone: backbone
backer: backer,backers
background: background
backsliding: backsliding
bad: bad,worse,worst
badge: badge
badly: badly
baffle: baffling
bag: bag,bags
baggage: baggage
bailiwick: bailiwick
bait: bait
bake: baked
baked: baked
baker: baker
bakery: bakeries
balance: balance,balanced
bald: bald
ball: ball
ballot: ballot
ban: ban
banana: banana
band: band,bands
bandage: bandage
bandanna: bandanna,bandannas
bandit: bandit,bandits
bandits: bandits
banish: banish,banished,banishes
bank: bank,banks
banker: banker,bankers
bankrupt: bankrupt
baptist: baptist
bar: bar,barred,barring,bars
barbarian: barbarian
barbarism: barbarism
barber: barber
bare: bare
barely: barely
bargain: bargain,bargaining
bargaining: bargaining
barge: barge
barkeeper: barkeeper
barometer: barometer
baron: baron
barrack: barrack
barracks: barracks
barrel: barrel,barrels
barren: barren
barrier: barrier,barriers
barrow: barrow
bartender: bartender
barter: barter,bartered
base: base,based
basement: basement,basements
basis: basis
basket: basket,baskets
basketful: basketful
baste: basted
basting: basting
bat: bats
batch: batch,batches
bath: baths
battalion: battalions
battery: battery
battle: battle,battles
baxter: baxter
bay: bay
bayard: bayard
bead: beads
beam: beams
bean: bean,beans
bear: bear,bearing,bears,bore,born,borne
beard: beard
bearing: bearing
beast: beast,beasts
beat: beat,beaten,beating,beats
beating: beating
beau: beau
beautiful: beautiful
beauty: beauty
beckon: beckons
bed: bed,beds
bedroom: bedroom,bedrooms
bedside: bedside
bedtime: bedtime
bee: bee
beef: beef
beer: beer
befitting: befitting
beg: beg,begged,begging,begs
beget: begat,begotten
beggar: beggar,beggars
beggary: beggary
begrime: begrimed
behalf: behalf
behave: behave,behaves
behold: behold
belated: belated
beldame: beldame
belief: belief
believer: believer
bell: bell,bells
bellevue: bellevue
belong: belong,belonged,belongs
belongings: belongings
beloved: beloved
belt: belt,belts
bench: bench,benches
bend: bend,bending,bent
beneath: beneath
benefaction: benefactions
beneficent: beneficent
benefit: benefit
benevolent: benevolent
bent: bent
berth: berth,berths
beset: beset
bespeak: bespoke
bestow: bestow
betake: betake
betray: betray,betraying,betrays
bewilder: bewildering
bewildering: bewildering
bid: bade
bidder: bidder
bide: bides
bier: bier
bigotry: bigotry
bin: bin
bind: binds,bound
bird: bird,birds
birth: birth
bit: bit
bite: bite,biting
bitter: bitter
bitterness: bitterness
black: black,blacking,blacks
blacker: blacker
blacklist: blacklist
blackmail: blackmailing
blacksmith: blacksmith
blade: blade
blake: blake
blame: blame,blamed
blank: blank
blanket: blanket,blankets
blast: blasted
blazes: blazes
blessing: blessing,blessings
blight: blighted,blighting
blind: blind,blinded,blinding
blindly: blindly
blindman: blindman
bliss: bliss
blithesome: blithesome
block: block,blocked,blocks
blood: blood
bloody: bloody
blossom: blossom
blot: blots,blotting
blotting: blotting
blouse: blouse
bloused: bloused
blow: blow,blowing,blows
blue: blue,bluest,bluing
bluff: bluff
blur: blurring
board: board,boards
boarder: boarder,boarders
boarding: boarding
boast: boast,boasted,boasts
boat: boat,boats
bode: bodes
bodied: bodied
bodily: bodily
body: bodies,body
bogus: bogus
bohemia: bohemia
bohemian: bohemian
bohemians: bohemians
boil: boiling
boiler: boiler,boilers
boisterous: boisterous
bold: bold,boldest
boldly: boldly
boldness: boldness
bolt: bolt
bond: bonds
bondage: bondage
bone: bone,bones
boodle: boodle
book: book,books
bookbinding: bookbinding
boot: boot,boots
booth: booths
border: borders
borderland: borderland
borrow: borrow,borrowed
bosom: bosom
boss: boss,bosses
boston: boston
bother: bother,bothers
bottle: bottle
bound: bound
boundary: boundaries,boundary
bounty: bounty
bow: bow
bowels: bowels
bower: bower
bowery: bowery
bowl: bowl
bowlder: bowlder
box: box,boxes
boxing: boxing
boy: boy,boys
boyhood: boyhood
braid: braided
brain: brain,brains
branch: branch
brand: brand
brass: brass
bravado: bravado
brave: brave,braved
brawny: brawny
bread: bread
break: break,breaks,broke,broken
breaker: breakers
breakfast: breakfast
breast: breast,breasts
breath: breath
breathe: breathe,breathed,breathes
breathing: breathing
breed: bred,breed,breeding
breeze: breeze
brethren: brethren
brew: brewed
brewer: brewer
brewery: brewery
brick: brick,bricks
bridal: bridal
bridge: bridge,bridges,bridging
brigade: brigades
bright: bright,brighter,brightest
brighten: brightened
brightness: brightness
brim: brim
bring: bring,bringing,brings,brought
brink: brink
brisk: brisk
broad: broad
broadly: broadly
broadway: broadway
brogue: brogue
broken: broken
broker: broker
brood: brood
brooklyn: brooklyn
broom: broom
broth: broth
brother: brother,brothers
brow: brow,browed
brown: brown
bruise: bruised,bruises
bruiser: bruiser
brush: brush
brutal: brutal
brutality: brutality
brute: brutes
buckle: buckle,buckled
bug: bugs
build: build,building,builds,built
builder: builder,builders
building: building,buildings
bulge: bulges
bulk: bulk
bullet: bullet
bully: bully
bulwark: bulwark
bum: bum
bump: bumped
bunco: bunco
bundle: bundle,bundles
bunk: bunk,bunks
bunks: bunks
burden: burden,burdens
bureau: bureau
burgher: burgher
burglar: burglar,burglars
burial: burial,burials
burn: burn,burned,burning
burning: burning
burrow: burrow,burrowed,burrowing,burrows
burst: burst
bury: buried,bury
burying: burying
business: business
bust: busted
bustle: bustle
busy: busied,busiest,busy,busying
butcher: butcher
butter: butter
button: button,buttons
buttonhole: buttonholes
buyer: buyer,buyers
byway: byways
cabal: cabal
cabalistic: cabalistic
cabbage: cabbage,cabbages
cain: cain
cake: cake
calculate: calculated
calculation: calculation,calculations
calico: calico
california: california
caller: callers
calling: calling
calm: calm
calmly: calmly
calmness: calmness
calvary: calvary
camera: camera
camp: camping
campaign: campaign
canal: canal,canals
candle: candle
candy: candy
cane: cane
canon: canon
canvas: canvas
canvass: canvass
cap: caps
capable: capable
capacity: capacity
cape: cape
capital: capital
capitalist: capitalists
caprice: caprice
captain: captain
captive: captive
capture: capture,captured
car: car
card: card,cards
cardinal: cardinal
care: care,cared,cares
career: career
careful: careful
carefully: carefully
careless: careless
cargo: cargo
carouse: carouse
carpenter: carpenters
carriage: carriage,carriages
carrier: carrier
carry: carried,carries,carry,carrying
carrying: carrying
cart: cart,carts
carve: carving
cash: cash
cashier: cashier
cast: cast,casts
caste: caste
castle: castle
cat: cat
catalogue: catalogue
catch: catch,caught
catechize: catechized
category: category
catholics: catholics
caucasian: caucasian,caucasians
caution: caution
cave: cave
cease: cease,ceased,ceases
cedar: cedar
ceiling: ceiling
celebrate: celebrate
celebrated: celebrated
celebration: celebration
celebrity: celebrities
celestial: celestial
cell: cell,cells
cellar: cellar,cellars
celt: celt
celtic: celtic
cemetery: cemetery
census: census
cent: cent,cents
centage: centage
central: central
centre: centre,centres
centurion: centurions
century: centuries,century
ceremonial: ceremonial
ceremony: ceremony
certificate: certificate
cessation: cessation
chaff: chaff
chain: chain,chained
chair: chair,chairs
chalk: chalking
challenge: challenge,challenged,challenges
champion: champion
chance: chance,chances
change: change,changed,changing
changing: changing
channel: channels
chapel: chapels
chaplain: chaplain
chapter: chapter
character: character,characters
characteristic: characteristic
characterize: characterized
charge: charge,charged,charges,charging
chariot: chariot
charitable: charitable
charitably: charitably
charities: charities
charity: charities,charity
charles: charles
chase: chased,chasing
chat: chatted
chattel: chattel
chatter: chatter
chay: chay
cheap: cheap,cheaper,cheapest
cheapness: cheapness
cheat: cheated
check: check
cheek: cheek
cheekily: cheekily
cheer: cheer
cheerful: cheerful
cheerfulness: cheerfulness
cheerless: cheerless
cheery: cheery
cherish: cherished
cherry: cherry
chew: chew
chicken: chicken,chickens
chief: chief
chiefly: chiefly
child: child,children
childhood: childhood
children: children
chill: chill
chilly: chilly
chimney: chimney
chin: chin
china: china
chinaman: chinaman
chinamen: chinamen
chinatown: chinatown
chinese: chinese
chip: chip,chipped
choice: choice
cholera: cholera
choose: choose,chooses,chose,chosen
christ: christ
christen: christened
christian: christian,christians
christianity: christianity
christmas: christmas
chronicle: chronicle
chum: chums
church: church,churches
churn: churning
chute: chute,chutes
cigar: cigar,cigars
cigarette: cigarette
circle: circle
circulation: circulation
circumstance: circumstance,circumstances
circumvent: circumventing
circus: circus
cite: cited
citizen: citizen,citizens
citizens: citizens
citizenship: citizenship
city: cities,city
civil: civil
civilization: civilization
clad: clad
claim: claim,claimed,claims
clammy: clammy
clamor: clamor
clamoring: clamoring
class: class,classed,classes
classification: classification
clatter: clatter
claw: claw
clay: clay
clean: clean,cleaner,cleaning
cleaner: cleaner
cleaning: cleaning
cleanliness: cleanliness
cleanly: cleanly
cleanse: cleansed
clergyman: clergyman,clergymen
clerk: clerk,clerks
cleveland: cleveland
clever: clever
clew: clew
climax: climax
climb: climb,climbed,climbing
clime: clime
clinch: clinch
cling: clung
clink: clink
cloak: cloak,cloaks
clock: clock
close: close,closed,closer,closes,closest,closing
closed: closed
closely: closely
closeness: closeness
closet: closets
closing: closing
cloth: cloth
clothe: clad,clothe
clothes: clothes
clothing: clothing
cloud: cloud
cloudless: cloudless
club: club,clubbed,clubs
clumsy: clumsy
cluster: cluster
clutch: clutch,clutches
coach: coach
coal: coal
coarse: coarse
coast: coast
coat: coat,coats
coax: coaxed
cobwebs: cobwebs
code: code
coerce: coerce
coffee: coffee
coffer: coffers
coffin: coffin,coffins
coin: coining,coins
coincidence: coincidence
cold: cold,coldest
collar: collar
collect: collect,collected,collecting
collective: collective
collector: collector
college: college
collins: collins
colonel: colonel
colonization: colonization
colony: colonies,colony
color: color,colored,colors
colored: colored
colossal: colossal
column: columns
combat: combat
combativeness: combativeness
combination: combination
combine: combine,combined
comely: comely
comer: comer
comfort: comfort,comforted,comforts
comfortable: comfortable
comfortably: comfortably
comic: comic
command: command
comment: comment,commented,commenting
commercial: commercial
commingling: commingling
commiseration: commiseration
commission: commission
commissioner: commissioners
commissioners: commissioners
commit: commit,committed,committing
commitment: commitment
committee: committee
commodity: commodity
common: common,commonest
commonly: commonly
commotion: commotion
communication: communication
community: communities,community
compact: compact
companion: companion
companionship: companionship
company: companies,company
comparative: comparative
comparatively: comparatively
compare: compared,comparing
comparison: comparison
compeer: compeers
compel: compel,compelled,compels
compelled: compelled
compelling: compelling
compensation: compensation
competent: competent
competition: competition
competitor: competitor
complacency: complacency
complain: complain,complained,complains
complainant: complainant
complaint: complaint,complaints
complement: complement
complete: complete,completing
completely: completely
compliment: compliment
comport: comports
compose: composed
compound: compound
comprise: comprising
compulsion: compulsion
computation: computation
comrade: comrades
conceal: conceal,conceals
conceive: conceive,conceived
concentration: concentration
conception: conception
concern: concern,concerned,concerns
concerned: concerned
concert: concerts
conclusion: conclusion
conclusive: conclusive
concoction: concoctions
concurrent: concurrent
condemn: condemned,condemns
condemnation: condemnation
condition: condition,conditions
conduct: conduct,conducting
conductor: conductors
conference: conference
confess: confess,confessed
confession: confession
confessor: confessor
confide: confided,confiding
confidence: confidence
confident: confident
confidently: confidently
confine: confined
confirm: confirmed
conflict: conflict,conflicts
conform: conforming
confound: confound,confounds
confront: confront,confronts
confuse: confused,confuses
confusion: confusion
congenial: congenial
congested: congested
conglomerate: conglomerate
congratulation: congratulation
congregate: congregate
congregation: congregation,congregations
congregational: congregational
congressional: congressional
conjecture: conjecture,conjectures
connect: connecting,connects
connection: connection
conscience: conscience
conscienceless: conscienceless
conscious: conscious
consecutively: consecutively
consent: consent
consequence: consequence
consequent: consequent
conservatism: conservatism
conservative: conservative
considerable: considerable
considerably: considerably
consist: consist,consisted,consists
consistent: consistent
consolation: consolation
conspicuous: conspicuous
conspicuously: conspicuously
conspiracy: conspiracy
constant: constant
constantly: constantly
constitute: constitute,constitutes
constitutional: constitutional
construct: construct,constructed
construction: construction
consult: consult
consume: consuming
consumer: consumer
consumption: consumption
contact: contact
contagion: contagion
contagious: contagious
contemplate: contemplated
contemporary: contemporary
contempt: contempt
content: content
contented: contented
contention: contention
contentious: contentious
contentment: contentment
contents: contents
contest: contest,contests
contested: contested
contiguous: contiguous
continental: continental
contingent: contingent
continual: continual
continually: continually
continue: continue,continued
continuous: continuous
contour: contour
contract: contract,contracts
contractor: contractor,contractors
contradiction: contradiction,contradictions
contrary: contraries,contrary
contrast: contrast,contrasted,contrasts
contribute: contributed,contributing
contribution: contributions
contrivance: contrivance
contrived: contrived
control: control
convenient: convenient
conveniently: conveniently
conventional: conventional
converge: converge
conversion: conversion
convert: converted,converting
convict: convict,convicted
conviction: conviction,convictions
convince: convince
convinced: convinced
cook: cook,cooked,cooking
cooking: cooking
cool: cooling
coolie: coolie
cooling: cooling
coop: coop,coops
cooper: cooper
cop: cops
copper: copper
copyright: copyright
cord: cords
core: core
corn: corn,corned
corner: corner,corners
cornered: cornered
cornice: cornice
coroner: coroner
corporation: corporations
corps: corps
corpse: corpse,corpses
corral: corral,corralled
correct: correct,corrected
correction: correction
correctly: correctly
correctness: correctness
correspond: corresponds
correspondent: correspondent
correspondingly: correspondingly
corrupt: corrupt,corrupted,corrupting,corrupts
corruption: corruption
cosmopolitan: cosmopolitan
cost: cost,costs
costly: costly
costume: costumes
cot: cot,cots
cottage: cottage,cottages
cotton: cotton
couch: couch
cough: cough
council: council,councils
counsellor: counsellor
count: count,counted,counting,counts
counter: counter,counters
counteract: counteract
counterbalance: counterbalance
counterpoise: counterpoise
country: country
countryman: countryman,countrymen
county: county
couple: couple,coupled
coupon: coupons
courage: courage
courageous: courageous
court: court,courts
courtesy: courtesy
cover: cover,covered,covering
covering: covering
cow: cow,cowed,cows
coward: coward
cowardly: cowardly
crack: crack,cracked,cracks
cracksman: cracksmen
cradle: cradle
crafty: crafty
crank: crank
cranny: cranny
crap: craps
crape: crape
craving: craving,cravings
crawl: crawl,crawling
crazy: crazy
creak: creaking
create: created,creating
creature: creature,creatures
credit: credit,credited
creed: creed
creep: creeping,crept
crew: crew
crib: crib
crime: crime,crimes
criminal: criminal,criminals
cripple: cripple,crippled,cripples
crippled: crippled
critic: critic
critical: critical
crook: crook,crooks
crooked: crooked
crop: crop,cropped,crops
crosby: crosby
cross: cross,crossed,crosses
crossing: crossing
crouch: crouch,crouched,crouching
crowd: crowd,crowded,crowding,crowds
crowded: crowded
crowning: crowning
cruel: cruel
cruelly: cruelly
cruelty: cruelty
cruise: cruise
cruller: crullers
crunch: crunches
crush: crushed,crushes
crust: crust
crusty: crusty
crutch: crutches
cubby: cubby
cubic: cubic
cuff: cuffs
culprit: culprit
cultivate: cultivated
cum: cum
cunning: cunning
cup: cup,cups
cupidity: cupidity
cur: cur
curb: curb
cure: cure,cures
curiosity: curiosities,curiosity
curious: curious
curiously: curiously
curl: curl
curly: curly
current: current,currents
curse: curse,cursed,curses
curtail: curtailed
curtain: curtain,curtains
custom: custom,customs
customer: customer,customers
cut: cut,cuts,cutting
cutter: cutter
cutthroat: cutthroats
cutting: cutting
czar: czar
czech: czech,czechs
daily: daily
daisy: daisies
dam: dam
damage: damage,damaged
damages: damages
damaging: damaging
dame: dame
damp: damp
dan: dan
dance: dance
dancing: dancing
danger: danger,dangers
dangerous: dangerous
dangle: dangling
daniel: daniel
daring: daring
dark: dark,darker
darken: darkened
darkness: darkness
darn: darning
dash: dash,dashes
daughter: daughter,daughters
david: david
dawn: dawn,dawned,dawning,dawns
day: day,days
daybreak: daybreak
daytime: daytime
dead: dead
deadly: deadly
deaf: deaf
deal: deal,dealing,deals,dealt
dealer: dealer
dealings: dealings
dearth: dearth
death: death,deaths
debase: debasing
debatable: debatable
debauch: debauch
debt: debt
debtor: debtor
decade: decade
decay: decay,decayed,decaying
decease: deceased
deceive: deceive,deceives
december: december
decency: decency
decent: decent
decently: decently
deception: deception
decide: decided
decipher: deciphered
decisive: decisive
deck: deck,decked
declaration: declaration
declare: declared,declaring
decline: declining
decorate: decorate
decorous: decorous
decrease: decrease,decreases
decree: decree,decrees
decrepit: decrepit
deduct: deduct
deed: deed
deem: deemed
deep: deep,deeper,deepest
deepen: deepening
deeply: deeply
defeat: defeat,defeated
defence: defence,defences
defenceless: defenceless
defiance: defiance
defiantly: defiantly
defilement: defilement
define: defined,defines
deform: deformed
deformity: deformity
deftly: deftly
deftness: deftness
defunct: defunct
degradation: degradation
degrade: degraded
degrading: degrading
degree: degree
delay: delay,delayed
deliberate: deliberate
deliberately: deliberately
delicate: delicate
delight: delight
delinquent: delinquents
deliver: delivers
delusion: delusion
delving: delving
demand: demand,demanding,demands
democratic: democratic
demolition: demolition
demonstrate: demonstrated
demonstration: demonstration
den: den,dens
denial: denial
denizen: denizens
dennis: dennis
denomination: denominations
denounce: denounced,denouncing
dense: dense,denser,densest
densely: densely
density: density
denunciation: denunciation
deny: denied,deny
depart: depart,departed
department: department
depend: depend,depended,depends
dependence: dependence
dependent: dependent
deplete: deplete
deplorable: deplorable
deplore: deplore
deposit: deposit,deposited
depraved: depraved
depravity: depravities,depravity
depredation: depredations
deprive: deprived,depriving
depth: depth
depths: depths
deputation: deputation
derision: derision
descend: descend
descendant: descendants
descent: descent
description: description
desert: desert,deserted
deserted: deserted
desertion: desertion
deserve: deserve,deserves
design: design,designed
designate: designate
desirable: desirable
desire: desire,desired
desk: desk
desolation: desolation
despair: despair
despairing: despairing
despatch: despatches
desperate: desperate
desperately: desperately
desperation: desperation
despise: despise
despoiled: despoiled
despond: despond
despotism: despotism
destine: destined
destiny: destiny
destitute: destitute
destitution: destitution
destroy: destroy,destroyed,destroying
destroyer: destroyer
destruction: destruction
destructive: destructive
desultory: desultory
detailed: detailed
detect: detect,detected
detective: detectives
deterioration: deterioration
determine: determine,determines
determined: determined
detriment: detriment
develop: develop,developed
device: device
devil: devil
devoid: devoid
devote: devoted,devotes
devoted: devoted
devotion: devotion
devour: devouring
dialect: dialect
dictate: dictated,dictates
die: die,died,dies,dying
diet: diet
difference: difference
difficult: difficult
difficulty: difficulties,difficulty
dig: dig,dug
digger: diggers
dignified: dignified
dignify: dignifies
dilapidated: dilapidated
dilapidation: dilapidation
dim: dim,dimmed
dime: dime
diminish: diminish
dimly: dimly
dingy: dingy
dinner: dinner
diphtheria: diphtheria
diplomatic: diplomatic
dire: direst
direct: direct,directed
direction: direction,directions
directory: directory
dirt: dirt
dirty: dirtier,dirty
disabled: disabled
disadvantage: disadvantage
disappear: disappear,disappeared,disappears
disappointing: disappointing
disappointment: disappointment
disarm: disarming
disaster: disaster
disbandment: disbandment
discard: discarded,discarding
discern: discern
discernible: discernible
discharge: discharge,discharged
disclose: disclosed
disclosure: disclosures
discomfiture: discomfiture
discomfort: discomfort
discontent: discontent
discourage: discourage,discouraged
discover: discover,discovered,discovering,discovers
discovery: discovery
discrepancy: discrepancy
discriminate: discriminating
discriminating: discriminating
discuss: discuss,discussed,discussing
discussion: discussion
disdain: disdain,disdained
disease: disease,diseases
disgrace: disgrace,disgraced
disgraceful: disgraceful
disguise: disguise,disguised,disguising
disgust: disgust
disgusted: disgusted
disgusting: disgusting
dish: dished
disheartening: disheartening
dishonest: dishonest
dishonor: dishonor
dishonored: dishonored
disinclined: disinclined
disinfectant: disinfectants
dislodge: dislodge,dislodged
dismal: dismal
dismiss: dismiss,dismissed
disobey: disobey
disorder: disorder
disorderly: disorderly
dispassionate: dispassionate
dispel: dispelled
dispensary: dispensary
dispensation: dispensation
dispense: dispensing
display: display,displayed
displeasure: displeasure
dispose: dispose,disposed,disposing
disposed: disposed
disposition: disposition
dispossess: dispossess
dispossessed: dispossessed
disprove: disproved
dispute: disputed,disputing
disquietude: disquietude
disreputable: disreputable
dissecting: dissecting
dissemination: dissemination
dissent: dissenting
dissipate: dissipated
dissipation: dissipation
distance: distance
distemper: distemper
distillery: distilleries
distinct: distinct
distinction: distinction
distinctive: distinctive
distinctively: distinctively
distinctly: distinctly
distinctness: distinctness
distinguish: distinguish,distinguished
distinguished: distinguished
distinguishing: distinguishing
distraction: distraction
distress: distress
distressing: distressing
distribute: distribute,distributes
district: district,districts
distrust: distrust
disturb: disturb,disturbed
disturber: disturber,disturbers
ditch: ditch
dive: dive,dives
diversion: diversions
divide: divide,divided,divides,dividing
dividend: dividends
divine: divine
diving: diving
division: division
divorce: divorce
dock: dock,docks
doctor: doctor,doctors
doctored: doctored
doctrine: doctrine
dodge: dodge
dodo: dodo
dog: dog
dogged: dogged
doings: doings
dollar: dollar,dollars
domain: domain
domestic: domestic
domicile: domicile,domiciles
doom: doom,doomed
door: door,doors
doorstep: doorstep,doorsteps
doorway: doorway,doorways
dormer: dormer
dormitory: dormitories,dormitory
dot: dot,dots
double: double,doubled
doubt: doubt,doubted,doubting,doubts
doubtfully: doubtfully
doubtless: doubtless
dovetail: dovetailed
downhearted: downhearted
downright: downright
downstairs: downstairs
downtown: downtown
doze: doze,dozing
dozen: dozen,dozens
draft: draft
drag: drag,dragged,dragging
drain: drained
dramatic: dramatic
dramshop: dramshop
drastic: drastic
draught: draught
draw: draw,drawing,drawn,draws,drew
drawing: drawing,drawings
dread: dread,dreaded
dreaded: dreaded
dreadful: dreadful,dreadfuls
dreadfully: dreadfully
dream: dream,dreamed,dreaming,dreams
drearily: drearily
dreariness: dreariness
dreary: dreary
dregs: dregs
drench: drenched
dress: dress,dressed,dresses
dressmaking: dressmaking
drift: drift,drifting
drily: drily
drink: drink,drinks
drinking: drinking
dripping: dripping
drive: drive,driven,drives,driving,drove
driver: driver
drone: drones
drop: drop,dropped,drops
dropping: dropping
drove: droves
drown: drowned,drowning,drowns
drowned: drowned
drudgery: drudgery
drug: drug,drugged,drugs
drum: drumming,drums
drunk: drunk
drunkard: drunkards
drunken: drunken
drunkenness: drunkenness
dry: dried,dry,drying
drying: drying
dryly: dryly
dual: dual
duane: duane
dub: dubbed
dull: dull,duller
dulness: dulness
dumb: dumb
dump: dump,dumped,dumps
duplicity: duplicity
dutch: dutch
dutchman: dutchman
duty: duties,duty
dwell: dwell,dwelling
dweller: dwellers
dwelling: dwelling,dwellings
dwellings: dwellings
dye: dyed
eager: eager
ear: ear,ears
earn: earn,earned,earning,earns
earner: earner,earners
earnest: earnest
earnestly: earnestly
earnings: earnings
earth: earth
ease: ease
easily: easily
east: east
eastern: eastern
easy: easier,easiest,easy
eat: eat,eaten,eating
eatables: eatables
ebb: ebbing
echo: echo,echoed,echoes,echoing
echoes: echoes
eclipse: eclipse
economic: economic
economical: economical
economist: economist
economy: economy
edge: edge
edging: edgings
edifice: edifice
educate: educate
education: education
educational: educational
edward: edward
edwin: edwin
efface: efface,effaced
effective: effective
effectual: effectual
effectually: effectually
efficient: efficient
effort: effort,efforts
egg: egg,egging,eggs
egypt: egypt
eighteen: eighteen
eighth: eighth
eject: eject
eke: eke
elaborate: elaborate
elbow: elbow,elbowing,elbows
eld: elder,eldest
elder: elders
elect: elected,elects
election: election,elections
electioneering: electioneering
elegant: elegant
element: element,elements
elementary: elementary
elevate: elevating
elevated: elevated
elevation: elevation
eleventh: eleventh
eliminate: eliminated
elizabeth: elizabeth
ellen: ellen
eloquence: eloquence
eloquent: eloquent
emanate: emanated
emancipation: emancipation
ember: embers
embodiment: embodiment
embody: embodied,embodies
embrace: embrace,embraced,embracing
embroiderer: embroiderers
emerald: emerald
emerge: emerged
emergency: emergencies,emergency
emigrant: emigrants
emigrate: emigrate
emigration: emigration
eminence: eminence
eminent: eminent
eminently: eminently
emotion: emotions
emphasize: emphasized,emphasizing
emphatic: emphatic
employ: employ,employed,employs
employee: employee
employer: employer,employers
employment: employment
emulate: emulates
en: en
enable: enable,enabled,enables
enactment: enactment
enclose: enclosing
encounter: encounter,encountered,encountering,encounters
encourage: encourage,encouraged
encroachment: encroachment,encroachments
encumbrance: encumbrance
endeavor: endeavored
endless: endless
endorsement: endorsement
endow: endowed
endure: endure
enemy: enemy
energetic: energetic
energetically: energetically
energy: energies,energy
enforce: enforce,enforcing
engage: engaged
engender: engendered
engine: engine
england: england
english: english
engulf: engulfed
enjoy: enjoyed,enjoying,enjoys
enjoyment: enjoyment
enlighten: enlightened
enlightened: enlightened
enlist: enlisted,enlisting
enormous: enormous
enormously: enormously
enslave: enslaved
ensnare: ensnared
ensue: ensues
entail: entails
enter: enter,entered,entering,enters
enterprise: enterprise,enterprises
entertained: entertained
enthusiasm: enthusiasm
entire: entire
entitle: entitle,entitled
entrance: entrance
entreat: entreated
entreaty: entreaty
entrust: entrust
entry: entries
enumerate: enumerates
enumeration: enumeration
environment: environment
ephemeral: ephemeral
epidemic: epidemic,epidemics
episode: episode
equal: equal
equally: equally
equivalent: equivalent
era: era
erect: erected,erects
erection: erection
errand: errand
erroneously: erroneously
error: error
eruption: eruption
escape: escape,escaped,escapes,escaping
essence: essence
essential: essential
essex: essex
establish: established
establishment: establishment,establishments
estate: estate,estates
estimate: estimate,estimated,estimates
eternal: eternal
ethic: ethics
europe: europe
european: european
evade: evade,evaded
eve: eve
evening: evening
event: event,events
eventually: eventually
everlasting: everlasting
everyday: everyday
eviction: eviction,evictions
evidence: evidence,evidences
evident: evident
evidently: evidently
evil: evil,evils
evince: evinced
evolution: evolution
exact: exact,exacted,exacting,exacts
exacting: exacting
exaggerated: exaggerated
exalt: exalt
examination: examination
examine: examined,examining
exceed: exceed,exceeded,exceeds
exceedingly: exceedingly
excellence: excellence
excellent: excellent
exception: exception,exceptions
exceptional: exceptional
excessive: excessive
excessively: excessively
exchange: exchange,exchanged
exchangeable: exchangeable
excise: excise
excite: excite,excited,excites
excitement: excitement
exciting: exciting
exclaim: exclaim
exclude: excluded
exclusive: exclusive
exclusively: exclusively
exclusiveness: exclusiveness
excursion: excursion,excursions
excuse: excuse
execution: execution
exemplary: exemplary
exercise: exercise,exercised,exercises
exhausted: exhausted
exhaustion: exhaustion
exhaustive: exhaustive
exhibit: exhibit,exhibited,exhibits
exhibition: exhibition
exigency: exigency
exist: exist,exists
existence: existence
exorbitant: exorbitant
expand: expands
expect: expect,expected,expecting
expectant: expectant
expectation: expectation
expedient: expedient,expedients
expedition: expedition
expend: expended
expense: expense,expenses
expensive: expensive
experience: experience,experienced,experiences
experienced: experienced
experiment: experiment,experimented,experiments
expert: expert,experts
expiration: expiration
explain: explain,explained,explaining,explains
explanation: explanation
exploit: exploits
explore: explore,exploring
explorer: explorers
expose: expose
exposure: exposure
expound: expound
express: express,expressed
expression: expression
expressive: expressive
extend: extend,extended,extending,extends
extensive: extensive
extensively: extensively
extent: extent
extenuation: extenuation
exterminate: exterminating
extinct: extinct
extol: extols
extortionate: extortionate
extra: extra
extraordinary: extraordinary
extravagant: extravagant
extreme: extreme,extremes
extremely: extremely
exuberance: exuberance
exultant: exultant
eye: eye,eyes
eyed: eyed
faced: faced
faction: faction,factions
factor: factor
factory: factories,factory
faculty: faculty
fad: fad
fade: faded
fagin: fagin
fail: fail,failed,failing,fails
failure: failure
faint: fainted
faintly: faintly
fair: fair,fairest
faith: faith
faithful: faithful
faithfully: faithfully
fall: fall,fallen,falling,falls,fell
fallacy: fallacy
false: false
falter: faltering
familiar: familiar
family: families,family
famish: famishing
famous: famous
fan: fan,fanned
fanatic: fanatic
fancy: fancy
farce: farce
fare: fare,fares
farm: farm,farms
farmer: farmer,farmers
farming: farming
farth: farthest
fascination: fascination
fashion: fashion
fashionable: fashionable
fashioned: fashioned
fast: fast,faster
fasten: fastened
fastness: fastnesses
fat: fat
fatal: fatal
fatally: fatally
fate: fate
father: father,fathers
faucet: faucet,faucets
fault: fault,faults
favor: favor
favorable: favorable
favored: favored
favorite: favorite
fear: fear,fearing,fears
fearful: fearful
fearfully: fearfully
feast: feast
feature: feature,features
february: february
fee: fee,fees
feeble: feeble
feed: fed,feed,feeding,feeds
feel: feel,feeling,feels
feeling: feeling,feelings
fellow: fellow,fellows
fellowship: fellowship
female: female,females
fence: fence,fenced,fences
ferocity: ferocity
fertile: fertile
festive: festive
fetch: fetches,fetching
fetter: fetters
feud: feuds
fever: fever
fiction: fiction
fiddle: fiddles
field: field,fields
fiend: fiend,fiends
fiendish: fiendish
fierce: fierce,fiercest
fiery: fiery
fight: fight,fighting,fights,fought
figure: figure,figured,figures
file: file,files
filler: filler
filling: filling
filth: filth
filthy: filthiest,filthy
final: final
finally: finally
finance: finance
financial: financial
financier: financiers
fine: fine,fined,fines,finest
finger: finger,fingering,fingers
finish: finish,finished,finishes,finishing
finished: finished
finisher: finisher
finishing: finishing
finnish: finnish
firebug: firebugs
fireman: firemen
fireside: firesides
firm: firm,firms
firmly: firmly
fish: fish
fist: fist
fit: fit,fits,fitted,fitting
flag: flag,flags
flagrant: flagrant
flagstone: flagstones
flame: flame,flames
flannel: flannel
flash: flash
flat: flat,flats,flatter
flattering: flattering
flavor: flavor
flee: fled
fleet: fleet
flesh: flesh
flexible: flexible
flight: flight,flights
fling: flung
float: float,floated,floating
floater: floaters
flock: flock
flood: flood
floor: floor,floors
flopping: flopping
flotsam: flotsam
flourish: flourish,flourished
flow: flows
flower: flower,flowers
flue: flue
flutter: flutters
fly: fly,flying
foe: foe
fold: fold
folk: folk,folks
follow: follow
fond: fond
fondly: fondly
food: food
fool: fool
foolishly: foolishly
foot: feet,foot,foots
footed: footed
foothold: foothold
footnote: footnotes
forbid: forbade,forbidden,forbidding
force: force,forced,forces,forcing
foreground: foreground
foreign: foreign
foreigner: foreigner
foremost: foremost
foresight: foresight
forest: forest
foretaste: foretaste
forge: forged
forget: forget,forgets,forgetting,forgot,forgotten
forgetfulness: forgetfulness
forlorn: forlorn
form: form,formed,forming,forms
formal: formal
formality: formality
forsake: forsook
forsooth: forsooth
forthwith: forthwith
fortune: fortune,fortunes
forum: forum
foster: fostered,fostering
foul: foul,fouler
foulness: foulness
foundation: foundation
foundling: foundlings
foundry: foundry
fourteen: fourteen
fourteenth: fourteenth
fourth: fourth,fourths
fowl: fowl
fox: foxes
fragment: fragments
frame: frame
franc: francs
france: france
franklin: franklin
frankness: frankness
frantic: frantic
fraud: fraud,frauds
fred: fred
freedom: freedom
freemasonry: freemasonry
freethinker: freethinkers
freethinkers: freethinkers
french: french
frequent: frequent
frequently: frequently
fresh: fresh
fret: fretting
fretful: fretful
fretfully: fretfully
friday: friday
friend: friend,friends
friendly: friendliest,friendly
friendship: friendship
fright: fright
frighten: frightened
frightened: frightened
frightful: frightful
frog: frog
frontier: frontier
frontispiece: frontispiece
frost: frosted
froth: froth
frowsy: frowsy
fruit: fruit,fruits
fruitless: fruitless
fry: frying
fugitive: fugitives
fullness: fullness
fume: fumes
fun: fun
fund: fund,funds
funds: funds
funeral: funeral,funerals
fur: fur
furious: furious
furnace: furnaces
furnish: furnished,furnishes
furniture: furniture
fury: fury
fusillade: fusillade
fuss: fuss
future: future
gag: gag
gaily: gaily
gain: gain,gained
gallantly: gallantly
gallery: gallery
galling: galling
gallows: gallows
gamble: gamble
gambler: gambler,gamblers
gambling: gambling
game: game,games
gang: gang,gangs
gangway: gangway
gap: gap,gaps
gape: gaping
garden: garden,gardens
garfield: garfield
garment: garment,garments
garner: garnered,garnering
garret: garret,garrets
gas: gas,gases
gasp: gasping
gate: gate,gates
gateway: gateway
gather: gather,gathered,gathering,gathers
gathering: gathering,gatherings
gatling: gatling
gaudy: gaudy
gauge: gauged
gay: gay
gayly: gayly
generation: generation,generations
generous: generous
genesis: genesis
genius: genius
genoa: genoa
gentiles: gentiles
gentle: gentle,gentlest
gentleman: gentleman
genuine: genuine
germ: germs
german: german,germans
germany: germany
gesticulate: gesticulating
gesture: gesture
gewgaw: gewgaws
ghastly: ghastly
ghost: ghosts
gift: gift
gigantic: gigantic
gimcrack: gimcracks
ginger: ginger
girl: girl,girls
girls: girls
giver: giver
glad: glad
glance: glance,glances
glasgow: glasgow
glass: glass
gleam: gleam
glean: gleaned
glimpse: glimpse,glimpses
glisten: glisten
gloom: gloom
gloomily: gloomily
glory: glory
glove: gloves
gloved: gloved
glow: glow,glowing
glower: glower
gnarl: gnarled
goad: goaded
goal: goal
goat: goat
god: god
goddess: goddess
gold: gold
goodly: goodly
goose: geese
gorgeous: gorgeous
gospel: gospel
gotham: gotham
govern: govern,governed
government: government,governments
gown: gowns
grace: grace
gracefully: gracefully
grade: grade,grades
gradual: gradual
gradually: gradually
graduating: graduating
grand: grand
grandmother: grandmother
granny: granny
grant: grant,granted
grapple: grappling
grasp: grasp,grasped,grasping
grass: grass
grate: grated,grating
grateful: grateful
gratify: gratifying
gratifying: gratifying
gratitude: gratitude
grave: grave
graveyard: graveyard
gravitate: gravitate,gravitates
gravitation: gravitation
gray: gray
greasy: greasy
greatly: greatly
greatness: greatness
greed: greed
greedy: greedy
greek: greek
green: green,greens
greeting: greeting
gregarious: gregarious
grenade: grenades
grief: grief
grievance: grievances
grievous: grievous
grimly: grimly
grimy: grimy
grin: grin
grind: grinding,ground
grip: grip
grippe: grippe
groan: groaned,groaning
grocer: grocer
grocery: groceries
groggery: groggeries
groove: groove
grope: grope,groped,gropes,groping
gross: gross
ground: ground
grounds: grounds
groundwork: groundwork
grove: grove
grow: grew,grow,growing,grown,grows
growl: growl,growls
growler: growler
growling: growling
grown: grown
growth: growth
grub: grub,grubbing
grudge: grudge
grumble: grumble,grumbling
grunt: grunts
guarantee: guarantee
guard: guard,guards
guards: guards
guess: guess,guessed
guest: guest,guests
guide: guide,guided,guiding
guilds: guilds
guillotine: guillotine
guilt: guilt
guilty: guilty
guise: guise
gun: gun,guns
gunpowder: gunpowder
gutter: gutter,gutters
guttural: gutturals
guy: guying
gymnasium: gymnasium
habit: habit,habits
habitation: habitation,habitations
habitually: habitually
hacking: hacking
hag: hag,hags
haggard: haggard
haggle: haggling
hail: hail,hailed
hair: hair
halfway: halfway
hall: hall,halls
hallway: hallway,hallways
hallways: hallways
halt: halted
hamburg: hamburg
hamilton: hamilton
hammer: hammer
hammock: hammock
hamper: hampers
hand: hand,hands
handcuffs: handcuffs
handed: handed
handful: handful
handle: handle,handles
handsome: handsome,handsomest
handsomely: handsomely
handy: handy
hang: hang,hanged,hanging,hangs,hung
hanging: hanging
hapless: hapless
happen: happened
happening: happenings
happily: happily
happiness: happiness
happy: happier,happiest,happy
harbor: harbor,harbored,harboring,harbors
hard: hard,harder,hardest
harden: hardened
hardened: hardened
hardship: hardship,hardships
harlem: harlem
harm: harm
harmless: harmless
harmlessly: harmlessly
harmonious: harmonious
harsh: harsh,harshest
harshly: harshly
hart: hart
hartford: hartford
harvest: harvest
haste: haste
hat: hat,hats
hatch: hatched
hatchet: hatchet
hate: hate,hates
hatred: hatred
haunt: haunt,haunts
haunting: haunting
hawk: hawked
hay: hay
head: head,headed,heading,heads
headlong: headlong
headquarters: headquarters
headway: headway
healing: healing
health: health
healthy: healthier,healthy
heap: heap,heaps
hear: hear,heard,hearing,hears
hearse: hearse
heart: heart,hearts
hearted: hearted
hearth: hearth
heartless: heartless
heat: heat,heats
heathen: heathen
heathenish: heathenish
heave: heaves
heaven: heaven
heaver: heaver
heavily: heavily
heavy: heavier,heaviest,heavy
hebrew: hebrew
hebrews: hebrews
hedge: hedge
heed: heeded,heeding
heedless: heedless
heel: heel,heels
hegira: hegira
height: height
heinous: heinous
helper: helper,helpers
helpless: helpless
helplessness: helplessness
hem: hem
hen: hen
herald: heralds
herb: herb
herd: herd,herds
herding: herding
hereditary: hereditary
heritage: heritage
hero: hero,heroes
heroic: heroic
heroism: heroism
hesitate: hesitate
hester: hester
heterogeneous: heterogeneous
hidden: hidden
hide: hidden,hide,hides,hiding
hideous: hideous
hiding: hiding
highly: highly
highway: highway
highwayman: highwaymen
hilarity: hilarity
hill: hill,hills
hilt: hilt
hinge: hinges
hint: hint
hire: hire,hired,hires,hiring
historian: historian
history: history
hit: hit,hitting
hitch: hitched
hitherward: hitherward
hive: hive,hives
hoard: hoard,hoarded,hoards
hod: hod
hog: hog,hogs
hold: held,hold,holding,holds
hole: hole,holes
holiday: holiday,holidays
hollow: hollow
holy: holy
homage: homage
homeless: homeless
homelessness: homelessness
homely: homeliest
homes: homes
homesickness: homesickness
homeward: homeward
honest: honest
honestly: honestly
honesty: honesty
honeycomb: honeycombed
honor: honor,honors
honorable: honorable
honored: honored
honors: honors
hoodlum: hoodlum
hook: hook
hookey: hookey
hope: hope,hoped,hopes
hopeful: hopeful
hopeless: hopeless
hopelessly: hopelessly
horde: horde,hordes
horrible: horrible
horror: horror,horrors
horse: horse
hospital: hospital,hospitals
hospitality: hospitality
host: host,hosts
hostelry: hostelry
hostility: hostility
hot: hot
hotel: hotel,hotels
hotly: hotly
hour: hour,hours
houri: houris
hourly: hourly
house: house,housed,houses,housing
household: household,households
housekeep: housekeeping
housekeeper: housekeeper
housekeeping: housekeeping
houses: houses
housetops: housetops
housing: housing
houston: houston
hovel: hovel,hovels
howitzer: howitzer
howl: howling,howls
huckster: hucksters
huddle: huddled
hudson: hudson
hue: hue
huge: huge
hum: hum
human: human
humane: humane
humanity: humanity
humanly: humanly
humble: humble,humblest
humor: humor,humored
hump: humped
hundredfold: hundredfold
hundredth: hundredth
hungary: hungary
hunger: hunger
hungrily: hungrily
hungry: hungry
hunt: hunt,hunted,hunting,hunts
hunting: hunting
hurried: hurried
hurry: hurried,hurry
hurt: hurt
husband: husband,husbands
hush: hush,hushed
hustling: hustling
hydrant: hydrant
hygiene: hygiene
hygienic: hygienic
hyphenate: hyphenated
hyphenation: hyphenation
icy: icy
idea: idea
ideal: ideal
idle: idle,idling
idleness: idleness
idler: idler
idol: idols
idolatry: idolatry
ignorance: ignorance
ignorant: ignorant
iii: iii
illegal: illegal
illegitimate: illegitimate
illness: illness
illogical: illogical
illogically: illogically
illustrate: illustrate
illustration: illustration,illustrations
image: images
imaginable: imaginable
imagine: imagine,imagined
imitator: imitators
immense: immense
immensely: immensely
immigrant: immigrant,immigrants
immigration: immigration
imminent: imminent
immoderately: immoderately
immorality: immorality
impart: impart
impartiality: impartiality
impatient: impatient
impel: impels
imperturbable: imperturbable
impetus: impetus
implicitly: implicitly
implore: implore
imply: implies
importation: importation
impose: imposed,imposes,imposing
impossibility: impossibility
impossible: impossible
impracticable: impracticable
impressed: impressed
impression: impression
improper: improper
improve: improve,improved,improving
improved: improved
improvement: improvement,improvements
improvidence: improvidence
improvident: improvident
improvise: improvised
impulse: impulse
impulsive: impulsive
impunity: impunity
imputation: imputation
inability: inability
inadequate: inadequate
inanition: inanition
incessant: incessant
incessantly: incessantly
incident: incident,incidents
incidental: incidental
incite: inciting
inclination: inclination
incline: incline,inclined
inclined: inclined
include: include,included,includes,including
income: income
incomparable: incomparable
incongruity: incongruities
inconsiderable: inconsiderable
inconsistency: inconsistencies
inconsistent: inconsistent
incorporation: incorporation
increase: increase,increased,increases,increasing
incredible: incredible
inculcate: inculcate
indebted: indebted
indefinitely: indefinitely
independence: independence
independent: independent
independently: independently
indictment: indictments
indifference: indifference
indifferent: indifferent
indifferently: indifferently
indigent: indigent
indignant: indignant
indignation: indignation
individual: individual,individuals
individuality: individuality
indomitable: indomitable
indoors: indoors
induce: induced
inducement: inducement
indulge: indulging
industrial: industrial
industrious: industrious
industriously: industriously
industry: industry
ineffective: ineffective
ineffectual: ineffectual
inevitable: inevitable
inevitably: inevitably
inexhaustible: inexhaustible
inexorable: inexorable
inexpressibly: inexpressibly
infallible: infallible
infamous: infamous
infamy: infamy
infant: infant,infants
infants: infants
infectious: infectious
infer: inferred
inferior: inferior
infernal: infernal
infidel: infidel,infidels
infinitely: infinitely
inflame: inflamed,inflaming
influence: influence,influences
influx: influx
inform: informed
infrequent: infrequent
infrequently: infrequently
infringement: infringement
infuse: infused
ingenuity: ingenuity
ingratitude: ingratitude
ingredient: ingredients
ingress: ingress
inhabit: inhabit,inhabited,inhabits
inhabitant: inhabitants
inhalation: inhalation
inherent: inherent
inherit: inherit,inherited
inheritance: inheritance
inhuman: inhuman
iniquity: iniquities,iniquity
injunction: injunction
injure: injured
injustice: injustice
ink: ink
inlet: inlet
inmate: inmates
innocent: innocent
innumerable: innumerable
inoffensive: inoffensive
inoffensiveness: inoffensiveness
inordinate: inordinate
inordinately: inordinately
inquire: inquire,inquiring
inquiry: inquiries,inquiry
inquisitive: inquisitive
inroad: inroads
insane: insane
insanity: insanity
insatiate: insatiate
inscription: inscription
insensible: insensible
inseparable: inseparable
insider: insider,insiders
insist: insist,insisted,insisting,insists
inspect: inspected
inspection: inspection,inspections
inspector: inspector
inspire: inspire
install: installed
instalment: instalment
instance: instance,instances
instant: instant
instinct: instinct,instincts
instinctive: instinctive
instinctively: instinctively
institute: institute
institution: institution,institutions
instruct: instruct,instructed,instructing
instruction: instruction,instructions
instrumentality: instrumentality
insult: insult
insurance: insurance
insure: insure,insured,insuring
integrity: integrity
intellectual: intellectual
intelligence: intelligence
intelligent: intelligent
intelligently: intelligently
intemperance: intemperance
intend: intended,intending
intense: intense
intensely: intensely
intensify: intensifying
intensity: intensity
intent: intent
intention: intention,intentions
interdict: interdicted
interfere: interfere
interference: interference
interim: interim
interior: interior
interminable: interminable
intermingle: intermingled
internal: internal
international: international
interpret: interprets
interpreter: interpreter
interval: intervals
intervention: intervention
intimately: intimately
intolerable: intolerable
intrench: intrenched
introduce: introduced
introduction: introduction
introspective: introspective
intrude: intrude
intruder: intruder,intruders
intrusion: intrusion
intuitively: intuitively
invade: invade,invaded
invalid: invalid
invariable: invariable
invariably: invariably
inveigle: inveigling
invent: invent,invented
invest: invested,investing
investigate: investigate,investigated,investigating
investigation: investigation
investment: investment
invitation: invitation
invite: invite,invited,invites,inviting
invoke: invoke,invoked
involve: involved,involving
involved: involved
ireland: ireland
irene: irene
irish: irish
irishman: irishman
iron: iron,ironing,irons
ironer: ironer
irresponsible: irresponsible
isaac: isaac
ishmael: ishmael
island: island,islands
isolate: isolated,isolating
isolation: isolation
israel: israel
israelite: israelite
issue: issue,issued,issues
italian: italian,italians
italy: italy
item: item,items
iv: iv
ix: ix
jacket: jackets
jacob: jacob
jail: jail,jails
jailor: jailor
jam: jammed
james: james
janitor: janitor
jargon: jargon
jeer: jeer
jersey: jersey
jerusalem: jerusalem
jesus: jesus
jetsam: jetsam
jew: jew
jewel: jewels
jewish: jewish
jewry: jewry
jews: jews
jimmy: jimmy
job: job
john: john
johnny: johnny
joint: joint,joints
joke: joke
jolly: jolly
joss: joss
jostle: jostle
journey: journey,journeys
joy: joy
joyless: joyless
joyous: joyous
judge: judge,judged,judges,judging
judgment: judgment
judicious: judicious
jug: jug
july: july
jump: jump
jumper: jumper
june: june
junk: junk
jurisdiction: jurisdiction
justice: justice,justices
justifiable: justifiable
justified: justified
justly: justly
juvenile: juvenile
kaftan: kaftan
keen: keen,keenest
keeper: keeper,keepers
keeping: keeping
keg: keg,kegs
kerchief: kerchiefs
kerosene: kerosene
kettle: kettle
key: key
keynote: keynote
kick: kick,kicks
kid: kid,kids
kill: kill,killed,killing,kills
killing: killing
kin: kin
kindergartens: kindergartens
kindle: kindling
kindliness: kindliness
kindly: kindly
kindness: kindness
kindred: kindred
king: king
kit: kit
kitchen: kitchen
kite: kites
kith: kith
knee: knee,knees
knickerbocker: knickerbocker
knickerbockers: knickerbockers
knife: knife
knit: knitting
knock: knock,knocked,knocking,knocks
knot: knot
knowledge: knowledge
knuckle: knuckles
label: labelled
labor: labor,laboring,labors
laborer: laborer,laborers
lace: lace
lack: lack,lacked,lacking,lacks
lad: lad,lads
ladder: ladder,ladders
lady: ladies,lady
lagging: lagging
lair: lair
lamb: lamb
lamentation: lamentation
lamp: lamp
lance: lances
land: land,landed,landing,lands
landing: landing
landlord: landlord,landlords
landmark: landmark
landscape: landscape
lane: lane,lanes
language: language
lap: lap
lapse: lapse,lapses,lapsing
lastly: lastly
late: late
latent: latent
latitude: latitude
laudable: laudable
laugh: laugh,laughed,laughs
laughable: laughable
laughter: laughter
laundry: laundries,laundry
lavish: lavish
law: law,laws
lawful: lawful
lawless: lawless
lawn: lawn
lawyer: lawyers
lay: laid,lay,laying,lays
layer: layer
layman: laymen
lazily: lazily
laziness: laziness
lazy: laziest,lazy
lead: lead,leading,leads,led
leader: leader
leadership: leadership
leaf: leaf,leaves
leak: leaking,leaks
lean: leanest,leaning
learn: learn,learned,learning,learns
learner: learner,learners
learners: learners
learning: learning
lease: leased
leasehold: leasehold
leather: leather
leave: leave,leaves,leaving,left
leaven: leaven
leavening: leavening
lecture: lecture,lectures
ledger: ledger
leer: leer
left: left
leg: leg,legs
legacy: legacy
legal: legal
legend: legend
legged: legged
legislation: legislation
legislative: legislative
legislature: legislature,legislatures
legitimate: legitimate
leisure: leisure
lend: lend,lends
lengthen: lengthened,lengthening
leonard: leonard
lessen: lessened
lesson: lesson,lessons
letter: letter,letters
letting: letting
level: level,levelling
levelling: levelling
lever: lever
levy: levying
liable: liable
liberal: liberal
liberty: liberty
license: licensed
licensed: licensed
lie: lie,lied,lies,lying
lien: lien
life: life,lives
lifeless: lifeless
lifetime: lifetime
lift: lift,lifts
lifting: lifting
light: light
lighted: lighted
lightly: lightly
likeness: likeness
lily: lily
limb: limbs
limit: limit,limited,limits
limited: limited
limp: limp
linen: linen
linger: linger,lingering
lingo: lingo
lining: lining,linings
link: link,links
lion: lion
lip: lips
liquor: liquor
list: list
listen: listen,listened,listening
literally: literally
literature: literature
litigation: litigation
litter: littered
live: live,lived,lives,living
lively: liveliest,lively
living: living
lo: lo
load: load,loaded,loads
loadstone: loadstone
loaf: loaf,loaves
loan: loan
loathe: loathe
loathsome: loathsome
local: local
locality: localities,locality
locate: located,locates
location: location,locations
lock: lock,locked,locking
locker: locker
locking: locking
locust: locust
lodge: lodge,lodged
lodgement: lodgement
lodger: lodger,lodgers
lodgers: lodgers
lodging: lodging
lodgings: lodgings
logic: logic
logical: logical
london: london
lonely: lonely
longing: longing
lookout: lookout
loom: looms
loose: loose
lord: lord
lose: lose,loses,losing,lost
loss: loss
lot: lot,lots
lottery: lottery
loud: loud,louder
loudly: loudly
louis: louis
lounge: lounge
love: love,loves,loving
lover: lover
loving: loving
lowell: lowell
loyal: loyal
loyalty: loyalty
luck: luck
lucky: lucky
ludicrous: ludicrous
ludlow: ludlow
lull: lulling
lullaby: lullaby
lumber: lumber
lump: lumping
lunatic: lunatic
lunch: lunch
lung: lung
lure: lured
lurk: lurks
lush: lush
lust: lusts
luxuriantly: luxuriantly
luxurious: luxurious
luxury: luxury
macadamized: macadamized
macaroni: macaroni
machination: machination
machine: machine,machines
machinery: machinery
mad: mad
madison: madison
madman: madman
madness: madness
maelstrom: maelstrom
magic: magic
magistrate: magistrate
magnificence: magnificence
magnitude: magnitude
main: main
maine: maine
maintain: maintain,maintained,maintaining,maintains
majesty: majesty
majority: majority
maker: maker,makers
makeshift: makeshifts
male: male,males
malodorous: malodorous
mamma: mammas
manage: manage,managed,manages
manageable: manageable
management: management
manager: manager,managers
mandate: mandate
manhattan: manhattan
manhole: manhole
mania: mania
manifest: manifest
manipulation: manipulation
mankind: mankind
manner: manner
mannered: mannered
manual: manual
manufacture: manufactures
manufacturer: manufacturer,manufacturers
manufacturing: manufacturing
manure: manure
map: map,maps
mar: mar
march: march,marched,marching
margin: margin
mark: mark,marking
market: market
marriage: marriage
marry: marrying
martha: martha
marvel: marvelled
marvellous: marvellous
mary: mary
mason: masons
mass: mass,masses
master: master,masters
mat: matted
material: material
materialistic: materialistic
matron: matron
matter: matter,matters
mattress: mattress,mattresses
maxim: maxim
maze: maze
meadow: meadows
meal: meal,meals
meaning: meaning
meanness: meanness
measles: measles
measure: measure,measured,measures
measurement: measurement
meat: meat
mechanic: mechanic,mechanics
meddling: meddling
medical: medical
medicine: medicine,medicines
mediterranean: mediterranean
meet: meet,meets,met
meeting: meeting,meetings
memento: memento
memory: memories,memory
menace: menace
menagerie: menagerie
mend: mended
mendacity: mendacity
mendicancy: mendicancy
mendicant: mendicants
menial: menial
mental: mental
mention: mention,mentioned
merchant: merchants
merciless: merciless
mercy: mercy
mere: mere
merit: merit,merits
merriment: merriment
merry: merry
mesh: meshes
message: message
messenger: messenger,messengers
messiah: messiah
method: method,methods
methodist: methodist
metropolis: metropolis
metropolitan: metropolitan
michigan: michigan
middle: middle
middleman: middleman
midnight: midnight
midst: midst
midwinter: midwinter
mighty: mighty
migration: migration,migrations
mild: mild
mildly: mildly
mile: mile,miles
milestone: milestone,milestones
milk: milk
mind: mind,minds
mingle: mingle,mingling
mingling: mingling
miniature: miniature
minimum: minimum
minister: minister,ministering
ministry: ministry
minor: minors
minute: minutes
minuteness: minuteness
miracle: miracle
miraculously: miraculously
mire: mire
mirth: mirth
miscreant: miscreant
misdeed: misdeeds
miser: miser
miserable: miserable
miserably: miserably
misery: miseries,misery
misfortune: misfortune
misgiving: misgivings
mishap: mishap
misjudge: misjudged
mislay: mislaid
missing: missing
mission: mission,missions
missionary: missionaries,missionary
misspell: misspelled
mistake: mistake,mistaking
mistaken: mistaken
mistrust: mistrust
misunderstand: misunderstood
mixed: mixed
mixture: mixture,mixtures
moan: moaning
mob: mob
mock: mock
mockery: mockery
mode: mode
model: model
modern: modern
modest: modest
moist: moist
molest: molest
moment: moment
monday: monday
money: money
monopolize: monopolize,monopolized,monopolizes
monotony: monotony
monstrous: monstrous
montgomery: montgomery
month: month,months
monthly: monthly
monument: monument
moonlight: moonlight
moor: moored
mooring: moorings
moral: moral,morals
moralist: moralist,moralists
morality: morality
morally: morally
morbid: morbid
morgue: morgue,morgues
morning: morning
morrow: morrow
mortality: mortality
mortar: mortar
mortgage: mortgage,mortgaged
mortification: mortification
mosaic: mosaic
moth: moth
mother: mother,mothers
motherhood: motherhood
motherless: motherless
motive: motive,motives
mott: mott
motto: motto
mould: moulded,moulds
mountain: mountain,mountains
mourn: mourning
mournful: mournful
mourning: mourning
mouse: mice
mouth: mouth,mouths
mouthed: mouthed
movement: movement
mover: movers
mud: mud
mulberry: mulberry
multiple: multiple
multiply: multiplies,multiplying
multitude: multitudes
municipal: municipal
municipality: municipality
munificent: munificent
murder: murder,murdered,murdering,murders
murderer: murderer,murderers
murderers: murderers
murderous: murderous
murmur: murmur
murphy: murphy
murray: murray
muscle: muscle
museum: museum
music: music
muster: muster,mustered
musty: musty
mutilation: mutilation
mutual: mutual
muzzle: muzzled
mysterious: mysterious
mysteriously: mysteriously
mystery: mysteries,mystery
naked: naked
nameless: nameless
naples: naples
napoleon: napoleon
narrow: narrow,narrower,narrows
nastiness: nastiness
national: national
nationality: nationalities,nationality
native: native,natives
natural: natural
naturally: naturally
nature: nature,natures
nausea: nausea
nearness: nearness
neat: neat,neater
neatness: neatness
necessaries: necessaries
necessity: necessities,necessity
neck: neck
necktie: neckties
needle: needle
needless: needless
neglect: neglect,neglected
negro: negro,negroes
neighbor: neighbor,neighbors
neighborhood: neighborhood,neighborhoods
neighboring: neighboring
nemesis: nemesis
nerve: nerve
nest: nest,nests
nether: nether
news: news
newsboy: newsboys
newsboys: newsboys
newspaper: newspaper,newspapers
nice: nice
nickle: nickles
nickname: nicknamed
niggardly: niggardly
nigger: nigger
nigh: nigh
night: night,nights
nightfall: nightfall
nightly: nightly
nimble: nimble
nineteen: nineteen
nineteenth: nineteenth
ninth: ninth
noble: noble
nod: nod,nods
nohow: nohow
noise: noise,noises
noisy: noisy
nominal: nominal
nook: nook
noon: noon
noose: noose
normal: normal
north: north
northward: northward
nose: nose,noses,nosing
notable: notable
note: note,notes
notice: notice,notices
noticeable: noticeable
noticeably: noticeably
notion: notion,notions
notoriety: notoriety
notorious: notorious
notoriously: notoriously
nourish: nourish,nourished
nourishment: nourishment
november: november
nowadays: nowadays
nuisance: nuisance,nuisances
numberless: numberless
numerous: numerous
nurse: nurse,nursed,nurses,nursing
nurseries: nurseries
nursery: nurseries,nursery
nursing: nursing
nurture: nurtured
nutritive: nutritive
oak: oak
oath: oaths
obey: obeyed
object: object,objected,objects
objectionable: objectionable
obligation: obligation
oblige: obliged
obscure: obscure,obscures
observation: observation,observations
observe: observe,observed,observes
observer: observer
obstacle: obstacle,obstacles
obstinately: obstinately
obstruct: obstruct
obstruction: obstructions
obvious: obvious
occasion: occasion,occasions
occasional: occasional
occasionally: occasionally
occupancy: occupancy
occupant: occupants
occupation: occupation,occupations
occupied: occupied
occupy: occupied,occupy,occupying
occur: occur,occurred,occurring
occurrence: occurrence,occurrences
ocean: ocean
october: october
odd: odd,oddest
odds: odds
odious: odious
odor: odor
offal: offal
offence: offence,offences
offend: offended
offended: offended
offender: offender,offenders
offensive: offensive
offer: offer,offered,offering,offers
office: office,offices
officer: officer,officers
official: official,officials
officially: officially
offset: offset
offspring: offspring
oftener: oftener
oftenest: oftenest
omen: omen
ominous: ominous
omnipresent: omnipresent
onion: onions
onset: onset
onward: onward
openly: openly
operate: operate,operates
operation: operation,operations
operator: operator
opinion: opinion,opinions
opium: opium
opponent: opponents
opportunity: opportunities,opportunity
oppose: oppose,opposed,opposing
opposition: opposition
oppressed: oppressed
oppression: oppression
oppressive: oppressive
oppressor: oppressors
optician: optician
optimist: optimist,optimists
optimistic: optimistic
orange: orange,oranges
orator: orators
orchard: orchard
orderly: orderly
ordinance: ordinance,ordinances
ordinarily: ordinarily
ordinary: ordinary
organ: organ
organization: organization,organizations
organize: organized
organizer: organizers
origin: origin
original: original
originally: originally
originate: originated
orphan: orphaned,orphans
orthodox: orthodox
ostrich: ostriches
ousting: ousting
outbid: outbid
outburst: outburst
outcast: outcast,outcasts
outcry: outcry
outdo: outdo,outdoing
outdoor: outdoor
outer: outer
outfit: outfit
outgrow: outgrow
outgrowth: outgrowth
outhouse: outhouses
outlandish: outlandish
outlay: outlay
outlet: outlets
outlook: outlook
outpost: outposts
outrage: outrage,outrages
outraged: outraged
outrageous: outrageous
outset: outset
outsider: outsider,outsiders
outwardly: outwardly
outweigh: outweigh
oven: oven
overalls: overalls
overawe: overawed
overbalance: overbalance
overcoat: overcoats
overcome: overcame,overcome
overcrowded: overcrowded
overcrowding: overcrowding
overdrawn: overdrawn
overflow: overflow
overhang: overhanging
overhead: overhead
overhear: overheard
overlook: overlooked
overpowering: overpowering
overrun: overran,overrun,overrunning
overseer: overseer,overseers
overshadow: overshadowing
overstate: overstates
overtake: overtaken
overtime: overtime
owe: owe,owed,owes
owner: owner,owners
ox: ox
pace: pace,paces
pack: pack,packed,packing
packed: packed
packing: packing
pad: pad
paddle: paddling
padlock: padlocked
padlocked: padlocked
padrone: padrone
pagan: pagan
pagination: pagination
pail: pail
pain: pain,pains
painful: painful
paint: paint,painted
pair: pair,pairs
pal: pals
palace: palace
pale: pale
palestine: palestine
palm: palm
palsied: palsied
pan: pan
pandemonium: pandemonium
panic: panic
panorama: panorama
pant: pant
pantaloons: pantaloons
panther: panther
panting: panting
pants: pants
papa: papas
paper: paper,papers
parade: parade,paraded,parading
paradise: paradise
paragraph: paragraph
parallel: parallel,parallels
paralysis: paralysis
paralyze: paralyzed
pare: paring
paregoric: paregoric
parent: parent,parents
paris: paris
park: park,parks
parlance: parlance
parlor: parlor
partial: partial
participation: participation
partition: partition,partitioned,partitions
partly: partly
partner: partner
partnership: partnership
party: parties,party
pass: pass,passed,passes,passing
passage: passage,passages
passing: passing
passion: passion,passions
paste: paste
pastime: pastime
pastor: pastor
pasture: pasture
pat: patted
patch: patched
patched: patched
patent: patent
path: path,paths
pathos: pathos
patience: patience
patient: patient,patients
patiently: patiently
patrol: patrol,patrols
patrolman: patrolman
patron: patron,patrons
patronage: patronage
patronize: patronized
paul: paul
pauper: pauper,paupers
pauperdom: pauperdom
pauperism: pauperism
pauperize: pauperizes,pauperizing
pave: paved,paving
pavement: pavement
pawn: pawn
pawnbroker: pawnbroker
pawnshop: pawnshops
pay: paid,pay,paying,pays
payer: payer
paymaster: paymaster
payment: payment
peace: peace
peaceably: peaceably
peaceful: peaceful
peacefully: peacefully
peach: peaches
peal: peals
pearl: pearl
pebble: pebble
peculiar: peculiar
peculiarity: peculiarity
peculiarly: peculiarly
peddle: peddles,peddling
pedigree: pedigree
pedlar: pedlar,pedlars
peg: peg
pell: pell
pen: pen,penned,pent
penal: penal
penalty: penalty
penance: penance
pencil: pencil,pencils
pend: pending
pendulum: pendulum
penetrate: penetrates
penitentiary: penitentiary
penniless: penniless
penny: pennies,penny
penury: penury
people: peopled
peopled: peopled
perambulate: perambulate,perambulating
perceive: perceived
percentage: percentage,percentages
perch: perch
perennial: perennial
perfect: perfect
perfectly: perfectly
perform: performing,performs
performance: performance,performances
peril: peril
period: period
periodical: periodical
periodically: periodically
perish: perishing
peritonitis: peritonitis
permanent: permanent
permission: permission
permit: permit,permits,permitted
pernicious: pernicious
perpetrate: perpetrated
perpetual: perpetual
perpetuate: perpetuate,perpetuated,perpetuating
perplex: perplexed
perplexing: perplexing
perplexity: perplexity
persecution: persecution,persecutions
persecutor: persecutors
persia: persia
persist: persist
persistent: persistent
persistently: persistently
person: people,person,persons
personal: personal
personality: personality
persuade: persuade,persuaded,persuading
pertain: pertaining
pervade: pervade,pervading
perversity: perversity
pervert: perverted
perverted: perverted
pessimist: pessimist
pest: pest
pestilence: pestilence
petty: petty
phalanx: phalanx
phase: phase
philadelphia: philadelphia
philanthropic: philanthropic
philanthropist: philanthropist
philanthropy: philanthropy
philosophic: philosophic
philosophically: philosophically
philosophy: philosophy
phlegmatic: phlegmatic
photograph: photograph,photographed,photographs
photographer: photographer
physical: physical
physically: physically
physician: physician
physiognomy: physiognomy
piano: pianos
pick: pick,picked,picking
pickaxe: pickaxe
picker: picker,pickers
picket: picketed
picking: picking
pickle: pickles
picnic: picnic,picnics
picnicker: picnickers
picture: picture,pictures
picturesque: picturesque
picturesquely: picturesquely
picturesqueness: picturesqueness
pie: pie
piece: piece,pieces
pier: pier
pig: pig,pigs
pigeon: pigeon
pigtail: pigtail
pilate: pilate
pile: pile,piled,piles,piling
pillar: pillars
pillow: pillowed
pin: pin,pinned,pins
pinch: pinched
pinched: pinched
pine: pine
pioneer: pioneers
pious: pious
pipe: pipe,pipes
pit: pit,pits
pitch: pitch,pitched,pitching
pitcher: pitcher
piteously: piteously
pitfall: pitfalls
pitiful: pitiful
pitifully: pitifully
pitiless: pitiless
pittance: pittance
pity: pitied,pity,pitying
placidly: placidly
plague: plague,plagues
plain: plain,plainer
plainly: plainly
plaintive: plaintive
plan: plan,planned,plans
plane: plane
plank: plank,planks
planner: planners
planning: planning
plant: planted
plate: plate
platform: platform
plausible: plausible
play: play,playing,plays
player: players
playmate: playmates
plea: plea
plead: plead,pleading
pleasant: pleasant
pleasing: pleasing
pleasure: pleasure
plentifully: plentifully
plenty: plenty
plight: plight
plot: plot,plotting
pluck: pluck,plucked,plucking
plucky: plucky
plug: plug
plumbing: plumbing
plunder: plunder
plunge: plunging
plush: plush
pocket: pocket,pockets
poet: poet
poetic: poetic
poison: poison,poisoned
poisoning: poisoning
poisonous: poisonous
poke: poked
poland: poland
pole: pole
police: police
policeman: policeman,policemen
policy: policies,policy
polish: polish
polite: polite
political: political
politician: politician,politicians
politics: politics
poll: polls
pollute: polluted,polluting
pomp: pomp
pond: pond
poor: poor,poorer,poorest
poorhouse: poorhouse
popular: popular
populate: populated
population: population
populous: populous
pork: pork
port: port,ports
portal: portal
portent: portent
portion: portion,portions
pose: pose
position: position
possess: possess,possessed,possesses,possessing
possession: possession,possessions
possibility: possibilities,possibility
post: post,posted,posts
posy: posies
pot: pot
potato: potatoes
potency: potency
potter: potter
pouch: pouch
pound: pound
pour: pour,pouring
poverty: poverty
power: power,powers
powerful: powerful
powerless: powerless
pox: pox
practicable: practicable
practical: practical
practically: practically
practice: practice
practise: practised
prayer: prayer,prayers
preach: preached,preaching
preacher: preacher
preaching: preaching
precaution: precaution
precede: preceded
precinct: precinct,precincts
precise: precise
precisely: precisely
preconceived: preconceived
predatory: predatory
predecessor: predecessor
predict: predicted
predispose: predisposed
predominate: predominates
preface: preface,prefaced
prefer: prefer,preferred,preferring,prefers
preferable: preferable
preference: preference,preferences
pregnant: pregnant
prejudice: prejudice
preliminary: preliminaries,preliminary
premise: premises
premium: premium,premiums
preparation: preparations
prepared: prepared
prerequisite: prerequisite
presage: presage
presence: presence
presently: presently
preservation: preservation
preserve: preserve,preserves,preserving
preside: presided,presides
president: president
presidential: presidential
press: press,pressed,presses,pressing
pressure: pressure
presume: presumed
presuppose: presupposes
pretence: pretence,pretences
pretend: pretend,pretended
pretension: pretensions
pretext: pretext
pretty: pretty
prevail: prevailed,prevailing,prevails
prevalence: prevalence
prevent: prevent,prevented,preventing,prevents
prevention: prevention
previous: previous
prey: prey
price: price,prices
prick: pricked
pride: pride
priest: priest,priests
primary: primary
prime: prime
princely: princely
principal: principal
principle: principle,principles
print: print,printed,prints
printer: printer,printers
printing: printing
prison: prison,prisons
prisoner: prisoner,prisoners
prisoners: prisoners
pristine: pristine
privacy: privacy
private: private
privation: privation
privilege: privilege
prize: prize,prizes
prizes: prizes
pro: pro
probability: probability
probe: probe
proceed: proceed,proceeds
proceedings: proceedings
proceeds: proceeds
process: process
procession: procession
proclaim: proclaim
procure: procuring
prod: prods
prodigious: prodigious
produce: produce
product: product
productive: productive
profane: profane
profanity: profanity
profess: profess,professed
profession: profession
professional: professional
professor: professor
profit: profit,profiting,profits
profitable: profitable
profligate: profligate
programme: programme
progress: progress
prohibit: prohibit,prohibited,prohibiting
prohibition: prohibition
project: project,projects
proletariat: proletariat
prolific: prolific
prominence: prominence
promiscuous: promiscuous
promise: promise,promises
promising: promising
promotion: promotion
prompt: prompted,prompts
promptness: promptness
prone: prone
proof: proof
prop: propped,propping
propaganda: propaganda
propagandism: propagandism
proper: proper
properly: properly
property: property
prophylactic: prophylactic
proportion: proportion,proportions
propose: proposed
proposition: proposition
proprietor: proprietor,proprietors
propriety: proprieties
proscribe: proscribed
proscription: proscription
prospect: prospect
prospective: prospective
prosper: prospers
prosperity: prosperity
prosperous: prosperous
protect: protect
protection: protection
protest: protest,protesting,protests
protestant: protestant,protestants
proudly: proudly
prove: prove,proved,proves
proverb: proverb
proverbial: proverbial
provide: provide,providing
provision: provision
provocation: provocation
provoke: provoked
proxy: proxy
prudent: prudent
public: public
pull: pull,pulls
puller: pullers
pulley: pulley
pulpit: pulpit,pulpits
pulse: pulse
pulverize: pulverizing
pump: pump,pumps
punch: punched,punches
punctuation: punctuation
pungent: pungent
punish: punish,punished
punishment: punishment
pupil: pupil,pupils
purchase: purchase,purchased
pure: pure,purer
purely: purely
purify: purified
purity: purity
purple: purple
purpose: purpose,purposes
purposely: purposely
purse: purse,purses
pursue: pursue,pursued,pursues,pursuing
pursuit: pursuit
purveyor: purveyor
push: pushed,pushes,pushing
puzzle: puzzle
puzzled: puzzled
puzzling: puzzling
quail: quailed
quaker: quaker
qualified: qualified
quality: qualities,quality
qualmy: qualmy
quarrel: quarrel,quarrelled,quarrelling,quarrels
quarrelling: quarrelling
quarry: quarry
quart: quart,quarts
quarter: quarter,quarters
queer: queer
quench: quenched
querulous: querulous
query: query
question: question,questioned,questions
questionable: questionable
quick: quick
quiescence: quiescence
quiet: quiet,quieted,quietest
quietly: quietly
quilt: quilt
quit: quit
quote: quote,quoted
rabbi: rabbi
rabbinical: rabbinical
rabbit: rabbits
race: race,races
rachel: rachel
rack: racks
racket: racket,rackets
radical: radical
radish: radish
rafter: rafters
rag: rag,rags
ragamuffin: ragamuffin,ragamuffins
rage: rage
ragged: ragged
raid: raid,raided,raids
railroad: railroad
rain: rain,rains
rainbow: rainbow
rainy: rainy
raise: raise,raised,raises,raising
ramshackle: ramshackle
randall: randall
random: random
range: range,ranged,ranges,ranging
rank: rank,ranks
rap: rap
rapid: rapid
rapidly: rapidly
rare: rare,rarest
rarely: rarely
rarity: rarity
rascal: rascals
rascality: rascality
rascally: rascally
rasp: rasping
rat: rat,rats
rata: rata
rate: rate,rates
ratio: ratio
ration: ration,rations
rattle: rattled
ravage: ravaged
raven: raven
raw: raw
ray: ray,rays
razor: razor,razors
reach: reach,reached,reaches,reaching
reaction: reaction
read: read,reads
reader: reader,readers
readiness: readiness
reading: reading
ready: readier,ready
real: real
reality: reality
realize: realized
reap: reap,reaped,reaps
reappear: reappear
rear: rear,reared
reason: reason,reasons
reasonable: reasonable
reasoning: reasoning
reassure: reassuring
reawakening: reawakening
rebate: rebate
rebel: rebel,rebels
rebellion: rebellion
rebuke: rebuke
recall: recall
recast: recast
receipt: receipts
receive: receive,received,receives,receiving
receiver: receivers
recital: recital
reckless: reckless
reckoning: reckoning
reclaim: reclaim,reclaiming
reclamation: reclamation
recognition: recognition
recognize: recognized,recognizes
recollect: recollect
recollection: recollection
recommend: recommended
record: record,recorded,records
recourse: recourse
recover: recovered,recovering,recovers
recovery: recovery
recreation: recreation
recruit: recruit,recruited,recruiting,recruits
recruiting: recruiting
recumbent: recumbent
red: red
redeem: redeem,redeemed
redeeming: redeeming
redemption: redemption
reduce: reduce,reduced,reduces,reducing
refer: refer,referred
referable: referable
reference: reference
refine: refined
refined: refined
refit: refitted
reflect: reflect,reflected
reform: reform,reformed,reforming
reformatory: reformatories,reformatory
reformer: reformer,reformers
refractory: refractory
refuge: refuge
refuse: refuse,refused,refuses,refusing
regard: regard,regarded
regeneration: regeneration
regimental: regimentals
region: region
register: register,registered
registrar: registrar
registry: registry
regret: regret,regrets
regular: regular
regularly: regularly
regulate: regulate,regulates
regulation: regulation,regulations
rehabilitation: rehabilitation
rehearsal: rehearsals
reign: reign,reigns
reinforce: reinforced
reject: rejects
rejection: rejection
rejoice: rejoices
relapse: relapsed
relation: relation
relationship: relationship
relative: relative,relatives
relaxed: relaxed
relentless: relentless
reliance: reliance
relic: relic
relief: relief
relieve: relieve,relieving
religion: religion
religious: religious
remain: remain,remained,remains
remark: remark
remarkably: remarkably
remedial: remedial
remedy: remedied,remedy
remember: remember,remembered
remind: remind,reminded
reminder: reminder
remodel: remodelling
removal: removal
remove: remove,removed
render: render,rendered,rendering
renegade: renegade
renew: renewed
rent: rent,rented,rents
rental: rental,rentals
renumber: renumbered
repair: repair,repairs
repay: repay
repeat: repeated,repeats
repentance: repentance
repine: repining
reply: replied,replies
report: report,reported,reports
reporter: reporter
repose: repose,reposed
represent: represent,represented,representing,represents
representation: representation
representative: representative,representatives
repressive: repressive
reproach: reproach
reproduce: reproduced,reproduces
reproduction: reproduction
republican: republican
repulsive: repulsive
repulsively: repulsively
reputable: reputable
reputation: reputation
repute: repute
reputed: reputed
request: request,requests
require: require,required,requires,requiring
requirement: requirements
rescue: rescue,rescued,rescues,rescuing
resemble: resembles
resent: resent
resentment: resentment
reserve: reserve,reserves
residence: residence,residences
resident: residents
residential: residential
resignation: resignation
resist: resist,resists
resistless: resistless
resolution: resolution
resolve: resolved,resolves
resort: resort,resorts
resound: resounded
resource: resources
respect: respect,respected
respectability: respectability
respectable: respectable
respectful: respectful
respiratory: respiratory
respond: respond,responded,responds
response: response
responsibility: responsibilities,responsibility
responsible: responsible
responsive: responsive
rest: rest,resting,rests
restaurant: restaurant,restaurants
restitution: restitution
restless: restless
restore: restored
restraint: restraint
restrict: restricted
result: result
resume: resumed
resuscitation: resuscitation
retain: retained
retort: retort
return: return,returned,returning,returns
reunite: reunited
reveal: revealing
revel: revelling
revelry: revelry
revenge: revenge
revenue: revenue
reverse: reverse
review: review
revival: revivals
revolt: revolts
revolver: revolvers
reward: reward,rewarding
rheumatism: rheumatism
ribald: ribald
rice: rice
rich: rich,richer
richly: richly
rickety: rickety
rid: rid
ride: ride
ridicule: ridicule
ridiculously: ridiculously
rifle: rifled
rift: rift
righteousness: righteousness
rightly: rightly
rigorous: rigorous
riot: riot,riots
rioting: rioting
ripe: ripe
rise: rise,rises,rising,rose
risk: risk,risks
rite: rite
rival: rival,rivals
rivalry: rivalries,rivalry
river: river,rivers
riverside: riverside
road: road,roads
roam: roamed,roams
roar: roar
roast: roast
rob: rob,robbed,robbing
robber: robber,robbers
robbery: robbery
rock: rock,rocks
rocky: rocky
roger: roger
rogues: rogues
role: role
roll: roll,rolled,rolling,rolls
rolling: rolling
roman: roman
romantic: romantic
romp: romps
roof: roof,roofs
rookery: rookeries,rookery
roomful: roomful
roomy: roomy
roosevelt: roosevelt
roost: roost
root: root,rooted,roots
rope: rope
rot: rotted
rotten: rotten
rough: rough,roughest
roughly: roughly
rounders: rounders
rouse: rouse,roused
route: route
row: row,rows
rubbish: rubbish
rude: rude
ruffian: ruffian,ruffians
ruffianly: ruffianly
rugged: rugged
ruin: ruin,ruined
ruinous: ruinous
rule: rule,rules,ruling
ruler: ruler,rulers
ruling: ruling
rum: rum
rumpus: rumpus
rumshop: rumshop
runaway: runaways
running: running
runway: runway,runways
rush: rush,rushes,rushing
russell: russell
russia: russia
russian: russian
rusty: rusty
rut: rut
sabbath: sabbath
sack: sack,sacking
sacrifice: sacrifice,sacrificed
sacrilegious: sacrilegious
sad: sad,sadder
sadden: saddening
saddening: saddening
sadly: sadly
safe: safe,safer
safely: safely
safety: safety
sail: sailed
sailing: sailing
sailor: sailors
saint: saint
sake: sake
salad: salad
salary: salary
sale: sale,sales
saleswoman: saleswoman,saleswomen
sallow: sallow
sally: sallying
saloon: saloon,saloons
saloonkeeper: saloonkeeper
salutary: salutary
salvation: salvation
sample: sample,samples
sanctuary: sanctuary
sand: sand
sandwich: sandwich
sanitarian: sanitarian
sanitarians: sanitarians
sanitary: sanitary
sap: saps
sarcasm: sarcasm
sardonic: sardonic
satisfaction: satisfaction
satisfactory: satisfactory
satisfied: satisfied
satisfy: satisfy
saturday: saturday
satyr: satyrs
sausage: sausage
sausages: sausages
savage: savage
savagery: savagery
save: save,saved,saves,saving
saving: saving
savings: savings
scaffold: scaffold
scale: scale
scandal: scandal
scandalous: scandalous
scandinavian: scandinavian
scant: scant
scantily: scantily
scanty: scantiest,scanty
scarce: scarce
scarcely: scarcely
scarcity: scarcity
scare: scare
scared: scared
scarlet: scarlet
scatter: scatter,scattered,scattering
scattered: scattered
scavenger: scavenger,scavengers
scene: scene,scenes
scent: scent
sceptical: sceptical
schedule: schedules
scheme: scheme,schemes,scheming
scholar: scholars
school: school,schools
schooling: schooling
schoolroom: schoolroom
schools: schools
schooner: schooner,schooners
science: science
scientific: scientific
scientist: scientist
scissors: scissors
scoff: scoffing
scope: scope
score: score,scores
scorn: scorn,scorns
scornful: scornful
scot: scot
scotland: scotland
scoundrel: scoundrel,scoundrels
scourge: scourge
scow: scow,scows
scowl: scowl
scrap: scrap,scraps
scrape: scraped,scraping
scrawl: scrawl
scream: scream,screamed,screams
screen: screen
scriptural: scriptural
scrub: scrub,scrubbing,scrubs
scrubbing: scrubbing
scruple: scruples
scrupulous: scrupulous
scrupulously: scrupulously
scrutiny: scrutiny
scullery: scullery
scum: scum
scurry: scurrying
sea: sea,seas
seam: seams
seaman: seaman
search: search,searching
searching: searching
season: season,seasons
seat: seat,seats
secret: secret,secrets
secretary: secretary
secretiveness: secretiveness
secretly: secretly
secure: secure,secured,secures
securely: securely
security: security
sediment: sediment
seed: seed
seek: seek,seeking,seeks,sought
seeker: seeker,seekers
seemingly: seemingly
seize: seized
seldom: seldom
select: selected
selection: selection
selfish: selfish
selfishness: selfishness
sell: sell,selling,sells,sold
selling: selling
semites: semites
senate: senate
senators: senators
send: send,sending,sends
sensation: sensation
sensational: sensational
sense: sense
senseless: senseless
sensuality: sensuality
sentence: sentence,sentences,sentencing
sentiment: sentiment
sentimental: sentimental
separate: separate,separated,separates
september: september
serenely: serenely
serf: serf
serfdom: serfdom
sergeant: sergeant
series: series
seriousness: seriousness
sermon: sermon,sermons
serve: serve,served,serves,serving
service: service,services
servitude: servitude
session: session
set: set,sets,setting
setting: setting
settle: settled,settles
settled: settled
settlement: settlement,settlements
seventeen: seventeen
seventh: seventh
severe: severest
severity: severity
sew: sew,sewn
sewer: sewer,sewers
sewing: sewing
sex: sexes
shabbiness: shabbiness
shabby: shabby
shade: shade
shading: shading
shadow: shadow
shady: shady
shaft: shaft,shafts
shake: shake,shaken,shakes
shaky: shaky
shallow: shallowest
shame: shame
shameful: shameful
shanty: shanties,shanty
shape: shape,shapes
share: share,shared,shares,sharing
sharer: sharers
sharp: sharp
sharpen: sharpening
sharpened: sharpened
sharper: sharpers
sharply: sharply
shawl: shawl
shear: shorn
sheeny: sheeny
sheep: sheep
sheer: sheer
sheet: sheet,sheets
shelf: shelves
shelter: shelter,sheltered,sheltering,shelters
sheriff: sheriff
shield: shield,shielded,shielding
shift: shift
shiftless: shiftless
shiftlessness: shiftlessness
shine: shines,shining,shone
shingle: shingle
ship: ship,shipped
shipboard: shipboard
shirt: shirt,shirts
shirtmaker: shirtmaker
shiver: shiver,shivered,shivering
shoal: shoal
shock: shock,shocked,shocks
shocked: shocked
shocking: shocking
shoe: shoes
shoemaker: shoemaker
shoot: shoot,shot
shop: shop,shops
shopful: shopful
shopper: shoppers
shopping: shopping
shore: shore,shores
short: short
shorten: shorten,shortened
shortly: shortly
shot: shot,shots
shoulder: shoulder,shoulders
shout: shout,shouting,shouts
shove: shoving
shovel: shovel
shower: shower,showered,showers
shred: shreds
shrewd: shrewd
shrine: shrine,shrines
shrink: shrinks
shroud: shroud
shrubbery: shrubbery
shrug: shrugs
shudder: shudder,shuddering
shuffling: shuffling
shun: shun,shunned,shunning,shuns
shut: shut,shuts,shutting
shutter: shutter,shutters
shy: shy
sic: sic
sicilian: sicilian
sick: sick
sickness: sickness
sidelong: sidelong
sidewalk: sidewalk
siege: siege
sieve: sieve
sift: sifts
sigh: sigh,sighing
sight: sight,sights
sighted: sighted
sign: sign,signs
signal: signal
signify: signifying
silas: silas
silence: silence
silent: silent
silently: silently
silk: silk,silks
sill: sills
silly: silly
silver: silver
simple: simple
simplicity: simplicity
simply: simply
simultaneous: simultaneous
sin: sin,sins
sincerity: sincerity
sinful: sinful
sing: sang,sing
singer: singer
singing: singing
single: single
singular: singular
singularly: singularly
sink: sink,sinking,sinks,sunk
sir: sir
sister: sister,sisters
sisters: sisters
sit: sat,sit,sits,sitting
sitter: sitter,sitters
situation: situation
sixteen: sixteen
sixteenth: sixteenth
sixth: sixth
size: size,sizes
sized: sized
sketch: sketch
skill: skill
skilled: skilled
skin: skin,skinned,skinning
skinned: skinned
skip: skip,skips
skirt: skirt,skirted
skulk: skulk,skulking,skulks
skull: skull,skulls
sky: sky
slab: slab
slack: slack
slam: slamming
slamming: slamming
slang: slang
slash: slashed
slaughter: slaughter,slaughtered
slave: slave,slaves
slavery: slavery
sleep: sleep,sleeping,sleeps,slept
sleeper: sleeper,sleepers
sleeping: sleeping
sleepless: sleepless
sleeplessness: sleeplessness
sleeve: sleeve,sleeves
slice: slices
slide: slid,slide,sliding
slight: slight,slightest
slim: slim
slimy: slimy
sling: sling
slip: slip,slips
slit: slit
slope: slope,slopes,sloping
slothful: slothful
slothfulness: slothfulness
slough: slough
slovenliness: slovenliness
slow: slow
slowly: slowly
slowness: slowness
slug: slugged
slum: slum,slums
slumber: slumbered
slums: slums
slyly: slyly
smart: smart
smash: smashing
smell: smell,smelling,smells
smile: smile
smirch: smirch
smith: smith
smoke: smoke,smokes,smoking
smoking: smoking
smooth: smooth,smoothing
smoothly: smoothly
smother: smother,smothered
smoulder: smouldering
snail: snail,snails
snappish: snappish
snatch: snatches
sneak: sneak,sneaks
snore: snoring
snort: snort
snout: snout
snow: snow
snug: snug
snuggle: snuggle
soap: soap
sober: sober
sobriety: sobriety
social: social
societies: societies
society: societies,society
sock: socked,socks
sod: sod
soft: soft
softly: softly
soil: soil,soiled
soiled: soiled
soldier: soldier,soldiers
sole: sole,soles
solemnity: solemnity
solid: solid
solution: solution
solve: solve,solved,solving
sombre: sombre
son: son,sons
song: song,songs
sons: sons
soothing: soothing
soothingly: soothingly
sore: sore,sores
sorrow: sorrow
sorrowful: sorrowful
sort: sort,sorting,sorts
soul: soul,souls
sound: sound,sounded,sounds
soup: soup
sour: sour
source: source,sources
south: south
southern: southern
sovereign: sovereign
sow: sow,sown
space: space
span: span
spanish: spanish
spare: spare,spared
spark: sparks
sparsely: sparsely
spasmodic: spasmodic
speak: speak,speaking,speaks,spoke,spoken
special: special
specially: specially
specialty: specialty
species: species
specimen: specimen,specimens
speck: speck
spectacle: spectacle
spectacles: spectacles
spectacular: spectacular
spectre: spectre
speculation: speculation
speculator: speculator
speech: speeches
speechless: speechless
speed: speeds
speedily: speedily
spell: spelled,spells
spend: spend,spends,spent
sphere: sphere
spice: spice
spider: spider,spiders
spin: spin,spinning,spun
spirit: spirit,spirits
spirited: spirited
spiritual: spiritual
spite: spite
splash: splash,splashed
spoil: spoil
sponsor: sponsor
spoon: spoon
spot: spot,spots
spread: spread,spreading,spreads
spring: sprang,spring,springing,sprung
sprout: sprout
squad: squad,squads
squalid: squalid
squalor: squalor
squander: squandered
square: square,squared
squat: squat
squeak: squeak,squeaking
squeaky: squeaky
squeeze: squeeze,squeezed
squelch: squelching
stab: stabbed
stable: stable,stables
stack: stacked,stacks
staff: staff,staffs
stage: stage
stagger: stagger
staid: staid
stain: stain
stair: stairs
staircase: staircase
stairway: stairway,stairways
stale: stale
stalwart: stalwart
stamp: stamp,stamped
stand: stand,standing,stands,stood
standard: standard
standing: standing
standpoint: standpoint
staple: staple,staples
starch: starch
stare: stare,stared
stark: stark
start: start,started,starting,starts
startle: startle,startled
startling: startling
starvation: starvation
starve: starve,starved,starving
starving: starving
statement: statement
statesman: statesmen
station: station,stations
stationary: stationary
statistician: statisticians
statistics: statistics
stature: stature
status: status
statute: statute
statutory: statutory
stay: stay,stayed,staying,stays
steadily: steadily
steady: steadier,steady
steal: steal,steals,stole,stolen
stealth: stealth
steam: steam
steamer: steamer
steamship: steamship
stem: stems
stench: stench,stenches
step: step,stepped,steps
stereotyped: stereotyped
sterile: sterile
stern: stern
stew: stew,stewing
stick: stick,sticking
stiffen: stiffened
stifle: stifling
stifling: stifling
stigma: stigma
stile: stile
stiletto: stiletto
stint: stint
stinted: stinted
stir: stir
stock: stock
stocking: stockings
stolid: stolid
stolidly: stolidly
stomach: stomach,stomachs
stone: stone,stones
stony: stony
stool: stool,stools
stoop: stoop,stoops
store: store,stores
storehouse: storehouse
storekeeper: storekeeper,storekeepers
storm: storm,storms
stormy: stormier
story: stories,story
stout: stout
stoutly: stoutly
stove: stove
straight: straight
strain: strain,strains
strait: straits
strand: stranded
strange: strange
stranger: stranger,strangers
strap: strap,strapped
stratagem: stratagem
strategy: strategy
stratum: stratum
straw: straw
stray: stray,strayed,straying
streak: streak,streaks
stream: stream
streamer: streamers
street: street,streets
streets: streets
strength: strength
strengthen: strengthen
stress: stress
stretch: stretch,stretched,stretches
stricken: stricken
strict: strict
stride: stride,strides
strike: strike,strikes,struck
striking: striking
strikingly: strikingly
string: string,strings,strung
strip: strip,stripped,stripping
stripe: stripes
strive: strives,striving
stroke: stroke,stroked,strokes,stroking
stroll: stroll
strong: strong,stronger,strongest
stronghold: stronghold,strongholds
structure: structure,structures
struggle: struggle,struggled,struggles,struggling
strut: strutting
stubborn: stubborn
stubbornly: stubbornly
student: student
study: studies,study
stuff: stuff,stuffed
stumble: stumble,stumbled
stump: stumps
stumpy: stumpy
stunned: stunned
stunt: stunted
stupid: stupid
stupidity: stupidity
sturdy: sturdiest,sturdy
sty: sty
style: style,styled,styles
stylish: stylish
subject: subject
sublet: subletting
submission: submission
submissiveness: submissiveness
submit: submits
subscription: subscription
subsidy: subsidies
subsist: subsisted
substance: substance
substantial: substantial
subtler: subtler
suburb: suburb,suburbs
suburban: suburban
succeed: succeed,succeeding,succeeds
success: success
successful: successful
successive: successive
successor: successor,successors
succinctly: succinctly
sudden: sudden
suddenly: suddenly
suds: suds
suffer: suffer,suffered,suffering
sufferer: sufferer
suffering: suffering,sufferings
sufficient: sufficient
suffocation: suffocation
sugar: sugar,sugared
suggestion: suggestion
suggestive: suggestive
suicidal: suicidal
suicide: suicide
suit: suit,suits
suitable: suitable
suite: suite
sullen: sullen
sullenly: sullenly
sum: sum,summed,sums
summarily: summarily
summary: summary
summer: summer
summon: summon,summoning
sun: sun
sunday: sunday
sundays: sundays
sundry: sundry
sunless: sunless
sunlight: sunlight
sunny: sunny
sunrise: sunrise
sunset: sunset
sunshine: sunshine
superfluous: superfluous
superintendence: superintendence
superintendent: superintendent
superior: superior
superstition: superstition
supervision: supervision
supper: supper
supplement: supplement
supply: supplied,supplies,supply
support: support,supported,supporting
suppose: suppose,supposed,supposing
suppress: suppressed
surely: surely
surface: surface
surge: surges,surging
surgeon: surgeon,surgeons
surgical: surgical
surplus: surplus
surprise: surprise
surprising: surprising
surrender: surrender,surrendered
surround: surround,surrounding
surroundings: surroundings
survey: survey
survive: survive,survives
survivor: survivors
suspect: suspect,suspected,suspecting
suspender: suspender
suspenders: suspenders
suspension: suspension
suspicion: suspicion,suspicions
sustain: sustain
swain: swains
swallow: swallowing
swamp: swamp,swamped
swarm: swarmed,swarming,swarms
swarthy: swarthy
swathe: swathing
sway: sway
swear: swear,swore
swearing: swearing
sweat: sweat
sweater: sweater,sweaters
sweep: sweep,sweeping,swept
sweet: sweet,sweeter
sweeten: sweeten,sweetening
swell: swell,swelled,swelling,swells,swollen
swelling: swelling
sweltering: sweltering
swift: swift
swill: swill
swim: swam,swim
swindle: swindles
swine: swine
swing: swing,swung
swinging: swinging
swiss: swiss
sydney: sydney
syllable: syllable,syllables
sympathize: sympathized
sympathizer: sympathizer
sympathy: sympathy
symposium: symposiums
symptom: symptom
synagogue: synagogues
synonymous: synonymous
systematic: systematic
tabernacle: tabernacles
table: table,tables
tacit: tacit
tack: tack,tacked
tackle: tackled
tail: tail
tailor: tailor,tailoring,tailors
taint: taint,tainted
taker: taker
tale: tale,tales
talent: talent
talisman: talisman
talk: talk,talked,talking
talkative: talkative
talking: talking
tall: tall,taller
talmudic: talmudic
tan: tan
tantamount: tantamount
tap: tap
tape: tape
tar: tars
tardy: tardy
tare: tares
tares: tares
task: task,tasks
taste: taste
tatters: tatters
taunt: taunting
tax: tax,taxed,taxes
taxation: taxation
taylor: taylor
te: te
tea: tea
teach: taught
teacher: teacher,teachers
teaching: teachings
team: team,teams
tear: tear,tears,torn
tearful: tearful
teem: teeming
teens: teens
telegraph: telegraph
teller: teller
temerity: temerity
temper: temper
temperament: temperament
temple: temples
temporary: temporary
tempt: tempt,tempted,tempts
temptation: temptation,temptations
tempter: tempter
tempting: tempting
tenant: tenant,tenants
tenantry: tenantry
tenants: tenants
tend: tend
tendency: tendencies,tendency
tender: tender,tenderest
tenement: tenement,tenements
tenth: tenth
term: term,terms
terrible: terrible
terror: terror
terrorize: terrorized
testify: testified,testifies
testimony: testimony
teuton: teuton
teutonic: teutonic
textual: textual
tha: tha
thankfully: thankfully
thanksgiving: thanksgiving
thee: thee
theft: theft
thenceforth: thenceforth
thenceforward: thenceforward
theory: theories,theory
thereabout: thereabouts
thermometer: thermometer
thicken: thicken
thief: thief,thieves
thiefdom: thiefdom
thieve: thieving
thine: thine
thirst: thirst
thirsty: thirsty
thirteen: thirteen
thirteenth: thirteenth
thompson: thompson
thoroughfare: thoroughfare,thoroughfares
thoughtless: thoughtless
thread: thread,threads
threat: threat
threaten: threatened,threatening,threatens
threshold: threshold
thrift: thrift
thrifty: thrifty
thrive: thrive,thrives,thriving
thriving: thriving
throat: throat,throats
throb: throbbing,throbs
throng: throng
throw: threw,throw,throwing,thrown,throws
thrust: thrust
thug: thugs
thumb: thumb
thump: thumps
thundering: thundering
thursday: thursday
thy: thy
tick: tick
ticket: ticket
tide: tide
tidy: tidy
tie: tie,tied
tier: tier,tiers
tiger: tiger
tight: tighter
tighten: tightening
tightly: tightly
timber: timbers
time: time,times
tin: tin
tinge: tinge,tinges
tinkle: tinkling
tint: tints
tiny: tiny
tipsy: tipsy
tired: tired
tireless: tireless
title: title,titles
tobacco: tobacco
toboggan: toboggan
toddle: toddling
toddler: toddlers
tog: togs
toil: toil,toiled,toiling,toils
toiler: toilers
tolerable: tolerable
tolerance: tolerance
toll: toll
tomato: tomato,tomatoes
tombs: tombs
ton: ton
tone: tone
tongue: tongue,tongues
tool: tools
tooth: teeth
tornado: tornado
torture: tortures
tortured: tortured
toss: toss
tosser: tossers
total: total
touch: touch,touched,touches
touching: touching
tough: tough,tougher,toughs
toughs: toughs
tour: tour,tours
tow: tow
tower: towered,towering
town: town,towns
township: township
toy: toy
trace: trace,traced,tracing
track: track
tractability: tractability
tracy: tracy
trade: trade,trades
trader: trader
trades: trades
tradesman: tradesman
tradition: tradition,traditions
traditional: traditional
traducer: traducer
traffic: traffic,traffics
tragedy: tragedies
tragic: tragic
trail: trailing
train: train,trained,training
training: training
trait: trait,traits
tramp: tramp,tramped,tramping,tramps
trampdom: trampdom
trample: trampling
tramps: tramps
transaction: transaction
transcriber: transcriber
transcription: transcription
transfer: transferred
transform: transformed
transformation: transformation
transient: transient
transit: transit
translate: translated
transmit: transmit
trap: trap
trapeze: trapeze
travel: travel,travelled,travelling,travels
treacherous: treacherous
treachery: treachery
tread: tread,treading,trod
treasonable: treasonable
treasury: treasury
treat: treat
treatment: treatment
tree: tree,trees
tremble: trembling
tremendous: tremendous
tremendously: tremendously
trench: trench,trenching
trial: trial
triangle: triangle
triangular: triangular
tribe: tribe,tribes
trick: trick,tricks
trifle: trifle
trifling: trifling
trim: trim
trimming: trimming,trimmings
trip: trip,trips
triple: triple
triumph: triumphs
trivial: trivial
trodden: trodden
troop: trooped
trouble: trouble,troubles
troubled: troubled
trough: trough
trousers: trousers
trow: trow
truant: truant
truck: truck,trucks
true: true,truer
trunk: trunks
trust: trust,trusted,trusts
trustful: trustful
truth: truth
tub: tub,tubs
tuck: tucked
tug: tug
tulip: tulips
tumble: tumble,tumbled,tumbles,tumbling
tune: tune
tunnel: tunnels
turban: turban
turbulence: turbulence
turbulent: turbulent
turf: turf
turmoil: turmoil
turpitude: turpitude
turret: turrets
tweed: tweed
twelvemonth: twelvemonth
twig: twigs
twin: twin,twins
twist: twist,twisted,twisting
type: type
typewrite: typewriting
typhus: typhus
typical: typical
typically: typically
tyrannical: tyrannical
tyrant: tyrant,tyrants
ubiquitous: ubiquitous
ugly: ugliest,ugly
ukase: ukase
ulterior: ulterior
ultimate: ultimate
ultimatum: ultimatum
unable: unable
unacquainted: unacquainted
unadorned: unadorned
unanimous: unanimous
unarmed: unarmed
unasked: unasked
unattainable: unattainable
unattractive: unattractive
unauthorized: unauthorized
unavailing: unavailing
unavenged: unavenged
unavoidable: unavoidable
unbearable: unbearable
unbelief: unbelief
unborn: unborn
unceasing: unceasing
unchallenged: unchallenged
unchanged: unchanged
unchecked: unchecked
unclaimed: unclaimed
unclean: unclean
uncleanliness: uncleanliness
uncleanly: uncleanly
unclouded: unclouded
uncommon: uncommon
uncomplaining: uncomplaining
uncomplainingly: uncomplainingly
unconcerned: unconcerned
unconquerable: unconquerable
unconscious: unconscious
unconsciously: unconsciously
unconstitutional: unconstitutional
uncontrollable: uncontrollable
uncover: uncovered
unction: unction
undaunted: undaunted
undeceive: undeceive
undefiled: undefiled
underbid: underbid
underestimate: underestimated
underfoot: underfoot
underground: underground
undermine: undermines
underpaid: underpaid
underpinning: underpinnings
understand: understand,understands,understood
undertake: undertake,undertaken,undertook
undertaker: undertaker
undertaking: undertaking,undertakings
underwear: underwear
undeserved: undeserved
undeveloped: undeveloped
undiscriminating: undiscriminating
undisguised: undisguised
undismay: undismayed
undisturbed: undisturbed
undo: undo,undone
undoubted: undoubted
undoubtedly: undoubtedly
unearth: unearths
uneasily: uneasily
uneasy: uneasy
unemployed: unemployed
unenviable: unenviable
unexampled: unexampled
unexpected: unexpected
unfair: unfair
unfamiliar: unfamiliar
unfathomable: unfathomable
unfinished: unfinished
unfit: unfit
unfortunate: unfortunate,unfortunates
unguarded: unguarded
unhappily: unhappily
unhealthy: unhealthy
unheeded: unheeded
unheralded: unheralded
unhesitating: unhesitating
unhesitatingly: unhesitatingly
unhindered: unhindered
unhonored: unhonored
unhung: unhung
uniform: uniform
unimpaired: unimpaired
uninstructed: uninstructed
uninterested: uninterested
uninterrupted: uninterrupted
union: union,unions
unique: unique
united: united
universal: universal
universally: universally
unjust: unjust
unjustly: unjustly
unkindness: unkindness
unknown: unknown
unlawful: unlawful
unlearn: unlearn
unlicensed: unlicensed
unload: unloads
unlock: unlocks
unluckily: unluckily
unmake: unmakes
unmerciful: unmerciful
unmistakable: unmistakable
unmixed: unmixed
unmolested: unmolested
unmoved: unmoved
unnecessary: unnecessary
unnumbered: unnumbered
unoccupied: unoccupied
unoffending: unoffending
unpaid: unpaid
unpainted: unpainted
unpitying: unpitying
unpleasantness: unpleasantness
unpractised: unpractised
unprecedented: unprecedented
unprepared: unprepared
unprofitable: unprofitable
unqualified: unqualified
unquestionably: unquestionably
unrestrained: unrestrained
unrivalled: unrivalled
unromantic: unromantic
unruffled: unruffled
unruly: unruly
unsafe: unsafe
unsalaried: unsalaried
unsatisfied: unsatisfied
unsavory: unsavory
unscrupulous: unscrupulous
unseeing: unseeing
unseen: unseen
unselfish: unselfish
unsettle: unsettled
unsewn: unsewn
unskilled: unskilled
unsolved: unsolved
unspoken: unspoken
unsteadiness: unsteadiness
unsteady: unsteady
unsuspected: unsuspected
unsuspecting: unsuspecting
untangle: untangle
unthinking: unthinking
unthrift: unthrift
untie: untying
untimely: untimely
untiring: untiring
untold: untold
untouched: untouched
unusual: unusual
unusually: unusually
unutterable: unutterable
unventilated: unventilated
unwary: unwary
unwelcome: unwelcome
unwholesome: unwholesome
unwillingly: unwillingly
unwind: unwound
unwonted: unwonted
unwontedly: unwontedly
unworthy: unworthy
unwritten: unwritten
upas: upas
upheaval: upheavals
uphill: uphill
upper: upper
uppermost: uppermost
upright: upright
upset: upset
upstairs: upstairs
uptown: uptown
upward: upward
urchin: urchin
urge: urged,urging
urgent: urgent
urgently: urgently
usage: usage
useless: useless
usual: usual
usurious: usurious
usurp: usurped
utmost: utmost
utopian: utopian
utter: utter,uttered
utterly: utterly
vacant: vacant
vaccinate: vaccinate
vagabond: vagabond,vagabonds
vagrancy: vagrancy
vagrant: vagrants
vague: vague
vaguely: vaguely
vain: vain
vainly: vainly
valley: valley
valuable: valuable
vanish: vanished
vanity: vanity
vanquish: vanquished
variation: variation,variations
variety: variety
vary: varying
vast: vast
vastly: vastly
vat: vat
vault: vaulted
vegetable: vegetables
vehemently: vehemently
vehicle: vehicle
vein: veins
venerable: venerable
vengeful: vengeful
vengefully: vengefully
vent: vent
ventilation: ventilation
venture: venture,ventures
verdict: verdict
verge: verging
verily: verily
veritable: veritable
versatility: versatility
vestibule: vestibule
vex: vexed
vexatious: vexatious
vicarious: vicarious
vice: vice,vices
vicious: vicious
victim: victim,victims
victor: victors
victorious: victorious
victory: victory
view: view
vigilance: vigilance
vigorous: vigorous
vii: vii
viii: viii
vile: vile,vilest
village: village
vine: vine
violate: violate
violence: violence
violent: violent
virtual: virtual
virtue: virtue,virtues
virtuous: virtuous
virulent: virulent
visible: visible
visit: visit,visited,visiting,visits
visitation: visitation
visitor: visitor,visitors
vital: vital
vitals: vitals
vivid: vivid
vocal: vocal
voice: voice,voiced,voices
volume: volume
voluntarily: voluntarily
voluntary: voluntary
volunteer: volunteered
vote: vote,voted,votes
voter: voter,voters
vouch: vouched
vulgarity: vulgarity
wag: wag
wage: wage,waged
wages: wages
wagon: wagon,wagons
waif: waif,waifs
wail: wail
waist: waist
wait: wait,waited,waiting
waiter: waiter
wake: wake,woke
walk: walk,walked,walking,walks
wall: wall,walls
wan: wan
wander: wandered,wanders
wanderer: wanderer
wane: waning
wanton: wanton
war: war,wars
ward: ward,wards
warden: warden
ware: ware
warehouse: warehouse,warehouses
wares: wares
warfare: warfare
warm: warm,warmer,warming
warn: warning
warning: warning
warrant: warrant,warranted,warrants
wary: wary
wash: wash,washed,washing
washday: washday
washer: washer
washerwoman: washerwoman
washing: washing
washington: washington
waste: waste,wasted,wasting
wasteful: wasteful
wastefulness: wastefulness
watch: watch,watched,watching
watchful: watchful
watchfulness: watchfulness
watchword: watchword
water: water,waters
watermelon: watermelon
wave: wave,waves
waver: waver,wavering
wax: waxing
wayfarer: wayfarer
weak: weak
weakness: weakness
wealth: wealth
wealthy: wealthier,wealthy
weapon: weapons
wear: wear,wearing,wears,worn
wearer: wearer
wearisome: wearisome
weary: weary
weasel: weasel
weather: weather
wedding: wedding
wedge: wedge
wednesday: wednesday
weed: weed,weeded,weeds
week: week,weeks
weekly: weekly
weep: weeping
weight: weight
welfare: welfare
west: west
western: western
wet: wet
wharf: wharf
whatsoever: whatsoever
wheat: wheat
wheel: wheel
whereabouts: whereabouts
whereat: whereat
whimper: whimper
whine: whine,whining
whir: whir,whirring
whirlpool: whirlpool
whiskey: whiskey
whistle: whistled
whit: whit
white: white
whites: whites
wholesale: wholesale
wholesome: wholesome
wholly: wholly
whyo: whyo
wicked: wicked,wickedest
wickedness: wickedness
wide: wide,wider
widen: widening,widens
widow: widow
wield: wields
wife: wife,wives
wild: wild
wildly: wildly
willie: willie
wilson: wilson
wily: wily
win: wins
wince: winces
wind: wind,winding,winds
window: window,windows
windsor: windsor
wine: wines
wingate: wingate
wink: winked
winner: winner
winnings: winnings
winter: winter
wintry: wintry
wipe: wipe,wiped
wire: wires
wisdom: wisdom
wise: wise,wiser,wisest
wisely: wisely
wit: wit
witch: witches
withal: withal
withhold: withheld
witness: witness,witnessed,witnesses
woe: woe
wolf: wolf
woman: woman,women
womanhood: womanhood
womanly: womanly
women: women
wonderfully: wonderfully
wondrous: wondrous
wood: wood
wooden: wooden
word: word
worker: worker,workers
workhouse: workhouse,workhouses
workingmen: workingmen
workman: workman,workmen
workshop: workshops
worn: worn
worry: worried
worship: worship,worshipping
worshipper: worshipper,worshippers
worth: worth
worthily: worthily
worthy: worthier,worthy
wound: wound,wounded
wounded: wounded
wrap: wrap
wrapper: wrapper,wrappers
wrath: wrath
wreath: wreaths
wreck: wreck,wrecked,wrecking,wrecks
wrecks: wrecks
wrestle: wrestling
wretch: wretch,wretches
wretched: wretched
wretchedly: wretchedly
wretchedness: wretchedness
wring: wring,wrung
wrinkle: wrinkled
write: write,writes,writing,written,wrote
writing: writing
wrong: wrong,wrongs
xi: xi
xii: xii
xiii: xiii
xiv: xiv
xix: xix
xvi: xvi
xvii: xvii
xviii: xviii
xx: xx
xxi: xxi
xxii: xxii
xxiii: xxiii
xxiv: xxiv
xxv: xxv
yard: yard,yards
yarn: yarn
yawn: yawns
yearn: yearn
yearning: yearnings
yell: yelled
yellow: yellow
yen: yen
yesterday: yesterday
yield: yield,yielding
yoke: yoke
yoking: yoking
yonder: yonder
york: york
yorkers: yorkers
youngster: youngsters
youth: youth
zebra: zebra
