abatement: abatement
abbey: abbey,abbeys
abhor: abhor
abhorrent: abhorrent
ability: abilities
abode: abode
abominably: abominably
abridger: abridger
abruptly: abruptly
abruptness: abruptness
absence: absence
absent: absent
absolute: absolute
absolutely: absolutely
absurd: absurd
absurdity: absurdity
abundance: abundance
abuse: abuse
abyss: abyss
accept: accept,accepted,accepting
acceptance: acceptance
accessible: accessible
accession: accession
accident: accident
accidental: accidental
accidentally: accidentally
accommodate: accommodate
accommodation: accommodation,accommodations
accompany: accompanied,accompany,accompanying
accomplish: accomplish,accomplished,accomplishing
accomplishment: accomplishment
accord: accord
account: account,accounted,accounts
accountable: accountable
accumulation: accumulation
accuse: accuse,accused
accustom: accustomed
accustomed: accustomed
acknowledge: acknowledge,acknowledged,acknowledging
acknowledgment: acknowledgment
acquaint: acquainted
acquaintance: acquaintance
acquiesce: acquiesce
acquiescence: acquiescence
acquisition: acquisition
acquit: acquit,acquitted
acre: acres
action: action,actions
active: active
activity: activity
actual: actual
acute: acute
acuteness: acuteness
adapt: adapted
add: add,adding
addicted: addicted
addition: addition
additional: additional
address: address,addressed,addressing
adieu: adieu
adieus: adieus
adjourn: adjourned
adjust: adjusted
administer: administering
admirably: admirably
admiration: admiration
admire: admire,admired,admiring
admission: admission
admit: admit,admitted,admitting
admittance: admittance
adopt: adopt
adorn: adorned
advance: advance,advanced,advances,advancing
advanced: advanced
advantage: advantage,advantages
advantageous: advantageous
adventure: adventure,adventures
advertise: advertised
advertisement: advertisement
advice: advice
advise: advise
affair: affair,affairs
affect: affect
affectation: affectation
affectedly: affectedly
affection: affection,affections
affectionate: affectionate
affectionately: affectionately
affirmative: affirmative
afflict: afflicted
affliction: affliction
afford: afford,afforded
affrighted: affrighted
affront: affront,affronted,affronts
afraid: afraid
afternoon: afternoon
age: age,ages
agitate: agitated
agitated: agitated
agitation: agitation
agony: agonies,agony
agree: agree,agreed,agreeing
agreeable: agreeable
agreeableness: agreeableness
agreeably: agreeably
agreement: agreement
aim: aim,aimed,aiming
air: air,airs
airing: airing
alacrity: alacrity
alarm: alarm,alarmed,alarms
alarming: alarming
alarmingly: alarmingly
alas: alas
alfred: alfred
alice: alice
alike: alike
allege: alleged
allen: allen
alley: alley
alliance: alliance
allowable: allowable
allowance: allowance
allude: alluding
aloud: aloud
alps: alps
alter: alter,altered,altering
alteration: alteration,alterations
altered: altered
alternately: alternately
altogether: altogether
amazed: amazed
amazement: amazement
amazing: amazing
amazingly: amazingly
ambiguous: ambiguous
ambition: ambition
amenable: amenable
amend: amends
amendment: amendment
amiable: amiable
amiss: amiss
amity: amity
ample: ample
amuse: amuse,amused
amusement: amusement,amusements
amusing: amusing
ancestor: ancestor
ancient: ancient
angel: angel
anger: anger
angrily: angrily
angry: angry
animal: animal
animate: animated
animation: animation
animosity: animosities
ankle: ankle,ankles
anne: anne
answer: answer,answered,answering
antechamber: antechamber
anthony: anthony
anticipation: anticipations
antique: antique
antiquity: antiquity
anxiety: anxieties,anxiety
anxious: anxious
anxiously: anxiously
anxiousness: anxiousness
apartment: apartment,apartments
apologize: apologize,apologizing
apology: apologies,apology
appalled: appalled
appeal: appeal
appearance: appearance,appearances
appease: appeased
appetite: appetite
apple: apple
applicable: applicable
application: application
apply: applied,apply
appoint: appointed
appointment: appointment
apprehension: apprehension
apprise: apprised
approach: approach,approached,approaches,approaching
approbation: approbation
approve: approve
april: april
arch: arch,arches
arched: arched
architecture: architecture
archness: archness
archway: archway
ardour: ardour
argue: arguing
argument: argument,arguments
argyle: argyle
aright: aright
arm: arm,arms
arrange: arranged
arrangement: arrangement,arrangements
arrival: arrival,arrivals
arrive: arrived,arriving
art: art
artful: artful
artfully: artfully
article: article,articles
artifice: artifice
artless: artless
ascend: ascend,ascended,ascending
ascertain: ascertain,ascertained
ascribe: ascribed
ash: ashes
ashamed: ashamed
asleep: asleep
aspect: aspect
aspire: aspiring
assail: assailed
assassin: assassins
assemble: assembled,assembling
assembly: assemblies,assembly
assent: assent,assented,assenting
assert: assert,asserted,asserting
assertion: assertion,assertions
assignment: assignment
assist: assist,assisted,assisting
assistance: assistance
association: associations
assume: assumed,assuming
assurance: assurance
assure: assure,assured,assuring
astonished: astonished
astonishing: astonishing
astonishment: astonishment
asunder: asunder
atone: atone
atrocity: atrocities
attach: attach,attached
attachment: attachment,attachments
attack: attack,attacked,attacking,attacks
attain: attain
attempt: attempt,attempted,attempting
attend: attend,attended,attending
attendance: attendance
attendant: attendant,attendants
attention: attention,attentions
attentive: attentive
attentively: attentively
attestation: attestation
attire: attire
attitude: attitude
attorney: attorneys
attract: attract,attracted,attracting
attraction: attraction
attractive: attractive
attribute: attribute,attributing
aubin: aubin
augment: augmented
augur: augured
aunt: aunt
auspices: auspices
author: author
authoress: authoress
authority: authority
authorize: authorized
avail: avail,availed
avarice: avarice
average: average
aversion: aversion
avocation: avocations
avoid: avoid,avoided,avoiding
avowal: avowal
avowed: avowed
awake: awake,awoke
awaken: awaken,awakened
aware: aware
awe: awe
awful: awful
awfulness: awfulness
awkward: awkward
awkwardness: awkwardness
aye: aye
bachelor: bachelor
bad: bad,worse,worst
ball: ball,balls
ballroom: ballroom
balm: balm
banish: banish
banishment: banishment
bank: bank
banker: banker
bar: bars
barbarous: barbarous
barely: barely
bargain: bargain
barometer: barometer
baronet: baronet,baronets
base: based
baseball: baseball
bath: bath
bead: beads
beam: beams
bear: bear,bearing,bore,born,borne
bearer: bearer
beast: beast
beat: beat
beating: beating
beautiful: beautiful
beauty: beauty
becomingly: becomingly
bed: bed,beds
bedford: bedford
bedroom: bedroom
beechen: beechen
beetle: beetle
befall: befall
befriend: befriended
beg: beg,begged
beggar: beggar
behalf: behalf
behave: behave,behaved
behaviour: behaviour
behold: beheld,behold,beholding
belief: belief
belinda: belinda
bell: bell,bells
belle: belle
belong: belong,belonged,belonging,belongs
beloved: beloved
bench: bench
bend: bend,bent
beneath: beneath
benefactor: benefactors
benefit: benefit
benevolence: benevolence
bent: bent
bespeak: bespoke
bestow: bestow,bestowed,bestowing,bestows
betray: betray,betrayed
beware: beware
bias: biased
bid: bade,bid,bidding
bilious: bilious
billiard: billiard
bind: bound
binding: binding
biographer: biographer
bird: bird,birds
bitter: bitter
bitterly: bitterly
bitterness: bitterness
black: black,blackest
blair: blair
blame: blame,blamed
blast: blast
blaze: blaze
bless: bless
blessing: blessing
blind: blinding
bliss: bliss
blockhead: blockheads
blood: blood
bloom: bloom,blooming
blow: blew,blow
blue: blue
blush: blush,blushed,blushing
board: board
boast: boast,boasted
bode: boded
body: body
bold: bold
boldly: boldly
boldness: boldness
bolt: bolt,bolts
bond: bond
bonnet: bonnet,bonnets
book: book,books
bookseller: bookseller
boot: booted
bosom: bosom
bother: bother
bottle: bottle
bound: bounded,bounding
bow: bow,bowed,bows
box: box
boy: boy,boys
brag: bragging
braid: braids
brain: brain,brains
brained: brained
bravo: bravo
breach: breach
bread: bread
breadth: breadth
break: break,breaking,broke,broken
breakfast: breakfast
breath: breath
breathe: breathe,breathing
breathless: breathless
breeches: breeches
breed: bred
breeding: breeding
breeze: breeze
brickbat: brickbat
bridge: bridge
bright: bright,brightest
brighten: brighten,brightened,brightening
brilliant: brilliant
bring: bring,bringing,brings,brought
brisk: brisker
briskly: briskly
bristol: bristol
british: british
broad: broad
brock: brock
broke: broke
broken: broken
brook: brook
brother: brother,brothers
brow: brow
brown: brown
brute: brute
buck: buck
build: build,built
building: building,buildings
burn: burn,burning
burst: burst
bush: bush
business: business
bustle: bustle
busy: busy
butler: butler
butter: butter
bye: bye
cabinet: cabinet
calculate: calculate,calculated
calculation: calculation,calculations
calling: calling
calm: calm
calmly: calmly
calmness: calmness
camilla: camilla
canary: canary
candid: candid
candle: candle
canvass: canvassed
cap: cap
capability: capability
capable: capable
capacity: capacity
cape: capes
caper: caper
capital: capital
captain: captain
captive: captive,captives
caractacus: caractacus
card: card
care: care,cared,cares,caring
career: career
careless: careless
carelessly: carelessly
caress: caressed
caricature: caricature
carpet: carpeted
carriage: carriage,carriages
carry: carried,carry,carrying
cart: carts
carve: carved
carving: carving
casement: casements
cash: cash
cast: cast
castle: castle,castles
catch: catch,catching,caught
catherine: catherine
cattle: cattle
causeless: causeless
caution: caution,cautions
cautiously: cautiously
cavity: cavity
cease: ceased,ceasing
cecilia: cecilia
cedar: cedar
celebrate: celebrated
celebrated: celebrated
celebration: celebration
celerity: celerity
cell: cell,cells
censure: censure
central: central
centre: centre
centred: centred
century: century
ceremonial: ceremonial
ceremony: ceremonies,ceremony
certainty: certainty
chair: chair,chairs
chaise: chaise,chaises
challenge: challenging
chamber: chamber,chambers
chance: chance,chanced,chances
chandler: chandler
change: change,changed
changeable: changeable
changing: changing
chap: chap
chapel: chapel
chaperon: chaperon,chaperons
chapter: chapter,chapters
character: character,characters
characteristic: characteristic
charge: charge,charging
charles: charles
charlotte: charlotte
charm: charm,charms
charming: charming
charmingly: charmingly
chat: chatting
chatter: chatter
cheap: cheap
check: check,checked
cheek: cheek,cheeks
cheerful: cheerful
cheerfully: cheerfully
cheerfulness: cheerfulness
cherish: cherished
chest: chest,chests
chestnut: chestnut,chestnuts
chicken: chickens
chief: chief
chiefly: chiefly
child: child,children
childless: childless
chilled: chilled
chimney: chimney
china: china
choice: choice
choose: choose,chose,chosen
christian: christian,christians
christmas: christmas
church: church
cipher: cipher
circle: circle
circulate: circulating
circumstance: circumstance,circumstanced,circumstances
city: city
civil: civil
civility: civilities,civility
civilized: civilized
civilly: civilly
claim: claim,claimed,claims
clandestine: clandestine
class: class,classed
classic: classic
clause: clause
clay: clay
clean: clean,cleanest
cleanliness: cleanliness
clearness: clearness
clemency: clemency
clergyman: clergyman
clever: clever
cliff: cliff
climate: climate
cloak: cloak
clock: clock,clocks
clog: clogs
cloister: cloister,cloisters
close: close,closed,closing
closely: closely
closet: closet,closets
closing: closing
clothe: clothe
clothes: clothes
cloud: clouds
cloudy: cloudy
club: club
coachmaker: coachmaker
coachman: coachman
coarse: coarse
cobwebs: cobwebs
cocoa: cocoa
coffee: coffee
coffin: coffin
coincidence: coincidence
cold: cold
coldly: coldly
coldness: coldness
collect: collect,collected,collecting,collects
collection: collection
college: college
colour: colour,coloured
colouring: colouring
combine: combine
comedy: comedy
comfort: comfort,comforts
comfortable: comfortable
comfortably: comfortably
comforting: comforting
comfortless: comfortless
coming: coming
command: command,commanded,commanding
commendation: commendation
commerce: commerce
commiserate: commiserated,commiserating
commodious: commodious
common: common
commonly: commonly
commonplace: commonplace
communicate: communicate,communicating
communication: communication,communications
communicative: communicative
companion: companion,companions
companionship: companionship
company: company
comparative: comparative
comparatively: comparatively
compare: compare,compared,comparing
comparison: comparison
compartment: compartment
compassion: compassion
compassionately: compassionately
complacency: complacency
complacent: complacent
complacently: complacently
complain: complain
complaisance: complaisance
complete: complete,completed,completing
completely: completely
completion: completion
complexion: complexion
compliance: compliance
compliment: compliment,complimented,compliments
complimentary: complimentary
comply: complied
compose: compose
composition: composition
composure: composure
comprehend: comprehend,comprehended,comprehending
comprehension: comprehension
comprehensive: comprehensive
compression: compression
comprise: comprised
compromise: compromise
conceal: conceal,concealed,concealing
concealment: concealment
conceit: conceit
conceited: conceited
conceive: conceive,conceiving
conception: conception
concern: concern,concerned,concerns
concerned: concerned
concert: concert
conciliatory: conciliatory
conclude: conclude,concluded
concluding: concluding
conclusion: conclusion
condemnation: condemnation
condition: conditions
conducive: conducive
conduct: conduct,conducted
conductor: conductor
conference: conference
confess: confess,confessed
confession: confession
confidante: confidante
confidence: confidence
confident: confident
confidential: confidential
confine: confine,confined,confining
confinement: confinement
confirm: confirm,confirmed,confirming
confirmation: confirmation
conformity: conformity
confound: confounded
confuse: confused
confused: confused
confusion: confusion
congratulate: congratulate,congratulated,congratulating
conjecture: conjecture,conjectured,conjectures,conjecturing
connect: connected
connected: connected
connection: connection,connections
connive: connive
conquer: conquering
conscience: conscience
conscientious: conscientious
conscious: conscious
consciousness: consciousness
consent: consent,consenting
consequence: consequence,consequences
consequent: consequent
consequential: consequential
considerable: considerable
consideration: consideration,considerations
consist: consist,consisting
consistent: consistent
consistently: consistently
consolation: consolation
console: console,consoling
conspicuous: conspicuous
constant: constant
constantly: constantly
constitution: constitution
constitutional: constitutional
constrain: constrained
construct: constructed
construction: construction
consult: consult,consulted
consultation: consultation
consume: consumed
consummate: consummate
contemplate: contemplated
contemplation: contemplation
contempt: contempt
contemptible: contemptible
contemptuous: contemptuous
contend: contend
contented: contented
contentedly: contentedly
contents: contents
contest: contest
continual: continual
continually: continually
continuance: continuance
continue: continue,continued,continuing
continued: continued
contract: contract,contracted
contradict: contradict,contradicted
contradiction: contradiction,contradictions
contrary: contrary
contrast: contrast
contribute: contribute,contributed,contributes
contriver: contriver
control: control
convenience: convenience
convenient: convenient
convent: convent
conversation: conversation,conversations
converse: conversing
convert: converts
convey: convey,conveyed,conveying
convict: convicted
conviction: conviction,convictions
convince: convince,convinced
convinced: convinced
cook: cook,cooks
cool: cool
cooperate: cooperate
cope: cope
coppice: coppice
coquelicot: coquelicot
coquette: coquette
cordial: cordial
corner: corner
corporal: corporal
corporation: corporation
correctly: correctly
correspond: corresponded
correspondence: correspondence
corroborate: corroborated
cost: cost
costliness: costliness
costly: costly
cotillion: cotillion,cotillions
cottage: cottage
cotton: cotton
couch: couch
counsel: counsel,counsels
count: counted
countenance: countenance
counterbalance: counterbalance
counterpane: counterpane
counterpart: counterpart
counterpoise: counterpoise
countess: countess
countless: countless
country: country
county: counties,county
couple: couple
courage: courage
courageously: courageously
court: court,courted,courting
courteously: courteously
courtesy: courtesy
cousin: cousin,cousins
cover: cover
cowardly: cowardly
coxcomb: coxcomb
cradle: cradle
cramp: cramp
cravat: cravats
craving: craving
create: create,created,creating
creation: creation
creature: creature,creatures
credit: credit
creep: creep,creeping,crept
crescent: crescent
cricket: cricket
crime: crime,crimes
criminal: criminal
critical: critical
critique: critique
croak: croaking
cross: cross,crossed,crossing
crossing: crossing
crowd: crowd,crowded,crowds
crowded: crowded
crown: crown
cruel: cruel
cruelty: cruelty
curate: curate
curiosity: curiosity
curious: curious
curiously: curiously
curl: curl
curricle: curricle
curse: curse,cursed
cursed: cursed
curtain: curtain,curtains
curtsy: curtsied,curtsies,curtsy
custom: custom
cut: cut,cutting
dagger: dagger
daily: daily
damp: damp
dance: dance,danced,dances,dancing
dancer: dancers
dancing: dancing
danger: danger,dangers
dangerous: dangerous
dark: dark,darker
darkness: darkness
darling: darling
dart: darted
daughter: daughter,daughters
davis: davis
day: day,days
daylight: daylight
dead: dead
deal: deal
dearest: dearest
dearly: dearly
death: death
deathlike: deathlike
debasement: debasement
debating: debating
decay: decayed,decaying
decease: decease
deceased: deceased
deceive: deceive,deceived
decency: decency
decent: decent
deception: deception
decide: decided
decidedly: decidedly
decipher: decipher
decision: decision
decisive: decisive
declaration: declaration,declarations
declare: declare,declared
decline: decline,declined
decree: decree
decry: decried,decrying
deduce: deduced
deduction: deduction
deem: deemed
deep: deep,deeper
deeply: deeply
defect: defects
defective: defective
defence: defence
defend: defend,defended
defer: deferred
deference: deference
defiance: defiance
deficiency: deficiency
definable: definable
definition: definition
defunct: defunct
defy: defy
degrading: degrading
degree: degree
deject: dejected
dejected: dejected
dejectedly: dejectedly
dejection: dejection
delay: delay,delayed,delays
delicacy: delicacy
delicate: delicate
delight: delight,delighted,delighting,delights
delighted: delighted
delightful: delightful
delightfully: delightfully
delineation: delineation
deliver: delivered
delivery: delivery
delusion: delusion
demand: demand,demanded,demanding,demands
denial: denial
deny: denied,deny
depart: departed
departure: departure
depend: depend,depended
dependence: dependence
deplore: deplored
deprive: deprived
derogatory: derogatory
descend: descend
descent: descent
description: description,descriptions
descry: descried
desert: desert,deserted
deserted: deserted
deserve: deserved
deserving: deserving
design: design,designed,designs
designedly: designedly
desirable: desirable
desire: desire,desired,desires,desiring
desirous: desirous
desk: desk
despair: despair
desperate: desperate
despise: despise,despised
despondency: despondency
desponding: desponding
destroy: destroy,destroyed,destroys
destroyer: destroyer
detach: detaching
detachment: detachment
detain: detain,detained
detect: detected
detection: detection
determination: determination
determine: determine,determined
determined: determined
detest: detest,detesting
detestable: detestable
detestation: detestation
develop: developing
development: development
devil: devil
devilish: devilish
devoir: devoirs
devolve: devolve
dexterity: dexterity
dialogue: dialogue
diamond: diamonds
dictate: dictate
diction: diction
die: die,died,dies,dying
difference: difference
difficult: difficult
difficulty: difficulties,difficulty
diffidence: diffidence
dignified: dignified
dignify: dignifies
dignity: dignity
digression: digression
diligence: diligence
dim: dim
dimension: dimensions
dimity: dimity
dimly: dimly
dimness: dimness
dine: dine
dining: dining
dinner: dinner,dinners
direct: direct,directed,directing
direction: direction
dirt: dirt
dirty: dirty
disadvantage: disadvantage
disagreeable: disagreeable
disagreement: disagreement
disallow: disallow
disappear: disappeared
disappoint: disappoint,disappointed
disappointed: disappointed
disappointment: disappointment,disappointments
disapprobation: disapprobation
discern: discern,discerned
discerning: discerning
discernment: discernment
disclaim: disclaimed,disclaiming
disclosure: disclosure
discompose: discomposed
disconcert: disconcert
disconcerted: disconcerted
discontent: discontent
discourage: discouraged
discourse: discourse,discourses
discover: discover,discovered,discovering,discovers
discovery: discovery
discredit: discredit
discreeter: discreeter
discretion: discretion
discuss: discuss,discussing
discussion: discussion
disdain: disdain
disengage: disengage,disengaged
disgrace: disgrace,disgraced
disguise: disguise
disgust: disgust
disgusting: disgusting
dishabille: dishabille
disinterested: disinterested
disinterestedness: disinterestedness
disjointed: disjointed
dislike: dislike,disliking
dismay: dismay
dismiss: dismiss,dismissed
dismissal: dismissal
disobedience: disobedience
disoblige: disobliging
disorder: disorder,disorders
dispatch: dispatch,dispatched
disperse: disperse,dispersed
display: display,displayed
displease: displease
displeased: displeased
displeasure: displeasure
disposal: disposal
dispose: disposed
disposed: disposed
disposition: disposition,dispositions
disproportionate: disproportionate
dispute: dispute
disquisition: disquisition
disregard: disregarded
disrespectful: disrespectful
disrespectfully: disrespectfully
dissatisfaction: dissatisfaction
dissatisfied: dissatisfied
dissent: dissenting
dissipate: dissipating
dissolution: dissolution
distance: distance,distances
distant: distant
distantly: distantly
distaste: distaste
distinct: distinct
distinction: distinction
distinguish: distinguish,distinguishing
distinguished: distinguished
distract: distracts
distress: distress,distressed,distresses
distressed: distressed
distressing: distressing
distrust: distrust
disturb: disturb,disturbed
disturbance: disturbance
diversity: diversities
divide: divide,divided
divided: divided
divine: divine,divining
divinity: divinity
division: division,divisions
dog: dogs
doll: dolls
domestic: domestic
doom: doomed
door: door,doors
doorway: doorway
dormouse: dormouse
dorothy: dorothy
dote: dote,doted
double: double,doubling
doubt: doubt,doubted,doubts
doubtingly: doubtingly
downcast: downcast
downstairs: downstairs
doze: doze
dozen: dozen,dozens
draft: draft
dragoons: dragoons
draw: draw,drawing,drawn,drew
drawback: drawback
drawer: drawer,drawers
drawing: drawing
dread: dread,dreaded,dreading
dreaded: dreaded
dreadful: dreadful
dreadfully: dreadfully
dream: dream,dreamt
dreamer: dreamer
dresden: dresden
dress: dress,dressed,dresses,dressing
dressed: dressed
dressing: dressing
dressmaker: dressmaker
drink: drank,drink,drinking,drinks
drinking: drinking
drive: drive,driven,driving,drove
driver: drivers
droll: droll
drop: drop,dropped,dropping,drops
drown: drown
druggist: druggist
drunk: drunk
drunken: drunken
dry: dry
dryer: dryer
duet: duets
dull: dull,dullest
duly: duly
duodecimo: duodecimo
duplicity: duplicity
duration: duration
dust: dust
dutiful: dutiful
duty: duties,duty
dwell: dwell,dwelt
dwelling: dwelling
eager: eager
eagerly: eagerly
eagerness: eagerness
ear: ear,ears
earn: earned
earnest: earnest
earnestly: earnestly
earnestness: earnestness
ease: ease,eased
easily: easily
east: east
easy: easy
eat: ate,eat,eating
eating: eating
ebony: ebony
echo: echo,echoed
economy: economy
ecstasy: ecstasies,ecstasy
ecstatic: ecstatic
edgar: edgar
edge: edge
edifice: edifice,edifices
edition: edition
education: education
edward: edward
effort: effort,efforts
effusion: effusion,effusions
egregious: egregious
eighteen: eighteen
ejaculation: ejaculations
elapse: elapsed
elasticity: elasticity
elated: elated
elation: elation
elbow: elbow
eld: eldest
elder: elder
eleanor: eleanor
elegance: elegance
elegant: elegant
elevated: elevated
eligible: eligible
eloquence: eloquence
elucidate: elucidated
embarrassed: embarrassed
embarrassing: embarrassing
embarrassment: embarrassment
embellishment: embellishments
ember: embers
emblem: emblem
embolden: emboldened
embrace: embrace,embraced,embraces,embracing
emigrant: emigrant
emily: emily
eminence: eminence
emit: emitted
emotion: emotion,emotions
emphasis: emphasis
employ: employ,employed
employment: employment,employments
empower: empowered
enable: enable,enabled,enabling
enchant: enchanted
enclose: enclosed
enclosure: enclosure
encounter: encounter,encountering
encourage: encourage,encouraged,encouraging
encouragement: encouragement
endanger: endanger,endangered
endear: endear,endears
endearing: endearing
endeavour: endeavour,endeavoured,endeavouring
endless: endless
endow: endowed
endowment: endowments
endurance: endurance
endure: endure
enemy: enemies,enemy
engage: engage,engaged,engaging
engagement: engagement,engagements
engaging: engaging
engagingly: engagingly
england: england
english: english
engross: engrossed
enhancement: enhancement
enjoy: enjoy,enjoyed,enjoying
enjoyment: enjoyment,enjoyments
enlighten: enlighten
enraged: enraged
ensue: ensued
ensure: ensure,ensured
enter: enter,entered,entering
entering: entering
entertain: entertain,entertained
entertained: entertained
entertaining: entertaining
entertainment: entertainment
entire: entire
entitle: entitled
entitled: entitled
entrance: entrance
entreat: entreat,entreated,entreating
entreaty: entreaties,entreaty
entree: entree
entrust: entrusted
envied: envied
environs: environs
envy: envy,envying
epitaph: epitaph
epithet: epithets
equal: equal
equally: equally
equip: equipped
equipage: equipage
equivalent: equivalent
ere: ere
erect: erect,erected
erection: erection
err: erred
errand: errand
error: error
escape: escape,escaped
escort: escort
essay: essay
essentially: essentially
establish: establish
established: established
establishment: establishment
estate: estate
esteem: esteem
estimation: estimation
eternity: eternity
eulogize: eulogized
evening: evening
event: event,events
eventful: eventful
eventually: eventually
everyday: everyday
evidence: evidence,evidences
evident: evident
evidently: evidently
evil: evil,evils
exact: exact,exacted
exaggerate: exaggerated
exaggerated: exaggerated
examination: examination,examinations
examine: examine,examined,examining
exceed: exceeded
exceedingly: exceedingly
excel: excel
excellence: excellence
excellency: excellencies
excellent: excellent
excess: excess
excessive: excessive
excessively: excessively
exchange: exchange,exchanged
excite: excite,excited
excited: excited
exclaim: exclaim,exclaimed,exclaiming
exclamation: exclamation,exclamations
exclude: excluded
exclusively: exclusively
excursion: excursion
excuse: excuse,excused,excuses
exemplification: exemplification
exempt: exempt
exercise: exercise
exert: exerting
exertion: exertion
exhausted: exhausted
exhibit: exhibiting
exhibition: exhibition
exist: exist,existed
existence: existence
expatiate: expatiated
expect: expect,expected,expecting
expectation: expectation,expectations
expedient: expedient
expenditure: expenditure
expense: expense,expenses
expensively: expensively
experience: experience,experienced
experienced: experienced
experimental: experimental
expert: expert
expire: expire,expired,expires,expiring
explain: explain,explained,explaining
explanation: explanation,explanations
explicit: explicit
explore: explore,exploring
expose: expose,exposed
express: express,expressed,expressing
expression: expression,expressions
expressively: expressively
expressly: expressly
exquisite: exquisite
extend: extend
extension: extension
extensive: extensive
extent: extent
extenuation: extenuation
extinction: extinction
extinguish: extinguished
extraordinary: extraordinary
extravagance: extravagance
extravagant: extravagant
extreme: extreme
extremity: extremities
exult: exulting
exultation: exultation
exulting: exulting
eye: eye,eyes
fable: fable
facilitate: facilitate
fade: fading
fag: fag
faggot: faggot
fail: fail,failed,failing
failure: failure
faint: fainting
fair: fair,fairer
fairness: fairness
faith: faith
faithful: faithful
faithfully: faithfully
fall: fall,fallen,falling,fell
fallen: fallen
false: false
falsehood: falsehood,falsehoods
falsely: falsely
falter: faltered,faltering
familiar: familiar
familiarity: familiarity
family: families,family
famous: famous
famously: famously
fan: fan
fancy: fancied,fancies,fancy,fancying
farewell: farewell
farm: farm
farrier: farrier
farth: farthest
fashion: fashion,fashions
fashionable: fashionable
fashioned: fashioned
fast: fast,faster
fasten: fasten
fastener: fastener
fatal: fatal
fate: fate,fated
father: father
fatigue: fatigue,fatigues
fatigued: fatigued
fault: fault,faults
faultless: faultless
favour: favour,favoured
favourable: favourable
favourably: favourably
favourite: favourite
fear: fear,feared,fearing,fears
fearful: fearful
fearfully: fearfully
fearlessly: fearlessly
feather: feathers
feature: feature,features
february: february
fed: fed
feeble: feeble
feed: feeding
feel: feel,feeling,feels
feeling: feeling,feelings
feelingly: feelingly
felicity: felicities,felicity
fellow: fellow,fellows
female: female,females
fender: fender
fervent: fervent
fetch: fetch
fever: fever
feverish: feverish
fickle: fickle
fickleness: fickleness
fidelity: fidelity
fidget: fidgeted
field: field
fields: fields
fiend: fiend
fifteenth: fifteenth
figure: figure,figures
filial: filial
final: final
finale: finale
finally: finally
fine: fine,finer,finest
finery: finery
finesse: finesse
finger: finger,fingers
finish: finish,finished,finishing
fir: firs
fireplace: fireplace
firm: firm,firmer
firmly: firmly
firmness: firmness
fish: fishing
fit: fit,fitted
fitly: fitly
fitting: fitting
flat: flat
flatness: flatness
flatter: flattered
flattering: flattering
flattery: flattery
flavour: flavoured
fletcher: fletcher
flight: flight,flights
flirt: flirt,flirting,flirts
flirtation: flirtation,flirtations
floor: floor
florid: florid
flow: flow,flowing
flower: flower,flowers
fluency: fluency
flush: flushed
flutter: flutter,fluttered
fly: flew,fly
foe: foes
foggy: foggy
foible: foibles
fold: folded,folding
folding: folding
follow: follow
folly: folly
fond: fond,fondest
fonder: fonder
fondness: fondness
food: food
fool: fool
foolish: foolish
foolishly: foolishly
foolishness: foolishness
foot: foot
footing: footing
footman: footman
footstep: footsteps
forbid: forbade,forbid,forbidden
forbidden: forbidden
forborne: forborne
force: force,forced,forcing
foreboding: foreboding
foreground: foregrounds
forehand: forehand
forehead: forehead
foresee: foreseen
foresight: foresight
forest: forest,forests
forestall: forestalled
foretell: foretold
forget: forget,forgetting,forgot,forgotten
forgive: forgive,forgiven
forgiveness: forgiveness
forgo: forgo
forlorn: forlorn
form: form,formed,forming
formally: formally
formidable: formidable
fortify: fortifying
fortitude: fortitude
fortnight: fortnight
fortunate: fortunate
fortunately: fortunately
fortune: fortune
forwards: forwards
foundation: foundation
fourteen: fourteen
fourth: fourth
fowl: fowl
fox: fox
fragment: fragment
fragmented: fragmented
fragrance: fragrance
france: france
fraternal: fraternal
fraught: fraught
fray: fray
frederick: frederick
freedom: freedom
freeman: freeman
french: french
frequent: frequent,frequented
frequenter: frequenters
frequently: frequently
fresh: fresh
fret: fret,fretted,fretting
friday: friday
friend: friend,friends
friendly: friendly
friendship: friendship
frighten: frighten,frightened
frightened: frightened
frightening: frightening
frightful: frightful
frivolous: frivolous
frolic: frolic
frontispiece: frontispiece
fruit: fruit,fruits
fruitful: fruitful
fruitless: fruitless
fulfil: fulfil
fulness: fulness
fun: fun
fund: funded
funeral: funeral
funereal: funereal
furious: furious
furnish: furnished,furnishes
furnished: furnished
furniture: furniture
fury: fury
fuss: fuss
future: future
gaiety: gaieties,gaiety
gaily: gaily
gain: gain,gained,gaining
gallant: gallant,gallants
gallantry: gallantry
gallery: galleries,gallery
game: game
garden: garden,gardens
gasp: gasp
gate: gates
gather: gathered
gay: gay
gayer: gayer
gaze: gaze,gazed,gazes,gazing
generality: generality
generation: generations
generosity: generosity
generous: generous
genius: genius
genteel: genteel
gentility: gentility
gentle: gentle
gentleman: gentleman,gentlemen
gentlewoman: gentlewoman
gently: gently
genuine: genuine
george: george
giant: giant
gig: gig,gigs
gild: gilding
girl: girl,girls
glad: glad
gladly: gladly
glance: glance,glanced
glass: glass
gleam: gleam
glimmer: glimmer
glimpse: glimpse
gloom: gloom
gloomy: gloomy
glory: glory
glove: gloves
glow: glow,glowing
god: god
godfather: godfather
goer: goer
gold: gold
goodness: goodness
goodwill: goodwill
gothic: gothic
gouty: gouty
government: government
gown: gown,gowns
grace: grace
graceful: graceful
gracious: gracious
gradation: gradation,gradations
gradually: gradually
grammar: grammar
grand: grand
grandeur: grandeur
grant: granted
grasp: grasped
grate: grated
grateful: grateful
gratification: gratification
gratified: gratified
gratify: gratifying
gratifying: gratifying
gratitude: gratitude
grave: grave
gravel: gravel
gravely: gravely
gray: gray
greatcoat: greatcoat,greatcoated,greatcoats
greatly: greatly
greedy: greedy
green: green
greet: greeted
grey: grey
grief: grief
grieve: grieved
grievous: grievous
grievously: grievously
groan: groans
groom: groom
grope: groping
grossly: grossly
ground: ground
groundless: groundless
grounds: grounds
grove: grove
grow: grew,grow,growing,grown,grows
growth: growth
guard: guard,guarded
guess: guess,guessed,guesses
guesswork: guesswork
guest: guest
guide: guide,guided
guileless: guileless
guilt: guilt
guilty: guilty
guinea: guineas
gun: guns
gust: gust,gusts
gutter: gutters
habit: habit,habits
habitable: habitable
habitual: habitual
habituate: habituated
habitude: habitude
hack: hack
haggle: haggling
hail: hailed
hair: hair
hall: hall
halloo: halloo,hallooing
hand: hand,handed,hands
handkerchief: handkerchief
handle: handle,handles
handsome: handsome,handsomer,handsomest
handsomely: handsomely
hang: hanging,hangs,hung
hanging: hangings
happen: happen,happened
happily: happily
happiness: happiness
happy: happier,happiest,happy
harass: harassed
harbour: harbour,harboured,harbours
hard: hard,harder
harden: hardened
hare: hare
harm: harm
harmless: harmless
harness: harness
harriet: harriet
harsh: harshest
hasp: hasp
haste: haste
hasten: hasten,hastened,hastening
hastily: hastily
hat: hat,hats
hate: hate,hated
hateful: hateful
haughtiness: haughtiness
haunch: haunches
haunt: haunted
hazard: hazarding,hazards
head: head,heads
health: health
hear: hear,heard,hearing
hearer: hearers
hearing: hearing
heart: heart,hearts
hearted: hearted
heartfelt: heartfelt
heartily: heartily
hearty: hearty
heaven: heaven,heavens
heavenly: heavenly
heavily: heavily
heavy: heaviest,heavy
heedless: heedless
height: height
heir: heir,heirs
heiress: heiress
helpless: helpless
hen: hens
henceforward: henceforward
henry: henry
hereford: hereford
heretofore: heretofore
hermitage: hermitage
hero: hero,heroes
heroic: heroic
heroine: heroine,heroines
heroism: heroism
hesitation: hesitation
hey: hey
heyday: heyday
hide: hide,hiding
hideous: hideous
highly: highly
hill: hill,hills
hindrance: hindrance
hint: hint,hinted,hints
historian: historians
history: histories,history
hitherto: hitherto
hoard: hoard
hobby: hobby
hold: held,hold,holding,holds
hole: hole
hollow: hollow
holy: holy
honest: honest
honesty: honesty
honour: honour,honoured,honours
honourable: honourable
honourably: honourably
hoop: hoop
hope: hope,hoped,hopes
hopeful: hopeful
hopeless: hopeless
horizon: horizon
horrible: horrible
horrid: horrid
horror: horror,horrors
horse: horse,horses
horseback: horseback
horseman: horsemen
hospitality: hospitality
hot: hot
hotel: hotel
hound: hounds
hour: hour,hours
house: house,houses
household: household
housekeeper: housekeeper
housemaid: housemaid,housemaids
hughes: hughes
hum: hum,hummed,humming
human: human
humanity: humanity
humble: humble,humbled,humbling
hume: hume
humiliation: humiliation
humour: humour
humoured: humoured
hundredth: hundredth
hunger: hunger
hungry: hungry
hunt: hunt
hunter: hunter
huntsman: huntsman
hurry: hurried,hurry,hurrying
hurt: hurt,hurts
husband: husband
hyacinth: hyacinth,hyacinths
ice: ice
idea: idea,ideas
idiot: idiot
idle: idle
idleness: idleness
idly: idly
ignorance: ignorance
ignorant: ignorant
illness: illness
illumination: illumination
image: image
imaginable: imaginable
imagination: imagination,imaginations
imagine: imagine,imagined
imbecility: imbecility
imitate: imitating
imitator: imitators
immeasurable: immeasurable
immense: immense
immoderately: immoderately
immovable: immovable
impartial: impartial
impatience: impatience
impatient: impatient
impatiently: impatiently
impediment: impediment
impel: impelled
impenetrable: impenetrable
imperfect: imperfect
imperfection: imperfection
impertinent: impertinent
impetuous: impetuous
implicitly: implicitly
implied: implied
imply: implied
impolitic: impolitic
import: import
importunate: importunate
importune: importune
impose: impose,imposed
imposing: imposing
impossibility: impossibility
impossible: impossible
impress: impress
impressed: impressed
impression: impression,impressions
imprisonment: imprisonment
improbable: improbable
improper: improper
impropriety: impropriety
improve: improve,improved,improving
improvement: improvement,improvements
imprudence: imprudence
imprudent: imprudent
impudent: impudent
inability: inability
inactive: inactive
inadequate: inadequate
inapplicable: inapplicable
inattention: inattention
inattentive: inattentive
incapable: incapable
incapacity: incapacity
incessant: incessant
incessantly: incessantly
inch: inch,inches
incivility: incivility
inclination: inclination
incline: incline
inclined: inclined
include: included,including
incoherent: incoherent
income: income
incommode: incommoded
incompatible: incompatible
incomprehensibility: incomprehensibility
incomprehensible: incomprehensible
incomprehensibly: incomprehensibly
inconceivable: inconceivable
inconsiderable: inconsiderable
inconsistency: inconsistencies,inconsistency
inconsistent: inconsistent
inconsolable: inconsolable
inconstancy: inconstancy
inconstant: inconstant
inconvenience: inconvenience,inconveniences
incorrectness: incorrectness
increase: increase,increased,increasing
incredible: incredible
incredulously: incredulously
incumbent: incumbent
indebt: indebted
indecorum: indecorum
independence: independence
independent: independent
indescribable: indescribable
indian: indian
indifference: indifference
indifferent: indifferent
indignation: indignation
indignity: indignity
indiscriminating: indiscriminating
indispensable: indispensable
induce: induce,induced
inducement: inducement
indulge: indulge,indulged,indulging
indulgence: indulgence
indulgent: indulgent
industrious: industrious
ineffectual: ineffectual
inequality: inequality
inevitable: inevitable
inevitably: inevitably
inexplicability: inexplicability
inexpressibly: inexpressibly
infallibly: infallibly
infamy: infamy
infancy: infancy
infatuation: infatuation
infer: infer
inferior: inferior,inferiors
inferiority: inferiority
infinitely: infinitely
inflated: inflated
inflict: inflicting
influence: influence,influenced
inform: inform,informed,informing,informs
informed: informed
ingenuity: ingenuity
inhabit: inhabit,inhabited
inhabitant: inhabitant,inhabitants
inherit: inherit
inheritance: inheritance
injunction: injunction
injure: injured,injuring
injured: injured
injurious: injurious
injury: injury
injustice: injustice
inlaid: inlaid
inn: inn,inns
innate: innate
innkeeper: innkeepers
innocence: innocence
innocent: innocent
innocently: innocently
innumerable: innumerable
inquietude: inquietude
inquire: inquire,inquired,inquiring
inquiry: inquiries,inquiry
insensibility: insensibility
insensible: insensible
inseparable: inseparable
insight: insight,insights
insignificant: insignificant
insinuation: insinuations
insipid: insipid
insist: insist,insisted
insolence: insolence
inspection: inspection
inspire: inspired
instance: instance,instances
instant: instant,instants
instantaneously: instantaneously
instantly: instantly
instigator: instigator
instinctive: instinctive
instinctively: instinctively
instruct: instruct
instruction: instruction,instructions
instrument: instrument
insufferable: insufferable
insult: insult
insupportable: insupportable
insupportably: insupportably
insurgent: insurgents
integrity: integrity
intellectual: intellectual
intelligence: intelligence
intelligent: intelligent
intelligible: intelligible
intend: intend,intended,intending
intense: intense
intent: intent
intention: intention,intentions
intentional: intentional
intently: intently
intercept: intercepting
intercourse: intercourse
interfere: interfere
interference: interference
interrupt: interrupted
interruption: interruptions
interval: interval,intervals
intervene: intervene
interview: interview
intimacy: intimacy
intimate: intimate
intimation: intimation
intimidate: intimidate
intolerable: intolerable
intolerably: intolerably
introduce: introduce,introduced
introduction: introduction
intruder: intruder
intrusion: intrusion
inured: inured
invent: invent
inventory: inventory
investigate: investigated
invigorate: invigorating
invitation: invitation,invitations
invite: invited,inviting
involuntarily: involuntarily
involuntary: involuntary
involve: involve,involved
ire: ire
irksome: irksome
irksomeness: irksomeness
iron: iron
irrecoverably: irrecoverably
irresistible: irresistible
irritable: irritable
irritated: irritated
irritating: irritating
irritation: irritation,irritations
isabella: isabella
issue: issuing
italian: italian
italy: italy
jackson: jackson
jade: jade
jaded: jaded
james: james
jane: jane
japan: japan
jealous: jealous
jealousy: jealousy
jest: jest
jew: jew
jig: jig
john: john
johnson: johnson
joke: joke
jones: jones
journal: journal
journey: journey
jove: jove
joy: joy
joyful: joyful
joyfully: joyfully
joyfulness: joyfulness
judge: judge,judging
judging: judging
judgment: judgment
judicious: judicious
judiciously: judiciously
jump: jumped
justice: justice
justification: justification
justify: justified,justify,justifying
justly: justly
justness: justness
keen: keen
key: key
kick: kick
kill: killed
kin: kin
kindly: kindly
kindness: kindness
king: king,kings
kingdom: kingdom
kitchen: kitchen
knee: knees
knock: knocked,knocking,knocks
knoll: knolls
knowing: knowing
knowledge: knowledge
laboriously: laboriously
labour: labour,labouring,labours
lace: lace
lady: ladies,lady
ladyship: ladyship
lament: lament,lamented
lamp: lamp,lamps
land: land,landed,lands
landing: landing
landscape: landscape,landscapes
language: language
languid: languid
languish: languished
languor: languor
lank: lank
lantern: lantern
lap: lap
lash: lashed
lassitude: lassitude
lastly: lastly
late: late
latin: latin
laugh: laugh,laughed,laughing
laughingly: laughingly
laughter: laughter
launch: launched
laura: laura
lavender: lavender
law: law,laws
lawful: lawful
lawn: lawn
lawyer: lawyer
lay: laid,lay,lays
laziness: laziness
lazy: lazy
lead: lead,leading,led
leafless: leafless
lean: leaning,leant
leaning: leaning
leap: leaped
learn: learn,learned,learning,learnt
learning: learning
leave: leave,leaves,leaving,left
lecture: lecture
left: left
leg: legs
legend: legends
leisure: leisure
leisurely: leisurely
lengthen: lengthen,lengthened
lenient: lenient
lessen: lessen,lessened
lesson: lesson,lessons
letter: letter,letters
level: level
liberal: liberal
liberally: liberally
liberty: liberty
library: library
lid: lid
lie: lies,lying
life: life,lives
light: light,lighted,lighter,lights,lit
lightly: lightly
likelihood: likelihood
likeness: likeness
liking: liking
linen: linen
linger: linger,lingering
lining: linings
link: linked
lip: lips
liquor: liquor
list: list
listen: listen,listened,listening
listlessness: listlessness
literary: literary
litter: litter
live: live,lived,living
lively: liveliest,lively
liveried: liveried
living: living,livings
lobby: lobby
lock: lock,locking,locks
lodge: lodge,lodged,lodges
lodgings: lodgings
lofty: lofty
loin: loins
loiter: loiter,loitered
loitering: loitering
london: london
lonely: lonely
longing: longing
looker: lookers
lord: lord,lords
lose: lose,losing,lost
loss: loss
lost: lost
lot: lot
loud: loud,loudest
lounge: lounges,lounging
love: love,loved,loves,loving
lovely: lovely
lover: lover,lovers
luck: luck
luckily: luckily
lucky: lucky
lute: lute
luxuriant: luxuriant
luxury: luxury
machination: machinations
madam: madam
magdalen: magdalen
magnificence: magnificence
magnificent: magnificent
magnify: magnified
mahogany: mahogany
maid: maid,maids
maintain: maintain,maintained
malady: malady
malevolent: malevolent
malicious: malicious
mamma: mamma,mammas
manage: manage
management: management
manner: manner
manners: manners
manufacture: manufacture
manuscript: manuscript
marble: marble
march: march
mare: mare
maria: maria
mark: marked
market: market
marketplace: marketplace
marquis: marquis
marriage: marriage,marriages
married: married
marry: married,marry,marrying
marrying: marrying
massy: massy
master: master
match: match,matched,matches
material: material
materially: materially
maternal: maternal
matilda: matilda
matrimony: matrimony
matter: matter,matters
mature: mature
maxim: maxims
mayst: mayst
meadow: meadow,meadows
meal: meal
meaning: meaning
measure: measure,measured,measures
meat: meat
mechlin: mechlin
meditate: meditate,meditated
meditation: meditations
meekly: meekly
meet: meet,meeting,met
meeting: meeting
meetly: meetly
melancholy: melancholy
melt: melt,melted
memento: memento
memoirs: memoirs
memorial: memorials
memory: memories,memory
mend: mended,mending
mental: mental
mention: mention,mentioned
merchant: merchant
mercy: mercy
mere: mere
merit: merit,merits
merriment: merriment
mess: mess
message: message
messenger: messenger
metal: metal
method: method
middle: middle
middling: middling
midland: midland
midnight: midnight
mild: mild
mildness: mildness
mile: mile,miles
milestone: milestone,milestones
military: military
millinery: millinery
milton: milton
mind: mind,minds
minded: minded
mingle: mingled
minute: minute,minutes,minutest
minutely: minutely
minuteness: minuteness
mirror: mirror
misapprehension: misapprehension
mischance: mischance
mischief: mischief
mischievous: mischievous
mischievousness: mischievousness
misconduct: misconduct
miserable: miserable
miserably: miserably
miserly: miserly
misery: misery
misfortune: misfortune
misgive: misgive
misinform: misinformed
mislay: mislaid
mislead: mislead,misled
misplace: misplaced
misrepresentation: misrepresentation
mistake: mistake,mistaken,mistakes
mistaken: mistaken
mistress: mistress
misunderstand: misunderstood
misunderstanding: misunderstanding
mitchell: mitchell
mixed: mixed
mixture: mixture
mizzling: mizzling
moan: moans
mob: mob
mockery: mockery
mode: mode
moderate: moderate
moderation: moderation
modern: modern
modest: modest
modestly: modestly
modesty: modesty
moment: moment,moments
momentary: momentary
monastic: monastic
monday: monday
money: money
monied: monied
monk: monk
monstrous: monstrous
month: month,months
monument: monument
mood: mood
moon: moon
moonlight: moonlight
moralizing: moralizing
morning: morning,mornings
morrow: morrow
mortal: mortals
mortification: mortification,mortifications
mortified: mortified
mortify: mortifying
mortifying: mortifying
mother: mother
motion: motion
motionless: motionless
motive: motive,motives
moulding: moulding
mount: mount,mounted
mountain: mountains
mournfully: mournfully
mouth: mouths
mouthful: mouthfuls
movement: movement,movements
muff: muff
mull: mull
multiplicity: multiplicity
multitude: multitude
murder: murder,murdered,murdering
murderer: murderer
murmur: murmur,murmurs
murray: murray
music: music
muslin: muslin,muslins
mutton: mutton
mutual: mutual
mysteries: mysteries
mysterious: mysterious
mysteriously: mysteriously
mysteriousness: mysteriousness
mystery: mystery
nail: nail
nameless: nameless
narrow: narrow,narrower
narrowly: narrowly
nasty: nasty
nation: nation
native: native
natural: natural
naturally: naturally
nature: nature
natured: natured
nearer: nearer
neat: neat,neatest
neatly: neatly
neatness: neatness
necessaries: necessaries
necessitous: necessitous
necessity: necessity
neck: necks
necromancer: necromancer
needful: needful
needle: needle
needless: needless
needlework: needlework
neglect: neglect,neglected
negligence: negligence
negligent: negligent
neighbour: neighbour,neighbouring,neighbours
neighbourhood: neighbourhood
nerve: nerves
netting: netting
newfoundland: newfoundland
newly: newly
news: news
newspaper: newspaper,newspapers
nice: nice,nicer,nicest
niggardly: niggardly
night: night,nights
nightly: nightly
nimbly: nimbly
noble: noble
nobleman: noblemen
nobleness: nobleness
nod: nod,nods
noise: noise,noises
noisy: noisy
nominal: nominal
nonsense: nonsense
noon: noon
north: north
northern: northern
note: note
notice: notice,noticed,noticing
notion: notion,notions
nourish: nourish
novelist: novelist
novelty: novelty
nowadays: nowadays
numerous: numerous
nun: nun
nurse: nursing
oak: oak,oaks
oath: oaths
obey: obey
object: object,objects
objection: objection,objections
objectionable: objectionable
obligation: obligation,obligations
oblige: oblige,obliged,obliging
observance: observance
observation: observation,observations
observe: observe,observed,observing
observer: observer
obsolete: obsolete
obstacle: obstacle
obstinate: obstinate
occasion: occasion,occasioned
occasional: occasional
occasionally: occasionally
occupation: occupation
occupied: occupied
occupy: occupied,occupy
occur: occur,occurred,occurring
occurrence: occurrence
octagon: octagon
odd: odd
odds: odds
odious: odious
offence: offence
offend: offend,offended,offending
offended: offended
offer: offer,offered,offering,offers
office: office,offices
oftener: oftener
oil: oiled
oneself: oneself
openly: openly
openness: openness
operation: operation
opinion: opinion,opinions
opportunity: opportunities,opportunity
oppose: oppose,opposing
opposition: opposition
oppress: oppress
orchard: orchard
orchestra: orchestra
ordinary: ordinary
oriel: oriel
origin: origin
original: original
originality: originality
originally: originally
originate: originated
ornament: ornament,ornaments
ornamental: ornamental
orphan: orphan
outer: outer
outrider: outriders
outset: outset
outstrip: outstripped
overcome: overcome
overdrawn: overdrawn
overflow: overflowing
overhear: overhear,overheard
overlook: overlooked
overpower: overpowered
overpowering: overpowering
overrate: overrated
overset: overset
overstrained: overstrained
overtake: overtake,overtaken,overtook
overthrow: overthrow
overture: overture
overturn: overturn
owner: owner
oxford: oxford
pace: pace,paced,paces
pacing: pacing
package: package
packing: packing
padlock: padlock
pain: pain,pains
pained: pained
painful: painful
paint: painted
painting: painting
pair: pair
palate: palate
pale: pale
paleness: paleness
pamphlet: pamphlets
pane: pane
panegyric: panegyric
panel: panels
pang: pang,pangs
pantry: pantries
papa: papa,papas
paper: paper,papered,papers
parade: parade,paraded,parading
parcel: parcels
pardon: pardon,pardoned
pardonable: pardonable
parent: parent,parents
parental: parental
parish: parish
park: park
parlour: parlour
parry: parry
parsonage: parsonage,parsonages
partial: partial
partiality: partiality
particulars: particulars
partly: partly
partner: partner,partners
partnership: partnership
party: parties,party
pass: pass,passed,passes,passing
passage: passage,passages
passion: passion,passions
passport: passport
pastry: pastry
patch: patched
path: path
pathos: pathos
patience: patience
patient: patient
patron: patron
patronize: patronized
patten: pattened
pause: pause,paused
pave: paved
pavement: pavement
pay: paid,pay,paying
peace: peace
peaceably: peaceably
peal: peals
pearl: pearls
peculiar: peculiar
peculiarly: peculiarly
pecuniary: pecuniary
peep: peeped
peerage: peerage
pelisse: pelisse
pen: pen,penned,pens
pencil: pencil
penetrate: penetrate,penetrating
penetration: penetration
penny: penny
pensive: pensive
perceivable: perceivable
perceive: perceive,perceived,perceiving
perfect: perfect,perfecting
perfection: perfection,perfections
perfectly: perfectly
perform: perform,performed,performing
performance: performance,performances
period: period,periods
permanently: permanently
permission: permission
permit: permit,permitted,permitting
perpetrate: perpetrated
perpetually: perpetually
perplexity: perplexity
persecution: persecutions
persevere: persevere,persevered
person: people,person,persons
personal: personal
perspective: perspectives
persuade: persuade,persuaded
persuasion: persuasion
perturbation: perturbation
perusal: perusal
peruse: peruse
perverse: perverse
perverseness: perverseness
pestilence: pestilences
petition: petition,petitioned
petty: petty
pew: pew
phaeton: phaeton,phaetons
philosophic: philosophic
philosophy: philosophy
phrase: phrases
physician: physician
pianoforte: pianoforte
picture: picture,pictured,pictures
picturesque: picturesque
piece: piece,pieces
pillow: pillow
pin: pin,pinned
pine: pine
pinery: pinery
pint: pints
pitch: pitch
pitiable: pitiable
pitiful: pitiful
pitiless: pitiless
pity: pitied,pity
placid: placid
placidly: placidly
plague: plague,plagued
plain: plain,plainer
plainly: plainly
plan: plan,plans
plant: plants
plantation: plantations
plausibility: plausibility
play: play,played,playing,plays
player: players
playful: playful
playing: playing
plea: plea
plead: pleaded
pleasant: pleasant,pleasanter
pleasantly: pleasantly
pleasantry: pleasantry
pleased: pleased
pleasing: pleasing
pleasure: pleasure,pleasures
pledge: pledged
plenty: plenty
plumpness: plumpness
plunge: plunge
pocket: pocket,pockets
pocketbook: pocketbook
poetry: poetry
pointedly: pointedly
poison: poison
policy: policy
polite: polite
politely: politely
politeness: politeness
politics: politics
ponder: pondering
ponderous: ponderous
pool: pool
poor: poor
pope: pope,popes
populous: populous
porch: porch
pore: poring
portion: portion
portionless: portionless
portrait: portrait,portraits
portray: portray,portrayed
position: position
positive: positive
positively: positively
possess: possess,possessed
possession: possession,possessions
possibility: possibility
post: post
postilion: postilions
postpone: postpone
potion: potions
poultice: poultice
pound: pounds
pour: poured
poverty: poverty
powder: powder
power: power,powers
practice: practice
praise: praise
pray: pray
prayer: prayers
precede: preceded
precinct: precincts
precious: precious
precision: precision
prediction: prediction,predictions
prefer: prefer,preferred,preferring
preference: preferences
preferment: preferment
prelude: prelude
prematurely: prematurely
premise: premises
preparation: preparation
prepare: prepare,prepared,preparing
prepared: prepared
preponderate: preponderated
prepossessing: prepossessing
presence: presence
presentiment: presentiment,presentiments
presently: presently
preserve: preserve,preserved,preserving
press: press,pressed,pressing
pressing: pressing
pressure: pressure
presume: presumed
presumption: presumption
pretence: pretence
pretend: pretend,pretended,pretending
pretension: pretension,pretensions
prettily: prettily
pretty: prettier,prettiest,pretty
prevail: prevail,prevailed,prevailing
prevailing: prevailing
prevent: prevent,prevented,preventing
prevention: prevention
price: price
pride: pride
principal: principal
principle: principle,principles
prior: prior
prison: prison
privacy: privacy
private: private
privileged: privileged
privy: privy
prize: prized
probability: probability
probable: probable
proceed: proceed,proceeded,proceeding
proceedings: proceedings
proclaim: proclaimed
procure: procure,procured
prodigious: prodigious
produce: produce,produced
production: production,productions
productive: productive
profess: professing
profession: profession,professions
proficiency: proficiency
profile: profile
profit: profit
profligacy: profligacy
profusion: profusion
progress: progress
project: project,projected,projects
promise: promise,promised,promises
promising: promising
promote: promote,promoting
promotion: promotion
prompt: prompt,prompted
pronounce: pronounce,pronounced
pronounced: pronounced
proof: proof,proofs
propensity: propensities,propensity
proper: proper,properest
properly: properly
property: property
proportion: proportioned
proposal: proposal,proposals
propose: propose,proposed
proprietor: proprietor
propriety: propriety
prospect: prospect
protection: protection
protest: protest,protested,protesting
proudly: proudly
prove: prove,proved
proverb: proverb
provide: provide,providing
proviso: proviso
provoke: provoke,provoked
provoking: provoking
proxy: proxy
prudence: prudence
psha: psha
public: public
publication: publication
publish: publish,published,publishes
publisher: publisher
puce: puce
pull: pull,pulled,pulling
pump: pump
pun: pun
punctual: punctual
punctuality: punctuality
punctuation: punctuation
puppy: puppies,puppy
purchase: purchase,purchased,purchases
pure: pure
purity: purity
purple: purple
purpose: purpose,purposes
purse: purse,purses
pursue: pursued
pursuit: pursuit
purvey: purvey
push: push,pushed
puzzle: puzzle,puzzled,puzzles
pyrenees: pyrenees
quadrangle: quadrangle
qualified: qualified
qualify: qualified
quality: quality
quarrel: quarrel,quarrels
quarrelsome: quarrelsome
quarter: quarter,quarters
queer: queer
quell: quell
quest: quest
question: question,questioned,questions
questioner: questioner
quick: quick
quicken: quickening
quickness: quickness
quiet: quiet,quietest
quietly: quietly
quietness: quietness
quit: quit,quitted,quitting
quiver: quivering
quiz: quiz,quizzes
quizzer: quizzers
quota: quota
quotation: quotations
race: race,racing
rage: rage,raged
raillery: raillery
rain: rain,rained,raining,rains
rainy: rainy
raise: raise,raised,raising
ramble: rambles
rambler: rambler
rambling: rambling
rampart: ramparts
random: random
range: range
rank: rank,ranked
rap: rap
rapid: rapid
rapidity: rapidity
rapidly: rapidly
rapture: rapture,raptures
rapturous: rapturous
rare: rare
rate: rate
rational: rational
rationally: rationally
rattle: rattle
rave: raved
ray: ray,rays
reach: reach,reached,reaching
read: read,reading,reads
readable: readable
reader: reader,readers
reading: reading
ready: ready
real: real
reality: reality
realization: realization
reappear: reappeared
reappearance: reappearance
rear: reared
reason: reason,reasoned
reasonable: reasonable
reasonableness: reasonableness
reasoning: reasoning,reasonings
reassure: reassure
recall: recall,recalled
recede: receding
receive: receive,received,receiving
recess: recess
reckon: reckoned
recognition: recognition
recognize: recognized
recollect: recollect,recollected,recollecting
recollection: recollection
recommence: recommenced
recommend: recommend,recommended,recommending
recommendation: recommendation,recommendations
reconcile: reconcile
reconciliation: reconciliation
record: records
recourse: recourse
recover: recover,recovered,recovering
recovered: recovered
recovery: recovery
rectify: rectify
recur: recurring
recurrence: recurrence
red: red,redder
reduce: reduce,reduced
reference: reference
refine: refined
refined: refined
refinement: refinement
reflect: reflect,reflected,reflecting
reflection: reflection,reflections
reformation: reformation
refrain: refrain
refreshment: refreshment,refreshments
refusal: refusal
refuse: refuse,refused,refusing
regain: regain
regard: regard,regarded
regiment: regiment
regret: regret,regretted,regretting
regular: regular
regularly: regularly
rein: reins
reject: rejected
rejection: rejection
rejoice: rejoice,rejoiced
rejoin: rejoined
rekindle: rekindling
relapse: relapse
relate: relate,relating
relation: relation,relations
relationship: relationship
relative: relative
relator: relator
relax: relax
relaxation: relaxation
release: release,released
reliance: reliance
relief: relief
relieve: relieve,relieved
religious: religious
relinquish: relinquished
relish: relish
reluctance: reluctance
reluctantly: reluctantly
rely: rely,relying
remain: remain,remained,remaining,remains
remainder: remainder
remains: remains
remark: remark,remarks
remarkable: remarkable
remarkably: remarkably
remember: remember,remembered,remembering
remembrance: remembrance
remind: remind,reminded,reminding
remiss: remiss
remissness: remissness
remnant: remnant
remonstrance: remonstrance,remonstrances
remonstrate: remonstrated
remorse: remorse
remote: remote
removal: removal
remove: removed,removing
removed: removed
rend: rending
render: render,rendered,rendering
renew: renewed
rent: rent
repair: repair,repaired
repass: repassing
repast: repast
repay: repaid
repeat: repeat,repeated,repeating
repeatedly: repeatedly
repent: repent
repentance: repentance
repetition: repetition
repine: repining
reply: replied,replies,reply
report: report
repose: repose,reposing
represent: represent,represented
representation: representation,representations
repress: repress
reproach: reproach,reproached,reproaches
reproof: reproof
reputation: reputation
reputed: reputed
request: request,requesting
require: require,required,requires
requisite: requisites
resee: reseeing
resemblance: resemblance
resent: resent,resented,resenting
resentful: resentful
resentment: resentment
reserve: reserve
residence: residence
resign: resigned,resigning
resist: resist,resisted
resistance: resistance
resistless: resistless
resolute: resolute
resolutely: resolutely
resolution: resolution,resolutions
resolve: resolve,resolved,resolving
resound: resounded
respect: respect,respected,respecting
respectable: respectable
respectably: respectably
respectful: respectful
respective: respective
respects: respects
rest: rest
restless: restless
restlessly: restlessly
restore: restore,restored,restoring
restrain: restrain,restrained,restraining
restraint: restraint
result: result
resume: resumed
retain: retained
retire: retire,retired,retiring
retired: retired
retirement: retirement
retract: retract,retracted
retraction: retraction
retreat: retreat,retreated,retreating
return: return,returned,returning
revenge: revenge
reverential: reverential
reverie: reverie,reveries
reverse: reverse,reversed,reversing
revert: reverted,reverting
review: review
reviewer: reviewers
revise: revised
revive: revived
revolution: revolution
revolve: revolving
reward: reward,rewarded
rhine: rhine
rhodomontade: rhodomontade
rhubarb: rhubarb
ribbon: ribbon,ribbons
rich: rich
richard: richard
richardson: richardson
richly: richly
richmond: richmond
rickety: rickety
rid: rid
ride: ride,riding
ridiculous: ridiculous
riding: riding
rightly: rightly
rigour: rigours
riot: riot
rise: rise,rising,rose
risk: risks
rival: rival
river: river
road: road,roads
roar: roared
rob: rob,robbed
robber: robbers
robe: robe
robinson: robinson
rocks: rocks
rocky: rocky
roll: roll,rolled,rolling
romance: romance
romancer: romancers
romantic: romantic
roof: roof
roomy: roomy
rose: rose,roses
rouse: roused
route: route
row: rows
rub: rubbed
rude: rude
rudeness: rudeness
ruder: ruder
rudiment: rudiments
ruffle: ruffle
ruin: ruin,ruined,ruining,ruins
rule: rule,rules
rush: rushed
sacrifice: sacrifice
sad: sad
sadly: sadly
sadness: sadness
safe: safe,safer
safely: safely
safety: safety
sagacity: sagacity
sake: sake
salisbury: salisbury
sallow: sallow
sally: sally
sam: sam
sameness: sameness
sampler: sampler
sanction: sanction,sanctioned
sanguine: sanguine
sarah: sarah
sarsenet: sarsenet
sash: sash
satin: satin
satire: satire
satisfaction: satisfaction
satisfactory: satisfactory
satisfied: satisfied
satisfy: satisfied,satisfy
saturday: saturday
saunter: saunter
save: save,saved,saving
saving: saving
scamper: scampered
scandalous: scandalous
scarce: scarce
scarcely: scarcely
scare: scare
scatter: scatter,scattered
scene: scene,scenes
scheme: scheme,schemes,scheming
scholar: scholar
schoolfellow: schoolfellow,schoolfellows
scold: scold,scolding
score: score,scores
scorn: scorned
scotch: scotch
scrape: scrape
screen: screens
scruple: scruple
scrupulous: scrupulous
scud: scud
scullery: scullery
sea: sea
search: search,searched
season: season
seat: seat,seated,seats
seated: seated
secondary: secondary
secret: secret
secrete: secreted
secretly: secretly
secure: secure,secured
securely: securely
security: security
sedate: sedate
sedentary: sedentary
seek: seek,seeking,sought
seize: seize,seized,seizing
seizure: seizure
seldom: seldom
select: selecting
selfish: selfish
sell: sell,sold
semicircular: semicircular
send: send,sending
sensation: sensation,sensations
sense: sense
sensibility: sensibility
sentence: sentence,sentences
sentiment: sentiment,sentiments
sentimental: sentimental
separate: separated,separating
separately: separately
separation: separation
serenity: serenity
servant: servant,servants
serve: served
service: service
serviceable: serviceable
servile: servile
set: set,sets,setting
setting: setting
settle: settle,settled,settles
settled: settled
settlement: settlements
seventeen: seventeen
severe: severe
severely: severely
severity: severity
sex: sex,sexes
shabbiness: shabbiness
shabby: shabby
shades: shades
shadow: shadow
shake: shake,shook
shakespeare: shakespeare
shallow: shallow
shame: shame
shape: shape,shaped
shapeless: shapeless
share: share,shared,sharing
sharer: sharers
sheet: sheet,sheets
shelf: shelf
shelter: shelter,sheltered
shift: shift
shilling: shillings
shine: shining,shone
shirk: shirked
shirt: shirts
shiver: shivering
shock: shock,shocking
shocked: shocked
shocking: shocking
shoe: shoe,shoes
shoot: shoot,shooting
shop: shop,shops
short: short,shorter
shortly: shortly
shortness: shortness
shot: shot
shoulder: shoulder,shoulders
showery: showery
shrewdness: shrewdness
shrink: shrink
shrub: shrub
shrubbery: shrubberies
shrug: shrugged
shudder: shuddered
shut: shut,shutting
shutter: shutter,shutters
shy: shy
shyness: shyness
sick: sick
sigh: sigh,sighed,sighing,sighs
sighing: sighing
sight: sight,sights
signet: signet
signify: signify
silence: silence,silenced
silencing: silencing
silent: silent
silently: silently
silk: silk
silly: silly
silver: silver
similarity: similarity
simile: simile
simpering: simpering
simple: simple,simpler
simpleton: simpleton
simplicity: simplicity
simply: simply
sin: sinned
sincerely: sincerely
sincerity: sincerity
sing: sang,sing
single: single
singly: singly
singular: singular
singularly: singularly
sink: sink,sinking,sunk
sir: sir
sister: sister,sisters
sisterly: sisterly
sit: sat,sit,sitting
situation: situation,situations
sixteen: sixteen
sixth: sixth
size: size
sized: sized
skeleton: skeleton
sketch: sketch
skill: skill
skin: skin
skinner: skinner
skinners: skinners
skulker: skulker
sky: skies,sky
slab: slabs
slave: slaves
sleep: sleep,sleeping,slept
sleeper: sleeper
sleepless: sleepless
sleeplessness: sleeplessness
sleeve: sleeve,sleeves
slide: sliding
slight: slight,slighted,slightest,slighting
slightingly: slightingly
slip: slipped
slope: slope
slowly: slowly
slumber: slumber,slumbers
sly: sly
smack: smacked
smallness: smallness
smart: smart
smile: smile,smiled,smiles,smiling
smirk: smirk
smith: smith
smoke: smoke
smooth: smooth
sneak: sneaked
snuff: snuffed
snugly: snugly
sober: sober
sobriety: sobriety
social: social
society: society
socket: socket
soften: softened,softening
softly: softly
sole: sole
solely: solely
solemn: solemn
solemnity: solemnity
solemnly: solemnly
solicit: solicit,solicited
solicitation: solicitations
solicitous: solicitous
solicitude: solicitude
solitariness: solitariness
solitary: solitary
solitude: solitude
sombre: sombre
son: son,sons
song: song
sonnet: sonnets
sooner: sooner
soothe: soothed,soothing
soothing: soothing
sophia: sophia
sorrow: sorrow,sorrows
sorrowing: sorrowing
sort: sort
soul: soul
sound: sound,sounds
soup: soup
source: source,sources
south: south
space: space
spacious: spacious
spaciousness: spaciousness
spar: spars
spare: spare,spared
sparkling: sparkling
speak: speak,speaking,spoke,spoken
species: species
specimen: specimen,specimens
speck: speck,specks
spectator: spectator
speculation: speculation,speculations
speech: speech,speeches
speechless: speechless
speed: speed
speedily: speedily
speedy: speedy
spell: spell
spelling: spelling
spend: spend,spending,spent
spire: spire
spirit: spirit,spirits
spite: spite
splash: splashed,splashing
splendid: splendid
splendour: splendour
spoil: spoil,spoilt
spoken: spoken
sport: sport
sportive: sportive
spot: spot,spotted
spotless: spotless
spotted: spotted
spread: spread
sprigged: sprigged
spring: sprang,spring,springing,springs
spurn: spurning
spy: spies
squeeze: squeeze,squeezed
squire: squire
stable: stable,stables
stage: stage,stages
stair: stairs
staircase: staircase
stake: stake
stamp: stamp
stand: stand,standing,stands,stood
standing: standing
stare: stared,staring
start: start,started,starting
startle: startle
startled: startled
statement: statement
station: station
stay: stay,stayed,staying,stays
steadily: steadily
steadiness: steadiness
steady: steady
steal: steal,stole
steep: steep
step: step,stepped,stepping,steps
steward: steward
stick: stick
stimulant: stimulant
sting: sting,stings
stipulation: stipulation
stir: stir,stirring
stirrup: stirrups
stock: stocked
stocking: stockings
stone: stone
store: store
storehouse: storehouse
storm: storm,storms
stormy: stormy
story: story
stout: stout
stoutly: stoutly
stove: stove,stoves
strain: strain,straining,strains
strained: strained
strange: strange
strangely: strangely
stranger: stranger,strangers
straw: straw
street: street,streets
strength: strength
strengthen: strengthened
strew: strewed
strict: strict,strictest
strike: strike,strikes,striking,struck
striking: striking
string: string
stroke: stroke,strokes
strong: strong,stronger,strongest
struggle: struggle,struggling
stubborn: stubborn
studiously: studiously
study: studied,studies,study
stuff: stuff
stupid: stupid,stupidest
stupidity: stupidity
style: style
stylishness: stylishness
subdue: subdue,subdued
subject: subject,subjects
submit: submit,submitted
subsequent: subsequent
subside: subsided
substance: substance
substantial: substantial
subterraneous: subterraneous
succeed: succeed,succeeded,succeeding
success: success
successful: successful
succession: succession
successive: successive
successively: successively
sudden: sudden
suddenly: suddenly
suddenness: suddenness
sue: sue
suffer: suffer,suffered,suffering
sufferance: sufferance
sufferer: sufferer
suffering: suffering,sufferings
suffice: sufficed
sufficient: sufficient
suggestion: suggestion,suggestions
suit: suit
suitable: suitable
suite: suite,suites
sullen: sullen
sully: sullying
sum: sums
summary: summary
summer: summer
summit: summit
summon: summon,summoned
summons: summons
sun: sun
sunday: sunday
sunshine: sunshine
superciliousness: superciliousness
superior: superior
superiority: superiority
supernatural: supernatural
supersede: supersede,superseded
supper: supper
supplant: supplanted
supplication: supplication,supplications
supply: supplied,supply,supplying
support: support,supported,supporting
suppose: suppose,supposed,supposing
supposition: supposition
supposititious: supposititious
suppress: suppressing
surely: surely
surmise: surmise,surmises
surmount: surmounting
surpass: surpassed
surprise: surprise,surprised
surprised: surprised
surprising: surprising
surround: surrounded,surrounding
survey: survey,surveying
surveyor: surveyor
susceptibility: susceptibilities
suspect: suspect,suspected,suspecting
suspend: suspended
suspense: suspense
suspension: suspension
suspicion: suspicion,suspicions
sustain: sustained
swallow: swallow,swallowed
swear: swearing,swore
sweat: sweat
sweep: sweep,swept
sweet: sweet,sweeter,sweetest,sweets
swell: swelled,swelling
swift: swift
swiftly: swiftly
swiftness: swiftness
switzerland: switzerland
sword: sword
syllable: syllable
sympathetic: sympathetic
sympathy: sympathy
symptom: symptoms
synonymous: synonymous
table: table,tables
tacit: tacit
tale: tale
talent: talent,talents
talk: talk,talked,talking,talks
talker: talker
talking: talking
tall: tall,tallest
tamboured: tamboured
tapestry: tapestry
tardiness: tardiness
tarnish: tarnished
task: task
taste: taste,tasted,tastes
tasteful: tasteful
tea: tea
teach: taught,teach,teaching
teachableness: teachableness
tear: tears,torn
tease: tease,teased,teasing
tedious: tedious
tediousness: tediousness
temper: temper,tempered,tempers
temperate: temperate
tempest: tempest,tempests
temple: temples
tempt: tempt,tempted,tempting
tenant: tenants
tend: tend
tendency: tendency
tender: tender
tenderness: tenderness
tenor: tenor
tenth: tenth
term: term,termed,terms
terminate: terminated
terrier: terriers
terrific: terrific
terrified: terrified
terror: terror,terrors
testimony: testimony
texture: texture
thankful: thankful
thankfully: thankfully
theatre: theatre
thickness: thickness
thinking: thinking
thirteen: thirteen
thither: thither
thorn: thorns
thorpe: thorpe,thorpes
thorpes: thorpes
thoughtfulness: thoughtfulness
thoughtless: thoughtless
thoughtlessness: thoughtlessness
thread: thread,threading
threadbare: threadbare
threaten: threatened,threatening
thrilling: thrilling
throat: throat
throng: throng
throw: threw,throw,throwing,thrown
thunder: thunder
thursday: thursday
thwart: thwarted
ticket: tickets
tiding: tidings
tidy: tidy
tie: tie,tying
time: time,timed,times
tinkle: tinkling
tippet: tippet
tiptoe: tiptoe
tired: tired
tiresome: tiresome
title: title,titles
tittuppy: tittuppy
toilette: toilette,toilettes
tolerable: tolerable
tolerably: tolerably
tolerate: tolerated
tom: tom
tombstone: tombstones
tone: tone
tongue: tongue
topic: topics
torment: torment,tormented,torments
torrent: torrents
torture: torture
toss: tossed
total: total
totally: totally
touch: touch,touched,touching
tower: tower,towers
town: town
trace: traced,traces
traditional: traditional
train: train
training: training
tranquillity: tranquillity
tranquillize: tranquillized
transaction: transactions
transient: transient
transition: transition
transmit: transmitting
transpire: transpire
trap: trap
trash: trash
travel: travelled,travelling
traveling: traveling
traveller: traveller
travelling: travelling
travels: travels
tray: tray
treacherous: treacherous
tread: tread,treading
treasure: treasure
treat: treat,treated,treating
treatment: treatment
treble: trebling
tree: trees
tremble: tremble,trembled,trembling
tremulous: tremulous
trespass: trespassed
trial: trial
tribute: tribute
trick: trick,tricked,tricks
trifle: trifle,trifles,trifling
trifler: trifler
trifles: trifles
trifling: trifling
trimming: trimmings
trio: trio
trip: tripping
triumph: triumph,triumphs
triumphant: triumphant
trivial: trivial
trod: trod
trodden: trodden
troop: troop
trot: trot,trotted
trouble: trouble,troubled
troublesome: troublesome
true: true
trunk: trunk,trunks
trust: trust,trusted,trusting
truth: truth
tuesday: tuesday
tumble: tumble
tumbled: tumbled
tune: tune
turban: turban
tuscany: tuscany
twelfth: twelfth
twelvemonth: twelvemonth
twist: twisting
tyranny: tyranny
ugly: ugly
umbrella: umbrella,umbrellas
unable: unable
unaccountable: unaccountable
unaccountably: unaccountably
unacquainted: unacquainted
unaffected: unaffected
unalloyed: unalloyed
unanswerable: unanswerable
unassisted: unassisted
unattended: unattended
unawares: unawares
unbelieving: unbelieving
unbroken: unbroken
uncandid: uncandid
unceasing: unceasing
unceasingly: unceasingly
uncensured: uncensured
uncertain: uncertain
uncertainty: uncertainty
uncheerful: uncheerful
uncivil: uncivil
uncomfortable: uncomfortable
uncomfortably: uncomfortably
uncommon: uncommon
uncommonly: uncommonly
unconquerable: unconquerable
unconscious: unconscious
unconsciously: unconsciously
unconvinced: unconvinced
uncoquettish: uncoquettish
uncritical: uncritical
undeceive: undeceive
undeceived: undeceived
undefined: undefined
undergo: undergone
understand: understand,understanding,understood
understanding: understanding
undertake: undertake,undertook
undertaking: undertaking
undervalue: undervalue
undervaluing: undervaluing
undiscovered: undiscovered
undisputed: undisputed
undistinguish: undistinguishing
undisturbed: undisturbed
undivided: undivided
undoubtedly: undoubtedly
undress: undressed
undressed: undressed
uneasiness: uneasiness
uneasy: uneasy
unequal: unequal
uneventful: uneventful
unexpected: unexpected
unexplored: unexplored
unfairly: unfairly
unfasten: unfasten
unfavourably: unfavourably
unfixed: unfixed
unfold: unfolded
unforgivingness: unforgivingness
unfortunate: unfortunate
unfounded: unfounded
unfrequently: unfrequently
unfriendly: unfriendly
unfurnished: unfurnished
ungenerous: ungenerous
ungraceful: ungraceful
unguarded: unguarded
unhappiness: unhappiness
unhappy: unhappy
uniformity: uniformity
uninformed: uninformed
uninhabited: uninhabited
unintelligible: unintelligible
unintentional: unintentional
uninteresting: uninteresting
unintricate: unintricate
union: union
unite: unite,united,uniting
united: united
universal: universal
universe: universe
unjust: unjust
unjustifiable: unjustifiable
unkind: unkind
unkindness: unkindness
unknowingly: unknowingly
unknown: unknown
unlimited: unlimited
unlock: unlock,unlocked,unlocking
unlooked: unlooked
unmarked: unmarked
unnatural: unnatural
unnaturally: unnaturally
unnecessary: unnecessary
unnoticed: unnoticed
unoccupied: unoccupied
unpardonably: unpardonably
unpin: unpin
unpleasant: unpleasant
unpleasantness: unpleasantness
unpractised: unpractised
unprejudiced: unprejudiced
unpretending: unpretending
unprincipled: unprincipled
unprivileged: unprivileged
unpromising: unpromising
unpropitious: unpropitious
unprovided: unprovided
unquiet: unquiet
unravel: unravelled
unreasonable: unreasonable
unreasonably: unreasonably
unreserve: unreserve
unreserved: unreserved
unrivalled: unrivalled
unsafe: unsafe
unsatisfied: unsatisfied
unsearched: unsearched
unseasonable: unseasonable
unseasonableness: unseasonableness
unseen: unseen
unsettled: unsettled
unsolicited: unsolicited
unspeakably: unspeakably
unsteady: unsteady
unsuccessful: unsuccessful
unsusceptible: unsusceptible
unsuspicious: unsuspicious
untasted: untasted
unthinkingly: unthinkingly
untoward: untoward
unusual: unusual
unusually: unusually
unutterable: unutterable
unwearied: unwearied
unwelcome: unwelcome
unwilling: unwilling
unwillingly: unwillingly
unwillingness: unwillingness
unworthy: unworthy
upper: upper
uppermost: uppermost
upstairs: upstairs
urge: urge,urged
urgent: urgent
usage: usage
useless: useless
usher: usher,ushered
usual: usual
utility: utility
utmost: utmost
utter: utter,uttered,uttering
utterly: utterly
vacancy: vacancy
vacation: vacation
vain: vain
vainer: vainer
vainly: vainly
valley: valley
valuable: valuable
vanity: vanities,vanity
variation: variation
variety: varieties,variety
vary: vary
vast: vast
vastly: vastly
vault: vault,vaulted,vaults
veal: veal
vehemence: vehemence
vehemently: vehemently
veil: veil
velvet: velvet
venerable: venerable
venerate: venerating
venture: venture,ventured,venturing
verb: verb
verdure: verdure
verify: verified
verily: verily
vex: vex,vexed
vexation: vexation,vexations
vice: vice,vices
vicinity: vicinity
vicissitude: vicissitudes
victory: victory
vide: vide
view: view,viewed,viewing,views
vigorous: vigorous
vigour: vigour
vile: vile
villa: villas
village: village
villain: villains
vindication: vindication
violate: violating
violence: violence
violent: violent
violently: violently
virtue: virtue
virtuous: virtuous
viscount: viscount
viscountess: viscountess
visible: visible
vision: visions
visit: visit,visited
visitor: visitor,visitors
vivacity: vivacity
voice: voice,voices
void: void
volume: volume,volumes
voluminous: voluminous
voluntarily: voluntarily
voluntary: voluntary
voucher: vouchers
vow: vow,vowed
vulgarity: vulgarity
waft: waft,wafted
waistcoat: waistcoats
wait: wait,waited,waiting,waits
waiter: waiters
waiting: waiting
waive: waive
wake: woke
walk: walk,walked,walking,walks
walker: walkers
walking: walking
wall: wall,walls
wander: wandering
wanton: wanton
war: war,wars
ward: ward
wardrobe: wardrobes
warehouse: warehouse
warm: warm,warmer
warmly: warmly
warn: warned
warning: warnings
warped: warped
warrant: warrant
warrior: warrior
wash: wash
washing: washing
waste: waste,wasted
watch: watch,watched,watching
watchful: watchful
water: water,watering,waters
wavering: wavering
waxen: waxen
weaken: weaken,weakened,weakening
weakness: weakness
wealth: wealth
wealthy: wealthy
wear: wear,wears,wore,worn
wearied: wearied
weariness: weariness
weary: weary,wearying
weather: weather
wedding: wedding
wednesday: wednesday
week: week,weeks
weigh: weigh
weight: weight
welfare: welfare
western: western
wet: wet
wheel: wheeled,wheels
whimsical: whimsical
whip: whip
whisk: whisked
whisper: whisper,whispered,whispering
white: white
wholly: wholly
whomsoever: whomsoever
wick: wick
wicked: wickedest
wide: wide
widow: widow
wife: wife,wives
wild: wild
wilful: wilful
william: william
willingly: willingly
wiltshire: wiltshire
win: win
wind: wind,winding,wound
winded: winded
window: window,windows
wine: wine
wink: wink
winner: winner
winter: winter
wisdom: wisdom
wise: wise,wisest
wisely: wisely
wisher: wishers
wit: wit,wits
witch: witch
withdraw: withdraw,withdrawn,withdrew
withered: withered
withhold: withheld,withhold
withstand: withstand,withstanding
witness: witness,witnessed
witted: witted
woe: woe,woes
woman: woman,women
wonderful: wonderful
wonderfully: wonderfully
wood: wood,woods
woody: woody
word: word,worded
workings: workings
worldly: worldly
worn: worn
worth: worth
worthlessness: worthlessness
worthy: worthy
wrap: wrap
wrapt: wrapt
wretched: wretched
wretchedly: wretchedly
wretchedness: wretchedness
wring: wring
writ: writ
write: write,writing,written,wrote
writer: writer,writers
writing: writing
wrong: wrong,wronging
yard: yard,yards
yawn: yawn
yearly: yearly
yellow: yellow
yesterday: yesterday
yield: yielded
york: york
youth: youth
youthful: youthful
