abandon: abandon,abandoned,abandoning,abandons
abashed: abashed
abate: abating
abbreviated: abbreviated
abduct: abducted
abide: abide
ability: abilities,ability
abode: abode,abodes
abridged: abridged
abridgement: abridgement
abruptly: abruptly
absence: absence
absent: absent
absolutely: absolutely
abstain: abstain,abstaining
abstract: abstract,abstracted
absurd: absurd
abundance: abundance
abuse: abuse,abusing
abusive: abusive
accept: accept,accepted,accepting,accepts
acceptable: acceptable
access: access,accessed
accessible: accessible
accession: accession
accident: accidents
accidental: accidental
accidentally: accidentally
accompany: accompanied,accompany,accompanying
accompanying: accompanying
accomplish: accomplish,accomplished,accomplishes,accomplishing
accord: accord,accorded
accost: accost
account: account
accumulate: accumulating
accusation: accusation
accustom: accustomed
accustomed: accustomed
acidulate: acidulated
acknowledge: acknowledged
acquaint: acquaint,acquainted
acquaintance: acquaintance,acquaintances
acquaintanceship: acquaintanceship
acquainted: acquainted
acquire: acquire,acquired,acquires,acquiring
acquirement: acquirements
acquisition: acquisition
action: action,actions
active: active
activity: activity
actor: actor,actors
actual: actual
adapt: adapting
add: add,adding,adds
addict: addicted
addition: addition,additions
additional: additional
address: address,addressed,addresses,addressing
addresses: addresses
adjust: adjust
admiration: admiration
admire: admire
admission: admission
admit: admit,admits,admitted
adopt: adopt
adore: adored
adorn: adorning
adornment: adornment
adulterous: adulterous
advance: advances
advantage: advantage
adventurous: adventurous
advice: advice
advisable: advisable
affair: affair,affairs
affect: affect
affection: affection,affections
affectionate: affectionate
affectionately: affectionately
affinity: affinity
affirm: affirm,affirms
afflict: afflicted
affliction: affliction
afford: afford,affords
afraid: afraid
afternoon: afternoon
age: age,ages
aged: aged
agent: agent,agents
agree: agree,agreed,agrees
agreeable: agreeable
agreement: agreement
agricultural: agricultural
ahmed: ahmed
aid: aid
ailment: ailment
ak: ak
alas: alas
albrecht: albrecht
alive: alive
alkali: alkali
allay: allay
allege: alleging
allen: allen
allude: allude,alluded,alludes
ally: allies
alteration: alteration
alternate: alternate
alternately: alternately
altogether: altogether
amaranth: amaranth
amaze: amaze
ambassador: ambassador
amiability: amiability
amorous: amorous
amuse: amuse
amusement: amusement,amusements
amusing: amusing
analogous: analogous
analysis: analysis
anaryan: anaryan
ancestor: ancestors
ancestral: ancestral
ancient: ancient
andropogon: andropogon
anger: anger
angrily: angrily
angry: angry
animal: animal,animals
annotate: annotated
annoyed: annoyed
anoint: anoint,anointing
answer: answer,answered,answers
antimony: antimony
anus: anus
anxiety: anxiety
anxious: anxious
apar: apar
apartment: apartments
aphorism: aphorisms
aphorisms: aphorisms
aphrodisiac: aphrodisiacs
apparent: apparent
appearance: appearance
appease: appease
appertain: appertaining
apple: apple
applicable: applicable
application: application,applications
apply: applied,applies,apply,applying
appoint: appoint,appointed
appreciation: appreciation
apprehension: apprehension
apprehensive: apprehensive
apprise: apprised
approach: approach,approached,approaching
appropriately: appropriately
approve: approved
approximate: approximate
apt: apt
aqueduct: aqueducts
arab: arab
arabesque: arabesque
arabian: arabian
arbour: arbours
archery: archery
architecture: architecture
archive: archive
ardently: ardently
argue: argue
arithmetical: arithmetical
arm: arm,arms
armlet: armlet,armlets
armpit: armpits
army: armies
arrange: arrange,arranged,arranges,arranging
arrangement: arrangements
array: array,arraying
arrest: arrested
arris: arris
arrival: arrival
arrive: arrive,arrived,arrives
arrow: arrow,arrows
ars: ars
arsenic: arsenic
art: art,arts
artful: artful
artfulness: artfulness
artha: artha
article: articles
artifice: artifice,artifices
artificial: artificial
artisan: artisan
artist: artist,artists
ascertain: ascertain,ascertained,ascertaining
ascetic: ascetic,ascetics
ascii: ascii
ash: ashes
asia: asia
asiatic: asiatic
asleep: asleep
asoka: asoka
asparagus: asparagus
aspiration: aspirations
ass: ass
assemblage: assemblage
assembly: assemblies,assembly
assert: asserts
assiduity: assiduity
assist: assist,assisted,assisting
assistance: assistance
associate: associate,associates
association: association
assume: assumed
assure: assuring
assuredly: assuredly
astrologer: astrologer,astrologers
astrology: astrology
attach: attach,attached,attaching
attached: attached
attachment: attachment
attain: attain,attained,attaining
attainment: attainment,attainments
attempt: attempt,attempted,attempts
attend: attend,attended,attending
attendant: attendant,attendants
attention: attention,attentions
attentive: attentive
attentively: attentively
attire: attire
attract: attract,attracting,attracts
attractive: attractive
attractiveness: attractiveness
attribute: attributes
aud: aud
aunt: aunt
auspicious: auspicious
author: author,authors
authorise: authorised
authority: authority
authorize: authorized
avanti: avanti
avarice: avarice
avaricious: avaricious
aversion: aversion
avert: averted,averting
avoid: avoid,avoided,avoiding,avoids
await: await
awake: awakes
awaken: awaken,awakens
aware: aware
bad: bad,worst
badly: badly
baking: baking
bald: bald
bali: bali
ball: ball,balls
balmy: balmy
bamboo: bamboo,bamboos
banish: banished
bank: bank
banyan: banyan
barbarous: barbarous
barber: barbers
bare: bare
bark: bark,barks
barley: barley
barren: barren
base: base,based
bashful: bashful
bashfulness: bashfulness
basis: basis
basket: basket
batch: batch
bath: bathed
bathe: bathe
bathing: bathing
bawd: bawd
bead: bead,beads
bean: beans
bear: bear,bearing,bears,born
bearer: bearer
beast: beast,beasts
beautiful: beautiful
beautify: beautifying
beauty: beauty
becomingly: becomingly
bed: bed,beds
bee: bee
beet: beet
befall: befall
befitting: befitting
beg: begs
beggar: beggar,beggars
behave: behave,behaved,behaves,behaving
behaviour: behaviour
belief: belief
bell: bell
belong: belong,belonging,belongs
belongings: belongings
beloved: beloved
bend: bend,bends,bent
benefactor: benefactors
beneficial: beneficial
benefit: benefit
bent: bent
bestow: bestow,bestowed
betel: betel
betroth: betrothed
betrothal: betrothal
bhima: bhima
bignonia: bignonia
binary: binary
bind: binding,bound
binding: binding
bird: bird,birds
birth: birth
bite: bite,bites,biting,bitten
biting: biting
bitter: bitter
black: black
blame: blame
bleach: bleaching
blemish: blemishes
blessing: blessings
blind: blind,blinded
blood: blood
bloom: blooming
blow: blow,blows
blue: blue
blunt: blunt
boar: boar
board: board
boat: boat
bodiless: bodiless
bodily: bodily
body: bodies,body
boil: boiled,boiling
boldly: boldly
boldness: boldness
bombay: bombay
bone: bone,bones
book: book,books
border: bordering
borrow: borrowed
bosom: bosom
boss: bosses
bottle: bottle
bouquet: bouquet,bouquets
bow: bow
bower: bower
box: box
boy: boy
bracelet: bracelet
brahman: brahman
brahmans: brahmans
braid: braiding
branch: branch,branches
bras: bras
brave: brave
breach: breach
break: break,broken
breakfast: breakfast
breast: breast,breasts
breath: breath
breed: bred
bribe: bribe
bridegroom: bridegroom
bright: bright
brightness: brightness
bring: bring,bringing,brings,brought
bristle: bristles
british: british
broad: broad
broken: broken
brother: brother,brothers
bruce: bruce
brutality: brutality
brute: brute
bud: bud
buff: buff
buffalo: buffalo
buffoon: buffoon
build: building,built
building: building
bulb: bulbs
bull: bull
bully: bullied
bunch: bunch,bunches
burden: burden
burn: burn,burning,burnt
burst: burst
burton: burton
bury: buried
bush: bush
busily: busily
business: business
butter: butter
buttock: buttocks
bye: bye
cadamba: cadamba
cage: cages
calamity: calamities
calculate: calculate,calculated
calcutta: calcutta
calf: calf
camel: camel
cane: cane
canopy: canopy
capable: capable
capital: capital
captain: captain
captive: captive
card: card,cards
care: care
careful: careful
carefully: carefully
careless: careless
carelessness: carelessness
caress: caressing
carnal: carnal
carpenter: carpenter
carpentry: carpentry
carpet: carpets
carriage: carriages
carrier: carrier
carry: carried,carries,carry,carrying
cart: cart
carve: carving
cassia: cassia
cast: casting
caste: caste,castes
cat: cat
catalogue: catalogue
cataphracta: cataphracta
cattle: cattle
caution: caution
cavalry: cavalry
cave: cave,caves
cavity: cavities
ce: ce
cease: cease,ceases
celebrate: celebrated,celebrating
celebrity: celebrity
censurable: censurable
censure: censure,censured,censuring
central: central
century: centuries,century
ceremony: ceremonies,ceremony
certainty: certainty
certificate: certificate
chafe: chafed
chaff: chaff,chaffing,chaffs
chaitra: chaitra
chance: chance,chances
change: change,changed,changing
chant: chanting
chaplet: chaplets
chapter: chapter,chapters
character: character,characters
characteristic: characteristic,characteristics
charge: charge,charges,charging
charitable: charitable
charity: charities
charm: charms
charming: charming
chaste: chaste
chastity: chastity
cheap: cheap
check: check,checks
cheek: cheek,cheeks
cheerful: cheerful
chemistry: chemistry
cherish: cherish
chide: chide
chief: chief
chiefly: chiefly
child: child,children
childhood: childhood
childless: childless
childlike: childlike
chin: chin
china: china
choice: choice
choose: choose,chosen
christian: christian,christians
churn: churning
circle: circle
circulation: circulation
circumstance: circumstance,circumstances
cistern: cisterns
citizen: citizen,citizens
citron: citron
city: cities,city
civil: civil
claim: claim,claims
claimant: claimants
clapping: clapping
clarify: clarified
clash: clash
clasping: clasping
class: class,classes
classify: classified
claw: claw
clay: clay
clean: clean,cleaned,cleaning
clever: clever
cleverness: cleverness
climb: climb,climbing
climbing: climbing
cling: clinging
clitoria: clitoria
close: close,closed,closes
closed: closed
closely: closely
cloth: cloth,cloths
clothe: clothed
clothes: clothes
cloud: cloud
clump: clumps
cluster: clusters
coarse: coarse
cock: cock,cocks
cocoa: cocoa
code: codes
cohabitation: cohabitation
coin: coin,coins
coition: coition
cold: cold
collate: collated
collect: collected,collecting
collection: collection
collyrium: collyrium,collyriums
colour: colour,coloured,colouring,colours
colouring: colouring
combination: combination,combinations
combine: combined,combining
comedy: comedy
command: command,commands
commandment: commandment,commandments
commence: commence,commenced
commencement: commencement
commend: commended
commendation: commendation
comment: comments
commentary: commentaries,commentary
commentator: commentator
commerce: commerce
commercial: commercial
commit: commit,committed,committing
commodity: commodities
common: common
companion: companion,companions
company: company
compare: compared,comparing
compartment: compartments
compassion: compassion
compassionate: compassionate
compatriot: compatriot
compilation: compilation
compile: compiled
complete: complete,completes,completing
completely: completely
completion: completion
complexion: complexion
compliance: compliance
compliment: compliments
comply: complied,comply,complying
compose: composed,composing
composition: composition
comprehension: comprehension
compress: compressed
conceal: conceal,concealed,concealing
conceit: conceit,conceited
concentrated: concentrated
concept: concept
concerned: concerned
concert: concert
conch: conch
conciliate: conciliate
conciliation: conciliation
conciliatory: conciliatory
concise: concise
conclude: concluding
conclusion: conclusion
concoct: concocted
concoction: concoctions
concubine: concubine,concubines
condition: condition,conditions
condoling: condoling
conduce: conduces
conducive: conducive
conduct: conduct,conducts
confer: conferred
confidant: confidant,confidants
confidante: confidante
confide: confide,confided,confides,confiding
confidence: confidence,confidences
confidential: confidential
confine: confine,confined
confirm: confirmed
confirmation: confirmation
conformation: conformation
conformity: conformity
confusion: confusion
congress: congress
connect: connected
connected: connected
connection: connection,connections
connivance: connivance
conquer: conquered,conquers
conquest: conquest
consciousness: consciousness
consent: consent,consents
consequence: consequence
consequential: consequential
considerable: considerable
consideration: consideration,considerations
consist: consist,consisted,consisting,consists
consistency: consistency
consistent: consistent
consonant: consonants
consort: consorts
constancy: constancy
constant: constant
constantly: constantly
construct: constructing
consult: consulted
consummation: consummation
consumptive: consumptive
contact: contact
contemplation: contemplation
contemplatively: contemplatively
contempt: contempt
contents: contents
continual: continual
continually: continually
continuation: continuation
continue: continue,continued,continues,continuing
continued: continued
contract: contract,contracted,contracting
contraction: contraction
contradict: contradict,contradicting
contrariety: contrarieties
contrary: contrary
contribution: contributions
control: control
convene: convened
conversant: conversant
conversation: conversation,conversations
converse: converse,conversed,converses,conversing
convert: convert
convex: convex
coo: cooing
cooing: cooing
cook: cooking
cookery: cookery
cooking: cooking
cool: cool
copper: copper
copying: copying
copyright: copyright
coral: coral
cord: cords
cordially: cordially
corn: corn
corner: corners
corporation: corporation
corpse: corpse
correct: correct,corrected,correcting
correspond: correspond
corrupt: corrupt,corrupted
cost: cost,costs
cot: cot
cotton: cotton
couch: couch,couches
couche: couche
council: council
country: countries,country
couple: couple
court: court,courts
courteous: courteous
courtesan: courtesan,courtesans
courtesans: courtesans
courtezan: courtezan
courtship: courtship
cover: cover,covered,covering
covering: covering
covert: covert
covet: covet
covetous: covetous
covetousness: covetousness
cow: cow,cows
cowardly: cowardly
cowherd: cowherds
crab: crab
create: create,created,creating
creation: creation
credit: credit
creditor: creditor
creep: crept
creeper: creeper,creepers
crest: crests
crime: crime,crimes
critical: critical
crooked: crooked
crop: crops
cross: cross
crow: crow,crows
cruel: cruel
cuckoo: cuckoo,cuckoos
cucumber: cucumber
culinary: culinary
cunning: cunning
cup: cup
cupid: cupid
curiosity: curiosities,curiosity
curious: curious
current: current
curse: cursed
curtain: curtain
curved: curved
cushion: cushions
custom: custom,customs
customary: customary
customer: customers
cut: cut,cuts
cypher: cypher
daily: daily
damage: damage
damaged: damaged
damages: damages
damsel: damsel
dance: dance,dancing
dancing: dancing
danger: danger
dangerous: dangerous
dark: dark
darkness: darkness
datum: data
daughter: daughter,daughters
day: day,days
dead: dead
deal: deal,dealing,dealt
dealings: dealings
death: death
debt: debt,debts
deceased: deceased
deceitful: deceitful
deceive: deceived
decency: decency
decide: decides
declare: declare,declaring
decorate: decorate,decorated,decorates,decorating
decoration: decorations
dedicate: dedicated
deductible: deductible
deed: deeds
deer: deer
defeat: defeat
defect: defect,defects
defective: defective
deference: deference
define: defined
definite: definite
definition: definition
deform: deformed
degree: degree,degrees
deity: deities,deity
dejected: dejected
dejection: dejection
delay: delaying
deletion: deletions
delhi: delhi
delicacy: delicacy
delicate: delicate
delight: delight,delights
delighted: delighted
delire: delire
deliverance: deliverance
demand: demand
demeanour: demeanour
demon: demon
demonstrative: demonstrative
denote: denoted
denounce: denounce
deny: deny
depend: depend,depending,depends
dependant: dependant
dependent: dependent
deposit: deposit
depress: depressed
deprive: deprive,deprived
depth: depth
deride: deride
derivative: derivative
derive: derive,derived,deriving
des: des
descendant: descendant
description: description,descriptions
deserve: deserve
deserving: deserving
design: design,designed,designs
desirable: desirable
desire: desire,desired,desires,desiring
desirous: desirous
despair: despair
despise: despise,despised
despondency: despondency
destine: destined
destiny: destiny
destitute: destitute
destroy: destroy,destroyed,destroying
destruction: destruction
detach: detach
detailed: detailed
detect: detect
determination: determination
determine: determine,determining
device: device,devices
devilry: devilry
devoid: devoid
devote: devoted
devoted: devoted
devotee: devotee
devotion: devotion
dharma: dharma
diagram: diagrams
dialect: dialects
dice: dice
dictate: dictates
dictionary: dictionaries
die: die,died
difference: difference
difficult: difficult
difficulty: difficulties,difficulty
dig: dug
digestive: digestive
dignity: dignity
dimension: dimensions
dimensions: dimensions
diminish: diminished
dine: dine
dip: dipped,dips
dire: dire
direct: direct,directed,directing
direction: direction
director: director
disaffected: disaffected
disaffection: disaffection
disagreeable: disagreeable
disappear: disappeared
disaster: disaster,disasters
disbelieve: disbelieved
disclaim: disclaim
disclaimer: disclaimer,disclaimers
discontinuance: discontinuance
discontinue: discontinue
discourage: discouraged
discourse: discourse
discoursing: discoursing
discover: discover,discovered
discovery: discovery
discredit: discredit
discuss: discuss
discussion: discussions
disease: disease,diseases
disfigured: disfigured
disgraceful: disgraceful
disguise: disguise,disguised,disguising
disgust: disgust
disillusion: disillusion
disinterested: disinterested
disk: disk
dislike: dislike,disliked,dislikes
dismiss: dismiss,dismissed,dismissing
disobey: disobey,disobeys
disparage: disparage
disparagement: disparagement
dispel: dispel
display: display,displayed,displaying
displease: displease,displeased
displeased: displeased
displeasure: displeasure
disposition: disposition,dispositions
dispute: dispute,disputes,disputing
disregard: disregard,disregarded,disregards
disrespect: disrespect
dissatisfaction: dissatisfaction
dissatisfied: dissatisfied
dissertation: dissertation
dissipate: dissipated
dissuade: dissuading
distance: distance
distant: distant
distil: distilled
distinction: distinction
distinctly: distinctly
distinguish: distinguished
distinguished: distinguished
distinguishing: distinguishing
distress: distress
distressed: distressed
distressing: distressing
distribute: distribute,distributed,distributing
distribution: distribution
distributor: distributor
district: districts
distrust: distrust
disturb: disturbed,disturbing
ditch: ditches
dive: dive
diversion: diversions
diversions: diversions
divert: diverting,diverts
divide: divide,divided
divine: divine
division: divisions
doctor: doctor
doctrine: doctrine,doctrines
dog: dog,dogs
doings: doings
doll: dolls
domain: domain
domestic: domestic
donate: donate
donation: donation,donations
donor: donors
door: door,doors
doorway: doorway
double: double,doubled
doubly: doubly
doubt: doubt,doubts
doubtless: doubtless
dough: dough
dove: dove
download: downloading
drama: drama
dramas: dramas
dramatic: dramatic
dravida: dravida
draw: draw,drawing,draws
drawing: drawing
dream: dream,dreams
dress: dress,dressed,dresses,dressing
dressed: dressed
drink: drink,drinking,drinks
drinking: drinking
drive: driven
driver: drivers
drug: drugs
druggist: druggists
drunk: drunk
dry: dries
duck: duck
dullness: dullness
dust: dust
duty: duties,duty
dwarfish: dwarfish
dweller: dweller
dye: dyed
dyeing: dyeing
dyer: dyer
dynasty: dynasty
eager: eager
ear: ear,ears
earnest: earnest
earring: earrings
earth: earth
earthquake: earthquakes
ease: ease
easily: easily
east: east
eastern: eastern
easy: easier,easy
eat: eat,eaten,eating,eats
eating: eating
edict: edicts
edification: edification
edition: edition,editions
educate: educated
education: education
educational: educational
edward: edward
effort: effort,efforts
efforts: efforts
egg: egg,eggs
egress: egress
eighteen: eighteen
eighteenth: eighteenth
eighth: eighth
eld: elder,eldest
elder: elder,elders
elect: elect
electronic: electronic
electronically: electronically
elegant: elegant
elegy: elegy
element: element,elements
elementary: elementary
elephant: elephant,elephants
elicit: elicited
eloquence: eloquence
eloquent: eloquent
emaciation: emaciation
email: email
embellish: embellishing
embrace: embrace,embraced,embraces,embracing
embryo: embryo
emissary: emissaries
emission: emission
emit: emit,emits
employ: employ,employed,employing
employee: employee,employees
employment: employment
emulation: emulation
en: en
enable: enable,enabled,enabling
enchant: enchanted
encircle: encircled
enclosure: enclosures
encode: encoding
encounter: encounter
encourage: encourage
encouragement: encouragement
endear: endear
endeavour: endeavour,endeavouring
endow: endow,endowed
enemy: enemies,enemy
energetic: energetic
engage: engage,engaged,engages,engaging
england: england
english: english
enigma: enigmas
enigmatical: enigmatical
enjoin: enjoined
enjoy: enjoy,enjoyed,enjoying,enjoys
enjoyment: enjoyment,enjoyments
enlarge: enlarge,enlarging
enlargement: enlargement
enlighten: enlightened
enmity: enmity
ensure: ensuring
enter: enter,entered,entering,enters
enterprising: enterprising
entertain: entertain,entertained,entertaining
entertaining: entertaining
entire: entire
entity: entity
entrance: entrance
entreaty: entreaties,entreaty
enumeration: enumeration
envy: envy
epic: epic
epidermis: epidermis
equal: equal,equals
equally: equally
equipage: equipages
equipment: equipment
era: era
erect: erect
erotic: erotic
erring: erring
error: errors
eruption: eruptions
esprit: esprit
essence: essence
establish: establish
esteem: esteem
eternal: eternal
eugenia: eugenia
eulogy: eulogy
eunuch: eunuch,eunuchs
euphorbia: euphorbia
europe: europe
evening: evening
event: event,events
eventually: eventually
evidence: evidence
evident: evident
evidently: evidently
evil: evil
exact: exact
exaggeration: exaggeration
examination: examination
examine: examine,examined
exceed: exceeds
exceedingly: exceedingly
excellence: excellence,excellences
excellency: excellencies
excellent: excellent
exception: exception,exceptions
excess: excess
excessive: excessive
excessively: excessively
exchange: exchange,exchanged
excite: excite
excited: excited
excitement: excitement
exciting: exciting
exclusion: exclusion
excommunicate: excommunicated
excrement: excrement
excuse: excuse
executive: executive
exemplify: exemplified
exempt: exempt
exercise: exercises,exercising
exert: exert
exertion: exertion
exhausted: exhausted
exhibit: exhibits
exhibition: exhibitions
exist: exist,existing,exists
existence: existence
exit: exit
expect: expect,expected
expend: expend
expenditure: expenditure
expense: expense,expenses
experience: experience,experienced,experiences
experienced: experienced
experiment: experiments
experimental: experimental
explain: explain,explained,explaining
explanation: explanation,explanations
export: exporting
expose: exposed,exposing
expound: expounded
express: express,expressed,expresses,expressing
expression: expression,expressions
expressive: expressive
expulsion: expulsion
extant: extant
extent: extent
external: external
extol: extol,extolling
extort: extorting
extra: extra
extract: extract,extracted,extracts
extremely: extremely
eye: eye,eyes
eyebrow: eyebrows
eyelid: eyelids
facility: facilities,facility
fail: fail,failed,failing,fails
failure: failure
faint: faint,fainting
fair: fair,fairs
fairbanks: fairbanks
faith: faith
faithful: faithful
fall: fall,fallen,falling,falls,fell
falls: falls
false: false
falsehood: falsehoods
fame: fame
familiar: familiar
familiarity: familiarity
familiarly: familiarly
family: families,family
famine: famines
famous: famous
fascinating: fascinating
fascination: fascination
fashion: fashion
fast: fasts
fat: fat
fatal: fatal
father: father
fatigue: fatigue,fatiguing
fatigued: fatigued
fault: fault,faults
faut: faut
favour: favour,favours
favourable: favourable
favourably: favourably
favourite: favourite
fawn: fawn
fear: fear,fears
feast: feasts
feature: features
federal: federal
fee: fee,fees
feed: fed
feel: feel,feeling,feels
feeling: feeling,feelings
fellow: fellow,fellows
female: female,females
feminine: feminine
femme: femme
fennel: fennel
ferment: ferments
festival: festival,festivals
festivals: festivals
festive: festive
festivity: festivities
fibre: fibres
fickle: fickle
fickleness: fickleness
fiction: fiction
fictitious: fictitious
field: fields
fifteenth: fifteenth
fig: fig
fight: fight,fights
fighting: fighting
figure: figure,figures
file: file,files
filter: filtered
finally: finally
financial: financial
fine: fine
finger: finger,fingers
finish: finished,finishes
firewood: firewood
firm: firm
fist: fist
fistula: fistula
fit: fit,fitted,fitting
fitness: fitness
fitting: fitting
fixed: fixed
fixing: fixing
flacourtia: flacourtia
flagellation: flagellation
flamingo: flamingo
flattery: flattery
flavour: flavour
flax: flax
flesh: flesh
flight: flight
flock: flocks
floor: floor
florist: florists
flour: flour
flow: flow,flows
flower: flower,flowers
flowing: flowing
fluid: fluid
fold: folded,folds
foliage: foliage
follow: follow
follower: follower,followers
folly: folly
fond: fond
fondle: fondle
fondness: fondness
food: food
foolish: foolish
foot: feet,foot
footnote: footnote,footnotes
footstep: footsteps
force: force,forced
forcible: forcible
forcibly: forcibly
fore: fore
forehead: forehead,foreheads
foreign: foreign
forenoon: forenoon
forest: forest,forests
forfeit: forfeit
forget: forgets
form: form,formed,forming,forms
format: format,formats
fortunate: fortunate
fortune: fortune
foster: foster
foul: foul
foundation: foundation
fourth: fourth
fragrance: fragrance
fragrant: fragrant
frame: framed,framing
france: france
freedom: freedom
freely: freely
french: french
frequent: frequent,frequented
frequently: frequently
fresh: fresh
friction: friction
friend: friend,friends
friendliness: friendliness
friendly: friendly
friendship: friendship,friendships
frighten: frighten,frightened
fruit: fruit,fruits
fulfil: fulfil,fulfilled,fulfils
fumigation: fumigation
funeral: funerals
furnish: furnish
furniture: furniture
future: future
gain: gain,gained,gaining,gains
gait: gait
gallantry: gallantry
gambling: gambling
game: game,games
ganda: ganda
gandharva: gandharva
gange: ganges
garden: garden,gardens
gardening: gardening
gardens: gardens
garland: garland,garlands
garlic: garlic
garment: garment,garments
gather: gather,gathered
gathering: gathering,gatherings
gatherings: gatherings
gem: gems
generality: generality
generate: generate
generation: generations
generosity: generosity
generous: generous
genius: genius
gently: gently
gesticulation: gesticulations
gesture: gesture,gestures
ghee: ghee
gift: gift,gifts
gilt: gilt
girdle: girdle
girl: girl,girls
glance: glance,glances
glandular: glandular
glass: glass,glasses
glean: glean
globe: globe
globule: globules
glossy: glossy
goad: goad
goal: goals
goat: goat,goats
god: god,gods
goddess: goddess,goddesses
gods: gods
gold: gold
golden: golden
goldsmith: goldsmith
goose: goose
gourd: gourd,gourds
gouter: gouter
govern: govern,governed
grace: grace
graceful: graceful
gracefully: gracefully
gradually: gradually
grain: grain
grammar: grammar
granary: granaries
grant: granted
grape: grapes
grass: grass
grat: grat
grateful: grateful
gratefully: gratefully
gratification: gratification
gratify: gratify
greatly: greatly
greatness: greatness
greek: greek,greeks
green: green
gregory: gregory
grey: grey
grind: ground
gross: gross
ground: ground
groundless: groundless
grounds: grounds
grove: groves
grow: grow,grown,grows
grudge: grudge
gruel: gruel
guard: guard,guarded,guarding,guards
guardian: guardian
guidance: guidance
guide: guide,guided,guiding
guitar: guitars
gum: gums
guyot: guyot
guzerat: guzerat
gymnastic: gymnastic
gymnastics: gymnastics
habit: habit,habits
habituate: habituated
hair: hair
halo: halo
hand: hand,hands
handle: handled
handsome: handsome
hang: hang,hanging,hangs
happen: happen,happened
happiness: happiness
happy: happy
hard: hard
harden: hardening
hare: hare
harem: harem,harems
harm: harm
harmless: harmless
harmonize: harmonize
harmony: harmony
harp: harp
harsh: harsh
harshly: harshly
hart: hart
hasten: hastening
hate: hate,hated,hates,hating
hater: hater,haters
hatred: hatred
haughty: haughty
hawk: hawks
head: head,heads
health: health
healthy: healthy
heap: heaps
hear: hear,heard,hearing,hears
hearing: hearing
hearsay: hearsay
heart: heart,hearts
hearted: hearted
heat: heat
heavenly: heavenly
hedge: hedge
hedysarum: hedysarum
heir: heir
hemp: hemp
herbal: herbal
herd: herd,herds
hereditary: hereditary
hermit: hermit
hero: hero
heroine: heroine
heron: heron
hesitation: hesitation
hidden: hidden
hide: hide,hides,hiding
highly: highly
hin: hin
hindi: hindi
hindoo: hindoo
hindu: hindu
hindus: hindus
hindustan: hindustan
hint: hints
hip: hips
hiss: hissing
history: history
hog: hog
hold: held,hold,holding,holds
holder: holder
holding: holding
hole: hole
holiday: holidays
holy: holy
homage: homage
hommage: hommage
honest: honest
honey: honey
honour: honour,honoured,honouring
hope: hope,hopes
horn: horn
horse: horse,horses
horseback: horseback
hospitality: hospitality
hostile: hostile
hour: hours
house: house,houses
household: household
householder: householder
hover: hover
human: human
humanities: humanities
humanity: humanity
humble: humble
humpbacked: humpbacked
hunger: hunger
hunting: hunting
hurry: hurry
hurt: hurt
husband: husband,husbands
hyena: hyena
hymn: hymn
ichneumon: ichneumon
idea: idea,ideas
identical: identical
identification: identification
identify: identified,identify
idle: idle
idol: idol
ignorance: ignorance
ignorant: ignorant
ignore: ignore
iii: iii
illness: illness
illustrious: illustrious
image: image,images
imaginable: imaginable
imagination: imagination
imitate: imitate,imitated,imitating
imitation: imitation
immoderate: immoderate
immoral: immoral
immorality: immorality
immortal: immortal,immortals
immortality: immortality
impel: impelled
imperfection: imperfections
impetuosity: impetuosity
impetuous: impetuous
implicitly: implicitly
imply: implied
import: import
importune: importuned
impose: imposed
impossible: impossible
impracticable: impracticable
impress: impress,impressed
impressed: impressed
imprison: imprison
improper: improper
impure: impure
impurity: impurity
inability: inability
inaccessibility: inaccessibility
inaccurate: inaccurate
inarticulately: inarticulately
inauspicious: inauspicious
incantation: incantations
incarnation: incarnation
incense: incense
incidental: incidental
inclination: inclination,inclinations
inclined: inclined
include: include,included,includes,including
including: including
income: income
incomplete: incomplete
incomprehensible: incomprehensible
inconsistent: inconsistent
incontinence: incontinence
incorrect: incorrect
increase: increase,increased,increases,increasing
incur: incur,incurred,incurring
incurable: incurable
indecision: indecision
indemnify: indemnify
indemnity: indemnity
independent: independent
india: india
indian: indian
indifference: indifference
indifferent: indifferent
indifferently: indifferently
indirect: indirect
indirectly: indirectly
indiscretion: indiscretion
indiscriminately: indiscriminately
indistinct: indistinct
indistinctly: indistinctly
individual: individual,individuals
individually: individually
indra: indra
induce: induce,induced
indulgence: indulgence
indus: indus
infancy: infancy
infant: infant
inference: inference,inferences
inferior: inferior,inferiors
inferring: inferring
infidelity: infidelity
inflame: inflame
inflict: inflicted
influence: influence,influences
inform: inform,informed,informing,informs
infringement: infringement
ingenious: ingenious
ingenuity: ingenuity
ingratitude: ingratitude
ingredient: ingredient
ingress: ingress
inhabitant: inhabitant,inhabitants
inherit: inherited,inheriting
inheritance: inheritance
initial: initial
injure: injure,injuring
injurious: injurious
injury: injury
ink: ink
inkling: inkling
inlay: inlaid
innocent: innocent
innumerable: innumerable
insect: insects
insist: insisted
instance: instance,instances
instigate: instigate
instinct: instincts
instruct: instructs
instructor: instructor
instrument: instrument,instruments
instrumental: instrumental
intellect: intellect
intellectual: intellectual
intelligence: intelligence
intelligent: intelligent
intend: intended,intends
intense: intense
intensely: intensely
intensity: intensity
intent: intent
intention: intention,intentions
intentionally: intentionally
interchange: interchange
intercourse: intercourse
interference: interference
interior: interior
intermingle: intermingled
internal: internal
internally: internally
international: international
interpret: interpreted
interrupt: interrupting
interval: intervals
interview: interview,interviewed
intimacy: intimacy
intimate: intimate,intimated
intimately: intimately
intone: intoning
intoxicate: intoxicated
intoxicated: intoxicated
intoxicating: intoxicating
intoxication: intoxication
intrigue: intrigue,intrigues
introduce: introduced
introduction: introduction
introductory: introductory
intuitive: intuitive
invalidity: invalidity
invariably: invariably
invasion: invasions
inventress: inventress
inverted: inverted
invest: invested
invisibility: invisibility
invisible: invisible
invitation: invitations
invite: invite,invited
involve: involve
iron: iron
irregular: irregular
irregularity: irregularities
irregularly: irregularly
irremediable: irremediable
irrespective: irrespective
irs: irs
iso: iso
issue: issued
italicize: italicized
iv: iv
ivory: ivory
ix: ix
jambolana: jambolana
january: january
jasmine: jasmine
jay: jay
jealous: jealous
jealousy: jealousy
jest: jest
jester: jester,jesters
jesting: jesting
jestingly: jestingly
jewel: jewel,jewels
jeweller: jeweller
jewellery: jewellery
jocularly: jocularly
joint: joints
joke: joke,joking
jon: jon
jones: jones
journey: journey
joy: joy,joys
judge: judged
jugglery: jugglery
juice: juice,juices
jujube: jujube
jules: jules
jump: jump
justice: justice
kama: kama
keeper: keepers
keeping: keeping
kick: kicked,kicks
kill: kill,killed
kindle: kindles,kindling
kindly: kindly
kindness: kindness
kinds: kinds
king: king,kings
kingdom: kingdom
kinsman: kinsmen
kiss: kiss,kissed,kisses,kissing
kissing: kissing
kitchen: kitchen
kite: kite
kneel: kneeling
knob: knobs
knot: knot,knots
knowledge: knowledge
kokila: kokila
kusha: kusha
labour: labour,labours
lac: lac
laden: laden
lady: ladies,lady
lake: lake
lament: lamenting
lamp: lamp
land: land
language: language,languages
lap: lap
lascivious: lascivious
lash: lashes
lastly: lastly
lat: lat
late: late
lathering: lathering
latin: latin
laugh: laugh,laughing
laughter: laughter
law: law,laws
lawful: lawful
laws: laws
lay: laid,lay,lays
lazy: lazy
le: le
lead: lead,leading,leads
leader: leader
leaf: leaf,leaves
league: league
lean: leaning
learn: learn,learned,learning,learnt
learning: learning
leave: leave,leaved,leaves,leaving,left
left: left
leg: legs
legal: legal
legally: legally
legerdemain: legerdemain
lemonade: lemonades
leper: leper
lessen: lessened
letter: letter,letters
levity: levity
liability: liability
liable: liable
liaison: liaison
liberal: liberal
liberality: liberality
liberation: liberation
library: libraries,library
license: license
licensed: licensed
lie: lie,lies,lying
lieu: lieu
life: life,lives
lifetime: lifetime
lift: lifts
light: light,lighted
lightly: lightly
likelihood: likelihood
likeness: likeness
liking: liking,likings
lily: lily
limb: limbs
limit: limited,limiting
limitation: limitation
limited: limited
lingam: lingam
link: linked,links
lion: lions
lip: lip,lips
liquor: liquor,liquors
liquorice: liquorice
list: list,listed
listen: listen,listening,listens
literary: literary
literature: literature
live: live,lived,lives,living
livelihood: livelihood
living: living
lobe: lobes
local: local
locality: localities
locate: located
location: locations
lock: lock
loin: loins
loiter: loiter
london: london
lonely: lonely
loose: loose
loosely: loosely
loosen: loosen
loquacious: loquacious
lord: lord,lords
lose: lose,loses,losing,lost
loss: loss,losses
lot: lot
lotion: lotion
lottery: lottery
lotus: lotus,lotuses
loud: loud
loudly: loudly
love: love,loved,loves,loving
loveliness: loveliness
lovely: lovely
lover: lover,lovers
loving: loving
lovingly: lovingly
lucky: lucky
lunatic: lunatic
lust: lust
lusty: lusty
lute: lute
machine: machine,machines
mad: mad
madness: madness
magic: magic
magical: magical
magnificent: magnificent
maid: maid,maids
maiden: maiden
main: main
maintain: maintaining
maintenance: maintenance
majority: majority
maker: maker
male: male,males
malignity: malignity
malwa: malwa
manage: manage,manages
mane: manes
manes: manes
mango: mango
manhood: manhood
manifest: manifest,manifested,manifesting,manifests
manifestation: manifestation,manifestations
manipulate: manipulate,manipulated
manipulation: manipulations
mankind: mankind
manner: manner
manners: manners
manual: manual
manuscript: manuscript
mare: mare
mark: mark,marked,marking,marks
market: market,markets
marriage: marriage,marriages
marriageable: marriageable
married: married
marry: married,marry,marrying
marrying: marrying
mass: masses
master: master,mastered,masters
mastery: mastery
material: materials
materialist: materialists
materialistic: materialistic
matrimony: matrimony
matron: matron
matter: matter,matters
maturely: maturely
maux: maux
maximum: maximum
meal: meals
meaning: meaning,meanings
meanness: meanness
meat: meat
mechanical: mechanical
medicinal: medicinal
medicine: medicine,medicines
mediocre: mediocre
medium: medium
meet: meet,meeting,meets,met
meeting: meeting,meetings
melancholy: melancholy
mendicant: mendicants
menial: menial
mental: mental
mention: mention,mentioned,mentioning,mentions
mercantile: mercantile
merchandise: merchandise
merchant: merchants
mercury: mercury
mere: mere
merit: merit,merits
meritorious: meritorious
message: message,messages
messenger: messenger,messengers
messengers: messengers
metal: metal
method: method,methods
michael: michael
midday: midday
middle: middle
middling: middling
mighty: mighty
milk: milk,milking
milky: milky
mimicry: mimicry
mind: mind,minds
minded: minded
mineralogy: mineralogy
minerva: minerva
minister: minister,ministers
minor: minor
minstrel: minstrels
minute: minute
mirror: mirror
mirth: mirth
mis: mis
miscarriage: miscarriage
miscellaneous: miscellaneous
miscellany: miscellany
misconduct: misconduct
miser: miser
miserable: miserable
misfortune: misfortune,misfortunes
mission: mission
mississippi: mississippi
mistake: mistake
mistress: mistress
mix: mix,mixed,mixes,mixing
mixed: mixed
mixture: mixture
mode: mode,modes
moderate: moderate
moderately: moderately
moderation: moderation
modern: modern
modesty: modesty
modification: modification
modify: modified
moisten: moistened,moistening
moksha: moksha
moment: moment
mon: mon
money: money
monier: monier
monkey: monkey,monkeys
monogamous: monogamous
monogamy: monogamy
month: month,months
monthly: monthly
moon: moon,moons
moonlight: moonlight
moor: moor
morality: morality
morning: morning
morrow: morrow
mortar: mortar
mother: mother,mothers
motion: motion,motions
motionless: motionless
mots: mots
mount: mounts
mounting: mounting
mouse: mouse
moustache: moustache
mouth: mouth,mouths
movement: movement,movements
mover: mover
mull: mull
multiply: multiplied,multiply
music: music
musical: musical
mustard: mustard
mute: mute
mutual: mutual
mutually: mutually
mysterious: mysterious
mystical: mystical
nagara: nagara
nail: nail,nails
naked: naked
nandi: nandi
narrate: narrates
narrative: narratives
narrow: narrowing
nation: nation
native: native
natural: natural
naturally: naturally
nature: nature,natures
navel: navel
neat: neat
neck: neck
necklace: necklaces
nectar: nectar
neglect: neglect,neglecting,neglects
negligence: negligence
negotiation: negotiations
neighbour: neighbour,neighbouring,neighbours
neighbourhood: neighbourhood
nervous: nervous
network: network
newly: newly
news: news
newsletter: newsletter
niggardly: niggardly
night: night,nights
nihilists: nihilists
nipple: nipple
noble: noble
nod: nod
noise: noise
nominal: nominal
nonproprietary: nonproprietary
noon: noon
noonday: noonday
north: north
northern: northern
nose: nose
nostril: nostril
note: note
notice: notice,noticed
notify: notifies
notorious: notorious
nourish: nourishing
novelist: novelists
novelty: novelty
numerous: numerous
nurse: nurse,nurses
nut: nut,nuts
oath: oaths
obedience: obedience
obedient: obedient
obey: obey,obeyed,obeys
object: object,objected,objects
objection: objection
oblation: oblation,oblations
obligation: obligation
oblige: obliged,obliging
observance: observance
observation: observation,observations
observations: observations
observe: observe,observed,observing
obsolete: obsolete
obstacle: obstacles
obstinacy: obstinacy
obstruct: obstructing
obstruction: obstruction
occasion: occasion,occasions
occasional: occasional
occasionally: occasionally
occult: occult
occupation: occupation
occupy: occupied,occupies
occur: occur
occurrence: occurrence,occurrences
ocean: ocean
odd: odd
odour: odours
offer: offer,offered,offering,offers
offering: offering,offerings
office: office
officer: officer,officers
official: official
offspring: offspring
oil: oil
oils: oils
ointment: ointment,ointments
olden: olden
omen: omen,omens
oneself: oneself
onion: onion
online: online
openly: openly
opinion: opinion,opinions
opportunity: opportunities,opportunity
oppose: oppose,opposed,opposing
oppress: oppressed
optionally: optionally
orb: orbs
ordain: ordains
ordinance: ordinances
ordinarily: ordinarily
ordinary: ordinary
organ: organ,organs
organize: organized
oriental: oriental
orifice: orifice
original: original
originally: originally
originator: originator
ornament: ornament,ornamented,ornaments
ornamental: ornamental
orphan: orphan
outdated: outdated
outer: outer
outward: outward
outwardly: outwardly
oval: oval
overcome: overcome,overcoming
overhear: overhear
overlook: overlook
overture: overtures
overwhelm: overwhelm
ovid: ovid
owe: owed
owner: owner
pacify: pacify
packed: packed
padding: padding
pain: pain,pains
painful: painful
paint: painting
painting: painting,paintings
pair: pair
pala: palas
palace: palace,palaces
palate: palate
palm: palm,palms
pandita: pandita
pang: pangs
pantheon: pantheon
paper: paper
paperwork: paperwork
papier: papier
par: par
paragraph: paragraph,paragraphs
parasite: parasite,parasites
parent: parents
paroxysm: paroxysm
parrot: parrot,parrots
parsley: parsley
parterre: parterre
partridge: partridges
party: parties,party
pass: pass,passed,passes,passing
passage: passages
passer: passers
passion: passion,passions
passionate: passionate
paste: paste
paternal: paternal
patience: patience
patroness: patroness
pay: paid,pay,paying,pays
payment: payments
peace: peace
peaceful: peaceful
peacock: peacock,peacocks
pebble: pebbles
peck: pecking
peculiar: peculiar
peculiarity: peculiarities,peculiarity
pecuniary: pecuniary
peepul: peepul
peg: peg
pelt: pelting
pen: pens
pencil: pencil
pendulous: pendulous
penniless: penniless
pepper: pepper
perceive: perceived,perceives,perceiving
perception: perception
perceptive: perceptive
perfect: perfect
perfectly: perfectly
perforate: perforates,perforating
perform: perform,performed,performing,performs
performance: performance,performances
perfume: perfume,perfumes,perfuming
perfumed: perfumed
perfumer: perfumers
period: period
periodic: periodic
permanent: permanent
permission: permission
permit: permit,permitted
perseverance: perseverance
person: people,person,persons
personal: personal
personally: personally
perspiration: perspiration
perspire: perspiring
persuade: persuade
perusal: perusal
peruse: perused
pestilent: pestilent
philanthropist: philanthropists
philter: philter,philters
phrase: phrase
phut: phut
physalis: physalis
physical: physical
physician: physician,physicians
pick: pick,picking
picnic: picnics
picnics: picnics
picture: picture,pictures
piece: pieces
pierce: pierce,pierced,pierces,piercing
pigeon: pigeon
pigment: pigment
pilgrimage: pilgrimage
pill: pills
pillar: pillar
pillow: pillows
pincers: pincers
pincher: pinchers
pinus: pinus
pipe: pipe
piper: piper
pit: pit,pits
pitiless: pitiless
pity: pity
plain: plain
planet: planets
plant: plant,planted,plants
plate: plates
play: play,played,playing,plays
plaything: playthings
pleasant: pleasant
pleased: pleased
pleasing: pleasing
pleasure: pleasure,pleasures
plenty: plenty
pluck: plucking
plum: plum
poem: poems
poet: poet,poets
poetical: poetical
poetically: poetically
poetry: poetry
poison: poison
polar: polar
police: police
polished: polished
pollute: polluted
polygamy: polygamy
pomegranate: pomegranate
pool: pool
poor: poor
popular: popular
popularly: popularly
portion: portion,portions
position: position,positions
possess: possess,possessed,possesses,possessing
possession: possession,possessions
possibility: possibility
post: posted,posts
pot: pot,pots
potato: potato
potter: potter
pound: pounded,pounding,pounds
poverty: poverty
powder: powder,powders
powdered: powdered
power: power,powers
powerful: powerful
practical: practical
practically: practically
practice: practice,practices
practise: practise,practised,practising
praise: praise,praised,praising
praiseworthy: praiseworthy
precede: preceded,precedes,preceding
precept: precepts
preceptor: preceptor
precious: precious
preface: preface
prefer: prefer,preferred
preferable: preferable
preference: preference
pregnancy: pregnancy
premier: premiers
premise: premises
prepare: prepare,prepared,preparing
prepared: prepared
prescribe: prescribed
prescription: prescriptions
presence: presence
presently: presently
preservative: preservative
preserve: preserve,preserves
press: press,pressed,presses,pressing
pressed: pressed
pressure: pressure
presume: presumed
pretence: pretence,pretences
pretend: pretend,pretended,pretending,pretends
pretext: pretext
prettily: prettily
prevalent: prevalent
prevent: prevent,prevented,preventing,prevents
previous: previous
pride: pride
priestly: priestly
prime: prime
primitive: primitive
prince: prince,princes
principal: principal
principle: principles
principled: principled
print: print,printed
printer: printer
private: private
privately: privately
probable: probable
proceed: proceed,proceeds
proceeds: proceeds
processing: processing
procurable: procurable
procure: procure,procured,procuring
produce: produce,produced,produces,producing
production: production,productions
productive: productive
profession: profession
professor: professor
profit: profit,profits
profound: profound
progeny: progeny
prohibit: prohibited,prohibits
prohibition: prohibition
project: project,projecting
prominently: prominently
promise: promise,promised,promises
promote: promoting
promotion: promotion
pronounce: pronounce,pronouncing
pronounced: pronounced
proofread: proofread
proofreading: proofreading
proper: proper
properly: properly
property: properties,property
propitiate: propitiated
propitious: propitious
proportion: proportion,proportions
proportionately: proportionately
propose: proposed
proposition: propositions
proprietary: proprietary
propriety: propriety
prose: prose
prospectus: prospectuses
prosperity: prosperity
prosperous: prosperous
prostitution: prostitution
protect: protect,protected
protection: protection
protrude: protruding
prove: prove,proved
provide: provide,providing
province: province,provinces
provision: provision,provisions
proviso: proviso
provocative: provocative
provoke: provokes
prudent: prudent
puberty: puberty
public: public
publication: publication
publicly: publicly
publish: published
pull: pull,pulling
pumpkin: pumpkin
punctuation: punctuation
pundit: pundit,pundits
punish: punished
punitive: punitive
pupil: pupil
purchase: purchase,purchases,purchasing
pure: pure
purify: purifying
purity: purity
purple: purple
purpose: purpose,purposes
puzzle: puzzles
quadruped: quadruped
quail: quail,quails
quality: qualities,quality
quantity: quantities,quantity
quarrel: quarrel,quarrelled,quarrelling,quarrels
quarry: quarries
quarter: quarter
queen: queen
queens: queens
question: question,questions
quick: quick
quickness: quickness
quiet: quiet
quote: quote,quoted,quotes
race: races
radish: radish
raiment: raiments
rain: rain
raise: raise,raised,raises,raising
raja: raja
ram: ram,rams
rank: rank
rapid: rapid
rapidly: rapidly
rarely: rarely
rasa: rasa
rate: rate,rates
reach: reached,reaching
read: read,reading
readable: readable
reader: reader
readiness: readiness
ready: ready
real: real
realise: realised
realistic: realistic
reality: reality
realize: realize,realized
rear: reared
reason: reason,reasons
reasonable: reasonable
reasoning: reasoning
rebuke: rebuke,rebuked
receipt: receipt
receipts: receipts
receive: receive,received,receives,receiving
reception: reception
recipe: recipe,recipes
recite: recited,reciting
recklessness: recklessness
reckon: reckoned
recline: reclining
recognise: recognise,recognised
recognize: recognize
reconcile: reconcile,reconciled
reconciliation: reconciliations
recourse: recourse
recover: recovered,recovers
recreation: recreations
red: red
reddish: reddish
redistribute: redistribute,redistributing
redistributing: redistributing
redistribution: redistribution
redness: redness
reduce: reducing
reed: reed
refer: referred,referring,refers
reference: reference,references
reflect: reflecting
reflection: reflection
refrain: refrains
refreshment: refreshment
refuge: refuge
refund: refund
refuse: refuse,refusing
regain: regained
regard: regard,regarded
region: region
register: registered
regret: regret,regretted
regular: regular
regulate: regulated,regulating
reign: reign,reigned
reject: reject,rejected,rejecting
relate: relate,relates,relating
relation: relation,relations
relationship: relationship
relative: relatives
relax: relaxes
release: release
religion: religion
religious: religious
rely: relied,relies
remain: remain,remained,remaining,remains
remains: remains
remark: remark,remarks
remarry: remarried
remede: remede
remedy: remedied,remedies
remember: remember,remembered,remembering
remembrance: remembrance
remind: remind
remote: remote
removal: removal
remove: remove,removed,removing
rename: renamed
render: rendering
renew: renew,renewed,renewing
repair: repair,repairs
repeat: repeat,repeated,repeating
repeatedly: repeatedly
replace: replace
replacement: replacement
reply: replied,replies,reply,replying
report: report,reported,reports
repose: repose
reprehend: reprehended
represent: represent,represented
representation: representations
reprint: reprint
reproach: reproach,reproaches
reproachable: reproachable
reproachful: reproachful
reproduce: reproduced
repulse: repulses
reputation: reputation
request: request,requested
require: require,required,requires
requirement: requirements
resemble: resemble,resembled,resembles
reservoir: reservoirs
reside: residing
residence: residence
resident: resident
resist: resisted,resists
resolve: resolved
resort: resort,resorted,resorting,resorts
resource: resources
respect: respect,respected,respecting
respectable: respectable
respectful: respectful
respects: respects
respond: responding
rest: rest,rested
restore: restore
restraint: restraint
restriction: restrictions
result: result
resume: resumed
retain: retained
retired: retired
return: return,returned,returning,returns
reveal: reveal,revealed,revealing,reveals
revenge: revenged
revenue: revenue
revere: revere
reverse: reverse
revise: revised
revolve: revolve
reward: reward,rewards
rhetoric: rhetoric
rice: rice
rich: rich
richard: richard
riches: riches
rid: rid
riddle: riddles
rider: riders
ridiculous: ridiculous
rig: rig
rinse: rinsing
rise: rise,rises,rising,rose
rishis: rishis
rising: risings
risk: risk
rite: rite,rites
rival: rival,rivals
rivalry: rivalry
river: river,rivers
road: road,roads
robber: robbers
roguery: roguery
roguish: roguish
role: role
roll: rolling
romance: romance
root: root,roots
rope: ropes
rosary: rosaries
rough: rough
roughness: roughness
rouse: rouse
row: row,rows
royal: royal
royalty: royalties,royalty
rub: rub,rubbed,rubbing,rubs
ruin: ruin,ruined
rule: rule,ruled,rules
rustic: rustic
sacred: sacred
sacrifice: sacrifice,sacrifices
sacrificer: sacrificer,sacrificers
safely: safely
saffron: saffron
sage: sage,sages
sake: sake
salary: salaries
sale: sale,sales
salt: salt
salutation: salutation
sample: samples
sancho: sancho
sanctuary: sanctuary
sand: sands
sandal: sandal
sanskrit: sanskrit
sara: sara
satisfaction: satisfaction
satisfactory: satisfactory
satisfied: satisfied
satisfy: satisfied,satisfy,satisfying
saturate: saturated
savage: savage
save: saving
savour: savour
scanning: scanning
scanty: scanty
scarification: scarification
scatter: scattered
scene: scenes
scenic: scenic
scent: scent
scheming: scheming
school: school
science: science,sciences
scissors: scissors
scold: scold
scorn: scorned
scotch: scotch
scratch: scratch,scratches,scratching
scratching: scratching
screw: screw
sculpture: sculptures
seal: seal
search: search
season: season,seasoning,seasons
seasoned: seasoned
seat: seat,seats
secluded: secluded
seclusion: seclusion
secrecy: secrecy
secret: secret,secrets
secretly: secretly
secure: secure,secured,securing
securely: securely
seduce: seduce,seduced,seducing
seduction: seduction
seed: seed,seeds
seek: seek,seeking,sought
seize: seizes
seldom: seldom
select: select,selected
selfish: selfish
sell: sell,selling
seller: sellers
semen: semen
send: send,sending,sends
senior: senior
sense: sense
sensibility: sensibility
sensual: sensual
sentence: sentence,sentences
sentiment: sentiment
sentinel: sentinels
separate: separate,separated,separating
separated: separated
separately: separately
separation: separation
seraglio: seraglio
serpent: serpent
servant: servant,servants
serve: serve,served,serves,serving
service: service,services
sesamum: sesamum
set: set,sets,setting
settle: settle,settled
seventh: seventh
severally: severally
severely: severely
sewing: sewing
sex: sex,sexes
sexual: sexual
shabby: shabby
shaiva: shaiva
shake: shakes,shaking
shame: shame
shamelessness: shamelessness
shampoo: shampoo,shampooing,shampoos
shampooer: shampooers
shampooing: shampooing
shank: shanks
shape: shape
share: share,shared,sharing
sharp: sharp
shastra: shastra
shastras: shastras
shastri: shastri
shave: shaved
sheep: sheep
sheik: sheik
shelter: shelter
sherbet: sherbet,sherbets
ship: ship
shock: shock
short: short
shortly: shortly
shoulder: shoulder,shoulders
shower: shower
shrewd: shrewd
shrewdness: shrewdness
shrink: shrinks
shruti: shruti
shut: shut
shyness: shyness
sick: sick
sickly: sickly
siddha: siddha
sideways: sideways
sigh: sighs
sighing: sighing
sight: sight
sign: sign,signs
signs: signs
silence: silence
silent: silent
silk: silk
silver: silver
sima: sima
simple: simple,simpler
simplicity: simplicity
simply: simply
sin: sin
sing: sing,singing
singer: singers
singing: singing
single: single
sink: sinks
sir: sir
sister: sister,sisters
sit: sit,sits,sitting
sita: sita
situate: situated
sixteenth: sixteenth
sixth: sixth
size: size
skilful: skilful
skilfulness: skilfulness
skill: skill
skilled: skilled
skin: skin,skins
slave: slave,slaves
slay: slain
sleep: sleep,sleeps
sleepy: sleepy
slight: slight,slighted,slightest
slip: slip
slough: slough
slow: slow
slowly: slowly
smallness: smallness
smartly: smartly
smell: smell,smelling,smells
smile: smile,smiles,smiling
smoke: smoke
smooth: smooth
snake: snakes
sneer: sneer
sneeze: sneezes
soak: soaked,soaks
soap: soap
sociable: sociable
social: social
socially: socially
society: societies,society
sodomy: sodomy
soft: soft
soften: softened
softly: softly
softness: softness
sole: soles
solely: solely
solemnly: solemnly
solicit: solicit
solicitation: solicitation
solution: solution
soma: soma
son: son,sons
song: songs
sorcery: sorcery
sorrow: sorrow
sort: sort,sorts
soul: soul,souls
sound: sound,sounding,sounds
sounds: sounds
soup: soup
sour: sour
source: sources
south: south
southern: southern
sow: sowing,sown
space: space
sparrow: sparrow,sparrows
speak: speak,speaking,speaks,spoken
speaker: speaker
special: special
speciality: specialities
specially: specially
specific: specific
specimen: specimens
spectacle: spectacle
spectacles: spectacles
speech: speech,speeches
speed: speed
spell: spells
spend: spend,spending,spent
spin: spinning
spinning: spinning
spirit: spirit,spirits
spirited: spirited
spiritless: spiritless
spiritual: spiritual
spirituous: spirituous
spite: spite
spitting: spitting
split: split
splitting: splitting
spontaneous: spontaneous
sport: sport,sporting,sports
sporting: sporting
sportive: sportive
spot: spots
spread: spread,spreading
spring: spring,springs
sprinkle: sprinkle
sprout: sprout,sprouts
spur: spur
spy: spies
squander: squandered
stab: stabbing
staff: staff
stage: stage,stages
stain: stained
staining: staining
stake: stake
stalk: stalk,stalks
stamp: stamp
stand: stand,standing,stands,stood
standard: standard
standing: standing
stanza: stanzas
star: star,stars
stare: staring
starling: starlings
start: start,starts
starve: starving
statement: statements
statue: statue
status: status
steal: stolen
step: steps
stick: stick
sting: stung
stinginess: stinginess
stingy: stingy
stock: stocks
stomach: stomach
stone: stones
stool: stool,stools
stoppage: stoppage
stopping: stopping
store: store,stored,storing
storm: storms
story: stories,story
straight: straight
straightforward: straightforward
stranger: stranger,strangers
stratum: stratum
street: street,streets
strength: strength
stretch: stretched,stretches
strict: strict
strictly: strictly
strike: strike,strikes,striking,struck
striking: striking
string: strings
stringing: stringing
strive: strive
strong: strong
struggle: struggle,struggling
stud: studded
student: student
study: studied,study,studying
stupidity: stupidity
style: style
subdue: subduing
subject: subject,subjecting,subjects
subjugate: subjugate,subjugating
submission: submission
subordinate: subordinate
subscribe: subscribe
subsequent: subsequent
subsequently: subsequently
subsistence: subsistence
substance: substance,substances
subtlety: subtlety
succeed: succeed,succeeded,succeeding,succeeds
success: success
successful: successful
succumb: succumb
suck: sucking,sucks
sudden: sudden
suddenly: suddenly
suffer: suffer,suffering,suffers
sufficiency: sufficiency
sufficient: sufficient
sugar: sugar
suggestively: suggestively
suit: suit,suited
suitable: suitable
suited: suited
sulky: sulky
sulphur: sulphur
sum: sum
summer: summer
sun: sun
superfluous: superfluous
superintend: superintend,superintended
superintendence: superintendence
superintendent: superintendents
superior: superior,superiors
superiority: superiority
superlative: superlative
supine: supine
supplement: supplement
supply: supplying
support: support,supported,supports
supporter: supporters
suppose: suppose,supposed
supposer: supposer
supreme: supreme
surface: surface
surpass: surpass
surprise: surprised
surround: surround,surrounded
surroundings: surroundings
survive: survive
suspect: suspecting
suspend: suspended
suspicion: suspicion,suspicions
suspicious: suspicious
sustain: sustained
sutra: sutra
swallow: swallow,swallowing
swamp: swamp
swan: swan
swear: swear
sweat: sweat
sweet: sweet
sweetly: sweetly
sweetmeat: sweetmeats
swell: swelling
swelling: swelling
swing: swing
swollen: swollen
sword: sword
syllable: syllable
symbol: symbols
sympathize: sympathize
symptom: symptoms
synonymous: synonymous
table: table
tactic: tactics
tailor: tailor
taint: tainted
tale: tale,tales
talent: talent,talents
talk: talk,talked,talking,talks
tank: tank,tanks
tarnish: tarnish
tassel: tassels
taste: taste,tastes,tasting
tattooing: tattooing
tavern: tavern
tax: tax,taxes
teach: taught,teach,teaches,teaching
teacher: teacher,teachers
teaching: teaching,teachings
team: team
tear: tears
technical: technical
teller: tellers
temper: temper
temperament: temperament
temple: temple,temples
temporarily: temporarily
temporary: temporary
tend: tend,tending
tendency: tendency
tender: tender
tenderness: tenderness
tenth: tenth
term: term,terms
terrace: terrace
testicle: testicle
testing: testing
textured: textured
theatre: theatre,theatres
theatrical: theatrical
thee: thee
theme: theme
therefrom: therefrom
thicken: thickens
thickening: thickening
thickness: thickness
thief: thief
thigh: thigh,thighs
thinking: thinking
thirst: thirst
thirteenth: thirteenth
thither: thither
tho: tho
thorn: thorn
thread: thread,threads
threaten: threatening
thrice: thrice
throat: throat
throb: throbbing
throbbing: throbbing
throne: throne
throw: throw,throwing,thrown,throws
thrust: thrusts
thugs: thugs
thunder: thundering
tidy: tidy
tie: tie,tied,ties
tiger: tiger,tigers
time: time,timed,times
timid: timid
timidity: timidity
tin: tin
tinkle: tinkle
tired: tired
title: title
toe: toe,toes
token: token,tokens
tolerably: tolerably
tone: tone
tong: tongs
tongue: tongue
tonic: tonic
tooth: teeth,tooth
topic: topics
toss: tosses
touch: touch,touched,touches,touching
touching: touching
tout: tout
town: town,towns
toy: toy
trace: traces
tract: tract
trademark: trademark
trader: trader
train: train,trained
training: training
transaction: transactions
transcribe: transcribe
transcriber: transcriber
transcript: transcript
transcription: transcription
transfer: transferred
translate: translated,translating
translation: translation,translations
translator: translator
transmigration: transmigration
transpose: transposed
trapa: trapa
travel: travelling
travelling: travelling
treasure: treasure
treat: treat,treated,treating,treats
treatise: treatise,treatises
treatment: treatment
tree: tree,trees
tremblingly: tremblingly
trick: tricks
trifler: trifler
trim: trimmed,trimming
trouble: trouble,troubled,troubles
true: true
trunk: trunk
trust: trust,trusted
truth: truth,truths
truthfulness: truthfulness
tube: tube
tubular: tubular
tuft: tufts
turban: turbans
tuscan: tuscan
tutor: tutored
twine: twines
twining: twining
twist: twist
twisting: twisting
twofold: twofold
type: type,types
udder: udder
ulcer: ulcers
umbilical: umbilical
unable: unable
unacquainted: unacquainted
unbroken: unbroken
uncertain: uncertain
uncertainty: uncertainty
unchanged: unchanged
unchaste: unchaste
uncle: uncle
unclean: unclean
uncover: uncovered
understand: understand,understood
understanding: understanding
undertake: undertake
undertaking: undertaking
uneasy: uneasy
uneaten: uneaten
unenforceability: unenforceability
unequal: unequal
unexceptional: unexceptional
unexpectedly: unexpectedly
unexpressed: unexpressed
unfailing: unfailing
unfavourable: unfavourable
unfinished: unfinished
unfit: unfit
unfriendly: unfriendly
unfulfilled: unfulfilled
ungrateful: ungrateful
unguent: unguent,unguents
unhappiness: unhappiness
uniform: uniform
unintelligible: unintelligible
union: union,unions
unique: unique
unite: unite,united,uniting
united: united
universal: universal
universally: universally
unjustly: unjustly
unknown: unknown
unlawful: unlawful
unlink: unlink
unmarried: unmarried
unnecessary: unnecessary
unobtainable: unobtainable
unpaid: unpaid
unpleasant: unpleasant
unrestrained: unrestrained
unrighteous: unrighteous
unseen: unseen
unsolicited: unsolicited
untarnished: untarnished
unwell: unwell
unwilling: unwilling
unwillingness: unwillingness
unworthy: unworthy
update: updated
upper: upper
urge: urge
usage: usage
useless: useless
user: user
usual: usual
ut: ut
utensil: utensils
utmost: utmost
utter: utter,utters
utterly: utterly
vain: vain
vajra: vajra
valour: valour
valuable: valuable
vampire: vampire
vanilla: vanilla
vanity: vanity
variety: variety
vary: varies
vast: vast
veda: veda
vegetable: vegetables
vehicle: vehicles
vendor: vendors
venerable: venerable
venerate: venerating
venus: venus
verbal: verbal
vermilion: vermilion
vernacular: vernacular
vernonia: vernonia
vers: vers
verse: verse,versed,verses
verses: verses
version: version
vessel: vessels
vestment: vestments
vice: vice,vices
vicinity: vicinity
view: view,viewed,viewing
vigorous: vigorous
vigour: vigour
vii: vii
viii: viii
village: village,villages
villager: villagers
violate: violated,violates,violating
virgin: virgin,virgins
virginity: virginity
virtue: virtue
virtuous: virtuous
virus: virus
vishnu: vishnu
visible: visible
visit: visit,visited,visiting,visits
visitor: visitors
vita: vita
vocabulary: vocabularies
voice: voice
void: void
volume: volume,volumes
volunteer: volunteer,volunteers
voluptuary: voluptuaries
voluptuous: voluptuous
vow: vow,vows
vowel: vowels
vulgar: vulgar
vulture: vultures
wager: wager,wagers
waist: waist
walk: walk,walking,walks
wall: wall,walls
wander: wandering
wane: waning
wanton: wanton
war: war
ward: warding
warlike: warlike
warm: warm
warn: warn
warranty: warranties,warranty
wash: wash,washed,washing
washerman: washerman
washermen: washermen
washing: washing
wasp: wasp
watch: watched
water: water
waters: waters
wax: wax
weak: weak
weakness: weakness
wealth: wealth
wealthy: wealthiest,wealthy
weapon: weapon
wear: wear,wearing,wears,worn
weary: weary
weaving: weaving
wedding: wedding
wedge: wedge
weed: weed
weep: weeping
weight: weight
welfare: welfare
west: west
western: western
whatsoever: whatsoever
wheat: wheat
wheedle: wheedled
wheel: wheel
wheeler: wheeler
whirl: whirling
white: white
whiten: whitening
wholesome: wholesome
wholly: wholly
wick: wick
wicked: wicked
wickedness: wickedness
wide: wide,widest
widen: widen
widow: widow,widows
wife: wife,wives
wild: wild
willed: willed
william: william
williams: williams
willingness: willingness
wilson: wilson
win: win,winning,wins
wind: wind
window: windows
wine: wine
wire: wire
wisdom: wisdom
wise: wise
witch: witches
witness: witness,witnesses
witty: witty
woman: woman,women
womanhood: womanhood
womankind: womankind
womb: womb
women: women
wonderful: wonderful
woo: woo
wood: wood
wooden: wooden
wool: wool
word: word
worldly: worldly
worm: worms
wormwood: wormwood
worn: worn
worship: worship,worshipping
worth: worth
worthless: worthless
worthy: worthy
wound: wounding,wounds
wounding: wounding
wrap: wrapping
wrapt: wrapt
wreath: wreaths
wreck: wrecked
wrestler: wrestlers
wretched: wretched
wrinkle: wrinkles
writ: writ
write: write,writes,writing,written,wrote
writer: writer,writers
writing: writing
writings: writings
wrong: wrong
yarn: yarn
yawn: yawn,yawns
yawning: yawning
yellow: yellow
yield: yield
yoni: yoni
yonis: yonis
youth: youth
youthful: youthful
zenana: zenana
zodiac: zodiac
