abandon: abandon,abandoned
abandonment: abandonment
abase: abasing
abasement: abasement
abashed: abashed
aberration: aberrations
ability: abilities,ability
abject: abject
ablutions: ablutions
abnormally: abnormally
abode: abode
abolish: abolished
abolition: abolition
abreast: abreast
abrupt: abrupt
abruptly: abruptly
abruptness: abruptness
absence: absence,absences
absent: absent
absently: absently
absolute: absolute
absolutely: absolutely
absolution: absolution
absorb: absorb,absorbed,absorbing
abstain: abstaining
abstract: abstract
abstractly: abstractly
absurd: absurd
absurdity: absurdities,absurdity
absurdly: absurdly
abundance: abundance
abundant: abundant
abuse: abuse,abused,abusing
abyss: abyss
acacia: acacia,acacias
academy: academy
accent: accent
accentuate: accentuating
accept: accept,accepted,accepting,accepts
acceptation: acceptation
accessibility: accessibility
accident: accident
accidental: accidental
accidentally: accidentally
accompaniment: accompaniment
accompany: accompanied,accompany,accompanying
accomplice: accomplice
accomplish: accomplish,accomplished
accomplished: accomplished
accord: accord
accost: accosted
account: account,accounts
accumulate: accumulated,accumulating
accurate: accurate
accurately: accurately
accuse: accused,accusing
accustom: accustom,accustomed
accustomed: accustomed
ache: ache,ached,aching
achievement: achievement
acknowledge: acknowledge,acknowledged,acknowledging
acknowledgment: acknowledgment
acquaint: acquainted
acquaintance: acquaintance,acquaintances
acquire: acquired
acquit: acquitted
acre: acre,acres
acting: acting
action: action,actions
active: active
actively: actively
activity: activity
actor: actors
actress: actress,actresses
actual: actual
acute: acute
acutely: acutely
adam: adam
adapt: adapting
add: add,adding
addition: addition,additions
address: address,addressed,addressing
adept: adept
adhere: adhered,adhering
adherence: adherence
adherent: adherent
adjoin: adjoined
adjutant: adjutant,adjutants
administration: administration
administrative: administrative
admirable: admirable
admirably: admirably
admiration: admiration
admire: admire,admired,admiring
admirer: admirer
admiringly: admiringly
admission: admission
admit: admit,admitted,admitting
admittance: admittance
adopt: adopt,adopting
adoration: adoration
adore: adored
adorer: adorers
adorn: adorn,adorned,adorning
adornment: adornments
adroit: adroit
adroitly: adroitly
adultery: adultery
advance: advance,advanced,advances
advanced: advanced
advancement: advancement
advantage: advantage,advantages
adventure: adventures
adverb: adverb,adverbs
advice: advice
advise: advise,advised,advising
adviser: adviser
advocate: advocate,advocates,advocating
afar: afar
affability: affability
affable: affable
affair: affair,affairs
affairs: affairs
affect: affect
affectation: affectation
affectedly: affectedly
affection: affection
affectionate: affectionate
affectionately: affectionately
affirm: affirming
affirmative: affirmative
affirmatively: affirmatively
afford: afford,afforded,affords
affront: affront
aflame: aflame
afraid: afraid
afresh: afresh
aftermath: aftermath
afternoon: afternoon
afterthought: afterthought
agaric: agaric
age: age,ages
aged: aged
agency: agency
ages: ages
aggravate: aggravated,aggravating
aggressively: aggressively
agile: agile
agitate: agitate,agitated,agitating
agitated: agitated
agitation: agitation
agonized: agonized
agonizing: agonizing
agonizingly: agonizingly
agony: agonies,agony
agree: agree,agreed,agreeing,agrees
agreeable: agreeable
agreeably: agreeably
agreement: agreement
agricultural: agricultural
agriculture: agriculture
agriculturist: agriculturist
aha: aha
aid: aid
aide: aide
aim: aim,aimed,aiming,aims
aimless: aimless
aimlessly: aimlessly
air: air,airs
akimbo: akimbo
akin: akin
alarm: alarm,alarmed
alarmed: alarmed
alarming: alarming
alas: alas
album: album,albums
alder: alder,alders
alert: alert
alertly: alertly
alertness: alertness
alexander: alexander
alias: alias
alien: alien
alienation: alienation
alight: alight,alighted,alights
alike: alike
aline: aline
alive: alive
aller: aller
alleviate: alleviate,alleviated
alley: alley
allez: allez
allot: allotted
allowance: allowance
alloy: alloy
allude: allude,alluded,alluding
allurement: allurements
alluring: alluring
allusion: allusion,allusions
ally: ally
almighty: almighty
almond: almond
aloft: aloft
aloof: aloof
aloofness: aloofness
aloud: aloud
altar: altar
alter: alter,altered,altering
altered: altered
alternate: alternate
alternately: alternately
alternative: alternative,alternatives
altogether: altogether
amalgamate: amalgamating
amalgamated: amalgamated
amalgamation: amalgamation
amassing: amassing
amateur: amateur,amateurs
amateurs: amateurs
amazed: amazed
amazement: amazement
amazing: amazing
ambassador: ambassador
amber: amber
ambition: ambition
ambitious: ambitious
amble: amble,ambling
ambulance: ambulance
amen: amen
amenable: amenable
amend: amend,amending
amendment: amendment
america: america
american: american
ami: ami
amiability: amiability
amiable: amiable
amiably: amiably
amicable: amicable
amicably: amicably
amis: amis
amiss: amiss
amour: amour
ample: ample
amuse: amuse,amused,amuses,amusing
amused: amused
amusement: amusement,amusements
amusing: amusing
amusingly: amusingly
analysis: analysis
analyze: analyze,analyzing
ancestor: ancestors
anchor: anchor
ancient: ancient
anecdote: anecdote,anecdotes
anew: anew
angel: angel,angels
anger: anger,angered
anglaise: anglaise
angle: angle,angles
angling: angling
angrily: angrily
angry: angry
anguish: anguish
animal: animal
animated: animated
animation: animation
anita: anita
ankle: ankles
anna: anna
annie: annie
annihilate: annihilate,annihilated
announcement: announcement
annoy: annoy,annoyed,annoys
annoyance: annoyance,annoyances
annoyed: annoyed
annoying: annoying
anomalous: anomalous
answer: answer,answered,answering,answers
antagonism: antagonism
antagonist: antagonist
antagonistic: antagonistic
antediluvian: antediluvian
anthropology: anthropology
anticipate: anticipate,anticipated,anticipating
anticipation: anticipation
antidote: antidote
antique: antiques
anxiety: anxieties,anxiety
anxious: anxious
anxiously: anxiously
apartment: apartments
apathetic: apathetic
apathy: apathy
ape: ape
apologetically: apologetically
apologize: apologize,apologized,apologizing
apology: apologies,apology
apostle: apostle
apostolic: apostolic
appal: appalled
appalling: appalling
apparent: apparent
apparition: apparition
appeal: appeal,appealed,appealing,appeals
appealing: appealing
appearance: appearance,appearances
appellation: appellation
appetite: appetite,appetites
appetizer: appetizer,appetizers
applaud: applauding
applause: applause
appliance: appliances
applicability: applicability
applicable: applicable
applicant: applicants
application: application,applications
apply: applied,applies,apply
appoint: appointed
appointment: appointment,appointments
apportionment: apportionment
appreciation: appreciation
apprehend: apprehend,apprehending
apprehension: apprehension
apprehensively: apprehensively
approach: approach,approached,approaches,approaching
appropriately: appropriately
approval: approval
approve: approve,approved,approving
approvingly: approvingly
appurtenance: appurtenances
apron: apron,aprons
apt: apt
aptitude: aptitude
arable: arable
arbitration: arbitration
arbitrator: arbitrator
arbor: arbor
arcade: arcade,arcades
arch: arched,arching
archdeacon: archdeacon
architect: architect
architecture: architecture
arcturus: arcturus
ardent: ardent
ardently: ardently
ardor: ardor
argue: argue,argued,argues,arguing
argument: argument,arguments
argumentative: argumentative
aristocracy: aristocracy
aristocrat: aristocrat,aristocrats
aristocratic: aristocratic
arithmetic: arithmetic
arithmetical: arithmetical
arm: arm,arms
armchair: armchair,armchairs
armed: armed
armful: armfuls
armor: armor
armory: armory
army: army
aromatic: aromatic
arouse: arouse,aroused
arrange: arrange,arranged,arranges,arranging
arrangement: arrangement,arrangements
array: array
arrest: arrest,arresting
arrival: arrival
arrive: arrive,arrived,arriving
arrow: arrow
art: art,arts
artful: artful
article: article,articles
articulate: articulate,articulated,articulating
articulation: articulation
artificial: artificial
artificiality: artificiality
artist: artist,artists
artistic: artistic
artless: artless
artlessness: artlessness
ascend: ascended,ascending
ascertain: ascertained,ascertaining
ascribe: ascribe,ascribed
ash: ash,ashes
ashamed: ashamed
ashtray: ashtray
asia: asia
askance: askance
askew: askew
aslant: aslant
asleep: asleep
asparagus: asparagus
aspect: aspect,aspects
aspen: aspen,aspens
assault: assaulting
assemble: assembled
assembly: assemblies,assembly
assent: assent,assented
assert: assert,asserted,asserting,asserts
assertion: assertion,assertions
assertive: assertive
asseveration: asseverations
assiduity: assiduity
assiduously: assiduously
assiette: assiette
assign: assigned,assigning
assimilate: assimilates
assist: assist,assisted,assisting
assistance: assistance
assistant: assistant
associate: associate
association: association,associations
assume: assume,assumed,assuming
assumption: assumption
assurance: assurance,assurances
assure: assure,assured,assures,assuring
asthma: asthma
astonish: astonished
astonished: astonished
astonishing: astonishing
astonishment: astonishment
astounded: astounded
astounding: astounding
astoundingly: astoundingly
astrachan: astrachan
astride: astride
astronomy: astronomy
astute: astute
asunder: asunder
asylum: asylum
atelier: atelier
atheism: atheism
athenian: athenian
atlas: atlas
atmosphere: atmosphere
atone: atone,atoned
attach: attach,attached,attaches,attaching
attachment: attachment,attachments
attack: attack,attacked,attacking,attacks
attain: attain,attained,attaining
attainment: attainment
attempt: attempt,attempted,attempting,attempts
attend: attend,attended,attending
attendant: attendant,attendants
attention: attention,attentions
attentive: attentive
attentively: attentively
attic: attic
attire: attire,attired
attitude: attitude
attract: attract,attracted,attracting
attraction: attraction
attractive: attractive
attractiveness: attractiveness
attribute: attributed
auction: auction
audacity: audacity
audible: audible
audibly: audibly
audience: audience
auditing: auditing
august: august
aunt: aunt,aunts
auntie: auntie
author: author,authors
authoress: authoress
authority: authorities,authority
autumn: autumn
avenge: avenge
avenue: avenue
averse: averse
aversion: aversion
avert: averting
avoid: avoid,avoided,avoiding
avowal: avowal
await: await,awaited,awaiting,awaits
awake: awake,awoke
awaken: awaken,awakened
aware: aware
awe: awe
awful: awful
awfulness: awfulness
awkward: awkward
awkwardly: awkwardly
awkwardness: awkwardness
axis: axes
axle: axles
ay: ay
babe: babe,babes
baby: baby
babylon: babylon
bach: bach
bachelor: bachelor
background: background
bacon: bacon
bad: bad,worse,worst
badge: badges
badly: badly
baffle: baffled
bag: bag,bags
baggage: baggage
baggy: baggy
bailiff: bailiff,bailiffs
baked: baked
baker: baker,bakers
balance: balance,balancing
balcony: balcony
bald: bald
baldly: baldly
ball: ball,balls
ballet: ballet
ballot: ballot,balloted
ballroom: ballroom
baltic: baltic
balustrade: balustrade
banc: banc
band: band,bands
bandage: bandaged,bandages
bandaged: bandaged
bang: bang,banging,bangs
bank: bank,banks
banker: banker,bankers
banking: banking
banner: banner,banners
banquet: banquet
banter: banter,bantering
bantering: bantering
bar: bar,bars
barbarism: barbarism
barbarity: barbarity
barbarous: barbarous
barber: barber
bare: bare,bared
barely: barely
bargain: bargain
bargaining: bargaining
bargeman: bargeman
baritone: baritone
bark: bark,barking
barn: barn,barns
baroness: baroness
baronetcy: baronetcy
barrel: barrel
barricade: barricade
barrier: barrier,barriers
barter: barters
base: base,based,basest,basing
baseless: baseless
basement: basement
baseness: baseness
bashful: bashful
bashfulness: bashfulness
basin: basin
basis: basis
bask: basked,basking
basket: basket,baskets
basketful: basketful
bass: bass
bast: bast
bat: bat
bateau: bateau
bath: bath,bathed,bathing,baths
bathe: bathe
bathing: bathing
bathroom: bathroom
batiste: batiste
batter: battering
battle: battle
bay: bay
beadle: beadle
beak: beak
beam: beamed,beaming
bean: beans
bear: bear,bearing,bears,bore,born,borne
beard: beard
bearded: bearded
beardless: beardless
bearing: bearings
bearskin: bearskin
beast: beast,beasts
beastly: beastly
beat: beat,beaten,beating,beats
beating: beating
beau: beau
beautiful: beautiful
beautifully: beautifully
beautify: beautify
beauty: beauty
beaux: beaux
beaver: beaver
beckon: beckoned,beckoning
bed: bed,beds
bedchamber: bedchamber
bedroom: bedroom
bedside: bedside
bedsore: bedsores
bedstead: bedstead
bedtime: bedtime
bee: bee,bees
beef: beef
beefsteak: beefsteak
beehive: beehives
beer: beer
beethoven: beethoven
beetle: beetle
befall: befall,befallen,befell
beg: beg,begged,begging,begs
beggar: beggar
behalf: behalf
behave: behave,behaved,behaving
behavior: behavior
behold: beheld,behold
beholder: beholders
belated: belated
belief: belief,beliefs
believer: believer,believers
bell: bell,bells
belle: belle
bellow: bellowed
belly: bellies
belong: belong,belonged,belonging
belongings: belongings
beloved: beloved
belt: belt,belted,belts
bench: bench,benches
bend: bend,bending,bends,bent
beneath: beneath
benediction: benediction
benefit: benefit
benevolent: benevolent
bent: bent
benumb: benumbing
berry: berry
berth: berth,berths
beseech: beseech,beseeches,beseeching,besought
bestow: bestow,bestowed,bestowing
bet: bet,bets
betake: betaken
bethink: bethinking,bethought
betray: betray,betrayed,betraying
betrayal: betrayal
betroth: betrothed
betrothal: betrothal
betsy: betsy
bewilder: bewildered
bewilderment: bewilderment
bewitch: bewitched,bewitching
bezique: bezique
bible: bible
biceps: biceps
bid: bid,bidden,bidding
bijou: bijou
billiard: billiard
billiards: billiards
billow: billows
bind: bind,binding,binds,bound
biography: biography
biological: biological
biology: biology
birch: birch,birches
bird: bird,birds
birth: birth
birthday: birthday,birthdays
bit: bit,bits
bitch: bitch
bite: bit,bite,biting
bitter: bitter,bitterest
bitterer: bitterer
bitterly: bitterly
bitterness: bitterness
black: black
blacken: blackened
blackguard: blackguard
blackish: blackish
blade: blade,blades
blague: blague
blame: blame,blamed,blaming
blanc: blanc
blanche: blanche
blank: blanks
bleat: bleating
blend: blended
bless: bless,blessed
blessed: blessed
blessing: blessing,blessings
blind: blind,blinding,blinds
blindly: blindly
blink: blinked,blinking
bliss: bliss
blissful: blissful
blissfully: blissfully
block: block,blocking
blockhead: blockhead
blonde: blonde
blood: blood
blooded: blooded
bloodless: bloodless
bloodshot: bloodshot
bloodstained: bloodstained
bloom: bloom,blooming
blossom: blossoms
blot: blot,blotted
blotting: blotting
blouse: blouse,blouses
blow: blew,blow,blowing,blown
blue: blue
bluish: bluish
blunder: blunder,blunders
bluntness: bluntness
blur: blurs
blurred: blurred
blurt: blurted
blush: blush,blushed,blushing
board: board,boards
boardroom: boardroom
boast: boast,boasted
boat: boat
bob: bobbing
bode: boded
bodice: bodice
bodily: bodily
body: bodies,body
bodyguard: bodyguard
bog: bog
bohemian: bohemian
boil: boiled,boiling
boiler: boiler
boiling: boiling
bol: bol
bola: bola
bold: bold,bolder
boldly: boldly
boldness: boldness
bolster: bolster
bolt: bolted
bon: bon
bond: bond
bone: bone,boned,bones
bonhomie: bonhomie
bonne: bonne
bonnet: bonnets
bony: bony
book: book,books
bookcase: bookcases
booking: booking
bookkeeping: bookkeeping
bookseller: booksellers
bookshelf: bookshelves
boom: boomed,booms
boot: boot,boots
border: bordered,borders
bore: bored,boring
bored: bored
boredom: boredom
borrow: borrow,borrowed
bosom: bosom
botany: botany
bother: bother,bothering,bothers
bottle: bottle,bottles
boudoir: boudoir
bouffe: bouffe
boulevard: boulevard,boulevards
bounce: bounces
bound: bounded,bounding,bounds
bouquet: bouquet,bouquets
bout: bouts
bow: bow,bowed,bowing,bows
bowl: bowl
bowlegged: bowlegged
box: box,boxes
boy: boy,boys
boyish: boyish
boyishness: boyishness
brace: braced,bracing
bracelet: bracelet,bracelets
braid: braid,braided
brain: brain,brains
brainless: brainless
branch: branch,branches
brand: brand
brandish: brandishing
brandy: brandy
bras: bras
brass: brass
bravo: bravo
breach: breach
bread: bread
breadth: breadth
break: break,breaking,breaks,broke,broken
breakdown: breakdown
breakfast: breakfast
breaking: breaking
breast: breast,breasts
breath: breath,breaths
breathe: breathe,breathed,breathing
breathing: breathing
breathless: breathless
breathlessly: breathlessly
breeches: breeches
breed: bred,breeding,breeds
breeder: breeder
breeding: breeding
breeze: breeze
brew: brew
bribe: bribe,bribes
brick: bricks
bridal: bridal
bride: bride,brides
bridegroom: bridegroom
bridge: bridge,bridges
bridle: bridle
bright: bright,brighter
brighten: brightened,brightening
brightly: brightly
brightness: brightness
brilliance: brilliance
brilliant: brilliant
brilliantine: brilliantine
brilliantly: brilliantly
brim: brim,brimmed,brimming
brimful: brimful
brin: brin
brindle: brindle
bring: bring,bringing,brings,brought
brink: brink
brisk: brisker
briskly: briskly
bristle: bristles
brittle: brittle
broad: broad
broadcloth: broadcloth
broaden: broadened
broadly: broadly
broderie: broderie
broke: broke
broken: broken
bronze: bronze,bronzes
brood: brood,brooded
brook: brook
broom: broom
broth: broth
brother: brother,brothers
brow: brow,brows
brown: brown,browned
brownie: brownie
brrr: brrr
bruise: bruise,bruises
brunette: brunette
brush: brush,brushed,brushes,brushing
brushwood: brushwood
brutal: brutal
brute: brute
bubble: bubbling
buck: buck,bucks
buckwheat: buckwheat
bud: buds
buffet: buffet
bug: bugs
build: build,building,built
building: building,buildings
bulge: bulging
bull: bull
bullet: bullet
bump: bump,bumping
bun: bun
bunch: bunch
bundle: bundle,bundles,bundling
burden: burden,burdening
burdensome: burdensome
bureau: bureau
burgundy: burgundy
burn: burn,burned,burning
burning: burning
burst: burst,bursting
bury: buried,bury
bush: bush,bushes
bushel: bushels
bushy: bushy
busily: busily
business: business
businesslike: businesslike
bust: bust,busts
bustle: bustle
busy: busied,busy
butler: butler
butter: butter
butterfly: butterfly
button: button,buttoned,buttoning,buttons
buzz: buzz,buzzed
bye: bye
byzantium: byzantium
cab: cab,cabs
cabbage: cabbage
cabman: cabman
cabmen: cabmen
cachet: cachet
cadence: cadence
cage: cage,caged
cake: cake,cakes
calamity: calamities,calamity
calculate: calculated,calculating
calculation: calculation,calculations
calculus: calculus
calf: calf,calves
calling: calling
callous: callous
callousness: callousness
calm: calm,calmed,calmer,calming
calmly: calmly
calumny: calumny
calve: calve,calved
cambric: cambric
camomile: camomile
camp: camp,camps
campaign: campaign
canary: canary
cancan: cancan
candid: candid
candidate: candidate,candidates
candidly: candidly
candle: candle,candles
candlestick: candlesticks
candor: candor
cane: cane
canvas: canvas
cap: cap,caps
capable: capable
capacity: capacity
cape: cape
capella: capella
capital: capital,capitals
capitalist: capitalist,capitalists
capitally: capitally
capon: capons
caprice: caprice
capricious: capricious
captain: captain
capture: captured
capuan: capuan
card: card,cards
cardsharper: cardsharper
care: care,cared,cares,caring
career: career,careers
careful: careful
carefully: carefully
careless: careless
carelessly: carelessly
carelessness: carelessness
caress: caress,caressed,caresses,caressing
caressing: caressing
carnival: carnival
carp: carp
carpenter: carpenter,carpenters
carpet: carpet,carpeted
carpeted: carpeted
carriage: carriage,carriages
carry: carried,carries,carry,carrying
cart: cart,carted,carting,carts
carte: carte
cartilage: cartilage
cartload: cartloads
cartridge: cartridge
carve: carved
carved: carved
carving: carving
cash: cash
cashier: cashier
cassock: cassocks
cast: cast,casting
casual: casual
casually: casually
cat: cat
catch: catch,catches,catching,caught
catechism: catechism
category: category
cathedral: cathedral
catherine: catherine
catholic: catholic
catkin: catkins
cattle: cattle
causeless: causeless
caution: caution
cautiously: cautiously
cavalry: cavalry
caviar: caviar
cavity: cavities
ce: ce
cease: cease,ceased,ceasing
ceaseless: ceaseless
cede: cede,ceded
ceiling: ceiling,ceilings
celebrate: celebrating
celebrated: celebrated
celebrity: celebrities,celebrity
cellar: cellar
cement: cement,cemented
censer: censer
censure: censure,censured
cent: cent
center: center,centered,centers
central: central
centralization: centralization
century: centuries,century
ceremonious: ceremonious
ceremony: ceremonies,ceremony
certainty: certainty
certificate: certificate
certitude: certitude
cessation: cessation
chablis: chablis
chaff: chaffing
chagrin: chagrin
chain: chain,chained,chains
chair: chair,chairs
chairman: chairman
chalk: chalk
challenge: challenge,challenged
challenging: challenging
chamber: chamber,chambers
chamois: chamois
chamoix: chamois
champagne: champagne
champion: championing
chance: chance,chanced,chances,chancing
chandelier: chandelier,chandeliers
change: change,changed,changing
changed: changed
channel: channel
chant: chanting
chaos: chaos
chaperon: chaperon
chapter: chapter
char: char,charred
character: character,characters
characteristic: characteristic,characteristics
charcoal: charcoal
charge: charge,charged,charges
charitably: charitably
charity: charity
charles: charles
charlotte: charlotte
charm: charm,charmed,charms
charming: charming
chase: chase,chasing
chasm: chasm
chaste: chaste
chastisement: chastisement
chat: chat,chatted,chatting
chatter: chatter,chattering
cheap: cheap,cheaper,cheapest
cheat: cheat,cheated,cheating
check: check,checked,checking
checkered: checkered
cheek: cheek,cheeks
cheekbone: cheekbones
cheeked: cheeked
cheer: cheer,cheering,cheers
cheerful: cheerful
cheerfully: cheerfully
cheerily: cheerily
cheerless: cheerless
cheese: cheese
chemist: chemist
cher: cher
cherish: cherished
cherub: cherubs
chess: chess
chest: chest,chests
chestnut: chestnut
chew: chewing
chic: chic
chicken: chicken,chickens
chief: chief
chiefly: chiefly
chignon: chignon,chignons
child: child,children
childbirth: childbirth
childhood: childhood
childish: childish
childishly: childishly
childishness: childishness
childless: childless
childlike: childlike
chill: chill
chilled: chilled
chilliness: chilliness
chilling: chilling
chilly: chilly
chime: chimed
chimney: chimney,chimneys
chin: chin
china: china
chivalrous: chivalrous
chocolate: chocolate
choice: choice
choir: choir
choke: choked,choking
choking: choking
choose: choose,chooses,choosing,chose,chosen
chop: chopped,chopping
choral: choral
chord: chords
chorister: choristers
chorus: chorus
chose: choses
christ: christ
christening: christening
christian: christian
christianity: christianity
christs: christs
chubby: chubby
chuck: chucked
chuckle: chuckled
chum: chum,chums
church: church,churches
cigar: cigar,cigars
cigarette: cigarette,cigarettes
circle: circle,circles,circling
circuit: circuit
circular: circular
circumspect: circumspect
circumspectly: circumspectly
circumstance: circumstance,circumstances
circumstanced: circumstanced
circus: circus
cite: cited
citizen: citizen
city: city
civil: civil
civilian: civilian
civility: civility
civilization: civilization
clack: clacking
claim: claim,claiming,claims
claire: claire
clairvoyant: clairvoyant
clamber: clamber,clambered,clambering
clamorous: clamorous
clang: clang,clanging
clank: clank,clanked,clanking
clapping: clapping
clasp: clasp,clasping,clasps
clasped: clasped
class: class,classes
classic: classic,classics
classical: classical
classify: classified
clatter: clattering
clean: clean,cleaned,cleaning
cleaner: cleaner
cleanliness: cleanliness
cleanly: cleanly
clearness: clearness
cleave: cleave
clench: clenched,clenching
clergy: clergy
clerk: clerk,clerks
clever: clever,cleverer,cleverest
cleverly: cleverly
cleverness: cleverness
client: client
cliff: cliff
climate: climate
climb: climbed,climbing
cling: clinging,clung
clip: clipped
cloak: cloak,cloaks
clock: clock,clocks
clod: clods
clog: clogging,clogs
close: close,closed,closer,closest,closing
closed: closed
closely: closely
closeness: closeness
cloth: cloth,cloths
clothe: clad,clothe,clothed
clothes: clothes
clothing: clothing
cloud: cloud,clouded,clouds
cloudlet: cloudlets
clover: clover
club: club,clubs
clubhouse: clubhouse
clue: clue
clump: clump,clumps
clumsiness: clumsiness
clumsy: clumsy
clung: clung
cluster: clustered
clustering: clustering
clutch: clutch,clutched,clutching
coach: coach
coachman: coachman,coachmen
coal: coal
coarse: coarse,coarsest
coarseness: coarseness
coat: coat,coats
cob: cob
cobble: cobbles
cochon: cochon
cock: cock,cocking,cocks
cockade: cockade
cockcrow: cockcrow
cocked: cocked
cod: cod
code: code
coffee: coffee
coffeepot: coffeepot
coffin: coffin
cognac: cognac
coiffeur: coiffeur
coiffure: coiffure
coil: coil,coils
coin: coin
coincide: coincides
cold: cold,colder,coldest
coldly: coldly
coldness: coldness
collar: collar,collars
colleague: colleague,colleagues
collect: collect,collected,collecting
collector: collector
college: college
collision: collision
colonel: colonel
colonize: colonize
color: color,colored,coloring,colors
colored: colored
colossal: colossal
colt: colt,colts
column: column,columns
comb: comb,combed,combing,combs
combine: combined,combining
comedy: comedy
comely: comely
comer: comers
comfort: comfort,comforted,comforting,comforts
comfortable: comfortable
comfortably: comfortably
comforter: comforter
comforting: comforting
comic: comic
comical: comical
comically: comically
coming: coming
command: command,commanding,commands
commander: commander
comme: comme
commemoration: commemoration
commencement: commencement
comment: comment,commented,comments
commercial: commercial
commingle: commingled
commis: commis
commiseration: commiseration
commission: commission,commissioned,commissions
commissionaire: commissionaire
commit: commit,committed
committee: committee,committees
commodity: commodity
common: common
commonly: commonly
commonplace: commonplace,commonplaces
communal: communal
commune: commune
communicate: communicate,communicated,communicating
communication: communication
communism: communism
communist: communist,communists
community: community
compact: compact
companion: companion,companions
companionship: companionship
company: companies,company
comparative: comparative
compare: compare,compared,comparing
comparison: comparison
compartment: compartment
compass: compass
compassion: compassion
compassionate: compassionate
compassionately: compassionately
compatriot: compatriot
compel: compelled
compensation: compensation
compete: competing
competitor: competitors
complacency: complacency
complacent: complacent
complacently: complacently
complain: complain,complained,complaining
complaint: complaint,complaints
complete: complete,completed,completing
completely: completely
completion: completion
complex: complex
complexion: complexion
complexity: complexity
compliance: compliance
complicate: complicate,complicated
complicated: complicated
complication: complication,complications
compliment: compliment
comply: complied
compose: compose,composed,composing
composedly: composedly
composer: composer
composite: composite
compost: compost
composure: composure
comprehend: comprehend,comprehended,comprehending
comprehensible: comprehensible
comprehension: comprehension
comprehensive: comprehensive
compress: compressed,compressing
compressibility: compressibility
compromise: compromise,compromised,compromising
compulsory: compulsory
comrade: comrade,comrades
comtesse: comtesse
conceal: conceal,concealed,concealing
concealment: concealment
conceit: conceit
conceited: conceited
conceivability: conceivability
conceive: conceive,conceived,conceiving
concentrate: concentrate,concentrated
concentrated: concentrated
concentration: concentration
conception: conception,conceptions
concern: concern,concerned,concerns
concerned: concerned
concert: concert
concession: concession,concessions
conciliation: conciliation
concise: concise
conclave: conclave
conclude: conclude,concluded
conclusion: conclusion,conclusions
conclusive: conclusive
conclusively: conclusively
condemn: condemn,condemned,condemning,condemns
condescending: condescending
condescendingly: condescendingly
condescension: condescension
condition: condition,conditions
condolence: condolences
conduce: conduce
conduct: conduct,conducted,conducting
conductor: conductor
confabulation: confabulations
confectioner: confectioner
confer: conferred
confess: confess,confessed,confessing
confession: confession
confide: confided,confiding
confidence: confidence,confidences
confident: confident
confidently: confidently
confine: confine,confined
confinement: confinement
confirm: confirm,confirmed,confirming
confirmation: confirmation
conflagration: conflagration
conflict: conflict
conform: conform
conformity: conformity
confound: confounded,confounding
confront: confronted,confronting
confuse: confused
confused: confused
confusing: confusing
confusion: confusion
congenial: congenial
congratulate: congratulate,congratulated,congratulating
congratulation: congratulation,congratulations
conjecture: conjecture,conjectures
conjunction: conjunction
conjure: conjured
connect: connect,connected,connecting
connection: connection,connections
connoisseur: connoisseur,connoisseurs
conquer: conquered,conquering
conquering: conquering
conqueror: conqueror
conquest: conquest
conscience: conscience
conscientious: conscientious
conscientiously: conscientiously
conscientiousness: conscientiousness
conscious: conscious
consciously: consciously
consciousness: consciousness
conscription: conscription
consecrate: consecrated
consecutive: consecutive
consent: consent,consented,consenting
consequence: consequence,consequences
consequent: consequent
consequential: consequential
conservative: conservative
considerable: considerable
considerably: considerably
consideration: consideration,considerations
consigne: consigne
consignment: consignment
consist: consist,consisted,consisting,consists
consistency: consistency
consistent: consistent
consolation: consolation
consolatory: consolatory
console: console,consoling
conspicuous: conspicuous
conspicuously: conspicuously
constance: constance
constant: constant
constantly: constantly
constatation: constatation
constitute: constitute,constituted
constitutional: constitutional
constrained: constrained
constraint: constraint
construct: construct,constructed,constructing
construction: construction
construe: construed
consult: consult,consulted,consulting
consultation: consultation
consumption: consumption
consumptive: consumptive
contact: contact
contemplate: contemplate,contemplating
contemplation: contemplation
contemporary: contemporaries,contemporary
contempt: contempt
contemptible: contemptible
contemptuous: contemptuous
contemptuously: contemptuously
contend: contend
content: content,contenting
contented: contented
contention: contention
contents: contents
contest: contest,contesting
continence: continence
contingency: contingencies,contingency
continual: continual
continually: continually
continue: continue,continued,continuing
continuity: continuity
continuous: continuous
continuously: continuously
contract: contract,contracted
contraction: contraction
contractor: contractor
contradict: contradicted,contradicting
contradiction: contradiction,contradictions
contradictory: contradictory
contradistinction: contradistinction
contralto: contralto
contrary: contrary
contrast: contrast
contravention: contravention
contribute: contribute,contributed
contrive: contrive
contrived: contrived
control: control,controlled,controlling
contumely: contumely
convalescence: convalescence
convalescent: convalescents
convenience: conveniences
convenient: convenient
conveniently: conveniently
conventional: conventional
conventionality: conventionality
conventionally: conventionally
conversation: conversation,conversations
converse: converse,conversed
convert: converted
converted: converted
convey: convey,conveyed
conveyance: conveyance
convict: convict,convicted
conviction: conviction,convictions
convince: convince,convinced,convinces
convinced: convinced
convincing: convincing
convincingly: convincingly
convulsively: convulsively
cook: cook,cooked
cookery: cookery
cool: cool,cooled,cooler,cooling
coolly: coolly
coolness: coolness
cooperate: cooperate
copper: copper
copse: copse
copyist: copyists
coquetry: coquetry
coquettishness: coquettishness
coral: coral
cord: cord,cords
cordelia: cordelia
cordial: cordial
cordiality: cordiality
cordially: cordially
cork: cork
corn: corn
corner: corner,corners
cornice: cornice,cornices
corps: corps
corpse: corpse
correct: correct,corrected
correction: correction,corrections
correctly: correctly
correctness: correctness
correspond: correspond,corresponded
correspondence: correspondence
corridor: corridor,corridors
corrupt: corrupt
corset: corset
corso: corso
cost: cost,costing,costs
costly: costly
costume: costume
coterie: coterie,coteries
cotillion: cotillion
cottage: cottage
cotton: cotton
couch: couch
cough: cough,coughed,coughing,coughs
council: council,councils
councilman: councilman
councilor: councilor
counsel: counsel,counsels
count: count,counted,counting
countenance: countenance
counter: counter
counterfeit: counterfeit
countess: countess
counting: counting
countinghouse: countinghouse
country: country
countryside: countryside
coup: coup
couple: couple,couples
courage: courage
courageously: courageously
courier: courier
court: court,courting,courts
courteously: courteously
courtesy: courtesy
courting: courting
courtship: courtship
courtyard: courtyard
cousin: cousin,cousins
couveuse: couveuse
covenant: covenant
cover: cover,covered,covering,covers
covered: covered
covering: coverings
coverlet: coverlet
covet: coveted
coveted: coveted
covey: covey
cow: cow,cows
coward: coward
cowardice: cowardice
cowherd: cowherd
cowhouse: cowhouse
cowman: cowman
cozy: cozy
crack: crack,cracked,cracking,cracks
crackle: crackled,crackling
cramp: cramped,cramps
crane: craned,cranes,craning
cranny: crannies
crash: crash,crashing
cravat: cravat,cravats
craving: craving
crawl: crawled,crawling,crawls
crazy: crazy
creak: creak,creaked,creaking
creaky: creaky
cream: cream
crease: crease
create: create,created,creating
creation: creation
creator: creator
creature: creature,creatures
credit: credit
creed: creeds
creep: crept
crescent: crescent
crest: crests
crestfallen: crestfallen
cretonne: cretonne
crime: crime
crimea: crimea
crimean: crimean
criminal: criminal,criminals
crimson: crimson,crimsoned,crimsoning
crimsoned: crimsoned
cringe: cringing
crinoline: crinolines
crisis: crisis
critic: critic,critics
critical: critical
criticism: criticism,criticisms
criticize: criticize,criticized,criticizing
crochet: crochet
crockery: crockery
crony: crony
crook: crook,crooking
crooked: crooked
crop: crop,cropped,crops
croquet: croquet
cross: cross,crossed,crosses,crossing
crossly: crossly
crossroads: crossroads
crossway: crossway
crouch: crouched
croup: croup
crow: crowing,crows
crowd: crowd,crowded,crowding,crowds
crowded: crowded
crown: crown,crowned,crowns
crucifix: crucifix
crude: crude
cruel: cruel,cruelest
cruelly: cruelly
cruelty: cruelties,cruelty
crumb: crumbs
crumble: crumble,crumbled,crumbling
crumple: crumpled,crumpling
crumpled: crumpled
crunch: crunching
crusade: crusade
crush: crush,crushed
crust: crust,crusted
crystal: crystal
crystallization: crystallization
crystallize: crystallized,crystallizing
cubic: cubic
cuckoo: cuckoo
cucumber: cucumber,cucumbers
cuff: cuff,cuffs
culprit: culprit,culprits
cultivate: cultivate,cultivated,cultivating
cultivation: cultivation
culture: culture,cultured
cunning: cunning
cup: cup,cups
cupboard: cupboard,cupboards
cupola: cupola
curb: curb
cure: cure,cured,curing
curiosity: curiosity
curious: curious
curl: curl,curled,curling,curls
curling: curling
curly: curly
currant: currant
current: current
curry: curried
curse: curse
curtain: curtain,curtains
curtsey: curtsey,curtseyed
curvature: curvature
curve: curve,curving
curved: curved
cushion: cushion
custom: custom,customs
customary: customary
customer: customer
cut: cut,cuts,cutting
cutlet: cutlet
cutter: cutter
cutting: cutting
cuttlefish: cuttlefish
cynical: cynical
da: das
dad: dad
daily: daily
daintily: daintily
dainty: dainty
dale: dale
dam: dam,dammed
damage: damage
dame: dame
damn: damn
damnation: damnation
damp: damp,dampest
dance: dance,danced,dances,dancing
dancer: dancer,dancers
dancing: dancing
dandified: dandified
dandle: dandled
dandy: dandy
danger: danger,dangers
dangerous: dangerous
dangerously: dangerously
dark: dark
darken: darkening
darkening: darkening
darkly: darkly
darkness: darkness
darling: darling
darn: darned,darns
dart: darted,darting
darts: darts
darya: darya
das: das
dash: dashed
datum: data
daughter: daughter,daughters
dawn: dawn
day: day,days
daybreak: daybreak
daydream: daydream,daydreams
daylight: daylight
daytime: daytime
daze: dazed
dazzle: dazzle,dazzled,dazzling
dazzling: dazzling
deacon: deacon
dead: dead
deaf: deaf
deal: deal,dealing
dealing: dealing
dearest: dearest
dearly: dearly
death: death
deathbed: deathbed
deathlike: deathlike
debauchery: debauchery
debt: debt,debts
decanter: decanter,decanters
decay: decay
decaying: decaying
deceit: deceit
deceitful: deceitful
deceive: deceive,deceived,deceiving
december: december
decembrist: decembrist
decent: decent
deception: deception
decide: decide,decided,deciding
decidedly: decidedly
decision: decision
decisive: decisive
decisively: decisively
deck: decked
declaim: declaimed
declaration: declaration
declare: declare,declared,declaring
decline: decline,declined
declivity: declivity
decorate: decorated
decoration: decoration
decorum: decorum
decrease: decrease,decreased
decree: decree,decrees
dedicate: dedicated
deduce: deduce,deduced,deducing
deduction: deductions
deed: deed,deeds
deem: deemed
deep: deep,deeper
deeply: deeply
defeat: defeat
defect: defect,defects
defective: defective
defend: defend,defended,defending
defense: defense
defensive: defensive
defer: defer
deference: deference
deferential: deferential
deferentially: deferentially
defiant: defiant
deficient: deficient
deficit: deficit
define: define,defined,defines
definite: definite
definiteness: definiteness
deft: deft
deftly: deftly
degenerate: degenerated,degenerating
degrading: degrading
degree: degree,degrees
deign: deigned,deigning,deigns
dejected: dejected
dejectedly: dejectedly
dejection: dejection
delay: delay,delayed,delays
deliberate: deliberate,deliberating
deliberately: deliberately
deliberation: deliberation
delicacy: delicacies,delicacy
delicate: delicate
delicious: delicious
deliciously: deliciously
delight: delight,delighted,delights
delighted: delighted
delightful: delightful
delightfully: delightfully
delinquent: delinquent
delirious: delirious
delirium: delirium
deliver: deliver,delivered,delivering
deliverance: deliverance
delivery: delivery
delusion: delusion
demain: demain
demand: demand,demanded,demanding,demands
demi: demi
demolish: demolish
demonstrate: demonstrating
demonstration: demonstrations
demur: demur
den: den
denote: denoted
densely: densely
density: density
dental: dental
deny: denied,deny,denying
depart: depart,departed,departing
department: department,departments
departure: departure
depend: depend,depended,depends
dependence: dependence
dependent: dependent
depict: depict
deplorable: deplorable
deportment: deportment
depraved: depraved
deprecating: deprecating
depress: depressed
depressed: depressed
depressing: depressing
depression: depression
deprive: deprive,deprived,depriving
depth: depth
depths: depths
deputation: deputation,deputations
depute: deputed
deputy: deputy
der: der
derange: deranged
derangement: derangement
derive: derived
dernier: dernier
derogatory: derogatory
des: des
descend: descend
descendant: descendant,descendants
description: description,descriptions
descry: descried
desecrate: desecrating
desert: desert,deserted
deserted: deserted
desertion: desertion
deserve: deserve,deserved
deserving: deserving
design: design,designs
designation: designation
desirable: desirable
desire: desire,desired,desires,desiring
desirous: desirous
desk: desk
despair: despair,despaired
despairing: despairing
despatch: despatched
desperate: desperate
desperately: desperately
desperation: desperation
despicable: despicable
despise: despise,despised,despises,despising
despondency: despondency
despondent: despondent
despondently: despondently
dessous: dessous
dessus: dessus
destination: destination,destinations
destine: destined
destiny: destiny
destroy: destroyed
destruction: destruction
destructive: destructive
det: detest
detailed: detailed
detain: detained,detaining
detect: detected,detecting
detection: detection
deteriorate: deteriorating
determination: determination
determine: determine,determined,determining
determined: determined
detest: detest
detestable: detestable
detract: detract
detriment: detriment
develop: develop,developed,developing
development: development,developments
deviation: deviation
device: devices
devil: devil
devilish: devilish
devise: devising
devoid: devoid
devoir: devoir
devote: devote,devoted,devotes
devoted: devoted
devotion: devotion
devour: devouring
devout: devout
devoutly: devoutly
dew: dew
dewy: dewy
dexterous: dexterous
dexterously: dexterously
diable: diable
diagonally: diagonally
diamond: diamond,diamonds
diana: diana
diary: diary
dickens: dickens
dictate: dictated,dictates
dictum: dictum
didactic: didactics
die: die,died,dies,dying
diet: diet
difference: difference,differences
difficult: difficult
difficulty: difficulties,difficulty
diffidently: diffidently
diffuse: diffused,diffusing
dig: dig
digest: digested
digestion: digestion
digestive: digestive
dignified: dignified
dignitary: dignitaries,dignitary
dignity: dignity
digression: digression
dilapidated: dilapidated
dilate: dilated
dilated: dilated
dilemma: dilemma
dilettante: dilettanti
dim: dim,dimmed
diminish: diminish,diminished
dimly: dimly
dimple: dimples
dine: dine,dined,dines,dining
ding: ding
dining: dining
dinner: dinner,dinners
dip: dip,dipping
diplomacy: diplomacy
diplomat: diplomat
diplomatic: diplomatic
dipper: dipper,dippers
direct: direct,directed,directing
direction: direction,directions
directness: directness
director: director,directors
dirt: dirt
dirtiness: dirtiness
dirty: dirty
disability: disabilities
disadvantage: disadvantages
disadvantageous: disadvantageous
disagree: disagreed
disagreeable: disagreeable
disagreeably: disagreeably
disagreement: disagreement,disagreements
disappear: disappear,disappeared,disappearing
disappoint: disappoint,disappointed
disappointment: disappointment,disappointments
disapprobation: disapprobation
disapproval: disapproval
disapprove: disapprove,disapproved,disapproves
disapproving: disapproving
disapprovingly: disapprovingly
disarrange: disarranging
disaster: disaster
disastrous: disastrous
disbelief: disbelief
disbelieve: disbelieve,disbelieved
discard: discarded
discern: discerned,discerning
discipline: discipline
disclose: disclose,disclosed
discomfit: discomfit
discomfort: discomfort
discomforting: discomforting
disconcert: disconcerted
disconcerted: disconcerted
disconcerting: disconcerting
disconnected: disconnected
disconnectedly: disconnectedly
disconnectedness: disconnectedness
disconsolately: disconsolately
discontentedly: discontentedly
discordant: discordant
discount: discount
discourse: discourse
discover: discover,discovered
discovery: discoveries,discovery
discreet: discreet
discreetly: discreetly
discretion: discretion
discuss: discuss,discussed,discussing
discussion: discussion,discussions
disdain: disdain,disdained
disease: diseases
disenchantment: disenchantment
disengage: disengaged,disengaging
disgrace: disgrace,disgracing
disgraced: disgraced
disgraceful: disgraceful
disguise: disguise,disguised,disguises
disgust: disgust
disgusted: disgusted
disgusting: disgusting
dish: dish,dishes
disheveled: disheveled
dishonest: dishonest
dishonesty: dishonesty
dishonorable: dishonorable
disillusion: disillusion
disinclination: disinclination
disinclined: disinclined
disjointed: disjointed
dislike: dislike,disliked,dislikes
dismay: dismay,dismayed
dismayed: dismayed
dismiss: dismiss,dismissed,dismissing
dismissal: dismissal,dismissals
dismount: dismounted
disobedient: disobedient
disorder: disorder
disorderly: disorderly
disorganized: disorganized
disown: disown,disowned
dispel: dispel
dispensary: dispensaries,dispensary
display: display
displease: displeased
displeased: displeased
displeasure: displeasure
disposal: disposal
dispose: disposed
disposed: disposed
disposition: disposition
disproportionate: disproportionate
disputant: disputants
dispute: dispute,disputed,disputes,disputing
disquisition: disquisition,disquisitions
disregard: disregard,disregarded
disreputable: disreputable
disrespectfully: disrespectfully
dissatisfaction: dissatisfaction
dissatisfied: dissatisfied
dissension: dissension
dissent: dissent
dissipate: dissipate,dissipated,dissipating
dissolute: dissolute
dissolve: dissolving
dissuade: dissuade
distance: distance
distant: distant
distaste: distaste
distasteful: distasteful
distinct: distinct
distinction: distinction,distinctions
distinctive: distinctive
distinctly: distinctly
distinctness: distinctness
distinguish: distinguish,distinguished,distinguishing
distinguished: distinguished
distort: distort,distorted
distortion: distortion
distract: distract,distracted,distracting
distraction: distraction,distractions
distraught: distraught
distress: distress
distressed: distressed
distressing: distressing
distribute: distributed,distributing
distribution: distribution
distributor: distributors
district: district,districts
disturb: disturb,disturbed
disturbance: disturbance
disturbed: disturbed
disturbing: disturbing
ditch: ditch,ditches
diva: diva
divan: divan
diverge: diverging
diverse: diverse
diversion: diversion
divert: divert,diverted,diverting
divide: divide,divided,dividing
divine: divine,divined,divining
divinity: divinity
division: division
divorce: divorce,divorced,divorces
divorced: divorced
dix: dix
dock: dock
doctor: doctor,doctored,doctoring,doctors
doctoring: doctoring
doctrine: doctrine,doctrines
document: documents
dodge: dodged
dog: dog,dogged,dogs
dogcart: dogcarts
dogged: dogged
doggedly: doggedly
dogma: dogmas
doings: doings
doll: doll,dolls
dolly: dolly
domain: domain
domestic: domestic
door: door,doors
doorkeeper: doorkeeper
doorway: doorway
dose: dose
dost: dost
dot: dotted
double: double
doubly: doubly
doubt: doubt,doubted,doubting,doubts
doubtfully: doubtfully
doubtless: doubtless
dough: dough
dove: dove,doves
dovelike: dovelike
downcast: downcast
downhill: downhill
downpour: downpour
downstairs: downstairs
downy: downy
dowry: dowry
doze: doze,dozed,dozing
dozen: dozen,dozens
drag: drag,dragged,dragging,drags
dram: dram
drama: drama
draper: draper
draw: draw,drawing,drawn,drew
drawback: drawback,drawbacks
drawer: drawer,drawers
drawing: drawing
drawl: drawling
dray: dray
dread: dread,dreaded,dreading
dreaded: dreaded
dreadful: dreadful
dreadfully: dreadfully
dream: dream,dreamed,dreaming,dreams
dreamily: dreamily
dreamy: dreamy
dreariness: dreariness
dreary: dreariest,dreary
drench: drenched
drenching: drenching
dress: dress,dressed,dresses,dressing
dressed: dressed
dresser: dresser
dressing: dressing
dressmaker: dressmaker
drift: drift,drifting
drill: drill,drills
drink: drank,drink,drinking,drinks,drunk
drinking: drinking
drip: drip
drive: drive,driven,drives,driving,drove
driver: driver,drivers
droll: droll
droop: droop,drooped,drooping
drooping: drooping
drop: drop,dropped,dropping,drops
drown: drown,drowned,drowning
drowsy: drowsy
drudgery: drudgery
drugstore: drugstores
drum: drum
drunk: drunk
drunkard: drunkard,drunkards
drunken: drunken
drunkenness: drunkenness
dry: dried,dry,drying
drying: drying
dryly: dryly
dryness: dryness
du: du
dubious: dubious
duc: duc
duchess: duchess
duck: duck,ducks
duel: duel,dueling
duet: duets
dull: dull,dullest
duly: duly
dumb: dumb
dumbbell: dumbbells
dung: dung
duplicity: duplicity
duration: duration
dusk: dusk
dusky: dusky
dust: dust
dustman: dustmen
dusty: dusty
dutch: dutch
dutiful: dutiful
duty: duties,duty
dwell: dwelling,dwelt
dyed: dyed
dying: dying
ea: ea
eager: eager
eagerly: eagerly
eagerness: eagerness
eagle: eagle
ear: ear,ears
eared: eared
earn: earn,earning
earnest: earnest
earnestly: earnestly
earnestness: earnestness
earring: earrings
earth: earth,earthed
earthly: earthly
ease: ease
easel: easel
easily: easily
east: east
easter: easter
eastern: eastern
easy: easier,easiest,easy
eat: ate,eat,eaten,eating,eats
eating: eating
eccentric: eccentric
ecclesiastical: ecclesiastical
echo: echo,echoed
economic: economic
economist: economists
economy: economy
ecstasy: ecstasies,ecstasy
ecstatic: ecstatic
ecstatically: ecstatically
edge: edge,edged,edges,edging
edible: edible
edification: edification
educate: educate,educated
education: education
educational: educational
eel: eel
effective: effective
effectual: effectual
effeminate: effeminate
effervescing: effervescing
efficient: efficient
effort: effort,efforts
effrontery: effrontery
egg: eggs
egoism: egoism
egoistic: egoistic
egyptian: egyptian
eighteen: eighteen
eighth: eighth
eject: ejected
elaborate: elaborate
elastic: elastic
elasticity: elasticity
elation: elation
elbow: elbow,elbows
eld: elder,eldest
elder: elder,elders
elderly: elderly
elect: elect,elected,electing
election: election,elections
electric: electric
electricity: electricity
elegance: elegance
elegant: elegant
elegantly: elegantly
element: element,elements
elemental: elemental
elephant: elephant
elevate: elevated
elevated: elevated
elevation: elevation
elicit: elicit
eligible: eligible
elk: elks
elle: elle
elliot: elliot
ellipse: ellipse
elm: elm
eloquent: eloquent
elucidate: elucidate
elude: eluded
emaciated: emaciated
emaciation: emaciation
emancipation: emancipation
embarrassed: embarrassed
embarrassing: embarrassing
embarrassment: embarrassment
embittered: embittered
embodiment: embodiment
embody: embodied
embrace: embrace,embraced,embraces,embracing
embroider: embroidered
embroidery: embroidery
emerald: emerald
emerge: emerge
emergency: emergency
emmet: emmets
emotion: emotion,emotions
emotional: emotional
emotionalism: emotionalism
emperor: emperor
emphasis: emphasis
emphasize: emphasized,emphasizing
emphatically: emphatically
empire: empire
employ: employed
employer: employer
empower: empowered
en: en
enable: enable
enact: enacted
enchain: enchained
enchant: enchanted,enchants
enchanted: enchanted
enchanting: enchanting
enchantment: enchantment
encircle: encircle,encircled
enclose: enclose,enclosed
encompass: encompassed,encompassing
encore: encore
encounter: encounters
encourage: encouraged,encouraging
encouragement: encouragement
encouraging: encouraging
encouragingly: encouragingly
encroach: encroaching
endeavor: endeavored,endeavoring,endeavors
endless: endless
endow: endow,endowed
endurance: endurance
endure: endure,endured,enduring
enemy: enemies,enemy
energetic: energetic
energetically: energetically
energy: energies,energy
enervated: enervated
enfant: enfant
enfants: enfants
engage: engage,engaged,engaging
engaged: engaged
engagement: engagement
engine: engine
engineer: engineer,engineers
england: england
english: english
englishman: englishman,englishmen
englishwoman: englishwoman
engouement: engouement
engraving: engravings
engross: engrossed
engrossed: engrossed
engrossing: engrossing
enigma: enigma
enigmatic: enigmatic
enjoin: enjoined
enjoy: enjoy,enjoyed,enjoying,enjoys
enjoyable: enjoyable
enjoyment: enjoyment
enlarge: enlarge,enlarged,enlarging
enlighten: enlightened
enlightened: enlightened
enlightenment: enlightenment
ennui: ennui
enoch: enoch
enormous: enormous
enormously: enormously
enos: enos
enrich: enrich,enriched
ensue: ensuing
enter: enter,entered,entering,enters
enterprise: enterprise
entertain: entertain,entertained,entertaining
entertainment: entertainment,entertainments
enthusiasm: enthusiasm
enthusiast: enthusiast
enthusiastic: enthusiastic
enthusiastically: enthusiastically
entice: enticing
entrance: entrance
entrancing: entrancing
entreat: entreat
entreaty: entreaties,entreaty
entrez: entrez
entrust: entrusted
entry: entry
enumerate: enumerating
enunciate: enunciated
envelop: enveloped
envelope: envelope
envious: envious
enviously: enviously
envy: envied,envies,envy
epaulet: epaulet,epaulets
epigram: epigram
episode: episode
epistle: epistle
equable: equable
equal: equal,equals
equally: equally
equation: equation
equerry: equerry
equivalent: equivalent
eradicate: eradicating
erase: erase
erect: erect
errand: errand
erroneousness: erroneousness
error: error,errors
escape: escape,escaped,escaping
eschew: eschewed
escort: escort,escorted,escorting
especial: especial
essential: essential
essentially: essentially
est: est
establish: established,establishing
estate: estate,estates
esteem: esteem
estimate: estimate
estimation: estimation
estrange: estrange
estrangement: estrangement
eternal: eternal
eternity: eternity
ethical: ethical
ethnographic: ethnographic
ethnographical: ethnographical
etiquette: etiquette
europe: europe
european: european
evade: evaded,evading
eve: eve
evening: evening,evenings
event: event,events
eventuality: eventualities
everlasting: everlasting
everyday: everyday
evidence: evidence
evident: evident
evidently: evidently
evil: evil,evils
evoke: evoked
evolution: evolution
exact: exact,exacted
exacting: exacting
exaggerate: exaggerate,exaggerating
exaggerated: exaggerated
exaggeration: exaggeration
exalt: exalted,exalting
examination: examination
examine: examine,examined,examining
exasperate: exasperate,exasperated,exasperating
exasperated: exasperated
exasperation: exasperation
exceedingly: exceedingly
excellency: excellency
excellent: excellent
exception: exception,exceptions
exceptional: exceptional
exceptionally: exceptionally
excess: excess
excessive: excessive
excessively: excessively
exchange: exchange,exchanged,exchanging
excitability: excitability
excite: excite,excited
excited: excited
excitedly: excitedly
excitement: excitement
exciting: exciting
exclaim: exclaimed
exclamation: exclamations
exclude: excludes,excluding
exclusively: exclusively
excursion: excursion
excuse: excuse,excused,excuses,excusing
execution: execution
exemplary: exemplary
exercise: exercise,exercised,exercises
exert: exert,exerted
exertion: exertion
exhaust: exhaust,exhausted,exhausting
exhausted: exhausted
exhaustion: exhaustion
exhibition: exhibition,exhibitions
exhilarate: exhilarating
exhortation: exhortation
exile: exile
exist: exist,existed,existing,exists
existence: existence
exonerate: exonerate
exorcise: exorcise
expanse: expanses
expect: expect,expected,expecting,expects
expectation: expectation,expectations
expedition: expedition
expel: expelled
expend: expended
expenditure: expenditure,expenditures
expense: expense,expenses
expensive: expensive
experience: experience,experienced,experiences,experiencing
experienced: experienced
experiment: experiment,experiments
expert: expert
expiate: expiate,expiated
explain: explain,explained,explaining,explains
explanation: explanation,explanations
explode: exploded
exploit: exploiting
exploration: exploration
explore: exploring
expose: expose,exposed
exposition: exposition
expound: expound,expounded,expounding
express: express,expressed,expressing
expression: expression,expressions
expressive: expressive
expressly: expressly
exquisite: exquisite
extended: extended
extent: extent
exterior: exterior
external: external
externally: externally
extinguish: extinguish,extinguished,extinguishing
extol: extolling
extra: extra
extract: extract,extracted,extracts
extraneous: extraneous
extraordinarily: extraordinarily
extraordinary: extraordinary
extravagance: extravagance
extreme: extreme,extremes
extremely: extremely
extremity: extremity
extricate: extricate,extricating
eye: eye,eyeing,eyes
eyebrow: eyebrows
eyed: eyed
eyelash: eyelashes
eyelid: eyelid,eyelids
eyewitness: eyewitnesses
fable: fable
faced: faced
facetious: facetious
facility: facilities,facility
factor: factor
factory: factory
faculty: faculties,faculty
fade: faded
faggot: faggot
fagot: fagots
fail: fail,failed,failing
failing: failings
failure: failure,failures
faint: faint,fainter,faintest,fainting
faintly: faintly
fair: fair
faire: faire
fairness: fairness
fairy: fairy
fairyland: fairyland
fait: fait
faith: faith
faithful: faithful
faithless: faithless
fall: fall,fallen,falling,falls,fell
fallen: fallen
fallow: fallow
false: false
falsehood: falsehood,falsehoods
falsely: falsely
falsity: falsity
falter: falter,faltering
fame: fame
familiar: familiar
familiarity: familiarity
family: families,family
famished: famished
famous: famous
fan: fan,fanned
fancy: fancied,fancies,fancy,fancying
fanny: fanny
fantasia: fantasia
fantastic: fantastic
fantasy: fantasies
farce: farce
fare: fare,fares
farewell: farewell
farinaceous: farinaceous
farm: farm,farming
farmer: farmer,farmers
farmhouse: farmhouse
farming: farming
farmyard: farmyard
farthing: farthing
fascinate: fascinated
fascinated: fascinated
fascinating: fascinating
fascination: fascination
fashion: fashion,fashions
fashionable: fashionable
fashionably: fashionably
fashioned: fashioned
fast: fast,faster,fasts
fasten: fasten,fastened,fastening
fastidious: fastidious
fasting: fasting
fat: fat
fatal: fatal
fatality: fatality
fatally: fatally
fate: fate,fated
father: father,fathers
fatherland: fatherland
fatherly: fatherly
fatigue: fatigue
fault: fault,faults
faut: faut
favor: favor
favorable: favorable
favorably: favorably
favorite: favorite,favorites
fear: fear,feared,fearing,fears
fearful: fearful
fearfully: fearfully
feasibility: feasibility
feast: feasts
feat: feats
feather: feather,feathers
feathery: feathery
feature: feature,features
february: february
fee: fees
feeble: feeble
feebleness: feebleness
feebly: feebly
feed: fed,feed,feeding
feel: feel,feeling,feels
feeling: feeling,feelings
feign: feign,feigned,feigning
fellow: fellow,fellows
female: female
feminine: feminine
femme: femme
fence: fence,fenced,fences
fer: fer
ferret: ferreting,ferrets
fervently: fervently
fervor: fervor
festive: festive
festively: festively
festivity: festivities
fetch: fetch,fetched,fetching
feud: feud
fever: fever
feverish: feverish
fickle: fickle
fictitious: fictitious
fiddle: fiddles
fidelity: fidelity
fidget: fidgeting
fidgety: fidgety
field: field,fields
fiend: fiend
fifteenth: fifteenth
fight: fight,fighting,fights,fought
fighting: fighting
figure: figure,figured,figures
filbert: filbert
filch: filch
file: file
filial: filial
filter: filtered
filth: filth
filthy: filthy
fin: fin
final: final
finally: finally
finance: finance
finances: finances
financial: financial
finding: finding
fine: fine,finest
fineness: fineness
finesse: finesses
finger: finger,fingering,fingers
finish: finish,finished,finishes,finishing
finished: finished
finnish: finnish
fireplace: fireplaces
firm: firm,firmer,firmest
firmament: firmament
firmly: firmly
firmness: firmness
fish: fish
fishing: fishing
fishmonger: fishmonger
fist: fist,fists
fit: fit,fits,fitted,fitting
fitting: fitting,fittings
fittingly: fittingly
fixed: fixed
fixedly: fixedly
flag: flag,flagged,flagging,flags
flagstone: flagstones
flame: flame,flaming
flare: flare,flared
flash: flash,flashed,flashes,flashing
flat: flat,flatter
flatiron: flatirons
flatter: flattered
flattering: flattering
flattery: flattery
flavor: flavor
flaxen: flaxen
flay: flay
fleck: flecked
fledged: fledged
flee: fleeing
fleecy: fleecy
fleeting: fleeting
flesh: flesh
fleshless: fleshless
fleshly: fleshly
fleshy: fleshy
flicker: flickered,flickering
flight: flight
fling: fling,flinging,flung
flint: flints
flirt: flirted,flirting
flirtation: flirtation
flit: flitted,flitting
flitch: flitch
float: float,floated,floating
flock: flock,flocked
flog: flog
flood: flood,flooded,flooding
floodgate: floodgates
floor: floor,floors
flounce: flounce,flounces
flounder: floundering
flour: flour
flourish: flourishing
flow: flow,flowed,flowing
flower: flower,flowered,flowers
flowering: flowering
fluent: fluent
fluently: fluently
flurry: flurried
flush: flush,flushed,flushing
flushing: flushing
flutter: fluttered,fluttering
fly: flew,flies,flown,fly,flying
flying: flying
foam: foaming
fodder: fodder
foe: foe
fog: fog
foist: foisting
fold: fold,folded,folding,folds
folding: folding
foliage: foliage
folk: folk,folks
follow: follow
follower: followers
folly: folly
fond: fond
fondant: fondant
food: food
fool: fool,fools
fooling: fooling
foolish: foolish
foolishness: foolishness
foot: feet,foot
footboard: footboard
foothold: foothold
footing: footing
footlights: footlights
footman: footman,footmen
footpath: footpath
footstep: footsteps
forage: forage
forbid: forbade,forbid,forbidden,forbidding
force: force,forced,forces,forcing
forcibly: forcibly
fore: fore
forecast: forecasts
forefinger: forefinger
forego: forego
foregone: foregone
foreground: foreground
forehead: forehead
foreign: foreign
foreigner: foreigner
foremost: foremost
forepart: forepart
forepaw: forepaws
foresee: foresaw,foresee,foreseeing,foreseen
foreshortened: foreshortened
forest: forest
foretell: foretold
forget: forget,forgetting,forgot,forgotten
forgetfulness: forgetfulness
forgive: forgave,forgive,forgiven,forgives,forgiving
forgiveness: forgiveness
fork: fork,forks
forkful: forkfuls
form: form,formed,forming,forms
formal: formal
formality: formalities,formality
formation: formation
formidable: formidable
formulate: formulated
forsake: forsake,forsaken
forthcoming: forthcoming
fortify: fortifying
fortnight: fortnight
fortunate: fortunate
fortune: fortune,fortunes
forwards: forwards
foul: foul
foundation: foundation
founder: founder
foundling: foundling
fourpence: fourpence
fourteen: fourteen
fourth: fourth
fourthly: fourthly
fowl: fowls
foyer: foyer
fraction: fraction
fragment: fragment
fragmentary: fragmentary
fragrance: fragrance
fragrant: fragrant
frame: frame,frames,framing
framework: framework
france: france
frank: frank
frankfort: frankfort
franklin: franklin
frankly: frankly
frankness: frankness
frantically: frantically
fraud: fraud
freak: freaks
freedom: freedom
freely: freely
freeze: frozen
freezing: freezing
french: french
frenchman: frenchman
frenchwoman: frenchwoman
frenzy: frenzy
frequent: frequent
frequently: frequently
fresco: frescoes
fresh: fresh,fresher
freshen: freshen
freshened: freshened
freshly: freshly
freshness: freshness
fret: fret,fretted,fretting
friday: friday
friend: friend,friends
friendliness: friendliness
friendly: friendly
friendship: friendship,friendships
fright: fright
frighten: frighten,frightened,frightens
frightened: frightened
frightening: frightening
frigid: frigid
frigidly: frigidly
frill: frills
fringe: fringed
fringed: fringed
frippery: frippery
frisk: frisked
frivolity: frivolity
frivolous: frivolous
fro: fro
frock: frock,frocks
frog: frogs
frolic: frolicked
frost: frost
frosty: frosty
froth: frothing
frown: frown,frowned,frowning
frowning: frowning
frozen: frozen
fruit: fruit,fruits
fruitful: fruitful
fruitfulness: fruitfulness
fruitless: fruitless
fruitlessly: fruitlessly
fulfil: fulfilled,fulfilling
fulfillment: fulfillment
fulness: fulness
fumble: fumbled,fumbling
fume: fumes
fun: fun
function: function,functions
functionary: functionaries,functionary
fund: fund
fundamental: fundamental
funeral: funeral
fungus: fungus,funguses
funnel: funnel
funny: funny
fur: fur
furious: furious
furnish: furnish,furnished
furniture: furniture
furrow: furrows
fury: fury
fuss: fuss,fussing
futile: futile
future: future
gadfly: gadflies
gaiety: gaiety
gaily: gaily
gain: gain,gained,gaining,gains
gait: gait
gaiter: gaiters
gallant: gallant,gallants
gallantly: gallantly
gallery: galleries,gallery
gallop: gallop,galloped,galloping
galosh: galoshes
gambetta: gambetta
gambler: gambler
gambling: gambling
game: game
gang: gang
gap: gap
gape: gaping
garden: garden,gardens
gardener: gardener,gardeners
gardens: gardens
garment: garment,garments
garnett: garnett
garnish: garnish
gas: gas
gasp: gasped,gasping,gasps
gate: gate,gates
gatepost: gatepost
gather: gathered,gathering
gathering: gathering
gay: gay
gaze: gaze,gazed,gazing
gazette: gazette
gelding: gelding
gem: gem
generality: generalities
generalization: generalization
generation: generation,generations
generosity: generosity
generous: generous
genial: genial
genially: genially
genre: genre
gentil: gentil
gentle: gentle
gentlefolk: gentlefolks
gentleman: gentleman,gentlemen
gentlemanly: gentlemanly
gentleness: gentleness
gentlewoman: gentlewoman
gently: gently
gentry: gentry
genuine: genuine
genuinely: genuinely
geometrical: geometrical
german: german,germans
germany: germany
gesticulate: gesticulated
gesture: gesture,gestures
ghost: ghost
giddy: giddy
gift: gift
gifted: gifted
giggle: giggle
gilded: gilded
gilt: gilt
girl: girl,girls
girlish: girlish
girth: girth
glace: glace
glad: glad
gladden: gladdened
glade: glade
gladiator: gladiator,gladiators
gladly: gladly
gladness: gladness
glance: glance,glanced,glances,glancing
glare: glare,glaring
glaring: glaring
glass: glass,glasses
glassful: glassful
gleam: gleam,gleamed,gleaming,gleams
glee: glee
gleeful: gleeful
gleefully: gleefully
glide: glided
glimpse: glimpse,glimpses
glisten: glistened,glistening
glitter: glitter,glittered,glittering
gloomily: gloomily
gloominess: gloominess
gloomy: gloomy
glorify: glorified
glory: glory
gloss: gloss
glossy: glossy
glove: glove,gloves
gloved: gloved
glow: glow,glowed,glowing
glowing: glowing
glue: glued
gnarl: gnarled
gnaw: gnawing
goal: goal
goblin: goblins
god: god
godfather: godfather
godly: godly
godmother: godmother
godsend: godsend
goffer: goffered
gold: gold
golden: golden
goodness: goodness
goodwill: goodwill
goose: geese,goose
gore: gore
gorgeous: gorgeous
gospel: gospel
gossip: gossip,gossiped
govern: governing
governess: governess
government: government
governmental: governmental
governor: governor,governors
gown: gown
grace: grace,graces
graceful: graceful
gracious: gracious
graciously: graciously
grade: grade
gradually: gradually
graft: grafted
grain: grain,grains
grammar: grammar
granary: granary
grand: grand
grandchild: grandchild,grandchildren
granddaughter: granddaughter
grande: grande
grandeur: grandeur
grandfather: grandfather
grandmamma: grandmamma
grandson: grandson
granny: granny
grant: grant,granted,grants
grasp: grasp,grasped,grasping
grass: grass
grassland: grasslands
grassy: grassy
grateful: grateful
gratefully: gratefully
gratification: gratification
gratify: gratify
grating: gratings
gratitude: gratitude
grave: grave
gravel: gravel
gravely: gravely
gravity: gravity
gray: gray,grays
grayish: grayish
graze: grazed,grazing
grease: grease
greatly: greatly
greatness: greatness
greedily: greedily
greediness: greediness
greedy: greedy
green: green,greener,greens
greenish: greenish
greet: greet,greeted,greeting
greeting: greeting
gretchen: gretchen
grief: grief,griefs
grievance: grievance
grieve: grieve
grieving: grieving
grim: grim
grime: grimed
grimm: grimm
grin: grin,grinned
grip: gripped,gripping
grizzled: grizzled
groan: groaned,groaning,groans
groom: groom,groomed
gross: gross,grossest
grotesque: grotesque
ground: ground,grounded
groundless: groundless
grounds: grounds
grouse: grouse
grow: grew,grow,growing,grown,grows
growing: growing
grown: grown
growth: growth
grudge: grudge,grudged
gruff: gruff
grumble: grumble
guarantee: guarantee
guard: guard,guarded,guards
guardianship: guardianship
guards: guards
guess: guess,guessed,guesses,guessing
guest: guest,guests
guidance: guidance
guide: guide,guided,guiding
guidebook: guidebook
guile: guile
guileless: guileless
guilt: guilt
guilty: guilty
guipure: guipure
gulf: gulf
gulp: gulp,gulping
gun: gun,guns
gush: gush,gushed
gusset: gussets
gust: gusts
guttural: guttural
gymnast: gymnast
gymnastic: gymnastic
gymnastics: gymnastics
gypsies: gypsies
gypsy: gypsies,gypsy
ha: ha
habit: habit,habits
habitual: habitual
habitually: habitually
hack: hack,hacks
haggle: haggle,haggling
hail: hail
hailstone: hailstones
hair: hair,hairs
haired: haired
hairpin: hairpins
hairy: hairy
halfheartedly: halfheartedly
halfpence: halfpence
halfpenny: halfpenny
halfway: halfway
hall: hall
halt: halt,halted
hamburg: hamburg
hammer: hammer
hand: hand,handed,handing,hands
handbag: handbag
handedness: handedness
handful: handfuls
handiwork: handiwork
handkerchief: handkerchief,handkerchiefs
handle: handle,handling
handsome: handsome
handsomely: handsomely
handsomer: handsomer
handwriting: handwriting
hang: hang,hanging,hung
hanging: hangings
happen: happen,happened,happening
happily: happily
happiness: happiness
happy: happier,happiest,happy
harass: harassed,harassing
hard: hard,harder
hardness: hardness
hardship: hardships
hare: hare
harem: harem
harm: harm
harmful: harmful
harmless: harmless
harmoniously: harmoniously
harmonize: harmonized
harmony: harmony
harness: harness,harnessed,harnessing
harrow: harrows
harrowing: harrowing
harsh: harsh
harvest: harvest
harvesting: harvesting
hast: hast
haste: haste
hasten: hastened
hastily: hastily
hasty: hasty
hat: hat,hats
hatch: hatching
hate: hate,hated,hates,hating
hateful: hateful
hatred: hatred
hatstand: hatstand
hatt: hatt
haughtily: haughtily
haughtiness: haughtiness
haughty: haughty
haunch: haunch
haunt: haunted,haunting
hawk: hawk,hawking,hawks
hawklike: hawklike
hay: hay
haycock: haycock,haycocks
haying: haying
haymaker: haymakers
haystack: haystacks
hazard: hazarded,hazards
haze: haze
hazel: hazel
head: head,headed,heads
headache: headache
headed: headed
heal: healed
health: health
healthy: healthy
heap: heap,heaped,heaping,heaps
hear: hear,heard,hearing,hears
hearing: hearing
hearsay: hearsay
heart: heart,hearts
hearted: hearted
heartedly: heartedly
heartedness: heartedness
heartfelt: heartfelt
hearth: hearth
heartily: heartily
heartless: heartless
hearty: hearty
heat: heat,heated
heated: heated
heating: heating
heave: heaved
heaven: heaven,heavens
heavenly: heavenly
heavens: heavens
heavenwards: heavenwards
heavily: heavily
heaviness: heaviness
heaving: heaving
heavy: heavier,heavy
hedge: hedge,hedges
heed: heed
heedless: heedless
heedlessly: heedlessly
heedlessness: heedlessness
heel: heel,heels
heeled: heeled
height: height,heights
heighten: heighten
heir: heir,heirs
helen: helen
helmet: helmet,helmets
helpless: helpless
helplessly: helplessly
helplessness: helplessness
helpmeet: helpmeet
hemp: hemp
hen: hen,hens
herb: herb,herbs
herd: herd,herding
herdsman: herdsman
hermitage: hermitage
hero: hero,heroes
heroine: heroine
herring: herrings
hesitate: hesitate,hesitated,hesitating
hesitatingly: hesitatingly
hesitation: hesitation
hey: hey
heyday: heyday
hidden: hidden
hide: hidden,hide,hiding
hideous: hideous
hideousness: hideousness
hiding: hiding
hierarchy: hierarchy
hieroglyphic: hieroglyphics
highly: highly
highness: highness
highroad: highroad,highroads
hill: hills
hillock: hillock,hillocks
hills: hills
hillside: hillside
hind: hind
hinder: hinder,hindered,hindering
hindrance: hindrance,hindrances
hint: hint,hinted,hinting,hints
hip: hips
hippopotamus: hippopotamus
hire: hire,hired,hiring
hiss: hiss,hissed
historian: historian,historians
historical: historical
historically: historically
history: history
hit: hit,hits,hitting
hitch: hitch
hitherto: hitherto
hive: hive
hoarfrost: hoarfrost
hoarse: hoarse
hoarsely: hoarsely
hobble: hobbled
hobby: hobby
hoeing: hoeing
hold: held,hold,holding,holds
holder: holder
holding: holding
hole: hole,holes
holiday: holiday,holidays
hollow: hollow,hollowed,hollows
holy: holy
homely: homely
homespun: homespun
homeward: homeward
homewards: homewards
homme: homme
honest: honest
honestly: honestly
honesty: honesty
honeymoon: honeymoon
honor: honor,honors
honorable: honorable
hood: hood
hoof: hoof,hoofs
hook: hook,hooked,hooking,hooks
hoop: hoop
hoot: hooted
hope: hope,hoped,hopes,hoping
hopeful: hopeful
hopeless: hopeless
hopelessly: hopelessly
hopelessness: hopelessness
horn: horns
horrible: horrible
horribly: horribly
horrid: horrid
horrified: horrified
horrify: horrified
horror: horror,horrors
horse: horse,horses
horseback: horseback
horsecloth: horsecloth,horsecloths
horseman: horsemen
hospitable: hospitable
hospitably: hospitably
hospital: hospital
hospitality: hospitality
host: host,hosts
hostess: hostess
hostile: hostile
hostilely: hostilely
hostility: hostility
hot: hot
hotel: hotel,hotels
hotly: hotly
hound: hounds
hour: hour,hours
house: house,houses
household: household
housekeeper: housekeeper
housekeeping: housekeeping
housewife: housewife
housing: housing
hover: hovering
howl: howls
huddle: huddled
hue: hue
hug: hug,hugging
huge: huge,huger
hugely: hugely
hum: hum,hummed,humming
human: human
humanity: humanity
humble: humble,humbles
humbly: humbly
humbug: humbug
humbugging: humbugging
humiliate: humiliate,humiliated
humiliating: humiliating
humiliatingly: humiliatingly
humiliation: humiliation,humiliations
humility: humility
humor: humor,humored
humored: humored
humorous: humorous
humorously: humorously
hundredth: hundredth
hunger: hunger
hungrily: hungrily
hungry: hungry
hunt: hunt,hunted,hunting,hunts
hunting: hunting
hurdle: hurdles
hurrah: hurrah
hurried: hurried
hurriedly: hurriedly
hurry: hurried,hurry,hurrying
hurt: hurt,hurting,hurts
husband: husband,husbands
husbandry: husbandry
hush: hush,hushed,hushes,hushing
hushing: hushing
husky: husky
hussar: hussar,hussars
hut: hut
hydra: hydra
hygienic: hygienic
hypocrisy: hypocrisy
hypocritical: hypocritical
hypocritically: hypocritically
ice: ice
iced: iced
ich: ich
idea: idea,ideas
ideal: ideal,ideals
identical: identical
idiocy: idiocy
idiomatic: idiomatic
idiot: idiot
idiotic: idiotic
idle: idle
idleness: idleness
idly: idly
idyllic: idyllic
ignorance: ignorance
ignorant: ignorant
ignore: ignore
illegitimate: illegitimate
illicit: illicit
illiterate: illiterate
illness: illness,illnesses
illogical: illogical
illusion: illusion
illustrate: illustrate
illustration: illustration,illustrations
image: image,images
imaginary: imaginary
imagination: imagination
imagine: imagine,imagined,imagines,imagining
imagining: imaginings
imbecile: imbecile
imitate: imitate,imitated,imitating
imitation: imitation,imitations
immaterial: immaterial
immense: immense
immoral: immoral
immorality: immorality
immortality: immortality
immovably: immovably
impalpable: impalpable
impassable: impassable
impassioned: impassioned
impatience: impatience
impatient: impatient
impatiently: impatiently
impel: impelled
impending: impending
impenetrable: impenetrable
imperceptible: imperceptible
imperceptibly: imperceptibly
imperial: imperial
imperious: imperious
impersonal: impersonal
impertinence: impertinence
implacable: implacable
implant: implanting
implement: implement,implements
implicate: implicated
implore: implore,implored,implores,imploring
imploringly: imploringly
imply: implied,imply
import: import,imported
impose: impose,imposing
imposing: imposing
impossibility: impossibility
impossible: impossible
impossibly: impossibly
impoverished: impoverished
impoverishing: impoverishing
impoverishment: impoverishment
impracticable: impracticable
impress: impress,impressed
impressed: impressed
impression: impression,impressions
imprint: imprinted
imprison: imprisoned
improper: improper
improperly: improperly
impropriety: impropriety
improve: improve,improved,improving
improved: improved
improvement: improvement,improvements
imprudence: imprudence
impudent: impudent
impulse: impulse
impulsive: impulsive
impulsively: impulsively
impunity: impunity
impurity: impurities
inability: inability
inaccessible: inaccessible
inactivity: inactivity
inane: inane
inapplicable: inapplicable
inappropriate: inappropriate
inappropriately: inappropriately
inaudible: inaudible
inborn: inborn
incapable: incapable
incapacity: incapacity
incarnation: incarnation
incautiously: incautiously
incense: incensed
incensed: incensed
incessant: incessant
incessantly: incessantly
incident: incident,incidents
incidental: incidental
incidentally: incidentally
incitement: incitement
inclination: inclination,inclinations
inclined: inclined
include: including
incognito: incognito
incoherence: incoherence
income: income,incomes
incomparably: incomparably
incomplete: incomplete
incomprehensible: incomprehensible
incomprehensibly: incomprehensibly
inconceivable: inconceivable
inconceivably: inconceivably
incongruous: incongruous
inconsistent: inconsistent
inconsolable: inconsolable
inconspicuous: inconspicuous
incontestable: incontestable
inconvenient: inconvenient
incorrectness: incorrectness
incorrigible: incorrigible
increase: increase,increased,increasing
incredible: incredible
incredibly: incredibly
incredulous: incredulous
incur: incurred
indecision: indecision
indecorous: indecorous
indefinable: indefinable
indefinite: indefinite
indefiniteness: indefiniteness
independence: independence
independent: independent
independently: independently
indescribable: indescribable
india: india
indication: indications
indicative: indicative
indifference: indifference
indifferent: indifferent
indifferently: indifferently
indignant: indignant
indignation: indignation
indirectly: indirectly
indiscreet: indiscreet
indiscriminately: indiscriminately
indispensable: indispensable
indispose: indisposed
indisposition: indisposition
indistinctly: indistinctly
individual: individual,individuals
individualistic: individualistic
individuality: individuality
individually: individually
indolence: indolence
indoor: indoor,indoors
indoors: indoors
indubitable: indubitable
indubitably: indubitably
induce: induce,induced
inducement: inducement
indulge: indulge,indulged
indulgence: indulgence
indulgent: indulgent
inequality: inequality
inertia: inertia
inevitability: inevitability
inevitable: inevitable
inevitably: inevitably
inexcusably: inexcusably
inexhaustible: inexhaustible
inexpensive: inexpensive
inexperience: inexperience
inexperienced: inexperienced
inexplicable: inexplicable
infallibly: infallibly
infamous: infamous
infant: infant
infantry: infantry
infatuation: infatuation
infect: infected
infected: infected
infectious: infectious
infectiously: infectiously
inferior: inferior,inferiors
infernal: infernal
infidelity: infidelities,infidelity
infinite: infinite
inflammation: inflammation
influence: influence,influenced,influences
influential: influential
influx: influx
inform: inform,informed,informs
informed: informed
infrequent: infrequent
infrequently: infrequently
infuriate: infuriated
ingenious: ingenious
ingeniously: ingeniously
ingenuity: ingenuity
ingratiate: ingratiate
ingratiating: ingratiating
ingredient: ingredient
inhale: inhale,inhaling
inherit: inherited
inheritance: inheritance
inimitable: inimitable
initial: initial
initiate: initiated
injudicious: injudicious
injure: injured,injuring
injured: injured
injuriously: injuriously
injury: injury
injustice: injustice
ink: ink
inmost: inmost
inn: inn
innocence: innocence
innocent: innocent
innuendo: innuendo,innuendoes
innumerable: innumerable
inoffensive: inoffensive
inquire: inquire,inquired,inquiring
inquirer: inquirer
inquiringly: inquiringly
inquiry: inquiries,inquiry
inquisitive: inquisitive
inquisitively: inquisitively
insane: insane
insanely: insanely
inseparable: inseparable,inseparables
inseparably: inseparably
insight: insight
insignificance: insignificance
insignificant: insignificant
insincere: insincere
insincerity: insincerity
insinuate: insinuated
insist: insist,insisted,insisting,insists
insistence: insistence
insolent: insolent
insolently: insolently
insoluble: insoluble
inspect: inspecting
inspection: inspection
inspector: inspector
inspiration: inspiration
inspire: inspire,inspired,inspiring
instability: instability
installment: installment,installments
instance: instance,instances
instant: instant,instants
instantaneous: instantaneous
instantaneously: instantaneously
instantly: instantly
instigation: instigation
instil: instilled,instilling
instinct: instinct,instincts
instinctive: instinctive
instinctively: instinctively
institute: instituted
institution: institution,institutions
instruction: instruction,instructions
instrument: instrument,instruments
insufferable: insufferable
insufferably: insufferably
insult: insult,insulted,insulting,insults
insulting: insulting
insuperable: insuperable
insupportable: insupportable
insurmountable: insurmountable
integral: integral
intellect: intellect
intellectual: intellectual,intellectuals
intellectually: intellectually
intelligence: intelligence
intelligent: intelligent
intelligible: intelligible
intend: intend,intended,intending
intense: intense,intensest
intensely: intensely
intensify: intensified,intensify
intensity: intensity
intent: intent
intention: intention,intentions
intentional: intentional
intentionally: intentionally
intently: intently
intercourse: intercourse
interfere: interfere,interfered
interference: interference
interior: interior
interlace: interlacing
intermediate: intermediate
internal: internal
interpolate: interpolate
interpose: interposed
interpret: interpret,interpreted,interpreting
interpretation: interpretation,interpretations
interpreter: interpreter
interrogation: interrogation
interrupt: interrupt,interrupted,interrupting
interrupted: interrupted
interruption: interruption
interval: interval,intervals
intervene: intervened
intervention: intervention
interview: interview,interviews
intimacy: intimacy
intimate: intimate
intimately: intimately
intimidate: intimidated
intolerable: intolerable
intolerably: intolerably
intolerant: intolerant
intonation: intonation,intonations
intoxicate: intoxicated
intoxicated: intoxicated
intoxication: intoxication
intractably: intractably
intricate: intricate
intrigue: intrigue,intrigues
intriguing: intriguing
intrinsically: intrinsically
introduce: introduce,introduced,introducing
introduction: introduction
intrude: intruding
intruder: intruder
intrust: intrust,intrusted,intrusting
intuition: intuition
intuitive: intuitive
invalid: invalid,invalids
invariable: invariable
invariably: invariably
invent: invent,invented,inventing
investigate: investigate,investigated
investigation: investigations
inveterate: inveterate
invincible: invincible
invisible: invisible
invitation: invitation,invitations
invite: invite,invited,invites,inviting
invoice: invoice
involuntarily: involuntarily
involuntary: involuntary
involve: involved,involving
inwardly: inwardly
iodine: iodine
iou: iou
irascibility: irascibility
irascible: irascible
irate: irate
irish: irish
irksome: irksome
iron: iron
ironical: ironical
ironically: ironically
ironing: ironing
irony: irony
irrational: irrational
irrationally: irrationally
irregular: irregular
irregularity: irregularities,irregularity
irregularly: irregularly
irrelevant: irrelevant
irrepressible: irrepressible
irrepressibly: irrepressibly
irreproachable: irreproachable
irresistible: irresistible
irresistibly: irresistibly
irresolutely: irresolutely
irresolution: irresolution
irreverent: irreverent
irrevocably: irrevocably
irrigation: irrigation
irritability: irritability
irritable: irritable
irritably: irritably
irritate: irritate,irritates,irritating
irritated: irritated
irritating: irritating
irritation: irritation
isaac: isaac
island: island,islands
isolate: isolated
isolation: isolation
issue: issue,issues
ist: ist
italian: italian
italy: italy
item: items
iteration: iteration
ivan: ivan
ivory: ivory
ivy: ivy
ja: ja
jabber: jabber
jacket: jacket,jackets
jam: jam
james: james
jar: jar,jarred,jarring
jargon: jargon
jarring: jarring
jauntily: jauntily
jaunty: jaunty
jaw: jaw,jaws
jealous: jealous
jealousy: jealousies,jealousy
jeer: jeer,jeered,jeering,jeers
jerk: jerk,jerked,jerking
jerkin: jerkin
jest: jest,jested,jests
jesting: jesting
jestingly: jestingly
jesus: jesus
jet: jet,jets
jew: jew
jews: jews
jingle: jingling
job: job
jobber: jobbers
jobmaster: jobmaster
jockey: jockey,jockeys
jocose: jocose
jocosely: jocosely
jocoseness: jocoseness
john: john
joint: joint,joints
joke: joke,joked,jokes,joking
jolly: jolly
jolt: jolting
jolting: jolting
jones: jones
joseph: joseph
jostle: jostled
journal: journal,journals
journalist: journalist
journey: journey
jove: jove
jovial: jovial
jovially: jovially
joy: joy,joys
joyful: joyful
joyfully: joyfully
joyous: joyous
joyously: joyously
jubilee: jubilee
judge: judge,judged,judges,judging
judgment: judgment
judicial: judicial
juicy: juicy
jules: jules
july: july
jump: jump,jumped,jumping,jumps
junction: junctions
juncture: juncture
june: june
junket: junket
jurisdiction: jurisdiction
jury: juries,jury
juryman: juryman
juster: juster
justice: justice,justices
justified: justified
justify: justified,justify,justifying
justly: justly
jut: jutting
karl: karl
katinka: katinka
keen: keen,keenest
keener: keener
keenly: keenly
keeper: keeper
keeping: keeping
kerchief: kerchief
kernel: kernel
kettle: kettle
key: key
kick: kicked
kid: kid
kiev: kiev
kill: kill,killed,killing
kindle: kindled
kindliness: kindliness
kindly: kindly
kindness: kindness
king: king
kingdom: kingdom
kinship: kinship
kiss: kiss,kissed,kisses,kissing
kitchen: kitchen
kitty: kitty
knack: knack,knacks
knave: knave
knead: kneaded
knee: knee,knees
kneed: kneed
kneel: kneeling,knelt
knick: knick
knife: knife,knives
knit: knit,knitted,knitting
knitting: knitting
knob: knob
knobbiness: knobbiness
knock: knock,knocked,knocking
knot: knot
knowingly: knowingly
knowledge: knowledge
knuckle: knuckles
konstantin: konstantin
kopeck: kopecks
label: label
labor: labor,laboring,labors
laborer: laborer,laborers
laborious: laborious
laboriously: laboriously
lace: lace
lack: lack,lacking
laconic: laconic
lad: lad,lads
ladder: ladder
laden: laden
ladle: ladled
lady: ladies,lady
lag: lagged
lair: lair
lake: lake
lamb: lamb,lambs
lame: lame
lamp: lamp,lamps
lamplight: lamplight
lamppost: lamppost
land: land,landed,lands
landau: landau
landing: landing
landlady: landlady
landlord: landlord
landowner: landowner,landowners
landscape: landscape
language: language,languages
languid: languid
languidly: languidly
lank: lank
lantern: lantern
lap: lap
larks: larks
lash: lashed,lashes
latch: latch
late: late
latin: latin
laugh: laugh,laughed,laughing,laughs
laughingly: laughingly
laughter: laughter
launch: launch,launched
laundry: laundry
laura: laura
lavish: lavish,lavished,lavishing
law: law,laws
lawful: lawful
lawfully: lawfully
lawn: lawn
lawsuit: lawsuit
lawyer: lawyer,lawyers
lay: laid,lay,laying,lays
layer: layer
lazily: lazily
laziness: laziness
lazy: lazy
le: le
lead: lead,leading,leads,led
leader: leaders
leaf: leaf,leaves
league: league
leak: leak,leaked
lean: lean,leaned,leaning
leap: leap,leaped,leaping
lear: lear
learn: learn,learned,learning,learns
learner: learners
learning: learning
leather: leather
leave: leave,leaves,leaving,left
lectern: lectern
lecture: lecture,lectures
lee: lee
leech: leeches
left: left
leg: leg,legs
legal: legal
legalize: legalize
legally: legally
legged: legged
leggings: leggings
legible: legible
legion: legion
legitimate: legitimate
legitimately: legitimately
legitimization: legitimization
legitimize: legitimize
leisure: leisure
leisurely: leisurely
lemon: lemon
lend: lend,lending,lent
lender: lender
lengthen: lengthening
lengthwise: lengthwise
lenient: lenient
lent: lent
leo: leo
leper: lepers
les: les
lessen: lessen
lessive: lessive
lesson: lesson,lessons
letter: letter,letters
lettering: lettering
letters: letters
letting: letting
levee: levee
level: level,leveled
lever: lever
levin: levin
levins: levins
levy: levy
liability: liability
liable: liable
liaison: liaison
liar: liar
liberal: liberal,liberals
liberalism: liberalism
liberty: liberty
library: library
libre: libre
lick: licking
lid: lid
lidia: lidia
lie: lain,lie,lies,lying
lieutenant: lieutenant
life: life,lives
lifeless: lifeless
lifelessness: lifelessness
lifetime: lifetime
lift: lift,lifted,lifting,lifts
light: light,lighted,lighter,lighting,lights,lit
lighted: lighted
lighten: lightening
lighting: lighting
lightly: lightly
lightness: lightness
lightning: lightning
likelihood: likelihood
likeness: likeness
likes: likes
liking: liking
lilac: lilac
lily: lily
limb: limb,limbs
lime: lime,limes
limit: limit,limited,limits
limitation: limitations
limited: limited
limp: limp,limping
linen: linen
linger: linger,lingered,lingering
link: link,linking
linon: linon
lion: lions
lip: lip,lips
liquor: liquor
lisp: lisp,lisping
list: list
listen: listen,listened,listening
listener: listener
listlessly: listlessly
litany: litanies,litany
literature: literature
litter: litter
live: live,lived,lives,living
lived: lived
livelihood: livelihood
liveliness: liveliness
lively: livelier,liveliest,lively
liver: liver
liveried: liveried
livery: liveries,livery
living: living
liza: liza
load: load,loaded,loading,loads
loaf: loaves
loan: loan
loath: loath
loathe: loathed,loathes
loathing: loathing
loathsome: loathsome
loathsomeness: loathsomeness
lobster: lobster
local: local
lock: lock,locked,locks
locket: locket
locksmith: locksmith
locksmiths: locksmiths
lockup: lockup
lodge: lodge,lodged,lodges
lodging: lodging
lodgings: lodgings
loftiness: loftiness
lofty: loftier,loftiest,lofty
logical: logical
logically: logically
lonely: lonely
longing: longing
lookout: lookout
loop: loop
loose: loose,loosed
loosely: loosely
loosen: loosened
lop: lop
loquacity: loquacity
lord: lord
lore: lore
lose: lose,losing,lost
losing: losing
loss: loss,losses
lost: lost
lot: lot,lots
loth: loth
loud: loud,louder
loudly: loudly
loudness: loudness
louis: louis
louise: louise
lounge: lounge,lounged
love: love,loved,loves,loving
loveliness: loveliness
lovely: lovely
lover: lover,lovers
lovesick: lovesick
loving: loving
lovingly: lovingly
lowering: lowering
luck: luck
luckily: luckily
luckless: luckless
lucky: lucky
lucrative: lucrative
ludicrous: ludicrous
luggage: luggage
lui: lui
lull: lull
luminous: luminous
lump: lump
lunch: lunch,lunched,lunching
luncheon: luncheon
lung: lungs
lurid: lurid
lust: lust
luster: luster,lusters
lusterless: lusterless
luxuriant: luxuriant
luxurious: luxurious
luxuriously: luxuriously
luxury: luxuries,luxury
lvov: lvov
lying: lying
machine: machine,machines
machinery: machinery
mad: mad
madam: madam
madame: madame
mademoiselle: mademoiselle
madman: madman
madness: madness
magazine: magazine,magazines
magdalen: magdalen
magic: magic
magical: magical
magistrate: magistrates
magnanimity: magnanimity
magnanimous: magnanimous
magnanimously: magnanimously
magnificence: magnificence
magnificent: magnificent
magnitude: magnitude
maid: maid,maids
maiden: maiden
maidenly: maidenly
main: main
mainspring: mainspring
maintain: maintain,maintained,maintaining,maintains
maintenance: maintenance
majolica: majolica
majority: majority
mal: mal
malachite: malachite
male: male
malice: malice
malicious: malicious
malignant: malignant
malignantly: malignantly
malnutrition: malnutrition
malthus: malthus
mamma: mamma
manage: manage,managed,managing
management: management
manager: manager
mandolin: mandolin
mane: mane
manger: manger
mangle: mangle
manifest: manifest,manifested
manifestation: manifestation,manifestations
mankind: mankind
manly: manly
manner: manner
manners: manners
manor: manor
manservant: manservant
mantelpiece: mantelpiece
mantle: mantle
manufacture: manufactures
manufacturing: manufacturing
manure: manure,manured,manuring
manuscript: manuscript,manuscripts
marble: marble
march: march
mare: mare
margined: margined
marie: marie
mark: mark,marked,marks
marked: marked
marker: marker
marketing: marketing
marmot: marmot
marquise: marquise
marriage: marriage,marriages
married: married
marry: married,marry,marrying
marrying: marrying
marsh: marsh,marshes
marshal: marshal,marshals
marshalship: marshalship
martyr: martyr
marvel: marvel,marveled,marveling,marvels
marvelous: marvelous
mary: mary
masculine: masculine
masha: masha
masquerade: masquerade
mass: mass
massive: massive
master: master,mastered,masters
mastery: mastery
match: match,matched,matches
matchmaker: matchmaker
matchmaking: matchmaking
material: material,materials
materialism: materialism
materialist: materialists
materialistic: materialistic
maternal: maternal
mathematician: mathematician
matin: matin
matrimony: matrimony
matted: matted
matter: matter,mattered,matters
matthew: matthew
matting: matting
mattress: mattress,mattresses
mature: mature
mazurka: mazurka
meadow: meadow,meadows
meadowland: meadowland
meal: meal,meals
meaning: meaning
meaningful: meaningful
meaningless: meaningless
measure: measure,measured,measures,measuring
meat: meat
mechanical: mechanical
mechanician: mechanician
mechanism: mechanism
medal: medals
meddle: meddle
mediation: mediation
mediator: mediator
medical: medical
medicinal: medicinal
medicine: medicine,medicines
meditate: meditating
meditation: meditation,meditations
medium: medium
medley: medley
meek: meek
meekness: meekness
meet: meet,meeting,met
meeting: meeting,meetings
melancholy: melancholy
mellow: mellow
melody: melody
melt: melt,melted,melting
melting: melting
memorable: memorable
memories: memories
memory: memories,memory
menace: menace
menacing: menacing
menacingly: menacingly
mend: mend,mended,mending
mending: mending
menelaus: menelaus
ment: ment
mental: mental
mentally: mentally
mention: mention,mentioned,mentioning
menu: menu
merchant: merchant,merchants
merci: merci
merciful: merciful
merciless: merciless
mercy: mercies,mercy
mere: mere,merest
merge: merged
merit: merit,merits
merrily: merrily
merriment: merriment
merry: merry
mes: mes
mesmerizer: mesmerizer
mess: mess
message: message,messages
messenger: messenger
messieurs: messieurs
messroom: messroom
metallic: metallic
metaphysical: metaphysical
method: method,methods
methodical: methodical
mettlesome: mettlesome
midday: midday
middle: middle
midge: midges
midnight: midnight
midst: midst
midwife: midwife,midwives
mighty: mighty
mild: mild
mildew: mildew
mildewy: mildewy
mile: mile,miles
military: military
milk: milk
mille: mille
miller: miller
mimic: mimicked,mimicking
mimicry: mimicry
mincing: mincing
mind: mind,minding,minds
minded: minded
mineral: mineral
mingle: mingled,mingling
minister: minister,ministers
ministerial: ministerial
ministry: ministry
minute: minute,minutes,minutest
minuteness: minuteness
minutes: minutes
miracle: miracles
mire: mire
mirror: mirror
mirth: mirth
mirthful: mirthful
mirthfully: mirthfully
mirthfulness: mirthfulness
mirthless: mirthless
miry: miry
misapprehend: misapprehending
misapprehension: misapprehension
misappropriate: misappropriated
misappropriation: misappropriation
misbehavior: misbehavior
mischief: mischief
mischievous: mischievous
misdirect: misdirected
miserable: miserable
miserably: miserably
miserly: miserly
misery: misery
misfortune: misfortune,misfortunes
misinterpret: misinterpreted,misinterpreting
misinterpretation: misinterpretation
mislead: misled
mismanage: mismanaged
misplace: misplaced
missal: missal
misshapen: misshapen
mission: mission
missionary: missionary
misspell: misspelt
mist: mist,mists
mistake: mistake,mistaken,mistakes,mistaking
mistaken: mistaken
mistakenly: mistakenly
mistress: mistress,mistresses
misty: mistiest,misty
misunderstand: misunderstood
misunderstanding: misunderstanding,misunderstandings
misuse: misuse
mix: mix,mixed
mixed: mixed
moan: moan,moaned
mobile: mobile
mock: mock,mocking
mockery: mockery
mockingly: mockingly
mode: mode,modes
model: model
moderation: moderation
modern: modern
modes: modes
modest: modest
modestly: modestly
modesty: modesty
modify: modified
moi: moi
moist: moist
moisten: moisten,moistened
moisture: moisture
moment: moment,moments
momentary: momentary
mon: mon
monarch: monarch
monastic: monastic
monday: monday
mondays: mondays
monde: monde
money: money,moneys
monger: monger
monk: monk,monks
monkey: monkey
monogram: monogram
monopolist: monopolists
monopoly: monopolies
monotony: monotony
monsieur: monsieur
monstrosity: monstrosities
monstrous: monstrous
month: month,months
monthly: monthly
monument: monument
mood: mood,moods
moon: moon
moonlight: moonlight
moor: moors
moral: moral,morals
moralist: moralist
morality: morality
morally: morally
morbid: morbid
morning: morning,mornings
morocco: morocco
morosely: morosely
morphine: morphine
morrow: morrow
mort: mort
mortar: mortar
mortification: mortification
mortified: mortified
mortify: mortified,mortify,mortifying
mortifying: mortifying
mosaic: mosaic
moscow: moscow
moses: moses
moss: moss
mossy: mossy
mot: mot
moth: moth,moths
mother: mother,mothers
motherhood: motherhood
motherly: motherly
motion: motion,motions
motionless: motionless
motive: motive,motives
mots: mots
motto: motto
mould: mould
moule: moule
mound: mound,mounds
mount: mount,mounted,mounting
mountain: mountain,mountains
mournful: mournful
mournfully: mournfully
mourning: mourning
mouse: mouse
mouth: mouth,mouths
mouthful: mouthful
movable: movable
movement: movement,movements
moving: moving
mow: mow,mowed,mowing,mown
mower: mower,mowers
mowing: mowing
mud: mud
muddle: muddle,muddled,muddles
muddled: muddled
muddy: muddied,muddy
muff: muff
muffle: muffled,muffling
muffled: muffled
multiplicity: multiplicity
mumble: mumbled
mumbling: mumbling
munch: munching
municipal: municipal
murder: murder,murdering
murderer: murderer
murmur: murmured,murmuring
muscle: muscle,muscles
muscular: muscular
muse: mused,muses,musing
mushroom: mushroom,mushrooms
music: music
musical: musical
musically: musically
musician: musician
musingly: musingly
muslin: muslin
muss: muss
mustache: mustache
mustiness: mustiness
mute: mute
mutilate: mutilated
mutter: muttered,muttering
mutual: mutual
muzzle: muzzle
mysterious: mysterious
mystery: mysteries,mystery
mystical: mystical
mystify: mystified
nag: nag
nail: nail,nails
nainsook: nainsook
naked: naked
nakedness: nakedness
nap: nap,napping
nape: nape
napkin: napkin,napkins
naples: naples
narrative: narrative
narrow: narrow,narrower
nasty: nasty
natalia: natalia
natation: natation
nation: nations
national: national
nationalize: nationalize
native: native
natural: natural
naturally: naturally
naturalness: naturalness
nature: nature,natures
natured: natured
naturedly: naturedly
naughtiness: naughtiness
naughty: naughty
naval: naval
navy: navy
nearer: nearer
nearness: nearness
neatly: neatly
neatness: neatness
necessaries: necessaries
necessitate: necessitated
necessity: necessity
neck: neck,necks
neckband: neckband
necked: necked
necklace: necklace
necktie: necktie
needful: needful
needle: needles
needlessly: needlessly
negation: negation
negative: negative
negatively: negatively
neglect: neglected,neglecting
negotiation: negotiation,negotiations
negro: negroes
neighbor: neighbor,neighbors
neighborhood: neighborhood
neighboring: neighboring
nephew: nephew
nerve: nerve,nerves
nervous: nervous
nervously: nervously
nervousness: nervousness
nest: nest
nestle: nestled
nettle: nettle,nettles
network: network
newborn: newborn
newly: newly
news: news
newspaper: newspaper,newspapers
nibble: nibbling
nice: nice,nicer,nicest
nicely: nicely
nicety: nicety
nickname: nickname,nicknamed
niece: niece
night: night,nights
nightcap: nightcap
nightingale: nightingales
nightmare: nightmare
nightshirt: nightshirt
nighttime: nighttime
nihilist: nihilist
nil: nil
nimble: nimble
nineteen: nineteen
nip: nip
nitrate: nitrate
noah: noah
nobility: nobility
noble: noble,nobler,nobles
nobleman: nobleman,noblemen
nobly: nobly
nod: nod,nodded,nodding,nods
noise: noise,noises
noiseless: noiseless
noiselessly: noiselessly
noisily: noisily
noisy: noisy
nominal: nominal
nonchalant: nonchalant
nonplussed: nonplussed
nonsense: nonsense
noonday: noonday
normal: normal
northern: northern
nose: nose,noses
nostril: nostrils
notary: notary
note: note,notes
notebook: notebook,notebooks
notice: notice,noticed,noticing
noticeable: noticeable
notify: notified
notion: notion,notions
notorious: notorious
nought: nought
nourishment: nourishment
nous: nous
novelty: novelty
november: november
nowadays: nowadays
noxious: noxious
numbed: numbed
numerous: numerous
nurse: nurse,nursed,nurses,nursing
nursery: nursery
nursing: nursing
nut: nut,nuts
nutrition: nutrition
oasis: oases,oasis
oath: oaths
oats: oats
obedience: obedience
obedient: obedient
obediently: obediently
obey: obeyed,obeying
object: object,objected,objects
objection: objection,objections
obligation: obligation
obligatory: obligatory
oblige: oblige,obliged,obliging
obliterate: obliterated
oblivion: oblivion
oblivious: oblivious
oblong: oblong
obscure: obscure
observance: observance
observation: observation,observations
observe: observe,observed,observing
observer: observer
obstacle: obstacle,obstacles
obstinacy: obstinacy
obstinate: obstinate
obstinately: obstinately
obtrusively: obtrusively
obvious: obvious
occasion: occasion,occasioned,occasions
occasionally: occasionally
occupation: occupation,occupations
occupied: occupied
occupy: occupied,occupies,occupy,occupying
occur: occur,occurred
ocean: ocean
october: october
odd: odd
odor: odor
offend: offend,offended
offended: offended
offense: offense
offensive: offensive
offer: offer,offered,offering,offers
offering: offering
office: office,offices
officer: officer,officers
official: official,officials
officially: officially
officiating: officiating
offspring: offspring
oftener: oftener
oil: oil
oilcloth: oilcloth
olive: olive
omen: omen,omens
omnibus: omnibuses
oneself: oneself
onslaught: onslaught,onslaughts
ont: ont
op: op
opener: opener
openly: openly
opera: opera
operation: operations
opine: opined
opinion: opinion,opinions
opium: opium
opponent: opponent,opponents
opportunity: opportunity
oppose: oppose,opposed,opposing
opposed: opposed
opposition: opposition
oppress: oppressed,oppresses,oppressing
oppressed: oppressed
oppression: oppression
oppressive: oppressive
orange: orange,oranges
orchard: orchard
orchestra: orchestra
ordain: ordained
ordeal: ordeal,ordeals
orderly: orderly
ordinarily: ordinarily
ordinariness: ordinariness
ordinary: ordinary
organ: organ,organs
organization: organization
organize: organize,organized,organizing
oriental: oriental
origin: origin
original: original
originality: originality
originate: originated
ornament: ornament
orphan: orphan
orthodox: orthodox
oscillate: oscillating
ossian: ossian
ostend: ostend
ostensibly: ostensibly
outburst: outburst
outcast: outcast
outcry: outcries,outcry
outdo: outdone
outer: outer
outfit: outfit
outing: outing
outlay: outlay
outline: outline,outlines
outlook: outlook
outright: outright
outsider: outsider,outsiders
outstretched: outstretched
outstrip: outstrip,outstripped
outward: outward
outwardly: outwardly
outweigh: outweigh,outweighed
oval: oval
ovation: ovations
overawe: overawed
overbalancing: overbalancing
overcoat: overcoat
overcome: overcome,overcoming
overdo: overdo
overdriven: overdriven
overgrown: overgrown
overhang: overhanging
overhead: overhead
overhear: overheard,overhearing
overjoy: overjoyed
overjoyed: overjoyed
overlook: overlook,overlooked
overpersuade: overpersuaded
overseer: overseer,overseers
overspread: overspread,overspreading
overstate: overstated
overstrained: overstrained
overtake: overtake,overtaken,overtakes,overtaking,overtook
overturn: overturn
overwhelm: overwhelm
overwhelmed: overwhelmed
overwork: overwork,overworked
overwrought: overwrought
owe: owe,owed
owl: owl
owner: owner
ownership: ownership
ox: ox
oxen: oxen
oyster: oysters
pace: pace,paced,paces
pacify: pacified,pacify
pacing: pacing
pack: pack,packed,packing
packed: packed
packet: packet
packing: packing
paddock: paddock
pail: pails
pain: pain,pains
pained: pained
painful: painful
painfully: painfully
paint: paint,painted,painting
painter: painter
painting: painting
pair: pair
palace: palace
palazzo: palazzo
pale: pale
paleness: paleness
palette: palette
paling: palings
pall: pall
palm: palm,palms
paltry: paltry
pamphlet: pamphlet
pan: pan,pans
pancake: pancakes
pane: pane,panes
panel: paneled,panels
pang: pang,pangs
panic: panic,panics
pansy: pansies
panting: panting
papa: papa
papacy: papacy
paper: paper,papers
par: par
paradise: paradise
paradox: paradox
paradoxical: paradoxical
parallel: parallel
paramount: paramount
parapet: parapet
parasite: parasites
parasol: parasol,parasols
parcel: parcel
pardon: pardon,pardoned
parent: parents
parfait: parfait
paris: paris
parish: parish
parishioner: parishioner
parisian: parisian
park: park,parks
parley: parley
parliament: parliament
parlor: parlor
parmesan: parmesan
parochial: parochial
parquet: parquet
parry: parried
partake: partake
partial: partial
participation: participation
particle: particle
particulars: particulars
partie: partie
partisan: partisan,partisans
partition: partition,partitioned
partly: partly
partner: partner,partners
partnership: partnership,partnerships
party: parties,party
pas: pas
pasha: pasha
pass: pass,passed,passes,passing
passage: passage
passenger: passenger,passengers
passer: passer,passers
passing: passing
passion: passion,passions
passionate: passionate
passionately: passionately
passionless: passionless
passive: passive
paste: paste
pastern: pasterns
pastime: pastime
pasture: pasture,pastures
pat: patted,patting
patch: patch,patched,patches
patched: patched
patent: patent
paternal: paternal
path: path,paths
pathetic: pathetic
patience: patience
patient: patient,patients
patriarch: patriarchs
patriarchal: patriarchal
patriot: patriots
patriotic: patriotic
patron: patron
patronage: patronage
patronize: patronized,patronizes,patronizing
patronizing: patronizing
patronymic: patronymic
patter: pattered
pattern: pattern,patterns
paul: paul
pause: pause,paused,pauses,pausing
pave: paved
paved: paved
pavement: pavement,pavements
pavilion: pavilion,pavilions
paw: paws
pawn: pawn,pawned
pay: paid,pay,paying
payment: payment
pea: pea
peace: peace
peaceable: peaceable
peaceful: peaceful
peacemaker: peacemakers
peach: peaches
peacock: peacock
peak: peak
peal: peal,peals
pear: pear
pearl: pearl,pearls
pearly: pearly
peasant: peasant,peasants
peasantry: peasantry
peck: pecking
peculiar: peculiar
peculiarity: peculiarities,peculiarity
peculiarly: peculiarly
pecuniary: pecuniary
pedal: pedal
pedestal: pedestal,pedestals
peel: peel,peeled
peep: peep,peeped,peeping
peeping: peeping
peer: peering
peevish: peevish
peewit: peewit,peewits
peg: peg
pen: pen,pens
pence: pence
pencil: pencil
penetrate: penetrate,penetrated,penetrating
penitent: penitent
penitently: penitently
penknife: penknife,penknives
penniless: penniless
penny: penny
pense: pense
pension: pensions
pensive: pensive
pensively: pensively
people: peoples
perceive: perceive,perceived,perceiving
perceptible: perceptible
perceptibly: perceptibly
perception: perception,perceptions
perch: perch
peremptorily: peremptorily
peremptory: peremptory
perfect: perfect
perfectibility: perfectibility
perfection: perfection
perfectly: perfectly
perforated: perforated
perforce: perforce
perform: perform,performed,performing
performance: performance
perfumed: perfumed
period: period,periods
periodical: periodical
permanent: permanent
permissible: permissible
permission: permission
permit: permit,permitted
pernicious: pernicious
perpetrate: perpetrate
perplex: perplexed
perplexity: perplexities,perplexity
persecute: persecuted
persecution: persecution
perseveringly: perseveringly
persian: persian
persist: persisted,persists
persistence: persistence
persistent: persistent
persistently: persistently
person: people,person,persons
personage: personage,personages
personal: personal
personality: personality
personally: personally
perspective: perspective
perspiration: perspiration
perspire: perspiring
persuade: persuade,persuaded,persuading
persuasion: persuasion
persuasive: persuasive
pertinacious: pertinacious
perturb: perturbed
perusal: perusal
pervade: pervaded
perverse: perverse
pessimism: pessimism
pet: petted
petal: petal,petals
peter: peter
petersburg: petersburg
petit: petit
petite: petite
petition: petition,petitions
petitioner: petitioner,petitioners
petticoat: petticoat,petticoats
pettily: pettily
petting: petting
petty: pettiest,petty
phantasm: phantasm,phantasms
phantom: phantoms
pharisaical: pharisaical
phase: phase,phases
pheasant: pheasants
phenomena: phenomena
phenomenon: phenomena,phenomenon
phew: phew
philanthropic: philanthropic
philanthropy: philanthropy
philip: philip
philosopher: philosopher,philosophers
philosophic: philosophic
philosophical: philosophical
philosophy: philosophy
phosphorus: phosphorus
photograph: photograph,photographs
phrase: phrase,phrases
physic: physic
physical: physical
physically: physically
physician: physician
physics: physics
physiological: physiological
physiology: physiology
piano: piano
pick: pick,picked,picking
picking: picking
pickle: pickle,pickled
picture: picture,pictured,pictures,picturing
pie: pies
piebald: piebald
piece: piece,pieces
pier: pier
pierce: pierced,piercing
pierre: pierre
pietist: pietist
pietists: pietists
pig: pig
pilate: pilate
pile: pile,piled
pill: pills
pillow: pillow,pillows
pillowcase: pillowcases
pin: pinned,pinning
pinch: pinch,pinched,pinching
pine: pines
pink: pink
pinnacle: pinnacle
pinprick: pinpricks
piotr: piotr
pipe: pipe,pipes,piping
pique: piqued
pis: pis
pistol: pistol,pistols
pit: pit
pitch: pitch,pitched,pitching
pitched: pitched
pitcher: pitchers
pitchfork: pitchfork,pitchforks
piteous: piteous
piteously: piteously
pitiable: pitiable
pitiful: pitiful
pity: pitied,pities,pity,pitying
pivot: pivot
placard: placards
placid: placid
plague: plague
plaid: plaid
plain: plain,plainer
plainly: plainly
plaintive: plaintive
plaintively: plaintively
plaited: plaited
plan: plan,planned,planning,plans
plane: planing
planet: planet
plank: plank,planks
plant: plant,planted,plants
plaster: plaster
plastic: plastic
plate: plate,plates
platform: platform
plato: plato
platonic: platonic
play: play,played,playing,plays
playbill: playbill
player: player,players
playful: playful
playfully: playfully
playfulness: playfulness
playing: playing
plaything: plaything,playthings
playtime: playtime
plea: plea
plead: pleaded
pleasant: pleasant,pleasanter
pleasantest: pleasantest
pleasantly: pleasantly
pleased: pleased
pleasing: pleasing
pleasure: pleasure,pleasures
pledge: pledged
plenty: plenty
plight: plight,plighted,plighting,plights
plinth: plinths
plop: plop
plot: plots
plough: plough,ploughed,ploughing,ploughs
ploughing: ploughing
ploughland: ploughland
pluck: pluck,plucked,plucking
plucky: plucky
plum: plum
plump: plump
plumper: plumper
plunge: plunge,plunged
plural: plural
plush: plush
ply: plied
poach: poached
pocket: pocket,pocketed,pockets
pocketbook: pocketbook
pockmarked: pockmarked
poet: poet
poetic: poetic
poetical: poetical
poetically: poetically
poetry: poetry
poignancy: poignancy
poignant: poignant
pointe: pointe
pointer: pointer
poison: poison,poisoned
poke: poked,poking
poland: poland
pole: poles
police: police
policeman: policeman,policemen
policy: policy
polish: polish,polishing
polite: polite
politeness: politeness
political: political
politician: politician
politics: politics
polka: polkas
pollen: pollen
pomade: pomaded
pomaded: pomaded
pond: pond
ponder: ponder,pondered,pondering
ponderous: ponderous
pool: pool,pools
poor: poor
pop: popped,popping
pope: pope
poplin: poplin
popular: popular
populate: populated
population: population,populations
porch: porch
porridge: porridge
port: port
porter: porter,porters
portfolio: portfolio
portion: portioned,portions
portrait: portrait,portraits
pose: pose,posing
position: position,positions
positive: positive
positively: positively
possess: possess,possessed,possesses
possession: possession
possibility: possibility
post: post,posting,posts
posting: posting
posture: posture
pot: pot,pots
potato: potato,potatoes
poulard: poulard
poulet: poulet
pounce: pounce,pounced
pounced: pounced
pound: pound,pounds
pour: pour,poured,pouring
pout: pout
pouting: pouting
poverty: poverty
powder: powder,powdering,powders
power: power,powers
powerful: powerful
powerfully: powerfully
powerless: powerless
practical: practical
practically: practically
practice: practice,practiced,practicing
praise: praise,praised,praises,praising
prance: prancing
prank: pranks
prattle: prattle
pray: pray,prayed,praying,prays
prayer: prayer,prayers
precarious: precarious
precaution: precautions
precede: preceded,precedes,preceding
precedent: precedents
precept: precept
preceptor: preceptor
precious: precious
precipice: precipice
precipitous: precipitous
precise: precise
precisely: precisely
precision: precision
preclude: precluded
predecessor: predecessor
prediction: prediction,predictions
preeminence: preeminence
preeminently: preeminently
preening: preening
prefer: prefer,preferred,preferring
prefigure: prefigured
pregnancy: pregnancy
preliminary: preliminary
premature: premature
prematurely: prematurely
preparation: preparation,preparations
preparatory: preparatory
prepare: prepare,prepared,preparing
prepared: prepared
preponderance: preponderance
prescribe: prescribe,prescribed
presence: presence
presentiment: presentiment
presently: presently
preserve: preserve,preserved,preserves,preserving
preside: presiding
president: president
presidential: presidential
press: press,pressed,pressing
pressed: pressed
presser: presser
pressingly: pressingly
pressure: pressure
prestige: prestige
presume: presume
presuppose: presupposing
pretend: pretend,pretended,pretending
pretense: pretense
pretension: pretension
pretentious: pretentious
pretext: pretext,pretexts
pretty: prettier,pretty
prevail: prevailed
prevalent: prevalent
prevent: prevent,prevented,preventing,prevents
previous: previous
price: price,prices
priceless: priceless
prick: prick,pricked
pride: pride,prided
priest: priest,priests
primary: primary
prime: prime
primitive: primitive
prince: prince,princes
princess: princess,princesses
principal: principal
principally: principally
principle: principle,principles
principled: principled
print: print,printed,prints
prison: prison,prisons
prisoner: prisoner
private: private
privation: privation
privilege: privileges
privileged: privileged
privy: privy
prize: prize,prized,prizes
probability: probability
probable: probable
procedure: procedure
proceed: proceed,proceeded,proceeding
proceeding: proceeding
proceedings: proceedings
process: process
proclaim: proclaimed
procreation: procreation
procure: procure,procured
prod: prod
produce: produce,produced,produces
product: product
production: production
productive: productive
productively: productively
profane: profaned,profaning
profession: profession
professor: professor,professors
proffer: proffered,proffering
proficient: proficient
profile: profile
profit: profit,profits
profitable: profitable
profound: profound
profoundly: profoundly
program: program
progress: progress
progression: progression
project: project,projecting,projects
prolong: prolong
prolonged: prolonged
prominent: prominent
promise: promise,promised,promising
promissory: promissory
promote: promoted,promoting
promotion: promotion
prompt: prompted,prompts
pronounce: pronounce,pronounced,pronouncing
proof: proof,proofs
prop: prop,propped,propping
propensity: propensities
proper: proper
properly: properly
property: property
proportion: proportion,proportions
proportionally: proportionally
proportionate: proportionate
propos: propos
proposal: proposal
propose: propose,proposed
proposed: proposed
proposition: proposition,propositions
proprietor: proprietors
propriety: proprieties,propriety
prosecution: prosecution
prosecutor: prosecutor
prospect: prospect
prosperity: prosperity
prosperous: prosperous
protect: protect,protected
protection: protection
protector: protector
protest: protest,protests
protestant: protestant
protestation: protestations
protrude: protruding
proudly: proudly
prove: prove,proved,proves,proving
proverb: proverb
provide: provide,providing
province: province,provinces
provincial: provincial
provision: provisions
provoke: provoke,provoked,provoking
prowess: prowess
proximity: proximity
prudence: prudence
prudent: prudent
prussia: prussia
psalm: psalm
psychological: psychological
public: public
publication: publications
publicity: publicity
publish: published
publisher: publisher
puce: puce
pucker: puckered
puckered: puckered
pudding: pudding,puddings
puddle: puddles
puerperal: puerperal
puff: puffed,puffs
pull: pull,pulled,pulling,pulls
pulse: pulse
pump: pumping
punctilious: punctilious
punctual: punctual
punctuality: punctuality
punctually: punctually
punish: punish,punished,punishing
punishment: punishment
pupil: pupil
purchase: purchase,purchases
purchaser: purchaser,purchasers
pure: pure,purer
purely: purely
purgative: purgative
purity: purity
purplish: purplish
purport: purport
purpose: purpose,purposes
purposely: purposely
purse: purse,pursed,pursing
pursue: pursue,pursued,pursuing
pursuit: pursuit,pursuits
purveyor: purveyor
push: push,pushed,pushing
putty: putty
puzzle: puzzled,puzzling
puzzled: puzzled
pyramid: pyramids
quack: quack,quacks
quadrangle: quadrangle
quadrangular: quadrangular
quadrille: quadrille
quail: quail
qualification: qualification,qualifications
qualified: qualified
quality: qualities,quality
quantity: quantity
quarrel: quarrel,quarreled,quarreling,quarrels
quarrelsome: quarrelsome
quarter: quarter,quarters
quartermaster: quartermaster
quartette: quartette
queen: queen
queer: queer
queerly: queerly
quell: quelling
quench: quench,quenched
query: queried
question: question,questioned,questioning,questions
questioning: questioning
questioningly: questioningly
qui: qui
quick: quick,quicker
quicken: quickened,quickening
quicksilver: quicksilver
quickwittedness: quickwittedness
quiet: quiet,quieter
quietly: quietly
quilt: quilt
quinze: quinze
quiver: quiver,quivered,quivering
quo: quo,quos
quos: quos
quotation: quotations
quote: quote,quoted
race: race,races,racing
racer: racers
rachel: rachel
racing: racing
rack: rack,racked
radiance: radiance
radiant: radiant
radical: radical
radicalism: radicalism
rag: rags
rage: rage,raging
raid: raids
rail: railed,rails
railing: railing
raillery: raillery
railroad: railroads
railway: railway,railways
rain: rain,raining,rains
rainbow: rainbow
raindrop: raindrops
raise: raise,raised,raising
raising: raising
rake: rake,raked,rakes
rally: rallying
rambouillet: rambouillet
rammer: rammers
ramrod: ramrod
rancor: rancor
random: random
range: range,ranged,ranging
rank: rank,ranks
ransack: ransacked
raphael: raphael
rapid: rapid
rapidity: rapidity
rapidly: rapidly
rapture: rapture,raptures
rapturous: rapturous
rapturously: rapturously
rare: rare
rarely: rarely
rasa: rasa
rascal: rascal
raspberry: raspberries,raspberry
rate: rate
ration: rations
rational: rational
rattle: rattle,rattling
rave: raves
raven: raven
ravine: ravine
raw: raw
ray: rays
razor: razor
reach: reach,reached,reaching
react: reacts
reactionist: reactionist
read: read,reading
reader: reader
readiness: readiness
reading: reading
ready: readier,ready
real: real
realism: realism
realistic: realistic
reality: reality
realization: realization
realize: realize,realized,realizes,realizing
reap: reaped,reaping
reappear: reappeared
reappearance: reappearance
rear: rear,reared
rearing: rearing
rearrange: rearrange,rearranged,rearranging
reason: reason,reasoned,reasons
reasonable: reasonable
reasonableness: reasonableness
reasoning: reasoning
reassert: reasserted
reassurance: reassurance
reassure: reassure,reassured
reassuring: reassuring
reassuringly: reassuringly
rebecca: rebecca
rebound: rebound,rebounded
rebuild: rebuilt
recall: recall,recalled,recalling
recapitulate: recapitulate
receipt: receipt
receive: receive,received,receiving
receiving: receiving
reception: reception
recess: recess,recesses
reciprocal: reciprocal
recite: recited
reckless: reckless
recklessly: recklessly
reckon: reckon,reckoned,reckoning,reckons
reckoning: reckoning
recognition: recognition
recognize: recognize,recognized,recognizes,recognizing
recollect: recollect,recollected,recollecting
recollection: recollection,recollections
recommend: recommended
reconcile: reconcile,reconciled,reconciling
reconciliation: reconciliation
reconstruction: reconstruction
recount: recounted
recourse: recourse
recover: recover,recovered,recovering
recovery: recoveries,recovery
recreation: recreations
recrimination: recriminations
recruit: recruit,recruits
rectify: rectifying
recur: recurred,recurring
red: red
redden: reddened,reddening
reddish: reddish
redemption: redemption
redouble: redoubled
reduce: reduce,reduced
reduction: reduction
reed: reeds
reel: reeling
reestablish: reestablished
refer: refer,referred,referring
reference: reference,references
refined: refined
refinement: refinement
reflect: reflect,reflected,reflecting
reflection: reflection,reflections
reflector: reflector
reflex: reflex
reform: reform,reformed,reforms
reformation: reformation
refrain: refrain,refrained
refresh: refreshed
refreshment: refreshment,refreshments
refuge: refuge
refusal: refusal
refuse: refuse,refused,refuses,refusing
regain: regain,regained,regaining
regale: regaled
regard: regard,regarded
regiment: regiment,regiments
regimental: regimental
region: regions
register: register,registered
regret: regret,regretted,regretting
regretfully: regretfully
regular: regular
regulate: regulate,regulating
rehabilitate: rehabilitate
rehearsal: rehearsal
rehearse: rehearsing
rein: rein,reins
reject: rejected,rejecting
rejection: rejection
rejoice: rejoice,rejoiced,rejoicing
rejoicing: rejoicing
rejoin: rejoin
rejoinder: rejoinder
rejuvenated: rejuvenated
relate: relate,relating
relation: relation,relations
relationship: relationship,relationships
relative: relative,relatives
relax: relax,relaxing
relaxation: relaxation
relaxed: relaxed
relay: relays
release: release
relent: relented
relentlessly: relentlessly
relic: relic
relief: relief
relieve: relieve,relieved
religion: religion
religious: religious
religiously: religiously
relinquish: relinquish
relish: relish,relished
reluctance: reluctance
reluctantly: reluctantly
rely: rely,relying
remain: remain,remained,remaining,remains
remainder: remainder
remark: remark,remarked,remarks
remarkable: remarkable
remedy: remedies,remedy
remember: remember,remembered,remembering,remembers
remind: remind,reminded,reminding
reminiscence: reminiscence,reminiscences
remnant: remnants
remorse: remorse
remote: remote,remotest
remoteness: remoteness
removal: removal
remove: remove,removed,removing
rend: rending
render: rendered,rendering
rendezvous: rendezvous
renew: renew,renewed,renewing
renounce: renounce,renounced,renouncing
renowned: renowned
rent: rent,rented,rents
renunciation: renunciation
reopen: reopened
reorganization: reorganization
reorganize: reorganizing
rep: rep
repaint: repainted
repair: repair,repaired,repairing,repairs
repay: repay,repaying
repeat: repeat,repeated,repeating,repeats
repeatedly: repeatedly
repel: repelled
repellant: repellant
repent: repent,repented,repenting
repentance: repentance
repetition: repetition
replace: replaced,replacing
reply: replied,replies,reply,replying
report: report,reported,reports
repose: repose
reprehensible: reprehensible
represent: represent,represented,representing
representation: representations
representative: representative,representatives
repress: repress,repressed,repressing
reprimand: reprimand,reprimanded
reproach: reproach,reproached,reproaches,reproaching
reproachful: reproachful
reproachfully: reproachfully
reproachfulness: reproachfulness
reprove: reprove
reprovingly: reprovingly
repudiate: repudiated
repugnance: repugnance
repulse: repulse
repulsion: repulsion
repulsive: repulsive
repulsively: repulsively
reputation: reputation
request: request,requests
require: require,required
requirement: requirements
requisite: requisite
rescue: rescue,rescued
resemblance: resemblance
resemble: resembled
resent: resenting
resentment: resentment
reservation: reservations
reserve: reserve,reserving
resign: resigned
resist: resist,resisted
resistance: resistance
resolute: resolute
resolutely: resolutely
resolution: resolution,resolutions
resolve: resolved,resolving
resort: resorted
resound: resounded
resounding: resounding
resource: resources
respect: respect,respected,respects
respectable: respectable
respectful: respectful
respectfully: respectfully
respectfulness: respectfulness
respective: respective
respects: respects
resplendent: resplendent
respond: respond,responded,responding
response: response,responses
responsible: responsible
rest: rest,rested,resting,rests
restaurant: restaurant
restful: restful
restive: restive
restless: restless
restlessly: restlessly
restore: restore,restored
restrain: restrain,restrained,restraining
restrained: restrained
restraint: restraint
restriction: restrictions
result: result
resume: resumed
retain: retain,retained
retinue: retinue
retire: retire,retired,retiring
retired: retired
retreat: retreat,retreated,retreating
retrieve: retrieved
return: return,returned,returning
reveal: reveal,revealed,revealing
revelation: revelation,revelations
revelry: revelry
revenge: revenge
revenue: revenue,revenues
reverence: reverence
reverend: reverend
reverential: reverential
reverie: reverie,reveries
reverse: reverse,reversed
review: review,reviewed,reviews
revise: revising
revision: revision
revival: revival
revive: revive,revived,reviving
revoir: revoir
revolt: revolt,revolted
revolting: revolting
revolution: revolution
revolutionary: revolutionary
revolutionist: revolutionist
revolutionize: revolutionize
revolver: revolver
revulsion: revulsion
reward: reward,rewarded,rewarding,rewards
rhine: rhine
rhythm: rhythm
rhythmically: rhythmically
rib: rib,ribs
ribbon: ribbon,ribbons
rich: rich,richer
riches: riches
richly: richly
rid: rid
riddle: riddle
ride: ridden,ride,riding,rode
rider: rider,riders
ridge: ridge,ridges
ridicule: ridicule,ridiculed,ridiculing
ridiculous: ridiculous
riding: riding
rig: rigged
rightly: rightly
rigid: rigid
rigidity: rigidity
ringlet: ringlets
rinse: rinsed
ripe: ripe
ripen: ripen
rise: rise,risen,rises,rising,rose
risk: risk
risky: risky
rite: rite,rites
rival: rival,rivals
rivalry: rivalry
river: river
riverside: riverside
road: road,roads
roadside: roadside
roan: roan
roar: roar,roared,roaring,roars
roast: roast,roasting
rob: robbed
robe: robe,robes
robust: robust
rock: rock,rocking
rocking: rocking
rod: rod
rode: rode
roguish: roguish
roi: roi
roland: roland
roll: roll,rolled,rolling,rolls
rolling: rolling
roman: roman
romance: romance,romances
romantic: romantic
rome: rome
rond: rond
rood: rood
roof: roof,roofs
roomy: roomy
roost: roost
root: root,roots
rope: rope
rose: rose,roses
rosette: rosettes
rosy: rosier,rosy
rouble: rouble,roubles
rough: rough
roughly: roughly
roughness: roughness
rounded: rounded
roundly: roundly
rouse: rouse,roused,rouses,rousing
roused: roused
rousing: rousing
route: route
routine: routine
row: row,rows
rub: rub,rubbed,rubbing
rubbish: rubbish
rubens: rubens
rubicund: rubicund
ruddy: ruddy
rude: rude
rudeness: rudeness
ruefully: ruefully
ruffle: ruffled
rug: rug,rugs
ruin: ruin,ruined,ruining,ruins
rule: rule,rules
rum: rum
rumble: rumble,rumbled,rumbling
rumor: rumored,rumors
rupture: rupture
rural: rural
rush: rush,rushed,rushing
russe: russe
russia: russia
russian: russian,russians
russification: russification
rust: rust
rustle: rustle
rustling: rustling
rusty: rusty
rut: ruts
ruthlessly: ruthlessly
rye: rye
sack: sack,sacks
sacrament: sacrament
sacred: sacred
sacrifice: sacrifice,sacrificed,sacrifices
sad: sad
saddle: saddle,saddled,saddling
saddler: saddler
saddling: saddling
safe: safe
safeguard: safeguard
saffron: saffron
sage: sage
sail: sails
sailor: sailor
saint: saint
sainte: sainte
saintly: saintly
sake: sake
salary: salaries,salary
sale: sale,sales
sallow: sallow
salt: salt,salted
salutation: salutation
salvation: salvation
sam: sam
sameness: sameness
samovar: samovar
samson: samson
sancta: sancta
sanction: sanction,sanctioned
sanctity: sanctity
sanctuary: sanctuary
sand: sand,sands
sandy: sandy
sanity: sanity
sap: sap
sapling: saplings
sappho: sappho
sarcasm: sarcasm
sarcastic: sarcastic
sarcastically: sarcastically
sash: sash
satchel: satchel
satin: satin
satiny: satiny
satisfaction: satisfaction
satisfactorily: satisfactorily
satisfactory: satisfactory
satisfied: satisfied
satisfy: satisfied,satisfy,satisfying
saturate: saturated
saturday: saturday
sauce: sauce,sauces
saucer: saucers
saul: saul
saunter: saunter
sausages: sausages
savage: savage,savages
savageness: savageness
savant: savant,savants
save: save,saved,saving
savior: saviors
saxe: saxe
scaffold: scaffolds
scaffolding: scaffolding
scale: scale,scales
scallop: scalloped
scan: scanned,scanning
scandal: scandal,scandals
scandalous: scandalous
scant: scant
scanty: scanty
scapegoat: scapegoat
scarcely: scarcely
scare: scare,scared
scared: scared
scarf: scarf
scarifier: scarifier
scarlatina: scarlatina
scarlet: scarlet
scatter: scatter,scattered,scattering
scene: scene,scenes
scent: scent,scented,scents
scepticism: scepticism
scheme: scheme,schemes
scholar: scholar
school: school,schooled,schools
schoolboy: schoolboy,schoolboys
schoolfellow: schoolfellow,schoolfellows
schoolmistress: schoolmistress
schoolroom: schoolroom
science: science,sciences
scientific: scientific
scientifically: scientifically
scissors: scissors
scoffer: scoffer
scold: scold,scolded
scolding: scolding
scope: scope
scorch: scorched
scorched: scorched
score: score,scored
scorn: scorn
scornful: scornful
scotch: scotch
scoundrel: scoundrel,scoundrels
scoundrelly: scoundrelly
scowl: scowled,scowling
scrape: scrapes,scraping
scratch: scratching
scream: scream,screamed,screaming,screams
screaming: screaming
screen: screen,screens
screw: screw,screwed,screwing,screws
scribble: scribbled,scribbling
scripture: scripture
scrub: scrub,scrubbing
scruple: scruples
scrupulous: scrupulous
scrupulously: scrupulously
scrutinize: scrutinize,scrutinized,scrutinizing
scrutiny: scrutiny
sculptor: sculptor
sculpturesque: sculpturesque
scum: scum
scurry: scurrying
scythe: scythe,scythes
sea: sea
seal: seal,sealed,sealing,seals
seam: seams
search: search,searched,searching
season: season,seasoned
seat: seat,seated,seating,seats
seating: seating
seclusion: seclusion
secondarily: secondarily
secondary: secondary
secret: secret,secrets
secretary: secretary
secretly: secretly
sect: sects
secular: secular
secure: secure,securing
security: security
sedate: sedate
sedge: sedge
seductive: seductive
seed: seed,seeds
seek: seek,seeking,sought
seemly: seemly
seize: seize,seized,seizing
seldom: seldom
select: select,selected,selecting
selection: selection
selfish: selfish
selfishness: selfishness
sell: sell,selling,sold
seller: seller
seltzer: seltzer
semicircular: semicircular
sempstress: sempstress
send: send,sending,sends
sensation: sensation,sensations
sense: sense
senseless: senseless
senselessness: senselessness
sensibility: sensibility
sensibly: sensibly
sensitive: sensitive
sentence: sentence
sentiment: sentiment,sentiments
sentimental: sentimental
sentimentality: sentimentality
separate: separate,separated,separates
separately: separately
separation: separation
sept: sept
september: september
sequel: sequel
sequence: sequence
serenade: serenade,serenades
serene: serene
serenely: serenely
serenity: serenity
serf: serf,serfs
serfdom: serfdom
serge: serge
series: series
seriousness: seriousness
serum: sera
servant: servant,servants
serve: serve,served,serves,serving
service: service,services
session: session
set: set,sets,setting
settee: settee
setter: setter
setting: setting
settle: settle,settled,settles,settling
settled: settled
settlement: settlement
seventeen: seventeen
seventh: seventh
sever: severed
severance: severance
severe: severe
severely: severely
severity: severity
sew: sewn
sewing: sewing
sha: sha
shabby: shabby
shade: shade,shaded
shades: shades
shadow: shadow,shadows
shady: shady
shaft: shaft,shafts
shag: shag
shaggy: shaggy
shake: shake,shaken,shaking,shook
shakespeare: shakespeare
shaky: shaky
shallow: shallow
shallowness: shallowness
sham: sham
shame: shame
shamefaced: shamefaced
shameful: shameful
shamefully: shamefully
shamelessly: shamelessly
shape: shape,shaped,shapes
shapely: shapely
share: share,shared,shares,sharing
shareholder: shareholder
sharp: sharp,sharper
sharpen: sharpened,sharpening
sharply: sharply
shatter: shatter,shattered
shave: shaved
shaven: shaven
shaving: shaving
shawl: shawl
sheaf: sheaves
sheep: sheep
sheepskin: sheepskin,sheepskins
sheet: sheet,sheets
shelf: shelf
shelter: shelter
sherry: sherry
shift: shifted,shifting
shilling: shillings
shine: shine,shining,shone
ship: ship,ships
shirt: shirt,shirts
shiver: shivered
shock: shock,shocks
shocking: shocking
shod: shod
shoe: shoe,shoes
shoemaker: shoemaker
shoot: shoot,shooting,shoots,shot
shooting: shooting
shop: shop,shops
shopkeeper: shopkeeper
shopman: shopman
shopping: shopping
shore: shore
short: short
shortcoming: shortcomings
shortly: shortly
shot: shot,shots
shoulder: shoulder,shouldered,shouldering,shoulders
shout: shout,shouted,shouting,shouts
shouting: shouting
shove: shove,shoved,shoving
shower: shower,showers
shrewd: shrewd
shriek: shriek,shrieked,shrieking,shrieks
shrieking: shrieking
shrill: shrill
shrilly: shrilly
shrine: shrine
shrink: shrank,shrink,shrinking,shrunk
shroud: shrouded
shrug: shrug,shrugged,shrugging
shudder: shudder,shuddered,shuddering
shuffling: shuffling
shut: shut,shutting
shutter: shutter,shutters
shy: shy
shyly: shyly
shyness: shyness
sich: sich
sick: sick
sicken: sickens
sickening: sickening
sickliness: sickliness
sickly: sickly
sickness: sickness
sideboard: sideboard
sided: sided
sidedness: sidedness
sidelong: sidelong
sideways: sideways
sidle: sidling
sieve: sieve
sift: sifted
sigh: sigh,sighed,sighing
sight: sight,sights
sighted: sighted
sign: sign,signed,signing,signs
signal: signal,signaled
signature: signature
significance: significance
signify: signify,signifying
silence: silence
silent: silent
silently: silently
silk: silk
silken: silken
silky: silky
silly: silly
silver: silver
silvery: silvery
simile: simile,similes
simper: simper
simple: simple,simpler,simplest
simplehearted: simplehearted
simplicity: simplicity
simplify: simplified
simply: simply
simultaneously: simultaneously
sin: sin,sinned,sins
sincerely: sincerely
sincerity: sincerity
sinew: sinews
sinful: sinful
sing: sang,sing,singing,sings,sung
singer: singer,singers
singing: singing
single: single
singly: singly
singular: singular
sink: sank,sink,sinking,sinks,sunk,sunken
sinner: sinner,sinners
sip: sipped,sips
sir: sir
sister: sister,sisters
sit: sat,sit,sits,sitting
sitting: sitting,sittings
situation: situation
sixpence: sixpence
sixteen: sixteen
sixth: sixth
size: size
skate: skate,skated,skates,skating
skater: skater,skaters
skating: skating
skeleton: skeleton,skeletons
skep: skep
sketch: sketch,sketched,sketching
sketchy: sketchy
skill: skill
skillful: skillful
skillfully: skillfully
skim: skim
skin: skin
skinned: skinned
skip: skip,skipping,skips
skirmish: skirmish
skirt: skirt,skirted,skirts
sky: skies,sky
slacken: slackened,slackening
slake: slaking
slam: slam,slammed,slamming
slander: slander
slant: slanting
slap: slapped,slapping
slate: slate
slave: slave,slaves
slavery: slavery
slavish: slavish
slavonic: slavonic
sledge: sledge,sledges
sledging: sledging
sleek: sleek
sleep: sleep,sleeping,sleeps,slept
sleeper: sleepers
sleepily: sleepily
sleeping: sleeping
sleepless: sleepless
sleeplessness: sleeplessness
sleepy: sleepy
sleeve: sleeve,sleeves
slender: slender
slice: slices
slide: slide,sliding
slight: slight,slighted,slightest
slightingly: slightingly
slim: slim
slime: slime
sling: sling
slip: slip,slipped,slipping
slipper: slippers
slippery: slippery
slit: slits
slop: slops
slope: slope,sloping
sloth: sloth
slovenliness: slovenliness
slow: slow
slowly: slowly
slur: slur
slush: slush
slushy: slushy
sly: sly
slyly: slyly
slyness: slyness
smack: smacked,smacking
smallpox: smallpox
smart: smart
smartly: smartly
smash: smashed,smashing
smear: smearing
smell: smell,smelling,smells,smelt
smile: smile,smiled,smiles,smiling
smilingly: smilingly
smite: smite,smitten,smote
smock: smock
smoke: smoke,smoked,smoking
smoking: smoking
smooth: smooth,smoothed,smoothing
smoothly: smoothly
smoothness: smoothness
smother: smother,smothered
snake: snake
snap: snap,snapped,snapping
snare: snares
snatch: snatch,snatched,snatching
sneer: sneer,sneering
sneeringly: sneeringly
sneeze: sneezed
sniff: sniff,sniffed,sniffing
snipe: snipe
snore: snore,snoring
snort: snort,snorted,snorting,snorts
snow: snow
snowdrift: snowdrift
snowstorm: snowstorm
snowy: snowy
snug: snug
soak: soaked,soaking
soap: soap
sob: sob,sobbed,sobbing,sobs
social: social
socialism: socialism
socialistic: socialistic
socially: socially
society: societies,society
sociology: sociology
socrates: socrates
sofa: sofa,sofas
soft: soft,softer
soften: soften,softened,softening
softened: softened
softening: softening
softly: softly
softness: softness
soil: soil
soldier: soldier,soldiers
sole: sole
solely: solely
solemn: solemn
solemnly: solemnly
solicitor: solicitor
solicitous: solicitous
solicitude: solicitude
solid: solid
solitary: solitary
solitude: solitude
solo: solo
solution: solution,solutions
solve: solve,solved
somersault: somersaults
son: son,sons
song: song,songs
soothe: soothe,soothed,soothing
soothed: soothed
soothing: soothing
soothingly: soothingly
sop: sop
sophistry: sophistries,sophistry
sore: sore
sorrel: sorrel
sorrento: sorrento
sorrow: sorrow,sorrows
sort: sort,sorted,sorting,sorts
soul: soul,souls
sound: sound,sounded,sounding,sounds
soundly: soundly
soup: soup
sour: sour
source: source,sources
souse: sousing
south: south
southern: southern
sow: sow,sowed,sowing,sown
sowing: sowing
space: space
spade: spade,spades
spain: spain
spanish: spanish
spare: spare,spared
spark: spark
sparkle: sparkled,sparkling
sparkling: sparkling
sparrow: sparrow
spat: spats
spatter: spatter,spattered
speak: speak,speaking,speaks,spoke,spoken
speaker: speaker,speakers
speaking: speaking
special: special
specialist: specialist,specialists
specialized: specialized
specially: specially
specialty: specialty
specimen: specimens
speck: speck
spectacles: spectacles
spectator: spectator,spectators
speculate: speculate
speculation: speculation
speculator: speculator,speculators
speech: speech,speeches
speed: speed
speedily: speedily
spell: spell
spellbound: spellbound
spencer: spencer
spend: spend,spending,spent
spending: spending
sphere: sphere,spheres
spider: spider,spiders
spiderweb: spiderweb
spill: spill,spilling
spilt: spilt
spin: spin,spinning
spinal: spinal
spindle: spindle
spine: spine
spirit: spirit,spirits
spirited: spirited
spiritual: spiritual
spiritualism: spiritualism
spiritualist: spiritualists
spiritually: spiritually
spite: spite
spiteful: spiteful
spittle: spittle
splash: splash,splashed,splashing
splendid: splendid
splendidly: splendidly
splendor: splendor
split: split
splutter: spluttered
spoil: spoil,spoiled,spoiling,spoilt
spoiled: spoiled
spoke: spokes
spokesman: spokesman
sponge: sponging
spontaneously: spontaneously
spoon: spoon
sport: sport,sports
sportsman: sportsman,sportsmen
spot: spot,spots,spotted
spotted: spotted
spouse: spouse
sprain: sprained
sprawl: sprawling
spread: spread
spring: sprang,spring,springing,springs,sprung
springiness: springiness
springy: springy
sprinkle: sprinkle,sprinkled
spruce: spruce
spur: spurs
squabble: squabbles
squall: squall
squalling: squalling
square: square,squared,squaring
squarely: squarely
squat: squat,squatting
squeak: squeaked
squeeze: squeeze,squeezed,squeezing
squelch: squelching
squirrel: squirrel
squirt: squirting
stab: stabbed
stable: stable,stables
staccato: staccato
stack: stack,stacks
staff: staff
stag: stag
stage: stage
stagger: staggered,staggering
staggering: staggering
stagnant: stagnant
stagnate: stagnate
stagnation: stagnation
stain: stained
stair: stairs
staircase: staircase
stake: stake,stakes,staking
stale: stale
stalk: stalk,stalked,stalks
stall: stall,stalls
stallion: stallion
stammer: stammered
stamp: stamp,stamping
stand: stand,standing,stands,stood
standard: standard
standing: standing
standpoint: standpoint
standstill: standstill
star: star,stars
starch: starched
starched: starched
starchy: starchy
stare: stare,stared,staring
start: start,started,starting,starts
starting: starting
startle: startled
startled: startled
starve: starve
stately: stately
statement: statement,statements
statesman: statesman,statesmen
station: station
statue: statue
status: status
stay: stay,stayed,staying,stays
staying: staying
steadfast: steadfast
steadily: steadily
steady: steady
steak: steak
steal: steal,stealing,stole,stolen
stealing: stealing
stealthily: stealthily
stealthy: stealthy
steam: steam,steaming
steamer: steamer
steamy: steamy
steed: steed
steel: steel
steely: steely
steep: steep,steeped
steeplechase: steeplechase
steer: steered,steering
stem: stem
step: step,stepped,stepping,steps
stepmother: stepmother
steppe: steppe,steppes
steppes: steppes
stepson: stepson
stereotype: stereotyped
sterling: sterling
stern: stern
sternly: sternly
stethoscope: stethoscope
steward: steward
stick: stick,sticking,sticks,stuck
sticky: sticky
stiff: stiff
stiffen: stiffened,stiffening
stiffly: stiffly
stiffness: stiffness
stifle: stifle,stifled,stifling
stifling: stifling
stillness: stillness
stimulate: stimulated,stimulating
stimulus: stimulus
sting: stinging,stung
stink: stinking
stipulation: stipulation
stipule: stipules
stir: stir,stirred,stirring
stirring: stirring
stirrup: stirrup
stitch: stitches
stock: stock,stocking,stocks
stocking: stocking,stockings
stomach: stomach
stone: stone,stones
stony: stony
stoop: stoop,stooped,stooping
stooping: stooping
stopping: stopping
store: store,stores,storing
storeroom: storeroom
storm: storm,storms
stormy: stormy
story: stories,story
storytelling: storytelling
stout: stout
stoutly: stoutly
stove: stove
straight: straight
straighten: straightened,straightening
straightforward: straightforward
straightforwardness: straightforwardness
strain: strain,strained,straining,strains
strained: strained
strange: strange,strangest
strangely: strangely
strangeness: strangeness
stranger: stranger,strangers
strangle: strangle
strap: strap,strapped,straps
strata: strata
strauss: strauss
straw: straw
strawberry: strawberries
stray: stray,strayed,straying
streak: streak,streaks
stream: stream,streamed,streaming,streams
streaming: streaming
street: street,streets
strength: strength
strengthen: strengthen,strengthened
strenuous: strenuous
strenuously: strenuously
stress: stress
stretch: stretch,stretched,stretching
strew: strewn
stricken: stricken
strict: strict,strictest
strictly: strictly
stride: stride,strides,strode
strife: strife
strike: strike,strikes,striking,struck
striking: striking
strikingly: strikingly
string: string,strings
stringed: stringed
stringy: stringy
strip: strip,striped,stripped,stripping,strips
stripe: stripes
strive: strive,striven,striving
stroke: stroke,stroked,strokes,stroking
stroll: stroll
strong: strong,stronger
struggle: struggle,struggled,struggles,struggling
stubble: stubble
stubborn: stubborn
stubbornly: stubbornly
stucco: stuccoed
stud: stud,studded,studs
student: student,students
studio: studio,studios
studiously: studiously
study: studied,studies,study,studying
stuff: stuff
stuffy: stuffy
stumble: stumble,stumbled,stumbling
stumbling: stumbling
stump: stump
stupefied: stupefied
stupefy: stupefied
stupid: stupid,stupider
stupidly: stupidly
sturdy: sturdy
sturgeon: sturgeon
stutter: stuttered
style: style,styled
stylish: stylish
subaltern: subalterns
subdivide: subdivided
subdivision: subdivisions
subdue: subdued
subdued: subdued
subject: subject,subjects
subjection: subjection
sublime: sublime
submission: submission
submissive: submissive
submissively: submissively
submissiveness: submissiveness
submit: submit,submitted
subordinate: subordinated,subordinates
subscribe: subscribed
subscription: subscriptions
subsequent: subsequent
subside: subside,subsided,subsiding
substance: substance
substitute: substitute,substituted
subtle: subtle
subtlety: subtleties
subtly: subtly
subtraction: subtraction
suburb: suburb
succeed: succeed,succeeded,succeeding
success: success
successful: successful
succession: succession
succor: succor
succulent: succulent
succumb: succumbed
suck: sucked,sucking
suckle: suckle
sudden: sudden
suddenly: suddenly
suffer: suffer,suffered,suffering
sufferer: sufferer
suffering: suffering,sufferings
sufficient: sufficient
suffuse: suffused
sugar: sugar
suggestion: suggestion,suggestions
suggestive: suggestive
suit: suit,suited,suits
suitability: suitability
suitable: suitable
suitably: suitably
suite: suite
suitor: suitors
sullen: sullen
sully: sullying
sum: sum,summed,summing,sums
summer: summer
summon: summon,summoned
summons: summons
sumptuous: sumptuous
sumptuousness: sumptuousness
sun: sun
sunbeam: sunbeams
sunburnt: sunburnt
sunday: sunday
sunken: sunken
sunlight: sunlight
sunny: sunny
sunrise: sunrise
sunset: sunset
sunshade: sunshade
sunshine: sunshine
superb: superb
superficial: superficial
superficiality: superficiality
superfluous: superfluous
superintend: superintend
superintendence: superintendence
superintendent: superintendents
superior: superior,superiors
superiority: superiority
supernatural: supernatural
supersede: supersede
superstructure: superstructure
supervision: supervision
supper: supper
supplant: supplants
supple: supple
supplicating: supplicating
supplication: supplication
supply: supplied,supplies,supply
support: support,supported,supporting
supporter: supporter,supporters
suppose: suppose,supposed,supposes,supposing
supposition: supposition,suppositions
suppress: suppress,suppressed,suppressing
supremely: supremely
surely: surely
surety: surety
surface: surface
surge: surged,surging
surgeon: surgeon
surmise: surmised,surmises
surmount: surmount,surmounting
surname: surname
surplice: surplices
surplus: surplus
surprise: surprise,surprised,surprises
surprised: surprised
surprising: surprising
surrender: surrender,surrendered
surreptitiously: surreptitiously
surround: surrounded,surrounding
surroundings: surroundings
survey: survey
survive: survived
susceptible: susceptible
suspect: suspect,suspected,suspecting
suspense: suspense
suspicion: suspicion,suspicions
suspicious: suspicious
sustain: sustain,sustained
swaddle: swaddling
swain: swain
swallow: swallow,swallowed,swallowing,swallows
swamp: swamp
swampy: swampy
swarm: swarm,swarmed,swarming,swarms
swathe: swathed
sway: sway,swayed,swaying
swaying: swaying
swear: swear,swore
swearing: swearing
sweat: sweat
swede: swede
sweden: sweden
swedish: swedish
sweep: sweep,sweeping,swept
sweet: sweet,sweetest,sweets
sweetmeat: sweetmeats
sweetness: sweetness
swell: swell,swelled,swelling,swollen
swift: swift
swiftly: swiftly
swiftness: swiftness
swim: swim,swimming
swimming: swimming
swindle: swindle,swindling
swindler: swindler
swine: swine
swing: swing,swinging,swings,swung
swinging: swinging
swinishness: swinishness
swish: swish,swishing
switch: switched
switzerland: switzerland
swollen: swollen
swoop: swoop,swooped,swooping
sword: sword
syllable: syllable,syllables
syllogism: syllogism
symbol: symbol
symmetry: symmetry
sympathetic: sympathetic
sympathetically: sympathetically
sympathize: sympathize,sympathized,sympathizing
sympathizing: sympathizing
sympathy: sympathies,sympathy
symptom: symptom,symptoms
synod: synod
synopsis: synopsis
syrup: syrup
table: table,tables
tablecloth: tablecloths
tabula: tabula
taciturn: taciturn
taciturnity: taciturnity
tack: tacked
tackle: tackle
tact: tact
tactic: tactics
tail: tail,tails
tailor: tailor
tale: tale,tales
talent: talent,talents
talk: talk,talked,talking,talks
talkative: talkative
talker: talker,talkers
talking: talking
tall: tall,taller
tallow: tallow
tan: tan
tangle: tangle,tangled
tangled: tangled
tank: tank
tanya: tanya
tap: tap,tapped,tapping
tape: tape,tapes
tar: tar
tardiness: tardiness
tart: tart
task: task
tassel: tassel,tassels
taste: taste,tasted,tastes,tasting
tastelessly: tastelessly
tatar: tatar
tatters: tatters
tavern: tavern,taverns
tax: taxes,taxing
taxpayer: taxpayer
tea: tea
teach: taught,teach,teaching
teacher: teacher,teachers
teaching: teaching
tear: tear,tearing,tears,tore,torn
tearful: tearful
tease: teased,teasing
technique: technique
tedious: tedious
telegram: telegram,telegrams
telegraph: telegraph
telegraphing: telegraphing
temper: temper,tempered,tempers
temperament: temperament
temperature: temperature
tempest: tempest
temple: temple,temples
temporary: temporary
tempt: tempt,tempted
temptation: temptation
tend: tending
tendency: tendencies,tendency
tender: tender,tenderest
tenderer: tenderer
tenderly: tenderly
tenderness: tenderness
tendril: tendrils
tenfold: tenfold
tennis: tennis
tenor: tenor,tenors
tense: tense
tension: tension
tenth: tenth,tenths
tenure: tenure
term: term,terms
terrace: terrace
terre: terre
terrible: terrible
terribly: terribly
terrified: terrified
terror: terror,terrors
testament: testament
thaler: thalers
thankful: thankful
thanklessness: thanklessness
thatching: thatching
thaw: thaw,thawed,thaws
thawing: thawing
theater: theater
thee: thee
theologian: theologians
theology: theology
theoretical: theoretical
theoretically: theoretically
theory: theories,theory
thermometer: thermometer
thicket: thicket,thickets
thickly: thickly
thief: thief
thigh: thighs
thinker: thinker,thinkers
thinking: thinking
thinness: thinness
thinning: thinning
thinnish: thinnish
thirdly: thirdly
thirst: thirst
thirteen: thirteen
thirteenth: thirteenth
thoroughbred: thoroughbred
thoughtful: thoughtful
thoughtfully: thoughtfully
thoughtless: thoughtless
thoughtlessly: thoughtlessly
thoughtlessness: thoughtlessness
thrash: thrashed,thrashing
thread: thread,threading,threads
threadbare: threadbare
threat: threat
threaten: threatening
threshing: threshing
thrill: thrill
thrilled: thrilled
thrilling: thrilling
throat: throat,throats
throb: throbbed,throbbing,throbs
throbbing: throbbing
throng: throng,thronged,thronging
throw: threw,throw,throwing,thrown,throws
thrust: thrust,thrusting
thud: thud,thudding
thule: thule
thunder: thunder
thursday: thursday
thursdays: thursdays
thy: thy
ticket: ticket
tickle: tickled
tidily: tidily
tidy: tidy,tidying
tie: tie,tied,ties,tying
tiger: tiger
tight: tight,tighter
tighten: tightened,tightening
tightly: tightly
tillage: tillage
tilt: tilt,tilted
timber: timber
time: time,times
timetable: timetable
timid: timid
timidity: timidity
timidly: timidly
timorously: timorously
tin: tin
tingle: tingled
tinkle: tinkle
tinplate: tinplate
tiny: tinier,tiniest,tiny
tipsy: tipsy
tiptoe: tiptoe
tire: tire,tires
tired: tired
tiresome: tiresome
tit: tit
titian: titian
title: title
toady: toadying
toast: toast
tobacco: tobacco
toe: toe,toes
toil: toil
toilet: toilet
toilette: toilette
token: token,tokens
tolerable: tolerable
tolstoy: tolstoy
tomb: tomb
tomorrow: tomorrow
ton: ton
tone: tone,tones
tongue: tongue,tongues
tonight: tonight
tool: tools
tooth: teeth,tooth
toothache: toothache
toothed: toothed
toothless: toothless
topic: topic,topics
topsy: topsy
torment: torment,tormented,tormenting,torments
torn: torn
torrent: torrent,torrents
tortoise: tortoise
torture: torture,tortured,tortures,torturing
tortured: tortured
toss: tossed,tossing
totally: totally
totter: totter,tottered,tottering
touch: touch,touched,touches,touching
touchiness: touchiness
touching: touching
touchingly: touchingly
tour: tour,tours
tout: tout
towel: towel,towels
tower: towered
town: town,towns
townsfolk: townsfolk
townspeople: townspeople
toy: toy,toys
toys: toys
trace: trace,traces
track: track,tracks
tract: tract,tracts
trade: trade,trades
tradition: tradition
traditionalism: traditionalism
tragedian: tragedians
tragedy: tragedy
tragic: tragic
tragically: tragically
train: train,trained,trains
trainer: trainer
training: training
trait: trait,traits
tramp: tramp
trample: trample,trampled,trampling
trampled: trampled
trance: trance
tranquil: tranquil
tranquillity: tranquillity
transact: transact
transcendental: transcendental
transfer: transferred
transform: transform,transformed
transformation: transformation,transformations
transient: transient
transition: transition,transitions
translate: translate,translated,translating
translation: translation
transmigration: transmigration
transmission: transmission
transparent: transparent
transport: transported
transpose: transposed
trap: trap
trapeze: trapeze
travel: travel,traveled,traveling
traveler: traveler,travelers
traveling: traveling
travels: travels
tray: tray,trays
treachery: treacheries,treachery
tread: tread,treading
treading: treading
treasure: treasure
treat: treat,treated,treating
treatise: treatise
treatment: treatment
tree: tree,trees
treillage: treillage
tremble: tremble,trembled,trembling
tremendously: tremendously
trend: trend
trepidation: trepidation
tress: tress
trial: trial,trials
triangle: triangle,triangles
tribe: tribes
tribes: tribes
tribunal: tribunal
tribute: tribute
trice: trice
trick: trick,tricks
trickery: trickery
trickle: trickling
trifle: trifle,trifles,trifling
trifling: trifling
trigger: trigger
trill: trilled
trim: trimmed
trinity: trinity
trinket: trinkets
triumph: triumph,triumphed,triumphing
triumphant: triumphant
triumphantly: triumphantly
trivial: trivial
triviality: triviality
trodden: trodden
trois: trois
trolley: trolleys
trop: trop
trot: trot,trotted,trotting
troth: troth
trotter: trotter
trouble: trouble,troubled,troubles,troubling
troubled: troubled
troubling: troubling
trough: trough
trousers: trousers
trousseau: trousseau
trowel: trowels
trudge: trudging
true: true,truer
truffle: truffles
trunk: trunk,trunks
truss: trussing
trust: trust,trusted
trustee: trustee
trustfully: trustfully
trustworthy: trustworthy
truth: truth,truths
truthful: truthful
truthfully: truthfully
truthfulness: truthfulness
tsar: tsar
tuberculous: tuberculous
tuck: tucked,tucking
tuesday: tuesday
tuft: tuft,tufts
tug: tugged,tugging
tulle: tulle
tumbler: tumbler
tunic: tunic
turban: turban
turbid: turbid
turbot: turbot
turkey: turkey,turkeys
turkish: turkish
turks: turks
turmoil: turmoil
turvy: turvy
tutor: tutor
twig: twig,twigs
twilight: twilight
twinge: twinge
twinkle: twinkle,twinkled,twinkling
twirl: twirling
twist: twist,twisted,twisting
twisted: twisted
twisting: twisting
twitch: twitch,twitched
twitching: twitching
twitter: twittered
twopence: twopence
type: type,types
typhus: typhus
typical: typical
ud: ud
udder: udder,uddered
ugh: ugh
ugliness: ugliness
ugly: uglier,ugly
umpire: umpire
unable: unable
unaccountable: unaccountable
unaccustomed: unaccustomed
unaffected: unaffected
unaided: unaided
unalterable: unalterable
unalterably: unalterably
unanimously: unanimously
unannounced: unannounced
unanswered: unanswered
unapproachable: unapproachable
unasked: unasked
unassailable: unassailable
unattainable: unattainable
unattractive: unattractive
unavoidable: unavoidable
unaware: unaware
unawares: unawares
unbearable: unbearable
unbearably: unbearably
unbecoming: unbecoming
unbecomingly: unbecomingly
unbelief: unbelief
unbeliever: unbeliever,unbelievers
unbelieving: unbelieving
unbend: unbending
unbridled: unbridled
unbroken: unbroken
unbutton: unbuttoned
unbuttoned: unbuttoned
uncalled: uncalled
uncanny: uncanny
unceasing: unceasing
unceasingly: unceasingly
uncertain: uncertain
uncertainly: uncertainly
uncertainty: uncertainty
unchanged: unchanged
uncivil: uncivil
uncle: uncle,uncles
uncleanness: uncleanness
uncomfortable: uncomfortable
uncommonly: uncommonly
uncomprehended: uncomprehended
uncompromising: uncompromising
uncongenial: uncongenial
unconscious: unconscious
unconsciously: unconsciously
unconsciousness: unconsciousness
uncontrollably: uncontrollably
uncork: uncorking
uncouth: uncouth
uncover: uncover,uncovered,uncovering
uncrook: uncrooked
unction: unction
uncut: uncut
undefined: undefined
underclothes: underclothes
undergo: undergoing
undergrowth: undergrowth
underlie: underlying
understand: understand,understanding,understands,understood
understanding: understanding
understood: understood
undertake: undertake,undertaken,undertaking
undertaking: undertaking,undertakings
undeserved: undeserved
undesigned: undesigned
undeveloped: undeveloped
undignified: undignified
undisguised: undisguised
undivided: undivided
undo: undid,undo,undone
undoubted: undoubted
undoubtedly: undoubtedly
undress: undress,undressed,undressing
undressed: undressed
undue: undue
undulating: undulating
unearned: unearned
unearthly: unearthly
uneasily: uneasily
uneasiness: uneasiness
uneasy: uneasy
unemphatically: unemphatically
unequal: unequal
unequaled: unequaled
unequally: unequally
uneven: uneven
unevenly: unevenly
uneventful: uneventful
unexpected: unexpected
unexpectedly: unexpectedly
unfailing: unfailing
unfair: unfair
unfairness: unfairness
unfaithful: unfaithful
unfaithfulness: unfaithfulness
unfamiliar: unfamiliar
unfasten: unfastening
unfathomable: unfathomable
unfavorable: unfavorable
unfeeling: unfeeling
unfeigned: unfeigned
unfeminine: unfeminine
unfinished: unfinished
unfit: unfit
unflagging: unflagging
unfold: unfold,unfolded,unfolding
unforeseen: unforeseen
unfortunate: unfortunate
unfrequent: unfrequent
ungracious: ungracious
unhappily: unhappily
unhappiness: unhappiness
unhappy: unhappy
unharness: unharness,unharnessing
unharnessed: unharnessed
unhasting: unhasting
unhealthily: unhealthily
unhesitating: unhesitating
unhinge: unhinged
unhook: unhooked
unhurt: unhurt
unification: unification
uniform: uniform,uniforms
uniformly: uniformly
unimpeachable: unimpeachable
unimportant: unimportant
unintelligible: unintelligible
uninteresting: uninteresting
uninterrupted: uninterrupted
union: union
unique: unique
unison: unison
unite: united,uniting
united: united
unity: unity
universal: universal
university: universities,university
unjust: unjust
unjustly: unjustly
unkempt: unkempt
unkindness: unkindness
unknown: unknown
unlawful: unlawful
unlawfully: unlawfully
unlearn: unlearning
unlighted: unlighted
unlooked: unlooked
unloose: unloosed
unloved: unloved
unluckily: unluckily
unlucky: unlucky
unmarried: unmarried
unmelted: unmelted
unmistakable: unmistakable
unmistakably: unmistakably
unmoved: unmoved
unmown: unmown
unnatural: unnatural
unnaturally: unnaturally
unnaturalness: unnaturalness
unnecessary: unnecessary
unnoticed: unnoticed
unobserved: unobserved
unobtrusively: unobtrusively
unoccupied: unoccupied
unpack: unpack,unpacked,unpacking
unpacked: unpacked
unpardonable: unpardonable
unpardonably: unpardonably
unpleasant: unpleasant
unpleasantly: unpleasantly
unpleasantness: unpleasantness
unprepared: unprepared
unprepossessing: unprepossessing
unproductive: unproductive
unproductively: unproductively
unprofitably: unprofitably
unqualified: unqualified
unquestionable: unquestionable
unreasonable: unreasonable
unresisting: unresisting
unresting: unresting
unromantic: unromantic
unsatisfactory: unsatisfactory
unsatisfied: unsatisfied
unscrewed: unscrewed
unseemly: unseemly
unseen: unseen
unsettled: unsettled
unsolved: unsolved
unsound: unsound
unspoken: unspoken
unstirred: unstirred
unsuccessful: unsuccessful
unsuitability: unsuitability
unsuitable: unsuitable
unsullied: unsullied
unsuspecting: unsuspecting
unsympathetic: unsympathetic
untarnished: untarnished
untidy: untidy
untie: untied
untouched: untouched
untrained: untrained
untroubled: untroubled
untrue: untrue
untruly: untruly
untruss: untrussing
untruth: untruth
unusual: unusual
unusually: unusually
unutterable: unutterable
unutterably: unutterably
unvarying: unvarying
unwarily: unwarily
unwell: unwell
unwholesome: unwholesome
unwilling: unwilling
unwillingly: unwillingly
unwithered: unwithered
unwonted: unwonted
unworthily: unworthily
unworthiness: unworthiness
unworthy: unworthy
unyoke: unyoked
uphill: uphill
uphold: upheld,upholding
upland: upland,uplands
upper: upper
uppermost: uppermost
upright: upright
upset: upset,upsets
upsetting: upsetting
upside: upside
upstairs: upstairs
upstart: upstarts
upward: upward
urbanity: urbanity
urge: urge,urged,urging
urgent: urgent
urgently: urgently
useless: useless
uselessness: uselessness
usher: ushering
usual: usual
utility: utility
utmost: utmost
utopia: utopia
utter: utter,uttered,uttering
utterance: utterance,utterances
utterly: utterly
vacate: vacated
vaccinate: vaccinate
vacillate: vacillating
vague: vague,vaguest
vaguely: vaguely
vain: vain
vainly: vainly
valet: valet
valley: valley
valorous: valorous
valuable: valuable
van: van
vanish: vanished,vanishes,vanishing
vanity: vanity
vanquish: vanquished
vapor: vapor
varied: varied
variety: variety
variously: variously
varnish: varnished
varnished: varnished
vase: vase,vases
vast: vast
vat: vats
vault: vaulted
vegetable: vegetable,vegetables
vegetate: vegetating
vehicle: vehicle
veil: veil,veiled
vein: veins
velvet: velvet
velvety: velvety
venerable: venerable
venetian: venetian
vengeance: vengeance
venice: venice
ventilation: ventilation
ventilator: ventilator
venture: venture,ventured,venturing
venus: venus
ver: vers
verbal: verbal
verbose: verbose
verification: verification
verify: verified,verify
vermin: vermin
verse: verse,verses
vertebra: vertebrae
vespers: vespers
vestal: vestals
vestige: vestige
vestment: vestment,vestments
veteran: veteran
veterinary: veterinary
vex: vexed
vexation: vexation
vexatious: vexatious
vexing: vexing
vibration: vibration
vicar: vicar
vice: vices
vicious: vicious
viciously: viciously
victim: victim
victory: victory
vienna: vienna
view: view,viewed,views
vigor: vigor
vigorous: vigorous
vigorously: vigorously
vile: vile
villa: villa,villas
village: village,villages
villain: villain,villains
vinaigre: vinaigre
vindicate: vindicate
vindictive: vindictive
vindictiveness: vindictiveness
vinegar: vinegar
violence: violence
violent: violent
violently: violently
violet: violet
virtue: virtue,virtues
virtuous: virtuous
vis: vis
visible: visible
visibly: visibly
vision: vision,visions
visit: visit,visited,visiting,visits
visitor: visitor,visitors
vital: vital
vitality: vitality
vite: vite
vive: vive
vivid: vivid
vividly: vividly
vividness: vividness
vladimir: vladimir
vocation: vocation
vodka: vodka
vogue: vogue
voice: voice,voices
volga: volga
volume: volume
vote: vote,voted,votes,voting
voting: voting
vouchsafe: vouchsafe,vouchsafed,vouchsafing
vulgar: vulgar
vulgarity: vulgarity
vulgarize: vulgarize
vulgarly: vulgarly
wade: wade
wafer: wafer
wag: wag,wagging,wags
wage: wage,waging
wages: wages
wagner: wagner
wagon: wagon,wagons
wagonette: wagonette
wail: wailed,wailing
wain: wain
waist: waist,waists
waistcoat: waistcoat,waistcoats
wait: wait,waited,waiting
waiter: waiter,waiters
waiting: waiting
waitress: waitresses
wake: wake,waked,waking,woke
walk: walk,walked,walking,walks
walking: walking
walks: walks
wall: wall,walls
wallpaper: wallpapers
waltz: waltz,waltzed,waltzes,waltzing
waltzing: waltzing
wander: wandered,wandering
wane: wane,waned,waning
war: war
ward: ward,wards
wardrobe: wardrobe
wardship: wardship,wardships
warehouse: warehouse
warfare: warfare
warily: warily
warm: warm,warmed,warmer
warmly: warmly
warmth: warmth
warn: warn,warned,warning
warning: warning
warrior: warriors
wary: wary
wash: wash,washed,washing
washed: washed
washhouse: washhouse
washing: washing
washstand: washstand
waste: waste,wasted,wastes,wasting
wastepaper: wastepaper
wasting: wasting
watch: watch,watched,watches,watching
watchmaker: watchmaker
watchman: watchman
water: water,waters
watering: watering
wave: wave,waved,waves,waving
waver: waver,wavered,wavering
wavering: wavering
wax: wax,waxing
weak: weak
weaken: weakened,weakening
weakly: weakly
weakness: weakness,weaknesses
weal: weal
wealth: wealth
wealthy: wealthy
wean: weaned
weapon: weapon
wear: wear,wearing,wore,worn
wearer: wearers
wearily: wearily
weariness: weariness
wearisome: wearisome
weary: wearied,weary
weather: weather
wedding: wedding
wedlock: wedlock
wednesday: wednesday
wee: wee
weed: weed,weeding,weeds
week: week,weeks
weep: weep,weeping
weigh: weigh,weighed,weighing,weighs
weight: weight,weights
weighty: weighty
weirdness: weirdness
welfare: welfare
wench: wench,wenches
west: west
western: western
wet: wet,wetted,wetting
wheat: wheat
wheel: wheel,wheels
whereabouts: whereabouts
wherefore: wherefore
wherewithal: wherewithal
whet: whetted,whetting
whetstone: whetstone,whetstones
whiff: whiffs
whimsical: whimsical
whine: whined,whines,whining
whinny: whinnying
whip: whip
whir: whir,whirring
whirl: whirling
whirling: whirling
whisk: whisking
whisker: whiskers
whiskered: whiskered
whisper: whisper,whispered,whispering
whistle: whistle,whistled,whistles,whistling
whit: whit
white: white,whiter
whiteness: whiteness
whiz: whizzing
wholly: wholly
whosoever: whosoever
wicked: wicked
wide: wide,wider
widow: widow
widower: widower
wife: wife,wives
wild: wild,wilds
wilderness: wilderness
wildest: wildest
wiles: wiles
wilful: wilful
willfully: willfully
willow: willow
wilson: wilson
win: win,winning
wind: wind,winding,wound
windmill: windmill,windmills
window: window,windows
wine: wine,wines
wing: wing,wings
wink: wink,winked,winking
winner: winner
winnow: winnowed
winnowing: winnowing
winter: winter
wipe: wipe,wiped,wiping
wire: wire
wise: wise
wit: wit,wits
witchcraft: witchcraft
withdraw: withdraw,withdrawing,withdrawn,withdrew
withers: withers
witness: witness,witnessed
witted: witted
wittily: wittily
witty: wittiest,witty
wobble: wobbling
woe: woes
wolf: wolf,wolves
woman: woman,women
womanly: womanly
womenfolk: womenfolks
wonderful: wonderful
wonderfully: wonderfully
wonderingly: wonderingly
wood: wood,woods
wooded: wooded
wooden: wooden
wool: wool
woolen: woolen
word: word
wordless: wordless
wordy: wordy
workaday: workaday
worker: worker,workers
workings: workings
workman: workman,workmen
workpeople: workpeople
worldly: worldly
worm: worm
worn: worn
worried: worried
worry: worried,worries,worry,worrying
worship: worships
worth: worth
worthless: worthless
worthy: worthy
wound: wound,wounded,wounding,wounds
wounded: wounded
wrangle: wrangling
wrap: wrap,wrapped,wrapping
wrapper: wrapper
wrapping: wrappings
wrath: wrath
wrathful: wrathful
wrathfully: wrathfully
wreath: wreath
wreathe: wreathed
wreck: wreck,wrecking
wretch: wretch,wretches
wretched: wretched
wretchedest: wretchedest
wretchedness: wretchedness
wriggle: wriggling
wring: wrung
wrinkle: wrinkled,wrinkles,wrinkling
wrist: wrist,wrists
write: write,writes,writing,written,wrote
writer: writer
writing: writing
wrong: wrong,wronged
wrongly: wrongly
wry: wry
yacht: yacht
yard: yard,yards
yawn: yawn,yawned,yawning
yawning: yawning
yearling: yearling
yearly: yearly
yellow: yellow
yellowish: yellowish
yelp: yelping
yesterday: yesterday
yield: yield,yielded,yielding,yields
yoke: yoke
yond: yonder
yonder: yonder
youngish: youngish
youth: youth,youths
youthful: youthful
youthfulness: youthfulness
zeal: zeal
zealously: zealously
zest: zest
zigzag: zigzag
zoological: zoological
zoology: zoology
