abandon: abandon,abandons
abandonment: abandonment
abantes: abantes
abas: abas
abash: abash
abate: abate
abbas: abbas
abhor: abhors
abide: abide
abject: abject
abjure: abjures
ablest: ablest
ablutions: ablutions
abode: abode,abodes
abound: abounding
abridgement: abridgement
absence: absence
absent: absent
absolute: absolute
absorb: absorbing
abstain: abstain
abstemious: abstemious
absurd: absurd
absurdity: absurdities
abuse: abused,abuses
abyss: abyss,abysses
accent: accent,accents
accept: accept,accepted,accepting
acceptable: acceptable
access: access,accessed
accessible: accessible
accident: accidents
accidental: accidental
acclaim: acclaim
acclamation: acclamations
accommodate: accommodated
accompaniment: accompaniments
accompany: accompanied,accompany,accompanying
accomplish: accomplish,accomplished
accord: accord
accords: accords
accost: accosted,accosts
account: account
accumulate: accumulated
accurate: accurate
accurse: accursed
accursed: accursed
accusation: accusation
accuse: accuse,accused,accuses
accustom: accustom,accustomed
ache: aching
achieve: achieved
achievement: achievement,achievements
achilleid: achilleid
achilles: achilles
acknowledge: acknowledge,acknowledged
acknowledgment: acknowledgments
acquaint: acquaint,acquainted
acquaintance: acquaintance
acquiescent: acquiescent
acquire: acquire,acquired
acquisition: acquisition
acre: acres
actaea: actaea
action: action,actions
active: active
actively: actively
actor: actor,actors
actual: actual
acumen: acumen
acute: acute
acuteness: acuteness
adam: adam
adamant: adamant
adamantine: adamantine
adamas: adamas
add: add,adding,adds
addison: addison
addition: addition,additions
additional: additional
address: address,addressed,addresses,addressing
adherence: adherence
adjective: adjective
adjoining: adjoining
adjourn: adjourn
adjudge: adjudged
adjure: adjure,adjured,adjures
admetus: admetus
admirable: admirable
admirably: admirably
admiral: admiral
admiration: admiration
admire: admire,admired,admiring
admirer: admirers
admissible: admissible
admission: admission
admit: admit,admits,admitted,admitting
admittance: admittance
admonish: admonish
adopt: adopt
ador: ador
adore: adore,adored,adores
adorn: adorn,adorning,adorns
adown: adown
adult: adult
adulterous: adulterous
advance: advance,advanced,advances,advancing
advanced: advanced
advancement: advancement
advantage: advantage,advantages
adventure: adventure,adventures
adventurous: adventurous
adversary: adversary
adverse: adverse
advice: advice
advise: advise,advised,advises,advising
advising: advising
advocate: advocating
aegean: aegean
aerial: aerial
afar: afar
affair: affair,affairs
affect: affect
affectation: affectation
affection: affection,affections
affectionate: affectionate
affiliation: affiliation
affirm: affirm
affix: affix
afflict: afflict,afflicted,afflicting,afflicts
affliction: affliction
afflictive: afflictive
afford: afford,affords
affright: affright,affrights
affrighted: affrighted
affront: affront
afraid: afraid
afresh: afresh
african: african
agamemnon: agamemnon
agave: agave
age: age,ages
aged: aged
agelaus: agelaus
agent: agent,agents
ages: ages
aggregate: aggregate
aggressor: aggressor
aghast: aghast
agonizing: agonizing
agora: agora
agoras: agoras
agree: agree,agreed,agreeing,agrees
agreeable: agreeable
agreement: agreement
aid: aid,aided,aiding,aids
aim: aim,aimed,aims
air: air
aire: aire
airy: airy
ajax: ajax
alarm: alarm,alarmed,alarms
alarming: alarming
alas: alas
alaster: alaster
alastor: alastor
alcyone: alcyone
alex: alex
alexander: alexander
alexandrine: alexandrine
alia: alia
alien: alien
alight: alight,alighted
alighting: alighting
alike: alike
alive: alive
allay: allay
allegorical: allegorical
allegorist: allegorists
allegorize: allegorize
allegory: allegories
alliance: alliance
allied: allied
allot: allotted
allowable: allowable
allude: allude,alludes
allure: allured
allurement: allurements
allusion: allusion,allusions
allusive: allusive
alluvial: alluvial
ally: allied,allies,ally
almighty: almighty
aloft: aloft
alois: alois
aloof: aloof
aloud: aloud
alpheus: alpheus
altar: altar,altars
alter: alter,altering
alteration: alteration,alterations
alternate: alternate
alternately: alternately
alternative: alternative
althaea: althaea
altogether: altogether
amain: amain
amalgamation: amalgamation
amaze: amaze
amazed: amazed
amazement: amazement
amazing: amazing
amazon: amazons
amazons: amazons
ambassador: ambassadors
amber: amber
ambient: ambient
ambition: ambition
ambitious: ambitious
ambo: ambo
ambrosia: ambrosia
ambrosial: ambrosial
ambuscade: ambuscade
ambush: ambush
amend: amends
amiable: amiable
amorous: amorous
amphion: amphion
amphitryon: amphitryon
amphora: amphora
ample: ample
ampler: ampler
amuse: amused
amused: amused
amusing: amusing
amydon: amydon
anachronism: anachronism
anacreon: anacreon
analysis: analysis
analytical: analytical
analyze: analyzing
anatomically: anatomically
anatomist: anatomist
ancestor: ancestor,ancestors
anchises: anchises
anchor: anchor,anchors
ancient: ancient,ancients
anciently: anciently
andromache: andromache
anecdote: anecdotes
anew: anew
angel: angels
angelic: angelic
anger: anger
angle: angle
angler: angler
angry: angry
anguish: anguish
animal: animal,animals
animate: animate,animated,animates,animating
animated: animated
animi: animi
animosity: animosity
ankle: ankle,ankles
anne: anne
annotation: annotations
announcement: announcement
annoy: annoy
annual: annual
anoint: anoint
anomaly: anomalies,anomaly
answer: answer,answered,answering,answers
ant: ant,ants
antagonist: antagonists
antedate: antedate
antenor: antenor
antheia: antheia
antigone: antigone
antilochus: antilochus
antipathy: antipathy
antiphon: antiphon
antiquarian: antiquarian
antique: antique
antiquity: antiquities,antiquity
anton: anton
anvil: anvil,anvils
anxiety: anxiety
anxious: anxious
anxiously: anxiously
apartment: apartment
apocryphal: apocryphal
apollo: apollo
apologue: apologue
apology: apologies
apotheosis: apotheosis
appal: appals
apparent: apparent
apparition: apparition
appeal: appeal,appealing,appeals
appearance: appearance
appease: appease,appeased,appeases
append: appended
appendix: appendix
appetite: appetite
applaud: applauding
applause: applause,applauses
apple: apple
applicable: applicable
applied: applied
apply: applied,applies,apply,applying
appoint: appoint,appointed
appreciation: appreciation
apprehension: apprehensions
apprehensive: apprehensive
approach: approach,approached,approaches,approaching
appropriately: appropriately
appropriation: appropriation
approval: approval
approve: approve,approved,approves,approving
april: april
apt: apt
arable: arable
arbiter: arbiter
arbitrary: arbitrary
arbitrate: arbitrate
arcadian: arcadian
arch: arch,arching
archaic: archaic
archbishop: archbishop
archdeacon: archdeacon
arched: arched
archer: archer,archers
archery: archery
arching: arching
architect: architect,architects
architectonic: architectonic
archive: archive
arctic: arctic
ardent: ardent
ardour: ardour
arduous: arduous
argive: argive
argos: argos
argue: argued,arguing
argument: argument,arguments
aright: aright
aristotle: aristotle
arm: arm,armed,arms
armament: armament
armed: armed
armida: armida
armipotent: armipotent
armour: armour
armourer: armourer
armoury: armoury
army: armies,army
arnold: arnold
arrange: arrange
arrangement: arrangement,arrangements
arranger: arrangers
array: array,arrays
arrears: arrears
arrest: arresting,arrests
arrival: arrival
arrive: arrived,arrives,arriving
arrogant: arrogant
arrow: arrow,arrows
art: art,arts
artemis: artemis
artful: artful
article: articles
articulate: articulate
artifice: artifice,artifices
artificial: artificial
artillery: artillery
artist: artist,artists
ascanian: ascanian
ascanius: ascanius
ascend: ascend,ascended,ascending,ascends
ascendency: ascendency
ascertain: ascertained
ascii: ascii
ascribe: ascribe,ascribed,ascribing
ash: ash,ashes
ashamed: ashamed
ashen: ashen
ashore: ashore
ashy: ashy
asia: asia
asian: asian
asiatic: asiatic
asleep: asleep
aspasia: aspasia
aspect: aspect
asperse: asperse
aspirate: aspirate
aspire: aspire,aspires,aspiring
assail: assail,assailed
assailant: assailants
assault: assault,assaults
assay: assays
assemblage: assemblage
assemble: assemble,assembled,assembles,assembling
assembly: assemblies,assembly
assent: assent,assenting,assents
assert: assert,asserted,asserts
assertion: assertion
assign: assign,assigned
assist: assist,assisted,assisting,assists
assistance: assistance
assistant: assistant,assistants
assistless: assistless
associate: associate,associates
association: association,associations
assuage: assuage,assuaged
assume: assume,assumed,assumes,assuming
assumption: assumption
assurance: assurance
assure: assure,assuring
assured: assured
assyrian: assyrian
astonish: astonish,astonished
astonishing: astonishing
astr: astr
astyanax: astyanax
asunder: asunder
atheist: atheist
athenian: athenian
athenians: athenians
athens: athens
athwart: athwart
atlas: atlas
atmospheric: atmospheric
atone: atone,atoned
atonement: atonement
atreus: atreus
attach: attached,attaches
attachment: attachments
attack: attack,attacked,attacks
attain: attain,attained,attaining
attainable: attainable
attainment: attainment,attainments
attaint: attaint
attempt: attempt,attempted,attempting,attempts
attend: attend,attended,attending,attends
attendance: attendance
attendant: attendant,attendants
attention: attention
attentive: attentive
attentively: attentively
attest: attest,attested,attesting
attic: attic
attire: attire,attires
attract: attracted,attracts
attractive: attractive
attribute: attribute,attributed,attributes
audacious: audacious
audience: audience
aught: aught
augment: augment,augmented
augur: augur
augury: augury
august: august
aura: aura
aurora: aurora
ausonian: ausonian
auspices: auspices
auster: auster
austere: austere
authentic: authentic
authenticate: authenticated
authenticity: authenticity
author: author,authors
authoress: authoress
authorise: authorised
authority: authorities,authority
authorize: authorized,authorizes
authorship: authorship
autumn: autumn
autumnal: autumnal
auxiliar: auxiliar
auxiliary: auxiliary
avail: avail,avails
avarice: avarice
avenge: avenge,avenged,avenging
avenger: avenger
avenging: avenging
average: average
averse: averse
aversion: aversion
avert: avert,averted,averting
avoid: avoid,avoiding,avoids
avoir: avoir
avow: avowed
await: await,awaits
awake: awake,awaked,awakes,awaking
awaken: awaken
award: award
aware: aware
awe: awe,awed
awed: awed
awful: awful
awhile: awhile
awkward: awkward
awkwardly: awkwardly
awkwardness: awkwardness
axe: axe
axes: axes
axis: axes
axle: axle,axles
azure: azure
babe: babe,babes
bacchus: bacchus
bad: bad,worse,worst
bade: bade
baffle: baffled
baggage: baggage
bait: bait
balance: balance,balanced,balances
balanced: balanced
bald: bald
baldric: baldric
baleful: baleful
ball: ball,balls
ballad: ballad,ballads
ballast: ballast
balm: balm,balms
balmy: balmy
band: band,banded,bands
bandage: bandage
banded: banded
bane: bane
baneful: baneful
banish: banish
banishment: banishment
bank: bank,banks
banquet: banquet,banqueted,banquets
bar: bar,bars
barb: barb
barbarity: barbarities
barbarous: barbarous
barbarously: barbarously
barbed: barbed
bard: bard,bards
bare: bare,bared,bares
barely: barely
bargain: bargain
bark: bark,barked,barking,barks
barley: barley
barn: barn
barr: barr
barren: barren
barrier: barrier,barriers
barter: barter
bas: bas
base: base,based
basely: basely
baseness: baseness
bashful: bashful
basil: basil
basis: basis
bask: bask
basket: baskets
bason: bason
basso: basso
bastard: bastard,bastards
bath: bath,bathed
bathe: bathe,bathes
battalion: battalion,battalions
batter: batter
battle: battle,battles
battlement: battlement
battlements: battlements
battles: battles
bay: bay,baying
baying: baying
beach: beach
beacon: beacons
beagle: beagle
beak: beak
beaky: beaky
beam: beam,beaming,beams
beamy: beamy
bear: bear,bearing,bears,bore,born,borne
beard: beard
bearded: bearded
beardless: beardless
bearer: bearer
bearing: bearing
beast: beast
beat: beat,beaten,beating,beats
beating: beating
beauteous: beauteous
beautiful: beautiful
beautify: beautify
beauty: beauties,beauty
beck: beck
bed: bed,beds
bedew: bedew
bee: bees
beech: beech
beechen: beechen
beef: beeves
befall: befall,befalls,befell
befit: befit,befits
befriend: befriend
beg: beg,begs
beget: begat
begirt: begirt
begone: begone
begot: begot
beguile: beguiles
behalf: behalf
beheld: beheld
behest: behest,behests
behold: beheld,behold,beholding,beholds
beholder: beholders
behove: behoved
bel: bel
belch: belch
beleaguer: beleaguer
belie: belied
belief: belief
bellerophon: bellerophon
bellona: bellona
bellow: bellowing,bellows
bellowing: bellowing
belly: bellies,belly,bellying
belong: belong,belongs
belove: beloved
beloved: beloved
belt: belt,belts
bemoan: bemoan
bend: bend,bended,bending,bends,bent
bended: bended
beneath: beneath
benefactor: benefactors
beneficial: beneficial
benevolence: benevolence
benjamin: benjamin
bent: bent
bequeath: bequeath
bereave: bereaves
beseem: beseems
beset: beset
besiege: besiege,besieging
besieger: besiegers
besmear: besmear
besought: besought
bespeak: bespoke
bespeaking: bespeaking
bespoke: bespoke
bestow: bestow,bestowed,bestows
bestrew: bestrew
bestrewn: bestrewn
bestride: bestrides
bestrode: bestrode
bestrow: bestrow
betake: betake
betime: betimes
betray: betray,betrayed,betrays
betters: betters
betwixt: betwixt
beverage: beverage
bewail: bewail
beware: beware
bias: bias
bibl: bibl
bible: bible
bid: bade,bid,bidden,bids
bidden: bidden
bier: bier
billow: billow,billows
binary: binary
bind: bind,binds,bound
binding: binding
biographical: biographical
biography: biographies,biography
bird: bird,birds
birth: birth
birthright: birthright
bishop: bishop
bit: bit
bite: bit,bite,bites
bitter: bitter
bitterness: bitterness
bk: bk
bl: blest
black: black
blacken: blacken,blackening,blackens
bladder: bladder
blade: blade
blair: blair
blame: blame,blamed
blameless: blameless
blandishment: blandishment
blandishments: blandishments
blast: blast,blasted,blasts
blaze: blaze,blazed,blazes,blazing
bleak: bleak
bleat: bleating
bleed: bled,bleed,bleeding,bleeds
bleeding: bleeding
blemish: blemish
blend: blend,blended
blending: blending
bless: bless,blessed,blest
blessing: blessing,blessings
blest: blest
blind: blind
blindness: blindness
blink: blinking
bliss: bliss
blissful: blissful
bloated: bloated
block: block
blockade: blockaded
blood: blood
bloodhound: bloodhounds
bloodless: bloodless
bloodshed: bloodshed
bloody: bloodier,bloody
bloom: bloom,blooming
blossom: blossoms
blot: blots,blotted
blow: blew,blow,blown,blows
blown: blown
blue: blue
blunt: blunted,blunts
blunted: blunted
blush: blush,blushes,blushing
bluster: blustering
boar: boar,boars
board: board,boards
boast: boast,boasted,boasting,boasts
boaster: boaster
boastful: boastful
boat: boat
bode: bodes,boding
boding: boding
body: bodies,body
bog: bog
boil: boil,boiling,boils
boiling: boiling
boisterous: boisterous
bold: bold,boldest
boldly: boldly
boldness: boldness
bolt: bolt,bolts
bond: bond
bondage: bondage
bone: bone,bones
book: book,books
boon: boon
boot: boots
booty: booty
border: border,bordering,borders
bore: bore
boreal: boreal
boreas: boreas
bored: bored
borne: borne
borrow: borrow,borrowed
bosom: bosom,bosoms
boss: boss,bosses
bossy: bossy
bough: bough,boughs
bound: bound,bounded,bounding,bounds
boundless: boundless
bounteous: bounteous
bounty: bounties,bounty
bow: bow,bows
bowels: bowels
bower: bower,bowers
bowl: bowl,bowls
bowless: bowless
bowstring: bowstring
box: box
boy: boy,boys
brace: brace,braced,braces
braced: braced
bracelet: bracelets
braces: braces
braid: braids
braided: braided
brain: brain,brains
brake: brake,brakes
branch: branch,branches,branching
branching: branching
brand: brand,brands
brandish: brandish,brandishing
brass: brass
brave: brave,braved,braves,bravest
bravely: bravely
braver: braver
brawn: brawn
brawny: brawny
brazen: brazen
breach: breach
bread: bread
breadth: breadth
break: break,breaking,breaks,broke,broken
breast: breast,breasts
breastplate: breastplate,breastplates
breath: breath
breathe: breathe,breathed,breathes,breathing
breathing: breathing
breathless: breathless
breed: bred,breed,breeds
breeze: breeze,breezes
breezy: breezy
brethren: brethren
briareus: briareus
bribe: bribe,bribed,bribes
bridal: bridal
bride: bride,brides
bridge: bridge,bridged
bridle: bridles
bright: bright,brighter,brightest
brighten: brighten,brightening,brightens
brilliant: brilliant
brim: brim,brims
brindled: brindled
bring: bring,bringing,brings,brought
brink: brink
briny: briny
briseis: briseis
brisk: brisk,brisker
bristle: bristled,bristles,bristling
bristly: bristly
british: british
brittle: brittle
broad: broad,broader,broadest
brodie: brodie
broider: broider
broil: broil
broke: broke
broken: broken
brook: brook
brother: brother,brothers
brow: brow,brows
brown: brown
bruise: bruised,bruises
brush: brush,brushing
brutal: brutal
bubble: bubbles,bubbling
buckle: buckled,buckles,buckling
buckler: buckler,bucklers
buckles: buckles
build: building,built
builder: builder
building: building
bulk: bulk
bulky: bulky
bull: bull,bulls
bullock: bullocks
bulwark: bulwark,bulwarks
bunch: bunch
buoy: buoy
burden: burden,burdens
burial: burial
burlesque: burlesque
burn: burn,burned,burning,burns
burning: burning
burns: burns
burst: burst,bursting,bursts
bursts: bursts
bury: buried,buries,bury,burying
bushy: bushy
busily: busily
business: business
bussy: bussy
busy: busied,busy
buxom: buxom
buzz: buzzing
byzantium: byzantium
cabinet: cabinet
cadence: cadence
cader: cader
cadmean: cadmean
caestus: caestus
cake: cake
calaber: calaber
calamitous: calamitous
calchas: calchas
calculate: calculate,calculated,calculating
calculation: calculations
caldron: caldron,caldrons
callianassa: callianassa
callow: callow
calm: calm
calmly: calmly
calmness: calmness
calumniate: calumniated
calydon: calydon
calypso: calypso
camilla: camilla
camp: camp,camps
campaign: campaign,campaigns
candidly: candidly
candour: candour
cane: cane
canister: canisters
canoe: canoe
canst: canst
canto: canto,cantos
canvas: canvas
cap: cap
capability: capabilities
capable: capable
capacious: capacious
capital: capital
captain: captain,captains
captious: captious
captive: captive,captives
capture: capture
car: car,cars
carcase: carcase,carcases
card: card
care: care,cares
career: career
careful: careful
carefully: carefully
careless: careless
carelessness: carelessness
caress: caress
carey: carey
carian: carian
carnage: carnage
carnivorous: carnivorous
carpet: carpet,carpets
carry: carried,carries,carry,carrying
carve: carved
cary: cary
casket: casket
casque: casque,casques
cassandra: cassandra
cast: cast,casting,casts
casting: casting
castor: castor
casual: casual
casus: casus
catalogue: catalogue
cataract: cataracts
catch: catch,caught
catholicity: catholicity
cattle: cattle
caul: cauls
cauldron: cauldron
caution: caution
cautious: cautious
cave: cave,caves
cavern: cavern,caverns
cavil: cavils
cavity: cavities
cease: cease,ceased,ceasing
cedar: cedar
ceiling: ceiling
celadon: celadon
celebrate: celebrate,celebrated,celebrating
celebrated: celebrated
celebrity: celebrity
celestial: celestial
cell: cells
celtic: celtic
cement: cemented
censure: censure,censured
censurer: censurers
centaur: centaur,centaurs
centaurs: centaurs
cento: cento
centre: centre
century: centuries,century
ceremonial: ceremonial
ceremony: ceremonies,ceremony
ceres: ceres
cession: cession
cestus: cestus
chaff: chaff
chain: chain,chains
chair: chair
chalcis: chalcis
chalcon: chalcon
chalky: chalky
challenge: challenge,challenged
chamber: chamber,chambers
champaign: champaign
champion: champion,champions
chance: chance,chanced
chancellor: chancellor
chandler: chandler
change: change,changed
channel: channel,channels
chap: chaps
chapman: chapman
character: character,characters
characteristic: characteristic,characteristics
characterize: characterized
charge: charge,charged,charges,charging
charger: charger,chargers
chariot: chariot,chariots
charioteer: charioteer,charioteers
charitable: charitable
charity: charities
charles: charles
charm: charm,charms
charmed: charmed
charming: charming
chase: chase,chased,chasing
chaser: chaser,chasers
chasing: chasing
chaste: chaste
chasten: chastened
chastise: chastised,chastises
chastisement: chastisement
chatter: chatter,chattering
chaucer: chaucer
che: che
cheat: cheat,cheats
check: check,checked,checking,checks
cheek: cheek,cheeks
cheer: cheer,cheered,cheering,cheers
cheerful: cheerful
cheerless: cheerless
cheese: cheese
cherish: cherished,cherishes
chersonese: chersonese
chest: chest,chests
chian: chian
chiding: chiding
chief: chief,chiefs
chiefly: chiefly
chiefs: chiefs
chieftain: chieftain,chieftains
child: child,children
chill: chill,chills
chimaera: chimaera
chimerical: chimerical
chin: chin
chine: chine,chines
chiron: chiron
choice: choice,choicest
choir: choir
choke: choke,choked
choler: choler
choose: choose,choosing,chose,chosen
christ: christ
christian: christian
chronicle: chronicle
chronos: chronos
church: church
cicero: cicero
cid: cid
cilician: cilician
cincture: cincture
circe: circe
circle: circle,circled,circles,circling
circlet: circlets
circling: circling
circuit: circuit
circumference: circumference
circumfuse: circumfused
circumlocution: circumlocution
circumstance: circumstance,circumstances
circumvent: circumvent
circus: circus
cistern: cistern
citadel: citadel
cithern: cithern
citizen: citizen
city: cities,city
civilized: civilized
claim: claim,claims
clamorous: clamorous
clamour: clamour,clamours
clamours: clamours
clan: clans
clang: clang,clanging
clanging: clanging
clangour: clangour,clangours
clank: clanks
clap: clap,claps
clarke: clarke
clash: clash,clashing
clasp: clasp,clasping,clasps
class: class
classic: classic
classical: classical
clatter: clatter
clattering: clattering
claw: claws
clay: clay
cleanse: cleanse,cleansed
cleansing: cleansing
clearness: clearness
cleave: cleave,cleaves,cleaving
cleft: cleft,clefts
clem: clem
cleopatra: cleopatra
clever: clever
cleverly: cleverly
cleverness: cleverness
cliff: cliff,cliffs
climate: climate
climb: climb,climbs
clime: clime,climes
cling: cling,clinging
clip: clip
clog: clogs
close: close,closed,closer,closes,closest
closely: closely
closing: closing
clot: clotted
clothe: clad,clothe,clothed
clotted: clotted
cloud: cloud,clouds
clouded: clouded
clouds: clouds
cloudy: cloudy
cloy: cloy
clung: clung
cluster: clusters
clustering: clustering
clytemnestra: clytemnestra
coagulate: coagulates
coal: coals
coan: coan
coast: coast,coasts
cock: cock
code: codes
coffer: coffer
cohort: cohorts
coin: coined
cold: cold,colder,coldest
coldly: coldly
coldness: coldness
collect: collect,collected,collecting,collects
collection: collection
collector: collector
collision: collision
collusion: collusion
colonel: colonel
colonization: colonization
colony: colony
colour: colour,colours
coloured: coloured
colouring: colouring
column: column,columns
comb: comb
combat: combat,combats
combatant: combatants
combine: combine,combined
combustion: combustion
comely: comelier,comely
comet: comet,comets
comfort: comfort,comforted
comfortable: comfortable
comfortless: comfortless
coming: comings
command: command,commanded,commanding,commands
commander: commander
commanding: commanding
commence: commence,commenced,commencing
commencement: commencement
commend: commend,commends
commendation: commendations
commentary: commentaries,commentary
commerce: commerce
commercial: commercial
commission: commission
commit: commit,commits,committed
common: common
commonly: commonly
commonwealth: commonwealth
commune: communed
communicate: communicated,communicates
communication: communication
community: community
commutual: commutual
compact: compact
compacted: compacted
companion: companion,companions
companionship: companionship
company: company
comparative: comparative
comparatively: comparatively
compare: compare,compared,compares,comparing
comparison: comparison,comparisons
compass: compass
compassion: compassion
compeer: compeer
compel: compel,compels
compeller: compeller
compelling: compelling
compensation: compensation
competent: competent
compilation: compilation
compile: compiled,compiling
compiler: compiler,compilers
complain: complain,complaining,complains
complaint: complaint,complaints
complete: complete,completed
completely: completely
completest: completest
compliance: compliance
compliant: compliant
complicated: complicated
compliment: compliment
comply: comply,complying
compose: compose,composed,composing
composition: composition,compositions
composure: composure
compound: compound,compounded
comprehend: comprehend
comprehension: comprehension
comprehensive: comprehensive
compress: compress,compressed
comprise: comprised
comrade: comrade,comrades
concave: concave
conceal: conceal,concealed,conceals
conceive: conceive,conceived
concept: concept
conception: conception
concern: concern,concerns
concerned: concerned
conclude: conclude,concluded,concludes,concluding
conclusion: conclusion
conclusive: conclusive
concubine: concubines
concur: concur,concurring
condemn: condemn,condemned,condemns
condense: condense,condensed,condensing
condescend: condescend
condition: condition,conditions
conduce: conduced
conducive: conducive
conduct: conduct,conducted,conducts
cone: cone
confederate: confederate,confederates
confer: confer,conferred,conferring,confers
conference: conference
confess: confess,confessed,confesses,confessing
confessedly: confessedly
confide: confiding
confidence: confidence
confiding: confiding
confine: confine,confined
confines: confines
confirm: confirm,confirmed,confirming,confirms
confirmation: confirmation
conflagration: conflagration
conflict: conflict,conflicting
conflicting: conflicting
conform: conform
confound: confound,confounded,confounds
confront: confronts
confucius: confucius
confuse: confused
confused: confused
confusedly: confusedly
confusion: confusion
congested: congested
conglobe: conglobing
congregate: congregated
congreve: congreve
congruity: congruity
conjecture: conjecture,conjecturing
conjoin: conjoin,conjoins
conjunction: conjunction
conjure: conjure
connect: connect,connected,connecting
connection: connection
connexion: connexion
conquer: conquer,conquered,conquering,conquers
conquering: conquering
conqueror: conqueror
conquest: conquest,conquests
conscious: conscious
consciousness: consciousness
consecrate: consecrated
consecrated: consecrated
consecution: consecution
consecutively: consecutively
consent: consent,consented,consenting,consents
consequence: consequence,consequences
consequent: consequent
consequential: consequential
conservatism: conservatism
considerable: considerable
considerably: considerably
considerate: considerate
consideration: consideration
consign: consign,consigned,consigns
consist: consist,consists
consistency: consistency
consistent: consistent
consistory: consistory
consolation: consolations
console: console
consonant: consonants
consort: consort,consorts
conspicuous: conspicuous
conspire: conspire
constancy: constancy
constant: constant
constantly: constantly
consternation: consternation
constituent: constituent
constitute: constitutes
constrain: constrain,constrains
constraint: constraint
construct: construct
construction: construction
construe: construe,construed
consult: consult,consulted,consulting,consults
consultative: consultative
consulting: consulting
consume: consume,consumed,consumes,consuming
consummate: consummate
contact: contact
contagion: contagion
contemplate: contemplate,contemplating
contemplation: contemplation
contempt: contempt
contemptible: contemptible
contemptuous: contemptuous
contend: contend,contended,contending,contends
content: content
contented: contented
contention: contention,contentions
contentious: contentious
contents: contents
contest: contest,contested,contests
contiguous: contiguous
continual: continual
continually: continually
continuation: continuation
continue: continue,continued,continues
continued: continued
continuous: continuous
contract: contract,contracted,contracting,contracts
contraction: contraction,contractions
contradict: contradicts
contradiction: contradictions
contradictory: contradictory
contradistinction: contradistinction
contrary: contrary
contrast: contrasted,contrasts
contribute: contribute,contributed
contribution: contributions
contrive: contrives,contriving
contrived: contrived
control: control,controls
controversy: controversy
controvert: controvert
contumacious: contumacious
convene: convene,convened
convenience: convenience
convenient: convenient
conventional: conventional
conversation: conversation
converse: converse,conversing
convert: convert
convex: convex
convey: convey,conveyed,conveying,conveys
conviction: conviction
convince: convince,convinced
convinced: convinced
convocation: convocations
convoke: convoked
convulsion: convulsions
cool: cool,cooler,cooling
coon: coon
coop: coop
cooper: cooper
copious: copious
copper: copper
copying: copying
copyist: copyist
copyright: copyright
cord: cord
cordage: cordage
cordial: cordial
corinth: corinth
corn: corn
corporation: corporation
corps: corps
corpse: corpse
correct: correct,corrected
correction: correction
correctly: correctly
corrects: corrects
correspondence: correspondence
correspondent: correspondent
corrupt: corrupt
corruption: corruption,corruptions
corse: corse
corses: corses
corslet: corslet,corslets
cos: cos
cost: cost,costs
costly: costly
costume: costume
cot: cot,cots
couch: couch,couches,couching
couldst: couldst
council: council,councils
counsel: counsel,counselling,counsels
counsellor: counsellor
count: count,counted
counterfeit: counterfeit
counterpoise: counterpoise
countless: countless
country: countries,country
countryman: countrymen
courage: courage
courageous: courageous
courser: courser,coursers
court: court,courted,courts
cover: cover,covered,covering,covers
covering: covering,coverings
coverlet: coverlets
covert: covert
covetous: covetous
cow: cows
coward: coward,cowards
cowardice: cowardice
cowardly: cowardly
cower: cowering
cowper: cowper
crack: crack,cracks
crackle: crackle,crackled,crackles,crackling
crackling: crackling
crag: crags
craggy: craggy
crane: cranes
cranny: crannies
crash: crash,crashing
crave: craves
crayon: crayon
cream: cream
create: create,created,creates,creating
creation: creation,creations
creature: creature
credible: credible
credit: credit
credulity: credulity
creep: creeping,creeps
crescent: crescent
crest: crest
crested: crested
creta: creta
cretan: cretan
crete: crete
crew: crew
crime: crime,crimes
crimson: crimson
crisis: crisis
critic: critic,critics
critical: critical
criticism: criticism,criticisms
criticize: criticize
crocus: crocus
crois: crois
crook: crook
crooked: crooked
crop: crops
cross: cross,crossed,crossing
crossing: crossing
crowd: crowd,crowded,crowding,crowds
crowded: crowded
crown: crown,crowns
cruel: cruel
cruelty: cruelty
crumble: crumbling
crush: crush,crushing
crux: crux
crystal: crystal
cubit: cubit,cubits
cuff: cuff
cuirass: cuirass
cuish: cuishes
cull: cull
culminate: culminating
cultivate: cultivate,cultivated,cultivating
cultivation: cultivation
cumbrous: cumbrous
cunning: cunning
cup: cup
cur: curs
curb: curb
curd: curds
cure: cure,cured,cures
cureless: cureless
curiosity: curiosities,curiosity
curious: curious
curl: curl,curling,curls
curling: curling
current: current,currents
currier: curriers
curse: curse,cursed,curses
cursed: cursed
curvature: curvature
curved: curved
custom: custom,customs
customary: customary
cut: cut,cuts
cutlass: cutlass
cybele: cybele
cycle: cycle
cyclic: cyclic
cyclus: cyclus
cynic: cynic
cynthia: cynthia
cypress: cypress
cypria: cypria
cyprian: cyprian
da: da
daedalean: daedalean
dagger: dagger
daily: daily
dainty: dainties
dale: dale,dales
damage: damage
damaged: damaged
damages: damages
dame: dame,dames
damp: damp
damsel: damsel
danae: danae
dance: dance,danced,dances
dancer: dancer,dancers
dancing: dancing
danger: danger,dangers
dangerous: dangerous
dangling: dangling
dante: dante
dappled: dappled
dardan: dardan
dares: dares
daring: daring
dark: dark,darker
darken: darken,darkening,darkens
darkening: darkening
darkness: darkness
darksome: darksome
darling: darling
dart: dart,darting,darts
darted: darted
darts: darts
dash: dash,dashing
dastard: dastard,dastards
datum: data
daughter: daughter,daughters
daunt: daunt
dauntless: dauntless
dawn: dawn,dawning,dawns
day: day,days
dazzle: dazzled,dazzling
dazzling: dazzling
dead: dead
deaden: deaden
deadly: deadly
deaf: deaf
deafening: deafening
deal: deal,dealing,deals,dealt
dearest: dearest
dearly: dearly
death: death,deaths
deathful: deathful
deathless: deathless
debate: debate,debates,debating
debt: debt
decade: decades
decay: decay,decays
decease: deceased
deceased: deceased
deceit: deceit,deceits
deceitful: deceitful
deceive: deceive,deceived,deceives
decent: decent
deception: deception,deceptions
decide: decide,decided
decisive: decisive
deck: deck,decks
declare: declare,declared,declares,declaring
decline: decline,declined,declines,declining
declivity: declivity
decorate: decorate,decorated,decorating
decree: decree,decreed,decrees
dedicate: dedicate,dedicates
deductible: deductible
deed: deed,deeds
deedless: deedless
deem: deem,deemed,deems
deep: deep,deeper,deepest,deeps
deepen: deepening,deepens
deeply: deeply
deer: deer
deface: deface,defaced
defaced: defaced
defame: defame
defeat: defeat,defeated
defect: defect,defects
defective: defective
defence: defence,defences
defend: defend,defended,defends
defender: defender,defenders
defending: defending
defensive: defensive
defer: defer,deferring
deference: deference
defiance: defiance
defile: defiled
definitively: definitively
deform: deform,deformed,deforms
deformity: deformities
defraud: defraud,defrauded,defrauding,defrauds
defy: defied,defies,defy,defying
degeneracy: degeneracy
degenerate: degenerate,degenerates
degrade: degrade
degree: degree,degrees
deign: deign
deiphobus: deiphobus
deity: deities,deity
dejected: dejected
del: del
delay: delay,delayed,delays
delegate: delegates
deletion: deletions
delian: delian
deliberate: deliberate
delicacy: delicacy
delicate: delicate
delicious: delicious
delight: delight,delighted,delighting,delights
delighted: delighted
delightful: delightful
deliver: deliver,delivered
deliverer: deliverer
delivery: delivery
delude: delude,deluded,deludes,deluding
deluge: deluge,deluged,deluges
demand: demand,demanded,demands
demi: demi
demodocus: demodocus
demon: demon
den: den,dens
denial: denial
denote: denotes
denounce: denounced,denouncing
dense: dense
deny: denied,denies,deny
depart: depart,departs
department: department
departure: departure,departures
depend: depend,depended,depends
dependent: dependent
depict: depicted
depicture: depictured
deplore: deplore,deplored
depopulate: depopulate,depopulates
deportment: deportment
deprecate: deprecate
depress: depress
deprive: deprive,deprived,deprives
depth: depth
depths: depths
depute: deputed,deputes
deride: deride,derides
derision: derision
derivative: derivative
derive: derive,derived,derives,deriving
derogate: derogated
derogatory: derogatory
descend: descend,descended,descending,descends
descendant: descendant,descendants
descent: descent
description: description,descriptions
descriptive: descriptive
descry: descried,descries,descry
desert: desert,deserted,deserting,deserts
deserted: deserted
deserter: deserters
deserting: deserting
deserve: deserve,deserved,deserves
deserved: deserved
deserving: deserving
design: design,designed,designing,designs
designate: designating
designedly: designedly
desire: desire,desired,desires,desiring
desirous: desirous
desist: desist,desists
desolate: desolate
desolated: desolated
desolation: desolation
despair: despair
despairing: despairing
despatch: despatch,despatched
desperate: desperate
despise: despise,despised
despoil: despoil,despoiled
despotism: despotisms
destin: destin
destine: destined
destiny: destinies,destiny
destitute: destitute
destroy: destroy,destroyed,destroying,destroys
destroyer: destroyer
destruction: destruction
destructive: destructive
destry: destrier
detach: detach
detain: detain,detained,detains
detect: detect,detected,detecting
deter: deterred,deters
determinate: determinate
determination: determination
determine: determine,determined,determines,determining
detest: detest,detested,detests
dethrone: dethrone
detract: detracts
detraction: detraction
deucalion: deucalion
develop: develop,developed
development: development
deviate: deviated,deviating
device: device,devices
devious: devious
devolve: devolve,devolves
devote: devoted
devoted: devoted
devotedness: devotedness
devotion: devotion
devotions: devotions
devour: devour,devouring,devours
devoutly: devoutly
dew: dew,dews
dewy: dewy
dexter: dexter
dexterous: dexterous
di: di
diadem: diadem
dialect: dialect,dialects
dian: dian
diana: diana
dictate: dictated,dictates
diction: diction
dictionary: dictionary
dido: dido
didst: didst
die: die,died,dies,dying
dier: dier
diet: diet
difference: difference,differences
difficult: difficult
difficulty: difficulties,difficulty
diffuse: diffused
digamma: digamma
digest: digest
dignified: dignified
dignity: dignity
diligence: diligence
diligently: diligently
dim: dim,dims
diminish: diminish
din: din
dine: dine
dinner: dinner
diogenes: diogenes
diomedes: diomedes
dion: dion
dione: dione
dionysus: dionysus
dip: dip
diphthong: diphthongs
dire: dire
direct: direct,directed,directs
directing: directing
direction: directions
direful: direful
dirt: dirt
disabled: disabled
disagree: disagree
disagreeable: disagreeable
disappear: disappears
disappoint: disappoints
disappointed: disappointed
disappointment: disappointment
disapprove: disapprove
disarm: disarm,disarms
disarray: disarray
disaster: disaster,disasters
discern: discern,discerned
discernible: discernible
discerning: discerning
discharge: discharge,discharged
discipline: discipline
disclaim: disclaim,disclaimed,disclaiming
disclaimer: disclaimer,disclaimers
disclose: disclose,disclosed
disconsolate: disconsolate
discontent: discontent
discontented: discontented
discontinue: discontinue
discord: discord
discourage: discouraged
discouraged: discouraged
discourse: discourse,discourses
discover: discover,discovered,discovering,discovers
discoverable: discoverable
discovery: discoveries,discovery
discreetly: discreetly
discrepancy: discrepancy
discretion: discretion
discus: discus
discussion: discussion,discussions
disdain: disdain,disdains
disdainful: disdainful
disease: disease,diseases
diseased: diseased
disengage: disengage
disfigure: disfigure
disfigured: disfigured
disgorge: disgorges
disgrace: disgrace
disgraced: disgraced
disgraceful: disgraceful
disguise: disguise,disguised
disguised: disguised
dishearten: disheartens
dishonest: dishonest
dishonour: dishonour,dishonoured
disjointed: disjointed
disk: disk
dislike: dislike
dismal: dismal
dismay: dismay
dismember: dismember
dismiss: dismiss,dismissed
disobedience: disobedience
disobey: disobey
disorder: disorder
dispel: dispel,dispels
dispensation: dispensations
dispense: dispense,dispensed,dispensing
disperse: disperse,dispersed,dispersing
dispirit: dispirit
display: display,displayed,displaying,displays
displease: displeased
displeased: displeased
displeasure: displeasure
disposal: disposal
dispose: dispose,disposed,disposes,disposing
disposed: disposed
disposer: disposer
disposition: disposition
disprove: disproving
dispute: dispute,disputed
disputed: disputed
disqualification: disqualification
disquiet: disquiet
disrespect: disrespect
disrobe: disrobes
dissatisfaction: dissatisfaction
dissect: dissected
dissemble: dissembled
dissertation: dissertation
dissolve: dissolve,dissolved,dissolving
dissuade: dissuade
distain: distain
distance: distance,distanced
distant: distant
distaste: distaste
distemper: distemper
distend: distend
distended: distended
distil: distil,distilling,distils
distill: distill
distinct: distinct
distinction: distinction,distinctions
distinctive: distinctive
distinctly: distinctly
distinguish: distinguish,distinguished,distinguishes,distinguishing
distinguished: distinguished
distinguishing: distinguishing
distort: distorted
distract: distract,distracted
distracted: distracted
distracting: distracting
distress: distress,distressed
distressed: distressed
distressful: distressful
distribute: distribute,distributed,distributes,distributing
distribution: distribution
distributor: distributor
disturb: disturb,disturbed,disturbs
disunite: disunite
ditch: ditch
dive: dive,dove
diver: divers
divergence: divergences
diverse: diverse
diversify: diversified
diversity: diversity
divert: diverting,diverts
divest: divests
divide: divide,divided,divides,dividing
divided: divided
divine: divine,divined
divinely: divinely
divinity: divinity
division: division
dizzy: dizzy
doctrine: doctrine
document: document
dodona: dodona
dodonaean: dodonaean
dog: dog,dogs
doleful: doleful
dolour: dolours
dolphin: dolphin,dolphins
domain: domain,domains
dome: dome,domes
domestic: domestic
dominion: dominion,dominions
domitian: domitian
donate: donate
donation: donation,donations
donne: donne
donor: donors
doom: doom,dooms
door: door,doors
doric: doric
doris: doris
dost: dost
dotard: dotards
doth: doth
doto: doto
double: double,doubled,doubling
doubling: doubling
doubly: doubly
doubt: doubt,doubted,doubting,doubts
doubtless: doubtless
dove: dove,doves
dower: dower
download: downloading
downward: downward
downy: downy
drag: drag,dragged,dragging,drags
dragon: dragon,dragons
drain: drain
drama: drama,dramas
dramatic: dramatic
dramatis: dramatis
dramatise: dramatised
draught: draught,draughts
draw: draw,drawing,drawn,draws,drew
drawing: drawings
dread: dread,dreads
dreadful: dreadful
dream: dream,dreamed,dreams,dreamt
drear: drear
dreary: dreary
dregs: dregs
drench: drench
dress: dress,dressed
drew: drew
drift: drifts
drink: drank,drink,drinks
drip: drip
drive: drive,driven,drives,driving,drove
driven: driven
driver: driver,drivers
droop: droop,drooping
drooping: drooping
drop: drop,dropping,drops
dropping: dropping
drove: droves
drown: drown,drowning,drowns
drudging: drudging
drunk: drunk
dry: dried,dries,dry
dryad: dryad
dryas: dryas
dryops: dryops
dubious: dubious
duci: duci
ductile: ductile
duel: duel
duke: duke
dull: dull,dulls
dulness: dulness
dumb: dumb
dung: dung
dungeon: dungeon,dungeons
durable: durable
duration: duration
durst: durst
dusky: dusky
dust: dust
dusty: dusty
duteous: duteous
duty: duties,duty
dwell: dwell,dwelling,dwells,dwelt
dweller: dwellers
dwelling: dwelling,dwellings
dyce: dyce
dye: dye,dyed,dyes
dynameter: dynameter
eager: eager
eagerly: eagerly
eagle: eagle,eagles
ear: ear,ears
earl: earl
earn: earned
earnest: earnest
earring: earrings
earth: earth
earthly: earthly
earthquake: earthquake,earthquakes
ease: ease,eased
easily: easily
east: east
eastern: eastern
easy: easier,easy
eat: ate,eating
ebb: ebbing
echo: echo,echoed,echoes,echoing
economy: economy
eddy: eddies
edge: edge,edged,edging
edict: edict
edition: edition,editions
editorial: editorial
edmund: edmund
educate: educated
education: education
educational: educational
edward: edward
eel: eels
efface: efface
effeminate: effeminate
effervescence: effervescence
efficacious: efficacious
effort: effort,efforts
effulgence: effulgence
effuse: effused
effusion: effusion
ego: ego
egypt: egypt
egyptian: egyptian
eighteenth: eighteenth
eighth: eighth
eiresione: eiresione
eject: ejecting,ejects
elaborate: elaborate
elapse: elapsed
elate: elate
elated: elated
elbow: elbow,elbows
eld: elder,eldest
elder: elder,elders
elect: elect,elected
electronic: electronic
electronically: electronically
electrum: electrum
elegance: elegance
elegant: elegant
elegiac: elegiac
element: element,elements
elevate: elevate,elevated
elevated: elevated
elevation: elevation
eleventh: eleventh
elicit: eliciting
ellipsis: ellipsis
elm: elm,elms
elocution: elocution
eloquence: eloquence
eloquently: eloquently
elude: elude,eluded,eludes
email: email
emanate: emanated
emanation: emanation
emancipate: emancipate
embalm: embalm
embark: embark,embarked
embarrassing: embarrassing
embassy: embassy
embattle: embattled
embattled: embattled
embellishment: embellishment,embellishments
ember: embers
emblaze: emblaze,emblazed
embody: embodied
embolden: embolden
emboss: emboss
embost: embost
embower: embowering
embrace: embrace,embraced,embraces,embracing
embroider: embroider
embroidery: embroidery
embrown: embrown
embrue: embrued
emendation: emendations
emerge: emerged,emerging
emergency: emergency
eminent: eminent
eminently: eminently
emit: emits
emotion: emotion,emotions
emphatic: emphatic
emphatically: emphatically
empire: empire,empires
employ: employ,employed,employing,employs
employee: employee,employees
employment: employments
empress: empress
empyreal: empyreal
emulate: emulate,emulated
emulation: emulation
en: en
enable: enable,enabled,enables,enabling
enact: enact,enacts
enamour: enamour
encamp: encamp,encamped
encase: encased
enchant: enchant
enchantment: enchantment
enchase: enchased
encircle: encircled
enclose: enclose,enclosed
encode: encoding
encompass: encompass,encompassed
encounter: encounter,encountering,encounters
encourage: encourage,encouraged,encourages
encourager: encouragers
encumber: encumber,encumbered
encycl: encycl
endanger: endangered
endearing: endearing
endeavour: endeavour,endeavoured,endeavouring
endless: endless
endowment: endowments
endue: endue,endued,endues
endure: endure,endured,enduring
enemy: enemies,enemy
energy: energy
enfeeble: enfeebled
enfold: enfold
engage: engage,engaged,engages
engaged: engaged
engagement: engagement,engagements
engaging: engaging
engine: engines
english: english
engrafted: engrafted
engross: engross
enhance: enhance,enhanced,enhancing
enigma: enigma
enjoin: enjoin,enjoins
enjoy: enjoy,enjoyed,enjoys
enjoyment: enjoyment
enlarge: enlarge,enlarged
enlighten: enlighten,enlightening
enlightenment: enlightenment
enlist: enlists
enlivened: enlivened
enmity: enmities
ennoble: ennobled,ennobling
ennobling: ennobling
enormous: enormous
enrage: enraged
enraged: enraged
enrich: enrich
ensanguined: ensanguined
enshrine: enshrined
ensign: ensign,ensigns
enslave: enslave,enslaved
ensue: ensue,ensues,ensuing
ensure: ensure,ensuring
entail: entails
entangled: entangled
enter: enter,entered,entering,enters
entering: entering
enterprise: enterprise
entertain: entertain,entertained,entertains
entertained: entertained
entertaining: entertaining
entertainment: entertainment
enthrone: enthroned
enthusiasm: enthusiasm
enthusiast: enthusiast
entire: entire
entity: entity
entrail: entrails
entrails: entrails
entrance: entrance,entranced
entrancing: entrancing
entreat: entreat,entreats
entreating: entreating
entreaty: entreaties,entreaty
entrenchment: entrenchments
entry: entry
enumerate: enumerate
enumeration: enumeration
enunciator: enunciator
envenom: envenom
envied: envied
envious: envious
environ: environs
envoy: envoy
envy: envied,envies,envy
enwrap: enwrap
epeus: epeus
ephialtes: ephialtes
epi: epi
epic: epic,epics
epical: epical
epigoni: epigoni
epigram: epigrams
episode: episode,episodes
epistle: epistle
epitaph: epitaph
epithet: epithet,epithets
epoch: epoch
equal: equal,equalled,equals
equality: equality
equally: equally
equipment: equipment
equivalent: equivalent
equivocation: equivocation
erase: erased
ere: ere
erect: erect,erected
eris: eris
err: err,erred,erring
error: error,errors
escape: escape,escaped,escapes,escaping
esoteric: esoteric
especial: especial
espouse: espoused,espousing
espy: espied,espies
essay: essay,essays
essential: essential
essentially: essentially
establish: established
esteem: esteem,esteemed
estimate: estimated
estimation: estimation
eternal: eternal
ether: ether
ethereal: ethereal
ethic: ethic
ethiopia: ethiopia
ethiopian: ethiopian,ethiopians
ethiops: ethiops
etiquette: etiquette
etymology: etymology
eulogize: eulogized
euripides: euripides
europa: europa
europe: europe
euryalus: euryalus
eurystheus: eurystheus
eurytus: eurytus
euxine: euxine
evade: evade
eve: eve
evening: evening
event: event,events
everlasting: everlasting
evidence: evidence,evidences
evident: evident
evidently: evidently
evil: evil,evils
evince: evinced
ewe: ewe
ewer: ewer
exact: exact
exacting: exacting
exaction: exactions
exactitude: exactitude
exactness: exactness
exaggeration: exaggeration
exalt: exalt,exalted,exalts
examination: examination,examinations
examine: examined,examines,examining
exceed: exceed,exceeding,exceeds
exceedingly: exceedingly
excel: excel,excelled,excels
excellence: excellence,excellences
excellent: excellent
excellently: excellently
exception: exception,exceptions
excess: excess
excessive: excessive
exchange: exchange
excite: excite,excites
exciting: exciting
exclaim: exclaim,exclaims
exclusion: exclusion
excursion: excursion
excusable: excusable
excuse: excuse,excused
execute: execute,executed
execution: execution
exempt: exempt,exempted
exercise: exercise,exercised,exercises
exert: exert,exerted,exerting,exerts
exhalation: exhalation,exhalations
exhale: exhale,exhaling
exhaust: exhaust
exhausted: exhausted
exhaustless: exhaustless
exhibit: exhibit,exhibited,exhibiting
exhort: exhort,exhorting,exhorts
exile: exile,exiled,exiles
exist: exist,existed,existing,exists
existence: existence
existent: existent
exit: exit
exp: exp
expand: expanded,expanding
expanse: expanse
expansion: expansion
expatiate: expatiate
expect: expect,expected,expecting,expects
expedient: expedient
expedition: expedition,expeditions
expel: expel,expelled,expels
expend: expend
expense: expense,expenses
experience: experience,experienced
experienced: experienced
expert: expert
expiate: expiate
expire: expire,expired,expires,expiring
explain: explain,explained,explains
explanation: explanation,explanations
explication: explications
exploit: exploits
explore: explore,explored,explores,exploring
export: exporting
exportation: exportation
expose: expose,exposed
exposition: exposition
express: express,expressed,expresses,expressing
expression: expression,expressions
expressive: expressive
expressly: expressly
expunge: expunging
exquisite: exquisite
extant: extant
extemporaneous: extemporaneous
extend: extend,extended,extending,extends
extended: extended
extension: extension
extensive: extensive
extent: extent
external: external
extinct: extinct
extinguish: extinguish
extirpate: extirpate
extoll: extoll
extract: extract,extracting,extracts
extraordinary: extraordinary
extravagance: extravagance
extreme: extremes
extremely: extremely
extremest: extremest
extremity: extremity
extricate: extricate
exuberant: exuberant
exult: exult,exulting,exults
exulting: exulting
eye: eye,eyes
eyeball: eyeballs
eyebrow: eyebrow
eyed: eyed
eyelid: eyelids
fa: fa
fab: fab
fable: fable,fables
fabled: fabled
fabric: fabric
facility: facilities,facility
faction: factions
factious: factious
faculty: faculty
fade: fade,faded,fades
fail: fail,failed,failing,fails
fain: fain
faint: faint,fainted,fainter,fainting,faints
fainting: fainting
faintly: faintly
fair: fair,fairer,fairest
fairy: fairies
faith: faith
faithful: faithful
faithless: faithless
falchion: falchion,falchions
falcon: falcon,falcons
fall: fall,fallen,falling,falls,fell
fallacious: fallacious
fallacy: fallacy
fallen: fallen
fallow: fallow
falls: falls
false: false
falsehood: falsehood
falsely: falsely
falter: faltering
fama: fama
fame: fame,famed
famed: famed
familiar: familiar
familiarize: familiarize
family: families,family
famine: famine
famish: famish
famous: famous
fan: fan,fans
fancied: fancied
fanciful: fanciful
fancifully: fancifully
fancy: fancied,fancy
fane: fane,fanes
fare: fare,fares
farewell: farewell
farm: farm
farth: farthest
fashion: fashion
fast: fast,faster,fasts
fasten: fasten,fastened,fastens
fat: fat,fattest
fatal: fatal
fate: fate,fated,fates
fated: fated
fateful: fateful
fates: fates
father: father,fathers
fatigue: fatigue
fatten: fatten
fault: fault,faults
faultless: faultless
favor: favor
favour: favour,favouring,favours
favourable: favourable
favoured: favoured
favouring: favouring
favourite: favourite
fawn: fawn,fawns
fear: fear,fears
fearful: fearful
fearless: fearless
feast: feast,feasted,feasts
feasting: feasting
feat: feats
feather: feather,feathers
feature: feature,features
fecundity: fecundity
fed: fed
federal: federal
fee: fee,fees
feeble: feeble,feebler
feebly: feebly
feed: fed,feed,feeding,feeds
feeding: feeding
feel: feel,feeling,feels
feeling: feeling,feelings
felicity: felicity
felix: felix
fell: fell,felling,fells
fellow: fellow,fellows
female: female,females
fen: fen,fens
fence: fenced,fences
fencing: fencing
fenny: fenny
ferocious: ferocious
feronia: feronia
ferret: ferret
fertile: fertile
fertilize: fertilizing
fervent: fervent
fervid: fervid
festering: festering
festival: festival,festivals
fetch: fetch,fetched
fetlock: fetlocks
fetter: fetters
feud: feuds
feudal: feudal
fever: fevers
fibre: fibres
fiction: fiction,fictions
fictitious: fictitious
field: field,fields
fiend: fiend,fiends
fierce: fierce,fiercer,fiercest
fiercely: fiercely
fiery: fiery
fifteenth: fifteenth
fig: fig,figs
fight: fight,fighting,fights,fought
fighting: fighting
figurative: figurative
figure: figure,figured,figures
figured: figured
file: file,files
filial: filial
fillet: fillets
film: film
filth: filth
final: final
finally: finally
financial: financial
fine: fine,finest
finely: finely
finger: finger,fingers
finish: finish,finished
fir: fir,firs
firm: firm,firmest
firmament: firmament
firmly: firmly
firmness: firmness
firs: firs
firstling: firstlings
fish: fish,fishes
fisherman: fisherman,fishermen
fit: fit,fits,fitted,fitting
fitness: fitness
fitting: fitting
flag: flagging
flaggy: flaggy
flagitious: flagitious
flaky: flaky
flame: flame,flamed,flames,flaming
flaming: flaming
flamy: flamy
flank: flank,flanked
flash: flash,flashes,flashing
flashing: flashing
flat: flat,flatter
flatness: flatness
flatterer: flatterers
flattering: flattering
flattery: flattery
flavourous: flavourous
flax: flax
flaxman: flaxman
flea: flea
flee: fled
fleece: fleece,fleeces
fleecy: fleecy
fleet: fleet,fleetest,fleets
fleeting: fleeting
fleetness: fleetness
flesh: flesh
flexion: flexions
flight: flight,flights
fling: fling,flings,flung
flinty: flinty
flit: flit,flits
float: float,floated,floating,floats
flock: flock,flocks
flocks: flocks
flood: flood,floods
floor: floor,floors
florian: florian
flounce: flounce,flouncing
flounder: floundering
flour: flour
flourish: flourish,flourished,flourishes
flow: flow,flowing,flows
flower: flower,flowering,flowers
floweret: flowerets
flowery: flowery
fluctuate: fluctuates
fluency: fluency
fluid: fluids
flung: flung
flush: flush
flute: flute
flutter: fluttering,flutters
flux: flux
fly: flew,flies,fliest,fly,flying
flying: flying
foal: foals
foam: foam,foaming,foams
foamy: foamy
foe: foe,foes
fold: fold,folded,folds
foliage: foliage
follow: follow
follower: followers
folly: follies,folly
fond: fond,fonder
fonder: fonder
fondly: fondly
food: food
foodful: foodful
fool: fool,fools
foolish: foolish
foot: feet,foot
footed: footed
footing: footing
footnote: footnotes
footstep: footstep,footsteps
footstool: footstool
forage: forage
forbear: forbear,forbears
forbearance: forbearance
forbid: forbade,forbid,forbidden,forbids
forbidden: forbidden
force: force,forced,forces,forcing
forceful: forceful
forcible: forcible
forcibly: forcibly
ford: ford,forded
fore: fore
forebode: foreboding
foredoom: foredoom
forefather: forefathers
forego: forego,foregoing
forehead: forehead,foreheads
foreign: foreign
foreknowledge: foreknowledge
foremost: foremost
forerun: foreruns
forerunner: forerunner
foresee: foresee,foreseen
forest: forest,forests
forewarn: forewarn
forfeit: forfeit,forfeited
forge: forge,forged,forges
forgery: forgeries
forget: forget,forgets,forgot,forgotten
forgetful: forgetful
forgive: forgive,forgives
fork: forked
forky: forky
forlorn: forlorn
form: form,formed,forming,forms
formal: formal
format: format,formats
formation: formation
formidable: formidable
formidably: formidably
forsake: forsake,forsakes,forsaking,forsook
forsook: forsook
forsworn: forsworn
fort: fort,forts
forthwith: forthwith
fortieth: fortieth
fortification: fortification,fortifications
fortify: fortifies,fortify
fortitude: fortitude
fortunately: fortunately
fortune: fortune,fortunes
forum: forum
forwarn: forwarn
fosse: fosse
foster: fostered
foul: foul
foundation: foundation,foundations
fount: fount
fountain: fountain,fountains
fountful: fountful
fourfold: fourfold
fourscore: fourscore
fourteenth: fourteenth
fourth: fourth
fowl: fowl,fowls
fragment: fragment,fragments
fragrance: fragrance
fragrant: fragrant
frail: frail
frailty: frailty
frame: frame,framed
framework: framework
france: france
frankness: frankness
franks: franks
frantic: frantic
fraud: fraud
fraudful: fraudful
fraudulent: fraudulent
fraught: fraught
fray: fray
freak: freaks
freedom: freedom
freely: freely
freeman: freeman
freeze: freeze
freight: freight
french: french
frenzy: frenzy
frequent: frequent,frequented
frequentation: frequentation
frequently: frequently
fresh: fresh
freshly: freshly
freshness: freshness
fret: fretted
friend: friend,friends
friendly: friendly
friendship: friendship,friendships
fries: fries
frieze: frieze
fright: fright,frighted
frighted: frighted
frigid: frigid
frigidity: frigidity
fringe: fringe
fro: fro
frogs: frogs
frontier: frontier
frost: frosts
frowardness: frowardness
frown: frown,frowning,frowns
frozen: frozen
frugal: frugal
fruit: fruit,fruits
fruitful: fruitful
fruitfulness: fruitfulness
fruitless: fruitless
frustrate: frustrate
fry: fry
fuel: fuel
fugitive: fugitive
fulfil: fulfil,fulfilled,fulfils
fulfill: fulfill
fulfilment: fulfilment
fulgid: fulgid
fulness: fulness
fume: fumes
function: functions
fund: fund
fundamental: fundamental
funeral: funeral,funerals
funereal: funereal
fur: fur,furs
furies: furies
furioso: furioso
furious: furious
furl: furl
furnace: furnace
furnish: furnish,furnished,furnishes
furnishing: furnishing
furrow: furrow,furrowed,furrows
furry: furry
fury: furies,fury
fustian: fustian
future: future
gabriel: gabriel
gain: gain,gained,gains
gainst: gainst
gait: gait
galatea: galatea
gale: gale,gales
galen: galen
gall: gall,galled
gallant: gallant
galley: galley,galleys
galling: galling
gambol: gambol
game: game,games
ganymede: ganymede
gap: gap,gaps
gape: gape,gaping
garden: garden,gardens
garland: garland,garlands
garlic: garlic
garment: garment,garments
garth: garth
gash: gash
gasp: gasping
gate: gate,gates
gather: gather,gathered,gathering,gathers
gatherer: gatherers
gathering: gathering
gaudy: gaudy
gaunt: gaunt
gauntlet: gauntlet,gauntlets
gay: gay
gaze: gaze,gazed,gazing
gem: gem,gems
genealogical: genealogical
genealogy: genealogy
generation: generations
generosity: generosity
generous: generous
generously: generously
genesis: genesis
genial: genial
genius: genius,geniuses
gentil: gentil
gentle: gentle,gentler,gentlest
gentleman: gentleman,gentlemen
gently: gently
genuine: genuine
genuineness: genuineness
genus: genus
geographical: geographical
george: george
georgics: georgics
germ: germ,germs
german: german
gesture: gesture
ghastly: ghastly
ghost: ghost,ghosts
giant: giant,giants
giddy: giddy
gift: gift,gifts
gifted: gifted
gigantic: gigantic
gild: gild,gilds
gilded: gilded
gird: gird,girds,girt
girdle: girdle
girl: girl,girls
girt: girt
glad: glad,glads
gladden: gladden
glade: glade
gladly: gladly
gladsome: gladsome
glance: glance,glanced,glancing
glare: glare,glared,glares,glaring
glaring: glaring
glass: glass
glassy: glassy
glaucus: glaucus
gleam: gleam,gleaming,gleams
gleamy: gleamy
glean: glean
glebe: glebe
glee: glee
glide: glide,glides,gliding
glimmer: glimmering,glimmers
glimmering: glimmering
glitter: glitter,glittering,glitters
globe: globe
gloom: gloom
gloomy: gloomy
glorious: glorious
gloriously: gloriously
glory: gloried,glories,glory,glorying
glossy: glossy
glove: gloves
glow: glow,glowing,glows
glowing: glowing
glut: glut,gluts
gluttons: gluttons
gnash: gnash,gnashing
gnaw: gnawed
goad: goading
goal: goal,goals
goat: goat,goats
goblet: goblet,goblets
god: god,gods
goddess: goddess,goddesses
godhead: godhead,godheads
godless: godless
godlike: godlike
gods: gods
gold: gold
golden: golden
goodliest: goodliest
goodly: goodly
goose: geese
gordius: gordius
gore: gore,gored
gorge: gorged
gorgeous: gorgeous
gorget: gorget
gorgon: gorgon
gorgons: gorgons
gory: gory
govern: govern
government: government,governments
gown: gown
grace: grace,graced,graces
graceful: graceful
gracefulness: gracefulness
graces: graces
gracious: gracious
gradual: gradual
gradually: gradually
grain: grain
grammarian: grammarian,grammarians
grand: grand
granddaughter: granddaughter
grande: grande
grandeur: grandeur
grandsire: grandsire
grandson: grandson
grant: grant,granted,granting,grants
graphic: graphic
grapple: grappling
grasp: grasp,grasping,grasps
grass: grass
grasshopper: grasshoppers
grassy: grassy
grateful: grateful
gratefully: gratefully
gratify: gratified,gratify
gratitude: gratitude
grave: grave,graved,graves
gravity: gravity
gray: gray
graze: graze,grazing
grazing: grazing
greatly: greatly
greatness: greatness
greave: greaves
grecian: grecian,grecians
greece: greece
greedy: greedy
greek: greek,greeks
green: green,greens
greet: greet,greeting,greets
grey: grey
grief: grief,griefs
grievance: grievance
grieve: grieve,grieved,grieves
grieving: grieving
grim: grim
grimly: grimly
grin: grinning,grins
grind: grinding,grinds,ground
gripe: gripe
grisly: grisly
groan: groan,groaning,groans
groaning: groaning
groans: groans
groin: groin
gross: gross,grosser
grote: grote
grotto: grotto
ground: ground,grounded
groundless: groundless
grounds: grounds
groundwork: groundwork
grove: grove,groves
grovel: grovel,grovelling
grow: grew,grow,growing,grown,grows
grown: grown
grudge: grudge
grudgingly: grudgingly
guard: guard,guarded,guards
guardian: guardian,guardians
guardianship: guardianship
guardless: guardless
guards: guards
guess: guess
guest: guest,guests
guidance: guidance
guide: guide,guided,guides,guiding
guideless: guideless
guides: guides
guileful: guileful
guilt: guilt
guiltless: guiltless
guilty: guilty
gulf: gulf,gulfs
gulfy: gulfy
gush: gush,gushing
gust: gust,gusts
gyges: gyges
habit: habit,habits
habitation: habitations
habitual: habitual
hack: hack
hades: hades
hadst: hadst
haggard: haggard
hail: hail,hails
hair: hair,hairs
haired: haired
hairy: hairy
halfpenny: halfpenny
halifax: halifax
hall: hall,halls
halt: halted,halting,halts
hamlet: hamlet
hammer: hammer
hand: hand,handed,hands
handle: handle,handles
handling: handling
handmaid: handmaid,handmaids
handsomely: handsomely
hang: hang,hanging,hangs,hung
hanger: hangers
hanover: hanover
hapless: hapless
happen: happen,happened
happiness: happiness
happy: happier,happiest,happy
harangue: harangued
harass: harassed
harbour: harbour
hard: hard
harden: harden,hardened
hardness: hardness
hardship: hardships
hardy: hardy
hare: hare
harefoot: harefoot
hark: hark
harm: harm,harms
harmless: harmless
harmonious: harmonious
harmoniously: harmoniously
harmonize: harmonize
harmony: harmonies,harmony
harness: harness
harold: harold
harp: harp
harpy: harpy
hart: hart
harvest: harvest,harvests
hast: hast,hasted
haste: haste,hastes
hasten: hasten,hastening,hastens
hastily: hastily
hasty: hasty
hate: hate,hated,hates
hateful: hateful
hath: hath
hatred: hatred
haughty: haughtiest,haughty
haul: haul
haunch: haunch
haunt: haunts
havoc: havoc
hazard: hazard,hazards
hazardous: hazardous
head: head,heads
headless: headless
headlong: headlong
headstall: headstalls
headstrong: headstrong
heal: heal,healed,healing
healing: healing
health: health
healthy: healthy
heap: heap,heaping,heaps
heaps: heaps
heapy: heapy
hear: hear,heard,hearing,hears
hearer: hearer,hearers
hearing: hearing
heart: heart,hearts
hearten: hearten
heartfelt: heartfelt
heartless: heartless
hearty: hearty
heat: heat
heathen: heathen
heave: heave,heaved,heaves,heaving
heaven: heaven,heavens
heavenly: heavenly
heavens: heavens
heavenward: heavenward
heaving: heaving
heavy: heavier,heaviest,heavy
hebe: hebe
hecatomb: hecatomb,hecatombs
hector: hector
hectorean: hectorean
hecuba: hecuba
heed: heed,heeds
heedful: heedful
heedless: heedless
heel: heel,heels
heifer: heifer,heifers
height: height
heighten: heightened
heir: heir,heirs
helen: helen
helenus: helenus
helicon: helicon
hellenes: hellenes
hellespont: hellespont
helm: helm,helms
helmet: helmet,helmets
helms: helms
helpful: helpful
helpless: helpless
henceforth: henceforth
heraclid: heraclid
herald: herald,heralds
herb: herb,herbs
herbage: herbage
herculean: herculean
hercules: hercules
herd: herd,herded,herds
herdsman: herdsman,herdsmen
hereditary: hereditary
hermes: hermes
hero: hero,heroes
heroes: heroes
heroic: heroic
heroine: heroines
heron: heron
hesiodic: hesiodic
hesitate: hesitating
hesitation: hesitation
hesper: hesper
hew: hew,hewn
hexameter: hexameter
hide: hidden,hide,hides
hideous: hideous
hie: hie
hierarchy: hierarchy
hieroglyphical: hieroglyphical
highly: highly
highway: highway
hill: hill,hills
hilt: hilt
hind: hind,hinds
hindmost: hindmost
hinge: hinges
hint: hint,hints
hip: hip
hippodame: hippodame
hippodamia: hippodamia
hippomedon: hippomedon
hipponous: hipponous
hiss: hiss,hisses,hissing
hissing: hissing
hist: hist
historian: historian
historic: historic
historical: historical
historically: historically
history: histories,history
hitherto: hitherto
hive: hive
hoar: hoar
hoarse: hoarse
hoary: hoary
hoist: hoist,hoisted
hold: held,hold,holds
holder: holder
holding: holding
hollow: hollow
holy: holy
hom: hom
homage: homage
homeopathic: homeopathic
homer: homer,homers
homeric: homeric
homicide: homicide
honest: honest
honey: honey
honor: honor
honorary: honorary
honour: honour,honoured,honours
honourable: honourable
hoof: hoof,hoofs
hope: hope,hoped,hopes
hopeless: hopeless
horace: horace
horizon: horizon
horn: horn,horns
hornet: hornet
horrible: horrible
horribly: horribly
horrid: horrid
horror: horror,horrors
horse: horse,horses
horseman: horseman,horsemen
hospitable: hospitable
hospitality: hospitality
host: host,hosts
hostile: hostile
hot: hot
hound: hound,hounds
hour: hour,hours
house: house,houses
household: household
hover: hover,hovering,hovers
howl: howl,howling,howls
huddle: huddled
hue: hue
huge: huge,huger
human: human
humanity: humanity
humankind: humankind
humble: humble,humbled,humbler,humbles
humid: humid
humorous: humorous
humour: humour,humours
hung: hung
hunger: hunger
hungry: hungry
hunt: hunted
hunter: hunter,hunters
huntress: huntress
huntsman: huntsman,huntsmen
hurl: hurl,hurls
hurls: hurls
hurry: hurried,hurries
hurt: hurt,hurts
husband: husband,husbands
husbandman: husbandmen
hush: hush
hut: hut
hyacinth: hyacinth,hyacinths
hyde: hyde
hydra: hydra
hyllus: hyllus
hymeneal: hymeneal
hymn: hymn,hymns
hyperion: hyperion
hypochondria: hypochondria
hypothesis: hypotheses,hypothesis
hypsipyle: hypsipyle
iambic: iambic
iapetus: iapetus
iberia: iberia
ibid: ibid
icarian: icarian
ichor: ichor
ida: ida
idaean: idaean
ide: ide
idea: idea,ideas
idealized: idealized
identification: identification
identify: identifies,identify,identifying
idle: idle
idly: idly
idolize: idolize
idomeneus: idomeneus
ignipotent: ignipotent
ignoble: ignoble
ignobly: ignobly
ignominious: ignominious
ignorance: ignorance
ignorant: ignorant
iii: iii
iliad: iliad
ilian: ilian
ilion: ilion
ilium: ilium
illumine: illumined
illumined: illumined
illusion: illusion
illustrate: illustrate,illustrated,illustrates
illustration: illustration,illustrations
illustrious: illustrious
image: image,images
imagery: imagery
imaginable: imaginable
imaginary: imaginary
imagination: imagination,imaginations
imagine: imagine,imagined,imagines
imbitters: imbitters
imbue: imbued
imitate: imitate,imitated,imitating
imitation: imitation
imitator: imitators
immeasurable: immeasurable
immeasurably: immeasurably
immense: immense
immerse: immerse,immersed
immigrant: immigrants
immigration: immigrations
imminent: imminent
immolate: immolate,immolated
immortal: immortal,immortals
immortality: immortality
immunity: immunity
immutable: immutable
impair: impairing
impart: impart,imparts
impartial: impartial
impassive: impassive
impatience: impatience
impatient: impatient
impel: impel,impelled,impels
impend: impend,impending,impends
impending: impending
impenetrable: impenetrable
imperatively: imperatively
imperfect: imperfect
imperfection: imperfection
imperial: imperial
imperious: imperious
impertinent: impertinent
impervious: impervious
impetuosity: impetuosity
impetuous: impetuous
impious: impious
implacable: implacable
implicit: implicit
implore: implore,implored,implores,imploring
imply: implied,imply
import: import
impose: imposed
impossible: impossible
impostor: impostor
imposture: imposture,impostures
impotence: impotence
impotent: impotent
impower: impower
imprecation: imprecations
impregnate: impregnate
impress: impress
impression: impression,impressions
imprison: imprison
improbability: improbability
improbable: improbable
improve: improve,improved,improving
improved: improved
improvisation: improvisation
impudence: impudence
impulse: impulse,impulses
impulsive: impulsive
inability: inability
inaccurate: inaccurate
inactive: inactive
inactivity: inactivity
inanimate: inanimated
inaptly: inaptly
incalculable: incalculable
incapable: incapable
incarnation: incarnation
incaution: incaution
incense: incense,incensed,incenses
incensed: incensed
incessant: incessant
inch: inch
incident: incidents
incidental: incidental
incidentally: incidentally
incircle: incircle
incite: incite,incited,incites,inciting
inclement: inclement
incline: incline,inclined
inclined: inclined
inclose: inclose,inclosed,inclosing
inclosed: inclosed
inclosure: inclosure
include: include,included,includes,including
including: including
inclusive: inclusive
income: income
incomplete: incomplete
incongruity: incongruities,incongruity
inconsistency: inconsistency
inconsistent: inconsistent
increase: increase,increased,increases,increasing
incredible: incredible
inculcate: inculcated
incumbent: incumbent
incur: incurred,incurring
incursion: incursions
indebt: indebted
indebted: indebted
indefatigable: indefatigable
indefinite: indefinite
indemnify: indemnify
indemnity: indemnity
independence: independence
independent: independent
indian: indian
indication: indication
indignant: indignant
indignation: indignation
indirect: indirect
indirectly: indirectly
indiscretion: indiscretion
indispensable: indispensable
indispensably: indispensably
indissolubly: indissolubly
indistinct: indistinct
indistinctly: indistinctly
individual: individual,individuals
indolent: indolent
induce: induce,induced
inducement: inducement
induction: induction
indulge: indulge,indulged,indulging
indulgence: indulgence
indulgent: indulgent
industrious: industrious
industry: industry
inevitable: inevitable
inexorable: inexorable
inexplicable: inexplicable
inextricable: inextricable
inf: infest
infallible: infallible
infallibly: infallibly
infamy: infamy
infancy: infancy
infant: infant,infants
infection: infection
infectious: infectious
infer: infers
inference: inference
inferior: inferior,inferiors
inferiority: inferiority
infernal: infernal
inferno: inferno
infest: infest
infidelity: infidelity
infinite: infinite
infinitely: infinitely
infinitude: infinitude
infinitum: infinitum
infix: infix
inflame: inflame,inflamed,inflames,inflaming
inflexible: inflexible
inflexibly: inflexibly
inflict: inflict,inflicted,inflicting,inflicts
influence: influence,influences
infold: infold,infolding
inform: inform,informed,informing,informs
informant: informant
infrangible: infrangible
infringe: infringe,infringed
infringement: infringement
infuse: infuse,infused
ingenious: ingenious
ingeniously: ingeniously
ingenuity: ingenuity
inglorious: inglorious
ingredient: ingredient
inhabit: inhabit,inhabited,inhabiting
inhabitant: inhabitants
inherit: inherited
inheritance: inheritance
inhuman: inhuman
inhume: inhume
inimitable: inimitable
injudicious: injudicious
injunction: injunction,injunctions
injure: injured,injures
injured: injured
injurious: injurious
injury: injuries,injury
injustice: injustice
inlaid: inlaid
inlay: inlay
inly: inly
inmost: inmost
innocent: innocent,innocents
innocently: innocently
innoxious: innoxious
innumerable: innumerable
ino: ino
inquire: inquire,inquired
inquiry: inquiries
inroll: inroll
insatiable: insatiable
insatiate: insatiate
inscribe: inscribed
inscription: inscription,inscriptions
insect: insects
insensible: insensible
insert: inserted
insidious: insidious
insight: insight
insignia: insignia
insignificant: insignificant
insist: insist,insisted
insolence: insolence
insolent: insolent
insolently: insolently
insomuch: insomuch
inspiration: inspirations
inspire: inspire,inspired,inspires,inspiring
inspiring: inspiring
inspirit: inspirited,inspiriting
instance: instance,instances
instant: instant
instantly: instantly
instigation: instigation
instil: instilling
instinct: instinct
instinctive: instinctive
institute: instituted,institutes
instruct: instruct,instructs
instruction: instruction,instructions
instructive: instructive
instrument: instrument,instruments
insufferable: insufferable
insult: insult,insulted,insulting,insults
insulting: insulting
insure: insure
integrity: integrity
intellect: intellect
intellectual: intellectual
intelligence: intelligence
intelligent: intelligent
intelligible: intelligible
intemperate: intemperate
intend: intend,intended
intense: intense
intent: intent
intention: intention,intentions
inter: inter
intercept: intercept
intercession: intercession
intercourse: intercourse
interdict: interdict,interdicted
interference: interference
intermediate: intermediate
interment: interment
intermingle: intermingled
internal: internal
international: international
interpolation: interpolation,interpolations
interpose: interposed,interposing
interposition: interposition
interpret: interpreted
interpretation: interpretation
interpreter: interpreter
interrogate: interrogating
interrupt: interrupted,interrupting
interruption: interruption
intersperse: interspersed
interval: interval
intervention: intervention
interview: interview
interweave: interwoven
intimate: intimate,intimated
intolerable: intolerable
intonation: intonation,intonations
intone: intoned
intractable: intractable
intreat: intreating
intrench: intrench
intrepid: intrepid
introd: introd
introduce: introduce,introduced,introducing
introduction: introduction
intrude: intruding
intrusive: intrusive
inundation: inundation
inurn: inurn
invade: invade,invades,invading
invalidity: invalidity
invasion: invasion
inventor: inventor,inventors
invest: invest
investigation: investigation,investigations
invidious: invidious
inviolable: inviolable
inviolate: inviolate
invisible: invisible
invitation: invitation
invite: invite,invited,invites,inviting
inviting: inviting
invoke: invoked,invokes,invoking
involve: involve,involved,involves,involving
invulnerable: invulnerable
inwrought: inwrought
ionic: ionic
ios: ios
iphigenia: iphigenia
iphis: iphis
ire: ire
iris: iris
iron: iron
ironside: ironside
irregular: irregular
irregularity: irregularity
irremeable: irremeable
irresistible: irresistible
irresistibly: irresistibly
irreverence: irreverence
irrevocable: irrevocable
irs: irs
island: island,islands
isle: isle,isles
islet: islet
issue: issue,issued,issues,issuing
issuing: issuing
italian: italian
italy: italy
ithaca: ithaca
iv: iv
ivory: ivory
ivy: ivy
ix: ix
ixion: ixion
jackal: jackals
jacob: jacob
jamie: jamie
jar: jar,jarring,jars
jason: jason
javelin: javelin,javelins
jaw: jaw,jaws
jealous: jealous
jealously: jealously
jealousy: jealousy
jejune: jejune
jerusalem: jerusalem
jest: jest
job: job
joining: joinings
joint: joint,joints
jointed: jointed
jointly: jointly
jolly: jolly
journey: journey,journeying
jove: jove
joy: joy,joys
joyful: joyful
joyous: joyous
judah: judah
judge: judge,judged,judges,judging
judgment: judgment,judgments
judicial: judicial
judicious: judicious
juice: juice
juliet: juliet
jump: jumping
juncture: juncture
juno: juno
junto: junto
jupiter: jupiter
jus: jus
justice: justice
justify: justified,justify
justly: justly
justus: justus
juvenile: juvenile
kai: kai
keel: keel,keels
keen: keen
keener: keener
kennedy: kennedy
kenneth: kenneth
key: key
kick: kick,kicked
kid: kids
kill: kill,killed,killing,kills
kindle: kindle,kindled,kindles,kindling
kindling: kindling
kindly: kindly
kindness: kindness
kindred: kindred
kine: kine
king: king,kings
kingdom: kingdom,kingdoms
kingly: kingly
kinsman: kinsman
kiss: kiss,kisses
knee: knee,knees
kneel: kneel
knife: knife
knight: knight,knights
knit: knit,knits
knock: knock,knocks
knot: knot,knotted
knotty: knotty
knowledge: knowledge
laborious: laborious
labour: labour,laboured,labouring,labours
labourer: labourer
ladder: ladder
lady: lady
laertes: laertes
lag: lag,lagging,lags
laid: laid
lair: lair
lake: lake,lakes
lamb: lamb,lambs
lambkin: lambkin
lame: lame
lament: lament,lamented,lamenting,laments
lamentable: lamentable
lamentation: lamentation,lamentations
lamented: lamented
lamp: lamp
lance: lance,lances
land: land,landed,lands
landscape: landscape
landsmen: landsmen
language: language
languaged: languaged
languid: languid
languish: languish
lapithae: lapithae
largo: largo
lash: lash
lastly: lastly
late: late
latent: latent
latin: latin
latitude: latitude
latona: latona
laugh: laugh,laughing
laughter: laughter
launch: launch
laundry: laundry
laurel: laurel
lave: lave,laves
lavish: lavish
law: law,laws
lawful: lawful
lawgiver: lawgivers
lawless: lawless
lawn: lawn,lawns
lawyer: lawyer
lay: laid,lay,laying,lays
lazy: lazy
le: le
lead: lead,leading,leads,led
leaden: leaden
leader: leader,leaders
leading: leading
leaf: leaf,leaves
leafy: leafy
league: league,leagues
leagued: leagued
leaguer: leaguer
lean: lean,leaning
leap: leap,leaped,leaping,leaps
learn: learn,learned,learning
learning: learning
leather: leather
leathern: leathern
leave: leave,leaves,leaving,left
leaves: leaves
lecture: lectures
leech: leeches
left: left
leg: leg,legs
legal: legal
legally: legally
legate: legate
legend: legend,legends
legion: legion,legions
lemnian: lemnian
lend: lend,lends,lent
lengthen: lengthen
lengthful: lengthful
lenitive: lenitives
lent: lent
leopard: leopard
lesbia: lesbia
lesbian: lesbian
lessen: lessen,lessens
lessening: lessening
lesson: lesson,lessons
lethargic: lethargic
letter: letter,letters
letters: letters
level: level,levels
leveret: leveret
lexic: lexic
liability: liability
liable: liable
lib: lib
libation: libation,libations
liberty: liberties,liberty
library: library
licence: licence
license: license,licensed
licensed: licensed
licentious: licentious
lick: lick
lid: lids
lie: lie,lies,lying
lieu: lieu
life: life,lives
lifeless: lifeless
lift: lift,lifted,lifting,lifts
lifting: lifting
ligature: ligature
light: light,lighted,lighter,lights,lit
lighted: lighted
lighten: lighten,lightens
lightly: lightly
lightning: lightning,lightnings
likeness: likeness
limb: limb,limbs
limit: limit,limited,limits
limitation: limitation
limited: limited
limnoria: limnoria
lineage: lineage
lineament: lineaments
linen: linen
linger: linger,lingering
link: link,linked,links
linus: linus
lion: lion,lions
lioness: lioness
lip: lips
liquid: liquid
list: listed,lists
listen: listen,listening,listens
listener: listeners
listening: listening
listless: listless
lit: lit
literal: literal
literally: literally
literary: literary
literature: literature
liv: liv
live: live,lived,lives,living
lived: lived
livelihood: livelihood
lively: lively
liver: liver
livid: livid
living: living
lo: lo
load: load,loaded,loads
loaded: loaded
loaden: loaden
local: local
locate: located
location: locations
lock: lock,locks
locrian: locrian
locust: locusts
lodge: lodge,lodged
lofty: lofty
loiter: loiter
loll: lolling
lone: lone
lonely: lonely
longing: longing
longshanks: longshanks
looker: lookers
loom: loom,looms
loose: loose,loosed
loosen: loosen
lop: lopped,lops
loquacious: loquacious
lord: lord,lords
lordly: lordly
lorenzo: lorenzo
lose: lose,losing,lost
loser: loser
loss: loss
lost: lost
lot: lot,lots
loth: loth
loto: lotos
loud: loud,louder,loudest
loudly: loudly
lour: louring,lours
louring: louring
love: love,loved,loves,loving
loved: loved
lovely: loveliest,lovely
lover: lover,lovers
lowing: lowing
lowly: lowly
loyal: loyal
loyalty: loyalty
lucan: lucan
lucid: lucid
luckless: luckless
lucky: luckier
lucre: lucre
lucretius: lucretius
lui: lui
lukewarm: lukewarm
lull: lull,lulls
lumber: lumber,lumbering
lung: lungs
lunge: lunge
lurk: lurk
lust: lust
lustful: lustful
lustration: lustration
lustre: lustre
luxuriant: luxuriant
luxury: luxury
lycian: lycian
lyctus: lyctus
lydia: lydia
lynceus: lynceus
lyre: lyre
lyric: lyric
lysander: lysander
macbeth: macbeth
mace: mace
machaon: machaon
machine: machine,machines
machinery: machinery
mad: mad
madame: madame
madding: madding
madly: madly
madness: madness
mae: mae
magazine: magazine
magic: magic
magnanimity: magnanimity
magnificence: magnificence
magnificent: magnificent
magnificently: magnificently
magnify: magnify
magnitude: magnitude
maia: maia
maid: maid,maids
maiden: maiden,maidens
mail: mail
maim: maimed
main: main
mainmast: mainmast
mainspring: mainspring
maintain: maintain,maintained,maintaining,maintains
maintenance: maintenance
majestic: majestic
majestical: majestical
majestically: majestically
majesty: majesty
maker: maker
malice: malice
malicious: malicious
malignant: malignant
mallet: mallet
manage: manage,managed,managing
management: management
manager: manager
mandate: mandate
mane: mane,manes
manger: manger,mangers
mangle: mangle
mangled: mangled
manifest: manifest
manifestly: manifestly
mankind: mankind
manlike: manlike
manly: manlier,manly
mann: mann
manna: manna
manner: manner
manners: manners
mansion: mansion,mansions
mantle: mantle,mantles
manufacture: manufacture
manuscript: manuscript,manuscripts
map: map
marble: marble
marbles: marbles
march: march,marches,marching
mare: mare,mares
margin: margin,margins
mariner: mariner
maris: maris
maritime: maritime
mark: mark,marked,marking,marks
marked: marked
marking: marking
marks: marks
marpessa: marpessa
marriage: marriage
married: married
marrow: marrow
marry: married
mars: mars
marsh: marsh,marshes
marshal: marshal
marshall: marshall
marshy: marshy
mart: mart
martial: martial
marvel: marvelled
marvellous: marvellous
mash: mash
mason: mason,masons
mass: mass
massive: massive
massiveness: massiveness
massy: massy
mast: mast,masts
master: master,masters
mastiff: mastiffs
match: match,matched
matchless: matchless
mate: mate,mates
material: material,materials
maternal: maternal
matron: matron,matrons
matter: matter
maturity: maturity
max: max
maxim: maxim,maxims
maximum: maximum
mayst: mayst
maze: maze,mazes
mazy: mazy
mead: mead,meads
meadow: meadows
meagre: meagre
meal: meal
meaning: meaning,meanings
meanly: meanly
meanness: meanness
measure: measure,measured,measures,measuring
meat: meat
mechanical: mechanical
medea: medea
mediate: mediate,mediates
medical: medical
medici: medici
medicine: medicine
meditate: meditate,meditated,meditates,meditating
medium: medium
meet: meet,meeting,meets,met
meeting: meeting,meetings
melancholy: melancholy
melanippus: melanippus
melas: melas
meleager: meleager
meles: meles
melodious: melodious
melody: melody
melt: melt,melted,melting,melts
melting: melting
memoirs: memoirs
memorable: memorable
memorial: memorial
memory: memory
menace: menace,menaced,menaces
menelaus: menelaus
menial: menial
mention: mention,mentioned,mentioning
mentor: mentor
merchant: merchants
merchantability: merchantability
mercury: mercury
mercy: mercy
mere: mere
meriones: meriones
merit: merit,merits
merops: merops
merriment: merriment
message: message,messages
messenger: messenger
met: met
metal: metal,metals
metallic: metallic
metaphor: metaphor,metaphors
meteor: meteors
meteorous: meteorous
methinks: methinks
method: method,methods
methodical: methodical
metrical: metrical
mettle: mettle
mewling: mewling
michael: michael
microscope: microscope
mid: mid
middle: middle
midmost: midmost
midnight: midnight
midst: midst
midway: midway
mien: mien
mighty: mightier,mightiest,mighty
migrate: migrating
mild: mild,milder,mildest
mildly: mildly
mile: miles
military: military
milk: milk,milking
milker: milker
milky: milky
milton: milton
mimic: mimic
mind: mind,minds
minded: minded
mindful: mindful
mindless: mindless
minerva: minerva
mingle: mingle,mingled,mingles
mingling: mingling
minister: minister,ministers
minor: minor
minos: minos
minstrel: minstrel
minute: minute,minutes
minutely: minutely
minyas: minyas
mira: mira
miracle: miracles
miraculously: miraculously
mirror: mirror
misbehaviour: misbehaviour
miscall: miscall
miscellaneous: miscellaneous
mischance: mischance
mischief: mischief
mischievous: mischievous
miserable: miserable
miserably: miserably
misery: miseries,misery
misfortune: misfortune,misfortunes
mislead: misled
misshapen: misshapen
missile: missile
mission: mission
mississippi: mississippi
missive: missive
mist: mist,mists
mistake: mistake,mistakes,mistook
mistaken: mistaken
mistress: mistress
misty: misty
mitigate: mitigate
mitre: mitre
mix: mix,mixed,mixes,mixing
mixing: mixing
mixture: mixture
moan: moan,moans
mob: mob
mock: mock,mocks
mode: mode,modes
moderate: moderate
modern: modern,moderns
modernism: modernism
modest: modest
modestly: modestly
modesty: modesty
modification: modification,modifications
modify: modified
modulation: modulations
mohammed: mohammed
moira: moira
moisture: moisture
mole: moles
molest: molest
molestation: molestation
molten: molten
moment: moment,moments
momentary: momentary
mon: mon
monarch: monarch,monarchs
money: money
mons: mons
monster: monster,monsters
monstrous: monstrous
month: month,months
monument: monument,monuments
monumental: monumental
mood: mood
moon: moon,moons
moony: moony
moor: moor
moral: moral
morbid: morbid
morbus: morbus
morn: morn
morning: morning
morrow: morrow
morsel: morsels
mortal: mortal,mortals
mortality: mortality
mortals: mortals
moschus: moschus
mossy: mossy
mother: mother,mothers
motion: motion,motions
motionless: motionless
motive: motive,motives
mott: mott
motto: motto
mould: mould,moulds
moulder: moulder
mound: mound,mounds
mount: mount,mounted,mounting,mounts
mountain: mountain,mountains
mourn: mourn,mourning,mourns
mourner: mourner,mourners
mournful: mournful
mourning: mourning
mouse: mice,mouse
mouth: mouth,mouths
moveless: moveless
moving: moving
mow: mow,mows
mower: mowers
muddy: muddy
mulciber: mulciber
mule: mule,mules
muller: muller
multifarious: multifarious
multiplicity: multiplicity
multitude: multitude,multitudes
multitudinous: multitudinous
murder: murder,murdered
murderer: murderer
murderous: murderous
mure: mure
murmur: murmur,murmuring,murmurs
murmuring: murmuring
mus: mus
musa: musa
muse: muse,muses,musing
muses: muses
museum: museum
music: music
muster: muster
mute: mute
mutter: mutter,muttering
mutual: mutual
myrmidon: myrmidons
myrmidonian: myrmidonian
myrmidons: myrmidons
myrtle: myrtles
mysian: mysian
mystery: mysteries,mystery
mystic: mystic
mystical: mystical
mythical: mythical
mythol: mythol
mythological: mythological
mythology: mythology
naiad: naiad
nail: nail,nailed
nais: nais
naked: naked
nape: nape
naples: naples
narrate: narrated,narrating
narration: narration,narrations
narrative: narrative
narrow: narrow,narrowest
narrowness: narrowness
natal: natal
nation: nation,nations
national: national
native: native,natives
natural: natural
naturally: naturally
nature: nature
natured: natured
naval: naval
nave: naves
navel: navel
navigable: navigable
navigate: navigated
navigation: navigation
navy: navies,navy
nearness: nearness
neat: neatest
neatly: neatly
necessity: necessity
neck: neck,necks
nectar: nectar
nectareous: nectareous
needful: needful
needle: needle
negative: negative
neglect: neglect,neglected,neglecting,neglects
neglectful: neglectful
negligence: negligence
negligently: negligently
negro: negroes
neigh: neigh,neighing
neighborhood: neighborhood
neighboring: neighboring
neighbour: neighbour,neighbouring,neighbours
neon: neon
neptune: neptune
nereid: nereids
nereids: nereids
nerve: nerve,nerves
nerveless: nerveless
nervous: nervous
nest: nest
nestor: nestor
nether: nether
network: network
newly: newly
news: news
newsletter: newsletter
nice: nice
nigh: nigh
night: night,nights
nightly: nightly
nile: nile
nimble: nimble
nimbler: nimbler
nineteen: nineteen
ninth: ninth
niobe: niobe
nobility: nobility
noble: noble,nobler,noblest
nobly: nobly
nocturnal: nocturnal
nod: nod,nodded,nodding,nods
noise: noise,noises
noisy: noisy
nomad: nomads
nomine: nomine
nonproprietary: nonproprietary
nonsense: nonsense
noon: noon
north: north
northern: northern
northward: northward
nose: nose
nostril: nostrils
note: note,notes
notes: notes
notice: notice,noticed,noticing
notify: notifies
notion: notion,notions
notoriety: notoriety
notturno: notturno
notus: notus
nought: nought
nourish: nourish
nourishment: nourishment
novelty: novelty
november: november
nowise: nowise
noxious: noxious
numa: numa
numb: numb,numbing
numerous: numerous
nuptial: nuptial
nuptials: nuptials
nurse: nurse,nursed
nursery: nursery
nursing: nursing
nurture: nurture,nurtured
nut: nuts
nymph: nymph,nymphs
nyssa: nyssa
oak: oak,oaks
oar: oar,oars
oath: oath,oaths
obedience: obedience
obedient: obedient
obeisance: obeisance
obey: obey,obeys
object: object,objects
objection: objection,objections
obligation: obligations
oblige: oblige,obliged,obliging
oblique: oblique
obliquely: obliquely
oblivion: oblivion
obloquy: obloquy
obscene: obscene
obscure: obscure,obscured,obscures
obscurest: obscurest
obscurity: obscurity
obsequious: obsequious
obsequy: obsequies
observable: observable
observant: observant
observation: observation,observations
observe: observe,observed,observes,observing
obsolete: obsolete
obstacle: obstacles
obstinacy: obstinacy
obstinate: obstinate
obstinately: obstinately
obstruct: obstruct
obtest: obtests
obtrude: obtrude
obvious: obvious
occasion: occasion,occasioned,occasions
occasional: occasional
occasionally: occasionally
occupy: occupied,occupy,occupying
occur: occur,occurring,occurs
occurrence: occurrence,occurrences
ocean: ocean
oceanus: oceanus
od: od
odd: odd
odds: odds
odious: odious
odour: odours
odysseus: odysseus
odyssey: odyssey
oedipus: oedipus
offence: offence,offences
offend: offend,offended,offending,offends
offended: offended
offender: offenders
offensive: offensive
offer: offer,offered,offering,offers
offering: offering,offerings
office: office,offices
officer: officer,officers
official: official
officious: officious
offspring: offspring
oft: oft
oftener: oftener
oftenest: oftenest
oil: oil
oils: oils
olive: olive
olympiad: olympiad
olympian: olympian
olympus: olympus
omen: omen,omened,omens
omission: omissions
omit: omit,omits,omitting
omnipotence: omnipotence
omnipotent: omnipotent
online: online
onset: onset
onward: onward
ope: opes
oped: oped
opera: operas
operate: operated
operation: operations
ophiuchus: ophiuchus
opinion: opinion,opinions
opp: opp
opponent: opponents
opportunity: opportunities,opportunity
oppose: oppose,opposed,opposes,opposing
opposition: opposition
oppress: oppress,oppressed
opprobrious: opprobrious
option: option
opuntia: opuntia
opus: opus
oracle: oracle,oracles
oracular: oracular
oral: oral
oratory: oratory
orb: orb,orbs
orbit: orbits
ordain: ordain,ordains
ordinance: ordinance
ordinarily: ordinarily
ordinary: ordinary
ore: ore
orestes: orestes
organization: organization
organize: organized
orient: orient
oriental: oriental
origin: origin
original: original
originality: originality
originally: originally
originator: originator
orion: orion
orlando: orlando
ornament: ornament,ornaments
orphan: orphan,orphans
orthian: orthian
osier: osiers
ostensible: ostensible
ostentation: ostentation
otus: otus
ourself: ourself
outcast: outcast
outdated: outdated
outgo: outgo
outline: outline
outnumber: outnumber
outset: outset
outshine: outshined,outshines,outshone
outspread: outspread
outstretch: outstretch
outstrip: outstrip,outstrips
outward: outward
outwards: outwards
outweigh: outweighs
outwork: outworks
oval: oval
overboard: overboard
overcast: overcast
overcharge: overcharged
overcome: overcome
overflow: overflow
overhang: overhangs,overhung
overlook: overlook,overlooked,overlooks
overpower: overpower
overrun: overrun
overspread: overspread
overtake: overtake,overtook
overthrow: overthrow,overthrown
overtop: overtops
overwhelming: overwhelming
owe: owe,owed,owes
owner: owner,owners
ox: ox
oxen: oxen
oxford: oxford
pace: pace,paced
pacific: pacific
pacify: pacified,pacifies
pact: pact,pacts
paeon: paeon
paeonia: paeonia
paeons: paeons
pagan: pagan
pail: pail,pails
pain: pain,pains
painful: painful
paint: painted,paints
painter: painter
pair: pair
palace: palace,palaces
palate: palate
pale: pale,pales
palisade: palisades
pall: palls
palladian: palladian
pallas: pallas
palm: palm,palms
palmed: palmed
palmus: palmus
palpable: palpable
palsy: palsy
pamper: pamper
pandarus: pandarus
pandion: pandion
panegyric: panegyric
pang: pang,pangs
panic: panic
panomphaean: panomphaean
panoply: panoply
pant: pant,panted
pantheon: pantheon
panther: panther
panting: panting
pants: pants
pap: pap
paper: paper,papers
paperwork: paperwork
paphian: paphian
papyrus: papyrus
paradise: paradise
paragraph: paragraph,paragraphs
parallel: parallel,parallels
paraphrase: paraphrase,paraphrased
parch: parch
pardon: pardon
pardonable: pardonable
parent: parent,parents
parentage: parentage
pari: pari
paris: paris
parity: parity
parley: parley
parnassus: parnassus
parody: parodied,parody
partake: partake,partakes
partaker: partaker
parterre: parterre
parti: parti
partial: partial
partiality: partiality
participate: participate
particle: particles
particularize: particularize
particulars: particulars
partition: partition
partly: partly
partner: partner,partners
partook: partook
party: parties,party
pas: pas
pass: pass,passed,passes,passing
passage: passage,passages
passenger: passenger,passengers
passing: passing
passion: passion,passions
passionate: passionate
pastor: pastor
pastoral: pastorals
pasture: pasture,pastures,pasturing
patch: patch
paternal: paternal
path: path,paths
pathetic: pathetic
pathless: pathless
pathway: pathway
patience: patience
patient: patient
patrimonial: patrimonial
patroclus: patroclus
patron: patron,patrons
pattern: pattern
paunch: paunch
pause: pause,paused,pauses,pausing
pavement: pavement
pavilion: pavilion,pavilions
paw: paw,paws
pay: paid,pay,paying,pays
payment: payments
peace: peace
peaceful: peaceful
peacefully: peacefully
peal: peals
pearly: pearly
peasant: peasant
pebble: pebble,pebbles
peculiar: peculiar
peculiarity: peculiarities,peculiarity
peculiarly: peculiarly
pecuniary: pecuniary
pedant: pedant
peer: peers
pelasgi: pelasgi
pelasgian: pelasgian
pelasgic: pelasgic
pelean: pelean
peleus: peleus
pelias: pelias
pelides: pelides
peloponnesian: peloponnesian
pelops: pelops
pen: pen,pent
pendant: pendant,pendants
pendulous: pendulous
penetrable: penetrable
penitence: penitence
pennyworth: pennyworth
pension: pension
pensive: pensive
peopled: peopled
perceive: perceive,perceived,perceives
perceived: perceived
perch: perch
perchance: perchance
peremptorily: peremptorily
perfect: perfect,perfected
perfection: perfection
perfectly: perfectly
perfidious: perfidious
perform: perform,performed,performing,performs
performance: performance,performances
perfume: perfume,perfumes
perfumed: perfumed
peril: peril,perils
perilous: perilous
period: period,periods
periodic: periodic
periphrasis: periphrasis
perish: perish,perished
perjure: perjured
perjured: perjured
perjury: perjuries,perjury
permanent: permanent
permission: permission
permit: permit,permits,permitted,permitting
pernicious: pernicious
perpetual: perpetual
perpetually: perpetually
perplex: perplexed
persecutor: persecutor
perseus: perseus
persevere: persevering
persian: persian
persis: persis
persist: persist,persists
person: people,person,persons
personage: personages
personal: personal
personality: personality
personify: personified
perspicuity: perspicuity
perspicuous: perspicuous
persuade: persuade,persuaded,persuades,persuading
persuasion: persuasion
persuasive: persuasive
pertinacious: pertinacious
perusal: perusal
peruse: perusing
pervade: pervading
pervading: pervading
pest: pest
pestilence: pestilence,pestilences
petition: petition
phalanx: phalanx
phantom: phantom
pharmacy: pharmacy
phenomenon: phenomenon
philip: philip
philoctetes: philoctetes
philological: philological
philosophical: philosophical
philosophy: philosophy
phocian: phocian
phoebe: phoebe
phrase: phrase,phrases
phraseology: phraseology
phrygia: phrygia
phrygian: phrygian
physical: physical
physician: physician
picture: picture,pictures
picturesque: picturesque
piece: piece,piecing
pierce: pierce,pierced,pierces,piercing
pierced: pierced
pig: pig
pigmy: pigmy
pile: pile,piled,piles
pilgrimage: pilgrimages
pillage: pillage,pillaged
pillager: pillager
pillar: pillar,pillars
pilot: pilot,pilots
pine: pine,pines
pinion: pinion,pinions
pinnace: pinnace
pinnacle: pinnacles
piny: piny
pious: pious
pipe: pipe,piping
piratical: piratical
pitch: pitch
pitchy: pitchy
pittance: pittance
pity: pity,pitying
plague: plague,plagued,plagues
plain: plain,plainer,plains
plainly: plainly
plainness: plainness
plaint: plaints
plaintive: plaintive
plaited: plaited
plan: plan,plans
plane: plane
planet: planet,planets
plank: plank,planks
plant: plant,planted,plants
plate: plate,plated,plates
platea: platea
plato: plato
platoon: platoon
plausibly: plausibly
play: play,played,plays
plead: plead,pleaded,pleads
pleased: pleased
pleasing: pleasing
pleasure: pleasure,pleasures
plebeian: plebeian
pledge: pledge,pledged
pleiads: pleiads
plenteous: plenteous
plentiful: plentiful
plenty: plenty
pleon: pleon
pleuron: pleuron
pliant: pliant
plight: plight,plighted,plights
pliny: pliny
plough: plough,ploughs
ploughmen: ploughmen
ploughshare: ploughshare
plumage: plumage
plume: plume,plumes
plumed: plumed
plumy: plumy
plunder: plunder
plunderer: plunderer
plunge: plunge,plunged,plunges,plunging
pluralist: pluralist
plurality: plurality
plutarch: plutarch
pluto: pluto
ply: plied,plies,ply
podalirius: podalirius
podarge: podarge
podargus: podargus
poem: poem,poems
poet: poet,poets
poetaster: poetasters
poetic: poetic,poetics
poetical: poetical
poetry: poetry
pointless: pointless
poise: poise,poised,poises
poison: poison,poisons
poisonous: poisonous
polar: polar
pole: pole,poles
polish: polish,polishing
polished: polished
polite: polite
political: political
polloi: polloi
pollute: pollute,polluted
pollution: pollution
pollux: pollux
polygamy: polygamy
polyphemus: polyphemus
polypus: polypus
pomp: pomp
pompous: pompous
ponder: pondering,ponders
ponderous: ponderous
poniard: poniard
pont: pont
poop: poop
poor: poor
pope: pope
poplar: poplar,poplars
poppy: poppies
populace: populace
popular: popular
popularity: popularity
popularly: popularly
populous: populous
porch: porch,porches
pore: pore,pores
porker: porker
port: port,ports
portal: portal,portals
portent: portent,portents
portentous: portentous
portion: portion,portions
position: position
positive: positive
possess: possess,possessed
possession: possession,possessions
possibility: possibility
post: post,posted,posts
posterity: posterity
postponement: postponement
posture: posture
pound: pound,pounded
pour: pour,poured,pouring,pours
poverty: poverty
power: power,powers
powerful: powerful
powerfully: powerfully
practically: practically
practice: practice
practise: practise,practised
praise: praise,praised,praises,praising
pramnian: pramnian
pray: pray,prayed,prays
prayer: prayer,prayers
precede: precede,preceded,precedes,preceding
precept: precept,precepts
preceptor: preceptor
precious: precious
precipice: precipice
precipitate: precipitate,precipitates
predestined: predestined
predominant: predominant
preeminent: preeminent
preface: preface
prefer: prefer,preferred,preferring,prefers
pregnant: pregnant
prejudice: prejudice,prejudices
prejudiced: prejudiced
prelude: prelude
prepare: prepare,prepared,prepares,preparing
prepared: prepared
prerogative: prerogative
presage: presage,presaging
prescribe: prescribed
presence: presence
preservation: preservation
preserve: preserve,preserved,preserves,preserving
preserver: preserver
preside: preside,presides,presiding
press: press,pressed,presses,pressing
prest: prest
presume: presume,presumes,presuming
presumptuous: presumptuous
pretend: pretend,pretending
pretension: pretension,pretensions
pretext: pretext
pretty: pretty
prevail: prevail,prevailed,prevailing,prevails
prevalence: prevalence
prevent: prevent,prevented,preventing,prevents
previous: previous
prey: prey,preys
priam: priam
price: price
pride: pride
priest: priest,priests
priestess: priestess
priestly: priestly
priests: priests
primary: primary
prime: prime
primi: primi
primitive: primitive
prince: prince,princes
princely: princely
princess: princess,princesses
principal: principal
principally: principally
principle: principle,principles
print: print,printed,prints
prior: prior
prisoner: prisoner,prisoners
pristine: pristine
private: private
privilege: privilege,privileges
prize: prize,prized,prizes
prized: prized
prizes: prizes
probability: probability
probable: probable
proceed: proceed,proceeded,proceeding,proceeds
proceeding: proceeding
proceeds: proceeds
process: process
processing: processing
procession: procession,processions
proclaim: proclaim,proclaiming,proclaims
procure: procure,procured
prodigal: prodigal
prodigious: prodigious
prodigy: prodigies,prodigy
produce: produce,produced,produces
product: product,products
production: production,productions
profane: profane,profaned
profess: profess,professed
profession: profession
professor: professor,professors
proffer: proffer,proffers
profile: profile
profit: profit,profits
profitable: profitable
profound: profound
profoundly: profoundly
profusely: profusely
profusion: profusion
progenitor: progenitor
progeny: progeny
progress: progress
prohibit: prohibits
prohibition: prohibition
project: project,projected
prolegomena: prolegomena
prolong: prolong,prolonged
prometheus: prometheus
prominent: prominent
prominently: prominently
promiscuous: promiscuous
promise: promise,promised,promising
promontory: promontory
promote: promote,promoted,promotes,promoting
promotion: promotion
prompt: prompt,prompted,prompts
prone: prone
pronounce: pronounce,pronounced
pronounced: pronounced
pronunciation: pronunciation
proof: proof,proofs
proofread: proofread
proofreading: proofreading
prop: prop,props
proper: proper
properly: properly
property: properties,property
prophecy: prophecy
prophesy: prophesied,prophesy
prophet: prophet,prophets
prophetic: prophetic
propitiate: propitiate,propitiated
propitious: propitious
proportion: proportion,proportions
proposal: proposal,proposals
propose: propose,proposed,proposes
propound: propounded
proprietary: proprietary
propriety: propriety
prose: prose
prospect: prospect
prospects: prospects
prosper: prosper
prosperity: prosperity
prosperous: prosperous
prostrate: prostrate
protect: protect,protected,protects
protection: protection
protector: protector
protend: protend,protended,protends
protended: protended
proto: proto
protract: protract
prouder: prouder
proudly: proudly
prove: prove,proved,proves,proving
proverb: proverb
proverbial: proverbial
proverbs: proverbs
provide: provide,providing
providence: providence
providential: providential
province: province
provision: provision,provisions
provoke: provoke,provoked,provokes
prowess: prowess
prowl: prowling
prudence: prudence
prudent: prudent
prudently: prudently
pruning: pruning
prytanis: prytanis
prythee: prythee
pseudo: pseudo
public: public
publication: publication
publish: publish,published
publisher: publisher,publishers
puff: puff,puffing
puke: puking
pull: pull
pulse: pulse,pulses
punish: punish
punishment: punishment
punitive: punitive
purchase: purchase,purchased
pure: pure,purer,purest
purely: purely
purge: purge,purged
purify: purify
purity: purity
purl: purl
purple: purple,purpled
purpled: purpled
purport: purport
purpose: purpose,purposes
pursuance: pursuance
pursuant: pursuant
pursue: pursue,pursued,pursues,pursuing
pursuit: pursuit
push: push
pylades: pylades
pylon: pylon
pyramid: pyramid
pyramus: pyramus
pyre: pyre,pyres
pyres: pyres
pyrrhus: pyrrhus
pyrus: pyrus
pythia: pythia
pythian: pythian
quai: quai
quaint: quaint
qualification: qualification,qualifications
qualified: qualified
quality: qualities,quality
quantity: quantity
quarrel: quarrel,quarrels
quarry: quarry
quarter: quarter,quarters
quarterly: quarterly
quasi: quasi
queen: queen
quell: quell,quells
quench: quench
queries: queries
query: queries
question: question,questioning,questions
questionable: questionable
qui: qui
quick: quick,quicker
quickness: quickness
quicksand: quicksand
quiet: quiet
quintus: quintus
quire: quire,quires
quit: quit,quits
quiver: quiver,quivering,quivers
quoit: quoit
quote: quoted,quotes,quoting
rabid: rabid
race: race,races
racer: racer,racers
racing: racing
rack: racks
racking: racking
radiance: radiance
radiant: radiant
rafter: rafters
rag: rags
rage: rage,raged,rages,raging
rail: rail
railing: railing
rain: rain,rains
rainbow: rainbow,rainbows
rainy: rainy
rais: rais
raise: raise,raised,raises,raising
rally: rallies,rally,rallying
ram: ram,rams
rambling: rambling
rampart: rampart,ramparts
rampire: rampire
rancour: rancour
range: range,ranged,ranges,ranging
rank: rank,ranks
ranker: ranker
ranks: ranks
ransom: ransom
rapacious: rapacious
rape: raped
rapid: rapid
rapidity: rapidity
rapidly: rapidly
rapine: rapine
rapt: rapt
rapture: rapture
rare: rare
rarely: rarely
rash: rash
rashly: rashly
rashness: rashness
rate: rate
ratify: ratifies,ratify
rattle: rattle,rattled,rattles,rattling
ravage: ravage
ravages: ravages
rave: rave,raves
ravish: ravish,ravished
ray: ray,rays
raze: raze,razed,razing
reach: reach,reached,reaches,reaching
read: read,reading,reads
readable: readable
reader: reader,readers
readiness: readiness
reading: reading
ready: readiest,ready
real: real
realise: realised
reality: realities,reality
realize: realize,realized
realm: realm,realms
reap: reap,reaps
reaper: reaper,reapers
reappear: reappearing
rear: rear,rears
reason: reason,reasons
reasonable: reasonable
reasonableness: reasonableness
reasoning: reasonings
rebate: rebated
rebel: rebel,rebelling,rebels
rebellion: rebellion
rebellious: rebellious
rebellow: rebellow
rebind: rebound
rebound: rebound
rebuke: rebuke,rebukes
recall: recall,recalled,recalls
recede: recede,recedes,receding
receipt: receipt
receive: receive,received,receives,receiving
receiving: receiving
recension: recension
reception: reception
recess: recess,recesses
recital: recital
recitation: recitation,recitations
recitative: recitative
recite: recite,recited,reciting
reciter: reciter,reciters
reckless: reckless
reckon: reckon
reclaim: reclaim
recline: recline,reclined,reclining
recognise: recognising
recognize: recognize,recognized
recollect: recollect,recollected
recollection: recollection
recommend: recommend
recommendation: recommendation
recompense: recompense
reconcile: reconcile,reconciled,reconciling
reconciliation: reconciliation
record: record,recorded,recording,records
recount: recount,recounting,recounts
recover: recover,recovers
recreant: recreant
recruit: recruit,recruited
recur: recurs
recurrence: recurrence
red: red
redden: reddening,reddens
redeem: redeem,redeeming
redemption: redemption
redistribute: redistribute,redistributing
redistributing: redistributing
redistribution: redistribution
redouble: redoubled,redoubling
redress: redress
reduce: reduce,reduced,reducing
redundancy: redundancy
reed: reed,reeds
reek: reeking
reeking: reeking
reel: reel,reeling
reeve: rove
refection: refection
refer: refer,referred,refers
reference: reference,references
refine: refines
refined: refined
refinement: refinement
reflect: reflect,reflected,reflecting,reflects
reflection: reflection,reflections
refluent: refluent
refractory: refractory
refrain: refrain
refresh: refresh,refreshed,refreshing
refreshment: refreshment
refuge: refuge
refulgent: refulgent
refund: refund
refusal: refusal
refuse: refuse,refused,refuses,refusing
refute: refute
regain: regain,regains
regal: regal
regard: regard,regarded
regardful: regardful
regent: regent
regie: regie
region: region,regions
register: registered
regret: regret,regrets,regretted
regular: regular
regularity: regularity
regularly: regularly
regulate: regulating
regulation: regulation
reign: reign,reigned,reigning,reigns
rein: rein,reins
reject: reject,rejected,rejecting,rejects
rejoice: rejoice,rejoiced,rejoices,rejoicing
rejoin: rejoin,rejoins
rekindle: rekindled,rekindles,rekindling
relate: relate,relates,relating
relation: relation
relative: relative
relax: relax,relaxing
release: release,released
relent: relent,relenting
relentless: relentless
relic: relic,relics
relief: relief,reliefs
relieve: relieve,relieved,relieves
religion: religion,religions
religious: religious
reluctance: reluctance
reluctant: reluctant
reluctantly: reluctantly
remain: remain,remained,remaining,remains
remainder: remainder
remains: remains
remark: remark,remarked,remarking,remarks
remarkable: remarkable
remedy: remedies
remember: remember,remembered
remembrance: remembrance
remiss: remiss
remissive: remissive
remit: remit
remnant: remnant
remodel: remodelled
remonstrance: remonstrance,remonstrances
remorse: remorse
remote: remote,remotest
remount: remount
remounts: remounts
remove: remove,removed,removes,removing
remurmur: remurmur
rename: renamed
rend: rend,rending,rends
render: render,rendered,renders
renew: renew,renewed,renewing,renews
renounce: renounce,renounced
renovate: renovating
renown: renown
renowned: renowned
rent: rent
repair: repair,repairing,repairs
repast: repast,repasting,repasts
repay: repaid,repay,repays
repeat: repeat,repeated,repeating
repeatedly: repeatedly
repel: repel,repelled
repent: repent
repentance: repentance
repentant: repentant
repetition: repetition,repetitions
repine: repine,repines
replace: replace
replacement: replacement
reply: replied,replies,reply
report: report,reported,reports
repose: repose,reposing
represent: represent,represented,representing,represents
representation: representation,representations
representative: representatives
repress: repress
repressing: repressing
reprieve: reprieved
reprimand: reprimanded
reprisal: reprisal
reproach: reproach,reproaches
reproachful: reproachful
reprobate: reprobate
reproduce: reproduce
reproof: reproof,reproofs
reprove: reproved,reproves
reptile: reptile
republican: republican
repugnant: repugnant
repulse: repulse,repulsed,repulses
repulsed: repulsed
repulsive: repulsive
reputation: reputation
reputed: reputed
request: request,requests
require: require,required,requires
required: required
requirement: requirements
requisite: requisite
requite: requite,requites
rescue: rescue,rescued,rescuing
resemblance: resemblance
resemble: resemble,resembles
resent: resent,resenting,resents
resentment: resentment
reserve: reserves
reside: reside,resided
resign: resign,resigns
resist: resist,resisting,resists
resistance: resistance
resistless: resistless
resolution: resolution
resolve: resolve,resolved,resolves,resolving
resort: resort
resound: resound,resounded,resounds
resounding: resounding
respect: respect,respecting
respectful: respectful
respective: respective
respects: respects
respire: respire,respired
respite: respite,respited
resplendent: resplendent
responsible: responsible
responsive: responsive
rest: rest,rested,resting,rests
resting: resting
restive: restive
restless: restless
restoration: restoration
restore: restore,restored,restores,restoring
restrain: restrain,restrained,restrains
restriction: restrictions
result: result
resume: resume,resumed,resumes
retain: retain,retained,retains
retard: retard,retards
retentive: retentive
retire: retire,retired,retires,retiring
retort: retorted,retorts
retreat: retreat,retreating,retreats
retribution: retribution
retributive: retributive
retrieve: retrieve,retrieves
return: return,returned,returning,returns
reveal: reveal,revealed,revealing,reveals
revel: revel
revenge: revenge,revenged,revenges
revengeful: revengeful
revenue: revenue,revenues
revere: revere,revered,reveres
reverence: reverence
reverend: reverend
reverent: reverent
reverential: reverential
reverse: reverse,reversed
revert: revert,reverts
review: review,reviews
revile: revile,reviles
revise: revised
revive: revive,revived,revives,reviving
revolting: revolting
revolution: revolutions
revolve: revolve,revolved,revolves,revolving
revolving: revolving
reward: reward,rewarded,rewards
rhapsode: rhapsodes
rhapsodic: rhapsodic
rhapsodize: rhapsodize
rhapsody: rhapsodies
rhea: rhea
rhesus: rhesus
rhetorical: rhetorical
rhodes: rhodes
rhodian: rhodian
rhyme: rhyming
rib: ribs
rich: rich,richest
richard: richard
riches: riches
richness: richness
rid: rid
riddle: riddle
ride: ride,rides,rode
ridge: ridges
ridicule: ridicule
ridiculous: ridiculous
rifle: rifle
rifled: rifled
righteous: righteous
rightly: rightly
rigid: rigid
rill: rill,rills
rim: rim
rinaldo: rinaldo
ringlet: ringlets
rings: rings
ripe: ripe
ripen: ripen,ripened,ripening
rise: rise,rises,rising,rose
rising: rising
risk: risk
rite: rite,rites
rival: rival,rivalled,rivals
rivalry: rivalry
riven: riven
river: river,rivers
rivers: rivers
rivet: rivets
road: road
roam: roam,roaming
roar: roar,roaring,roars
roaring: roaring,roarings
roast: roast
rob: rob,robs
robber: robbers
robbery: robbery
robe: robe,robes
rock: rock,rocks
rocking: rocking
rocky: rocky
rod: rod
roe: roe
roll: roll,rolled,rolling,rolls
rolling: rolling
rolls: rolls
roman: roman,romans
romance: romance,romances
romulus: romulus
roof: roof,roofed,roofs
root: root,rooted,roots
rooted: rooted
rope: ropes
roscoe: roscoe
rose: rose
roseate: roseate
rosy: rosy
rotte: rotte
rotunda: rotunda
rough: rough
roughness: roughness
rouse: rouse,roused,rouses
rousing: rousing
rout: rout
route: routed
rove: rove
row: row,rowed,rows
royal: royal
royalty: royalties,royalty
rubbish: rubbish
ruddy: ruddy
rude: rude
rudely: rudely
rudiment: rudiments
rueful: rueful
ruffle: ruffled
rugged: rugged
ruin: ruin,ruins
rule: rule,ruled,rules,ruling
ruler: ruler,rulers
ruling: ruling
rumble: rumbling
ruminate: ruminate
rumour: rumour
rural: rural
rush: rush,rushes,rushing
rustic: rustic,rustics
rusticity: rusticity
rustling: rustling
ruthless: ruthless
saber: saber
sable: sable
sack: sack,sacked,sacks
sacred: sacred
sacredness: sacredness
sacrifice: sacrifice,sacrificed,sacrifices
sacrificial: sacrificial
sad: sad,sadder
sadden: sadden,saddens
sadly: sadly
sadness: sadness
safe: safe,safer,safest
safely: safely
safety: safety
saffron: saffron
saga: sagas
sagacious: sagacious
sagacity: sagacity
sage: sage,sages
sai: sai
sail: sail,sailed,sails
sailing: sailing
sailor: sailors
saint: saint
sake: sake
salaminian: salaminian
salamis: salamis
sally: sally
salt: salt,salted
salubrious: salubrious
salute: salute
sameness: sameness
samian: samian
sample: sample
samuel: samuel
sanctify: sanctify
sanction: sanction
sanctuary: sanctuaries
sand: sand,sands
sandal: sandals
sandy: sandy
sangar: sangar
sanguine: sanguine
santa: santa
sap: saps
saracen: saracen
sarcastically: sarcastically
sarpedon: sarpedon
sat: sat
satan: satan
sate: sate
satiate: satiate,satiating
satiety: satiety
satire: satires
satisfaction: satisfaction
satisfactorily: satisfactorily
satisfactory: satisfactory
satisfied: satisfied
satisfy: satisfy
saturn: saturn
saturnia: saturnia
savage: savage,savages
save: save,saved,saves,saving
saved: saved
saviour: saviour
savour: savours
savoury: savoury
scald: scalding
scale: scale,scaled,scales
scaliger: scaliger
scaling: scaling
scaly: scaly
scamander: scamander
scamandrius: scamandrius
scandal: scandal
scandalize: scandalized
scantling: scantling
scap: scaped
scape: scape,scapes
scarce: scarce
scarcely: scarcely
scared: scared
scarf: scarf
scatter: scatter,scattered,scattering,scatters
scene: scene,scenes
scent: scent,scents
sceptic: sceptic
scepticism: scepticism
sceptre: sceptre,sceptres
sceptred: sceptred
schedius: schedius
scheme: scheme,schemes
scholar: scholar,scholars
scholastic: scholastic
scholia: scholia
school: school
schoolfellow: schoolfellows
science: science
scoffing: scoffing
scoop: scoop
scorch: scorch,scorching
score: score
scorn: scorn,scorns
scornful: scornful
scotland: scotland
scott: scott
scour: scour
scourge: scourge,scourged,scourges
scout: scout,scouts
scrap: scrap
scratch: scratch
scream: scream,screaming
screen: screen
scripture: scripture
scud: scuds
sculptor: sculptor
sculpture: sculpture,sculptured
sculptured: sculptured
sculptures: sculptures
sea: sea,seas
seal: seal,sealed,seals
seaman: seamen
search: search,searched,searching
seashore: seashore
season: season,seasons
seat: seat,seated,seats
secession: secession
secondary: secondary
secret: secret,secrets
secretary: secretary
secure: secure,secured
secured: secured
securely: securely
security: security
sedate: sedate
sedgy: sedgy
sedition: sedition
seduce: seduced
seed: seed,seeds
seek: seek,seeking,seeks,sought
seer: seer
seize: seize,seized,seizes,seizing
seldom: seldom
select: select,selected
selection: selection,selections
selfish: selfish
sell: sold
selli: selli
semblance: semblance
senate: senate
send: send,sending,sends
seneca: seneca
senior: senior,seniors
sense: sense
senseless: senseless
sentence: sentence,sentenced,sentences
sentiment: sentiment,sentiments
sentinel: sentinel
separate: separate,separated
sepulchral: sepulchral
sepulchre: sepulchre
sepulture: sepulture
sequel: sequel
sequester: sequester
seraph: seraph
serene: serene,serenes
serenely: serenely
series: series
serpent: serpent,serpents
servant: servant,servants
serve: serve,served,serves
service: service,services
servile: servile
servilely: servilely
servitude: servitude
servius: servius
set: set,sets,setting
setting: setting
settle: settle,settled,settles,settling
settlement: settlement
sevenfold: sevenfold
seventeenth: seventeenth
seventh: seventh
sever: sever
severe: severe,severer
severely: severely
sex: sex
sextus: sextus
shade: shade,shaded,shading
shades: shades
shadow: shadowed,shadows
shadowy: shadowy
shady: shady
shaft: shaft,shafted,shafts
shaggy: shaggy
shake: shake,shaken,shakes,shaking,shook
shaker: shaker
shalt: shalt
shame: shame
shameful: shameful
shameless: shameless
shape: shape,shaped,shapes
share: share,shared,shares,sharing
sharp: sharp,sharper,sharpest
sharpen: sharpen
shatter: shatter
sheaf: sheaves
shear: shorn
sheath: sheath
sheathe: sheathe,sheathed,sheathes
sheep: sheep
sheephook: sheephook
sheer: sheer
sheet: sheets
shelter: shelter,shelters
shelve: shelving
shepherd: shepherd,shepherds
shield: shield,shielded,shields
shields: shields
shift: shift,shifting,shifts
shine: shine,shined,shines,shining,shone
shingly: shingly
ship: ship,ships
ships: ships
shipwreck: shipwreck,shipwrecked
shipwright: shipwright
shiver: shiver,shivering,shivers
shoal: shoals
shock: shock,shocks
shocked: shocked
shocking: shocking
shoot: shoot,shooting,shoots,shot
shooter: shooter
shooting: shooting
shore: shore,shores
short: short,shorter
shorten: shorten
shortness: shortness
shot: shot
shoulder: shoulder,shoulders
shouldst: shouldst
shout: shout,shouting,shouts
shouting: shouting
shower: shower,showering,showers
showery: showery
shriek: shriek,shrieking,shrieks
shrill: shrill,shrillest,shrilling
shrilling: shrilling
shrine: shrine,shrines
shrink: shrink,shrinks,shrunk
shroud: shroud,shrouds
shrub: shrubs
shrunk: shrunk
shudder: shudders
shun: shun,shuns
shut: shut,shuts
shuttle: shuttle
sick: sick
sicken: sicken
sickle: sickle,sickles
sidonian: sidonian
siege: siege
sift: sifted
sigh: sigh,sighing,sighs
sight: sight,sights
sightless: sightless
sign: sign,signs
signal: signal,signals
signalize: signalizes
signification: significations
signify: signified,signifies,signifying
silence: silence,silenced
silent: silent
silken: silken
silver: silver
silvery: silvery
simar: simars
similarity: similarity
simile: simile,similes
simple: simple,simpler,simples,simplest
simplicity: simplicity
sin: sins
sincerely: sincerely
sinecure: sinecures
sinew: sinews
sinewy: sinewy
sing: sang,sing,singing,sings,sung
singe: singed
singing: singing
single: single,singled
singles: singles
singly: singly
singular: singular
singularly: singularly
sinister: sinister
sink: sank,sink,sinking,sinks,sunk
sinner: sinner
sinon: sinon
sir: sir
sire: sire,sires
sirian: sirian
sirius: sirius
sister: sister,sisters
sisyphus: sisyphus
sit: sat,sit,sits,sitting
situate: situated
situation: situation,situations
sixteen: sixteen
sixteenth: sixteenth
sixth: sixth
size: size
sketch: sketch
skilful: skilful
skill: skill
skilled: skilled
skim: skimming,skims
skin: skin
skirmish: skirmish
skulk: skulk
skull: skull
sky: skies,sky
slack: slack
slacken: slacken
slain: slain
slaughter: slaughter,slaughtered,slaughtering,slaughters
slave: slave,slaves
slavish: slavish
slay: slain,slay,slays
slaying: slaying
sleek: sleek
sleep: sleep,sleeping,sleeps,slept
sleepless: sleepless
sleight: sleight
slender: slender
slew: slew
slide: slide,slides
slight: slight,slighted,slighting,slights
slimy: slimy
sling: sling
slinger: slingers
slippery: slippery
slope: slope
sloth: sloth
slothful: slothful
sloven: sloven
slow: slow
slowly: slowly
slowness: slowness
sluice: sluices
sluicy: sluicy
slumber: slumber,slumbering,slumbers
slumbering: slumbering
sly: sly
smart: smart,smarting
smear: smear
smile: smile,smiled,smiles,smiling
smintheus: smintheus
smit: smit
smite: smit,smites,smote
smoke: smoke,smoked,smokes,smoking
smoking: smoking
smoky: smoky
smooth: smooth,smoothed,smooths
smoothness: smoothness
smote: smote
smother: smother
smyrna: smyrna
snake: snake,snakes
snatch: snatch,snatched,snatches
snort: snort,snorted
snow: snow,snows
snowy: snowy
snuff: snuffs
soar: soar,soaring,soars
sob: sob,sobs
sober: sober
soberly: soberly
social: social
society: societies,society
socrates: socrates
soever: soever
soft: soft,softer,softest
soften: soften,softened,softens
softened: softened
softly: softly
softness: softness
soil: soil,soils
sol: sol
solace: solace
solar: solar
soldier: soldier,soldiers
sole: sole
solely: solely
solemn: solemn
solemnity: solemnities,solemnity
solemnly: solemnly
solicit: solicit,solicits
solicitation: solicitation
solid: solid
solitary: solitary
solymaean: solymaean
somnus: somnus
son: son,sons
song: song,songs
sonorous: sonorous
sons: sons
soothe: soothe,soothed,soothes
sooty: sooty
sophocles: sophocles
sordid: sordid
sordidness: sordidness
sore: sore
sorrow: sorrow,sorrowing,sorrows
sorrowing: sorrowing
sort: sort,sorts
soul: soul,souls
sound: sound,sounder,sounding,sounds
sour: sour
source: source,sources
sourly: sourly
souse: sousing
south: south
southern: southern
sovereign: sovereign
sow: sow
space: space
spacious: spacious
spade: spade
span: span
spangled: spangled
spare: spare,spared,spares,sparing
sparkle: sparkle,sparkled,sparkles,sparkling
sparkling: sparkling
sparta: sparta
spartan: spartan,spartans
spatter: spatter
speak: spake,speak,speaking,speaks,spoke,spoken
speaker: speaker,speakers
spear: spear,spears
spears: spears
special: special
specially: specially
species: species
speckled: speckled
spectacle: spectacle
spectator: spectator,spectators
spectre: spectre,spectres
speech: speech,speeches
speed: sped,speed,speeds
speeds: speeds
speedy: speedy
spell: spelt
spend: spends,spent
sphere: sphere
spiky: spiky
spill: spilt
spin: spin,spun
spinal: spinal
spindle: spindle
spinster: spinster
spire: spire,spires
spirit: spirit,spirits
spirited: spirited
spiritless: spiritless
spiry: spiry
spleen: spleen
spleenful: spleenful
splendid: splendid
splendour: splendour
splinter: splinter
spoil: spoil,spoils
spoke: spoke,spokes
sponge: sponge
spontaneous: spontaneous
sport: sport,sported
sporting: sporting
sportive: sportive
spot: spot,spots
spotless: spotless
spotted: spotted
spouse: spouse,spouses
spout: spouting,spouts
sprang: sprang
spread: spread,spreading,spreads
spreading: spreading
sprig: sprig
sprightly: sprightly
spring: sprang,spring,springing,springs,sprung
springing: springing
springs: springs
sprinkle: sprinkle,sprinkled,sprinkles,sprinkling
sprinkling: sprinkling
spurious: spurious
spurn: spurn,spurns
sputtering: sputtering
spy: spied,spies,spy
sqq: sqq
squadron: squadron,squadrons
square: square
squeamish: squeamish
squint: squinting
squire: squire,squires
staff: staff
stag: stag
stage: stage
stagger: staggering
staggering: staggering
stain: stain,stained,stains
stake: stake,stakes
stalk: stalk,stalked,stalks
stalks: stalks
stall: stall,stalls
stamp: stamp,stamped
stanch: stanch
stand: stand,standing,stands,stood
standard: standard
stander: stander
standing: standing
stanhope: stanhope
stanza: stanzas
star: star,stars
stare: stare,stares
starr: starr
starry: starry
start: start,started,starting,starts
startle: startle
startled: startled
startling: startling
stately: stately
statement: statement,statements
statesman: statesman
station: station,stations
statistical: statistical
statue: statue
stature: stature
status: status
stay: stay,stayed,stays
stead: stead
steadily: steadily
steady: steady
steal: steal,stole,stolen
stealth: stealth
steam: steaming,steams
stedfast: stedfast
steed: steed,steeds
steeds: steeds
steel: steel
steele: steele
steely: steely
steep: steep,steeps
steepy: steepy
steer: steer,steers
stem: stem
stentor: stentor
step: step,stepping,steps
stern: stern,sterns
sternly: sternly
steward: steward
stick: sticking,sticks,stuck
stiff: stiff
stiffen: stiffen,stiffening,stiffens
stimulate: stimulating
sting: stings,stung
stipend: stipend
stir: stirring,stirs
stirling: stirling
stock: stock,stocked,stocks
stone: stone,stones
stones: stones
stony: stony
stoop: stoop,stooping,stoops
stoppage: stoppage
store: store,stored,stores
storehouse: storehouse
storm: storm,storms
stormy: stormy
story: story
stow: stow
straggle: straggling
straight: straight
strain: strain,straining,strains
strait: strait,straits
straiten: straiten
strand: strand,strands
strange: strange
stranger: stranger,strangers
strangle: strangling
strap: straps
stratagem: stratagem
strauss: strauss
straw: straw
stray: stray,strays
streak: streak
stream: stream,streaming,streams
streaming: streaming
streams: streams
streamy: streamy
street: street,streets
strength: strength
strengthen: strengthen,strengthened,strengthening,strengthens
strenuous: strenuous
stretch: stretch,stretched,stretches,stretching
strew: strew,strews
strict: strict,strictest
stride: stride,strides,strode
strife: strife
strike: strike,strikes,striking,struck
striker: striker
striking: striking
string: string,strings,strung
strip: strip,stripping,strips
stripling: stripling
strips: strips
stript: stript
strive: strive,strives,striving,strove
strode: strode
stroke: stroke,strokes
strong: strong,stronger,strongest
strook: strook
strow: strow,strows
struck: struck
structure: structure,structures
struggle: struggle,struggling
stubble: stubble
stubborn: stubborn
stuck: stuck
stud: studded,studs
student: student
studious: studious
study: study
stuffing: stuffing
stumble: stumbles
stunning: stunning
stupendous: stupendous
stupid: stupid
stupidity: stupidity
sturdy: sturdy
stygian: stygian
style: style,styled
styptic: styptic
styrian: styrian
styx: styx
subdue: subdue,subdued
subject: subject,subjected,subjects
subjugator: subjugator
sublime: sublime
sublimity: sublimity
submiss: submiss
submission: submission,submissions
submissive: submissive
submit: submit,submits,submitted,submitting
subordinate: subordinate
subscribe: subscribe
subscriber: subscribers
subsequent: subsequent
subsequently: subsequently
subside: subside,subsides
subsidence: subsidence
subsiding: subsiding
subsist: subsisted,subsisting,subsists
subsistence: subsistence
substance: substance
substantial: substantial
substantive: substantive
substitute: substituted,substituting
subtartarean: subtartarean
subterfuge: subterfuge
subtle: subtle
subtlety: subtlety
suburb: suburb
subvert: subverting
succeed: succeed,succeeded,succeeding,succeeds
success: success,successes
successful: successful
succession: succession
successive: successive
successless: successless
succinct: succinct
succour: succour,succours
suck: suck,sucked,sucks
sudden: sudden
suddenly: suddenly
sue: sue,sued,sues
suffer: suffer,suffered,suffering,suffers
suffering: suffering,sufferings
suffice: suffice,sufficed,suffices
sufficient: sufficient
suffrage: suffrage
suicide: suicide
suit: suit,suited,suiting,suits
suitable: suitable
suitor: suitors
sullen: sullen
sulphur: sulphur
sultry: sultry
sum: sum,sums
summarily: summarily
summary: summary
summer: summer
summit: summit,summits
summon: summon,summoned
summons: summons
sumptuous: sumptuous
sun: sun,suns
sunbeam: sunbeam
sung: sung
sunk: sunk
sunshine: sunshine
superb: superb
superinduce: superinduce
superintendence: superintendence
superior: superior,superiors
superiority: superiority
supernatural: supernatural
supernumerary: supernumerary
superstition: superstition,superstitions
superstitious: superstitious
superstructure: superstructure
supine: supine
supper: supper
supple: supple
suppliant: suppliant,suppliants
supplicate: supplicate,supplicates,supplicating
supplication: supplications
supply: supplied,supplies,supply
support: support,supported,supporting
suppose: suppose,supposed,supposes,supposing
supposition: supposition
suppress: suppress
supreme: supreme
supremely: supremely
surcease: surcease
surcharge: surcharged
surely: surely
surface: surface,surfaces
surge: surge,surges,surging
surgeon: surgeons
surgical: surgical
surly: surly
surname: surnames
surpass: surpass,surpassed,surpassing
surprise: surprise,surprised
surprised: surprised
surprising: surprising
surround: surround,surrounded,surrounding,surrounds
survey: survey,surveying,surveys
survive: survive,survived,survives,surviving
suspect: suspect,suspected,suspects
suspend: suspend,suspended,suspends
suspense: suspense
suspicion: suspicion
sustain: sustain,sustained,sustains
sustaining: sustaining
sustenance: sustenance
swain: swain,swains
swallow: swallow,swallowed
swamp: swamp
swan: swans
swarm: swarm,swarming,swarms
swarth: swarths
sway: sway,sways
swear: swear,swore,sworn
sweat: sweat,sweating,sweats
sweating: sweating
sweaty: sweaty
sweep: sweep,sweeping,sweeps,swept
sweeping: sweeping
sweepy: sweepy
sweet: sweet,sweetest,sweets
sweetest: sweetest
sweetness: sweetness
swell: swell,swelled,swelling,swells
swift: swift,swifter,swiftest
swiftest: swiftest
swiftly: swiftly
swiftness: swiftness
swim: swam,swim,swimming,swims
swimming: swimming
swine: swine
swing: swings,swung
swinging: swinging
swoln: swoln
swoon: swoon,swoons
sword: sword,swords
swords: swords
sycamore: sycamore
syllable: syllables
sylvan: sylvan
sylvans: sylvans
symbol: symbols
symbolic: symbolic
symmetry: symmetry
sympathize: sympathized
sympathizer: sympathizers
sympathy: sympathies,sympathy
symptom: symptom,symptoms
synod: synod
synonymous: synonymous
table: table,tables
tablet: tablet,tablets
tacit: tacit
tact: tact
tactic: tactics
tail: tail
taint: tainting,taints
tainted: tainted
tale: tale
talent: talent,talents
talk: talk
tall: tall
talon: talons
tamarisk: tamarisk,tamarisks
tame: tame,tamed
tamely: tamely
tanto: tanto
taper: taper
tardy: tardier,tardy
targe: targe
target: target,targets
tartarean: tartarean
tartarus: tartarus
task: task,tasks
taste: taste,tasted,tastes
tatian: tatian
tatters: tatters
taunt: taunts
taurus: taurus
tawdry: tawdry
tawny: tawny
tax: tax,taxes
taxation: taxation
taylor: taylor
teach: taught,teach
teacher: teacher
team: team,teams
tear: tear,tearing,tears,tore,torn
tearful: tearful
tedious: tedious
tediously: tediously
tedium: tedium
teem: teeming
tela: tela
telamon: telamon
telemachus: telemachus
tempe: tempe
temper: temper,tempered,tempering
temperate: temperate
tempest: tempest,tempesting,tempests
tempestuous: tempestuous
temple: temple,temples
temporary: temporary
tempt: tempt,tempted,tempts
tempting: tempting
tend: tend,tending
tendency: tendencies,tendency
tender: tender,tenderest
tenderness: tenderness
tendon: tendons
teneriffe: teneriffe
tenfold: tenfold
tenor: tenor
tenour: tenour
tent: tent,tents
tented: tented
tenth: tenth
term: term,terms
termination: termination
terra: terra
terrestrial: terrestrial
terrible: terrible
terrific: terrific
terrify: terrifies,terrify
territory: territory
terror: terror,terrors
testament: testament
testify: testifies
testimony: testimonies,testimony
tethys: tethys
teucer: teucer
teucri: teucri
texture: texture,textures
thalia: thalia
thankful: thankful
thankless: thankless
thatch: thatch
theban: theban
thee: thee
theft: theft
theme: theme
themis: themis
thenceforth: thenceforth
theodore: theodore
theophilus: theophilus
theorist: theorists
theory: theories,theory
thersites: thersites
theseus: theseus
thessalian: thessalian
thetis: thetis
thicken: thicken,thickening,thickens
thickening: thickening
thicket: thicket,thickets
thief: thief,thieves
thigh: thigh,thighs
thine: thine
thinking: thinking
thinly: thinly
thirst: thirst,thirsting,thirsts
thirsty: thirsty
thirteen: thirteen
thirteenth: thirteenth
thirtieth: thirtieth
thither: thither
tho: tho
thong: thong,thongs
thoughtful: thoughtful
thoughtless: thoughtless
thracian: thracian
thread: thread
threat: threat,threats
threaten: threaten,threatening,threatens
threatening: threatening
threefold: threefold
threshold: threshold
thrice: thrice
thrift: thrift
thrill: thrill,thrills
thrilling: thrilling
thrive: thrive
throat: throat,throats
throe: throes
throne: throne,thrones
throng: throng,thronging,throngs
throw: threw,throw,thrown,throws
thrust: thrust
thunder: thunder,thundering,thunders
thunderbolt: thunderbolt,thunderbolts
thunderer: thunderer
thundering: thundering
thwart: thwarts
thy: thy
thyestes: thyestes
thyself: thyself
tide: tide,tides
tiding: tidings
tie: tie,tied,ties
tiger: tiger
tim: tim
timber: timber
time: time,timed,times
timely: timely
timorous: timorous
tin: tin
tincture: tincture
ting: ting
tinge: tinged
tinkle: tinkled,tinkling
tire: tire,tired,tires
tired: tired
tiresome: tiresome
tit: tit
titan: titan
titanian: titanian
titans: titans
tithonus: tithonus
title: title,titled,titles
toil: toil,toils
token: token
tolerable: tolerable
tolerably: tolerably
tomb: tomb
tombstone: tombstone
ton: ton
tone: tone
tong: tongs
tongue: tongue,tongues
tooth: teeth,tooth
topmost: topmost
topography: topography
torch: torch,torches
torment: torment
torn: torn
torrent: torrent,torrents
torso: torso
torture: torture,tortures
toss: toss,tosses
total: total
totter: totter,totters
touch: touch,touched,touches,touching
touching: touching
touchstone: touchstone
tough: tough
tow: towed
tower: tower,towering,towers
towering: towering
towers: towers
towery: towery
town: town,towns
townsman: townsman,townsmen
toy: toys
trace: trace,traced,traces
track: track
tract: tract,tracts
trade: trade
trademark: trademark
tradition: tradition,traditions
traditional: traditional
traditionary: traditionary
tragedian: tragedians
tragedy: tragedies,tragedy
tragic: tragic
trail: trail,trails
train: train,trained,trains
traitor: traitor
trample: trampled,tramples,trampling
trampled: trampled
trampling: trampling
trance: trance
tranquillity: tranquillity
transaction: transaction
transcend: transcending,transcends
transcendent: transcendent
transcribe: transcribe
transcript: transcript
transcription: transcription
transfer: transfer,transferred,transfers
transfix: transfix,transfixes
transform: transform
transfuse: transfuse,transfusing
transgress: transgress
transient: transient
transition: transition,transitions
translate: translate,translated,translates,translating
translation: translation,translations
translations: translations
translator: translator,translators
transmission: transmission
transmit: transmitted
transparent: transparent
transpierce: transpierced,transpiercing
transpierced: transpierced
transpiercing: transpiercing
transport: transport,transported,transports
trappings: trappings
travel: travel
traveller: traveller,travellers
travels: travels
traverse: traverse,traversed
treacherous: treacherous
treacherously: treacherously
tread: tread,treads,trod
treasure: treasure,treasured,treasures
treasury: treasury
treat: treat,treated,treats
treatise: treatise
treatment: treatment
treaty: treaties
tree: tree,trees
tremble: tremble,trembled,trembles,trembling
tremendous: tremendous
trench: trench,trenches
trenchant: trenchant
tress: tresses
trial: trial,trials
tribe: tribes
tribunal: tribunal
tributary: tributary
tribute: tribute
trick: trick,tricked
trickle: trickle,trickling
trident: trident
trifle: trifles
trifling: trifling
triple: triple
tripod: tripod,tripods
tristram: tristram
tritonia: tritonia
triumph: triumph,triumphing,triumphs
triumphant: triumphant
triumphantly: triumphantly
trivial: trivial
troad: troad
trod: trod
troilus: troilus
trojan: trojan,trojans
troop: troop
troops: troops
trop: trop
trophy: trophies,trophy
trouble: trouble,troubles
troubled: troubled
troublesome: troublesome
troy: troy
truce: truce
true: true,truest
trumpet: trumpet,trumpets
trunk: trunk,trunks
truss: truss
trust: trust,trusted,trusting,trusts
trustworthy: trustworthy
trusty: trusty
truth: truth,truths
tu: tu
tug: tug,tugging,tugs
tumble: tumble,tumbled,tumbles,tumbling
tumbler: tumblers
tumour: tumours
tumult: tumult,tumults
tumultuous: tumultuous
tune: tune,tuned
tuneful: tuneful
tunic: tunic
tuque: tuque
turbulent: turbulent
turf: turf
turgid: turgid
turret: turret,turrets
turtle: turtle,turtles
tusk: tusks
tusky: tusky
tutor: tutor
twaddling: twaddling
twain: twain
twang: twang,twanging,twangs
twelfth: twelfth
twentieth: twentieth
twilight: twilight
twin: twins
twine: twined
twist: twisting
twisted: twisted
twisting: twisting
tydeus: tydeus
type: type,types
typhon: typhon
tyrant: tyrant,tyrants
tyrian: tyrian
ultimate: ultimate
ulysses: ulysses
umber: umber
umbrage: umbrage
unabated: unabated
unable: unable
unacquainted: unacquainted
unactive: unactive
unadored: unadored
unadorned: unadorned
unaffected: unaffected
unaided: unaided
unalterable: unalterable
unanimated: unanimated
unanimously: unanimously
unappeased: unappeased
unarm: unarm
unassisted: unassisted
unassisting: unassisting
unattended: unattended
unavailing: unavailing
unawed: unawed
unbar: unbar,unbars
unbathed: unbathed
unbecoming: unbecoming
unbend: unbend
unbended: unbended
unbent: unbent
unbid: unbid
unbidden: unbidden
unbless: unbless
unbodied: unbodied
unborn: unborn
unbound: unbound
unbounded: unbounded
unbrace: unbrace,unbraced
unbraced: unbraced
unbroke: unbroke
unbroken: unbroken
unbuckle: unbuckling
unburied: unburied
unceasing: unceasing
uncertain: uncertain
uncertainty: uncertainty
unchangeable: unchangeable
unchanged: unchanged
uncle: uncle
unclose: unclose
unclouded: unclouded
uncomfortable: uncomfortable
uncommon: uncommon
uncommonly: uncommonly
unconfined: unconfined
unconquerable: unconquerable
unconscious: unconscious
unconsciously: unconsciously
uncontrollable: uncontrollable
uncorrupted: uncorrupted
uncover: uncover
undaunted: undaunted
undeceived: undeceived
undefiled: undefiled
undergo: undergo,undergone
underground: underground
undermine: undermine,undermining
understand: understand,understanding,understood
undertake: undertake,undertaken,undertakes
undertaking: undertaking
undeserved: undeserved
undetermined: undetermined
undisciplined: undisciplined
undisfigured: undisfigured
undistinguish: undistinguish
undistinguished: undistinguished
undisturbed: undisturbed
undo: undone
undoubted: undoubted
undoubtedly: undoubtedly
undried: undried
undrossy: undrossy
undulation: undulations
uneducated: uneducated
unemployed: unemployed
unenforceability: unenforceability
unequal: unequal
unequalled: unequalled
unerring: unerring
unexpected: unexpected
unfading: unfading
unfailing: unfailing
unfaithful: unfaithful
unfinish: unfinish
unfit: unfit
unfold: unfold,unfolding,unfolds
unforeseen: unforeseen
unforgiving: unforgiving
unfortified: unfortified
unfortunate: unfortunate
unfreed: unfreed
unfrequent: unfrequent
unfrequently: unfrequently
unfruitful: unfruitful
ungenerous: ungenerous
ungentle: ungentle
ungraceful: ungraceful
ungrateful: ungrateful
unguarded: unguarded
unguent: unguents
unguided: unguided
unhappily: unhappily
unhappy: unhappy
unharness: unharness
unheard: unheard
unheeded: unheeded
unheedful: unheedful
unhelp: unhelp
unhurt: unhurt
uniform: uniform
unimportant: unimportant
uninjured: uninjured
uninspired: uninspired
unintelligible: unintelligible
union: union
unison: unison
unite: unite,united,unites
united: united
unity: unity
universal: universal
universally: universally
university: university
unjust: unjust
unkind: unkind
unkindled: unkindled
unkingly: unkingly
unknow: unknowing
unknowing: unknowing
unknown: unknown
unlawful: unlawful
unlearning: unlearning
unlimited: unlimited
unlink: unlink
unloose: unloosed
unloosed: unloosed
unlucky: unlucky
unmaimed: unmaimed
unman: unmans
unmangled: unmangled
unmanly: unmanly
unmatched: unmatched
unmeasured: unmeasured
unmindful: unmindful
unmix: unmix
unmolested: unmolested
unmoved: unmoved
unnecessary: unnecessary
unnerve: unnerves
unnerved: unnerved
unnumber: unnumber
unobserved: unobserved
unpaid: unpaid
unperceived: unperceived
unpitied: unpitied
unpitying: unpitying
unpopularity: unpopularity
unpractised: unpractised
unprofitably: unprofitably
unprotected: unprotected
unravel: unravel
unreasonable: unreasonable
unregarded: unregarded
unrelenting: unrelenting
unremoved: unremoved
unreproved: unreproved
unresisted: unresisted
unresisting: unresisting
unresolved: unresolved
unrevenged: unrevenged
unrewarded: unrewarded
unrivalled: unrivalled
unroll: unroll
unruly: unruly
unsaid: unsaid
unseal: unseal
unseen: unseen
unsheathed: unsheathed
unskilful: unskilful
unskilfully: unskilfully
unskill: unskill
unsleeping: unsleeping
unsolicited: unsolicited
unstain: unstain
unstrings: unstrings
unsubdued: unsubdued
unsuccessful: unsuccessful
unsuccessfully: unsuccessfully
unsuitable: unsuitable
unsullied: unsullied
unsupported: unsupported
unsuspicious: unsuspicious
untainted: untainted
untaken: untaken
untame: untamed
untamed: untamed
untasted: untasted
untaught: untaught
untenable: untenable
unterrified: unterrified
unthinking: unthinking
unthought: unthought
untie: untie,untied
untimely: untimely
untired: untired
untouch: untouch
untrodden: untrodden
untwine: untwine
unused: unused
unuseful: unuseful
unusual: unusual
unutterable: unutterable
unwarlike: unwarlike
unwary: unwary
unwearied: unwearied
unwelcome: unwelcome
unwept: unwept
unwieldy: unwieldy
unwilling: unwilling
unwise: unwise
unworthy: unworthy
unyoke: unyoke,unyokes
upborne: upborne
upbraid: upbraid,upbraiding,upbraids
update: updated
upheave: upheaved,upheaving
uphold: upheld,uphold
uplift: uplifted,uplifts
upper: upper
uprear: uprear
upright: upright
uprightness: uprightness
uprising: uprising
uproot: uproot,uprooted
uprose: uprose
upspring: upspringing
urge: urge,urged,urges,urging
urgent: urgent
uriel: uriel
urn: urn,urns
usage: usage
useless: useless
user: user
usual: usual
usurp: usurping
usurpation: usurpation
ut: ut
utility: utility
utmost: utmost
utter: utter
utterly: utterly
uttermost: uttermost
vagrant: vagrant,vagrants
vain: vain,vainest
vainly: vainly
vale: vale,vales
vales: vales
valiant: valiant
valley: valley,valleys
valour: valour
valuable: valuable
valve: valves
van: van
vanilla: vanilla
vanish: vanish
vanity: vanities,vanity
vanquish: vanquish,vanquished
vapour: vapour
vapours: vapours
variation: variation,variations
varied: varied
variety: variety
vary: varied,varies,vary,varying
vase: vase,vases
vassal: vassal,vassals
vast: vast,vaster
vault: vault,vaulted,vaults
vaunt: vaunt,vaunting,vaunts
vaunted: vaunted
vaunter: vaunter
vaunting: vaunting
vegetable: vegetable
vehement: vehement
veil: veil,veils
vein: vein,veins
venerable: venerable
venerably: venerably
venerate: venerates
veneration: veneration
venetian: venetian
vengeance: vengeance
vengeful: vengeful
venom: venom
vent: vent,vented,vents
venture: venture
venturous: venturous
venus: venus
ver: ver,vers
verbal: verbal
verdant: verdant
verdure: verdure
verge: verge
vermilion: vermilion
vernal: vernal
verse: verse,verses
versification: versification
version: version,versions
vessel: vessel,vessels
vessels: vessels
vest: vest,vests
vestal: vestals
vesture: vestures
vex: vex
vexation: vexation
vibrate: vibrates
vibration: vibrations
vice: vice,vices
vicious: vicious
vicissitude: vicissitudes
victim: victim,victims
victor: victor,victors
victorious: victorious
victoriously: victoriously
victory: victory
vie: vie,vied
view: view,viewed,viewing,views
viewing: viewing
vigilant: vigilant
vigorous: vigorous
vigour: vigour
vii: vii
viii: viii
vile: vile,vilest
village: village,villages
vindicate: vindicate,vindicates,vindicating
vindictive: vindictive
vine: vine,vines
vineyard: vineyard,vineyards
viny: viny
violate: violated,violates
violence: violence
violent: violent
violet: violet,violets
virgil: virgil
virgin: virgin,virgins
virtue: virtue,virtues
virtuous: virtuous
virulent: virulent
virus: virus
vis: vis
visage: visage
visible: visible
vision: vision
visionary: visionary
visit: visit,visited,visiting
visitor: visitors
visor: visor
vital: vital
vitals: vitals
vivid: vivid
vividness: vividness
vocal: vocal
voice: voice,voices
void: void
voluble: voluble
volume: volume,volumes
voluntary: voluntary
volunteer: volunteer,volunteers
voracious: voracious
vortex: vortex
votary: votaries
vote: vote,voted,votes
vouch: vouch
vouchsafe: vouchsafe,vouchsafed
vow: vow,vowed,vows
vowel: vowels
voyage: voyage
vulcan: vulcan
vulcanian: vulcanian
vulgar: vulgar
vulture: vulture,vultures
wade: wades
waft: waft,wafts
wage: wage,waged
waggon: waggon,waggons
wail: wail,wailing,wails
wain: wain
waist: waist
wait: wait,waited,waiting,waits
waive: waive
wake: wake,waked,wakes,waking
wakeful: wakeful
waken: waken,wakens
walk: walk,walking,walks
wall: wall,walls
walter: walter
wan: wan
wand: wand
wander: wander,wandering,wanders
wanderer: wanderer
wanderings: wanderings
wanton: wanton
war: war,warring,wars
warble: warbling
ward: ward,wards
wardrobe: wardrobe,wardrobes
warfare: warfare
warily: warily
warlike: warlike
warm: warm,warmer,warms
warmth: warmth
warn: warn,warns
warning: warning
warrant: warranting
warranted: warranted
warranty: warranties,warranty
warrior: warrior,warriors
wary: wary
wash: wash,washed
wasp: wasps
waste: waste,wasted,wastes,wasting
wasteful: wasteful
watch: watch,watched
watchful: watchful
watching: watchings
water: water,waters
watery: watery
wave: wave,waved,waves,waving
waver: wavering
waxen: waxen
wayfaring: wayfaring
weak: weak,weaker,weakest
weaken: weakened
weakness: weakness
weal: weal
wealth: wealth
wealthy: wealthy
weapon: weapon,weapons
wear: wear,wears,wore,worn
wearied: wearied
weary: wearied,wearies,weary
weave: weaved,wove
wedge: wedged,wedges
weed: weeds
week: weeks
weep: weep,weeping,weeps,wept
weeping: weeping
weigh: weigh,weighed,weighs
weight: weight,weights
weighty: weighty
welfare: welfare
wert: wert
west: west
western: western
whale: whales
whatsoever: whatsoever
wheat: wheat
wheel: wheel,wheeling,wheels
whelm: whelm,whelming,whelms
whelp: whelps
whensoever: whensoever
wherefore: wherefore
whet: whet
whip: whip
whirl: whirl,whirling,whirls
whirling: whirling
whirlwind: whirlwind,whirlwinds
whisper: whisper,whispered,whispering,whispers
whistle: whistling
white: white
whiten: whiten,whitening,whitens
whiteness: whiteness
whiz: whizzing
whizz: whizz,whizzes
wholesale: wholesale
wholesome: wholesome
wholly: wholly
wide: wide,wider,widest
widespread: widespread
widow: widow
wield: wield,wielded,wields
wife: wife,wives
wild: wild,wilds
wildly: wildly
wildness: wildness
wiles: wiles
wilful: wilful
willed: willed
willingness: willingness
willow: willows
wilt: wilt
win: win,winning,wins
wind: wind,winding,winds,wound
winding: windings
windpipe: windpipe
winds: winds
wine: wine,wines
wing: wing,winged,wings
winged: winged
winning: winning
winnow: winnow,winnows
winter: winter,winters
wintry: wintry
wipe: wipe,wiped
wire: wire
wisdom: wisdom
wise: wise,wiser,wisest
wisely: wisely
wit: wit
withdraw: withdraw,withdrawing,withdrawn,withdraws,withdrew
wither: wither,withering,withers
withhold: withheld,withhold,withholds
withstand: withstand,withstands,withstood
witness: witness,witnessed,witnesses
witty: witty
woe: woe,woes
wolf: wolf,wolves
wolfian: wolfian
woman: woman,women
womankind: womankind
womb: womb,wombs
wonderful: wonderful
wonderfully: wonderfully
wondrous: wondrous
wonted: wonted
woo: woo
wood: wood,woods
wooden: wooden
woodland: woodland
woodman: woodman
woodmen: woodmen
wool: wool
woollen: woollen
woolly: woolly
word: word
wordy: wordy
workman: workman,workmen
workmanship: workmanship
worm: worm,worms
worn: worn
worship: worship,worshipped
worth: worth
worthless: worthless
worthlessness: worthlessness
worthy: worthy
wouldst: wouldst
wound: wound,wounded,wounds
wounded: wounded
wounding: wounding
wounds: wounds
wrack: wrack
wrangle: wrangling
wrap: wrap,wrapped,wraps
wrapt: wrapt
wrath: wrath
wrathful: wrathful
wreak: wreak
wreath: wreath,wreaths
wrench: wrench
wrest: wrest
wrestle: wrestle
wrestler: wrestlers
wrestling: wrestling
wretch: wretch,wretches
wretched: wretched
wretchedness: wretchedness
wring: wrings
wrinkle: wrinkled
wrist: wrist,wrists
writ: writ
write: write,writes,writing,written,wrote
writer: writer,writers
writhe: writhes
writing: writing
writings: writings
wrong: wrong,wronged,wrongs
xi: xi
xii: xii
xiii: xiii
xiv: xiv
xix: xix
xvi: xvi
xvii: xvii
xviii: xviii
xx: xx
xxi: xxi
xxii: xxii
xxiii: xxiii
xxiv: xxiv
xxx: xxx
yard: yards
yawning: yawning
yearly: yearly
yearn: yearn
yellow: yellow,yellower
yew: yew
yield: yield,yielded,yielding,yields
yoke: yoke,yoked,yokes
yoked: yoked
yon: yon
yond: yonder
yonder: yonder
yore: yore
youth: youth,youths
youthful: youthful
zeal: zeal
zenith: zenith
zephyr: zephyr
zeus: zeus
zone: zone,zones
