ab: ab
abbreviation: abbreviation
abide: abide
ability: ability
abit: abit
aboard: aboard
abode: abode
abominably: abominably
abomination: abominations
abrupt: abrupt
abruptly: abruptly
absent: absent
absolutely: absolutely
absolution: absolution
absorb: absorbed
absurd: absurd
abundance: abundance
accede: acceded
accent: accents
accept: accept,accepted,accepting
access: access,accessed
accessible: accessible
accident: accident,accidents
accidental: accidental
accidentally: accidentally
accompaniment: accompaniment
accompany: accompanied,accompanies,accompany,accompanying
accomplished: accomplished
accomplishment: accomplishment
accost: accosted
account: account,accounts
accounting: accounting
accurately: accurately
accursed: accursed
accusation: accusation
accusative: accusatives
accustomed: accustomed
ach: ach
ache: ache
acknowledge: acknowledge,acknowledged
acquaint: acquainted
acquaintance: acquaintance
acquiesce: acquiesce
acquire: acquired
acquirement: acquirements
acquit: acquit
acre: acre,acres
action: action
active: active
activity: activity
actor: actor,actors
actual: actual
adage: adage
adam: adam
adaption: adaption
add: add,adding,adds
addict: addicted
addition: addition,additions
additional: additional
address: address,addressed,addresses,addressing
addy: addy
adieu: adieu
adjoining: adjoining
adjourn: adjourned
administer: administered
admirable: admirable
admiration: admiration
admire: admired
admired: admired
admirer: admirer
admission: admission
admit: admit,admitted
ado: ado
adonis: adonis
adore: adore
adored: adored
adrift: adrift
adroitly: adroitly
advance: advanced
advanced: advanced
advantage: advantage,advantages
adventure: adventure,adventures
adventurous: adventurous
adversary: adversary
adverse: adverse
adversity: adversity
advertisement: advertisement
advice: advice
advise: advise,advised
afear: afeared
afeard: afeard
afeared: afeared
aff: aff
affair: affair,affairs
affect: affect
affectation: affectation
affection: affection,affections
affectionate: affectionate
affirmation: affirmation
affluence: affluence
afford: afford,afforded
affrighted: affrighted
affront: affronted
afore: afore
aforesaid: aforesaid
afraid: afraid
africa: africa
afternoon: afternoon
afterward: afterward
age: age,ages
aged: aged
agency: agencies,agency
agent: agent
ager: agers
aggravate: aggravate
aggravation: aggravation
aghast: aghast
agin: agin
agon: agon
agree: agree,agreed
agreeable: agreeable
agreeably: agreeably
agreement: agreement
ahab: ahab
ahem: ahem
ail: ailed
aim: aimed
air: air
airn: airn
airth: airth
ak: ak
alarm: alarm,alarmed,alarms
albeit: albeit
alderman: alderman
ale: ale
algebra: algebra
alight: alight
alive: alive
allowance: allowance
allude: allude,alluded
allusion: allusion
aloft: aloft
aloud: aloud
alphabet: alphabet
altar: altar
alter: alter
alteration: alteration
altercation: altercation
alternate: alternate
alternative: alternative
altogether: altogether
amain: amain
amazed: amazed
amazement: amazement
amber: amber
ambition: ambition
amend: amends
america: america
american: american,americans
amiable: amiable
amin: amin
amiss: amiss
ample: ample
amply: amply
amuse: amuse,amused
amusement: amusement,amusements
amusing: amusing
anathema: anathema
anathematically: anathematically
ancient: ancient
angel: angel,angels
anger: anger
anglicanum: anglicanum
angrily: angrily
angry: angry
anguish: anguish
animal: animal
animate: animated
animated: animated
anna: anna
anne: anne
anniversary: anniversary
announcement: announcement
annoy: annoy
annoyance: annoyance
annual: annual
anon: anon
answer: answer,answered,answering,answers
antagonist: antagonist
anthony: anthony
antipathy: antipathy
antique: antique
antiquity: antiquity
anxiety: anxiety
anxious: anxious
ap: ap
apartment: apartment
aphorism: aphorisms
apiece: apiece
apology: apology
apostle: apostle,apostles
apostolical: apostolical
apostrophize: apostrophize,apostrophizing
apothecary: apothecary
apotheosis: apotheosis
apparel: apparel
appeal: appeal
appearance: appearance
append: appended
appendage: appendage
applaud: applauded
applause: applause
apple: apple,apples
applicable: applicable
apply: applied,apply,applying
appoint: appoint,appointed
appointment: appointments
apprehension: apprehension
apprize: apprize
approach: approach,approached,approaching
approve: approving
apron: apron,aprons
apropos: apropos
apt: apt
aqua: aqua
arabian: arabian
arbitrary: arbitrary
arch: arch
archive: archive
archly: archly
ardently: ardently
argue: argue,argued
argument: argument,arguments
aria: aria,arias
arm: arm,arms
armed: armed
armenian: armenian
armful: armfuls
armor: armor
arouse: aroused
arrah: arrah
arrand: arrand
arrange: arranged
arrangement: arrangement
array: array
arrest: arrest
arrival: arrival
arrive: arrived,arriving
arrow: arrow
art: art,arts
article: article,articles
artless: artless
ascend: ascend,ascended,ascending
ascent: ascent
ascertain: ascertain,ascertained
ascii: ascii
ash: ash
ashamed: ashamed
ashore: ashore
asleep: asleep
aspiration: aspirations
assail: assail
assassin: assassins
assault: assaults
assemble: assemble
assembly: assemblies
assiduity: assiduity
assiduous: assiduous
assign: assigned
assistance: assistance
assizes: assizes
assortment: assortment
assume: assume,assumed
assurance: assurance,assurances
assure: assure,assured,assures
ast: ast
astern: astern
astonish: astonish,astonished
astonished: astonished
astonishment: astonishment
ate: ating
athwart: athwart
atlantic: atlantic
atom: atom
atrocious: atrocious
attach: attached
attachment: attachment
attempt: attempt,attempted,attempting
attend: attend,attended
attendance: attendance
attendant: attendant
attention: attention,attentions
attic: attic
attract: attracted
attraction: attraction,attractions
attribute: attributed,attributing
audacious: audacious
audible: audible
augh: augh
augur: auguring
august: august
auspicious: auspicious
austin: austin
author: author
authority: authority
authorize: authorizes
autumn: autumn
av: av
avail: avail
average: average
avidity: avidity
avoid: avoid
await: await
awake: awake,awoke
awaken: awaken
aware: aware
awee: awee
awful: awful
awkwardness: awkwardness
ax: ax,axed,axing
axin: axin
axing: axing
axiom: axioms
ay: ay
aye: aye
babylon: babylon
bacchus: bacchus
bachelor: bachelor,bachelors
bacon: bacon
bad: bad,worse,worst
badge: badge
badinage: badinage
badly: badly
bag: bag
bagdad: bagdad
bail: bail
bailiff: bailiff
baker: baker
balance: balance
balancing: balancing
balderdash: balderdash
bale: bales
ball: ball,balls
ballad: ballad
band: band,bands
bandy: bandy
bang: bang,banged,bangs
banish: banished
bank: bank,banks
banner: banners
banquet: banqueted
banter: banter
baptism: baptism
bar: bar,barring
barbarity: barbarity
bare: bare,barest
barefaced: barefaced
barely: barely
bargain: bargain
barge: barge
bark: bark,barking
barn: barn,barns
barny: barny
barometer: barometer
baronet: baronet
barony: barony
barracks: barracks
barrel: barrel
base: based
basin: basin
bask: basked
basket: basket,baskets
baste: baste,bastes
bate: bate,bates
bath: bath
bathe: bathe
bay: bay
beadle: beadle
bean: bean
bear: bear,bearing,bore,born
beard: beard
beast: beasts
beat: beat
beautiful: beautiful
beautifully: beautifully
beauty: beauties,beauty
bed: bed,beds
bedad: bedad
bedpost: bedpost
bedroom: bedroom
bee: bee
beef: beef
beefsteak: beefsteak
beer: beer
befall: befell
beg: beg,begged,begging
begad: begad
beggar: beggar
begorra: begorra
behalf: behalf
behold: beheld,behold
beholder: beholders
bein: bein
belabor: belabored
belief: belief
bell: bell,bells
bellyful: bellyful
belong: belonged,belonging,belongs
beloved: beloved
ben: ben
bench: bench
bend: bent
beneath: beneath
beneficial: beneficial
benefit: benefit
benevolence: benevolence
benevolent: benevolent
bengal: bengal
bent: bent
bereaved: bereaved
beseech: besought
besom: besom
besought: besought
bespeak: bespeak,bespoke
bespoke: bespoke
bestow: bestowed,bestowing
bet: bet
bethought: bethought
betoken: betoken
betray: betray
betty: betty
betwixt: betwixt
beware: beware
bewilder: bewildered
bewitch: bewitched
beys: beys
bias: bias
bible: bible,bibles
bid: bade,bid,bidding,bids
bilin: bilin
billet: billet
billiard: billiard
billing: billing
billow: billows
billy: billy
binary: binary
bind: bound
biped: bipeds
bird: bird,birds
biscuit: biscuits
bishop: bishop,bishops
bit: bit,bits
bite: bite,bites
bitter: bitter
bitterness: bitterness
bl: bl
black: black,blacks
blackbeard: blackbeard
blackguard: blackguards
blame: blame
blank: blank
blanket: blanket
blast: blast
bleed: bled,bleeding
bleeding: bleeding
bless: bless,blessed
blessed: blessed
blessing: blessing
blest: blest
blind: blind,blinding
blindly: blindly
blither: blither
bloated: bloated
blockhead: blockhead
blood: blood
bloodthirstiness: bloodthirstiness
bloody: bloody
blossom: blossom
blow: blew,blow,blowing,blows
blubber: blubbering
blue: blue
bluebeard: bluebeard
blunder: blunders
blur: blur
blush: blush,blushed,blushing
board: board
boarding: boarding
boast: boast,boasting
boat: boat,boats
boatman: boatman,boatmen
boddagh: boddagh
body: bodies,body
boil: boil,boiling
bold: bold,bolder
boldly: boldly
bolt: bolted
bombazine: bombazine
bona: bona
bondage: bondage
bone: bone,bones
boo: boo
book: book,books
boot: boot,boots
border: borders
bore: bore
bosom: bosom,bosoms
boss: boss
boston: boston
bottle: bottle,bottles
bough: bough
bounce: bounce
bound: bound,bounding,bounds
bow: bow,bowed,bows
bowl: bowl
box: box
boy: boy,boys
brache: brache
brag: brag,bragged
brain: brain,brains
brake: brake
branch: branch,branches
brandy: brandied,brandy
brass: brass
brassy: brassy
brat: brat,brats
brave: brave,bravest
brawny: brawny
breach: breach
bread: bread
break: break,breaks,broke,broken
breakfast: breakfast
breaking: breaking
breath: breath
breathless: breathless
breeches: breeches
breed: bred,breed
breeze: breeze,breezes
brew: brewing
brewing: brewing
brian: brian
bribe: bribe,bribed
brick: brick
bride: bride
bridegroom: bridegroom
bridge: bridge
bridle: bridle
brig: brig
bright: bright
brighten: brightened
brightness: brightness
bring: bring,bringing,brings,brought
briskly: briskly
broad: broad
broadside: broadside
brogue: brogue
broil: broiled
broken: broken
brother: brother,brothers
brow: brow,brows
brown: brown
bruise: bruised
brush: brush
brute: brute
bryan: bryan
buck: buck
bud: bud
build: build
building: building
bulk: bulk
bull: bull
bullock: bullocks
bully: bully
bum: bum
bumper: bumper
bunch: bunch
burden: burden
burn: burnt
burst: burst,bursting,bursts
bury: buried
bush: bushes
bushy: bushy
busily: busily
business: business
bust: bust
bustle: bustle
busy: busy
butler: butler
butter: butter
button: button,buttoned,buttons
buzz: buzzing
bystander: bystanders
cackle: cackling
cake: cakes
calamity: calamity
calculate: calculate,calculated
calf: calves
caliph: caliph
calm: calm
calmly: calmly
calumny: calumnies,calumny
cambridge: cambridge
campaign: campaign
campaigner: campaigner
candle: candle
candlemas: candlemas
cane: cane
canna: canna
cannon: cannon,cannons
cannonade: cannonade
canter: cantering
canvas: canvas
canvass: canvassed
cap: cap,caps
capability: capabilities
capable: capable
capacity: capacity
cape: cape
caper: caper,capering
capital: capital
captain: captain,captains
car: car
caravansary: caravansary
card: card,cards
cardinal: cardinal,cardinals
care: care,cared,caring
careful: careful
carefully: carefully
careless: careless
cargo: cargo
carlisle: carlisle
carlo: carlo
carouse: carouse
carpet: carpet
carriage: carriage
carry: carried,carry,carrying
cart: cart,carts
cask: cask
cast: cast,casting
castigation: castigation
cat: cat,cats
catch: catch,caught
catholic: catholic
cattle: cattle
caubeen: caubeen
cautiously: cautiously
cavalry: cavalry
cease: cease
celebrate: celebrated
celebrated: celebrated
celery: celery
celestial: celestial
cellar: cellar
centre: centring
centrifugal: centrifugal
ceremony: ceremonies
certainty: certainty
cess: cess
chain: chain
chair: chair
chairman: chairman
challenge: challenge
chamber: chamber,chambers
champagne: champagne
champion: champion
champions: champions
chance: chance,chanced,chances
chancery: chancery
chandler: chandler
change: change,changed
channel: channel,channels
chant: chant
chanticleer: chanticleer
chaos: chaos
chaotic: chaotic
chap: chap,chaps
chapel: chapel,chapels
character: character,characters
characteristically: characteristically
charcoal: charcoal
charge: charge,charged,charges
charitable: charitable
charitably: charitably
charity: charities,charity
charles: charles
charley: charley
charm: charmed
charming: charming
charon: charon
chart: chart
chase: chase
chat: chat
chatty: chatty
che: che
cheap: cheap,cheaper
cheapen: cheapened
check: check,checks
cheek: cheeks
cheer: cheer,cheers
cheerful: cheerful
cherry: cherry
chest: chest
chesterfield: chesterfield
chew: chew
chibouque: chibouque
chicken: chickened,chickens
chief: chief
child: child,children
childre: childre
chimney: chimney,chimneys
chin: chin
china: china
choice: choice
choke: choke,choked
choose: choose,chose
chop: chop
chorus: choruses
christen: christened
christendom: christendom
christian: christian,christians
chronicle: chronicle
chronology: chronology
chuckle: chuckled,chuckling
church: church
churchyard: churchyard
ciceronian: ciceronian
cigar: cigar,cigars
cinder: cinder
circle: circle
circuitous: circuitous
circulate: circulated
circumbendibus: circumbendibus
circumstance: circumstances
city: cities,city
civil: civil
civilization: civilization
clack: clack
claim: claim,claims
clap: clap,clapped
clapping: clapping
claptrap: claptrap
clarendon: clarendon
claret: claret
clasp: clasping
class: class,classing
classic: classic,classics
classical: classical
claudius: claudius
cleave: cleaving
cleft: cleft
clergyman: clergyman,clergymen
clerk: clerk,clerks
clever: clever,cleverer,cleverest
cleverly: cleverly
clew: clew
client: client
climate: climate
climb: climb
cloak: cloaks
clock: clock
close: close,closed,closer
closed: closed
closely: closely
closet: closet
cloth: cloth,cloths
clothe: clad
clothes: clothes
cloud: cloud,clouds
clover: clover
coach: coach
coachman: coachman
coal: coal,coals
coat: coat,coats
cobwebs: cobwebs
cock: cock
cocked: cocked
cockle: cockle,cockles
coction: coction
code: codes
coefficient: coefficient
coffee: coffee
coffin: coffin,coffins
cognizance: cognizance
coin: coin,coined
coincide: coincided
cold: cold
coldly: coldly
collar: collar
collection: collection
colleen: colleen
college: college
colloquy: colloquy
colonel: colonel
color: color,colors
colored: colored
combat: combat
combination: combination
combine: combine
comedy: comedy
comer: comer,comers
comfort: comfort
comfortable: comfortable
comfortably: comfortably
comical: comical
command: command,commands
commander: commander
commemorate: commemorating
commence: commence,commenced
comment: comment
commercial: commercial
commiseration: commiseration
commit: commit,committed,committing
committee: committee,committees
commodity: commodity
common: common
commoner: commoner
commonly: commonly
commonplace: commonplace
communicate: communicated
community: community
companion: companion,companions
companionship: companionship
company: company
compare: compare,compared,compares
comparison: comparison
compartment: compartment
compass: compass,compasses
compassion: compassion
compel: compelled
compensation: compensation
compilation: compilation
complain: complained
complaint: complaint
complaisance: complaisance
complete: complete
completely: completely
complexion: complexion
compliance: compliance
compliment: compliment,complimented,compliments
complimentary: complimentary
comply: complied,comply,complying
compose: composed
composition: composition
composure: composure
compound: compound
comprehend: comprehend
comprehension: comprehension
compress: compressed
comprise: comprises
comrade: comrade,comrades
concede: conceding
conceivable: conceivable
conceive: conceive
concept: concept
concern: concerns
concerned: concerned
concert: concert
concerto: concerto,concertos
conclude: concluded
conclusion: conclusion
concurrence: concurrence
concussion: concussion
condescend: condescend,condescended
condition: condition
condolence: condolence
conduct: conduct
confer: conferred
confess: confess
confessor: confessor
confidence: confidence
confident: confident
confidentially: confidentially
confidently: confidently
confine: confine,confined
confinement: confinement
confirm: confirmed
confirmation: confirmation
confound: confound,confounded
confuse: confused
confused: confused
confusion: confusion
congratulation: congratulation
congregate: congregated
conjecture: conjecture,conjectured,conjectures
conjurer: conjurer
connaught: connaught
connect: connected
conquer: conquering
conscience: conscience,consciences
conscious: conscious
consciousness: consciousness
consent: consent,consented
consequence: consequence
consequential: consequential
considerable: considerable
considerably: considerably
consideration: consideration
consist: consisted
consolation: consolation
console: consoled
constable: constable
constancy: constancy
constant: constant
constantly: constantly
consternation: consternation
constitution: constitution
constrain: constrained
consult: consult,consulted,consulting
consume: consume,consumed
consumption: consumption
contact: contact
contemplate: contemplating
contemporary: contemporaries
contempt: contempt
contemptuously: contemptuously
content: content
contented: contented
contents: contents
continue: continue,continued,continues
continued: continued
continuity: continuity
contract: contract
contradict: contradict
contrary: contrary
contrast: contrast
contribute: contribute,contributed,contributing
contribution: contribution,contributions
contrived: contrived
contusion: contusions
convenience: convenience
conversant: conversant
conversation: conversation
converse: conversing
convert: convert,converted
convey: convey,conveyed
convince: convince
convincing: convincing
convulsive: convulsive
cooing: cooing
cook: cooked
cool: cooled
copious: copious
copying: copying
copyright: copyright
coram: coram
cordial: cordial
cordially: cordially
corinna: corinna
cork: cork,corks
corn: corn
corner: corner
cornet: cornets
cornish: cornish
corporal: corporal
corporation: corporation
correct: correct
correctly: correctly
corroborate: corroborated
corrupt: corrupt
cortical: cortical
cosily: cosily
cost: cost,costs
costume: costume
cotch: cotch
cottage: cottage
cough: cough
counsel: counsel
counsellor: counsellors
countenance: countenance
countrie: countrie
country: countries,country
countryman: countrymen
county: county
couple: couple
courage: courage
court: court
courteously: courteously
courtship: courtship
cousin: cousin
cove: cove
cover: cover,covered
cow: cow,cows
cowk: cowk
crab: crabs
crack: crack,cracked
craft: craft
cramp: cramped
crap: crap,craps
crape: crape
crash: crashing
crass: crass
crave: crave
crawl: crawled
craythur: craythur
crazed: crazed
cream: cream
create: created,creating
creation: creation
creator: creator
creature: creature,creatures
credit: credit
creed: creed
creek: creek
creep: creeping
crescent: crescent
crest: crest
crestfallen: crestfallen
crew: crew
crier: crier
crime: crime
crimped: crimped
critic: critic
critical: critical
crockery: crockery
crooked: crooked
crop: crops
cross: cross,crossed,crossing
crouse: crouse
crow: crow,crows
crowd: crowd,crowded
crown: crown
crud: cruds
cruel: cruel
cruise: cruise
crust: crust
crystal: crystal
cube: cube
cuckoo: cuckoo
cud: cud
cuff: cuff,cuffs
culpa: culpa
culprit: culprit
cultivate: cultivate
cum: cum
cunning: cunning
cup: cups
cupboard: cupboard
cupid: cupid
curat: curat
cure: cure,cured,curing
curiosity: curiosities,curiosity
curious: curious
curl: curl,curling
currant: currant
current: current
curse: curse,curses,cursing
cursed: cursed
cursedly: cursedly
cursing: cursing
curtain: curtains
custom: custom
cut: cut,cuts,cutting
cute: cute
cutlery: cutlery
cutting: cutting
cyathi: cyathi
cyathus: cyathus
dabble: dabbled
dad: dad
dagger: daggers
daily: daily
dale: dale
dally: dally
damage: damage,damaged
damaged: damaged
damages: damages
damp: damp
damper: damper
damsel: damsel
dance: dance,danced,dancing
dancing: dancing
dandy: dandy
danger: danger,dangers
dangling: dangling
dappled: dappled
dar: dar
daresay: daresay
dark: dark
darken: darken,darkened
darling: darling,darlings
dart: darted
dash: dash,dashed,dashing
datum: data
daughter: daughter
daunt: daunted
davy: davy
daw: daw
dawn: dawn,dawned
day: day,days
daybreak: daybreak
daylight: daylight
dazzling: dazzling
dead: dead
deaf: deaf
deal: deal,dealing
dealer: dealers
dearest: dearest
death: death
debate: debate,debating
decay: decayed
deceased: deceased
deceit: deceit
december: december
decide: decide,decided
decidedly: decidedly
deck: deck
declare: declare,declared,declaring
decline: declined
decoction: decoction
decoy: decoyed
decree: decrees
deductible: deductible
deduction: deduction
deed: deed
deem: deemed
deep: deep,deeper,deepest
deepen: deepen
deeply: deeply
deer: deer
default: default
defeat: defeat
defect: defect,defects
defective: defective
defend: defended
defendant: defendant
defender: defender
defy: defy
degree: degree,degrees
dei: dei
deign: deigned
delay: delay,delayed,delaying,delays
deletion: deletions
deliberately: deliberately
delicate: delicate
delicious: delicious
delight: delight,delights
delighted: delighted
delightful: delightful
delightfully: delightfully
delinquent: delinquent
deliver: deliver,delivered
deliverance: deliverance
delude: delude
deludher: deludher
demand: demand,demanded
demi: demi
demolish: demolished
demure: demure
demurer: demurer
den: dens
denomination: denominations
denounce: denouncing
dentist: dentist,dentists
deny: denied,deny,denying
depart: departed
departure: departure
depend: depend,depended,depending,depends
dependence: dependence
deposit: deposited
deprive: deprive,deprived
der: der
derbyshire: derbyshire
derision: derision
derivative: derivative
derive: derive,derived
descend: descend,descended,descending
descent: descent
description: description
desert: desert,deserted
deserter: deserter
deserve: deserved
designate: designated
desire: desire,desired,desires
desirous: desirous
desk: desk
desolation: desolation
despair: despair
despatch: despatched
desperate: desperate
desperately: desperately
destroy: destroy
destruction: destruction
detach: detach
determination: determination
determine: determine,determined
determined: determined
deuce: deuce
deucedly: deucedly
devant: devant
devil: devil,devils
devilish: devilish
devise: devise
devote: devoted
devoted: devoted
devotion: devotion
devoutly: devoutly
dew: dew
dexterity: dexterity
dexterously: dexterously
diabolus: diabolus
diagram: diagram
dialogue: dialogue
diametrically: diametrically
diamond: diamonds
dickens: dickens
didst: didst
die: die,died,dying
difference: difference,differences
difficult: difficult
difficulty: difficulty
diffuse: diffuse
dig: dig,dug
dignity: dignity
digress: digressing
dilapidation: dilapidation
dilate: dilate
dilemma: dilemma
dilly: dilly
dimension: dimensions
dimple: dimple
din: din
dine: dine,dined
dingy: dingy
dining: dining
dinner: dinner,dinners
dip: dipped
direct: direct
direction: direction,directions
director: director
dirge: dirges
dirty: dirty
disagree: disagreed
disagreeable: disagreeable
disappear: disappeared
disappointed: disappointed
disappointment: disappointment
disbeliever: disbelievers
disbursement: disbursement
discernment: discernment
disclaim: disclaim
disclaimer: disclaimer,disclaimers
discomfited: discomfited
discontent: discontent
discontented: discontented
discontinue: discontinue
discourse: discourse
discover: discover,discovered
discovery: discovery
discuss: discuss,discussing
disgrace: disgrace
disgust: disgust
dish: dishes
dishevelled: dishevelled
disinclination: disinclination
disk: disk
dislocate: dislocated
dismal: dismal
disorderly: disorderly
disown: disowned
display: display,displayed,displaying
disposal: disposal
dispose: dispose
disputation: disputation,disputations
dispute: dispute,disputed
dissolute: dissolute
distance: distance
distant: distant
distilled: distilled
distilment: distilment
distinct: distinct
distinctiveness: distinctiveness
distinctly: distinctly
distinguish: distinguish,distinguished
distinguished: distinguished
distracted: distracted
distracting: distracting
distraction: distraction
distrait: distrait
distress: distress
distribute: distribute,distributed,distributing
distribution: distribution
distributor: distributor
district: district
disturb: disturb,disturbed
disturbance: disturbance
ditch: ditch
ditto: ditto
div: div
diversion: diversion
divert: divert,diverted
dives: dives
divide: dividing
divine: divine,divined
divinity: divinity
divulge: divulge
dizzy: dizzy
doctor: doctor,doctors
doctrine: doctrines
dodge: dodging
dog: dog,dogs
dogged: dogged
dogmatical: dogmatical
doings: doings
dolly: dolly
domain: domain
dome: dome
domestic: domestic,domestics
domine: domine
domineering: domineering
donate: donate
donation: donation,donations
donec: donec
donkey: donkey
donor: donors
door: door,doors
doorway: doorways
dose: dose
dost: dost
doth: doth
double: double,doubling
doubt: doubt
doubtless: doubtless
download: downloading
downright: downright
downward: downward
dozen: dozen
drab: drab
drag: drag,dragged
draggle: draggled
dragon: dragon
dragoon: dragoon,dragoons
drain: drains
draper: draper
draught: draught
draw: draw,drawing,drawn,drew
drawback: drawback
drawer: drawer
drawing: drawing
dread: dreaded
dreadful: dreadful
dreadfully: dreadfully
dream: dreamed,dreams
dreary: dreary
dredge: dredges
drench: drench,drenched
dress: dress,dressed
dribble: dribbling
drift: drift,drifting
drink: drank,drink,drinks
drinking: drinking
drive: drive,driven,drove
driver: driver
drizzle: drizzle
drop: drop,dropped,drops
drown: drown,drowned,drowning
drowned: drowned
drowsy: drowsy
dry: dry,drying
dublin: dublin
duchess: duchess
duck: duck,ducking,ducks
duel: duel
duet: duet
dull: dull
dumb: dumb
dunce: dunce
dung: dung
dust: dust,dusted
dutch: dutch
dutifully: dutifully
duty: duty
dwarf: dwarf
dwell: dwell
dwelling: dwelling
dwindle: dwindled
dyer: dyer
dyestuff: dyestuffs
eager: eager
ear: ear,ears
earnest: earnest
earth: earth
earthly: earthly
ease: ease
easily: easily
east: east
easter: easter
easy: easy
eat: ate,eat,eaten,eating
eatable: eatable
eating: eating
ebb: ebbed
echo: echoed
economy: economy
eddy: eddies
edge: edge
edgeway: edgeways
edifying: edifying
edit: edited
edition: edition,editions
editor: editor
educational: educational
effort: effort,efforts
egg: eggs
ego: ego
eighth: eighth
ejaculate: ejaculated
eject: eject
elastic: elastic
elbow: elbow,elbows
elder: elder,elders
elect: elect
election: election
electronic: electronic
electronically: electronically
elevation: elevation
elicit: elicited
eliza: eliza
eloquence: eloquence
eloquent: eloquent
emaciated: emaciated
email: email
embalm: embalmed
embark: embark,embarked
embody: embodied
embolden: emboldened,emboldens
embrace: embrace
eminent: eminent
emotion: emotions
emphatically: emphatically
employ: employ,employed
employee: employee,employees
employment: employment
en: en
enable: enabled
enact: enacted
enclose: enclosed
encode: encoding
encounter: encounter,encountered
encourage: encouraged,encourages
encouraging: encouraging
endanger: endangered
endeavor: endeavor,endeavored,endeavoring
engage: engage,engaged
engagement: engagement
engaging: engaging
engender: engendered
engine: engine
england: england
english: english
engraven: engraven
enhance: enhancing
enjoin: enjoin
enjoy: enjoy,enjoyed,enjoying
enjoyment: enjoyment
enormous: enormous
enormously: enormously
enrage: enraged
enraged: enraged
ensconce: ensconced
ensign: ensign
ensue: ensuing
ensure: ensuring
entangle: entangled
enter: enter,entered,entering
entertain: entertain,entertained
entertainment: entertainment,entertainments
entire: entire
entitle: entitled
entity: entity
entre: entre
entreat: entreated
entreaty: entreaties
entry: entry
envelop: enveloped
envious: envious
envy: envy
epistolical: epistolical
epitaph: epitaph,epitaphs
epithet: epithet
equal: equal,equalled
equally: equally
equation: equation
equipment: equipment
equity: equity
equivalent: equivalent
erase: erase
erat: erat
ere: ere
erect: erect,erected
ergo: ergo
error: errors
escape: escape,escaped,escapes
essential: essential
est: est
establish: established
esteem: esteem
etiam: etiam
etymology: etymology
euphemia: euphemia
euripides: euripides
evade: evaded
eve: eve
evening: evening
event: event,events
everlasting: everlasting
evidence: evidence
evident: evident
evidently: evidently
evil: evil
evince: evince
exact: exact
exalt: exalted
examination: examination
examine: examining
exasperation: exasperation
exceed: exceeding
exceedingly: exceedingly
excellent: excellent
exception: exceptions
excessive: excessive
exchange: exchange,exchanged
excite: excited
excited: excited
exclaim: exclaimed,exclaiming,exclaims
exclamation: exclamation,exclamations
exclusion: exclusion
excursion: excursion
excuse: excuse
execration: execration
execute: execute,executed
execution: execution
executive: executive
exempt: exempt
exemption: exemption
exhibit: exhibit,exhibited,exhibiting
exhilarate: exhilarating
exhort: exhorting
exist: exist,exists
expanse: expanse
expect: expect,expected,expecting,expects
expectation: expectations
expedient: expedient
expedition: expedition
expend: expend
expense: expense,expenses
expensive: expensive
experience: experience,experienced
experienced: experienced
experiment: experiments
expire: expired
explain: explain,explained,explaining
explanation: explanation
explicitly: explicitly
exploit: exploit
explosion: explosion
exponent: exponent
export: export,exporting
expose: exposed
express: express,expressed,expresses
expression: expression
expressive: expressive
extensive: extensive
extensively: extensively
extent: extent
external: external
externally: externally
extinct: extinct
extort: extorted
extract: extracted
extraordinary: extraordinary
extravagant: extravagant
extravaganza: extravaganza
extremely: extremely
eye: eye,eyes
eyebrow: eyebrows
eyed: eyed
eyelash: eyelashes
eyelid: eyelids
eyesight: eyesight
facer: facer
facetious: facetious
facility: facility
faction: faction
factitious: factitious
faggot: faggot
fagot: fagots
fail: fail,failed
fain: fain
faint: fainted
fainting: fainting
faintness: faintness
fair: fair,fairer
fairbanks: fairbanks
fairest: fairest
faith: faith
faithful: faithful
faithfully: faithfully
fall: fall,fallen,falls,fell
fallow: fallows
falsehood: falsehood
falsity: falsities
fame: fame
family: families,family
fancy: fancy
fangled: fangled
farewell: farewell
farm: farm
farmer: farmer,farmers
farming: farming
fashion: fashion
fashioned: fashioned
fast: fast,fasting,fasts
fat: fat
fatal: fatal
fate: fate
father: father,fathers
fathom: fathom
fatigue: fatigue
fatima: fatima
fault: fault
favor: favor
favorite: favorite
fear: fear,feared,fears
fearfully: fearfully
feast: feast,feasted
feather: feathers
feature: features
federal: federal
fee: fee,fees
feed: feeding
feel: feel,feeling
feeling: feeling,feelings
feigned: feigned
feint: feint
fellow: fellow,fellows
female: female
ferguson: ferguson
ferocious: ferocious
ferret: ferret,ferreted
ferry: ferry
fertile: fertile
fervent: fervent
fester: festered
festive: festive
fetch: fetch,fetching
fever: fever
fibre: fibre
fickle: fickle
fictitious: fictitious
fide: fide
fidelity: fidelity
fie: fie
field: field,fields
fielding: fielding
fierce: fierce
fiercely: fiercely
fieri: fieri
fig: fig
fight: fight
figuratively: figuratively
figure: figure,figures
file: file,files
fillet: fillets
filthy: filthy
finally: finally
financial: financial
fine: fine,finer,finest
fingal: fingal
finger: finger,fingers
finish: finish,finished,finishing
fireplace: fireplace
firmness: firmness
fish: fish,fishes
fisherman: fisherman,fishermen
fishing: fishing
fist: fist
fit: fit,fits,fitted
fitness: fitness
fitting: fitting
flabby: flabby
flaking: flaking
flash: flashed,flashing
flat: flat,flatter
flatter: flattered
flavor: flavor
flaw: flaw
flea: flea
fleet: fleet,fleetest
flesh: flesh
flight: flight
fling: fling,flinging,flings,flung
float: floating,floats
flock: flock,flocked
floor: floor,floored
flout: flouted
flow: flow,flowed,flowing
flower: flower,flowers
flush: flushed
flute: flute
fluxion: fluxions
fly: flew,flies,flown,fly,flying
foal: foal
foe: foe
fog: fog
fogy: fogies
foil: foil
folk: folks
follow: follow
folly: folly,follying
fond: fond
fool: fool,fools
foolish: foolish
foolishness: foolishness
foot: feet,foot
footman: footman,footmen
fop: fop
forbid: forbid
forbye: forbye
force: force
fore: fore
forefinger: forefinger
forehead: forehead
foreign: foreign
foremost: foremost
foresheet: foresheet
foresight: foresight
forest: forest
forevermore: forevermore
forfeit: forfeited
forget: forget,forgetting,forgot
forgetful: forgetful
forgive: forgive
fork: fork,forks
form: form,formed
formal: formal
formality: formalities
format: format,formats
fornenst: fornenst
forninst: forninst
forthwith: forthwith
fortify: fortified
fortitude: fortitude
fortnight: fortnight
fortunate: fortunate
fortunately: fortunately
fortune: fortune
forwards: forwards
foundation: foundation
fountain: fountain
fours: fours
fourth: fourth
fox: fox
foxite: foxite
fraction: fractions
fragrant: fragrant
fraid: fraid
frail: frail
france: france
frantic: frantic
frederick: frederick
freedom: freedom
freely: freely
freeman: freeman
freight: freighted
french: french
frequency: frequency
frequent: frequent
frequently: frequently
fresco: fresco
friction: friction
friday: friday
friend: friend,friends
friendly: friendly
friends: friends
friendship: friendship
fright: fright
frighten: frighten,frightened
frightened: frightened
frightening: frightening
frightful: frightful
frightfully: frightfully
frisk: frisked,frisking
frisking: frisking
fro: fro
frost: frost
froward: froward
frown: frowning
frozen: frozen
fruit: fruit
fud: fud
fulfilment: fulfilment
fun: fun
funeral: funeral
funny: funny
furious: furious
furiously: furiously
furnace: furnace
furnish: furnish
furriner: furriner,furriners
furrow: furrows
furtive: furtive
fury: fury
fut: fut
future: future
gab: gab
gaff: gaff
gain: gain,gained,gaining
gale: gale
gallant: gallant
galt: galt
gambol: gambol,gambols
game: game
gap: gaps
gar: gar
garden: garden
gardener: gardener
garlic: garlic
garment: garments
garret: garret,garrets
garrick: garrick
garrison: garrison
gash: gash
gasp: gasped,gasping
gate: gate,gates
gatekeeper: gatekeeper
gather: gathered,gathering
gay: gay
gayly: gayly
gaze: gazed
gem: gems
genealogical: genealogical
generation: generation,generations
generosity: generosity
generous: generous
genius: genius
genteel: genteel
gentle: gentle,gentles
gentleman: gentleman,gentlemen
gently: gently
gentry: gentry
genus: genus
geographical: geographical
george: george
german: german
ghastly: ghastly
ghost: ghost,ghosts
ghostly: ghostly
gibbet: gibbet
gift: gift,gifted
gig: gig
giggle: giggled
gilt: gilt
girl: girl,girls
givin: givin
glad: glad
glade: glades
gladly: gladly
gladness: gladness
glance: glance,glanced,glances
glass: glass,glasses
glassy: glassy
glauber: glauber
gleam: gleam
glebe: glebe
gleeful: gleeful
glide: glide,glided
glimpse: glimpse,glimpses
glitter: glittered,glittering
gloom: gloom
gloomy: gloomy
glory: glory
glove: gloves
gnat: gnats
gnaw: gnawing
goal: goals
goat: goat
god: god
godsend: godsend
gog: gog
goggle: goggling
gold: gold
goldsmith: goldsmith
gong: gong
goodly: goodly
goodness: goodness
goose: geese,goose
gooseberry: gooseberries
gor: gor
gorra: gorra
gossamer: gossamer
gotham: gotham
govern: govern
gown: gown,gowns
grab: grabbing
grace: grace
gracious: gracious
gradually: gradually
grand: grand
grandfather: grandfather
grandmother: grandmother
grant: grant,granted,granting
grass: grass
grate: grate
grateful: grateful
gratefully: gratefully
gratification: gratification
grave: grave,graves
gravely: gravely
graveyard: graveyard
grayish: grayish
graze: graze,grazing
gre: gre
greased: greased
greatly: greatly
greek: greek,greeks
green: green
greenness: greenness
greensward: greensward
greenwich: greenwich
gregory: gregory
greyhound: greyhound
gridiron: gridiron
grief: grief
grieve: grieved,grieves
grievous: grievous
grin: grin,grinning,grins
grizzled: grizzled
groan: groan,groaning
groaning: groaning
grog: grog
gross: gross
ground: ground
grouse: grouse
grouts: grouts
grove: groves
grow: grew,grow,growing,grown,grows
grownup: grownup
growth: growth
grub: grub
gruffly: gruffly
grumble: grumbled
grunt: grunted
guard: guard
guess: guess,guessed
guest: guest
guidance: guidance
guide: guide,guided,guides
guinea: guinea
guitar: guitar
gun: gun,guns
gunner: gunners
gurgle: gurgled
ha: ha
habeas: habeas
habet: habet
habit: habit,habits
habitually: habitually
hackney: hackney
hail: hail,hailed
hair: hair,hairs
hall: hall
halloo: hallooed
halter: halter
ham: ham,hams
hammer: hammer
hamper: hamper,hampers
hand: hand,handed,hands
handful: handful
handkerchief: handkerchief
handle: handled
handling: handling
handsome: handsome
handsomely: handsomely
handsomer: handsomer
handy: handy
hang: hang,hanged,hanging,hung
hanging: hanging
hangman: hangman
happen: happen,happened,happening
happily: happily
happiness: happiness
happy: happier,happiest,happy
harbor: harbor
hard: hard,hardest
hardship: hardship
hardy: hardy
hare: hare
harem: harem
harm: harm
harmless: harmless
harrowing: harrowing
harsh: harsh
hart: hart
haste: haste
hasten: hastened
hastily: hastily
hasty: hasty
hat: hat,hats
hatchment: hatchment
hate: hate,hated
hateful: hateful
haul: haul,hauled,hauling
haunch: haunch
haunt: haunt,haunted
hav: hav
hay: hay
hayes: hayes
haythorn: haythorn
haze: haze
hazy: hazy
head: head,headed,heads
headache: headache
headlong: headlong
health: health
heap: heap
hear: hear,heard,hearing,hears
hearing: hearing
heart: heart,hearts
hearted: hearted
heartedness: heartedness
hearth: hearth
hearthstone: hearthstone
heartily: heartily
heartless: heartless
hearty: heartier
heat: heat
heathen: heathen
heave: heaved,hove
heaven: heaven,heavens
heavily: heavily
heavy: heavy
hedge: hedge,hedged,hedges
hedges: hedges
heed: heed,heeded
heel: heel,heels
heifer: heifer
height: height
heir: heirs
helm: helm
helplessness: helplessness
hem: hem
hen: hen,hens
heresy: heresy
heretic: heretic,heretics
heretical: heretical
hero: hero,heroes
heroine: heroine
herring: herrings
hibernian: hibernian
hiccup: hiccup
hidden: hidden
hide: hide
hiding: hiding
highly: highly
hill: hill,hills
hillo: hillo
hind: hind
hint: hint,hinted,hints
hiss: hissed
historian: historian
historical: historical
history: history
hit: hit,hitting
hitherto: hitherto
ho: ho
hob: hob
hobble: hobble
hobbly: hobbly
hogshead: hogshead
hoist: hoisted
hold: held,hold,holding,holds
holder: holder
holding: holding
hole: hole,holes
holiday: holiday
holiness: holiness
holinesses: holinesses
hollow: hollow
holy: holy
homage: homage
homeward: homeward
homewards: homewards
hone: hone
honest: honest
honester: honester
honesty: honesty
honeymoon: honeymoon
honor: honor
hood: hoods
hoodwink: hoodwinked
hoof: hoofs
hook: hook
hooker: hooker
hop: hop,hopped
hope: hope,hoped,hopes
hopeless: hopeless
horace: horace
horizon: horizon
horn: horn
horrid: horrid
horrify: horrified
horror: horror
hors: hors
horse: horse,horses
horseback: horseback
horseshoe: horseshoe
horticultural: horticultural
host: host
hostile: hostile
hot: hot
hottentot: hottentot
houghton: houghton
hound: hounds
hour: hour,hours
house: house,houses
household: household
housekeeper: housekeeper
housemaid: housemaid
hove: hove
howl: howl,howled,howling
hue: hue
hugely: hugely
hull: hull
hum: hummed
human: human
humble: humble,humbled
humbug: humbug
humdrum: humdrum
humor: humor
humorous: humorous
hunger: hunger
hungry: hungrier,hungry
hunt: hunt,hunted
hunting: hunting
hurrah: hurrah
hurried: hurried
hurriedly: hurriedly
hurroo: hurroo
hurry: hurried,hurry,hurrying
hurt: hurt,hurts
husband: husband,husbands
husky: husky
hussy: hussy
hymeneal: hymeneal
hypocrisy: hypocrisy
ice: ice,ices
idea: idea,ideas
identification: identification
identify: identify
identity: identity
idiom: idiom
ignoramus: ignoramus
ignorance: ignorance
ignorant: ignorant
iii: iii
illness: illness
imaginable: imaginable
imaginary: imaginary
imagine: imagine,imagined
imbue: imbued
imitate: imitated
imitation: imitation,imitations
immaterial: immaterial
immerse: immersed
imminent: imminent
immortality: immortality
immovable: immovable
impair: impaired
impart: impart
impatience: impatience
impatient: impatient
impatiently: impatiently
impend: impending
impenetrable: impenetrable
imperance: imperance
imperial: imperial
impertinence: impertinence
impertinent: impertinent
implement: implements
imply: implied,imply,implying
impose: imposed
impossibility: impossibility
impossible: impossible
impracticable: impracticable
impression: impression
impromptu: impromptu
improvement: improvement
inaccurate: inaccurate
inadvertently: inadvertently
inarticulate: inarticulate
inaudible: inaudible
incantation: incantation
incensed: incensed
inch: inch
incident: incident
incidental: incidental
inclination: inclination
incline: incline,inclined
inclined: inclined
include: include,included,includes,including
including: including
incomplete: incomplete
incomprehensible: incomprehensible
inconsistency: inconsistencies
inconsolable: inconsolable
incontinently: incontinently
incorrect: incorrect
increase: increase,increased,increasing
incredulous: incredulous
incurably: incurably
ind: ind
indecision: indecision
indemnify: indemnify
indemnity: indemnity
independence: independence
independently: independently
indescribable: indescribable
india: india
indian: indian
indies: indies
indifference: indifference
indifferent: indifferent
indifferently: indifferently
indignation: indignation
indirect: indirect
indirectly: indirectly
indispensable: indispensable
indisposed: indisposed
individual: individual
indomitable: indomitable
induce: induce
indulge: indulge,indulged
industry: industry
ineffable: ineffable
ineffectually: ineffectually
inexperienced: inexperienced
inexplicable: inexplicable
infallibly: infallibly
infer: infer
inferior: inferior
inferiority: inferiority
infinite: infinite
inflame: inflamed
inflict: inflict
influence: influence,influenced
inform: inform,informed
infringement: infringement
ing: ing
ingenious: ingenious
ingine: ingine
ingredient: ingredients
inhabit: inhabited
inimitable: inimitable
injure: injured
injustice: injustice
innocent: innocent
innumerable: innumerable
inordinate: inordinate
inquire: inquire,inquired,inquiring
inquiringly: inquiringly
inquiry: inquiries
inquisitive: inquisitive
inscribe: inscribed
insensible: insensible
insinuate: insinuating
insinuation: insinuation
insist: insist,insisted
insolence: insolence
inspect: inspect
instance: instance,instances
instant: instant
instantly: instantly
institution: institution
instruct: instructed
instruction: instructions
instrument: instrument
insult: insulted,insulting
insure: insure
intellect: intellect
intellectual: intellectual
intelligent: intelligent
intend: intended
intention: intention,intentions
inter: inter
interchange: interchanged
interfere: interfere
interior: interior
interjection: interjection
internal: internal
internally: internally
international: international
interpret: interpret,interpreted
interrupt: interrupted,interrupting,interrupts
interruption: interruption
intersperse: interspersed
interstice: interstices
intervene: intervened
interview: interview
intimation: intimation
intolerable: intolerable
introduce: introduced
introduction: introduction,introductions
intruder: intruder
invade: invaded
invalidity: invalidity
invaluable: invaluable
invariably: invariably
inveigle: inveigled
invent: invented,inventing
inverse: inverse
investment: investments
invisible: invisible
invitation: invitation
invite: invite,invited
inwardly: inwardly
ireland: ireland
irish: irish
irishman: irishman
irishmen: irishmen
iron: iron,irons
irrational: irrational
irs: irs
island: island
iso: iso
issue: issue,issued,issuing
italian: italian
iv: iv
ivy: ivy
ja: ja
jack: jack
jackdaw: jackdaws
jacket: jacket
jacqueline: jacqueline
jail: jail
jam: jam
james: james
jane: jane
janes: janes
japan: japan
jaw: jaw,jaws
jealous: jealous
jealousy: jealousy
jeer: jeered
jeeringly: jeeringly
jelly: jelly
jemmy: jemmy
jeremy: jeremy
jericho: jericho
jest: jest
jewel: jewel
jewelled: jewelled
jib: jib
jim: jim
jimmy: jimmy
jing: jing
jingle: jingle,jingling
job: job,jobs
jocund: jocund
jog: jogged
john: john
johnny: johnny
johnson: johnson
joint: joints
joke: joke,jokes,joking
jolly: jolly
jolt: jolted
jones: jones
jostle: jostle,jostling
journal: journal
journey: journey,journeyed
joy: joy
joyously: joyously
judge: judge,judges
judgment: judgment
jug: jug
juice: juice
julius: julius
july: july
jump: jump,jumped,jumping,jumps
junction: junction
juncture: juncture
june: june
junior: junior
jury: jury
justice: justice
justly: justly
keeper: keeper
keepsake: keepsake
kelly: kelly
kennel: kennel
kent: kent
key: key
kick: kicked,kicking
kill: kill,killed,kills
kilt: kilt
kin: kin
kindle: kindled
kindly: kindly
kindness: kindness
kindred: kindred
king: king,kings
kingdom: kingdom
kiosk: kiosk
kiss: kiss,kissed,kissing
kitchen: kitchen
kith: kith
kitten: kitten
knack: knack
knee: knee,knees
kneel: kneel,kneeling,knelt
knife: knife,knives
knight: knighted
knock: knock,knocked,knocks
knowledge: knowledge
knowledgeable: knowledgeable
knuckle: knuckles
labor: laboring
laboriously: laboriously
lad: lad,lads
laden: laden
lady: ladies,lady
ladyship: ladyship
lake: lake
lamb: lamb
lament: lamented
lamentation: lamentation,lamentations
land: land,landed,lands
landing: landing
landlord: landlord
landmark: landmark
landscape: landscape
lane: lane
language: language
lanky: lanky
lantern: lantern
lapse: lapse
lash: lashed,lashes
lastly: lastly
late: late
latin: latin
latinity: latinity
latitudes: latitudes
laudatory: laudatory
laugh: laugh,laughed,laughing
laughter: laughter
laundress: laundress
laurel: laurels
lave: lave,laving
law: law,laws
lawfulness: lawfulness
lawn: lawn
lawyer: lawyer,lawyers
lay: laid,lay,laying,lays
lazy: lazy
lead: lead,leading,leads,led
leader: leader,leaders
leaf: leaves
league: leagues
lean: leaned
learn: learn,learned,learning
leather: leather
leave: leave,leaving,left
lecture: lectured,lectures
lee: lee
leetle: leetle
leeward: leeward
left: left
leg: leg,legs
legal: legal
legally: legally
legged: legged
legislative: legislative
leisurely: leisurely
lend: lent
lent: lent
lepus: lepus
lesson: lesson
letter: letter
level: level
liability: liability
liable: liable
liaison: liaison
liar: liar
liberal: liberal
liberally: liberally
liberty: liberties,liberty
library: library
license: license
licensed: licensed
lid: lid
lie: lie,lies,lying
lieu: lieu
life: life,lives
lifeless: lifeless
lift: lift,lifted,lifts
light: light,lighted,lighting,lit
lighten: lightened
lighting: lighting
lightning: lightnings
likeness: likeness
likes: likes
limb: limbs
limit: limit,limited,limits
limitation: limitation
limited: limited
lind: lind
link: linked,links
linstock: linstocks
lint: lint
lion: lion
lip: lips
liquid: liquid
liquor: liquor,liquors
list: list
listen: listen,listened,listening
listener: listeners
literally: literally
literary: literary
literature: literature
live: live,lived,lives,living
livid: livid
living: living
lo: lo
load: load,loading
loading: loading
loaf: loaf
loan: loan
local: local
locality: locality
locate: located
location: locations
lock: lock,locked,locks
locket: locket
lodge: lodge,lodges
lodger: lodger
lodgings: lodgings
lofty: lofty
logic: logic
logical: logical
london: london
loneliness: loneliness
lonely: lonely
longitude: longitude
lookout: lookout
looky: looky
loose: loose
loquacity: loquacity
lord: lord
lore: lore
lorimer: lorimer
lose: lose,losing,lost
loss: loss
lost: lost
lot: lot
lotion: lotion
loud: loud
loudly: loudly
louisa: louisa
love: love,loved
lovely: lovely
lover: lover
lovingly: lovingly
lozenge: lozenge
lubber: lubbers
luck: luck
lucky: lucky
luff: luffed
luke: luke
lumber: lumber
lump: lump
lunch: lunch
luncheon: luncheon
lung: lungs
luscious: luscious
lustily: lustily
lute: lute
machine: machine
mackerel: mackerel
mad: mad
madam: madam
madame: madame
madman: madman
madness: madness
magisterially: magisterially
magistrate: magistrate,magistrates
magnificent: magnificent
magnitude: magnitude
mahomet: mahomet
maid: maid,maids
maiden: maiden
main: main
maintain: maintaining,maintains
majesty: majesty
major: major
malady: maladies,malady
malam: malam
male: male
mamma: mamma
mammoth: mammoth
mammy: mammy
manage: manage
management: management
manager: manager
mane: mane,manes
manhood: manhood
manifest: manifest,manifested
manifestation: manifestations
manly: manly
manned: manned
manner: manner
manners: manners
manor: manor
mantel: mantel
mar: mar
marble: marbles
march: march,marched
mare: mare
maria: maria
marian: marian
marine: marine
mariner: mariners
mark: mark,marked,marks
marked: marked
market: market
marriage: marriage
married: married
marry: married,marry
marrying: marrying
mars: mars
marvellous: marvellous
mary: mary
mason: masons
mass: mass,masses
mast: mast,masts
master: master,masters
masterful: masterful
mastery: mastery
mat: mat
match: match
mate: mate
mathematical: mathematical
matilda: matilda
matter: matter,matters
matthew: matthew
mausoleum: mausoleum
maximum: maximum
mea: mea
meadow: meadow,meadows
meal: meal
meaning: meaning
measure: measure,measures
mechanism: mechanism
medallion: medallions
meddle: meddle
medea: medea
medical: medical
medicament: medicaments
meditation: meditations
medium: medium
meet: meet,meets,met
meeting: meeting,meetings
melancholy: melancholy
memoirs: memoirs
memory: memory
menace: menaces
mend: mend,mended
menstruum: menstruum
ment: ment
mental: mental
mention: mention,mentioned,mentioning
mercer: mercer
merchandise: merchandise
merciful: merciful
mercury: mercury
mercy: mercy
mere: mere,merest
merit: merits
merriment: merriment
merry: merry
mess: mess
message: message
messmate: messmates
metaphysics: metaphysics
method: method,methods
metropolitan: metropolitan
meum: meum
michael: michael
middle: middle
middling: middling
midge: midge
midnight: midnight
midst: midst
mightily: mightily
mighty: mighty
migrate: migrate
mikey: mikey
mild: mild
mile: mile,miles
milesian: milesian
military: military
militia: militia
milk: milk
miller: miller
milliner: milliner
millstone: millstones
min: min
mind: mind,minded,minding,minds
minded: minded
miner: miner
miniature: miniature
minister: minister,ministering,ministers
minute: minute,minutes
minx: minx
miraculous: miraculous
mis: mis
mischief: mischief
misdoubt: misdoubt
miserable: miserable
misfortunate: misfortunate
misfortune: misfortune,misfortunes
misguided: misguided
mishap: mishap
mislead: misled
mission: mission
mississippi: mississippi
mistake: mistake,mistakes,mistook
mistaken: mistaken
mistaking: mistaking
mister: mister
mistress: mistress,mistresses
mit: mit
mite: mite
mix: mix,mixes,mixing
mixed: mixed
moan: moaning
mock: mock
mockery: mockery
mode: mode
modern: modern
modesty: modesty
modification: modification
modify: modified
mollify: mollified
molly: molly
moment: moment
monday: monday
money: money,moneys
monkey: monkey
monny: monny
monster: monster,monsters
monstrous: monstrous
month: month,months
monthly: monthly
monument: monument,monuments
mood: mood
moon: moon
moonlight: moonlight
moorland: moorland
moral: moral
morel: morel
morn: morn
morning: morning
morocco: morocco
morrow: morrow
morsel: morsel
mortal: mortal
mortem: mortem
mortification: mortification
mortify: mortified
mose: mose
mother: mother
motion: motion
motive: motives
motto: motto
mount: mount,mounted,mounting
mountain: mountain
mourn: mourning
mourner: mourner
mournful: mournful
mourning: mourning
mouse: mouse
mouth: mouth,mouths
mouthful: mouthfuls
movement: movement
mud: mud
muffin: muffins
mulatto: mulattoes
mule: mule
multitude: multitude
multum: multum
mumbling: mumbling
mun: mun
muntz: muntz
murder: murder,murdered,murders
murderer: murderer
murderous: murderous
murmur: murmured
murther: murther
musha: musha
music: music
musical: musical
mustache: mustache
mustachio: mustachios
mustard: mustard
mute: mute
mutter: muttered
mutton: mutton
mutual: mutual
muzzle: muzzled
mysterious: mysterious
mystery: mystery
mystic: mystic
mystification: mystification
mystify: mystifying
nail: nail,nailed
nam: nam
namesake: namesake
naming: naming
nancy: nancy
narcotic: narcotic
narrative: narrative
nate: nate
nation: nation
national: national
native: native
natural: natural
naturally: naturally
nature: nature
natured: natured
nautical: nautical
navigation: navigation
navigator: navigator
nearer: nearer
neat: neat
necessity: necessity
neck: neck
necromancer: necromancer
needless: needless
negative: negative
neglect: neglect,neglecting
negligence: negligence
negro: negro,negroes
neighbor: neighbor,neighbors
neighborhood: neighborhood
neighboring: neighboring
nephew: nephew
nerve: nerves
nervous: nervous
nervousness: nervousness
network: network
newfoundland: newfoundland
newly: newly
news: news
newsletter: newsletter
nice: nice
nigh: nigh
night: night
nightgown: nightgown
ninth: ninth
nip: nip
noble: noble
nod: nod,nodded
noddle: noddle
noise: noise,noises
nomination: nomination
nomine: nomine
nominee: nominees
nonproprietary: nonproprietary
nonsense: nonsense
nook: nook,nooks
noon: noon
north: north
northeast: northeast
nose: nose,noses
notable: notable
note: note
notes: notes
notice: notice
noticeable: noticeable
notify: notifies
notion: notion
nous: nous
nuisance: nuisance,nuisances
numerous: numerous
nunc: nunc
nurse: nurse
nursery: nursery
ny: ny
oak: oak
oar: oar
oath: oath,oaths
oats: oats
obdurate: obdurate
obedience: obedience
obedient: obedient
obesity: obesity
obey: obeyed,obeying
object: object,objected
objection: objection
obligate: obligated
obligato: obligato
oblige: obliged
obscure: obscure,obscurest
observation: observation,observations
observe: observe,observed,observing
observer: observer
obsolete: obsolete
obstinacy: obstinacy
obstinate: obstinate
obstreperous: obstreperous
obvious: obvious
occasion: occasion,occasioned,occasions
occasional: occasional
occasionally: occasionally
occupation: occupation
occupy: occupied
occur: occur,occurred
occurrence: occurrence,occurrences
ocean: ocean
och: och
october: october
oddity: oddity
odds: odds
odious: odious
odor: odor,odors
offence: offence
offend: offend,offended
offensive: offensive
offer: offer,offered,offering,offers
offering: offering
office: office
officer: officer,officers
official: official
offspring: offspring
oftener: oftener
oil: oil
omadhaun: omadhaun
omission: omission
omni: omni
onion: onions
online: online
openly: openly
operation: operation,operations
operculum: operculum
opinion: opinion,opinions
opium: opium
opponent: opponent
opportunity: opportunities,opportunity
opposition: opposition
opprobrium: opprobrium
optically: optically
optics: optics
oracle: oracle
orange: orange
oration: oration
orchard: orchard
ordinal: ordinals
ordinary: ordinary
organize: organized
original: original
originality: originality
originate: originating
originator: originator
ornament: ornament,ornamented,ornaments
orphan: orphan
orthodox: orthodox
orthography: orthography
oscula: oscula
otium: otium
outbreak: outbreak
outdated: outdated
outdo: outdone
outlawry: outlawry
outpouring: outpouring
outward: outward
outwitting: outwitting
overcome: overcome
overhear: overheard
overmuch: overmuch
overpower: overpowered
overrule: overruled
overseer: overseer
overtake: overtaking
overture: overture
overwhelmed: overwhelmed
owd: owd
owe: owe,owed
owl: owl
owner: owner
oyster: oyster,oysters
pace: pace
pacify: pacified
pack: pack,packed,packing
package: packages
paddle: paddles,paddling
paddy: paddy
pagan: pagan
pain: pain,pains
paint: painted
pair: pair
pale: pale
paler: paler
pallid: pallid
palm: palms
pane: panes
panel: panels
pang: pang,pangs
paper: paper,papers
paperwork: paperwork
parade: parade,paraded
paradise: paradise
paragraph: paragraph,paragraphs
parallel: parallel,paralleled
paramount: paramount
parcel: parcel,parcels
pardon: pardon
pardonable: pardonable
parish: parish
parishioner: parishioners
park: park
parlance: parlance
parley: parley
parlor: parlor
parly: parly
parson: parson,parsons
partake: partake
partaker: partakers
partiality: partiality
particle: particles
partly: partly
partner: partner
partook: partook
party: parties,party
pas: pas
pass: pass,passed,passing
passable: passable
passage: passage
passenger: passengers
passing: passing
passion: passion
passionate: passionate
passionately: passionately
pasta: pasta
pastry: pastry
pat: pat,patted
path: path
pathetic: pathetic
pathetically: pathetically
patience: patience
patient: patient
patiently: patiently
pattern: pattern
paul: paul
paunch: paunch
pause: paused
pay: paid,pay,paying
payment: payment,payments
pea: pea,peas
peace: peace
peaceful: peaceful
peacock: peacock
peahen: peahen
peak: peak
peck: peck
peculiar: peculiar
peculiarly: peculiarly
peep: peeping
peg: peg
pelican: pelican
pelt: pelt
pen: pen
penal: penal
pennsylvania: pennsylvania
perceive: perceive,perceived,perceiving
perch: perch,perched
perchance: perchance
perfect: perfect,perfected
perfectibility: perfectibility
perfectly: perfectly
perform: perform,performed,performing
performance: performance,performances
perilous: perilous
period: period
periodic: periodic
perish: perish,perished,perishing
permanent: permanent
permission: permission
permit: permitted
perpetrate: perpetrated
perplex: perplexed
perplexed: perplexed
perplexing: perplexing
persecutor: persecutor
persevere: persevere
persist: persisted
person: people,person,persons
personal: personal
persuade: persuade
pertinacity: pertinacity
perturb: perturbed
pestilent: pestilent
peter: peter
pether: pether
phenomenon: phenomena,phenomenon
phew: phew
philosopher: philosophers
philosophic: philosophic
philosophical: philosophical
philosophically: philosophically
philosophy: philosophy
phoo: phoo
phrase: phrase,phrases
physic: physic
physical: physical
pick: pick,picked,picking
pickle: pickled
picnic: picnic
picnicker: picnickers
picture: picture,pictures
pie: pie,pies
piece: piece,pieces
pierce: pierced,piercing
piety: piety
pig: pig,pigs
pigeon: pigeon,pigeons
piggery: piggery
pigtail: pigtails
pill: pill
pillar: pillars
pillion: pillion
pilot: pilot,piloting,pilots
pin: pin,pins
pinch: pinch
pincushion: pincushion
pinfold: pinfold
pint: pint,pints
pious: pious
pipe: pipe,pipes
pitch: pitch
pity: pity
placet: placet
plague: plague
plaguy: plaguy
plain: plain,plainest
plainly: plainly
plaintiff: plaintiff
plan: plan
plant: planted
plantation: plantation,plantations
planting: planting
plash: plash
plaster: plaster
plate: plate,plates
plateful: plateful
platform: platform
play: play,playing,plays
player: players
plea: plea
plead: plead,pleads
pleading: pleadings
pleasant: pleasant,pleasanter,pleasantest
pleasantest: pleasantest
pleasantly: pleasantly
pleasantry: pleasantries,pleasantry
pleased: pleased
pleasing: pleasing
pleasure: pleasure
plentiful: plentiful
plenty: plenty
plough: plough,ploughed,ploughing
ploughing: ploughing
pluck: pluck,plucking
plucking: plucking
pluff: pluff
plum: plum
plump: plump
plunge: plunge,plunged
plunging: plunging
plutarch: plutarch
ply: plied
poacher: poachers
pocket: pocket,pocketed,pocketing,pockets
pod: pod
poet: poets
poison: poisoned
poke: poke,pokes,poking
poker: poker
pole: pole
polish: polished
polished: polished
polite: polite
politeness: politeness
political: political
polk: polk
polyanthus: polyanthuses
pomegranate: pomegranates
pompous: pompous
pon: pon
pond: pond
ponderous: ponderous
pons: pons
pooh: pooh
poor: poor
pop: pop
pope: pope
porcelain: porcelain
porch: porch
pork: pork
port: port,ports
portion: portion
portrait: portrait
pose: posed
position: position
positive: positive
possess: possessed,possessing
possession: possession
posset: posset
possibility: possibility
post: post,posted,posts
posterity: posterity
postscript: postscript
posture: posture
pot: pot
potato: potato,potatoes
potency: potency
potteen: potteen
poulterer: poulterer
poultry: poultry
pound: pound,pounds
pour: pours
powder: powder
power: power,powers
powerful: powerful
practically: practically
practice: practice,practices
praise: praised
prate: prate
pray: pray,praying
prayer: prayer,prayers
preach: preach,preached
precede: preceding
precious: precious
precipitate: precipitated
precisely: precisely
preconcert: preconcert
predict: predicted
preface: preface
prefer: prefer,preferred
preferable: preferable
preference: preference
prejudice: prejudice,prejudices
premise: premises
preparation: preparation,preparations
preparative: preparative
preparatory: preparatory
prepare: prepare,prepared,preparing
preposterous: preposterous
presence: presence
presentation: presentation
presently: presently
preserve: preserve
press: press,pressed
presume: presume
presumption: presumption
pretence: pretence
pretend: pretend
pretension: pretensions
preternatural: preternatural
prettily: prettily
pretty: pretty
prevail: prevailed
prevalence: prevalence
prevalent: prevalent
prevent: prevent,prevented
previous: previous
prick: prick
pride: pride
priest: priest,priests
prime: prime
prince: prince
principal: principal
principle: principle,principles
print: print,printed
prior: prior
prisoner: prisoner
prithee: prithee
privileged: privileged
prize: prize
pro: pro
probable: probable
proceed: proceed,proceeded,proceeding
proceeding: proceeding
proceedings: proceedings
processing: processing
procession: procession
proclaim: proclaimed
procure: procure,procured
produce: produce,produced,producing
production: production
profession: profession
professor: professor
profit: profit,profits
profitable: profitable
profound: profound,profoundest
profoundly: profoundly
profusely: profusely
progeny: progeny
programme: programme
progress: progress
progression: progression
prohibit: prohibited
prohibition: prohibition
project: project,projected
projector: projector
promenader: promenaders
prominence: prominences
prominently: prominently
promise: promise,promised,promises
promote: promoting
promotion: promotion
prompt: prompted
promulgate: promulgate
promulgator: promulgator
pronounce: pronounce,pronounced
proofread: proofread
proofreading: proofreading
propagate: propagated
propel: propelled
proper: proper
properly: properly
property: property
prophecy: prophecy
prophesy: prophesied
prophet: prophet
propitiate: propitiated
proportion: proportion
propose: propose,proposed
proposition: proposition
proprietary: proprietary
propriety: propriety
prospect: prospect
protect: protect
protector: protector
protest: protested
proudly: proudly
prove: prove,proved
provender: provender
proverb: proverb
provide: provide,providing
providence: providence
providential: providential
provision: provision,provisions
provoke: provoke,provoking
provoking: provoking
prudence: prudence
prudent: prudent
psalm: psalm
pshaw: pshaw
public: public
puck: puck
pudding: pudding
pug: pug
pugnacious: pugnacious
pull: pull,pulled,pulling
pulpit: pulpit
pump: pump,pumps
pun: pun
punch: punch
punctual: punctual
puncture: punctured
punish: punish,punished
punitive: punitive
punt: punt
purchase: purchase,purchased
pure: pure
purpose: purpose,purposes
purse: purse,pursed
pursue: pursue,pursued,pursuing
pursuit: pursuit,pursuits
purty: purty
push: pushed,pushing
puzzling: puzzling
quack: quacking
quadrant: quadrant
quaker: quaker
quakerism: quakerism
quakers: quakers
qualification: qualification
quality: qualities,quality
quam: quam
quantity: quantities,quantity
quare: quare
quarrel: quarrel,quarrelled,quarrels
quart: quart,quarts
quarter: quarter,quartered,quarters
quarterly: quarterly
queen: queen
queer: queer
quench: quenched
querist: querist
query: queries,query
quest: quest
question: question,questioned,questions
qui: qui
quia: quia
quick: quick
quid: quid
quiet: quiet
quietly: quietly
quietness: quietness
quit: quit,quitted
quo: quo
quod: quod
quomodo: quomodo
quotation: quotation
quote: quote,quoted,quoting
race: race
rack: rack
radiant: radiant
rag: rag
ragamuffin: ragamuffins
rage: rage
rail: rail,rails
railing: railing
railroad: railroad,railroads
railway: railway
rain: rain,rains
rainbow: rainbow
raise: raise,raised
raison: raison
rake: rake
rale: rale
rally: rallied
range: ranged
ranunculus: ranunculuses
rap: rap
rapidly: rapidly
rapscallion: rapscallions
rare: rare
rarely: rarely
rarity: rarity
rascal: rascal
rash: rash
rasher: rasher
rason: rason
rat: rat,rats
rate: rate,rated,rates
ratio: ratio
ravages: ravages
raw: raw
razor: razors
reach: reach,reached,reaching
read: read,reading,reads
readable: readable
reader: reader,readers
readiness: readiness
ready: ready
real: real
reality: reality
realize: realized
rear: rear
rearing: rearing
reason: reason,reasons
reasonable: reasonable
reassure: reassured,reassuring
recall: recall,recalled
receipt: receipt
receive: receive,received,receiving
reciprocally: reciprocally
recital: recital
reckon: reckon
recognition: recognition
recollection: recollections
recommend: recommend,recommended
record: record
recount: recounted
recourse: recourse
recover: recover,recovered
rector: rector
recurrence: recurrence
red: red
redistribute: redistribute,redistributing
redistributing: redistributing
redistribution: redistribution
reduce: reduce,reduced,reducing
refer: referring
reference: references
refinement: refinement
reflect: reflected
refrain: refrained
refresh: refreshing
refreshing: refreshing
refund: refund
refuse: refuse,refused
regard: regard,regarded
regiment: regiment
region: region
register: registered
regret: regret,regrets
regular: regular
regularly: regularly
regulate: regulating
rehearsal: rehearsals
reign: reign
rejoice: rejoiced
rejoin: rejoined
relate: relate
relation: relation,relations
relative: relative
release: release
relieve: relieved
religion: religion
religious: religious
religiously: religiously
relish: relish,relished
reluctance: reluctance
rely: relies
remain: remain,remained,remaining,remains
remainder: remainder
remark: remarked,remarks
remarkable: remarkable
remarkably: remarkably
remedy: remedies
remember: remember,remembered
remind: reminds
reminiscence: reminiscences
remnant: remnant
remorse: remorse
remote: remote,remoter,remotest
remove: remove,removed
rename: renamed
rend: rending
render: render,rendered
rendezvous: rendezvous
renew: renewed
renewedly: renewedly
renown: renown
renowned: renowned
rent: rent
repair: repair
repeat: repeat,repeated,repeating
repeater: repeater
repent: repent
repine: repine
replace: replace
replacement: replacement
replenish: replenished
reply: replied,reply
report: report,reported,reports
repose: repose
represent: represented,represents
representation: representations
repress: repressing
reproach: reproach
reprobate: reprobate
republican: republican
repudiate: repudiate
repulsive: repulsive
reputation: reputation
request: request,requested
require: require,required,requires
requirement: requirements
requisite: requisite
resave: resave
resemble: resembling
resentment: resentment
reserve: reserve
residence: residence
residuary: residuary
residuum: residuum
resign: resigned
resistance: resistance
resolutely: resolutely
resolution: resolution
resolve: resolve,resolved,resolving
resort: resort
respect: respect,respecting
respectable: respectable
respectful: respectful
respective: respective
respects: respects
rest: rest,rests
resting: resting
restive: restive
restless: restless
restore: restored
restrain: restrain
restriction: restrictions
result: result
resume: resumed
retain: retained,retaining
retire: retired
retreat: retreat,retreated
retrieve: retrieved
retrograde: retrograde
return: return,returned,returning,returns
reveal: revealed
revel: revel
revenue: revenue
reverence: reverence
reverend: reverend
revert: revert
revolve: revolve
revulsion: revulsion
reward: reward,rewarded
rhetoric: rhetoric
rhyme: rhyming
rib: ribs
rich: rich
richard: richard
rick: rick
rid: rid
ride: ridden,ride,riding,rode
ridiculous: ridiculous
riding: riding
rig: rig
rightly: rightly
rioting: rioting
ripple: rippling
rise: rise,rises,rose
risk: risk
rival: rival,rivalling
rivalry: rivalry
river: river
riverside: riverside
road: road,roads
roam: roamed
roar: roar,roared
roast: roast,roasting
roasted: roasted
rob: robbed
robber: robber
robed: robed
robert: robert
rock: rock,rocks
rod: rod
roger: roger
rogue: rogues
roll: rolled,rolls
rome: rome
roof: roof
rookery: rookery
root: root,rooted
rose: rose
rosemary: rosemary
rosy: rosy
rotten: rotten
rotundity: rotundity
rough: rough
route: route
row: rowed
royalty: royalties,royalty
roystering: roystering
rub: rub,rubbed,rubbing
rubbish: rubbish
rudder: rudder
rude: rude
ruder: ruder
ruffian: ruffians
ruin: ruin,ruined,ruins
ruinate: ruinate
ruinous: ruinous
rule: rule,ruled,rules
rum: rum
rummage: rummaged
running: running
rush: rush,rushed,rushes,rushing
ruthlessly: ruthlessly
sabre: sabres
sack: sack,sacked
sacred: sacred
sacrilege: sacrilege
sad: sad
saddle: saddle,saddled
sae: sae
safe: safe
safely: safely
sagacious: sagacious
sagacity: sagacity
sage: sages
sail: sail,sailed,sailing,sails
sailing: sailing
sailor: sailor,sailors
saint: saint,saints
sake: sake
sal: sal
salaam: salaam
salad: salad
salary: salary
salmon: salmon
salt: salt
salubrious: salubrious
salute: salute,saluted
salvation: salvation
salvo: salvo
sam: sam
sambo: sambo
sammy: sammy
samuel: samuel
sane: sane
sarcasm: sarcasm
sartain: sartain
sate: sate
satire: satire
satisfaction: satisfaction
satisfactory: satisfactory
satisfied: satisfied
satisfy: satisfy
saturday: saturday
saucer: saucer
saucy: saucy
saunter: sauntered
sausage: sausage
save: save
saver: saver
savin: savin
sawyer: sawyer
scale: scale,scaled
scandal: scandal
scandalous: scandalous
scarcely: scarcely
scarecrow: scarecrows
scarify: scarified
scarlet: scarlet
scatter: scatter,scattered
scena: scena
scene: scene,scenes
scenery: scenery
sceptical: sceptical
scheme: scheme
schiedam: schiedam
scholar: scholar
school: school,schools
science: science
scientific: scientific
scientifical: scientifical
scold: scolded,scolding
scope: scope
scorch: scorching
score: score,scores
scorn: scorn
scotch: scotch
scotchman: scotchman
scottish: scottish
scoundrel: scoundrel
scram: scram
scramble: scramble,scrambled,scrambling
scrape: scrape
scratch: scratch,scratched
scream: scream,screamed,screaming,screams
screw: screw
scrubby: scrubby
scullion: scullions
scut: scut
scythe: scythe
sea: sea,seas
search: search,searched
season: season
seat: seat,seated
secret: secret
secretly: secretly
secundum: secundum
secure: secure,securing
seductive: seductive
seed: seed
seize: seize,seized,seizing
seldom: seldom
select: select
selection: selection
seminary: seminary
semiquaver: semiquaver
send: send,sending
senex: senex
senior: senior
sense: sense
sensibly: sensibly
sentence: sentence,sentences
sentiment: sentiment,sentiments
separate: separated,separating
september: september
sermon: sermon,sermons
serpent: serpent
servant: servant,servants
serve: serve,served,serves,serving
service: service,services
set: set,sets,setting
setting: setting
settle: settle,settled
settlement: settlement
sevenfold: sevenfold
severe: severe
severely: severely
sex: sex
sexton: sexton
shabby: shabby
shade: shade
shadow: shadow,shadowing,shadows
shaft: shaft
shaggy: shaggy
shake: shake,shakes,shaking,shook
shame: shame
shameful: shameful
shape: shape,shaped,shapes
share: share,shared,sharing
sharp: sharp,sharps
sharpen: sharpen
sharpness: sharpness
shave: shave
shawl: shawl
shear: shorn
shebeen: shebeen
sheep: sheep
sheet: sheet,sheets
shelter: shelter,sheltered
sherbet: sherbet
shift: shift
shilling: shilling
shilly: shilly
shin: shins
shine: shine,shining
ship: ship,ships
shiver: shivers
shoal: shoal
shocked: shocked
shocking: shocking
shod: shod
shoe: shoe,shoes
shoot: shoot,shot
shop: shop
shore: shore
short: short
shot: shot
shotted: shotted
shoulder: shoulder,shoulders
shout: shouted,shouting
shower: shower
shrewd: shrewd
shriek: shriek
shrieking: shrieking
shrill: shrill
shrink: shrinking
shrub: shrub
shrug: shrug,shrugged
shure: shure
shut: shut
shutter: shutter
sich: sich
sick: sick
sideboard: sideboard
siege: siege
sigh: sigh,sighed,sighs
sight: sight
sighted: sighted
sign: sign,signs
signal: signal
signify: signified,signifies,signify
silence: silence,silenced
silent: silent
silhouette: silhouette
silk: silk
silly: silly
silver: silver
simper: simpered
simpering: simpering
simple: simple
simpleton: simpleton
simplicity: simplicity
simply: simply
simultaneous: simultaneous
sinecure: sinecure
sing: sing,sings,sung
single: single
singular: singular
sink: sink,sinking,sunk
sinner: sinner
sion: sion
sir: sir
sis: sis
sister: sister,sisters
sit: sat,sit,sitting
sitch: sitch
situate: situated
situation: situation,situations
size: size
sized: sized
skeleton: skeleton
sketch: sketch
skilful: skilful
skilled: skilled
skillet: skillet
skin: skin
skinny: skinny
skip: skips
sky: skies,sky
slap: slap
slash: slashing
slate: slate
slave: slaves
sledge: sledge
sleep: sleep,slept
sleeper: sleeper,sleepers
sleet: sleet
sleeve: sleeve,sleeves
slice: slice,slices
slight: slight,slightest
sling: sling
slip: slip
sloe: sloe
slope: sloping
slouch: slouched
slough: slough
slow: slow
slumber: slumber
sly: sly
slyly: slyly
smack: smack,smacking
smart: smart
smartness: smartness
smash: smashed
smell: smell,smelling
smile: smile,smiled,smiles,smiling
smite: smitten,smote
smith: smith
smoke: smoke,smoked,smokes,smoking
smooth: smooth,smoothed
snatch: snatching
sneer: sneer
sneering: sneering
snout: snout
snuff: snuff
snug: snug
snuggest: snuggest
sob: sobbed,sobs
sober: sober
sociable: sociable
social: social
socially: socially
society: societies,society
sod: sod
sofa: sofa,sofas
soft: soft
soften: soften
softly: softly
solace: solaced
soldier: soldier,soldiers
sole: sole
solemn: solemn
solemnly: solemnly
solent: solent
solicit: solicit,solicited
solicitation: solicitation
solicitude: solicitude
solitude: solitude
solomon: solomon
solution: solution
somniferous: somniferous
son: son
song: song,songs
sooth: sooth
sophocles: sophocles
sore: sore
sorely: sorely
sorra: sorra
sorrow: sorrow
sort: sort,sorts
soul: soul,souls
sound: sound,sounded,soundest,sounds
soundly: soundly
soup: soup,souped
sour: sour
south: south
sowing: sowing
sowl: sowl
space: space
spacious: spacious
spain: spain
spake: spake
spar: spars
spare: spare,sparing
spark: sparks
sparkle: sparkle
speak: spake,speak,speaking,speaks,spoke,spoken
speaker: speaker
spec: spec,specs
special: special
species: species
specific: specific
specimen: specimen,specimens
speckled: speckled
speculation: speculation,speculations
speculator: speculators
speculum: speculum
speech: speech,speeches
speed: speed
speedily: speedily
speedy: speedy
spelling: spelling
spend: spend,spending,spent
sphere: sphere
spice: spice
spike: spike
spin: spun
spirit: spirit,spirits
spirited: spirited
spiritual: spiritual
spit: spitted,spitting
spite: spite
spiteful: spiteful
splendid: splendid
split: split
spoil: spoils
spoon: spoons
sportsman: sportsman
spot: spot
spotless: spotless
spouse: spouse
sprat: sprats
sprawl: sprawling
spread: spread,spreading
sprig: sprig
spring: sprang,spring,springing,springs,sprung
sprinkling: sprinkling
spud: spud
spur: spurs
spy: spied,spy
squabble: squabble
squabbling: squabbling
square: square
squash: squash
squeal: squealing
squeeze: squeezed
squint: squinting,squints
squire: squire
stable: stable
staff: staff
stag: stag
stair: stair,stairs
staircase: staircase
stake: staked
stale: stale
stall: stalls
stammer: stammered
stamp: stamped
stand: stand,standing,stands,stood
star: stars
starch: starch
stare: stare,stared,staring
start: start,started,starting
starvation: starvation
starve: starved,starving
stately: stately
statement: statements
station: station
stationary: stationary
status: status
statute: statute
stay: stay,stayed,staying
steadily: steadily
steady: steady
steam: steam
steamboat: steamboat,steamboats
steed: steed,steeds
steel: steel
steep: steep
steeple: steeple
steer: steer
steering: steering
step: step,stepped,stepping,steps
stern: stern
steward: steward
stick: stick,sticks,stuck
sticking: sticking
stickler: stickler
stiff: stiff
stiffness: stiffness
stillness: stillness
stipulate: stipulated
stir: stir,stirred,stirring,stirs
stirabout: stirabout
stitch: stitch
stock: stock,stocks
stocking: stockings
stoical: stoical
stomach: stomach
stone: stone,stones
stool: stool
store: stored
storm: storm,storming
story: stories,story
stout: stout
stoutly: stoutly
stow: stowed
straight: straight
straightness: straightness
straightway: straightway
strain: straining
strait: strait
stramash: stramash
strange: strange
strangely: strangely
stranger: stranger
strangulation: strangulation
strap: strap
stratagem: stratagems
straw: straw,straws
stream: stream,streams
street: street
strength: strength
stretch: stretch,stretched,stretching
stricken: stricken
strict: strict
strictly: strictly
stricture: strictures
strike: struck
striking: striking
string: string,strings
stroll: strolled
strong: strong,stronger,strongest
strut: strutted
stub: stub
stubby: stubby
stud: studded
study: studying
stuff: stuff
stumble: stumbling
stupendous: stupendous
stupid: stupid
sturdily: sturdily
stutter: stuttering
style: style
subject: subject,subjects
subjection: subjection
subjugation: subjugation
submission: submission
submit: submit,submitted
subnasal: subnasal
subscribe: subscribe,subscribed
subscriber: subscriber
subscription: subscriptions
subside: subsided
substance: substance
substantial: substantial
substitute: substitute
subtlety: subtlety
subtraction: subtraction
succeed: succeeded,succeeding
success: success
successful: successful
succession: succession
successively: successively
succor: succor
sudden: sudden
suddenly: suddenly
suffer: suffer,suffered
sufficient: sufficient
sugar: sugar,sugared
suggestion: suggestion
suicide: suicide
suit: suit
suitable: suitable
sulkily: sulkily
sum: sum
summer: summer
summon: summon,summoned,summoning
sun: sun
sunbeam: sunbeams
sunburnt: sunburnt
sunday: sunday
sundays: sundays
sundry: sundry
sunny: sunny
sunt: sunt
supercilious: supercilious
superficial: superficial
superintendence: superintendence
superior: superior
supernatural: supernatural
superstitious: superstitious
supper: supper
supply: supplied,supply
support: support,supports
suppose: suppose,supposed,supposing
suppress: suppressed
supremely: supremely
surd: surds
surely: surely
surety: sureties
surface: surface
surfeit: surfeit
surge: surge
surgeon: surgeon
surmount: surmounted
surprise: surprise,surprised,surprises
surprised: surprised
surprising: surprising
surrey: surrey
surround: surrounded
survey: survey,surveyed,surveying
survive: survive
survivorship: survivorship
susceptible: susceptible
suspect: suspect,suspected
suspend: suspended
suspense: suspense
sustain: sustain
sustenance: sustenance
swaddle: swaddling
swaddler: swaddler
swaddling: swaddling
swagger: swagger
swallow: swallowed,swallowing
swamp: swamp
swape: swape
sway: swayed,swaying
swear: swore,sworn
swearer: swearer
swearing: swearing
sweep: sweep,swept
sweet: sweet,sweetest
sweetly: sweetly
swift: swift
swig: swig
sword: sword
symmetry: symmetry
sympathize: sympathize
symptom: symptoms
syncope: syncope
synonymous: synonymous
table: table
tache: tache
tack: tacks
tackle: tackled
tact: tact
tactician: tacticians
tail: tail,tails
tailor: tailor
tain: tain
takin: takin
tale: tale
talent: talents
talk: talk,talked,talking
tall: tall
tanquam: tanquam
tap: tap
taper: tapering
tare: tare
tarnal: tarnal
tarnation: tarnation
tartar: tartar
tassel: tasselled
taste: taste,tasted,tasting
tate: tate
taunt: taunts
taut: taut
tawny: tawny
tax: tax,taxes
tay: tay
te: te
tea: tea
teach: teach
teacher: teachers
teaching: teaching
teal: teal
team: team
tear: tears,torn
tee: tee
tellin: tellin
temper: temper
temperament: temperament
tempered: tempered
tempest: tempests
temple: temple,temples
tempo: tempo
tempore: tempore
temptation: temptation,temptations
tempting: tempting
tenacity: tenacity
tend: tended
tender: tender
tenfold: tenfold
term: term,termed,terms
terminate: terminated
termination: termination
terrace: terrace
terrible: terrible
terror: terror,terrors
terry: terry
testament: testament
testimonial: testimonials
testimony: testimonies,testimony
testy: testy
tha: tha
thames: thames
thankful: thankful
thataway: thataway
thaw: thaws
theatre: theatre
thee: thee
thegither: thegither
theme: theme
theology: theology
theory: theory
thief: thief
thigh: thigh
thimble: thimble
thine: thine
thinking: thinking
thirst: thirst
thirteen: thirteen
thither: thither
thomas: thomas
thrap: thrap
thread: threaded
threaten: threatened
threep: threep,threeped
thresher: threshers
thrice: thrice
thrilling: thrilling
throat: throat,throats
throng: throng
throughother: throughother
throw: threw,throw,throwing,thrown
thrust: thrust,thrusts
thumb: thumb
thump: thump,thumped
thumping: thumping
thunder: thunder,thundered
thursday: thursday
thwart: thwart
thy: thy
thyself: thyself
thysen: thysen
tiber: tiber
tickled: tickled
ticklish: ticklish
tide: tide
tie: ties
tight: tight
tigris: tigris
tile: tiles
tiller: tiller
time: time,times
times: times
tinker: tinker
tired: tired
tit: tit
tithe: tithes
title: title
toad: toad
tobacco: tobacco
toe: toe,toes
toil: toil
token: token
tolerably: tolerably
toll: toll
tom: tom
tomb: tomb
ton: tons
tone: tone,toned,tones
tong: tongs
tongue: tongue,tongues
tooth: teeth,tooth
topic: topics
topsail: topsail
topsy: topsy
tormentingly: tormentingly
tormentum: tormentum
torrent: torrents
torture: torturing
tortured: tortured
toss: toss,tossing
total: total
totally: totally
touch: touch,touched,touching
touching: touching
tough: tough
tould: tould
tower: tower
town: town,towns
townsman: townsman
toy: toy
trace: trace
trackless: trackless
trade: trade,trading
trademark: trademark
trader: trader
train: train
training: training
trait: trait
transact: transact
transaction: transaction
transatlantic: transatlantic
transcribe: transcribe
transcriber: transcriber
transcription: transcription
transfer: transfer,transferred,transferring
transplant: transplant
trap: trap
travel: travel,travelled
traveller: traveller,travellers
travels: travels
traverse: traverse
tray: trays
treacherous: treacherous
treat: treat
treatment: treatment
tree: tree,trees
tremble: trembled,trembling
tremendous: tremendous
tremor: tremor
tremulous: tremulous
trench: trenches
trencher: trencher
trial: trial
trick: trick
trifle: trifle,trifles
trifling: trifling
trim: trimming
trip: trip
trippet: trippet
triumph: triumph
triumphant: triumphant
triumphantly: triumphantly
trod: trod
trophy: trophies
trot: trotted
troth: troth
trouble: trouble
troublesome: troublesome
trousers: trousers
true: true
trust: trust
trusty: trusty
truth: truth
tu: tu
tua: tua
tuck: tuck
tuesday: tuesday
tui: tui
tumble: tumbled
tumbler: tumbler
tune: tune
tunnel: tunnel
turf: turf
turkey: turkey
turks: turks
turnstile: turnstile
turvy: turvy
tut: tut
tutor: tutor
twig: twigs
twilight: twilight
twinkle: twinkling
twinkling: twinkling
type: types
tyranny: tyranny
tyrant: tyrant
ud: ud
ugliness: ugliness
ugly: ugly
ultimate: ultimate
ultimo: ultimo
umph: umph
unaccountable: unaccountable
unacquaint: unacquainted
unbounded: unbounded
uncapable: uncapable
uncertainty: uncertainty
uncivil: uncivil
uncle: uncle
unclouded: unclouded
unconcern: unconcern
unconscious: unconscious
unconsciously: unconsciously
unconsciousness: unconsciousness
uncontrollable: uncontrollable
uncooked: uncooked
understand: understand,understanding,understands,understood
understanding: understanding
undertake: undertaking
undertaking: undertaking
undeviatingly: undeviatingly
undismayed: undismayed
undoubted: undoubted
undoubtedly: undoubtedly
undulation: undulations
uneasy: uneasy
unembarrassed: unembarrassed
unenforceability: unenforceability
unengaged: unengaged
unfavorable: unfavorable
unfortunate: unfortunate
ungentlemanlike: ungentlemanlike
ungratefully: ungratefully
unhappy: unhappy
unheedingly: unheedingly
uniform: uniform
uninterrupted: uninterrupted
unique: unique
united: united
universal: universal
unknown: unknown
unlink: unlink
unloading: unloading
unmitigated: unmitigated
unmolested: unmolested
unnecessary: unnecessary
unperceived: unperceived
unpleasant: unpleasant
unpossible: unpossible
unpretending: unpretending
unproper: unproper
unpropitious: unpropitious
unprotected: unprotected
unquestionable: unquestionable
unroll: unrolled
unscathed: unscathed
unseen: unseen
unsettle: unsettled
unsolicited: unsolicited
unspeakable: unspeakable
unsubstantial: unsubstantial
unsuccessful: unsuccessful
untasted: untasted
untoward: untoward
unusual: unusual
unwell: unwell
unwholesome: unwholesome
unwilling: unwilling
unwillingness: unwillingness
unwise: unwise
update: updated
uphold: upheld
upholder: upholder
upset: upset
upstart: upstart
upward: upward
urchin: urchin
urge: urged
user: user
usher: usher
usual: usual
ut: ut
utility: utility
utmost: utmost
utter: utter,uttered,uttering
utterance: utterance
uttermost: uttermost
vacation: vacation
vacuum: vacuum
vain: vain
vainly: vainly
valor: valor
valuable: valuable
vanilla: vanilla
vanish: vanished
vanity: vanity
variation: variations
variegate: variegated
variety: variety
varnish: varnished
vast: vast
vatican: vatican
vault: vault
vauxhall: vauxhall
veal: veal
vehicle: vehicle
vein: veins
velocity: velocity
venerable: venerable
veneration: veneration
vengeance: vengeance
venison: venison
vent: vented
venture: venture,ventured
venus: venus
verbum: verbum
verdict: verdict
vernacular: vernacular
verse: verse
versicle: versicle
version: version
vesica: vesica
vessel: vessel,vessels
vestry: vestries,vestry
veteran: veteran
vex: vexed
vexation: vexation
viator: viator
vicar: vicar
vicinity: vicinity
vie: vied
view: view,viewed,viewing
vigilant: vigilant
vigor: vigor
vile: vile
village: village,villages
villain: villain
vinegar: vinegar
violate: violates
violence: violence
violent: violent
violently: violently
virgin: virgin
virtue: virtue,virtues
virtuous: virtuous
virus: virus
vis: vis
visible: visible
vision: vision
visionary: visionary
visit: visit,visited,visiting,visits
visitor: visitor
vita: vita
voice: voice,voices
void: void
volatile: volatile
volley: volley
volunteer: volunteer,volunteers
voting: voting
vow: vowed
voyage: voyage
vulgar: vulgar
wa: wa
wag: wag,wagged,wagging
waistband: waistband
waistcoat: waistcoat
wait: wait,waited,waiting
waiter: waiter
wake: wake
walk: walk,walked,walking,walks
walker: walkers
wall: wall
war: war
warehouse: warehouse
warlike: warlike
warm: warm,warmer
warn: warn
warning: warning
warrant: warrant,warrants
warranty: warranties,warranty
waste: waste
watch: watch,watched,watching
watcher: watchers
watchman: watchman
water: water,waters
waterman: watermen
wather: wather
wave: wave,waved,waves,waving
wealthy: wealthy
wear: wear,wearing,wore
weather: weather
wedding: wedding
wedge: wedge
wedlock: wedlock
wednesday: wednesday
weed: weed,weeds
week: week,weeks
weekly: weekly
weeper: weepers
weigh: weighed
weight: weight
weighty: weighty
welfare: welfare
welt: welt
wench: wench
wer: wer
west: west
westminster: westminster
wet: wet
wharf: wharf
whatsoever: whatsoever
wheel: wheel,wheeled,wheels
whereabout: whereabout
whereabouts: whereabouts
wherefore: wherefore
whereof: whereof
whey: whey
whin: whin
whip: whip
whippersnapper: whippersnapper
whisht: whisht
whisker: whiskers
whiskey: whiskey
whisper: whisper,whispered,whispering,whispers
whist: whist
whistle: whistle,whistled
whit: whit
white: white,whitest
whites: whites
whoo: whoo
wi: wi
wicked: wicked
wickedness: wickedness
wid: wid
wide: wide,widest
widow: widow,widowed
wife: wife,wives
wig: wig,wigs
wild: wild
wilderness: wilderness
wildly: wildly
wilkinson: wilkinson
william: william
willingly: willingly
win: win
wind: wind,winds
window: window,windows
windward: windward
windy: windiest,windy
wine: wine,wines
wing: wing,wings
wink: wink,winking
wint: wint
winter: winter
wintry: wintry
wipe: wiped,wiping
wisdom: wisdom
wise: wise,wiser,wisest
wishful: wishful
wisht: wisht
wit: wit
withdraw: withdraw,withdrew
wither: withering
witness: witness,witnessed,witnesses
witty: witty
wizard: wizard
wo: wos
woe: woe
woman: woman,women
womankind: womankind
wonderful: wonderful
wondrous: wondrous
wood: wood,woods
woodcut: woodcuts
wooden: wooden
wool: wool
word: word
worn: worn
worth: worth
worthy: worthy
wran: wran
wrap: wrapped
wrath: wrath
wrench: wrench
wretch: wretch,wretches
wretched: wretched
wringing: wringing
wrist: wrist
writ: writ
write: write,writing,written,wrote
writing: writing
writings: writings
wrong: wrong
wunna: wunna
yankee: yankee
yankees: yankees
yard: yard,yards
yarn: yarn
yearly: yearly
yell: yell
yelp: yelped,yelping
yeomanry: yeomanry
yesterday: yesterday
yew: yew
yez: yez
yi: yis
yield: yielded
yis: yis
yo: yo
york: york
youngster: youngsters
youth: youth
zealous: zealous
