abandon: abandon,abandoned
abide: abide
ability: abilities,ability
ablution: ablution
ablutions: ablutions
abode: abode
absorb: absorbed,absorbing
abstain: abstain
abuse: abused
accept: accept,accepted,accepting
access: access,accessed
accessible: accessible
accompany: accompanied
account: account
accusation: accusation
accustom: accustomed
accustomed: accustomed
ache: ache
achieve: achieved,achieving
action: actions
active: active
activity: activities
actual: actual
add: add
addition: addition,additions
additional: additional
address: address,addresses,addressing
admiration: admiration
admire: admired,admiring
admit: admitted,admitting
admonish: admonished
admonition: admonition
advice: advice
advise: advise,advised
afar: afar
affair: affairs
affection: affection
affectionately: affectionately
afraid: afraid
afternoon: afternoon
age: age,aged
aged: aged
agent: agent
agonising: agonising
agony: agony
agree: agree,agreed
agreement: agreement
ail: ailing
aim: aim
air: air
akin: akin
alas: alas
alien: alien
alike: alike
alive: alive
alleged: alleged
alley: alleys
alms: alms
aloud: aloud
alteration: alteration
alternate: alternate
amusedly: amusedly
amusement: amusement
amy: amy
anew: anew
anger: anger
angry: angry
anguish: anguish
animal: animal,animals
animallike: animallike
annihilate: annihilate,annihilating
annoyance: annoyance
annoyed: annoyed
anoint: anoint
answer: answer,answered,answering,answers
ant: ants
anticipate: anticipated
anxiety: anxiety
ape: apes
appeal: appeal
appearance: appearance,appearances
appetite: appetite
applicable: applicable
apply: apply
appoint: appointed
approach: approach,approached
approval: approval
approve: approve
arc: arcs
arch: arch
archive: archive
ardent: ardent
argue: argue,arguing
arm: arm,arms
arouse: aroused
arrangement: arrangement
array: array
arrival: arrivals
arrive: arriving
arrogance: arrogance
arrogant: arrogant
arrow: arrow
art: art
artist: artist
ascend: ascended
ascetic: ascetic,ascetics
asceticism: asceticism
ascii: ascii
ashamed: ashamed
asleep: asleep
aspect: aspect,aspects
assistance: assistance
assistant: assistant
assume: assumed
astonish: astonished
astonished: astonished
astonishment: astonishment
atman: atman
atone: atoned
attach: attach,attached
attempt: attempts
attend: attended
attention: attention
attentively: attentively
attract: attracted,attracts
attribute: attributes
audacious: audacious
austere: austere
author: author
autumn: autumn
avoid: avoid,avoiding
await: await,awaited,awaiting
awake: awake,awaking,awoke,awoken
awaken: awakened
awakening: awakening
aware: aware
awe: awe
awoken: awoken
axe: axe
baby: baby
bad: bad
badly: badly
ball: ball,balls
bamboo: bamboo
banana: banana,bananas
bank: bank,banks
banter: banter
banyan: banyan
barber: barber
bare: bare
bark: bark
base: base,based
bashful: bashful
basics: basics
basket: basket,baskets
bast: bast
bath: bath,bathing
bathe: bathe
bathing: bathing
beach: beach
beam: beams
bear: bear,bearing,bore,born
beard: beard
bearded: bearded
beat: beat,beating,beats
beautiful: beautiful
beautifully: beautifully
beckon: beckoned
bed: bed,beds
bedroom: bedroom
bee: bee,bees
beetle: beetle
beg: beg,begging
beggar: beggar,beggars
behold: beheld,behold
believer: believers
belong: belong,belonged,belonging,belongs
beloved: beloved
bend: bend,bent
benefactor: benefactor,benefactors
benefit: benefit
benevolence: benevolence
benevolent: benevolent
benevolently: benevolently
bent: bent
besiege: besiege
bid: bid,bidding
binary: binary
bind: bound
bird: bird,birds
birth: birth,births
birthplace: birthplace
bit: bit,bits
bite: bite,biting,bitten
bitter: bitter
bitterly: bitterly
bizarre: bizarre
black: black
blessing: blessing
blind: blind
blindly: blindly
bliss: bliss
blissful: blissful
blissfulness: blissfulness
bloated: bloated
blood: blood
bloody: bloody
blossom: blossom,blossomed,blossoming
blow: blew,blow,blown
blue: blue
bluish: bluish
boar: boars
board: board
boast: boasted
boat: boat,boats
body: bodies,body
boil: boiled
bold: bold
bolt: bolt
bondage: bondage
bone: bone
book: book,books
bore: bored
bother: bother
bottomless: bottomless
bow: bow,bowed,bowing,bows
bowl: bowl,bowls
boy: boy,boys
bracelet: bracelets
brahma: brahma
brahman: brahman,brahmans
brahmanism: brahmanism
brahmans: brahmans
branch: branches
brawny: brawny
breach: breach
bread: bread
break: breaking,broke,broken
breast: breast,breasts
breath: breath
breathe: breathe,breathed,breathes,breathing
bright: bright
brightly: brightly
bring: bring,brought
brother: brothers
brow: brow
brown: brown
brush: brushed
brushwood: brushwood
bubble: bubbles
buddha: buddha
build: build,built
building: building
bull: bull,bulls
burden: burden,burdening
burn: burn,burned,burning,burnt
burning: burning
burst: burst,bursting
bury: bury
bush: bushes
business: business,businesses
businessman: businessmen
bustle: bustle,bustling
busy: busy
butterfly: butterfly
buzz: buzzed,buzzing
cage: cage
cake: cake
calculate: calculate,calculated
calculation: calculations
calling: calling
calm: calm
calmly: calmly
calmness: calmness
camp: camp
cane: canes
canopy: canopy
capable: capable
capacity: capacity
captive: captive
capture: capture,captured
card: card
care: care,cared
careful: careful
carefully: carefully
caress: caress
carp: carp
carpet: carpets
carrier: carrier
carrion: carrion
carry: carried,carries,carry,carrying
cart: cart
carter: carters
cast: cast
castaway: castaway
caste: caste
castigation: castigation
casually: casually
catch: catch,caught
cautious: cautious
cavity: cavities
cease: cease
celebrate: celebrating
celebration: celebration
chain: chain
chair: chair
chamber: chamber
chance: chance
change: change,changed
character: character
characteristic: characteristics
charge: charge,charged,charges
charitable: charitable
charity: charities
charm: charms
charming: charming
chat: chatted
cheat: cheat
check: check,checks
cheek: cheek,cheeks
cheerful: cheerful
cheerfully: cheerfully
cheerfulness: cheerfulness
chess: chess
chest: chest
chew: chewing
chiefly: chiefly
child: child,children
childhood: childhood
childish: childish
childlike: childlike
childlikeness: childlikeness
chimpanzee: chimpanzee
chin: chin
choose: choose,choosing,chose,chosen
chop: chopped
chore: chore
circle: circle,circles,circling
cistern: cistern
city: city
claim: claim
clang: clanged
clap: clapped
clean: clean
cleansing: cleansing
clemency: clemency
clench: clenched
cleric: cleric
climb: climbing
cling: cling
cloak: cloak
close: close,closed,closer
closely: closely
clothes: clothes
cloud: cloud,clouds
coconut: coconut
code: codes
coin: coins
coincidence: coincidence
coincidental: coincidental
cold: cold
collapse: collapsed
collect: collect,collected
collection: collection
colour: colour,coloured,colours
colourful: colourful
comb: comb,combed
comedy: comedy
comfort: comfort,comforting
command: command,commanded,commands
commemorate: commemorate
commercial: commercial
commit: commit,committed,committing
common: common
community: community
companion: companion
companionship: companionship
company: company
compare: compare,compared,comparing
compilation: compilation
complain: complain,complaining
complete: complete
completely: completely
completeness: completeness
completion: completion
compliance: compliance
comply: comply,complying
comprehend: comprehend
comprehensible: comprehensible
compress: compressed
conceal: conceal,concealed
conceited: conceited
concentrate: concentrated
concentrated: concentrated
concentration: concentration
concept: concept
conception: conceptions
concern: concern,concerned
conclusion: conclusion,conclusions
conduct: conducted,conducting,conducts
confess: confess,confessed,confessing
confession: confession
confirm: confirmed
confirmation: confirmation
conflict: conflict
confused: confused
connect: connected
conscious: conscious
consciousness: consciousness
consent: consent,consented
consequential: consequential
considerable: considerable
consist: consisted
constant: constant
constantly: constantly
contact: contact
contemplation: contemplation
contempt: contempt
content: content
contently: contently
contents: contents
continue: continue,continued,continuing
contract: contract,contracted,contracts
contradiction: contradiction
contribution: contributions
control: control,controlled
conversation: conversation
convert: convert
convey: convey,conveyed
convince: convince
cook: cooked
cool: cooled
copper: copper
copying: copying
copyright: copyright
core: core
corner: corners
cornucopia: cornucopia
coronation: coronation
corporation: corporation
corpse: corpses
correctly: correctly
corrupt: corrupt
cost: cost,costs
cottage: cottages
couch: couch
coulter: coulter
count: counted
counterpart: counterpart
country: countries,country
courage: courage
court: court
courtesan: courtesan,courtesans
courtesy: courtesy
cousin: cousin
cover: covered
covetousness: covetousness
cower: cowered
crack: cracked
craft: craft,crafts
cramp: cramps
create: created,creating
creation: creation,creations
creature: creature,creatures
credit: credit
crescent: crescent
criminal: criminal
critical: critical
croak: croak
crocodile: crocodiles
cross: crossed
crouch: crouched
crowd: crowd
crude: crude
cruise: cruise
crystal: crystal
cult: cult
curiosity: curiosity
curious: curious
curiously: curiously
current: current
custom: custom
customer: customers
cut: cut
cycle: cycle
daemon: daemons
daily: daily
damage: damage
damaged: damaged
damages: damages
damp: damp
dance: dance
dancing: dancing
danger: danger
dangerous: dangerous
dangling: dangling
dark: dark
darkness: darkness
datum: data
daughter: daughter,daughters
day: day,days
daybreak: daybreak
daytime: daytime
daze: daze
dead: dead
deadly: deadly
deaf: deaf
deal: deal,deals
dealer: dealer
death: death,deaths
debate: debate
debtor: debtor,debtors
decay: decayed
deceitful: deceitful
deceive: deceive
december: december
decency: decency
decent: decent
deception: deception,deceptions
deceptive: deceptive
deceptively: deceptively
decide: decide,decided
decision: decision
dedicate: dedicated
deductible: deductible
deed: deed
deep: deep,deepest
deeply: deeply
defamation: defamation
defeat: defeated
defect: defect,defects
defective: defective
degree: degree
deletion: deletions
delicacy: delicacy
delicate: delicate
delicious: delicious
delight: delight,delighted,delights
delighted: delighted
delightedly: delightedly
delude: delude
delusion: delusion
demand: demand,demanded
demonstrate: demonstrate,demonstrated,demonstrating
denial: denial
dense: denser
deny: deny
depart: depart
depend: depending,depends
dependency: dependencies
depict: depicted
depraved: depraved
deprivation: deprivations
deprive: deprived
depth: depth
depths: depths
derivative: derivative
derive: derive,derived
desire: desire,desired,desires,desiring
desolate: desolate
despair: despair
desperate: desperate
desperation: desperation
despicable: despicable
despise: despise,despised
destination: destination
destine: destined
destiny: destiny
destitute: destitute
destroy: destroy,destroyed,destroying
destructive: destructive
detach: detach
determine: determine,determining
detour: detour,detours
develop: develop,developed,developing
devil: devil
devious: devious
devote: devote,devoted
devotion: devotion
devour: devour,devoured
devout: devout
dew: dew
dice: dice
die: die,died,dying
differentiate: differentiate
differentiation: differentiation
difficult: difficult
difficulty: difficulties
dim: dim
dinner: dinner
direct: direct,directed
direction: direction,directions
disappear: disappeared
disappearance: disappearance
disappointed: disappointed
disappointment: disappointment,disappointments
disbeliever: disbelievers
discard: discard
disciple: disciples
disclaim: disclaim
disclaimer: disclaimer,disclaimers
discontent: discontent
discontinue: discontinue
discover: discover,discovered
discuss: discuss,discussing
discussion: discussions
disdain: disdain
disdainfully: disdainfully
disease: disease
disembark: disembarking
disgust: disgust,disgusted
disgusted: disgusted
dish: dish
disk: disk
dismember: dismembered
disobedience: disobedience
disobedient: disobedient
disperse: dispersed
display: display,displayed,displaying
displease: displease
displeasure: displeasure
disposition: disposition
dispute: dispute,disputes
disregard: disregard
dissect: dissect
dissolve: dissolved
distant: distant
distinction: distinction
distinguish: distinguished
distinguished: distinguished
distort: distorted
distorted: distorted
distress: distress
distribute: distribute,distributed,distributing
distribution: distribution
distributor: distributor
distrust: distrust
distrustful: distrustful
diversity: diversity
divide: divide
divine: divine
diving: diving
divinity: divinity
doctrine: doctrines
dog: dog
domain: domain
donate: donate
donation: donation,donations
donor: donors
doom: doomed
door: door,doors
dormant: dormant
doubt: doubt,doubted
downhill: downhill
download: downloading
drag: dragged
draw: draw,drawn
drawing: drawing
dream: dream,dreamed,dreaming,dreams,dreamt
dreariness: dreariness
dreary: dreary
dress: dress,dressed
dressed: dressed
drift: drifted
drink: drank,drink,drinking
drinker: drinker
drip: dripped,dripping
drive: driven
driver: driver
drop: drop
drove: droves
drown: drown,drowned
drunk: drunk
drunkard: drunkard
dry: dry
dryness: dryness
dull: dull
dust: dust
dusty: dusty
duty: duties,duty
dwell: dwell,dwelling,dwells,dwelt
eager: eager
eagerly: eagerly
eagerness: eagerness
ear: ear,ears
earn: earn,earned
earth: earth
earthly: earthly
easily: easily
easy: easy
eat: ate,eat,eaten
eater: eaters
eccentric: eccentric
ecstasy: ecstasy
ecstatic: ecstatic
eddy: eddies
edge: edges
edition: edition,editions
educate: educated
educational: educational
effort: effort,efforts
eightfold: eightfold
elect: elect
electronic: electronic
electronically: electronically
elegant: elegant
element: elements
elephant: elephants
elevated: elevated
elevation: elevation
email: email
embarrassed: embarrassed
embarrassing: embarrassing
embarrassment: embarrassment
embrace: embraced
emerge: emerged
emergency: emergency
emit: emit
employee: employee,employees
emptiness: emptiness
enchant: enchanted
enchantment: enchantment
encircle: encircled
encode: encoding
encompass: encompassed
encounter: encountered
endure: endure,endured
enemy: enemies,enemy
english: english
enjoy: enjoy,enjoyed,enjoying
enjoyable: enjoyable
enlarge: enlarged
enlightened: enlightened
enlightenment: enlightenment
enrich: enriched
ensure: ensuring
entangle: entangled
enter: enter,entered,entering
entice: entice,enticed
entire: entire
entity: entities,entity
entrance: entrance
entrust: entrust
envy: envied,envy,envying
equal: equal
equanimity: equanimity
equipment: equipment
era: era
ere: ere
err: err
error: error,errors
escape: escape,escaped,escapes,escaping
essence: essence
essential: essential
etch: etched
eternal: eternal
eternally: eternally
eternity: eternity
evening: evening
event: event,events
eventually: eventually
evil: evil
exalt: exalted
excellent: excellent
excess: excess
exchange: exchanged
excited: excited
exclaim: exclaimed
exclusion: exclusion
executioner: executioner
exempt: exempt
exercise: exercise,exercises
exhale: exhaled,exhaling
exhaust: exhausted
exhausted: exhausted
exhausting: exhausting
exist: existed,existing,exists
existence: existence
expect: expect,expected,expecting
expectation: expectation
expend: expend
expense: expense,expenses
experience: experience,experienced
experienced: experienced
expertise: expertise
explain: explain
explanation: explanation
export: exporting
expose: exposed
express: express,expressed,expresses,expressing
extent: extent
external: external
extreme: extreme
extremely: extremely
exuberant: exuberant
eye: eye,eyes
eyebrow: eyebrows
eyelid: eyelids
facility: facility
factor: factor
fade: fades,fading
fail: failed,failing
failure: failure
fair: fair
faith: faith
faithful: faithful
faithfulness: faithfulness
falcon: falcon
fall: fall,fallen,falling,falls,fell
false: false
familiarity: familiarity
family: family
famous: famous
fan: fan
fare: fare
farewell: farewell
farmer: farmer,farmers
fast: fast,fasted,fastest,fasting,fasts
fasting: fasting
fate: fate
fateful: fateful
father: father,fathers
fatten: fattened
fault: fault
favourite: favourite
fear: fear,feared,fears
fearful: fearful
fearfulness: fearfulness
feat: feats
feather: feathers
feature: features
february: february
federal: federal
fee: fee,fees
feed: fed,feed
feel: feel,feeling,feels
feeling: feeling
fellow: fellow
female: female
fence: fenced
ferment: fermented
ferry: ferried,ferry
ferryman: ferryman,ferrymen
ferrymen: ferrymen
fervour: fervour
fester: festering
feverish: feverish
field: field,fields
fiery: fiery
fig: fig
fight: fight,fighting,fought
figure: figures
file: file,files
filth: filth
final: final
finally: finally
financial: financial
finding: finding
fine: fine,finer
finger: finger,fingers
finish: finished
firm: firm
firmly: firmly
fish: fish,fishes
fisher: fisher
fist: fists
fitness: fitness
flabby: flabby
flame: flame
flare: flared
flash: flash
flee: fled,flee,fleeing
fleeing: fleeing
fleeting: fleeting
flesh: flesh
flexible: flexible
flicker: flickered
float: floated,floating
flock: flock,flocked,flocking
flourish: flourished,flourishing
flow: flow,flowed,flowing
flower: flower,flowers
fly: flew,flown,fly,flying
foam: foamed,foaming
focus: focused
fold: folded
follow: follow
follower: follower,followers
food: food
fool: fool,fools
foolish: foolish
foolishly: foolishly
foolishness: foolishness
foot: feet,foot
forbid: forbade
force: force,forced,forces
forcefully: forcefully
forehead: forehead
foreign: foreign
forest: forest,forests
forget: forget,forgotten
forgetfulness: forgetfulness
forgive: forgive
forgiveness: forgiveness
forlorn: forlorn
form: form,forms
format: format,formats
fornicator: fornicator
forsake: forsaken
fortunate: fortunate
fortune: fortune,fortunes
foundation: foundation
fragrance: fragrance
fragrant: fragrant
freely: freely
freeze: freezing
frenzied: frenzied
fresh: fresh
freshly: freshly
friend: friend,friends
friendliness: friendliness
friendly: friendly
friendship: friendship
frightened: frightened
frightening: frightening
fro: fro
frost: frost
fruit: fruit,fruits
fume: fuming
funeral: funeral
futile: futile
future: future
gaga: gaga
gamble: gambled
gambler: gambler,gamblers
gambling: gambling
game: game,games
gap: gap,gaps
garden: garden,gardens
garment: garment,garments
gate: gate
gather: gather,gathered,gathering
gaze: gaze,gazed
generate: generated
generation: generations
gentleman: gentleman
gesture: gesture,gestures
gift: gift,gifted,gifts
girl: girl,girls
glad: glad
glance: glance,glances
glass: glass
glisten: glistened,glistening
gloomy: gloomy
glorious: glorious
glory: glory
glow: glow,glowing
gnaw: gnaw
goal: goal,goals
goat: goat
god: god,gods
godly: godly
gold: gold
golden: golden
govern: govern
grab: grab,grabbed
grace: grace
grant: grant,granted
grasp: grasp,grasped
grass: grass
grateful: grateful
gratefully: gratefully
gray: gray
greatness: greatness
greed: greed
greedily: greedily
greedy: greedy
green: green
greet: greeted,greeting
greeting: greeting
grief: grief
groove: grooves
gross: gross
ground: ground
grove: grove
grow: grew,grow,growing,grown
guard: guard
guest: guest,guests
guide: guided
guilt: guilt
gullibly: gullibly
gunther: gunther
habit: habit,habits
hair: hair,hairs
halt: halted
hand: hand,handed,hands
handle: handle
handsome: handsome
hang: hang,hanging,hung
happen: happen,happened,happening
happily: happily
happiness: happiness
happy: happier,happy
hard: hard,harder
hardness: hardness
harm: harm,harmed,harming
harmless: harmless
harmony: harmony
harsh: harsh
hart: hart
harvest: harvest
hastiness: hastiness
hasty: hasty
hate: hate,hated,hating
hatred: hatred
head: head,headed,heading,heads
heal: heal,healed
healing: healing
health: health
healthy: healthy
hear: hear,heard,hearing
heart: heart,hearts
heat: heat,heating
heavenly: heavenly
heavy: heavier,heavy
hedge: hedge
heed: heed
height: height
helper: helper
herb: herbs
herd: herd
herman: herman
hermit: hermit
heron: heron
hesitantly: hesitantly
hesitate: hesitate,hesitated
hesitation: hesitation
hidden: hidden
hide: hidden,hide
highly: highly
highway: highway
hill: hill
hint: hint
hip: hips
hit: hit
hold: held,hold,holding
holder: holder
holiness: holiness
holy: holy
honest: honest
honestly: honestly
honey: honey
honour: honoured,honours
honourable: honourable
honoured: honoured
hope: hope,hoped,hopes
hopeless: hopeless
hopelessness: hopelessness
hornbill: hornbill
horror: horror
hospitality: hospitality
host: host
hostile: hostile
hot: hot
hour: hour,hours
house: house,houses
hover: hovered
hug: hug
huge: huge
hull: hull
human: human,humans
humble: humblest
humidity: humidity
humiliate: humiliate
humorous: humorous
humour: humour
hunger: hunger
hungrily: hungrily
hunt: hunting
hunter: hunter
hurriedly: hurriedly
hurry: hurry,hurrying
hurt: hurt
hut: hut
hyaena: hyaenas
ice: ice
idea: idea
identification: identification
identify: identify
ignorant: ignorant
illusion: illusion,illusions
image: image,images
imagine: imagine,imagined,imagining
imitate: imitate
imitation: imitation
immaterial: immaterial
immense: immense
immensely: immensely
impatience: impatience
impatient: impatient
impatiently: impatiently
impending: impending
impenetrable: impenetrable
imperceptibly: imperceptibly
imperfect: imperfect
impetuously: impetuously
imply: implied
impose: imposed
impossible: impossible
inaccurate: inaccurate
incarnation: incarnation
incessant: incessant
incessantly: incessantly
incidental: incidental
include: include,included,includes,including
including: including
incomplete: incomplete
increase: increase,increased,increasing
indemnify: indemnify
indemnity: indemnity
indestructibility: indestructibility
indestructible: indestructible
india: india
indian: indian
indignant: indignant
indignantly: indignantly
indignation: indignation
indirect: indirect
indirectly: indirectly
indispensable: indispensable
individual: individual
individuality: individuality
indulgence: indulgence
inescapable: inescapable
inevitable: inevitable
infant: infants
infect: infected
inferior: inferior
infinitely: infinitely
inform: inform,informed
infringement: infringement
infuse: infused
inhale: inhale,inhaled,inhaling
initiate: initiate
injury: injury
injustice: injustice
inn: inn
innermost: innermost
innumerable: innumerable
insatiably: insatiably
inscription: inscription
inscrutable: inscrutable
insensitivity: insensitivity
insight: insight,insights
insist: insist
instance: instance
instantly: instantly
instruct: instruct,instructed
instruction: instructions
insult: insult,insulted,insulting
intellectual: intellectual
intelligent: intelligent
intend: intend,intended
intent: intent
intention: intention
interior: interior
internal: internal
international: international
interpret: interpreted
interrupt: interrupted,interrupting
intertwine: intertwined
intimate: intimate
intoxicate: intoxicated
intoxication: intoxication
invade: invaded
invalidity: invalidity
invisibly: invisibly
invitation: invitation
invite: invited
invocation: invocation
involved: involved
inwardly: inwardly
irrefutably: irrefutably
irreproachable: irreproachable
irs: irs
isaac: isaac
isolate: isolated
jackal: jackal,jackals
jaguar: jaguar
japan: japan
jewelry: jewelry
job: job
joint: joint
joke: joke,jokes,joking
jones: jones
journey: journey
joy: joy,joys
joyful: joyful
judge: judge
judgement: judgement
juicy: juicy
jump: jumped
kamala: kamala
keen: keen
kid: kid,kidding
kidnap: kidnap
kill: kill,killed,killing
killing: killing
kindle: kindled
kindly: kindly
kindness: kindness
king: king
kiss: kiss,kissed,kisses
kissing: kissing
knee: knees
kneel: kneeling
knife: knife
knock: knock
knowledge: knowledge
knowledgeable: knowledgeable
krishna: krishna
laborious: laborious
lack: lack,lacked,lacks
laden: laden
lady: lady
lake: lake
lakshmi: lakshmi
lament: lamented
lamentation: lamentation
lamentingly: lamentingly
land: land,lands
landlord: landlord
lane: lanes
language: language
lank: lank
late: late
laugh: laugh,laughed,laughing,laughs
laughter: laughter
law: law,laws
lay: lay
layer: layers
lazy: lazy
lead: lead,leading,led
leaf: leaf,leaves
lean: leaned
leapt: leapt
learn: learn,learned,learning
learning: learning
leave: leave,leaving,left
left: left
leg: legs
legal: legal
legally: legally
legend: legend
lesson: lesson,lessons
letter: letter,letters
level: level
liability: liability
liable: liable
liberated: liberated
library: library
license: license
licensed: licensed
lie: lain,lie,lied,lies,lying
lieu: lieu
life: life,lives
lifetime: lifetime
lift: lifted
light: light,lighting,lit
lightning: lightning
likes: likes
limb: limbs
limit: limited
limitation: limitation
limited: limited
linen: linen
link: linked,links
lip: lips
listen: listen,listened,listening
listener: listener,listeners
listening: listening
listlessness: listlessness
literary: literary
live: live,lived,lives,living
living: living
loan: loan,loaned,loaning
locate: located
location: locations
lock: locked
log: log
loincloth: loincloth
loneliness: loneliness
lonely: lonely
longing: longing
longingly: longingly
loop: loops
loose: loose
lose: lose,loses,losing,lost
loss: loss,losses
lost: lost
lot: lot,lots
lotus: lotus
loud: loud
loudly: loudly
lovable: lovable
love: love,loved,loving
loved: loved
lovely: lovely
lover: lover,lovers
loving: loving
loyalty: loyalty
lucky: lucky
lukewarm: lukewarm
luminous: luminous
lunatic: lunatic
lunch: lunch
lure: lured
lust: lust
lustful: lustful
lustre: lustre
luxury: luxury
machine: machine
magic: magic
magical: magical
maid: maid,maids
main: main
maintain: maintaining
majority: majority
male: male
manage: managed
manager: manager
mango: mango
manifestation: manifestations
mankind: mankind
manner: manner
manners: manners
mara: mara
mark: mark,marked
marvellous: marvellous
mask: mask
master: master,mastered,masters
masterful: masterful
mat: mat
match: match
mating: mating
matter: matter,matters
maximum: maximum
maya: maya
meal: meal,meals
meaning: meaning
meaningful: meaningful
meaningless: meaningless
meaninglessness: meaninglessness
meat: meat
meditate: meditate
meditation: meditation,meditations
meditative: meditative
medium: medium
meet: meet,met
melt: melted,melting
memory: memory
mend: mend
mention: mentioned
merchandise: merchandise
merchant: merchant,merchants
merchantability: merchantability
merciless: merciless
mercilessly: mercilessly
mere: mere
merge: merged
message: message
messenger: messenger
method: method,methods
michael: michael
middle: middle
midnight: midnight
midst: midst
mild: mild
mildness: mildness
milk: milk
mind: mind
miracle: miracles
miraculous: miraculous
mirror: mirror
miserable: miserable
miserably: miserably
misery: misery
mission: mission
mississippi: mississippi
mist: mist
mistake: mistakes
mistaken: mistaken
mistress: mistress
moan: moaning
mock: mock,mocking
mockery: mockery
mockingly: mockingly
moderate: moderate
modest: modest
modestly: modestly
modesty: modesty
modification: modification
modify: modified
mold: mold
moment: moment,moments
money: money
monk: monk,monks
month: month,months
mood: moods
moon: moon
moonlight: moonlight
morning: morning
mortal: mortal
mother: mother,mothers
motion: motion,motioned
motionless: motionless
motionlessly: motionlessly
mountain: mountains
mourn: mourning
mourner: mourners
mourning: mourning
mouth: mouth
movement: movement,movements
moving: moving
mud: mud
multitude: multitude
mumble: mumbled
mumbling: mumbling
murderer: murderer
murky: murkier,murky
murmur: murmur,murmured,murmuring
music: music
musician: musicians
mute: mute
mysterious: mysterious
mystery: mystery
myth: myth
nail: nails
naive: naive
naked: naked
nameless: nameless
nation: nations
natural: natural
naughtiness: naughtiness
neck: neck
negligence: negligence
nest: nest
network: network
newly: newly
news: news
newsletter: newsletter
nice: nice
nicely: nicely
night: night,nights
nipple: nipple
nirvana: nirvana
noble: noble
nobleman: nobleman,noblemen
nod: nodded
noise: noise
nonproprietary: nonproprietary
noon: noon
north: north
nothingness: nothingness
notice: notice,noticed
noticeable: noticeable
notify: notifies
notion: notions
novice: novices
nuisance: nuisance
numb: numb,numbing,numbs
numbness: numbness
nurse: nurse,nursing
nurture: nurtured
oar: oar
oarsman: oarsman
obedience: obedience
obedient: obedient
obey: obey,obeyed
object: object
objection: objection
observe: observed
obsess: obsessed
obsolete: obsolete
obstacle: obstacle
obstruct: obstructing
occasionally: occasionally
occupation: occupation,occupations
occupy: occupied,occupy
occur: occur,occurred
odds: odds
offer: offer,offered,offering,offers
offering: offerings
office: office
official: official
oil: oil
oily: oily
ointment: ointments
omen: omen
oneness: oneness
oneself: oneself
online: online
openly: openly
openness: openness
operate: operate
opinion: opinion,opinions
opportunity: opportunities,opportunity
oppose: oppose,opposed
ordinary: ordinary
organize: organized
orgy: orgies
origin: origin
original: original
originally: originally
originator: originator
ornamental: ornamental
outburst: outburst
outdated: outdated
overcome: overcame,overcome,overcoming
overestimate: overestimated
overwhelm: overwhelmed
owe: owed
owl: owl
owner: owner
ox: ox
pace: pace,paced,paces
pain: pain,pains
painful: painful
painfully: painfully
paint: painted
pale: pale
palm: palm
pampered: pampered
pang: pangs
paper: paper
paperwork: paperwork
parable: parable
parade: parade
paragraph: paragraph,paragraphs
paralysed: paralysed
parched: parched
pardon: pardon
parent: parents
partake: partaking
partially: partially
participate: participate
partner: partner
party: party
pass: pass,passed,passes,passing
passenger: passenger
passion: passion,passions
passionately: passionately
path: path,paths
patience: patience
patient: patient
patiently: patiently
pause: pause
pavilion: pavilion
pay: paid,pay,paying
payment: payment,payments
peace: peace
peaceful: peaceful
peacefully: peacefully
peacock: peacocks
pearl: pearls
peel: peel,peels
pen: pen
penance: penance
penetrate: penetrated,penetrating
penitent: penitent,penitents
perceive: perceived
perfect: perfect,perfected
perfection: perfection
perfectly: perfectly
perform: perform,performed,performing
performance: performance,performances
perfume: perfume
perfumed: perfumed
periodic: periodic
perish: perish,perished,perishing
permanent: permanent
permission: permission
permit: permit,permitted
person: people,person
persuade: persuading
pestilence: pestilence
pet: petted
petition: petitioned
petrified: petrified
petrifying: petrifying
petty: petty
phrase: phrase
physical: physical
physician: physicians
pick: picked
picture: picture
piece: piece,pieces
pike: pike
pile: pile,piled
pilgrim: pilgrim,pilgrims
pilgrimage: pilgrimage,pilgrimages
pillow: pillows
pious: pious
pit: pit
pity: pitied,pity
plague: plague
plain: plain
plan: plan,planning,plans
plant: plant
play: play,played,playing,plays
player: player
pleasantly: pleasantly
pleasure: pleasure,pleasures
plentiful: plentiful
pluck: plucked
plunge: plunge,plunging
poem: poem
poetry: poetry
pointless: pointless
pointlessness: pointlessness
poison: poison,poisoned
polite: polite
politely: politely
ponder: pondered,pondering
ponderingly: ponderingly
poor: poor,poorer
pop: popped
pose: posed
position: position,positioned,positioning,positions
possess: possess,possessed
possession: possession,possessions
possibility: possibility
post: posted
potion: potion
potter: potter
pouch: pouch,pouches
poultry: poultry
pour: poured
poverty: poverty
power: power
powerful: powerful
practically: practically
practise: practise,practised,practising
praise: praise,praised
prajapati: prajapati
pray: praying,prays
prayer: prayer,prayers
precious: precious
precise: precise
precisely: precisely
precocious: precocious
predecessor: predecessor
prefer: prefer,preferred
preferred: preferred
pregnant: pregnant
prepare: prepare,prepared
prepared: prepared
preserve: preserve,preserved
presumable: presumable
pretend: pretended
pretty: pretty
prevail: prevailing
prevent: prevent
previous: previous
price: price
pride: pride
priest: priest,priests
prince: prince,princes
print: print,printed
prisoner: prisoner
pristine: pristine
privileged: privileged
proceed: proceed
process: process
processing: processing
produce: produce,produced
production: production
professor: professor
profit: profit,profits
profitable: profitable
progress: progress,progressed
prohibit: prohibited
prohibition: prohibition
project: project
prominently: prominently
promise: promises
promote: promoting
promotion: promotion
proofread: proofread
propel: propelling
proper: proper
properly: properly
property: properties,property
proprietary: proprietary
prosper: prosper
protect: protect,protected
protrude: protruding
proudly: proudly
prove: proven
provide: provide,providing
provision: provision,provisions
public: public
pull: pulled,pulling
pullen: pullen
pumpkin: pumpkin
punish: punish,punished
punitive: punitive
pupil: pupils
purchase: purchase
pure: pure,purer
purify: purified
purity: purity
purpose: purpose
pursue: pursued,pursuing
pursuer: pursuer
pus: pus
push: pushed
putrefaction: putrefaction
puzzle: puzzled
quality: quality
quench: quenched
question: question,questions
quick: quick
quiet: quiet
quietly: quietly
quietness: quietness
quoth: quoth
rabbit: rabbit
radiantly: radiantly
raft: raft
rage: rage
rain: rain
rainbow: rainbows
rainy: rainy
random: random
rank: rank
ranting: ranting
rapid: rapids
rare: rare
rarely: rarely
rational: rational
ray: rays
reach: reach,reached,reaches,reaching
read: read,reading,reads
readable: readable
readiness: readiness
ready: ready
real: real
realisation: realisation
realise: realised
reality: reality
realization: realization,realizations
realize: realized
realm: realm
reason: reason
reasonable: reasonable
rebirth: rebirths
reborn: reborn
rebuke: rebuke
receipt: receipt
receive: receive,received,receiving
reciprocate: reciprocate
recitation: recitation
recognise: recognise,recognised,recognising
red: red
reddishly: reddishly
redeem: redeemed
redistribute: redistribute,redistributing
redistributing: redistributing
redistribution: redistribution
reduce: reduce
reed: reeds
refer: refer
reference: references
reflect: reflected,reflecting
reflection: reflection
refresh: refreshed
refuge: refuge
refund: refund
refuse: refuse
regain: regained
regard: regard,regarded
register: registered
regulate: regulating
reject: rejected,rejecting
rejoice: rejoiced
rejuvenated: rejuvenated
relationship: relationships
relative: relative
release: release
reliable: reliable
relief: relief
relieve: relieve
religious: religious
reluctance: reluctance
remain: remain,remained,remaining,remains
remedy: remedies
remember: remember,remembered
remembered: remembered
remind: reminded
reminder: reminder
reminiscent: reminiscent
remote: remote
remove: remove,removed
rename: renamed
render: rendered
renew: renew,renewed
renounce: renounced
repeat: repeat,repeated,repeating
repentance: repentance
repetition: repetition,repetitions
replace: replace,replaced
replacement: replacement
reply: replied
report: reported,reports
represent: represented
representation: representations
reproach: reproach
repulsive: repulsive
request: request
require: require,required,requires
requirement: requirements
resemble: resembled,resembling
reside: reside
resistance: resistance
resolution: resolution
resound: resounded
respect: respect
respects: respects
rest: rest,rested,resting,rests
restless: restless
restlessness: restlessness
restriction: restrictions
retell: retold
retire: retired,retiring
retreat: retreated
return: return,returned,returning,returns
reveal: revealed
revel: revel
revenue: revenue
reward: reward
rice: rice
rich: rich,richer,richest
riches: riches
richness: richness
ridiculous: ridiculous
rig: rig
righteously: righteously
rigid: rigid
rigidly: rigidly
rip: ripped
ripen: ripened
rise: risen,rising,rose
river: river,rivers
riverbank: riverbank
road: road
roar: roared
robber: robber,robbers
robe: robe,robes
rock: rock,rocks
roll: roll,rolled,rolling
romain: romain
roof: roof
root: root
rope: ropes
rosy: rosy
rot: rot
rotten: rotten
roughly: roughly
roundness: roundness
royalty: royalties,royalty
ruin: ruins
rule: rule,rules
rumble: rumbling
rumour: rumour,rumours
rush: rushing
sacred: sacred
sacrifice: sacrifices,sacrificing
sacrificial: sacrificial
sad: sad
sadly: sadly
sadness: sadness
safe: safe
sail: sail
saint: saint
sake: sake
sakyamuni: sakyamuni
sal: sal
sale: sale,sales
salt: salt
salutation: salutation,salutations
salvation: salvation
sanctity: sanctity
sand: sand
sandy: sandy
sansara: sansara
satisfied: satisfied
satisfy: satisfied,satisfy
saturate: saturated
savage: savage
save: save
scared: scared
scatter: scattered
scene: scene
scent: scent
scholar: scholar
school: school
scold: scold,scolding
scolding: scolding
scorch: scorched
scorn: scorn,scorned,scorns
scream: scream,screamed,screams
scripture: scriptures
scroll: scroll
sea: sea
seam: seams
search: search,searched,searches,searching
searcher: searcher
searching: searching
season: season,seasons
seat: seat
secret: secret,secrets
secretly: secretly
secure: secure
sedan: sedan
seducer: seducer
seed: seeding,seeds
seek: seek,seeking,seeks,sought
seeker: seeker
seemingly: seemingly
sell: sold
send: send,sending
sensation: sensation,sensations
sense: sense,sensed,sensing
sensual: sensual
sentence: sentence
separate: separated,separating
separation: separation
sequence: sequence
sermon: sermon
servant: servant,servants
serve: serve,served
service: service
set: set,setting
settle: settled
sex: sex
sexual: sexual
sexuality: sexuality
shackle: shackle
shade: shade
shadow: shadow
shady: shady
shaggy: shaggy
shake: shake,shaking,shook
shameful: shameful
shape: shape,shaped
share: share,shared,sharing
shave: shave,shaved
shaven: shaven
sheep: sheep
shelter: shelter
shimmer: shimmered
shimmering: shimmering
shin: shins
shine: shine,shines,shining,shone
ship: ship
shipment: shipment
shipping: shipping
shiver: shiver,shivered,shivering,shivers
shocked: shocked
shoe: shoes
shop: shop
shore: shore
short: short
shot: shot
shoulder: shoulder,shoulders
shout: shouted,shouts
shudder: shuddering
shut: shut
shy: shy
sick: sick
sickliness: sickliness
sickness: sickness
siddhartha: siddhartha
sigh: sigh,sighed,sighing
sight: sight
silence: silence
silent: silent
silently: silently
silly: silly
silver: silver
simple: simple,simpler
simply: simply
simultaneous: simultaneous
simultaneously: simultaneously
simultaneousness: simultaneousness
sin: sin,sins
sinful: sinful
sing: sang,sing
singing: singing
single: single
singsong: singsong
singular: singular
sink: sink
sinner: sinner
sir: sir
sit: sat,sit,sitting
situation: situation
skeleton: skeleton
skill: skill,skills
skin: skin,skinned
skinny: skinny
sky: sky
sleep: sleep,sleeping,slept
sleepless: sleepless
slender: slender
slight: slight,slightest
slim: slim
slip: slip,slipped
sloth: sloth
slow: slow,slower
slowly: slowly
slumber: slumber
slurred: slurred
smart: smart,smarter,smartest
smash: smash,smashing
smell: smell,smelled
smile: smile,smiled,smiling
smoothly: smoothly
snake: snake,snakes
sneak: sneak
soap: soap
sob: sob
sobering: sobering
soft: soft
softly: softly
softness: softness
soil: soil,soiled,soiling
solely: solely
solemnity: solemnity
solicit: solicit
solicitation: solicitation
solid: solid
solve: solved
son: son,sons
song: song,songs
sorcerer: sorcerers
sorrow: sorrow
soul: soul
sound: sound,sounded,sounds
source: source,sources
space: space
spare: spare,spared
sparingly: sparingly
sparkle: sparkling
speak: speak,speaking,speaks,spoke,spoken
speaker: speaker
spear: spear
special: special
specific: specific
spectacle: spectacle
spectator: spectator
speech: speech,speeches
speed: sped,speed
spell: spell,spells
spend: spend,spent
spice: spices
spiral: spiral
spirit: spirit
spiritual: spiritual
spirituality: spirituality
spit: spit
spite: spite
splendid: splendid
splendour: splendour
split: split
sponge: sponge
spot: spot,spots
spread: spread,spreading,spreads
spring: sprang,spring
sprout: sprout
squander: squandering
square: squares
squeeze: squeeze
stable: stable
staff: staff
stain: stains
stair: stairs
stake: stakes
stale: stale
stammer: stammered
stammeringly: stammeringly
stand: stand,standing,stood
standstill: standstill
stank: stank
star: star,stars
stare: stared
starry: starry
start: start,started,starting,starts
startled: startled
statement: statements
status: status
stay: stay,stayed,staying
steal: steal,stole,stolen
stefan: stefan
stem: stem,stems
step: step,stepped,steps
stick: stuck
stiff: stiff
sting: stung
stir: stir,stirred,stirring
stirring: stirring
stomach: stomach
stone: stone,stones
storage: storage
store: stored
story: stories,story
stove: stove
straight: straight
straighten: straightened,straightening
strange: strange,strangest
strangely: strangely
stranger: stranger,strangers
straw: straw
stream: stream
street: street,streets
strength: strength
strengthen: strengthened
stretch: stretched
strict: strict
strictly: strictly
stride: strides
strike: strike,struck
strive: strive,striving
strong: strong,stronger,strongest
struggle: struggle,struggling
stubborn: stubborn
stubbornly: stubbornly
student: student,students
study: study
stuff: stuff
stupid: stupid
stupidity: stupidity
style: style
subdue: subdued
subject: subject
submerge: submerged
submergence: submergence
submission: submission
submissive: submissive
subscribe: subscribe
subservient: subservient
substance: substance
succeed: succeed,succeeded
success: success
succumb: succumbed
suck: suck,sucked,sucks
suddenly: suddenly
suffer: suffer,suffered,suffering
suffering: suffering
sufferingly: sufferingly
suicide: suicide
suitable: suitable
summon: summoned
sun: sun
sunrise: sunrise
sunset: sunset
sunshine: sunshine
superior: superior
superiority: superiority
supple: supple
support: support
suppose: supposed
surely: surely
surface: surface
surpass: surpassed
surround: surrounded
survive: survive
suspect: suspect,suspected
swamp: swamp
sweet: sweet,sweetest,sweets
sweetly: sweetly
sweetness: sweetness
swell: swollen
swiftly: swiftly
sword: sword
syllable: syllable
symbol: symbols
sympathy: sympathy
synonymous: synonymous
table: table
tackle: tackle
tale: tale,tales
talk: talk,talked,talking
tall: tall
tan: tanned
target: target
task: task
taste: taste,tasted
tavern: tavern
tax: tax,taxes
teach: taught,teach,teaches
teachable: teachable
teacher: teacher,teachers
teaching: teaching,teachings
tear: tears
temple: temple
tenacity: tenacity
tend: tended,tending
tendency: tendency
tender: tender
tenderly: tenderly
tenderness: tenderness
tense: tense
term: terms
terrible: terrible
terribly: terribly
textbook: textbooks
thankful: thankful
thicket: thicket
thief: thieves
thigh: thighs
thinker: thinker,thinkers
thinking: thinking
thirst: thirst,thirsted
thirsty: thirsty
thorny: thorny
thoughtful: thoughtful
thoughtfully: thoughtfully
threadbare: threadbare
threaten: threatened
throw: threw,throw,throwing,thrown
thump: thumped
tie: tie,tied
tiger: tiger
tilt: tilted
time: time,times
timid: timid
timidly: timidly
timidness: timidness
tiny: tiny
tired: tired
tiredly: tiredly
tiredness: tiredness
title: title
toe: toes
toil: toiling
toilsome: toilsome
tolerance: tolerance
tomorrow: tomorrow
tone: tone
tongue: tongue
tooth: teeth
torment: tormented,tormenting
torn: torn
torture: torture,tortured
touch: touch,touched,touching
tough: tough
tower: tower
town: town,towns
trace: traced
trade: trade,trading
trademark: trademark
trading: trading
train: train
trainee: trainee
tranquility: tranquility
transcendent: transcendent
transcribe: transcribe
transcription: transcription
transform: transformed
transformation: transformation,transformations
transitoriness: transitoriness
translator: translator
transmit: transmitted
transparent: transparent
transport: transported
travel: travelled,travelling
traveller: traveller,travellers
travels: travels
treasure: treasure,treasures
treat: treat,treated
treatment: treatment
tree: tree,trees
tremble: trembling
tremendous: tremendous
tremor: tremor
trick: trick
trifle: trifles
trip: trip
trouble: troubled
troubled: troubled
true: true
trunk: trunk
trust: trust
truth: truth
truthful: truthful
tumble: tumbles
twitch: twitched
type: types
ugliness: ugliness
ugly: ugly
ultimate: ultimate
ultimately: ultimately
unable: unable
unbearable: unbearable
unbelievable: unbelievable
uncertain: uncertain
unchanged: unchanged
unconscious: unconscious
unconsciousness: unconsciousness
undefeatable: undefeatable
understand: understand,understanding,understood
understandable: understandable
understanding: understanding
undertake: undertook
unenforceability: unenforceability
unexpressable: unexpressable
uniform: uniform
uniformity: uniformity
united: united
unity: unity
universe: universe
unknown: unknown
unlearn: unlearn
unleash: unleash
unlink: unlink
unmoved: unmoved
unpleasant: unpleasant
unprotected: unprotected
unrelenting: unrelenting
unrest: unrest
unsaid: unsaid
unsatisfiable: unsatisfiable
unselfish: unselfish
unsolicited: unsolicited
unsown: unsown
unsteadiness: unsteadiness
unstoppable: unstoppable
unsuccessfully: unsuccessfully
untouchable: untouchable
unworthy: unworthy
upanishad: upanishad
upbringing: upbringing
upcoming: upcoming
update: updated
upholster: upholstered
upper: upper
upright: upright
upriver: upriver
upset: upset
upward: upward
urge: urge,urged,urges
urgently: urgently
useless: useless
user: user
usual: usual
ut: ut
utter: utter,uttered,uttering
vacuous: vacuous
vain: vain
valuable: valuable
vanilla: vanilla
vanity: vanities,vanity
vapour: vapour
variety: variety
vasudeva: vasudeva
veda: veda
veil: veil
vein: veins
vendor: vendor
venerability: venerability
venerable: venerable
venerate: venerate,venerated
veneration: veneration
verily: verily
verse: verse,verses
version: version
vessel: vessel
vex: vexed
vice: vice,vices
viciousness: viciousness
victim: victim
victorious: victorious
victory: victory
view: viewed,viewing
vigour: vigour
village: village,villages
violate: violates
violently: violently
virtue: virtue,virtues
virus: virus
vishnu: vishnu
visible: visible
vision: vision
visit: visit,visited
visitor: visitor,visitors
voice: voice,voices
void: void
voluntarily: voluntarily
volunteer: volunteer,volunteers
vomit: vomits
vomiting: vomiting
vulture: vultures
wail: wailing
wait: wait,waited,waiting,waits
waiting: waiting
wake: wake,waking,woke,woken
walk: walk,walked,walking,walks
walking: walking
wall: wall
wander: wander,wandered
wane: waned
war: war,wars
warm: warmer
warmly: warmly
warn: warned
warning: warning,warnings
warranty: warranties,warranty
warrior: warrior,warriors
wash: wash,washed,washing
waste: waste,wasted,wasting
watch: watch,watched,watching
watchful: watchful
water: water,waters
waterfall: waterfall
wave: waves
waver: wavered,wavers
weak: weak
weaken: weakened
wealth: wealth
wear: wear,wearing,wore,worn
weary: weary
weave: weave,weaving,wove,woven
wedding: wedding,weddings
weep: weep,weeping,wept
weigh: weighed
weird: weird
west: west
wet: wet
wetness: wetness
whatsoever: whatsoever
wheel: wheel
whine: whining
whisper: whisper,whispered
white: white
whore: whores
whorehouse: whorehouses
wide: wide,widest
widespread: widespread
wife: wife
wiggle: wiggling
wild: wild
wilhelm: wilhelm
willingly: willingly
willingness: willingness
win: win
wind: wind
window: window
wine: wine
wisdom: wisdom
wise: wise,wiser,wisest
wisely: wisely
wither: withered,withering
withered: withered
woe: woe
woman: woman,women
womb: womb
wonderful: wonderful
wonderfully: wonderfully
wondrous: wondrous
wondrously: wondrously
wood: wood
wool: wool
word: word
worker: worker,workers
workings: workings
worldly: worldly
worried: worried
worry: worries,worry,worrying
worser: worser
worship: worship,worshipped
worshipper: worshipper
worth: worth
worthless: worthless
worthwhile: worthwhile
worthy: worthy
wound: wound,wounded,wounds
wrap: wrapped
wrestle: wrestled
wretched: wretched
wretchedness: wretchedness
wrinkle: wrinkles
wrist: wrists
write: write,writing,written,wrote
writing: writing
wrong: wrong
yearn: yearned
yearning: yearning
yellow: yellow
yesterday: yesterday
yoga: yoga
youth: youth
zeal: zeal
zealous: zealous
zealously: zealously
