abandon: abandon,abandoned
abandonment: abandonment
abase: abase,abased,abasing
abbey: abbey
abbot: abbots
abet: abetted
abhor: abhorring
abide: abide,abiding
abject: abject
abjection: abjection
ablative: ablative
ablaze: ablaze
abode: abode
abominable: abominable
abrupt: abrupt
abruptly: abruptly
absence: absence
absent: absent
absently: absently
absolutely: absolutely
absolution: absolution
absolve: absolve,absolved
absurdity: absurdity
abyss: abyss
accent: accent,accents
accept: accept,accepted,accepting
acceptable: acceptable
acceptance: acceptance
access: access,accessed
accessible: accessible
accident: accident,accidents
accompany: accompanying
accomplice: accomplices
accomplish: accomplished,accomplishing
account: account
accrue: accruing
accustomed: accustomed
ace: ace
ache: ache,ached,aching
achieve: achieve,achieving
acknowledgement: acknowledgement
acolyte: acolyte
acquaint: acquainted
acquiesce: acquiesced
acquiescence: acquiescence
acquire: acquired
acquisition: acquisition
acre: acre
action: action
active: active
activity: activity
actor: actor,actors
actual: actual
adam: adam
add: add
addison: addison
addition: addition,additions
additional: additional
address: address,addressed,addresses,addressing
adelphi: adelphi
adieu: adieu
admiration: admiration
admire: admire,admired
admirer: admirer
admit: admit
admixture: admixtures
admonition: admonition
adolescence: adolescence
adoration: adoration
adorn: adorned
adrift: adrift
adulterer: adulterer
adulterous: adulterous
advance: advance,advanced,advancing
advent: advent
adventure: adventure,adventures
adventurer: adventurers
advice: advice
afar: afar
affair: affair,affairs
affection: affection,affections
afflict: afflict,afflicted
aflame: aflame
afraid: afraid
africa: africa
afterglow: afterglow
afternoon: afternoon
age: age,ages
aged: aged
ageing: ageing
agelong: agelong
agent: agent,agents
agile: agile
agitation: agitation
aglow: aglow
agonising: agonising
agony: agony
agree: agree,agreed
agreement: agreement
aid: aid,aided,aiding
aim: aim,aimed
air: air,airs
airy: airy
aisle: aisle
ajar: ajar
akin: akin
alarm: alarm,alarmed
alas: alas
ale: ale
alec: alec
alert: alert
alien: alien,aliens
alight: alighting
alike: alike
allay: allayed,allaying
allen: allen
alley: alley
allude: allude
allure: allured
alluring: alluring
allusion: allusion,allusions
ally: ally
almighty: almighty
almond: almonds
alms: alms
aloft: aloft
aloof: aloof
aloud: aloud
aloysius: aloysius
altar: altar
alteration: alteration
alternate: alternate
alternation: alternation
altruism: altruism
amass: amass
amateur: amateur
ambition: ambition,ambitions
amble: ambling
amen: amen
amend: amend,amended
amendment: amendment
america: america
american: american
amiably: amiably
amuse: amuses
amusing: amusing
analyse: analysed
analysis: analysis
anatomy: anatomy
ancestor: ancestors
anchor: anchored
ancient: ancient
anew: anew
angel: angel,angels
angelic: angelic
angelical: angelical
angels: angels
anger: anger
angle: angles
angrily: angrily
angry: angry
anguish: anguish
anguished: anguished
animal: animal,animals
annoy: annoyed
annoyed: annoyed
annual: annual
anoint: anoint,anointed
anselm: anselm
answer: answer,answered,answering,answers
antagonism: antagonism
antelope: antelopes
anthony: anthony
anticipation: anticipation
antisocial: antisocial
antlike: antlike
anxious: anxious
ape: ape
apelike: apelike
apologise: apologise,apologised
apostle: apostle
apostleship: apostleship
apparatus: apparatus
apparel: apparel
appeal: appeal,appealed,appealing
appearance: appearance
appease: appease,appeased
appetite: appetite
applause: applause
apple: apple,apples
applicable: applicable
apply: applied,apply
appoint: appointed
apprehend: apprehend,apprehended
apprehension: apprehension,apprehensions
approach: approach,approached,approaching
approve: approve
april: april
apron: apron
aquinas: aquinas
arab: arabs
arbitration: arbitration
arbour: arbour
arcade: arcade
arch: arch,arches
archangel: archangel,archangels
archangelical: archangelical
archive: archive
ardent: ardent
ardour: ardour
argue: argue,arguing
arid: arid
aristotle: aristotle
ark: ark
arm: arm,armed,arms
armchair: armchair
armed: armed
armour: armour
armpit: armpit,armpits
armrest: armrest
army: army
aromatic: aromatic
arrange: arrange,arranged
arras: arras
array: array,arrayed
arrest: arrest,arrested,arrests
arrival: arrival
arrive: arrive,arrived
arrow: arrow
arse: arse
art: art,arts
article: articles
artificer: artificer
artillery: artillery
artist: artist
artistic: artistic
ascend: ascend,ascended,ascending
ascent: ascent
ascertain: ascertain
ascii: ascii
ash: ashes
ashamed: ashamed
ashplant: ashplant
asiatic: asiatic
askance: askance
asleep: asleep
aspiration: aspirations
assail: assailed,assailing
assemble: assembled
assert: asserted
assiduous: assiduous
assign: assign
assistance: assistance
associate: associate
association: associations
assume: assumed,assumes
assuredly: assuredly
astir: astir
astonished: astonished
astonishment: astonishment
astray: astray
asunder: asunder
atheist: atheist,atheists
athlete: athlete
athletic: athletic
athletics: athletics
athwart: athwart
atom: atoms
atone: atoned
atonement: atonement
atrocity: atrocity
attach: attached
attack: attacked,attacks
attain: attain
attempt: attempt
attend: attend,attended,attending,attends
attendant: attendants
attention: attention
attitude: attitude
attract: attract,attracted
attraction: attraction
attribute: attribute,attributes
aubrey: aubrey
auburn: auburn
auction: auction
audible: audible
audience: audience
aught: aught
augur: augur
augury: augury
august: august
augustine: augustine
aunt: aunt
author: author
authority: authority
autumn: autumn
autumnal: autumnal
avail: avail,availed
avenger: avenger
avenue: avenue,avenues
avert: averted
avid: avid
avoid: avoid
await: awaited,awaiting
awake: awake,awoke
awaken: awaken,awakened,awakens
aware: aware
awe: awe
awful: awful
awhile: awhile
awkwardly: awkwardly
awry: awry
axis: axes
ay: ay
azure: azure
baaing: baaing
babble: babble
baby: baby
babylonian: babylonian
backdoor: backdoor
background: background
backhand: backhand
backless: backless
backside: backside
bacon: bacon
baculus: baculus
bad: bad,worse,worst
badge: badge
baffle: baffled
bag: bag
bah: bah
baize: baize
bake: bake
balance: balance
balanced: balanced
balcony: balconies,balcony
bald: bald
baldhead: baldhead
baldwin: baldwin
baldy: baldy
bale: bales
balefire: balefire
balk: balked
ball: ball,balls
ballad: ballad
ballock: ballocks
bally: bally
balmy: balmy
balsamum: balsamum
band: band,bands
bang: bang,banged
banish: banish
bank: bank,banked
bankrupt: bankrupt
banter: banter
baptise: baptised,baptising
baptism: baptism
baptist: baptists
bar: bar,barred,bars
barbed: barbed
barbell: barbells
bare: bare,bared
barefoot: barefoot
barefooted: barefooted
bareheaded: bareheaded
bark: bark
barmaid: barmaids
barman: barmen
barrack: barrack
barrel: barrels
barren: barren
barrett: barrett
barrier: barriers
barter: bartered
barton: barton
base: base,based
bashful: bashful
basin: basin,basins
basket: basket,baskets
bass: bass
bat: bats
bath: bath
batlike: batlike
batter: battered
battered: battered
battle: battle,battles,battling
battlefield: battlefield,battlefields
bawl: bawl,bawling
bay: bay
bazaar: bazaars
beach: beach
bead: beads
beak: beak,beaked,beaks
bear: bear,bearing,bears,bore,born,borne
beard: beard,beards
bearded: bearded
bearing: bearing
beast: beast,beasts
beastlike: beastlike
beat: beat,beaten,beating
beatific: beatific
beatitude: beatitude
beautiful: beautiful
beautifully: beautifully
beauty: beauty
beckon: beckoned
bed: bed,beds
bedad: bedad
bedclothes: bedclothes
bedimmed: bedimmed
bedroom: bedroom
bedside: bedside
beer: beer
beg: beg,begged
beget: begat,begetting
beggar: beggar,beggars
begotten: begotten
behave: behave,behaved
behold: beheld,behold
belfast: belfast
belgium: belgium
belief: belief
believer: believer,believers
bell: bell,bells
bellied: bellied
belly: belly
belong: belong,belonged
beloved: beloved
belt: belt
belted: belted
belvedere: belvedere
ben: ben
bench: bench,benches
bend: bend,bending,bent
beneath: beneath
benediction: benediction
benefit: benefit
benevolent: benevolent
benevolently: benevolently
bent: bent
benumb: benumbed
bergamasca: bergamasca
berretta: berretta
bertie: bertie
beseech: beseech,besought
beset: beset
besiege: besieged
besmear: besmeared
besotted: besotted
bestial: bestial
bestiality: bestiality
bestially: bestially
bestow: bestow,bestowed
bet: bet,bets
betray: betray,betrayed
betty: betty
bewail: bewail
beware: beware
bible: bible
bicycle: bicycle
bid: bade,bid,bidden,bidding
bidden: bidden
bidding: bidding
bike: bike
billiard: billiard
billiards: billiards
billy: billy
binary: binary
bind: bind,binding,bound
bird: bird,birds
birth: birth
birthday: birthday
biscuit: biscuit
bishop: bishop,bishops
bit: bit,bits
bitch: bitch,bitches
bite: bit,bitten
bitter: bitter
bitterly: bitterly
bitterness: bitterness
black: black,blackest
blacken: blackened
blackguard: blackguard
blackish: blackish
blake: blake
blame: blame
blandly: blandly
blank: blank
blanket: blanket,blankets
blankety: blankety
blarney: blarney
blasphemer: blasphemer
blasphemous: blasphemous
blasphemy: blasphemies,blasphemy
blast: blast,blasts
blaze: blaze
blazer: blazers
bleak: bleak
bleakly: bleakly
bleat: bleating
bless: bless,blessed
blessed: blessed
blessing: blessing
blind: blind,blinded,blinds
blindly: blindly
blink: blinking
bliss: bliss
blithely: blithely
blither: blithering
bloated: bloated
block: block
blood: blood
bloodless: bloodless
bloody: bloody
bloom: bloom
blossom: blossoming,blossoms
blot: blot
blow: blew,blow,blowing,blown,blows
blue: blue
bluish: bluish
blunder: blundering
blunt: blunt
bluntly: bluntly
bluntness: bluntness
blush: blush,blushed,blushing
board: board,boarded,boards
boarder: boarder
boat: boat
bob: bob,bobbing
bobbin: bobbins
bodily: bodily
body: bodies,body
bog: bogs
boghole: boghole
boil: boiling,boils
bold: boldest
boldly: boldly
bolster: bolster
bonaventure: bonaventure
bond: bond,bonds
bone: bone
bonnet: bonnet
bonum: bonum
bony: bony
boody: boody
booing: booing
book: book,booked,books
bookcase: bookcases
boorish: boorish
boot: boots
booth: booth
bore: bore
borrow: borrowed
borrower: borrowers
bosom: bosom
boss: boss
botany: botany
bother: bother
bottle: bottle,bottles
bottomless: bottomless
bough: boughs
bounce: bouncing
bound: bound,bounded,bounding
boundless: boundless
boundlessness: boundlessness
bounty: bounty
bout: bout
bovine: bovine
bow: bow,bowed,bowing
bowels: bowels
bower: bower
bowl: bowl
bowling: bowling
bowstring: bowstring
box: box,boxes
boy: boy,boys
boyhood: boyhood
boyish: boyish
brackish: brackish
brain: brain,brains
brake: brake
bran: bran
branch: branch,branches
branching: branching
brand: brand
brass: brass,brasses
bravely: bravely
bravo: bravo
bray: bray
brazen: brazen
breach: breach
bread: bread
breadbasket: breadbasket
break: break,breaking,broke,broken
breakfast: breakfast
breakneck: breakneck
breakwater: breakwater
breast: breast,breasts
breastbone: breastbone
breath: breath
breathe: breathe,breathed,breathing
breathing: breathing
breathless: breathless
breeches: breeches
breed: bred,breed
breeze: breeze
brethren: brethren
brick: brick
bride: bride
bridge: bridge,bridged
bright: bright,brighter
brightly: brightly
brightness: brightness
brigid: brigid
brilliant: brilliant
brim: brim,brimming
brimless: brimless
brimstone: brimstone
brine: brine
bring: bring,bringing,brings,brought
brisk: brisk
briskly: briskly
bristle: bristling
brittle: brittle
broad: broad
broaden: broadened
broadly: broadly
broke: broke
broken: broken
brood: brood,brooded,brooding,broods
brooding: brooding
brothel: brothels
brother: brother,brothers
brotherhood: brotherhood
brothers: brothers
brow: brow,brows
brown: brown
browsing: browsing
bruise: bruised
bruno: bruno
brush: brush,brushed,brushes
brutal: brutal
brutally: brutally
brute: brutes
brutelike: brutelike
brutish: brutish
bubble: bubble,bubbling
buck: buck
bucket: bucket
bucketful: bucketful
buddhist: buddhists
budding: budding
buff: buff
build: build,building,built
building: building
bulge: bulged
bull: bull
bum: bum
bump: bump,bumped
bunch: bunch,bunches
bunt: bunting
burden: burden
burly: burly
burn: burn,burned,burning,burns
burning: burning
bursar: bursar
burst: burst,bursting,bursts
bury: buried,bury
bush: bush,bushes
bushel: bushel
business: business
buskin: buskins
bust: bust
bustle: bustle,bustled
bustling: bustling
busy: busied,busy
butcher: butcher
butler: butler
butt: butt,butts
butter: butter,buttered
button: buttoned,buttons
buttonhole: buttonhole
bye: bye
byron: byron
bystander: bystanders
bystreet: bystreet
cabbage: cabbage,cabbages
cabin: cabin
cabinet: cabinet
cable: cables
cachou: cachou
cackle: cackling
cadence: cadence,cadences
cage: cage
cajole: cajole
cake: cake,cakes
calculate: calculate,calculated
calculation: calculations
calf: calf
calico: calico
calling: calling
calm: calm,calming
calmly: calmly
calumnious: calumnious
calvary: calvary
caman: caman
campbell: campbell
canal: canal
cancer: cancer
candle: candle,candles
candlestick: candlestick,candlesticks
cane: cane
canister: canisters
canker: canker
canon: canon
canonical: canonical,canonicals
canopy: canopy
canticle: canticles
canvas: canvas
cap: cap,caps
capable: capable
caper: caper,capered,capering
capital: capital
captain: captain
captive: captive
captivity: captivity
capture: capture
capuchin: capuchin
capuchins: capuchins
car: car,cars
caravan: caravans
carcass: carcasses
card: card,cards
cardboard: cardboard
cardiac: cardiac
cardinal: cardinal
care: care,cared,cares
career: career
careful: careful
carefully: carefully
carelessly: carelessly
carelessness: carelessness
caress: caress,caressed,caresses
caressing: caressing
carmelite: carmelite
carmine: carmine
carnal: carnal
carnival: carnival
carpenter: carpenter,carpenters
carpet: carpet
carriage: carriage
carrot: carrots
carry: carried,carries,carry,carrying
cart: carts
carver: carvers
casey: casey
cash: cash
cask: cask
cast: cast,casting,casts
castle: castle
casual: casual
cat: cat
catacombs: catacombs
catafalque: catafalque
catcall: catcalls
catch: catch,caught
catchword: catchwords
catechism: catechism,catechisms
catherine: catherine
catholic: catholic,catholics
cattle: cattle
caught: caught
cavalry: cavalry
cave: cave,caves
cavern: cavern,caverns
cease: cease,ceased
ceaseless: ceaseless
cecil: cecil
cedrus: cedrus
celebrant: celebrant
celebrate: celebrate
celery: celery
cell: cell
cemetery: cemetery
censer: censer
central: central
centre: centre,centres
century: centuries,century
cerement: cerements
ceremony: ceremony
certificate: certificate
certitude: certitude
cessation: cessation
cesspool: cesspool
chain: chain
chainless: chainless
chair: chair,chairs
chalice: chalice
chalk: chalks
challenge: challenge
chamber: chamber,chambering
chambering: chambering
champagne: champagne
chance: chances
chandelier: chandelier,chandeliers
change: change,changed,changing
channel: channel
chant: chant,chanting
chaos: chaos
chap: chap,chaps
chapel: chapel
chaplet: chaplets
chapter: chapter
character: character,characters
characterless: characterless
charcoal: charcoal
charge: charge,charged,charges,charging
charitable: charitable
charity: charities
charles: charles
charming: charming
chase: chase
chastisement: chastisement
chasuble: chasuble
chat: chatted,chatting
cheap: cheap
cheaply: cheaply
check: check,checked,checks
cheek: cheek,cheeks
cheer: cheer,cheered,cheering,cheers
cheerily: cheerily
cheerless: cheerless
cheerlessly: cheerlessly
chemical: chemical
cherubim: cherubim
chess: chess
chest: chest
chestnut: chestnut
chew: chewed,chewing
chiding: chiding
chief: chief
chiefly: chiefly
chieftain: chieftain
child: child,children
childhood: childhood
childish: childish
chill: chill
chilled: chilled
chilly: chilly
chime: chime
chin: chin
china: china
chine: chines
chinese: chinese
chink: chink
chivalry: chivalry
chocolate: chocolate
choice: choice
choir: choir,choirs
choke: choked,choking
choose: choose,choosing,chose,chosen
chord: chord,chords
christ: christ
christendom: christendom
christian: christian
christmas: christmas
christopher: christopher
christy: christy
chronicle: chronicled
church: church
churchyard: churchyard
ciborium: ciborium
cigar: cigar,cigars
cigarette: cigarette,cigarettes
cinder: cinders
cinnamomum: cinnamomum
circle: circle,circled,circles,circling
circling: circling
circumfluent: circumfluent
circumstance: circumstance,circumstances
citadel: citadel
city: cities,city
civil: civil
clack: clacking
claim: claim,claims
clamber: clambered
clamorous: clamorous
clamour: clamour,clamouring
clap: clapped
clapping: clapping
clark: clark
clash: clashes
clasp: clasp,clasping
clasped: clasped
class: class,classes
classical: classical
classmate: classmate,classmates
classroom: classroom
clatter: clatter,clattering
claude: claude
clay: clay
clean: clean
cleanse: cleanse
cleave: cleaving,clove,cloven
cleft: cleft
clench: clenched,clenching
clenched: clenched
clergy: clergy
clerical: clerical
clever: clever
cliff: cliffs
climb: climbed,climbing
cling: clinging
clip: clipped
cloak: cloak
clock: clock
clodhopper: clodhoppers
clogging: clogging
cloister: cloister,cloisters
cloistral: cloistral
close: close,closed,closer,closes,closing
closed: closed
closely: closely
closet: closet,closets
closing: closing
closure: closure
clot: clots
cloth: cloth
clothe: clad,clothed
clothes: clothes
cloud: cloud,clouds
cloudlet: cloudlets
cloudlike: cloudlike
cloudy: cloudy
clownishly: clownishly
club: club,clubs
clumsy: clumsy
cluster: clusters
coachman: coachman
coal: coal,coals
coarse: coarse,coarser
coarsely: coarsely
coat: coat,coated,coats
cobble: cobbled
cobweb: cobweb
cobwebbed: cobwebbed
cock: cock,cocks
cocked: cocked
cocoa: cocoa
cocoon: cocoon
cod: cod
code: codes
coefficient: coefficient
coexistent: coexistent
coffeehouse: coffeehouse
coffer: coffers
coffin: coffin
coherent: coherent
cohort: cohort
coil: coil,coiling,coils
coin: coin,coins
coincide: coincide
col: col
cold: cold,colder
coldly: coldly
collar: collar,collars
collect: collected
collection: collection
collectively: collectively
college: college,colleges
collins: collins
collywobbles: collywobbles
colonnade: colonnade
colour: colour,coloured,colours
coloured: coloured
colourless: colourless
column: column
combat: combat
combine: combine
combustible: combustible
comeliness: comeliness
cometh: cometh
comfort: comfort,comforts
comic: comic
comically: comically
comma: commas
command: command,commands
commandment: commandment
comment: comments
commercial: commercial
commingle: commingled
commiseration: commiseration
commission: commissions
commit: commit,committed
committed: committed
common: common,commons
commonwealth: commonwealth
commune: communed,communing
communicant: communicant
communicate: communicate
communion: communion,communions
community: community
compact: compact
companion: companion,companions
companionless: companionless
companionship: companionship
company: companies,company
compare: compared
comparison: comparison,comparisons
compass: compass
compassion: compassion
compassionate: compassionate
compatible: compatible
compilation: compilation
complacently: complacently
complain: complain,complained,complaining
complex: complex
complexity: complexity
compliance: compliance
compliment: compliments
comply: comply,complying
compose: composed
composition: composition
composure: composure
compound: compound
comprehend: comprehend
compress: compressed
comrade: comrades
comradeship: comradeship
conceive: conceive,conceived
concept: concept
conception: conception
concern: concerned
concertina: concertina
conclusively: conclusively
condemn: condemned
condemnation: condemnation
condense: condensed
condition: condition,conditions
conduct: conduct
conductor: conductor
confess: confess,confessed,confessing
confession: confession,confessions
confessional: confessional,confessionals
confessor: confessor,confessors
confidence: confidence
confident: confident
confine: confine
confirm: confirm,confirmed
confirmation: confirmation
confiteor: confiteor
conflagration: conflagration
confound: confounded
confuse: confused
confused: confused
confusedly: confusedly
confusion: confusion
congeal: congealing
connexion: connexion
connotation: connotation
conqueror: conqueror
conscience: conscience
conscious: conscious
consciously: consciously
consciousness: consciousness
consecrate: consecrated
consent: consent
consequence: consequences
consequential: consequential
considerable: considerable
consist: consists
constabulary: constabulary
constant: constant
constantly: constantly
constitutional: constitutional
constrain: constrained
construe: construe
consume: consumed,consumes
consumptive: consumptive
contact: contact
contemplate: contemplating
contemplation: contemplation
contempt: contempt
content: content
contented: contented
contentedly: contentedly
contents: contents
continent: continents
continual: continual
continually: continually
continue: continue,continued
contorted: contorted
contract: contract
contrary: contraries,contrary
contribution: contributions
contrite: contrite
contrition: contrition
control: control
convent: convent
converse: conversing
conversion: conversions
convert: convert,converted
conviction: conviction
convulsion: convulsion
convulsively: convulsively
cool: cool
coolly: coolly
cope: cope
copious: copious
copper: copper
copt: copt
copybook: copybook
copying: copying
copyright: copyright
corbet: corbet
cord: cord
cordial: cordial
cordially: cordially
corduroy: corduroy
core: core
cork: cork,corks
corn: corns
cornelius: cornelius
corner: corner,corners
cornwallis: cornwallis
corolla: corolla
coronal: coronals
corporation: corporation
corpse: corpse,corpses
corpus: corpus
correct: correct,corrected,corrects
correction: corrections
correspond: correspond
correspondence: correspondence
corridor: corridor,corridors
corrugated: corrugated
corrupt: corrupt
corruption: corruption
cost: cost,costs
cottage: cottage,cottages
cotton: cotton
cough: cough,coughed,coughing,coughs
counsel: counsel,counselled,counsels
count: count
counter: counter
counteract: counteracting,counteracts
countless: countless
country: countries,country
countryman: countryman,countrymen
county: county
couple: coupling
couplet: couplet
courage: courage
court: court,courts
courteous: courteous
courtesy: courtesy
courtly: courtly
cousin: cousin,cousins
covenant: covenant
covent: covent
cover: cover,covered,covering,covers
covering: covering
coverlet: coverlet
covet: covet,coveted
covetousness: covetousness
cow: cow,cows
cowardice: cowardice
cowardly: cowardly
cower: cowered,cowering
cowhouse: cowhouse
cowl: cowl
cowled: cowled
cowyard: cowyard
crack: crack,cracked,cracking
cracker: crackers
cradle: cradle
craft: craft
cramped: cramped
crane: crane,craning
crankery: crankery
crash: crash
crashing: crashing
crave: crave,craved
craving: craving
crawl: crawled
crayon: crayons
creak: creaked,creaking
cream: cream
creamy: creamy
crease: creased
create: create,created,creating
creation: creation
creator: creator
creature: creature,creatures
credit: credit
credo: credo
creep: creep,creeping,crept
crest: crest
crevice: crevice
cricket: cricket
cricketer: cricketers
crime: crime,crimes
criminal: criminal
crimped: crimped
crimson: crimson
cripes: cripes
crisis: crises
crisp: crisping
crisply: crisply
critic: critics
critical: critical
critically: critically
criticism: criticism
crocodile: crocodile,crocodiles
crony: cronies
crook: crook
crookedly: crookedly
croon: crooned,crooning
crop: cropping
crosby: crosby
cross: cross,crossed,crossing
crouch: crouched,crouching
crowd: crowd,crowds
crowded: crowded
crown: crown,crowned
crowning: crowning
crucifix: crucifix
crucify: crucified,crucifies
crude: crude
cruel: cruel
cruelty: cruelty
crumble: crumble,crumbled
crumple: crumple,crumpled
crush: crush,crushed
crust: crusted,crusts
cue: cue
cuff: cuffs
cullen: cullen
culture: culture
cultus: cultus
cum: cum
cumbrous: cumbrous
cunning: cunning
cup: cup,cups
cupressus: cupressus
curbstone: curbstones
cure: cured
curfew: curfew
curiosity: curiosity
curious: curious
curl: curl,curled,curling,curls
curly: curly
current: current,currents
curry: curry
curse: curse,cursed,curses
curtain: curtain,curtains
curtseying: curtseying
curve: curve,curves,curving
curved: curved
curving: curving
cushion: cushioned
cusp: cusped
custom: custom
cut: cut,cuts,cutting
cycle: cycle,cycles
cyclic: cyclic
cycling: cycling
cynically: cynically
da: da
dabble: dabbling
daily: daily
dainty: dainty
dairy: dairy
dais: dais
dalmatic: dalmatic
dam: dam
damage: damage
damaged: damaged
damages: damages
damascus: damascus
damn: damn
damnation: damnation
damned: damned
damp: damp
dan: dan
dance: dance,danced,dancing
dancer: dancers
dancing: dancing
dandyish: dandyish
danes: danes
danger: danger,dangers
dangerous: dangerous
dangle: dangling
dangling: dangling
dank: dank
dante: dante
dappled: dappled
daresay: daresay
dark: dark,darker
darken: darkened,darkening
darkly: darkly
darkness: darkness
dart: darting
darting: darting
datum: data
daughter: daughter,daughters
david: david
dawn: dawn
day: day,days
daydream: daydream
daylight: daylight
deacon: deacon
dead: dead
deadly: deadly
deaf: deaf
deal: deal,dealt
dealer: dealer
dean: dean
dearly: dearly
dearness: dearness
death: death,deaths
deathbed: deathbed
debt: debts
decanter: decanter
decay: decay
decaying: decaying
deceive: deceived
december: december
decency: decency
decent: decent,decentest
decide: decide
deck: deck
declare: declare,declared
decline: decline
decollate: decollated
decollation: decollation
decompose: decomposing
decomposition: decomposition
decree: decreed
dedicate: dedicated
deductible: deductible
deed: deed,deeds
deem: deemed
deep: deep,deeper,deepest
deepen: deepen,deepened,deepening
deeply: deeply
defect: defect,defects
defective: defective
defence: defence
defend: defend
defer: deferred
deference: deference
defile: defile,defiled,defiles
define: defined
definite: definite
definition: definition,definitions
deflower: deflower
deform: deformed
deft: deft
deftly: deftly
defy: defy
degraded: degraded
degrading: degrading
degree: degree
dei: dei
dejected: dejected
dejection: dejection
delegate: delegates
deletion: deletions
deliberate: deliberate
deliberately: deliberately
delicacy: delicacies,delicacy
delicate: delicate
delicately: delicately
delight: delight,delighted
delighted: delighted
delightedly: delightedly
delightful: delightful
deliver: deliver,delivered
deliverance: deliverance
delving: delving
demand: demand,demands
demeanour: demeanour
democrat: democrat
demon: demon,demons
demure: demure
demurely: demurely
den: den
denary: denaries
denial: denial
denounce: denounce,denounced
dense: dense
deny: denied
depart: depart
departure: departure
depend: depend,depends
depress: depress,depressed
deprive: deprived
depths: depths
derivative: derivative
derive: derive,derived
descend: descend,descended,descending
descendant: descendant
description: descriptions
desecration: desecration
desert: desert,deserts
deserted: deserted
deserving: deserving
design: design,designed,designs
desire: desire,desired,desires
desirously: desirously
desist: desist,desisting
desk: desk,desks
desolate: desolate
desolating: desolating
desolation: desolation
despair: despair
despairing: despairing
despondent: despondent
destine: destined
destiny: destiny
destroy: destroy,destroys
destruction: destruction
desuetude: desuetude
detach: detach,detached,detaching
detain: detain,detained,detaining
detection: detection
determine: determine,determined
detest: detest
deucedly: deucedly
deus: deus
device: device
devil: devil,devils
devious: devious
devotedly: devotedly
devotion: devotion
devotional: devotional
devotions: devotions
devour: devoured,devours
devout: devout
dew: dew
dewlap: dewlaps
dewy: dewy
diagram: diagrams
dial: dial
diamond: diamonds
dice: dice
dictionary: dictionaries
didactic: didactic
die: die,died,dies,dying
difference: difference
difficult: difficult
difficulty: difficulty
diffident: diffident
diffuse: diffused,diffusing
dig: digged,dug
digest: digest
dignity: dignity
dilate: dilated
dim: dim,dimmed,dimmer
diminished: diminished
dimly: dimly
dimple: dimples
din: din
dine: dining
dingdong: dingdong
dinner: dinner
dint: dint
diorama: diorama
dip: dip
diplomacy: diplomacy
dire: dire
direct: direct,directed
direction: direction,directions
director: director
dirty: dirty
disappear: disappearing
disappointment: disappointment
disapprove: disapprove
disarmament: disarmament
disband: disband
disbelieve: disbelieve
discard: discarded
discern: discerning
discharging: discharging
disciple: disciple
discipline: discipline
disclaim: disclaim
disclaimer: disclaimer,disclaimers
disclose: disclosed
discontinue: discontinue
discourage: discouraging
discouraged: discouraged
discover: discover,discovered
discoverer: discoverer
discovery: discovery
discreet: discreet
discreetly: discreetly
discuss: discuss,discussing
discussion: discussion
disdain: disdain
disease: disease,diseases
diseases: diseases
disgust: disgust,disgusted
dish: dish,dishes
dishearten: disheartened
disheartening: disheartening
dishonour: dishonour
dishonourable: dishonourable
dishonoured: dishonoured
disingenuous: disingenuous
disinterred: disinterred
disjointed: disjointed
disk: disk
dislike: dislike
dislodge: dislodged
disloyalty: disloyalty
dismantle: dismantle
dismay: dismay
dismount: dismounted
disobedience: disobedience
disobey: disobey,disobeyed
disorder: disorder
dispassionate: dispassionate
dispassionately: dispassionately
display: display,displayed,displaying
displease: displease,displeased
disposition: disposition
dispossession: dispossession
dispute: disputes,disputing
disquieted: disquieted
disremember: disremember
dissatisfaction: dissatisfaction
dissenter: dissenters
dissertation: dissertations
dissipate: dissipated
dissolve: dissolved,dissolves,dissolving
dissolving: dissolving
distance: distance
distant: distant
distil: distilled
distillery: distillery
distinct: distinct
distinctly: distinctly
distinguish: distinguish,distinguished
distinguished: distinguished
distort: distorted
distorted: distorted
distractedly: distractedly
distraction: distraction
distressing: distressing
distribute: distribute,distributed,distributing
distribution: distribution
distributor: distributor
disturb: disturbed
ditch: ditch
diver: diver
divert: divert
divest: divested,divesting
divi: divi
divide: divided,divides
divine: divine,divined,divining
divinity: divinity
divisible: divisible
dizzily: dizzily
dock: docks
docket: dockets
doctor: doctor
doctrine: doctrine,doctrines
document: document
doddering: doddering
dodge: dodged
dog: dog,dogs
dogma: dogmas
dogmatist: dogmatists
doll: doll,dolls
domain: domain
dome: dome
domination: dominations
domini: domini
dominic: dominic
dominican: dominican
dominos: dominos
donate: donate
donation: donation,donations
donor: donors
donovan: donovan
doom: doom
doomsday: doomsday
door: door,doors
doorway: doorway,doorways
dormitory: dormitory
doth: doth
double: double,doubling
doubt: doubt,doubted,doubting,doubts
dove: dove
dovetail: dovetailed
downcast: downcast
download: downloading
downward: downward
doyle: doyle
doze: dozed
dozen: dozen
drag: dragged,dragging
drain: drain,drained
dramatic: dramatic
drape: draped
draught: draught,draughts
draw: draw,drawing,drawn,drew
drawer: drawers
drawing: drawing
drawl: drawl
drawling: drawling
dray: dray
dread: dread,dreaded,dreads
dreadful: dreadful
dreadfully: dreadfully
dream: dream,dreamed,dreams
dreamless: dreamless
dreary: drearier
dregs: dregs
drench: drenched
dress: dress,dressed,dressing
dresser: dresser
drift: drift,drifted,drifting
drily: drily
drink: drank,drink,drunk
drinker: drinker
drinking: drinking
dripping: dripping
drive: drive,driven,drives,driving,drove
drivel: drivel
driver: driver,drivers
droll: droll
droning: droning
drop: drop,dropped,drops
dross: dross
drownd: drownded
drunk: drunk
drunken: drunken
dry: dried,dry
dryness: dryness
dual: dual
dubitative: dubitative
dublin: dublin
duck: duck
duke: duke
dull: dull
dullard: dullards
dullness: dullness
dumb: dumb
dumbbell: dumbbell,dumbbells
dun: dun
duncan: duncan
dunce: dunce
dung: dung
dunghill: dunghill
dupe: duped,dupes
duration: duration
dusk: dusk
dusky: dusky
dust: dust
dusty: dusty
dutiful: dutiful
duty: duties,duty
dwarf: dwarf
dwarfish: dwarfish
dwell: dwell,dwelt
dwelling: dwelling
dyas: dyas
eager: eager
eagerly: eagerly
eagerness: eagerness
eagle: eagle,eagles
ear: ear,ears
earl: earl
earn: earn,earned
earnestly: earnestly
earth: earth
earthen: earthen
earthly: earthly
ease: ease,eased
easily: easily
east: east
easter: easter
easy: easier,easy
eat: ate,eat,eaten,eating,eats
eater: eater
eave: eave
eaves: eaves
ebb: ebbing
ebonite: ebonite
ecclesiastes: ecclesiastes
echo: echo,echoed,echoes
economics: economics
ecstasy: ecstasy
eddy: eddied,eddies
eden: eden
edge: edge,edges
edition: edition,editions
education: education
educational: educational
efface: effaced
effort: effort,efforts
egg: eggs
eggshell: eggshells
ego: ego
eighteen: eighteen
eileen: eileen
ejaculation: ejaculation,ejaculations
eke: eke
elaborate: elaborate
elaborately: elaborately
elastic: elastic
elbow: elbow,elbows
eld: eldest
elder: elder,elders
elderly: elderly
elect: elect,elected
election: election
electric: electric
electrocution: electrocution
electronic: electronic
electronically: electronically
elegance: elegance
element: element,elements
elements: elements
elephant: elephant,elephants
elevate: elevate
elfin: elfin
eliminate: eliminated
elizabeth: elizabeth
elizabethan: elizabethan,elizabethans
ellen: ellen
ellipsoid: ellipsoid
ellipsoidal: ellipsoidal
elliptical: elliptical
eloquence: eloquence
elude: elude,eluded
elusive: elusive
email: email
emancipation: emancipation
embarrassed: embarrassed
embay: embayed
embed: embedded
ember: embers
embittered: embittered
embittering: embittering
embitterment: embitterment
emblem: emblem,emblems
emboss: embossed
embrace: embrace,embraced,embraces
embrasure: embrasure
emerald: emerald
emerge: emerged,emerging
eminent: eminent
emma: emma
emotion: emotion,emotions
emotional: emotional
emotionalist: emotionalist
emperor: emperor
emphasis: emphasis
emphatically: emphatically
employee: employee,employees
enamel: enamel
enamelled: enamelled
encampment: encampment
enchant: enchanted
enchanted: enchanted
enchanting: enchanting
enchantment: enchantment
encircle: encircled
enclose: enclose,enclosed
encode: encoding
encounter: encounter
encouraging: encouraging
endeavour: endeavour,endeavoured,endeavouring
endless: endless
endow: endowed
endure: endure
enemy: enemies,enemy
energetically: energetically
energy: energy
enfold: enfolded
engender: engendered
england: england
english: english
englishman: englishman
enjoy: enjoy,enjoyed
enjoyment: enjoyment
enkindle: enkindled
enlarge: enlarged
enlighten: enlighten,enlightened
enlist: enlisted
enormity: enormities,enormity
enormous: enormous
enrage: enrage
enrich: enriched
ensure: ensuring
entangle: entangled
enter: enter,entered,entering
entered: entered
enterprise: enterprises
entertain: entertained
enthusiasm: enthusiasm,enthusiasms
entire: entire
entity: entity
entrails: entrails
entrance: entrance
entreat: entreated
entreaty: entreaty
entrenched: entrenched
entry: entry
enumerate: enumerate
envoy: envoy
envy: envied,envy
eon: eon,eons
ephod: ephod
epical: epical
episode: episode
epitaph: epitaph
equality: equality
equation: equation
equidistant: equidistant
equine: equine
equipment: equipment
equivocal: equivocal
era: eras
ere: ere
err: err,erred,erring
errand: errands
error: error,errors
escape: escape,escaped,escaping
esplanade: esplanade
espousal: espousal
essay: essay,essays
essence: essence
essential: essential
est: est
establish: established
establishment: establishment
esthetic: esthetic,esthetics
esthetically: esthetically
estrange: estranged
estrangement: estrangement
eternal: eternal
eternally: eternally
eternity: eternity
eton: eton
eucharist: eucharist
eucharistic: eucharistic
eugenics: eugenics
europe: europe
european: european
evade: evade
eve: eve
evening: evening,evenings
event: event
everlasting: everlasting
everlastingly: everlastingly
everliving: everliving
evil: evil,evils
evocation: evocation
evoke: evoke,evoked
evoker: evoker
exaltation: exaltation
exam: exams
examination: examination,examinations
examine: examine,examined,examining
excellent: excellent
excess: excess
excitable: excitable
excite: excite,excited
excited: excited
excitedly: excitedly
excitement: excitement
exciting: exciting
exclaim: exclaimed,exclaiming
exclusion: exclusion
excrement: excrement
excrementitious: excrementitious
excuse: excuse
execration: execration,execrations
exempt: exempt,exempted
exercise: exercise,exercises
exert: exerted
exhalation: exhalation
exhale: exhale
exhausted: exhausted
exhibition: exhibition
exhortation: exhortation
exile: exile,exiled
exist: existed,exists
existence: existence
exodus: exodus
exorcism: exorcism
expanse: expanse
expect: expect,expected
expectation: expectation
expel: expelled
expend: expend
expense: expense,expenses
experience: experience
experiment: experiments
explain: explain,explained
explanation: explanation
explore: explore
export: exporting
expose: exposed
express: express,expressed,expresses
expression: expression,expressions
expressionless: expressionless
expressively: expressively
expressly: expressly
expulsion: expulsion
exquisite: exquisite
extend: extending,extends
extension: extension
extensive: extensive
extent: extent
exterior: exterior
external: external
extinguish: extinguished
extra: extra
extreme: extreme
extremity: extremities
exult: exult,exulted
exultant: exultant
eye: eye,eyes
eyebrow: eyebrows
eyed: eyed
eyeglass: eyeglass
eyeless: eyeless
eyelid: eyelid,eyelids
fabled: fabled
fabric: fabric,fabrics
fabulous: fabulous
facies: facies
facility: facility
facing: facings
facto: facto
factory: factory
faculty: faculties,faculty
fade: fade,faded,fades,fading
fail: fail,failed,failing
failure: failure
faint: faint,fainter,fainting
faintly: faintly
fair: fair
fairy: fairy
faith: faith
faithful: faithful
falconry: falconry
fall: fall,fallen,falling,falls,fell
fallen: fallen
falling: fallings
false: false
falsehood: falsehood
fame: fame
familia: familia
familiar: familiar
family: family
famous: famous
fan: fanned
fancy: fancied,fancy
fantastic: fantastic
farcical: farcical
fare: fare
farewell: farewell
farmer: farmer
farmhand: farmhand
farmhouse: farmhouse
farrow: farrow
fart: farted
farth: farthest
farthing: farthing
fascinate: fascinated
fashion: fashion,fashioned
fast: fast,faster,fasts
fasting: fasting
fat: fat
fate: fate
father: father,fathers
fatherland: fatherland
fatten: fattened,fattening
fattish: fattish
fault: fault
favour: favour,favoured
favourable: favourable
favourite: favourite
fear: fear,feared,fearing,fears
fearful: fearful
fearless: fearless
fearlessly: fearlessly
feast: feast,feasts
feather: feathering,feathers
feathery: feathery
feature: featured,features
fed: fed
federal: federal
fee: fee,fees
feeble: feeble
feebly: feebly
feed: feed,feeding
feeding: feeding
feel: feel,feeling,feels
feeling: feeling,feelings
feign: feigned,feigning
feigned: feigned
fell: fells
fellow: fellow,fellows
female: female
fence: fence
fender: fender
fenian: fenian
ferment: ferment
ferrule: ferrule
fervent: fervent
fervently: fervently
fervour: fervour
fester: festering
festering: festering
festive: festive
festoon: festooned
fetid: fetid
fetter: fetters
fever: fever
fevered: fevered
feverish: feverish
fianna: fianna
fibre: fibres
field: field,fields
fiend: fiend,fiends
fiendish: fiendish
fiendishly: fiendishly
fierce: fierce,fiercer
fiercely: fiercely
fiery: fiery
fig: fig,figs
fight: fight,fought
figure: figure,figures
filch: filched
file: file,filed,files,filing
filial: filial
filing: filing
filling: filling
film: film
filter: filtered
filth: filth
filthily: filthily
filthy: filthy
final: final
finally: finally
financial: financial
fine: fine,finer
finely: finely
finespun: finespun
finger: finger,fingers
fingernail: fingernails
fingertip: fingertips
finish: finish,finished
firbolg: firbolg
firearm: firearms
firelight: firelight
fireplace: fireplace
firm: firm
firmament: firmament
firmly: firmly
fish: fish
fisher: fisher
fisherman: fishermen
fishy: fishy
fissure: fissure
fist: fist,fists
fit: fit,fitted
fitful: fitful
fitfully: fitfully
fitness: fitness
fitting: fitting
flabby: flabby
flag: flag,flags
flagstaff: flagstaff
flagstone: flagstone,flagstones
flake: flakes
flame: flame,flamed,flames,flaming
flanders: flanders
flank: flanked,flanks
flannel: flannel,flannels
flap: flapping,flaps
flapless: flapless
flare: flaring
flash: flash,flashed,flashing
flask: flask
flat: flat
flatly: flatly
flattened: flattened
flatter: flattered
flattered: flattered
flattering: flattering
flavour: flavour
fleck: flecked
flee: fled,flee
fleece: fleece
fleet: fleet
fleming: fleming
flesh: flesh
flexible: flexible
flicker: flickered,flickering
flight: flight
fling: flinging,flung
flippant: flippant
flirt: flirt,flirted
flit: flitting
float: floated,floating
flock: flock,flocks
flog: flog,flogged,flogging
flood: flood,flooded,flooding
floor: floor
florid: florid
flounder: floundering
flour: flour
flourish: flourish
flout: flouted
flow: flowed,flowing
flower: flower,flowers
flowering: flowering
flue: flue
fluent: fluent
fluff: fluff
fluid: fluid
flush: flush,flushed,flushes,flushing
flutter: flutter,fluttered,fluttering
fly: flew,flies,fly,flying
flyleaf: flyleaf
foam: foam
focus: focus
foe: foe
fog: fog
foggy: foggy
foil: foiled
fold: fold,folded,folding,folds
follow: follow
follower: follower,followers
folly: folly
fond: fond
font: font
food: food,foods
fool: fool
foolish: foolish
foot: feet,foot
football: football
footboard: footboard
footed: footed
footpath: footpath
footstep: footsteps
footstool: footstool
foray: forays
forbearance: forbearance
forbid: forbidding
forbidden: forbidden
force: force,forced
forefinger: forefinger
forehead: forehead
foreign: foreign
foreigner: foreigners
foreknow: foreknew
foreknowledge: foreknowledge
foremost: foremost
foresee: foresaw
foreshore: foreshore
forest: forest
forester: forester
forewarn: forewarned
forfeit: forfeited
forge: forge,forging
forget: forget,forgetting,forgot,forgotten
forgive: forgive,forgiven
forgiveness: forgiveness
fork: fork
form: form,formed,forming,forms
formal: formal
format: format,formats
formless: formless
formula: formula
forsake: forsake
fortieth: fortieth
fortnight: fortnight
fortune: fortune
foster: foster
fosterage: fosterage
foul: foul,fouled
foully: foully
foulness: foulness
foundation: foundation
founder: founder
fountain: fountain,fountains
fourteenth: fourteenth
fourth: fourth
fowl: fowl
fox: fox,foxes,foxing
foxy: foxy
fragment: fragment,fragments
fragrance: fragrance
fragrant: fragrant
frail: frail
frame: frame,framed,frames
france: france
francis: francis
franciscan: franciscan,franciscans
frank: frank
frankincense: frankincense
frankly: frankly
fraught: fraught
fray: frayed
freckled: freckled
freedom: freedom
freely: freely
freemason: freemason
french: french
frenchman: frenchman
frenzy: frenzy
frequency: frequency
frequent: frequent
frequently: frequently
fresh: fresh
fret: fret,frets
friar: friar
friday: friday
friend: friend,friends
friendliness: friendliness
friendly: friendly
friendship: friendship,friendships
fright: fright
frightened: frightened
frightful: frightful
fringe: fringe,fringes
fritter: fritters
fro: fro
frog: frog
frontispiece: frontispiece
froth: froth
frown: frown,frowned,frowning
frowsy: frowsy
fruit: fruit,fruits
fruitful: fruitful
fruitless: fruitless
fruitlessly: fruitlessly
frustrate: frustrate
fry: fried
fudge: fudge
fulfil: fulfilled,fulfilling
fullness: fullness
fumble: fumbled,fumbling
fume: fume,fumes
fun: fun
function: functions
funds: funds
fungus: fungus
funk: funk
funnel: funnel
funny: funny
furious: furious
furiously: furiously
furled: furled
furlong: furlong
furnace: furnace
furnish: furnished
furniture: furniture
furtive: furtive
fury: fury
fuse: fused
futile: futile
future: future
gabriel: gabriel
gades: gades
gael: gael
gaily: gaily
gain: gain,gained
gait: gait
gallant: gallant
gallery: galleries,gallery
gallnut: gallnuts
gallop: galloping
game: game,games
gamecock: gamecocks
gang: gang
garden: garden,gardens
garish: garish
garment: garments
garner: garner
garrulous: garrulous
gas: gas
gate: gate,gates
gather: gather,gathered,gathering
gathering: gathering
gaudy: gaudy
gay: gay
gaze: gaze,gazed,gazes,gazing
gem: gems
gender: genders
generalization: generalization
generation: generations
generous: generous
generously: generously
gent: gents
genteel: genteel
gentle: gentle
gentleman: gentleman,gentlemen
gentlewoman: gentlewomen
gently: gently
genuflect: genuflecting
geography: geography
george: george
german: german
germany: germany
gestation: gestation
gesture: gesture,gestures
ghost: ghost,ghosts
ghostly: ghostly
gibbet: gibbet,gibbeted
gibe: gibes,gibing
gift: gift,gifts
gilbert: gilbert
gill: gills
gingerly: gingerly
gipsy: gipsy
gipsylike: gipsylike
giraffe: giraffe
girdle: girdle
girl: girl,girls
girlish: girlish
girt: girt
girth: girth
giver: giver,givers
glad: glad
gladness: gladness
gladstone: gladstone
glance: glance,glanced,glancing
gland: gland
glare: glare
glass: glass,glasses
glassy: glassy
gleam: gleamed,gleaming
glee: glee
glibly: glibly
glimmer: glimmer,glimmered,glimmering
glimmering: glimmering
glimpse: glimpse,glimpses
glint: glint
glisten: glistening
glitter: glittered
gloat: gloat
gloom: gloom
gloomily: gloomily
gloomy: gloomy
gloriam: gloriam
glorify: glorified
glorious: glorious
glory: glories,glory
glossy: glossy
glove: glove,gloves
gloved: gloved
glow: glow,glowed,glowing
glower: glowering
gluttonous: gluttonous
gluttony: gluttony
glynn: glynn
gnaw: gnawed,gnaws
goad: goaded,goads
goal: goal,goals
goalpost: goalposts
goat: goat
goatee: goatee
goatish: goatish
goblet: goblet
god: god,gods
godforsaken: godforsaken
godhead: godhead
goethe: goethe
gold: gold
golden: golden
goodbye: goodbye
goodhearted: goodhearted
goodness: goodness
goodnight: goodnight
goose: geese,goose
gorgeous: gorgeous
gospel: gospel,gospels
gossip: gossip
govern: govern
governor: governor
gown: gown,gowns
grace: grace
gradual: gradual
gradually: gradually
grain: grain,grains
grammar: grammar
grand: grand
grandchild: grandchildren
grandfather: grandfather
grandnephew: grandnephew
granduncle: granduncle
grant: granted
grape: grapes
grapple: grapple
grasp: grasp,grasping,grasps
grass: grass,grasses
grassplot: grassplot
grate: grate,grating
gratefully: gratefully
grave: grave
gravel: gravel
gravely: gravely
graveyard: graveyard
gravity: gravity
gravy: gravy
grease: grease,greased
greasy: greasy
greave: greaves
greece: greece
greek: greek
green: green
greet: greet,greeted,greeting
greeting: greeting
grey: grey,greyed
greyhound: greyhounds
greyly: greyly
greyness: greyness
grief: grief
grieving: grieving
grievous: grievous
griffin: griffin
grim: grim
grimace: grimace
grimy: grimy
grin: grin,grinned
grip: grip,gripped,gripping
grit: grit
grizzled: grizzled
groan: groaning,groans
groceries: groceries
grocery: groceries
groin: groins
grooved: grooved
grope: grope,groping
gross: gross
grossness: grossness
ground: ground
grounds: grounds
groves: groves
grow: grew,grow,growing,grown,grows
grownup: grownup
growth: growth
gruel: gruel
grunt: grunting
guard: guards
guardian: guardian,guardians
guess: guess
guest: guest,guests
guffaw: guffaw
guidance: guidance
guide: guide,guiding
guido: guido
guile: guile
guilelessness: guilelessness
guilt: guilt
guilty: guilty
guinea: guinea,guineas
gulf: gulf
gulp: gulped,gulping
gun: guns
gunpowder: gunpowder
gurgle: gurgling
gust: gust,gusts
gut: guts
gutter: gutter
guzzle: guzzle
gymnasium: gymnasium
gymnastic: gymnastic
ha: ha
habit: habit,habits
habitation: habitation
hack: hack,hacking
hacking: hacking
haha: haha
hair: hair,hairs
hairpin: hairpins
hairy: hairy
hale: hale
hall: hall,halls
hallowed: hallowed
hallway: hallway
halt: halt,halted,halting,halts
ham: ham
hamilton: hamilton
hamper: hamper
hand: hand,handed,hands
handball: handball
handful: handful,handfuls
handicapped: handicapped
handiwork: handiwork
handkerchief: handkerchief
handle: handle,handling
handling: handling
handsel: handsel
handsome: handsome,handsomest
hang: hanged,hanging,hung
hansom: hansom
happen: happen,happened
happiness: happiness
happy: happier,happiest,happy
harbour: harbour
hard: hard,harder
harden: hardened,hardening
hardship: hardship
hare: hares
harlot: harlots
harm: harm
harmless: harmless
harmonious: harmonious
harmonise: harmonised
harmony: harmony
harness: harness
harold: harold
harp: harping
harridan: harridan
harry: harry
harsh: harsh
harshly: harshly
hart: hart,harts
hash: hash
hast: hast
haste: haste
hasty: hasty
hat: hat,hats
hate: hate,hated,hates
hateful: hateful
hatred: hatred
haughty: haughty
haul: hauled
hawk: hawk
hawklike: hawklike
hayseed: hayseeds
haze: haze
head: head,headed,heads
headless: headless
headline: headline
headlong: headlong
health: health
healthy: healthy
heap: heaped,heaps
hear: hear,heard,hearing
hearer: hearer,hearers
hearing: hearing
heart: heart,hearts
heartburn: heartburn
hearth: hearth
hearthrug: hearthrug
heartily: heartily
hearty: hearty
heat: heat
heated: heated
heath: heath
heaven: heaven,heavens
heavenly: heavenly
heavily: heavily
heaviness: heaviness
heavy: heavy
hedge: hedge,hedges
heed: heed
heedless: heedless
heel: heel,heels
heifer: heifer
heighten: heightened
heinous: heinous
heir: heir,heirs
hellfire: hellfire
hellish: hellish
hellward: hellward
helper: helpers
helpless: helpless
helplessly: helplessly
henry: henry
heraldry: heraldry
herb: herbs
herd: herd
heredity: heredity
heresy: heresy
heretic: heretic
hero: hero
heroic: heroic
heron: heron
hew: hewn
hickey: hickey
hidden: hidden
hide: hidden,hide,hiding
hideous: hideous
highland: highland
highly: highly
hill: hill,hills
hillock: hillocks
hind: hinds
hinder: hinder
hingeless: hingeless
hip: hips
hireling: hirelings
hiss: hiss,hissed,hisses
history: history
hit: hit
hitherto: hitherto
hoard: hoard
hoarding: hoardings
hoarse: hoarse
hoarsely: hoarsely
hob: hob
hogwash: hogwash
hoho: hoho
hoist: hoisted
hold: held,hold,holding,holds
holder: holder,holders
hole: hole
holiday: holiday,holidays
holily: holily
holiness: holiness
holland: holland
hollow: hollow
holly: holly
holy: holy
hom: hom
homage: homage
homely: homely
homeward: homeward
homewards: homewards
honest: honest
honey: honey
honour: honour,honoured,honours
honourable: honourable
hooded: hooded
hoodwink: hoodwink,hoodwinked
hoof: hoofs
hooked: hooked
hoop: hoop
hoosh: hoosh
hope: hope,hoped
hopeless: hopeless
horace: horace
horizon: horizon
hornpipe: hornpipe
horny: horny
horrible: horrible
horrid: horrid
horror: horror
horse: horse,horses
horsehair: horsehair
horseplay: horseplay
hospital: hospital
host: host
hostile: hostile
hot: hot
hotel: hotel
hotly: hotly
hottentot: hottentot
hound: hounded,hounds
hour: hour,hours
house: house,housed,houses
household: household
howl: howl,howling,howls
hoyden: hoyden
hoydenish: hoydenish
huddle: huddled,huddling
hue: hue
hueless: hueless
huge: huge
hugo: hugo
hulk: hulks
hum: hum,hummed
human: human
humanity: humanity
humble: humble,humbled,humblest
humbly: humbly
humeral: humeral
humiliate: humiliate,humiliated
humiliating: humiliating
humiliation: humiliation
humility: humility
humour: humour
hundredfold: hundredfold
hundredth: hundredth
hung: hung
hungrily: hungrily
hungry: hungry
hunkers: hunkers
hunter: hunter
hurl: hurl,hurled,hurling
hurley: hurley
hurray: hurray
hurricane: hurricane
hurroo: hurroo
hurry: hurried,hurry,hurrying
hurt: hurt
hurtful: hurtful
hurtle: hurtled
husband: husband,husbands
hush: hush,hushed
hustle: hustled
hustling: hustling
hymn: hymn
hymnal: hymnal
hypocrisy: hypocrisy
hypocrite: hypocrite,hypocrites
hypothenuse: hypothenuse
hypothesis: hypothesis
hysterical: hysterical
ibis: ibis
icon: icon
idea: idea,ideas
ideal: ideal,ideals
idealism: idealism
idealist: idealist
idealistic: idealistic
identification: identification
identify: identify
idiom: idioms
idiot: idiot
idle: idle,idlest
idler: idler
idly: idly
idolater: idolaters
ignatius: ignatius
ignoble: ignoble
ignorance: ignorance
iii: iii
illogical: illogical
illuminate: illuminated
illusion: illusion
illustrate: illustrate
illustrious: illustrious
image: image,images
imagery: imagery
imagination: imagination,imaginations
imagine: imagine,imagined,imagining
imbecile: imbecile
imitate: imitate,imitated
imitation: imitation
immeasurable: immeasurable
immeasurably: immeasurably
immense: immense
immensely: immensely
immerse: immersed
imminent: imminent
immodest: immodest
immoral: immoral
immortal: immortal
immune: immune
immunity: immunity
impalpable: impalpable
impart: impart
impartially: impartially
impassible: impassible
impassive: impassive
impatience: impatience
impatient: impatient
impatiently: impatiently
impel: impelled
impenetrable: impenetrable
impenitence: impenitence
imperfection: imperfection,imperfections
imperishable: imperishable
impersonal: impersonal
implicit: implicit
implore: implore
imply: implied
importune: importuned
impose: imposed
imposition: imposition
impossible: impossible
impotent: impotent
impress: impress
impression: impression
imprint: imprints
improper: improper
impudent: impudent
impulse: impulse,impulses
impure: impure
impurity: impurity
inaccurate: inaccurate
inaction: inaction
inalienably: inalienably
inanition: inanition
inarticulate: inarticulate
inattention: inattention
inaudible: inaudible
inbreathe: inbreathed
inbred: inbred
incapable: incapable
incense: incense,incensing
incertitude: incertitude
incestuous: incestuous
inch: inch
incident: incident,incidents
incidental: incidental
incite: incited
incline: incline,inclined,inclining
include: include,included,includes,including
including: including
incoherent: incoherent
incommunicable: incommunicable
incomplete: incomplete
incomprehensibility: incomprehensibility
increase: increased,increasing
incredible: incredible
indelible: indelible
indelicate: indelicate
indelicateness: indelicateness
indemnify: indemnify
indemnity: indemnity
independent: independent
india: india
indian: indian,indians
indication: indication
indies: indies
indifference: indifference
indifferent: indifferent
indignation: indignation
indignity: indignity
indirect: indirect
indirectly: indirectly
indispensable: indispensable
indistinct: indistinct
individual: individual
induce: induce,induced,induces
indulge: indulge,indulging
indulgence: indulgence,indulgences
indulgent: indulgent
indulgently: indulgently
ineffectiveness: ineffectiveness
ineffectual: ineffectual
inexact: inexact
inexhaustible: inexhaustible
inexperience: inexperience
inexpressive: inexpressive
infantry: infantry
infect: infect
infection: infection
inferior: inferior
infernal: infernal
infinite: infinite
infinitely: infinitely
infirmary: infirmary
inflame: inflaming
inflict: inflicted
influence: influence,influenced
informer: informer,informers
infrahuman: infrahuman
infringe: infringed
infringement: infringement
infuriate: infuriated
infuse: infusing
ingenuity: ingenuity
ingomar: ingomar
inhabit: inhabit
inhale: inhaling
inheritance: inheritance
inhuman: inhuman
iniquitous: iniquitous
initial: initial,initials
injure: injured
injury: injuries
ink: ink
inky: inky
innocence: innocence
innocent: innocent
innumerable: innumerable
inquire: inquire
inquisitive: inquisitive
insect: insect
insensible: insensible
insignificant: insignificant
insincerity: insincerity
insist: insisting,insists
insistence: insistence
insistent: insistent
insistently: insistently
insolence: insolence
inspiration: inspiration
instance: instance
instant: instant,instants
instantaneous: instantaneous
instinct: instinct,instincts
instinctive: instinctive
institute: instituted
institution: institution
instructive: instructive
instrument: instrument,instruments
insufflation: insufflation
insulate: insulates
insulated: insulated
insult: insult,insulted
intangible: intangible
intellect: intellect
intellection: intellection
intellectual: intellectual
intelligence: intelligence
intelligent: intelligent
intelligible: intelligible
intend: intend,intended
intense: intense
intensely: intensely
intensify: intensified
intensity: intensity
intent: intent
intention: intention,intentions
intently: intently
inter: inter
intercede: intercede
interior: interior
interject: interjected
interleave: interleaved
internal: internal
international: international
interpret: interpret,interpreted
interrupt: interrupted
interrupted: interrupted
interstice: interstices
interval: intervals
interweave: interwoven
intimacy: intimacy
intimately: intimately
intolerable: intolerable
intolerably: intolerably
intone: intoned,intoning
intricate: intricate
intrigue: intrigue
intriguer: intriguers
introduction: introduction
intrusion: intrusions
intuition: intuition
invalidity: invalidity
invent: invented,inventing
inventiveness: inventiveness
inventor: inventor
invert: inverted
invest: invested
investor: investor
invisible: invisible
invite: invite,invited,inviting
involuntarily: involuntarily
ipso: ipso
ire: ire
ireland: ireland
irish: irish
irishman: irishman
irishmen: irishmen
irk: irk
iron: iron
ironically: ironically
irradiate: irradiate
irregular: irregular
irresistibly: irresistibly
irresolutely: irresolutely
irresolution: irresolution
irreverence: irreverence
irrevocable: irrevocable
irritated: irritated
irritation: irritation
irs: irs
island: island,islanding
isle: isles
isolation: isolation
issue: issued,issuing
italian: italian
itch: itch
item: item
iv: iv
ivory: ivory
ivy: ivy
jack: jack
jackass: jackass
jackeen: jackeen
jacket: jacket
jackknife: jackknife
jacob: jacob
jacques: jacques
jade: jaded
jaded: jaded
jagged: jagged
jamb: jambs
james: james
jangled: jangled
japan: japan,japanned
jar: jar,jars
jargon: jargon,jargons
jarvy: jarvies
jaw: jaw,jaws
jaws: jaws
jealous: jealous
jean: jean
jeer: jeer,jeering
jellylike: jellylike
jericho: jericho
jerk: jerked,jerking,jerks
jerusalem: jerusalem
jesting: jesting
jesu: jesu
jesuit: jesuit,jesuits
jesus: jesus
jetsam: jetsam
jew: jews
jewel: jewel
jewelly: jewelly
jewish: jewish
jews: jews
jiffy: jiffy
jim: jim
jimmy: jimmy
jingle: jingle,jingling
job: job
joey: joey
jog: jogged
john: john
johnny: johnny
joined: joined
joke: joke,joking
jolly: jolly
jones: jones
joseph: joseph
josephine: josephine
jostle: jostle,jostled
journal: journal
journey: journey,journeying
jove: jove
jovial: jovial
joy: joy,joys
joyce: joyce
joyful: joyful
juan: juan
judge: judge,judged
judgement: judgement,judgements
jug: jug
juggle: juggle
juice: juice
julius: julius
july: july
jump: jump,jumped
jumper: jumpers
jupe: jupes
justice: justice
jut: jutting
juxta: juxta
keen: keen
keenly: keenly
keeper: keeper
kelly: kelly
kendal: kendal
kenny: kenny
kentish: kentish
kerry: kerry
kettle: kettle
key: key
keyboard: keyboard
kick: kick,kicking
kidney: kidney
kill: kill,killed,kills
killarney: killarney
kilt: kilted,kilting
kindle: kindle,kindled,kindling
kindly: kindly
kinesis: kinesis
kinetic: kinetic
king: king,kings
kingdom: kingdom
kinship: kinship
kinsman: kinsman,kinsmen
kiss: kiss,kissed,kisses,kissing
kisser: kisser
kitchen: kitchen
kitty: kitty
knee: knee,knees
kneel: kneel,kneeling,knelt
knickers: knickers
knife: knife,knives
knifeboard: knifeboard
knight: knight
knightly: knightly
knob: knob
knock: knocked
knot: knotted
knotting: knotting
knotty: knotty
knowledge: knowledge
knuckly: knuckly
labour: labour,laboured,labours
lace: lace,laces
lacy: lacy
laden: laden
ladle: ladled
lady: ladies,lady
laggard: laggards
lair: lair
lake: lake,lakes
lakelike: lakelike
lamb: lamb
lambent: lambent
lame: lame
lamp: lamp,lamps
lancaster: lancaster
lance: lance
land: land,lands
landing: landing
landlord: landlord
landmark: landmark
landward: landward
lane: lane,lanes
laneway: laneway
language: language,languages
languid: languid
languor: languor
languorous: languorous
lank: lank
lantern: lantern,lanterns
laocoon: laocoon
lap: lap
lapping: lapping
lapse: lapse,lapsed
lark: lark
lash: lashes
lasting: lasting
latchless: latchless
late: late
latecomer: latecomer
latin: latin
latinist: latinist
latticed: latticed
laugh: laugh,laughed,laughing
laughter: laughter
laurel: laurel
lavatory: lavatory
lavender: lavender
lavish: lavish
law: law,laws
lawfully: lawfully
lawless: lawless
lawn: lawn
lawton: lawton
lax: lax
lay: laid,lay,laying,lays
layman: layman
lazily: lazily
lazy: lazy
lead: lead,leading,leads,led
leader: leader,leaders
leaf: leaf,leaves
leafage: leafage
leafless: leafless
league: league,leagues
lean: lean,leaned,leaning
leaning: leaning
leanness: leanness
leap: leap,leaped,leaping,leapt
learn: learn,learned,learnt
learning: learning
leather: leather
leave: leave,leaves,leaving,left
leavetaking: leavetaking
lecherous: lecherous
lecture: lecture,lectures
ledge: ledge
lee: lee
left: left
leg: leg,legs
legal: legal
legally: legally
legend: legend,legends
legendary: legendary
legion: legion
legitimate: legitimate
leicester: leicester
leisure: leisure
leisurely: leisurely
lemon: lemon
lend: lend,lends,lent
lent: lent
leopard: leopards
leprous: leprous
les: les
lesson: lesson,lessons
letter: letter,letters
levelheaded: levelheaded
levite: levite
lewd: lewd
liability: liability
liable: liable
liar: liar
libel: libel
liberal: liberal
liberally: liberally
liberation: liberation
liberator: liberator
liberty: liberty
library: libraries,library
lice: lice
license: license
licensed: licensed
lick: licking,licks
licking: licking
lid: lid
lie: lain,lie,lies,lying
lieu: lieu
lieutenant: lieutenant,lieutenants
life: life,lives
lifeless: lifeless
lifelong: lifelong
lift: lift,lifted,lifting
light: light,lighted,lighter,lighting,lights,lit
lighted: lighted
lighting: lighting
lightly: lightly
lightning: lightnings
lightsome: lightsome
likelihood: likelihood
liken: likened
likeness: likeness
lily: lily
limb: limb,limbs
limbed: limbed
limbo: limbo
lime: limes
limericks: limericks
limestone: limestone
limit: limited,limits
limitation: limitation
limited: limited
limitless: limitless
limp: limp,limping
lineage: lineage
linen: linen,linens
liner: liners
linger: linger,lingered,lingering
lingered: lingered
lingua: lingua
link: linked,linking,links
lip: lip,lips
liquid: liquid
lisa: lisa
list: list,lists
listen: listen,listened,listening
listener: listener,listeners
listening: listening
listless: listless
listlessly: listlessly
listlessness: listlessness
litany: litany
literary: literary
literature: literature
lithe: lithe
litter: litter
liturgy: liturgy
live: live,lived,lives,living
lively: lively
liverpool: liverpool
livid: livid
living: living
lo: lo
load: load
loafer: loafer,loafers
loan: loan,loans
loathe: loathe,loathed
loathing: loathing
loathsome: loathsome
lob: lob,lobs
local: local
locate: located
location: locations
lock: lock,locked
locker: locker
locking: locking
locust: locusts
loft: loft
logical: logical
logically: logically
loin: loins
loiter: loitered
london: london
loneliness: loneliness
lonely: lonely
longing: longing,longings
longstanding: longstanding
looping: looping
loose: loose,loosed
loosely: loosely
loosen: loosened
lopsided: lopsided
lord: lord
lore: lore
lorenzo: lorenzo
lorry: lorry
lose: lose,lost
loss: loss
lost: lost
lot: lot
loth: loth
lottie: lottie
loud: loud,louder
loudly: loudly
louis: louis
lounge: lounged
louse: louse
love: love,loved,loves,loving
loveless: loveless
loveliness: loveliness
lovely: lovely
lover: lover
loving: loving
lowly: lowliest,lowly
loyal: loyal
loyalty: loyalty
lucid: lucid
lucifer: lucifer
luck: luck
lucky: lucky
luigi: luigi
lukewarm: lukewarm
lull: lull,lulled,lulling
lumber: lumbering
luminary: luminary
luminous: luminous
luminously: luminously
lump: lumps
lumpish: lumpish
lumpy: lumpy
lunch: lunches
lung: lungs
lure: lure,lured
lurk: lurking
lust: lust,lusted
lustful: lustful
lustre: lustre
lustreless: lustreless
lutenist: lutenists
luxuriant: luxuriant
luxurious: luxurious
luxury: luxury
lying: lying
lynch: lynch
lynx: lynx
lyrical: lyrical
mabel: mabel
machine: machine
machinery: machinery
mad: mad
madam: madam
madden: maddening
maddening: maddening
madhouse: madhouse
madly: madly
madman: madman
madness: madness
maggy: maggy
magic: magic
magically: magically
magistrate: magistrate,magistrates
magus: magus
mahogany: mahogany
maid: maid,maids
maiden: maiden
mail: mail
maim: maimed
maimed: maimed
main: main
maintain: maintain,maintained,maintaining
majestic: majestic
majesty: majesty
major: major
majorem: majorem
maker: maker
malady: malady
malcolm: malcolm
male: male
malefactor: malefactors
malevolent: malevolent
malice: malice
malignant: malignant
malignity: malignity
mallow: mallow
malo: malo
mamma: mamma
manager: manager
mane: mane
mangled: mangled
manhood: manhood
maniac: maniac
manifold: manifold
mankind: mankind
manly: manly
manned: manned
manner: manner
manners: manners
mannikin: mannikin
mantelpiece: mantelpiece
mantle: mantle,mantled
manufacture: manufacturing
manufacturing: manufacturing
map: map
maple: maple
mar: marred
marble: marbles
march: march,marched
mare: mare
mariana: mariana
marine: marine
mark: mark,marked,marks
market: market
marketplace: marketplace
maroon: maroon
marquess: marquess
married: married
marrow: marrow
marry: married,marry
marseilles: marseilles
marshal: marshal,marshalled,marshals
marshalled: marshalled
martin: martin
martyr: martyr
marvellous: marvellous
marx: marx
mary: mary
masculine: masculine
mask: mask
masked: masked
mass: mass,massed,masses
mast: masts
master: master,masters
mat: mat
match: match,matches
mate: mate
material: material
mathematician: mathematicians
mathematics: mathematics
matric: matric
matriculation: matriculation
matted: matted
matter: matter,matters
matting: matting
maul: mauled
maundy: maundy
maurice: maurice
maximum: maximum
maze: maze
mea: mea
meal: meal,meals
meaning: meaning
meaningless: meaningless
measure: measure,measured
meat: meat
meddle: meddle
mediate: mediate
medical: medical
medicine: medicine
medieval: medieval
meditation: meditations
medium: medium
medley: medley
meek: meek
meekly: meekly
meet: meet,met
meeting: meeting
melancholy: melancholy
melody: melody
melt: melt
memorable: memorable
memory: memories,memory
menace: menace
mend: mending
mental: mental
mentality: mentality
mention: mention,mentioned
mercedes: mercedes
mercenary: mercenary
merchandise: merchandise
merchantability: merchantability
merciful: merciful
mercifulness: mercifulness
merciless: merciless
mercy: mercy
mere: mere
merge: merge,merged
merit: merits
merrily: merrily
merriment: merriment
merry: merry
merrymake: merrymaking
message: message,messages
messenger: messenger
met: met
metal: metal
metamorphoses: metamorphoses
metaphor: metaphors
mete: mete
method: method,methods
michael: michael
mick: mick
micky: micky
middle: middle
midnight: midnight
midst: midst
midstream: midstream
midwifery: midwifery
mighty: mighty
mike: mike
mild: mild
mildly: mildly
mile: mile,miles
milesian: milesian
milk: milk,milking
milkman: milkman
millionfold: millionfold
millionth: millionth
mills: mills
millstone: millstone
mince: mincing
mind: mind,minding,minds
mineral: mineral
mingle: mingled
minister: minister,ministers
minor: minor
minute: minute,minutes
mire: mire
mirror: mirror,mirrored
mirth: mirth
mirthless: mirthless
miser: miser
miserable: miserable
misery: miseries,misery
misfortune: misfortune,misfortunes
misrule: misrule
missa: missa
mission: mission
mississippi: mississippi
mist: mists
mistake: mistake,mistakes
mistress: mistress
mistrust: mistrust,mistrusted
mistrustfulness: mistrustfulness
mix: mix,mixed
moan: moan,moaned,moaning
mobile: mobile
mock: mock,mocked,mocking
mocker: mocker
mockery: mockery
mode: mode
model: model
modern: modern
modification: modification
modify: modified
moiety: moiety
moist: moist
moisture: moisture
mole: mole
mollify: mollifying
molten: molten
moment: moment,moments
momentary: momentary
mona: mona
monday: monday
money: money,moneys
monk: monk
monkey: monkey
monkeyish: monkeyish
monkish: monkish
monologue: monologue
monosyllable: monosyllable
monotonously: monotonously
monster: monster
monstrance: monstrance
monstrous: monstrous
monte: monte
month: month,months
monthly: monthly
monument: monuments
mood: mood
moodiness: moodiness
moody: moody
moon: moon
moonless: moonless
moonlit: moonlit
mooring: moorings
moral: moral
morality: morality
morally: morally
moran: moran
morgue: morgue
morning: morning,mornings
mortal: mortal
mortally: mortally
mortification: mortification,mortifications
mortified: mortified
mortify: mortify
mortifying: mortifying
moses: moses
moth: moth
mother: mother,mothers
mottled: mottled
motto: motto
mould: mould
moulder: mouldering
mound: mounds
mount: mount,mounted
mountain: mountain,mountains
mournful: mournful
mouse: mice
moustache: moustache,moustaches
mouth: mouth,mouths
mouthpiece: mouthpiece
movement: movement,movements
mozambique: mozambique
mud: mud
muddy: muddied,muddy
muff: muff
muffled: muffled
mulier: mulier
multiple: multiple
multiply: multiplied
multitude: multitude
mumble: mumbled
mummery: mummery
munch: munched
munster: munster
murder: murder,murders
murderer: murderer,murderers
murderous: murderous
murmur: murmur,murmured,murmuring,murmurs
murmuring: murmuring
murmurous: murmurous
murmurously: murmurously
muscatel: muscatel
muscle: muscle
muscular: muscular
muse: muse,mused
museum: museum
music: music
musical: musical
musing: musings
musingly: musingly
mute: mute
mutely: mutely
mutter: muttered
mutton: mutton
myriad: myriads
myrrh: myrrh
myrtle: myrtle
mysterious: mysterious
mysteriously: mysteriously
mystery: mysteries,mystery
mystic: mystic
mystical: mystical
myth: myth
nail: nail,nails
naked: naked
nakedness: nakedness
nameless: nameless
nape: nape
napoleon: napoleon
narration: narration
narrative: narrative
narrow: narrow
nasal: nasal
nash: nash
nasty: nasty
nation: nation,nations
national: national
nationalist: nationalist
nationality: nationality
natural: natural
nature: nature,natures
nauseous: nauseous
nave: nave
nazareth: nazareth
neapolitan: neapolitan
nearer: nearer
neat: neat
neatly: neatly
nebulous: nebulous
necessity: necessity
neck: neck
neckcloth: neckcloth
needful: needful
neediness: neediness
needle: needle
neglect: neglected
negligence: negligence
neighbour: neighbour,neighbouring
neighbourhood: neighbourhood
nelly: nelly
nephew: nephew
nerve: nerves
nervous: nervous
nervously: nervously
nest: nest
nettle: nettle
network: network
newcomer: newcomers
newly: newly
news: news
newsagent: newsagent
newsletter: newsletter
nice: nice,nicer
nicely: nicely
niche: niche
nickname: nicknamed,nicknames
night: night,nights
nightfall: nightfall
nightly: nightly
nightshade: nightshade
nightshirt: nightshirt
nile: nile
nimble: nimble
nimbly: nimbly
nob: nobs
nobility: nobility
noble: noble,noblest
nobleman: nobleman,noblemen
nod: nodded,nodding
noise: noise,noises
noiseless: noiseless
noiselessly: noiselessly
noisily: noisily
noisome: noisome
nomad: nomads
nominal: nominal
nonproprietary: nonproprietary
nonsense: nonsense
nook: nook
norfolk: norfolk
normal: normal
north: north
northern: northern
northward: northward
nose: nose,noses
nosed: nosed
nosegay: nosegay
nostril: nostrils
note: note,notes,noting
notebook: notebooks
nothingness: nothingness
notice: notice,notices
notify: notifies
notion: notion
noun: noun
november: november
novena: novena
novitiate: novitiate
noxious: noxious
nudge: nudged,nudges
nudging: nudging
nun: nun,nuns
nurse: nurse
nursemaid: nursemaids
nursery: nursery
oar: oar
oarsman: oarsman
oath: oath
obedience: obedience
obedient: obedient
obediently: obediently
obey: obey,obeyed,obeying
object: object,objected
oblige: obliged
oblong: oblong
obscene: obscene
obscure: obscure,obscured
observant: observant
observe: observed
obsolete: obsolete
obstinately: obstinately
obvious: obvious
occasion: occasion,occasions
occur: occur,occurred
ocean: ocean,oceans
oceanic: oceanic
october: october
odd: odd
odorous: odorous
odour: odour,odours
odourless: odourless
offal: offal
offence: offence
offend: offend,offended,offending,offends
offended: offended
offer: offer,offered,offering,offers
offering: offering
office: office,offices
officer: officers
official: official
offspring: offspring
oft: oft
ohm: ohms
oil: oil
oilcan: oilcan
oils: oils
olden: olden
oldish: oldish
olive: olive
omnipotent: omnipotent
omnipresent: omnipresent
onion: onions
online: online
onlooker: onlookers
onset: onset
onward: onward
onwards: onwards
ooze: oozed,oozing
openly: openly
operation: operation
opinion: opinion,opinions
opportunity: opportunities,opportunity
oppose: opposed
orator: orator
orb: orb
orchard: orchards
orchestra: orchestra
ordination: ordination
ordure: ordure
organize: organized
orgiastic: orgiastic
orgy: orgies
origin: origin
original: original
originator: originator
ornamental: ornamental
orthodox: orthodox
osier: osier
outburst: outburst,outbursts
outdated: outdated
outdoor: outdoor
outer: outer
outhouse: outhouse
outlaw: outlaw
outlet: outlet
outline: outlined
outrage: outrages
outraged: outraged
outright: outright
outshine: outshine
outstrip: outstrip
outward: outward
oval: oval
overblown: overblown
overcloud: overcloud
overcoat: overcoat,overcoats
overcoated: overcoated
overcome: overcome,overcomes
overflow: overflow
overgrown: overgrown
overhaul: overhauled
oversee: oversee
overt: overt
overtake: overtake
overtone: overtone
overturn: overturned
ovid: ovid
owe: owed
owner: owner
ox: ox
ozone: ozone
pace: pace,paced,paces
pack: pack
packet: packet
paddy: paddy
pain: pain,pains
pained: pained
painful: painful
painfully: painfully
painless: painless
painlessly: painlessly
paint: paint,painted,paints
pair: pair
palate: palate
pale: pale
paler: paler
palest: palest
pallid: pallid
pallor: pallor
palm: palm,palms
palma: palma
palsy: palsy
pancake: pancake,pancakes
pandy: pandied,pandies,pandy
pandybat: pandybat
pane: pane,panes
panting: panting
pantomime: pantomime
pants: pants
papa: papa
paper: paper,papers
paperwork: paperwork
parable: parable
paraclete: paraclete
parade: parading
paraffin: paraffin
paragraph: paragraph,paragraphs
paramour: paramour
parcel: parcels
parch: parching
parched: parched
pardon: pardon,pardoned
pare: pared,paring
parent: parent,parents
parenthesis: parenthesis
paris: paris
park: park
parley: parley,parleyed
parliament: parliament
parlour: parlour
parricide: parricide
parry: parried
particle: particle,particles
partly: partly
party: party
pascal: pascal
pass: pass,passed,passes,passing
passage: passage,passages
passion: passion,passions
passionless: passionless
passionlessly: passionlessly
password: password
paste: pasted
pastor: pastors
pat: patted
patchwork: patchwork
paten: paten
patent: patented
path: path
pathway: pathway
patience: patience
patient: patient
patiently: patiently
patrician: patricians
patrick: patrick
patron: patron,patrons
patter: pattering
paul: paul
pause: pause,paused,pauses
pavan: pavan
pavilion: pavilion
pawn: pawn,pawns
pax: pax
pay: paid,pay,paying,pays
payment: payments
pea: peas
peace: peace
peaceful: peaceful
peach: peach
peacock: peacock
peak: peak
peaked: peaked
peal: peal
pearl: pearled
peasant: peasant,peasants
peculiar: peculiar
pedagogue: pedagogue
pedalling: pedalling
pedantic: pedantic
pediment: pediment
peel: peel,peeled
peep: peeped,peeping
peer: peer,peered,peering
peevish: peevish
pembroke: pembroke
pen: pen,pens
penal: penal
penance: penance,penances
pence: pence
pencil: pencil,pencilled
penetrate: penetrate,penetrated,penetrating
penetration: penetration
penitent: penitent,penitents
penny: penny
pennyworth: pennyworth
people: peopled
pepper: pepper,peppered
perambulator: perambulator
perceive: perceive
perception: perception
perfect: perfect
perfection: perfections
perfections: perfections
perfectly: perfectly
perform: perform,performed,performing
performance: performances
perfume: perfume
perfumed: perfumed
peril: peril
perilous: perilous
period: period
periodic: periodic
perish: perished,perishing
permanent: permanent
permissible: permissible
permission: permission
permit: permitted
perpetrate: perpetrated
perpetual: perpetual
persist: persisted
person: people,person,persons
personal: personal
personality: personality
persuade: persuading
perturb: perturbed
pervading: pervading
pervert: pervert,perverted
pestilential: pestilential
peter: peter
petition: petition
phantasmal: phantasmal
phantasy: phantasy
phantom: phantom,phantoms
pharaohs: pharaohs
phase: phase,phases
phenomena: phenomena
phenomenon: phenomenon
philip: philip
philosopher: philosopher
philosophical: philosophical
philosophy: philosophy
phosphorescent: phosphorescent
photograph: photograph,photographs
phrase: phrase,phrases
phrasing: phrasing
physical: physical
physics: physics
physiologist: physiologist
piano: piano
pick: pick,picking
picture: picture,pictures
pidgin: pidgin
piece: piece,pieces
pierce: pierce,pierced,piercing
piercingly: piercingly
pierhead: pierhead
piety: pieties,piety
pig: pig,pigs
pigeon: pigeon
pile: piled
pilgrim: pilgrim
pillar: pillar,pillars
pillared: pillared
pillow: pillow
pin: pinned,pinning
pinch: pinched
pine: pining
pinhole: pinholes
pinion: pinioned
pink: pink
pint: pint
pious: pious
piously: piously
pip: pip
pipe: pipe,pipes
piss: piss
pit: pitting
pitch: pitch,pitched
pith: pith
pitiable: pitiable
pity: pity
placard: placard
placent: placent
plague: plague,plagues
plain: plain,plains
plainly: plainly
plan: plans
plane: plane,planing
plank: planks
plant: plant,planting,plants
platanus: platanus
plate: plate,plates
platform: platform
platinoid: platinoid
plato: plato
platt: platt
play: play,played,playing,plays
playbill: playbill
player: player,players
playful: playful
playground: playground,playgrounds
playroom: playroom,playrooms
plead: pleaded,pleading
pleasant: pleasant
pleasantly: pleasantly
pleasantry: pleasantry
pleased: pleased
pleasing: pleasing
pleasure: pleasure,pleasures
pledger: pledger
plenipotentiary: plenipotentiary
plentifully: plentifully
plenty: plenty
plop: plop
pluck: plucked
plum: plum
plump: plump
plunge: plunges,plunging
plural: plural
pock: pock
pocket: pocket,pockets
poem: poem,poems
poet: poet,poets
poetic: poetics
poetry: poetry
poignant: poignant
poise: poise,poised
poison: poison
poke: poke,poked,poking
poker: poker
pole: pole,poles
police: police
policeman: policeman
polished: polished
polite: polite
politely: politely
political: political
politician: politician
politics: politics
polling: polling
pollute: pollutes
pomp: pomp,pomps
pontiff: pontiff
pony: pony
pool: pool,pools
poor: poor,poorer
pope: pope
porcelain: porcelain
porch: porch
pore: pored,poring
porker: porkers
portal: portals
portent: portents
porter: porter,porters
portfolio: portfolio
portly: portly
portrait: portrait,portraits
portuguese: portuguese
position: position,positions
possess: possess,possessed,possesses
possession: possession
possibility: possibility
post: post,posted
pot: pot
potato: potatoes
potboy: potboy
pothead: pothead
potsherd: potsherds
pouch: pouch
pound: pound,pounds
pour: pour,poured,pouring,pours
poverty: poverty
powder: powdered
powdered: powdered
powdery: powdery
power: power,powers
powerful: powerful
powerless: powerless
powerlessness: powerlessness
practically: practically
practice: practice,practices
practise: practised,practising
prague: prague
praise: praise
praiser: praiser
prate: prating
prattle: prattled
pray: pray,prayed,praying,prays
prayer: prayer,prayers
preach: preach,preached
preacher: preacher
precede: preceding
precept: precepts
precision: precision
precursor: precursor
prefect: prefect,prefects
prefecture: prefecture
prefer: prefer,preferred
prelatic: prelatic
prelude: prelude
premonition: premonition
preparation: preparations
prepare: prepare,prepared,preparing
presence: presence
preserve: preserve,preserves
president: president
press: press,pressed,presses,pressing
pressed: pressed
pressure: pressure
presume: presumed
presumptuous: presumptuous
pretend: pretended,pretending
pretty: prettier,pretty
prevail: prevail
prevent: prevent,prevented
previous: previous
prey: prey,preys
price: price,priced
prick: pricked
pride: pride
priest: priest,priests
priestcraft: priestcraft
priested: priested
priesthood: priesthood
priestlike: priestlike
priestly: priestly
prince: prince,princes
principal: principal
principality: principalities
principle: principle
print: print,printed,prints
prism: prism
prison: prison,prisons
prisoner: prisoner,prisoners
private: private
prize: prize,prizes
probe: probed
proceed: proceed,proceeded,proceeding,proceeds
proceeds: proceeds
process: process,processes
processing: processing
procession: procession
processional: processional
prod: prodded,prodding
prodigal: prodigal
prodigious: prodigious
produce: produce,produced,produces
production: production
prof: prof
profane: profane
profaner: profaner
professional: professional
professor: professor
profit: profit,profiting,profits
profound: profound
profusely: profusely
programme: programme
progress: progress,progresses,progressing
progressive: progressive
prohibition: prohibition
project: project,projecting
prolong: prolonged,prolongs
prominent: prominent
prominently: prominently
promise: promise,promised,promises,promising
promote: promoting
promotion: promotion
prompting: promptings
prone: prone
prong: prong
pronounce: pronounce,pronounces
pronounced: pronounced
proof: proof
proofread: proofread
propagandist: propagandist
propagation: propagation
proper: proper
property: property
prophecy: prophecies,prophecy
propose: proposed,proposing
proprietary: proprietary
prose: prose
protagonist: protagonists
protect: protect,protected
protest: protest,protesting
protestant: protestant,protestants
protrude: protruded,protrudes
proudly: proudly
provide: provide,providing
provincial: provincial
provision: provision,provisions
provisional: provisional
provoke: provoke
prowess: prowess
prowl: prowled
prowling: prowling
prudence: prudence
prudent: prudent
pry: pry
psalm: psalms
psalms: psalms
psychology: psychology
public: public
puck: puck
pucker: puckered
pudding: pudding
puddle: puddles
pull: pull,pulled
pulp: pulp
pulpit: pulpit
pulsation: pulsation
pulse: pulses
punch: punch
punctual: punctual
punctuality: punctuality
pungent: pungent
punish: punish,punished
punishment: punishment
punitive: punitive
puppy: puppy
purchase: purchase
pure: pure,purest
purely: purely
purgatorial: purgatorial
purgatory: purgatory
purge: purged
purify: purified
purity: purity
purple: purple
purpose: purpose,purposes
purr: purred
purse: purse,pursed
pursue: pursuing
pursuit: pursuit
push: pushed,pushing
putrefaction: putrefaction
putrid: putrid
puzzle: puzzled
quadrangle: quadrangle
quadruple: quadrupling
quagmire: quagmire
quail: quail
quaint: quaint
quaintly: quaintly
quaking: quaking
quality: qualities,quality
quantity: quantity
quarantine: quarantines
quarrel: quarrel
quarrelsome: quarrelsome
quart: quarts
quarter: quarter
quartet: quartet
quasi: quasi
quay: quay,quays
queen: queen
queer: queer,queerest
quell: quelled
quench: quench,quenched,quenching
querulous: querulous
quest: quest
question: question,questions
questioner: questioner
quia: quia
quick: quick,quicker
quicken: quicken,quickened,quickening
quid: quid
quiet: quiet
quietly: quietly
quietude: quietude
quis: quis
quiver: quivered,quivering
quod: quod
quote: quote,quoting
rabbit: rabbits
rabbitskin: rabbitskin
rabble: rabble
race: race,raced,races,racing
racehorse: racehorses
rack: racks
racket: racket
radiance: radiance
radiant: radiant
radiantly: radiantly
radiate: radiating
rage: rage,raged,rages,raging
ragged: ragged
rail: rail
railing: railing
railway: railway
raiment: raiment
rain: rain
raindrop: raindrops
rainy: rainy
raise: raise,raised,raising
rake: rake
rancour: rancour
random: random
rangers: rangers
rank: rank
rapidly: rapidly
rapier: rapier
rapt: rapt
rapture: rapture
rare: rare,rarer
rascal: rascal
rat: rat,rats
rath: rath
rattle: rattle,rattled,rattling
ravage: ravaged
ravenous: ravenous
ravisher: ravishers
raw: raw
rawly: rawly
ray: ray,rays
reach: reach,reached,reaching
reactionary: reactionary
read: read,reading
readable: readable
reader: reader
reading: reading
ready: ready
real: real
realise: realise
reality: reality
rearisen: rearisen
reason: reason,reasoned
reasonable: reasonable
reasoning: reasoning
reassume: reassumed
rebellion: rebellion
rebellious: rebellious
rebind: rebound
rebuff: rebuffs
recall: recall,recalled,recalling
recede: recede,receded,receding
receipt: receipt,receipts
receive: receive,received,receiving
reception: reception
recipe: recipe
recite: recite
reckless: reckless
reckon: reckoning
reckoning: reckoning
recognise: recognise,recognised,recognising
record: record
recover: recovering
recreate: recreate
rector: rector
recur: recurred,recurring
recurrence: recurrence
red: red
redden: redden,reddened
reddish: reddish
redeem: redeem,redeemed
redeemer: redeemer
redemption: redemption
redistribute: redistribute,redistributing
redistributing: redistributing
redistribution: redistribution
reed: reed
reek: reeking
reeking: reeking
reel: reel
refectory: refectory
refer: refers
reference: references
refine: refine,refined,refines
reflect: reflect,reflected,reflecting
reflection: reflection,reflections
reflectively: reflectively
reflector: reflector
reflex: reflex
reform: reformed
refrain: refrain
refresh: refresh
refreshment: refreshment
refrigerate: refrigerating
refuge: refuge
refund: refund
refusal: refusal
refuse: refused
regard: regard,regarded
regiment: regiment
region: region
register: register,registered
regret: regret,regrets
regretfully: regretfully
regularly: regularly
regulate: regulating
rehearsal: rehearsals
reign: reigned,reigns
rein: reins
reinforce: reinforcing
rejection: rejection
relation: relation,relations
relationship: relationships
relative: relatives
release: release
relief: relief
religion: religion,religions
religious: religious
religiously: religiously
relish: relish
reluctance: reluctance
remain: remain,remained,remaining,remains
remark: remark,remarks
remedy: remedies
remember: remember,remembered,remembering,remembers
remembrance: remembrance
remind: remind,reminded
remit: remitted
remorse: remorse
remote: remote,remotest
remoteness: remoteness
removal: removal
remove: remove,removed
rename: renamed
rend: rend
render: render,rendered,rendering
renegade: renegade
reopen: reopened
repair: repaired
repeat: repeat,repeated,repeating
repel: repelled,repelling
repellent: repellent
repent: repent,repented
repentance: repentance
repentantly: repentantly
repercussion: repercussion
repetition: repetition
replace: replace,replacing
replacement: replacement
reply: replied,reply
report: reported,reports
reporter: reporter
repose: repose
representation: representation,representations
reproach: reproach,reproaches
reproachful: reproachful
reproduction: reproduction
reproof: reproof
reprovingly: reprovingly
reptile: reptile
repugnance: repugnance
reputation: reputation
request: request
require: require,required,requires
requirement: requirements
rescript: rescript
resemble: resembled
resent: resented
resentment: resentment
reshape: reshaping
resist: resist
resistance: resistance
resolute: resolute
resolution: resolutions
resounding: resounding
respect: respect,respecting
respectable: respectable
respectful: respectful
respite: respite
resplendent: resplendent
respond: respond,responded,responds
response: response,responses
responsibility: responsibility
responsive: responsive
rest: rest,rested,resting,rests
restless: restless
restlessly: restlessly
restlessness: restlessness
restore: restore
restrain: restrained
restriction: restrictions
result: result
resume: resumed
retain: retain,retaining
retire: retired
retreat: retreat
retrieve: retrieve
return: return,returned,returning,returns
reveal: reveal
revel: revelled
reveller: revellers
revengeful: revengeful
revenue: revenue
reverberation: reverberation
reverence: reverence
reverend: reverend
reverent: reverent
reverie: reverie,reveries
revibrate: revibrate
review: reviews
revile: revile,reviled
revival: revival
revolt: revolt,revolted,revolting
revolutionary: revolutionary
reward: reward
rhetoric: rhetoric
rheum: rheum
rhyme: rhyme
rhymester: rhymester
rhythm: rhythm,rhythms
rhythmic: rhythmic
rhythmical: rhythmical
rhythmically: rhythmically
rib: ribs
rice: rice
rich: rich,richer
richly: richly
rictus: rictus
rid: rid
riddle: riddle,riddles
ride: riding,rode
ridiculous: ridiculous
rifle: rifled
rift: rift
rightly: rightly
rigid: rigid
rigorous: rigorous
rim: rim,rims
rimmed: rimmed
riot: riot,riots
rip: ripped,ripping
ripe: ripe
rippingly: rippingly
rise: rise,risen,rising,rose
rising: risings
risk: risk
risotto: risotto
rite: rite
ritual: ritual
rival: rival,rivals
river: river
rivulet: rivulet
road: road,roads
roadway: roadway
roar: roar,roared,roaring
rob: rob,robbed
robber: robber
robbery: robberies
robe: robe,robed
robed: robed
roche: roche
rock: rock,rocking,rocks
rod: rod,rods
roderick: roderick
rogue: rogue
roguery: roguery
roll: roll,rolled,rolling
rolling: rolling
roman: roman,romans
romantic: romantic
rome: rome
romp: romped,romping
roof: roof,roofs
root: root,rooted,rooting
rope: rope,ropes
rosary: rosaries,rosary
rose: rose,roses
rosebush: rosebushes
roselike: roselike
rosin: rosin
rosy: rosy
rot: rot,rotted,rotting
rotunda: rotunda
rouge: rouged
rough: rough
roughly: roughly
rounders: rounders
roundheaded: roundheaded
rousseau: rousseau
rout: rout
route: routed,routing
rove: rove,roved
rowan: rowan
rowing: rowing
royal: royal
royalty: royalties,royalty
rub: rubbed,rubbing
rubbish: rubbish
ruddy: ruddy
rude: rude
rudely: rudely
rudeness: rudeness
rue: rue
ruffian: ruffian
ruffle: ruffled
rugged: rugged
ruin: ruin
rule: rule,rules
ruler: ruler
rumble: rumbling
rump: rump
runner: runner,runners
rush: rushed
russet: russet
rustling: rustling
sabbath: sabbath
sack: sack
sackcloth: sackcloth
sacrament: sacrament,sacraments
sacramental: sacramental
sacred: sacred
sacrifice: sacrifice,sacrificed,sacrificing
sacrificial: sacrificial
sacrilege: sacrilege
sacrilegious: sacrilegious
sacristan: sacristan
sacristy: sacristy
sad: sad,sadder
sadden: saddened
saddlebow: saddlebow
sadly: sadly
sadness: sadness
safe: safe
safely: safely
sag: sag
sailor: sailor
saint: saint,saints
saintliness: saintliness
saintly: saintly
sake: sake
salaam: salaamed
salt: salt
salubrious: salubrious
salutary: salutary
salute: salute,saluted
salvation: salvation
san: san
sanctify: sanctified,sanctifying
sanctity: sanctity
sanctuary: sanctuary
sand: sand,sanded,sands
sandhill: sandhill
sandy: sandy
sarcasm: sarcasm
sash: sash
satan: satan
satisfaction: satisfaction
satisfy: satisfies,satisfy
satisfying: satisfying
saturate: saturated
saturday: saturday
sauce: sauce
sauceboat: sauceboat
saucer: saucer
sausages: sausages
savage: savage,savages
save: save,saved,saving
saviour: saviour
savour: savour,savours
sawdust: sawdust
sawn: sawn
scald: scalded,scalding
scale: scale,scales
scalp: scalp
scamper: scampering
scandal: scandal
scandalise: scandalise
scandalous: scandalous
scant: scant
scarcely: scarcely
scarlet: scarlet
scatter: scatter,scattered
scene: scene,scenes
scenery: scenery
sceptical: sceptical
schemer: schemer,schemers
schism: schisms
scholastic: scholastic
school: school,schooled
schoolboy: schoolboy
schoolhouse: schoolhouse
schoolmaster: schoolmaster
schoolroom: schoolroom
science: science
scissors: scissors
scoff: scoff
scoop: scooped
scope: scope
score: score
scorn: scorn,scorned
scornful: scornful
scornfully: scornfully
scott: scott
scourge: scourged
scowl: scowl
scramble: scrambled
scrape: scraped,scraping
scrawl: scrawl,scrawled
scream: scream,screamed,screaming
screech: screech,screeching
screw: screwed
scribbler: scribbler
scrimmage: scrimmage
scroll: scroll
scrub: scrub,scrubbed
scruple: scruples
scrupulous: scrupulous
scrupulously: scrupulously
scud: scudding
scullery: scullery
scullion: scullion
scum: scum
scut: scut
scuttle: scuttling
sea: sea
seabird: seabird
seaborne: seaborne
seaport: seaport
search: search,searched,searching
seashore: seashore
season: season,seasons
seasoned: seasoned
seat: seat,seated,seats
seawall: seawall
seaward: seaward
seawater: seawater
seaweed: seaweed
secession: secessions
secondhand: secondhand
secrecy: secrecy
secret: secret,secrets
secretary: secretary
secretly: secretly
sectarianism: sectarianism
secular: secular
secure: secure
seduce: seduce,seduced
seed: seed,seeds
seek: seek,sought
seemingly: seemingly
seethe: seethed,seethes
seize: seize,seized,seizing
sell: sell,sold
seller: sellers
semblance: semblance
seminary: seminaries
senate: senate
send: send,sending
senior: senior
sensation: sensation
sense: sense
sensitive: sensitive
sensitiveness: sensitiveness
sentence: sentence,sentences
sentiment: sentiment
sentry: sentries,sentry
separable: separable
separate: separate,separated,separates
separation: separation
september: september
sepulchre: sepulchre
sequel: sequel
seraph: seraph
seraphic: seraphic
seraphim: seraphim
sere: sere
serene: serene
serf: serf
sergeant: sergeant
serpent: serpent
servant: servant,servants
serve: serve,served,serving
server: server
service: service
servile: servile
serving: serving
servingman: servingman
set: set,setting
settle: settled,settling
seventh: seventh
sever: severed
severe: severe
sewer: sewer
sex: sex,sexes
shabby: shabby
shade: shade
shadow: shadow,shadowed,shadows
shaft: shaft
shaggy: shaggy
shake: shake,shaken,shaking,shook
shallow: shallow
shalt: shalt
shambling: shambling
shame: shame,shamed
shameful: shameful
shameless: shameless
shape: shape,shaped,shapes,shaping
shapeless: shapeless
shapely: shapely
share: share,shared,shares,sharing
sharp: sharp
sharpen: sharpened,sharpening
sharpened: sharpened
sharply: sharply
shatter: shattered
shaven: shaven
shawl: shawl
sheath: sheath
sheet: sheet,sheets
shelf: shelf,shelves
shelley: shelley
shelter: shelter,sheltering
shepherd: shepherd
shield: shield
shieldlike: shieldlike
shift: shifted,shifts
shilling: shilling
shimmer: shimmer
shimmering: shimmering
shine: shine,shining,shone
shingle: shingle
shiny: shiny
ship: ship,ships
shipwreck: shipwrecks
shirt: shirt
shiver: shiver,shivered,shivering
shivery: shivery
shock: shock,shocked,shocks
shocked: shocked
shod: shod
shoe: shoe,shoes
shoot: shot
shooting: shooting
shop: shop,shops
shopman: shopman
shore: shore
shoreless: shoreless
short: short,shorter,shortest
shortbread: shortbread
shortly: shortly
shoulder: shoulder,shouldered,shouldering,shoulders
shout: shouted,shouting,shouts
shove: shoved
shower: shower,showers
shred: shreds
shrewd: shrewd
shriek: shrieking
shrill: shrill
shrine: shrine
shrink: shrank,shrink,shrinking,shrinks,shrunk
shrivel: shrivelled
shrivelled: shrivelled
shroud: shrouded
shrub: shrubs
shrunken: shrunken
shuffling: shuffling
shun: shun,shunned
shut: shut
shy: shies,shy
shyly: shyly
shyness: shyness
sick: sick
sicken: sickened
sickening: sickening
sickish: sickish
sickly: sickly
sickness: sickness
sideboard: sideboard
sidewall: sidewall
sideways: sideways
sidle: sidled
siegfried: siegfried
siena: siena
sigh: sigh,sighed,sighing,sighs
sight: sight
sign: sign,signed,signs
signal: signal,signalled
signature: signature,signatures
signboard: signboards
signet: signet
signify: signifies
silence: silence,silences
silent: silent
silently: silently
silk: silk
silken: silken
sill: sill
silly: silly
silver: silver
silvery: silvery
similiter: similiter
simmer: simmering
simon: simon
simoom: simoom
simple: simple,simplest
simpliciter: simpliciter
simplicity: simplicity
simply: simply
sin: sin,sinned,sinning,sins
sincerely: sincerely
sincerity: sincerity
sinewy: sinewy
sinful: sinful
sinfully: sinfully
sing: sang,sing,singing,sung
singe: singed
singer: singer,singers
singing: singing
single: single
singlet: singlets
singular: singular
sink: sank,sink,sinking,sunk
sinless: sinless
sinner: sinner,sinners
sion: sion
sir: sir,sirs
sister: sister,sisters
sit: sat,sit,sits,sitting
sixpence: sixpence
sixteen: sixteen
sixth: sixth
sizeable: sizeable
skeleton: skeleton
skewer: skewered
skill: skill
skin: skin
skintight: skintight
skip: skipped
skirt: skirts
skull: skull
sky: skies,sky
skylight: skylight
skyline: skyline
slab: slab,slabs
slam: slammed
slap: slapped
slate: slate,slates
sleek: sleek
sleep: sleep,sleeping,slept
sleeper: sleepers
sleeping: sleeping
sleepy: sleepy
sleeve: sleeve,sleeves
slender: slender
slide: slid,slide
slight: slight,slighted
slily: slily
slim: slim
slime: slime
slimy: slimy
sling: slung
slip: slipped,slipping
slipper: slippers
slobber: slobbering
slobbering: slobbering
slope: slope,sloping
sloth: sloth
slow: slow,slowed
slowly: slowly
slug: slugs
sluggish: sluggish
sluggishly: sluggishly
slumber: slumber
sly: sly
smack: smacked,smacking,smacks
smacking: smacking
smart: smart,smarting
smear: smear
smell: smell,smelling,smells,smelt
smile: smile,smiled,smiles,smiling
smiler: smiler
smite: smitten,smote
smithy: smithy
smitten: smitten
smoke: smoke,smoked,smokes,smoking
smoking: smoking
smoky: smoky
smooth: smooth
smoulder: smouldering
snake: snake
snaky: snaky
snap: snap
snare: snares
snatch: snatched
sneer: sneering
sneerer: sneerer
sneeze: sneeze
snort: snort
snoutish: snoutish
snuffbox: snuffbox
snug: snug
soar: soaring
sob: sob,sobbed,sobbing,sobs
sober: sober
social: social
socialism: socialism
socket: socket
sodalist: sodalists
sodality: sodality
sofa: sofa
soft: soft,softer
soften: soften
softly: softly
softness: softness
soldier: soldier,soldiers
soldiery: soldiery
sole: sole
solemn: solemn
solemnly: solemnly
solicit: solicit
solicitation: solicitation
solid: solid
solitary: solitary
solve: solve
sombre: sombre
somnolent: somnolent
son: son,sons
song: song,songs
sonny: sonny
sonorously: sonorously
soothe: soothed
soothing: soothing
sophistry: sophistry
sordid: sordid
sore: sore
sorrow: sorrow,sorrows
sorrowful: sorrowful
sorrows: sorrows
sort: sorts
soul: soul,souls
sound: sound,sounded,sounding,sounds
soup: soup
sour: sour
source: source,sources
sourly: sourly
soutane: soutane
south: south
southern: southern
southward: southward
sovereign: sovereign
sovereignty: sovereignty
sow: sow,sowed
space: space,spaces
spade: spade
spain: spain
span: span
spaniard: spaniard
spanish: spanish
spare: spare,spared,sparing
spark: spark
spasm: spasm
spatial: spatial
speak: speak,speaking,speaks,spoke,spoken
speaker: speaker
speaking: speaking
spear: spear
special: special
specially: specially
species: species
speck: speck
speckled: speckled
spectacles: spectacles
spectral: spectral
spectre: spectre
speculation: speculation,speculations
speech: speech,speeches
speed: speed
spell: spell
spelling: spelling
spend: spent
spiff: spiffing
spike: spikes
spikenard: spikenard
spin: spin,spinning
spine: spine
spirit: spirit,spirits
spirited: spirited
spiritual: spiritual
spit: spat,spit,spitting
spite: spite
spitting: spitting
spittle: spittle
splash: splashed,splashes
splendour: splendour
splitting: splitting
spoil: spoils
spoiled: spoiled
spool: spools
spoonful: spoonful
sport: sports
spot: spot
spotless: spotless
spouse: spouse
spray: spray,sprays
spread: spread,spreading
sprig: sprigs
spring: sprang,spring,sprung
springboard: springboard
sprinkle: sprinkle
sprinter: sprinter
spurn: spurned,spurning
spy: spied,spy
squad: squad
squalid: squalid
squall: squall
squalor: squalor
squander: squandered,squandering
square: square,squares
squarely: squarely
squat: squat
squeak: squeak,squeaking
squeeze: squeezing
squire: squires
staff: staff
stage: stage,stages
stagnation: stagnation
stain: stain,stained
stair: stairs
staircase: staircase
stale: stale
stall: stalls
stammer: stammering
stamp: stamping
stand: stand,standing,stood
stanza: stanzas
star: star,starred,stars
starch: starched
stardust: stardust
stare: stare,stared,stares,staring
starry: starry
start: start,started,starting
startle: startled
starve: starving
stasis: stasis
stately: stately
statement: statement,statements
static: static
station: station,stations
statue: statue,statues
stature: stature
status: status
stave: stave
stay: stay,stayed
stead: stead
steadfast: steadfast
steady: steadied,steadier
steal: steal,stealing,stole,stolen
steam: steamed,steaming
steamer: steamers
steel: steel
steer: steered
stench: stench
step: step,stepping,steps
stephanos: stephanos
stephen: stephen
stern: stern
sternly: sternly
stew: stew,stewing
steward: stewards
stewardship: stewardship
stewing: stewing
stick: stick,sticks,stuck
stiff: stiff
stiffly: stiffly
stifle: stifling
stilly: stilly
stimulant: stimulants
stimulus: stimulus
sting: sting,stinging,stung
stink: stank,stink,stinking
stinking: stinking
stinkpot: stinkpot
stir: stir,stirred,stirring
stock: stocked,stocking
stocking: stocking,stockings
stolid: stolid
stomach: stomach
stone: stone,stones
stonecutting: stonecutting
stoop: stooped
stopper: stopper
store: stored
storied: storied
storm: storm
story: stories,story
storyteller: storyteller
stout: stout
stow: stowed
straggler: stragglers
straight: straight
straighten: straighten,straightened
strain: strain,straining
strait: strait
straitness: straitness
strand: strand
strange: strange
strangely: strangely
strangeness: strangeness
stranger: stranger,strangers
strangle: strangled
straw: straw
stray: strayed
streak: streaks
stream: stream,streamed,streaming,streams
streaming: streaming
street: street,streets
strength: strength
strengthen: strengthen,strengthening
stress: stress
stressed: stressed
stretch: stretch,stretched
strew: strewn
strict: strict
stride: striding,strode
strife: strife,strifes
strike: strike,striking,struck
striking: striking
strip: stripped,strips
strive: strive,striving,strove
stroke: stroke,strokes,stroking
strong: strong,stronger
structure: structure
struggle: struggle,struggled,struggles,struggling
stuart: stuart
stubble: stubble
stuck: stuck
stud: studded
student: student,students
study: studied,studies,study
stuff: stuff,stuffs
stultified: stultified
stumble: stumble,stumbled,stumbling
stump: stump
stupor: stupor
style: style
suave: suave
suavely: suavely
subdeacon: subdeacon
subject: subject,subjected,subjects
subjection: subjection
sublime: sublime
submission: submission
submissively: submissively
subscribe: subscribe
substance: substance
subterfuge: subterfuge
subtle: subtle,subtlest
subtler: subtler
subversive: subversive
succeed: succeeded,succeeding
success: success
succession: succession
succumb: succumbing
suck: suck,sucking
sudden: sudden
suddenly: suddenly
suffer: suffer,suffered,suffering
sufferance: sufferance
sufferer: sufferer,sufferers
suffering: suffering,sufferings
suffice: suffice
suffocate: suffocated,suffocating
suffrage: suffrage
suffuse: suffused
sugan: sugan
sugar: sugar,sugared
suggestion: suggestions
suit: suit,suited
sully: sully
sulphurous: sulphurous
sum: sum,sums
summer: summer
summon: summon,summoned
summons: summons
sun: sun
sunbonnet: sunbonnet,sunbonnets
sunday: sunday
sundays: sundays
sunder: sundered
sundering: sundering
sundown: sundown
sunken: sunken
sunlight: sunlight
sunny: sunny
sunrise: sunrise
sunt: sunt
sunward: sunward
super: super
supererogation: supererogation
supersaturate: supersaturated
supper: supper
supple: supple
supply: supply
support: support,supports
suppose: suppose
suppression: suppression
supralapsarian: supralapsarian
supreme: supreme
supremely: supremely
surd: surd
surely: surely
surface: surface
surge: surge
surlily: surlily
surly: surly
surname: surname
surplice: surplices
surprise: surprise,surprised
surrender: surrender,surrendering
surround: surrounded
surroundings: surroundings
survey: survey
survive: survive
suspend: suspended
suspicion: suspicion
suspicious: suspicious
sustain: sustained,sustains
swallow: swallow,swallowed,swallows
swamp: swamp
swan: swans
swarm: swarming
sway: sway,swayed,swaying
swaying: swaying
swear: swear
sweat: sweat,sweated
sweater: sweater,sweaters
sweep: sweep,sweeping,swept
sweet: sweet,sweets
sweetness: sweetness
swell: swollen
swerve: swerve,swerving
swift: swift
swiftly: swiftly
swing: swing,swung
swinging: swinging
swirl: swirl,swirling
swish: swish,swished
swishing: swishing
switch: switched
swollen: swollen
swoon: swoon,swooning
swop: swop
sword: sword
swordlike: swordlike
syllable: syllable
symbol: symbol,symbols
symbolise: symbolising
symbolism: symbolism
symmetrical: symmetrical
sympathy: sympathy
synonymous: synonymous
synopsis: synopsis
synthesis: synthesis
tabernacle: tabernacle
table: table,tables
tablecloth: tablecloth
tablet: tablet
tail: tail,tails
talbot: talbot
tale: tale,tales
talent: talent
talk: talk,talked,talking,talks
talking: talking
tall: tall
tallow: tallow
tame: tame
tan: tan,tanned
tangle: tangle
tangled: tangled
tanto: tanto
tap: tapped,tapping
tapelike: tapelike
tar: tar
tara: tara
tardy: tardy
tarnish: tarnished
tarry: tarrying
task: task
taste: taste,tasted,tasting
tasty: tasty
tate: tate
tattered: tattered
taunt: taunt,taunting
tavern: taverns
tawdry: tawdry
tawny: tawny
tax: tax,taxes
taxgatherer: taxgatherer
tea: tea
teach: taught,teach,teaching
teacher: teacher
teacup: teacups
team: team
tear: tear,tearing,tears,tore,torn
technical: technical
teem: teeming
telegraph: telegraph
teller: teller
temper: temper
temperament: temperament
temperature: temperature
temple: temple,temples
tempora: tempora
temporal: temporal
tempt: tempted,tempts
temptation: temptation,temptations
tempter: tempter,tempters
temptress: temptress
tend: tending
tendency: tendency
tender: tender
tenderness: tenderness
tendril: tendrils
tenement: tenement
tenfold: tenfold
tennyson: tennyson
tenor: tenor
tenuous: tenuous
tepid: tepid
terence: terence
term: term,terms
terminology: terminology
terrace: terrace
terrible: terrible
terribly: terribly
terrier: terrier
terrific: terrific
terrified: terrified
terror: terror
testament: testament,testaments
testimonial: testimonial
texture: texture
thankful: thankful
thankfulness: thankfulness
thanksgiving: thanksgiving
theatre: theatre
thee: thee
theme: theme,themes
theologian: theologian,theologians
theological: theological
theorem: theorem
theory: theory
therewith: therewith
thickening: thickening
thicket: thicket
thickness: thickness
thief: thief
thigh: thigh,thighs
thimbleful: thimbleful
thine: thine
thinking: thinking
thinly: thinly
thirteen: thirteen
thirtieth: thirtieth
thistle: thistles
thither: thither
thomas: thomas
thorn: thorn,thorns
thoughtfully: thoughtfully
thoughtlessness: thoughtlessness
thousandfold: thousandfold
thread: threads
threadbare: threadbare
threaten: threatened,threatening
threefold: threefold
threepence: threepence
threshold: threshold
thrice: thrice
thrill: thrill,thrilled
thrilled: thrilled
throat: throat,throats
throaty: throaty
throb: throb,throbbing
throne: thrones
throng: throng,thronging
throw: threw,throw,throwing,thrown
thrust: thrust,thrusting
thud: thud,thuds
thumb: thumb
thunder: thunder
thundercloud: thundercloud
thunderstorm: thunderstorms
thurible: thurible
thursday: thursday
thusness: thusness
thy: thy
tick: ticking
ticket: ticket,tickets
ticking: ticking
tickling: tickling
tide: tide,tides
tiding: tidings
tie: tie,tied,ties
tier: tier
tig: tig
tight: tight
tighten: tightening
tightly: tightly
tile: tiled,tiles
tim: tim
time: time,times,timing
timeless: timeless
timeworn: timeworn
timid: timid
timidity: timidity
timidly: timidly
timorous: timorous
tin: tins
tinge: tinges
tingle: tingle,tingling
tingling: tingling
tinkling: tinkling
tinsel: tinsel
tiny: tiniest,tiny
tiptoe: tiptoe
tiptop: tiptop
tired: tired
tissue: tissue
title: title,titles
titter: titter,tittered,tittering
toast: toast,toasted
tobacco: tobacco
toe: toe,toes
token: token
tolerantly: tolerantly
toll: toll
tolling: tolling
tom: tom
tomorrow: tomorrow
tone: tone,tones
toneless: toneless
tongue: tongue,tongues
tonight: tonight
tool: tools
tooth: teeth
toothpick: toothpick
torment: torment,tormented,torments
tormentor: tormentors
torn: torn
torpid: torpid
torpor: torpor
torture: torture,tortured,tortures
toss: toss,tossed
total: total
totally: totally
totum: totum
touch: touch,touched,touching
tourist: tourist
towel: towels
tower: tower
town: town
township: township
towser: towser
toy: toy,toying
trace: trace,traces
track: track
tract: tract
tractable: tractable
trade: trade
trademark: trademark
tradition: tradition
traffic: traffic
tragic: tragic
trail: trail,trailed,trailing
train: train,trained
trainer: trainer
traitor: traitor
tram: tram,trams
tramp: tramp,tramping
trample: trample,trampled
tranquil: tranquil
tranquilly: tranquilly
trans: trans
transcribe: transcribe
transcription: transcription
transfer: transfers
transference: transference
transfigure: transfigured
transfix: transfixing
transform: transformed
transgression: transgression,transgressions
transgressor: transgressor
translate: translate
translation: translation
transmit: transmit
transmute: transmuting
travel: travelled,travelling
traverse: traversed
tread: trod
treasure: treasure,treasures
treat: treat,treated
treatment: treatment
treble: treble,trebling
tree: tree,trees
trellis: trellises
tremble: trembled,trembling
tremor: tremor,tremors
tremulous: tremulous
trepidation: trepidation
trial: trial,trials
triangle: triangle
tribute: tribute
trick: trick
trickle: trickled,trickling
trigonometry: trigonometry
trill: trilled
trim: trim
trinity: trinity
trinket: trinkets
triple: triple
trite: trite
triumph: triumph,triumphs
trivial: trivial
troop: troop
tropics: tropics
trouble: trouble,troubled
troubled: troubled
troublesome: troublesome
troubling: troubling
trough: troughs
trousers: trousers
trudge: trudging
true: true,truest
trumpet: trumpet
truss: trussed
trust: trust
trusty: trusty
truth: truth
tryst: tryst
tsar: tsar
tu: tu
tub: tub
tuck: tucked,tucking
tuesday: tuesday
tuft: tufted,tufts
tug: tugged
tuition: tuition
tumble: tumbling
tumult: tumult,tumults
tundish: tundish
tunelessly: tunelessly
tunicle: tunicle
tunnel: tunnel,tunnels
turbulence: turbulence
turbulent: turbulent
turf: turf
turk: turk
turkey: turkey
turnip: turnips
turnover: turnover
turnstile: turnstile
turret: turret,turrets
tusk: tusks
tusker: tusker,tuskers
tussle: tussle
tutor: tutor
tweed: tweed
twig: twig
twigging: twigging
twilight: twilight
twine: twine,twines
twined: twined
twinkle: twinkled,twinkling
twirl: twirling
twist: twist,twisted,twisting
twisted: twisted
twister: twisters
twitching: twitching
twitter: twittered
twofold: twofold
type: type,types
tyrant: tyrant
ugly: ugly
ulster: ulster
umbrella: umbrella,umbrellas
unable: unable
unadorned: unadorned
unaided: unaided
unawares: unawares
unbaptised: unbaptised
unbearably: unbearably
unbent: unbent
unbreathable: unbreathable
unbroken: unbroken
unbuttoned: unbuttoned
uncarpeted: uncarpeted
unceasing: unceasing
unceasingly: unceasingly
uncertain: uncertain
unchallenged: unchallenged
unchangeable: unchangeable
uncle: uncle
uncoil: uncoiling
uncomfortable: uncomfortable
uncontaminated: uncontaminated
uncouth: uncouth
uncover: uncover,uncovered
uncreated: uncreated
undefiled: undefiled
undefined: undefined
underdone: underdone
understand: understand,understands,understood
understanding: understanding
undismayed: undismayed
undistinguished: undistinguished
undivined: undivined
undo: undid,undo,undone
undoubtedly: undoubtedly
undress: undress,undressed,undressing
undressed: undressed
undry: undried
unearth: unearthed
unearthly: unearthly
uneasily: uneasily
uneducated: uneducated
unenforceability: unenforceability
unexpected: unexpected
unfair: unfair
unfallen: unfallen
unfavourable: unfavourable
unfelt: unfelt
unfettered: unfettered
unfinished: unfinished
unfold: unfold,unfolding
unforeseen: unforeseen
unfortunate: unfortunate
ungraced: ungraced
ungrudgingly: ungrudgingly
unhappy: unhappy
unheeded: unheeded
uniform: uniform,uniforms
union: union
unite: unite,united,unites,uniting
united: united
universal: universal
universalis: universalis
universality: universality
universe: universe
university: university
unjust: unjust
unkempt: unkempt
unkindness: unkindness
unknown: unknown
unlasting: unlasting
unlawful: unlawful
unlink: unlink
unlit: unlit
unlived: unlived
unlock: unlocking
unluckily: unluckily
unmanly: unmanly
unnerve: unnerved
unpeopled: unpeopled
unpleasant: unpleasant
unpleasantness: unpleasantness
unprotected: unprotected
unpunished: unpunished
unquestionable: unquestionable
unreal: unreal
unrepentant: unrepentant
unrepented: unrepented
unrest: unrest
unresting: unresting
unseemly: unseemly
unseen: unseen
unshaven: unshaven
unsolicited: unsolicited
unspeakable: unspeakable
unspoken: unspoken
unsubstantial: unsubstantial
unsure: unsure
unsustaining: unsustaining
untenanted: untenanted
untidy: untidy
untrue: untrue
unutterable: unutterable
unveil: unveil
unwatchful: unwatchful
unwell: unwell
unwieldy: unwieldy
unwind: unwound
unworldly: unworldly
unworthiness: unworthiness
unworthy: unworthy
upbraid: upbraid
update: updated
uphill: uphill
uphold: upheld
uplift: uplifted
uplifted: uplifted
upper: upper
upraise: upraise
upright: upright
upsetting: upsetting
upstairs: upstairs
upward: upward
urbane: urbane
urbanely: urbanely
urchin: urchin
urge: urge,urged,urges,urging
urinal: urinal
urine: urine
usage: usage
useless: useless
user: user
usher: ushered
usual: usual
ut: ut
utter: utter,uttered,utters
utterance: utterance
utterly: utterly
vacant: vacant
vacation: vacation
vague: vague
vaguely: vaguely
vagueness: vagueness
vain: vain
vainly: vainly
valid: valid
valley: valley
valve: valve
van: vans
vanilla: vanilla
vanish: vanished,vanishing
vanity: vanities,vanity
vanman: vanmen
vanquish: vanquished
vaporous: vaporous
vapour: vapour
vapours: vapours
vapoury: vapoury
variant: variant
variety: variety
vary: varied
vast: vast,vaster
vastly: vastly
vastness: vastness
vault: vault,vaulting,vaults
vegetable: vegetable
vegetation: vegetation
vehemently: vehemently
vehicle: vehicle
veil: veil,veiled,veiling,veils
veiled: veiled
vein: veins
velocity: velocity
velvet: velvet
venal: venal
veneration: veneration
vengeance: vengeance
venial: venial
vent: vent
ventricle: ventricles
venus: venus
verbal: verbal
verge: verge,verges
vermin: vermin
veronica: veronica
verse: verse,verses
verses: verses
version: version,versions
vervain: vervain
vessel: vessel
vest: vested
vested: vested
vestment: vestments
vestry: vestry
vesture: vesture
vexilla: vexilla
vice: vice,vices
victor: victor
victoria: victoria
victory: victories,victory
vienna: vienna
view: view,viewed,viewing
vigilant: vigilant
vigour: vigour
vile: vile,vilest
villa: villas
village: village
villainous: villainous
villanelle: villanelle
vincent: vincent
vindicate: vindicated
vinegar: vinegar
violate: violates
violence: violence
violent: violent
violently: violently
violet: violets
viper: viper
virgil: virgil
virgin: virgin
virginal: virginal
virtual: virtual
virtue: virtue,virtues
virus: virus
visa: visa
viscid: viscid
visible: visible
vision: vision
visit: visit,visits
visitor: visitors
vita: vita
vital: vital
vitality: vitality
vitals: vitals
vive: vive
vivid: vivid
vividly: vividly
vocation: vocation
voice: voice,voices,voicing
voices: voices
void: void
volunteer: volunteer,volunteers
vomit: vomited
vote: votes
vouchsafe: vouchsafed
vow: vows
vowel: vowel,vowels
voyage: voyaging
wade: waded,wading
wafer: wafer
wag: wagging
wagonette: wagonette
wail: wail
wainscot: wainscot
waist: waist
waistcoat: waistcoat,waistcoats
wait: wait,waited,waiting
waiter: waiter,waiters
wake: wake,wakes,waking,woke
waken: wakened
walk: walk,walked,walking,walks
walker: walker
walking: walking
wall: wall,walls
wallow: wallowed
wallpaper: wallpaper
walter: walter
waltz: waltz
wan: wan
wander: wander,wandered,wandering
wanderer: wanderer
wanderings: wanderings
wane: wane,waned,waning
wantonness: wantonness
war: war,wars
wardrobe: wardrobe
ware: ware
warm: warm,warmed,warmer
warmth: warmth
warn: warning
warning: warning,warnings
warranty: warranties,warranty
wart: warts
warwick: warwick
wash: wash,washed,washing
washing: washing
washstand: washstand
waste: waste,wasting
watch: watch,watched,watching
watcher: watcher,watchers
watchful: watchful
water: water,watered,watering,waters
waterlog: waterlogged
waterproof: waterproofs
watery: watery
wave: wave,waves,waving
wavelet: wavelet,wavelets
wavering: wavering
wax: wax,waxed,waxes
waxy: waxy
wayside: wayside
wayward: wayward
weak: weak,weaker
weakly: weakly
weakness: weakness,weaknesses
wealth: wealth
wear: wear,wearing,wears,wore,worn
wearied: wearied
wearily: wearily
weariness: weariness
weary: wearied,wearier,weary,wearying
weather: weather
weave: woven
wedge: wedged
wednesday: wednesday
wednesdays: wednesdays
weed: weeds
weedy: weedy
week: week,weeks
weekly: weekly
weep: weep,weeping,wept
weigh: weigh,weighed
weight: weight
wellread: wellread
welter: welter
wench: wenches
west: west
westward: westward
wet: wet,wetted,wetting
wettish: wettish
whalebone: whalebone
whatness: whatness
whatsoever: whatsoever
wheel: wheel,wheeling
wheeze: wheezing
whereon: whereon
whet: whet,whetted
whey: whey
whimper: whimpering
whimsical: whimsical
whine: whine,whines,whining
whining: whining
whinny: whinny
whip: whip,whips
whir: whirring
whirl: whirl
whisker: whiskers
whisky: whisky
whisper: whisper,whispered,whispering
whispering: whispering
whistle: whistle,whistled,whistles,whistling
whit: whit
white: white,whited
whiteboy: whiteboy
whited: whited
whitewashed: whitewashed
whitsuntide: whitsuntide
wholeness: wholeness
wholly: wholly
whore: whores
wicked: wicked
wickedness: wickedness
wide: wide,wider,widest
widen: widening
widespread: widespread
wield: wielding
wife: wife,wives
wig: wig
wild: wild
wilder: wilder
wilderness: wilderness
wildly: wildly
wiles: wiles
wilful: wilful
wilfully: wilfully
wilfulness: wilfulness
willed: willed
william: william
willie: willie
win: win,winning,wins
wind: wind,winding,winds,wound
windless: windless
window: window,windows
windswept: windswept
wine: wine,wines
winepress: winepress
wineshop: wineshops
wing: wing,wings
winged: winged
wink: winked
winter: winter
wintry: wintry
winy: winy
wipe: wipe
wire: wire,wires
wisdom: wisdom
wise: wise
wiseacre: wiseacre
wisp: wisps
wit: wit,wits
withdraw: withdraw,withdrawing,withdrawn,withdrew
withdrawal: withdrawal
wither: withered,withering
withered: withered
withhold: withheld
witless: witless
witness: witnessing
wittily: wittily
woe: woe
woeful: woeful
woman: woman,women
womanhood: womanhood
womanish: womanish
womb: womb
wonderful: wonderful
wonderment: wonderment
wonderstruck: wonderstruck
woo: wooed,wooing
wood: wood
wooden: wooden
woollen: woollen
woolly: woolly
word: word
workaday: workaday
workman: workmen
workshop: workshop
worldling: worldlings
worldly: worldly
worm: worm,worms
worn: worn
worship: worship,worshipped
worshipper: worshippers
worth: worth
worthless: worthless
worthy: worthy
wound: wound,wounded,wounds
wounded: wounded
wrangle: wrangle,wrangling
wrangling: wrangling
wrap: wrap,wrapped,wrapping
wrath: wrath
wreath: wreaths
wreckage: wreckage
wrench: wrenched
wrest: wrest
wretch: wretch,wretches
wretched: wretched
wriggle: wriggled
wring: wrung
wrinkle: wrinkled
wrist: wrists
write: write,writes,writing,written,wrote
writer: writer,writers
writing: writing
writings: writings
wrong: wrong,wronged
wrongly: wrongly
yard: yard
yawn: yawn,yawned,yawning
yawning: yawning
yell: yells
yellow: yellow
yellowish: yellowish
yield: yield,yielded,yielding
yoke: yoke
york: york
youngster: youngster
yous: yous
youth: youth
zeal: zeal
zealous: zealous
zoology: zoology
