ab: ab
abbreviate: abbreviated
ability: ability
ablest: ablest
abolish: abolished
abolition: abolition
abrogation: abrogation
abrupt: abrupt
abruptly: abruptly
absence: absence
absent: absent
absolute: absolute
absolutely: absolutely
abstention: abstention
abstinence: abstinence
abstract: abstract
absurd: absurd
absurdly: absurdly
abundance: abundance
abundant: abundant
abyss: abyss
ac: ac
accelerate: accelerated
accept: accept,accepted,accepts
access: access
accident: accident,accidents
accidentally: accidentally
accommodate: accommodate
accompany: accompanied,accompanying
accomplished: accomplished
accord: accord
accost: accosted
account: account,accounts
accumulate: accumulating
accuracy: accuracy
accurately: accurately
accustom: accustomed
ache: ache
achieve: achieve,achieved
acknowledge: acknowledge
acquaintance: acquaintances
acquiesce: acquiesce
acquire: acquire
acting: acting
action: action
activity: activity
actor: actors
actual: actual
acute: acute
acuteness: acuteness
adage: adage
adapt: adapted
adaptation: adaptation
add: add
addition: addition
additional: additional
address: address,addressed,addressing
administrators: administrators
admirable: admirable
admire: admire
admired: admired
admission: admission
admit: admit,admitted
adoption: adoption
adorable: adorable
adoration: adoration
adore: adored
adult: adult
advance: advanced,advancing
advantage: advantage,advantages
advantageous: advantageous
adventure: adventures
advise: advised
advocate: advocates,advocating
afar: afar
affair: affair
affect: affect
affection: affection,affections
affectionate: affectionate
afflict: afflicted
afford: afford
afraid: afraid
age: age,ages
aged: aged
agitated: agitated
agitation: agitation
agony: agony
agricultural: agricultural
aid: aid,aided
aide: aides
aim: aimed
air: air
alarm: alarm,alarmed,alarming
alas: alas
alike: alike
alive: alive
alliance: alliances
allure: allured
aloud: aloud
alphabet: alphabet
alter: altered
alteration: alteration
altogether: altogether
amb: amb
ambition: ambition
ample: ample
amply: amply
amuse: amused
amusement: amusement
analogy: analogy
anarchical: anarchical
anarchy: anarchy
ancestor: ancestor,ancestors
ancestry: ancestry
ancient: ancient
anger: angered
angle: angle,angles
angled: angled
angles: angles
angularity: angularity
animate: animate
animosity: animosity
annals: annals
annex: annexed
annihilate: annihilated
annually: annually
answer: answer,answered,answers
antagonism: antagonism
antagonistic: antagonistic
antecedent: antecedents
anticipate: anticipate,anticipated
anticipation: anticipation,anticipations
antiquarian: antiquarian
anxiety: anxiety
anxiously: anxiously
apartment: apartment,apartments
aperture: aperture
apologise: apologised
apology: apologies
apostle: apostle
apparent: apparent
appeal: appeal
appearance: appearance
appertain: appertain
applause: applause
apply: applied,applies,apply
appreciably: appreciably
apprehend: apprehended
approach: approach,approached,approaches,approaching
approval: approval
approve: approved
approximate: approximate,approximated,approximates,approximating
approximation: approximation,approximations
approximator: approximator
apt: apt
arbitrary: arbitrary
architecture: architecture
archive: archives
argue: argue
argument: argument,arguments
aristocracy: aristocracy
aristocratic: aristocratic
arithmetic: arithmetic
arithmetical: arithmetical
army: army
arouse: arouse,aroused
arrange: arranged
arrangement: arrangements
arrest: arrest,arrested
art: art,arts
artery: arteries
artful: artful
artificial: artificial
artillery: artillery
artillerymen: artillerymen
artisan: artisan
artisans: artisans
artist: artist
artistic: artistic
artistically: artistically
arts: arts
ascend: ascend,ascended,ascending
ascent: ascent
ascertain: ascertain,ascertained,ascertaining
asleep: asleep
aspect: aspect
aspiration: aspirations
aspire: aspire,aspiring
aspiring: aspiring
assembly: assembly
assent: assent
assert: assert,asserted,asserting
assertion: assertions
assign: assigned,assigning
assimilate: assimilated
assistance: assistance
assume: assume,assumed,assuming
assure: assuring
assuredly: assuredly
astonishing: astonishing
astonishment: astonishment
asylum: asylum,asylums
atmosphere: atmosphere
attack: attacked,attacks
attain: attain,attained
attempt: attempt,attempted,attempting,attempts
attend: attend,attended
attendance: attendance
attention: attention
attentively: attentively
attest: attested
attitude: attitude
attract: attract,attracted
attraction: attraction
attractive: attractive
attribute: attribute,attributed
audacious: audacious
audible: audible
audience: audience
audition: audition
aught: aught
august: august
author: author
authority: authorities,authority
avail: avail
aver: aver
average: average
averse: averse
avert: avert
avocation: avocations
avoid: avoid,avoiding
avoidance: avoidance
avow: avows
avowal: avowal
avowed: avowed
await: awaiting,awaits
awake: awoke
aware: aware
awestruck: awestruck
awhile: awhile
awkwardly: awkwardly
awkwardness: awkwardness
axiom: axiom
baby: babies,baby
babyish: babyish
bachelor: bachelor
bachelors: bachelors
background: background
bad: bad,worse
balance: balance
ball: ball
band: band,bands
bar: bars
barbarism: barbarism
bare: bared
barracks: barracks
barren: barren
barrier: barrier
base: base,based
baseless: baseless
basis: bases,basis
bass: bass
battle: battle,battles
bay: bays
beam: beamed
bear: bear,bears,born
bearing: bearings
beat: beating
beatitude: beatitude
beautiful: beautiful
beauty: beauty
bed: bed
bedimmed: bedimmed
befall: befall
beg: beg,begged
behalf: behalf
behaviour: behaviour
behold: beheld,behold
beholder: beholder
belauded: belauded
belief: belief
believer: believers
bell: bell
belong: belong,belongs
belongings: belongings
bend: bending
beneficent: beneficent
benefit: benefit,benefits
benighted: benighted
beseech: beseech,besought
beset: beset
besotted: besotted
betoken: betokened,betokens
betray: betrayed
betters: betters
bewilder: bewildered
bid: bid,bidding
bind: bound
birth: birth,births
bisect: bisect
bit: bits
bitter: bitterest
black: black
blame: blame
blank: blank
bless: blessed
blessed: blessed
blessing: blessing
blind: blind
blindly: blindly
bliss: bliss
blossom: blossom
blot: blot,blotting
blow: blow
blue: blue
blunt: blunt
board: board,boards
boasting: boasting
bodily: bodily
body: bodies,body
boldly: boldly
book: book,books
bottle: bottles
bound: bounded,bounding
boundless: boundless
box: boxes
boy: boy
brain: brain
brainless: brainless
brave: brave
bread: bread
breadth: breadth
break: breaking
breakfast: breakfast
breath: breath
breed: bred,breeding
breeding: breeding
brethren: brethren
brick: brick
bride: bride
bright: bright,brighter
brightly: brightly
brightness: brightness
brilliancy: brilliancy
bring: bring,bringing,brings,brought
broad: broad
brother: brother,brothers
brutal: brutal
bud: bud
build: building
building: building,buildings
burden: burden
burdensome: burdensome
burglar: burglar
burn: burnt
burst: burst,bursting
business: business
butler: butler
buzz: buzzing
cabinet: cabinet
calamity: calamities
calculate: calculate,calculated
calculation: calculation
calmly: calmly
cap: cap
capable: capable
capacity: capacity
capital: capital
card: cards
care: care
career: career,careering
careful: careful
carefully: carefully
careless: careless
caret: caret
carnage: carnage
carry: carried,carry,carrying
cast: cast,casting
caste: caste
castigation: castigation
casual: casual
casually: casually
catastrophe: catastrophe
catch: catch,caught
cautious: cautious
cavern: caverns
cb: cb
cease: cease,ceased,ceases
celestial: celestial
cellar: cellar
cemetery: cemetery
census: census
central: central
centre: centre,centres
century: centuries,century
ceremonial: ceremonial
certainty: certainty
certifiable: certifiable
certificate: certificate
certified: certified
certify: certified
chafe: chafed
chamber: chamber,chambers
change: change,changed,changing
changing: changing
chaos: chaos
character: character
characteristic: characteristics
charge: charge
charm: charm,charmed,charms
cheap: cheap,cheaper
check: checked,checking
cheerful: cheerful
cheerfulness: cheerfulness
chest: chests
chief: chief
child: child,children
childhood: childhood
childish: childish
childless: childless
chilling: chilling
chirp: chirping
chirrup: chirruped
choice: choice,choicest
choose: choose,choosing
choral: choral
chorus: chorus
chromatic: chromatic
chronic: chronic
church: church,churches
circle: circle,circles
circles: circles
circular: circular
circumference: circumference
circumspection: circumspection
circumstance: circumstances
citizen: citizen,citizens
citizens: citizens
city: city
civic: civic
civilised: civilised
civilization: civilization
claim: claim,claims
class: class,classes
classify: classify
clay: clay
clearness: clearness
clerk: clerk
clever: clever
client: client,clients
climate: climate,climates
climax: climax
climb: climbs
close: close,closed,closer
closed: closed
closely: closely
closet: closet
cloud: cloud
clue: clue
clumsy: clumsy
coarse: coarse
coast: coast
code: code
cognizance: cognizance
cold: cold
collective: collective
collector: collectors
collision: collision
colour: colour,coloured,colours
colourless: colourless
combination: combination
combine: combine,combines
comfort: comfort
coming: coming
command: command,commanding,commands
commandment: commandment,commandments
commence: commenced
commencement: commencements
commend: commended
commerce: commerce
commit: commit,committed,committing
common: common,commonest
commonly: commonly
commonplace: commonplace
communicate: communicate
communication: communications
community: community
companion: companion
companionship: companionship
company: company
comparative: comparative
comparatively: comparatively
compare: compare,compared
comparison: comparison,comparisons
compass: compass
compel: compelled,compels
compelled: compelled
compensate: compensated
compensation: compensation
compensative: compensative
competitor: competitors
complacency: complacency
complacently: complacently
complete: complete,completed
completely: completely
completion: completion
complex: complex
comport: comport
compose: composed
composition: composition
comprehend: comprehend
compression: compression,compressions
comrade: comrades
conceal: conceal
conceit: conceit
conceive: conceive
conception: conception,conceptions
concern: concerns
concerned: concerned
concert: concert
concession: concession
conclave: conclave
conclude: concluded
conclusion: conclusion,conclusions
conclusive: conclusive
concourse: concourse
concur: concur,concurred,concurs
condemn: condemn
condition: condition
condole: condole
conduct: conduct,conducted
cone: cones
confess: confess,confessed
confide: confiding
confidence: confidence
confident: confident
configuration: configuration,configurations
confine: confine,confined
confinement: confinement
confirm: confirm,confirming,confirms
confirmation: confirmation
conformation: conformation
confound: confounding
confuse: confuse,confused
confused: confused
confusion: confusion
congenital: congenital
conjecture: conjecture,conjectured
conjugal: conjugal
connection: connection
conscience: conscience
conscious: conscious
consequence: consequence,consequences
consequent: consequent
conservative: conservative
considerable: considerable
consideration: consideration,considerations
consign: consigned
consist: consists
consistent: consistent
consistently: consistently
consort: consort
conspiracy: conspiracies
constant: constant
constantly: constantly
constituent: constituents
constitute: constitute,constituted
constitution: constitution
constraint: constraint
construct: construct,constructed
construction: construction
consume: consumed
consummate: consummate,consummated,consummating
consumption: consumption
contact: contact
contemplate: contemplate,contemplating
contemplation: contemplation
contemptible: contemptible
content: content
contented: contented
contentment: contentment
contents: contents
continually: continually
continue: continue,continued,continues,continuing
continued: continued
continuous: continuous
contract: contracted
contralto: contralto
contrary: contrary
contrast: contrast
contribute: contributing
control: control
controller: controllers
convene: convened
convenience: convenience
conversant: conversant
conversation: conversation
conversazione: conversazione
convert: convert,converted,converting,converts
convey: convey
convict: convict,convicts
conviction: conviction
convicts: convicts
convince: convince,convinced
convulsive: convulsive
coolness: coolness
corner: corner
corporal: corporal
correct: correct,corrected
correspondent: correspondent
correspondingly: correspondingly
corrupt: corrupted
cost: cost
council: council
counsellor: counsellors
counsellors: counsellors
count: count
country: countries,country
countryman: countrymen
court: court,courts
courtesy: courtesy
courtship: courtship
cover: covered
cradle: cradle
craft: craft
crash: crash
crave: crave
create: create
creative: creative
creature: creature,creatures
credible: credible
creep: creeping
crime: crime
criminal: criminal,criminals
criminality: criminality
critic: critic,critics
crowd: crowd
crown: crown
crowning: crowning
cube: cube,cubes
cubes: cubes
culture: culture
cunning: cunning
cupboard: cupboard
cure: cured
curiosity: curiosity
curtail: curtailed
custom: custom
customary: customary
cut: cut
cylinder: cylinders
cynic: cynics
dabble: dabbling
dae: dae
daily: daily
dance: dance,dancing
danger: danger,dangers
dangerous: dangerous
dark: dark
darkness: darkness
dash: dashed,dashing
daughter: daughter,daughters
dawn: dawn
day: day,days
dead: dead
deaf: deaf
deal: dealing
death: death
debar: debarred
debilitation: debilitation
decay: decay
decaying: decaying
decease: decease
deception: deception,deceptions
decide: decide,decided
decimate: decimated
decisive: decisive
declare: declared,declaring
decline: declined
decorate: decorated,decorating
decoration: decoration
decree: decree,decreed,decrees
dedicate: dedicated
deed: deeds
deem: deemed
deep: deep,deeper
defect: defects
defence: defence
defend: defends
defensive: defensive
defer: defer
deference: deference
deficiency: deficiencies
deficient: deficient
define: define
degradation: degradation
degrade: degraded
degraded: degraded
degree: degree,degrees
deign: deign
delay: delayed
deliberately: deliberately
delicate: delicate
delight: delight
delimit: delimited
deliver: deliver
delivery: delivery
delusion: delusions
demand: demand,demanded,demands
demarcation: demarcation
demoniacal: demoniacal
demonstrate: demonstrate
demonstration: demonstration,demonstrations
demoralization: demoralization
demoralize: demoralize
denote: denote,denotes,denoting
dense: dense
deny: deny,denying
depart: depart,departing
depend: depend,depended,depends
deplorable: deplorable
deplorably: deplorably
deplore: deplore,deplored
depopulate: depopulated
depress: depressing
deprive: deprived,depriving
depth: depth
depths: depths
deride: derided
derivable: derivable
derive: derived
descend: descend,descended,descending
descendant: descendant,descendants
descent: descent
describable: describable
description: description,descriptions
deserve: deserve
desirable: desirable
desire: desire,desired,desires,desiring
desolate: desolate
desolation: desolation
despair: despair
desperate: desperate
despise: despised
destine: destined
destiny: destiny
destitute: destitute
destroy: destroy,destroyed
destruction: destruction
destructiveness: destructiveness
detect: detect,detected
determine: determine,determined,determines,determining
deterrent: deterrent
develop: developed
developed: developed
development: development
deviate: deviates
deviation: deviation,deviations
devil: devil
devise: devise
devoid: devoid
devote: devoted
devour: devouring
devoutly: devoutly
dexterity: dexterity
diabolical: diabolical
diagonal: diagonal,diagonals
diagram: diagram,diagrams
dialect: dialect
dialogue: dialogue
diameter: diameter
dictate: dictate,dictating
die: died
difference: difference
difficult: difficult
difficulty: difficulties,difficulty
diffuse: diffuse
digress: digressing
digression: digressions
dilemma: dilemma
diligent: diligent
dim: dim,dimmer
dimension: dimension,dimensioned,dimensions
dimensionality: dimensionality
dimensions: dimensions
diminish: diminish,diminished
diminished: diminished
diminution: diminution
dimness: dimness
dire: direst
direct: directed
direction: direction,directions
director: directors
disadvantage: disadvantages
disadvantageous: disadvantageous
disappear: disappeared
disappoint: disappointed
disaster: disasters
disbelief: disbelief
discard: discarding
discern: discern,discerned,discerning,discerns
disciple: disciple
discomfort: discomfort
discord: discord
discourage: discouraged
discourse: discourse
discover: discover,discovered,discovering
discovery: discovery
discretion: discretion
discriminate: discriminate,discriminated,discriminating
discrimination: discrimination
discriminative: discriminative
discursive: discursive
discuss: discussing
disease: disease
diseased: diseased
disengage: disengage
disfavour: disfavour
disgrace: disgrace
disguise: disguise,disguises
dishonour: dishonouring
disobedience: disobedience
disparagement: disparagement
dispassionate: dispassionate
dispense: dispense
dispose: disposed
disposed: disposed
disproportionate: disproportionate
disrepute: disrepute
dissimilar: dissimilar
distance: distance
distant: distant
distinct: distinct
distinction: distinction,distinctions
distinctly: distinctly
distinguish: distinguish,distinguished
distinguishable: distinguishable
distract: distracting
distress: distress
district: district,districts
diver: divers
divert: divert
divest: divest
divide: divided,divides,dividing
divine: divine
divulge: divulging
dizzy: dizzy
docile: docile
doctor: doctor
doctrine: doctrine
dodecahedron: dodecahedron
dodecahedrons: dodecahedrons
domain: domain
domestic: domestic,domestics
dominion: dominion,dominions
doom: doom
door: door,doors
doorless: doorless
dost: dost
double: double,doubles
doubt: doubt,doubting
doubtless: doubtless
downward: downward
dozen: dozen
drag: drags
draught: draught,draughts
draw: drawing
drawback: drawbacks
dream: dream,dreamed,dreaming,dreams
dreary: dreary
drop: dropping
drowsy: drowsy
drudge: drudge
dry: dry
dull: dull,dullest
duly: duly
dumb: dumb
duplicate: duplicate
duration: duration
duty: duties,duty
dwell: dwell
dwindle: dwindles
ear: ear,ears
earnestness: earnestness
earth: earth
easily: easily
east: east
eastern: eastern
easy: easy
ecclesiastical: ecclesiastical
echo: echo
economy: economy
ecstasy: ecstasy
ecstatic: ecstatic
edge: edge,edged,edges,edging
edition: edition
educate: educated
education: education
educational: educational
effectually: effectually
effort: effort,efforts
egress: egress
eighth: eighth
elaborate: elaborate
elapse: elapsed
elect: elected
electronic: electronic
element: element
elementary: elementary
elevation: elevation
eleventh: eleventh
elicit: elicited,eliciting
eliminate: eliminates
emanate: emanated
embittered: embittered
embrace: embrace
emerge: emerge
emergence: emergence
emergency: emergencies
emotion: emotion
emotional: emotional
employ: employ
enable: enable,enabled,enables
enact: enacting
enactment: enactments
enchanter: enchanter,enchanters
enclose: enclosed
encompass: encompassed
encourage: encourage,encouraged
encouragement: encouragement
endeavour: endeavour,endeavoured,endeavouring
endless: endless
endow: endowed
endowed: endowed
endowment: endowments
endure: endure
energy: energy
enfeeble: enfeeble,enfeebling
enfeebling: enfeebling
enforce: enforce
engineering: engineering
enhance: enhance
enigmatic: enigmatic
enjoin: enjoining
enjoy: enjoy,enjoys
enjoyment: enjoyment
enlarge: enlarging
enlargement: enlargement
enlighten: enlighten,enlightening
ennoble: ennobled
enquire: enquire
ensue: ensue
ensure: ensured
enter: enter,entered,entering,enters
entertain: entertain
enthusiasm: enthusiasm
entire: entire
entitle: entitled
entrance: entrance
entreat: entreat
entreaty: entreaties
enumerate: enumerate,enumerating
enumeration: enumeration
envied: envied
environed: environed
enwrap: enwrap
equal: equal
equality: equality
equally: equally
equilateral: equilateral
era: era
ere: ere
erect: erect
err: erred
error: error
escape: escape
escutcheon: escutcheon
esoteric: esoteric
essay: essay
essence: essence
essential: essential
essex: essex
esteem: esteemed
estimate: estimate,estimated
estimation: estimation
etiquette: etiquette
eulogy: eulogies
evade: evading
evangelize: evangelize
event: event,events
eventful: eventful
evident: evident
evidently: evidently
evil: evil,evils
evolution: evolution
exact: exact
exactness: exactness
examination: examination
examine: examined
exasperate: exasperated
exceed: exceed,exceeding,exceeds
excellent: excellent
exception: exception,exceptions
excess: excess
excessive: excessive
exchange: exchanged,exchanging
excited: excited
exclaim: exclaim,exclaimed,exclaiming
exclude: excluded
exclusive: exclusive
excuse: excuse
execute: executed
execution: execution
executioner: executioner
exemplification: exemplification
exempt: exempted
exercise: exercise,exercised
exhausting: exhausting
exhibit: exhibit,exhibiting
exhort: exhorted
exile: exile
exist: exist,exists
existence: existence,existences
expansion: expansion
expect: expect,expected
expediency: expediency
expenditure: expenditure
expense: expense
expensive: expensive
experience: experience,experienced,experiences
experiment: experiment
experimental: experimental
explain: explain
explanation: explanation,explanations
expose: exposed
express: express,expressed
expression: expressions
expulsion: expulsion
exquisite: exquisite
extend: extend,extending
extension: extensions
extent: extent
exterminate: exterminated
extermination: extermination
extinguish: extinguished
extra: extra
extract: extracted,extracts
extraordinary: extraordinary
extreme: extreme
extremely: extremely
extremity: extremities,extremity
extricate: extricating
exultant: exultant
eye: eye,eyes
fabric: fabric
faction: factions
faculty: faculties,faculty
fail: fail,failed,fails
failure: failure
faint: faint
fair: fair
faith: faith
faithfully: faithfully
fall: fall,fallen,falling,falls,fell
falsely: falsely
familiar: familiar
familiarize: familiarized
family: families,family
famous: famous
farewell: farewell
farmers: farmers
fascination: fascinations
fashion: fashion
fashionable: fashionable
fashioned: fashioned
fast: fast
fatal: fatal
fate: fate,fated
father: father,fathers
fatuity: fatuity
fault: fault,faults
favour: favour
favourable: favourable
favourably: favourably
favourite: favourite
fear: fear
fecundity: fecundity
feed: fed,feed
feel: feel,feeling
feeler: feeler
feeling: feeling
feign: feign,feigning,feigns
feigned: feigned
female: female,females
feminine: feminine
fertile: fertile
fervent: fervent
festival: festivals
fetter: fettered
fiction: fiction
fictitious: fictitious
fidgety: fidgety
fie: fie
field: field
fight: fight
figure: figure,figures
final: final
finally: finally
fine: finest
finish: finished
firmly: firmly
fit: fit,fits
fitly: fitly
fitness: fitness
fixity: fixity
flagitious: flagitious
flash: flashed,flashing
flat: flatter
flatland: flatland
flatlander: flatlander
fleet: fleet
flight: flight
flit: flit
float: floated
flood: flood
floor: floor
flounder: flounders
flower: flowers
fluid: fluid
fly: flew,fly
foe: foe,foes
fog: fog
follow: follow
follower: followers
folly: folly
foment: fomented
food: food
foodless: foodless
fool: fool
foolish: foolish
foot: feet,foot
footnotes: footnotes
footstep: footsteps
forbid: forbidden,forbidding,forbids
forbidden: forbidden
force: force,forced,forces,forcing
foreland: forelands
foremost: foremost
foresee: foresaw
forethought: forethought
forfeit: forfeited
forget: forget,forgot,forgotten
forgetfulness: forgetfulness
form: form,formed,forming,forms
formal: formal
formality: formality
formidable: formidable
formula: formula
forsooth: forsooth
fortification: fortifications
foundation: foundations
fourth: fourth
fracture: fractured
fragment: fragments
frail: frail,frailer
frame: frame
frankly: frankly
franticly: franticly
fraternal: fraternal
fraud: fraud,frauds
fraudulent: fraudulent
freedom: freedom
freely: freely
freeman: freeman
frenzy: frenzy
frequent: frequent
fresh: fresh
freshly: freshly
friend: friend,friends
friendship: friendship
fringe: fringe
frivolous: frivolous
fro: fro
frugality: frugality
fruit: fruits
fruition: fruition
fruitless: fruitless
frustrated: frustrated
fulfil: fulfilled
fun: fun
fundamental: fundamental
furious: furious
furlong: furlongs
fury: fury
future: future
gag: gag
gain: gain,gained,gains
gamboge: gamboge
gash: gash
gate: gates
generality: generalities
generalship: generalship
generate: generate,generating
generation: generation,generations
genius: genius
gentleman: gentlemen
gentlemen: gentlemen
gently: gently
genuine: genuine
geometrical: geometrical
geometrician: geometricians
geometry: geometry
gesticulate: gesticulate
gift: gift
gifted: gifted
girl: girl,girls
glad: glad
gladly: gladly
glance: glance,glanced
glass: glass
gleam: gleam
glimpse: glimpse,glimpses
gloomy: gloomy
glorious: glorious
goal: goal
god: god,gods
gods: gods
gold: gold
gospel: gospel
govern: governed
government: government
gracious: gracious
gradation: gradations
gradual: gradual
gradually: gradually
grand: grand
grandchildren: grandchildren
grandfather: grandfather
grandpapa: grandpapa
grandson: grandson,grandsons
grant: grant,granting
grapple: grapple
grasp: grasp,grasped
grasshopper: grasshoppers
grave: grave
gravitation: gravitation
greatly: greatly
green: green
grey: grey
groan: groaned
grope: groping
ground: ground
grounds: grounds
grow: grew
grown: grown
guard: guard,guards
guest: guest
guidance: guidance
guide: guide
guilty: guilty
gulf: gulf
gun: guns
gymnasium: gymnasium
ha: ha
habit: habit
habitual: habitual
hall: hall
hamlet: hamlet
hamper: hampered,hampering
hand: hand,handed,hands
haply: haply
happen: happen,happened
happiness: happiness
happy: happy
harangue: harangue
hard: hard,hardest
hark: hark
harmless: harmless
harmonious: harmonious
harmonise: harmonise
harmony: harmony
harvest: harvests
hast: hast
hastily: hastily
hastiness: hastiness
haunt: haunts
head: head
healing: healing
health: health
hear: hear,heard,hearing,hears
hearer: hearer,hearers
hearing: hearing
hearsay: hearsay
heart: heart,hearts
heave: heaved
heavenly: heavenly
heavily: heavily
heavy: heavy
heed: heed
height: height,heights
henceforth: henceforth
herald: herald
hereditary: hereditary
hereon: hereon
heresy: heresies,heresy
hesitate: hesitate,hesitated
heterodox: heterodox
hexagon: hexagon,hexagons
hexagonal: hexagonal
hexagons: hexagons
hexahedrons: hexahedrons
hierarchy: hierarchy
highly: highly
highness: highness
hill: hill,hills
hinder: hinder
hint: hints
hiss: hissed
historical: historical
history: history
hitherto: hitherto
hold: held,hold
hollow: hollow
homage: homage
honestly: honestly
honour: honour
honourable: honourable
hoot: hooted
hope: hope,hoped,hopes
hopeful: hopeful
hopefulness: hopefulness
hopelessly: hopelessly
horizon: horizon
horror: horror
hospital: hospital,hospitals
hospitals: hospitals
hour: hour,hours
house: house,houses
household: household,households
houses: houses
hue: hue,hues
hum: humming
human: human
humanity: humanity
humble: humble
humiliation: humiliation,humiliations
humour: humour
hundredth: hundredth
hurriedly: hurriedly
hurt: hurt
husband: husband,husbands
hush: hush
hypocrisy: hypocrisy
hypocrite: hypocrite
idea: idea
ideal: ideal
identical: identical
identity: identity
idiom: idiom
ignorance: ignorance
ignorant: ignorant
ignore: ignore
illegal: illegal
illustrate: illustrating
illustration: illustration,illustrations
illustrious: illustrious
image: image
imaginary: imaginary
imagination: imagination
imagine: imagine,imagined
imbecile: imbecile
imitate: imitate,imitated,imitating
imitation: imitation
immemorial: immemorial
immense: immense
immoral: immoral
immovably: immovably
immunity: immunity
immure: immured
impair: impaired
impart: impart,imparted,imparting,imparts
impartiality: impartiality
impartially: impartially
impassioned: impassioned
impatience: impatience
impel: impelled
impending: impending
impenetrable: impenetrable
imperceptibly: imperceptibly
imperfect: imperfect
impertinence: impertinence
impertinent: impertinent
impervious: impervious
imply: implied,implies,imply,implying
impose: imposes
impossibility: impossibility
impossible: impossible
imposture: imposture,impostures
impotent: impotent
impotently: impotently
impression: impression
imprison: imprison,imprisoned
imprisonment: imprisonment
improbable: improbable
improvement: improvement
imputed: imputed
inaccurate: inaccurate
inane: inane
inanimate: inanimate
inaudible: inaudible
incapable: incapable
incautious: incautious
inch: inch,inches
incident: incident,incidents
incline: inclined,inclining
include: included,including
incommode: incommode
incompatible: incompatible
incomplete: incomplete
inconceivable: inconceivable
inconsiderate: inconsiderate
inconsistent: inconsistent
inconvenience: inconvenience
incorporate: incorporate
increase: increase,increased,increases,increasing
incredible: incredible
incredulity: incredulity
incurable: incurable
indebted: indebted
indecisive: indecisive
indefinitely: indefinitely
indescribable: indescribable
indifferent: indifferent
indignant: indignant
indirectly: indirectly
indiscretion: indiscretion,indiscretions
indistinguishably: indistinguishably
individual: individual,individuals
individuality: individuality
indoctrinate: indoctrinating
induce: induce,induced,induces,inducing
indulgence: indulgence
ineffectual: ineffectual
inequality: inequality
inert: inert
inexperienced: inexperienced
inexpressibly: inexpressibly
infallible: infallible
infant: infant
infect: infected
infecundity: infecundity
infer: infer,inferred,inferring
inferior: inferior
infinite: infinite
infinitely: infinitely
infinitesimally: infinitesimally
infinity: infinity
inflict: inflict
influence: influence
infuriate: infuriated
inhabitant: inhabitant,inhabitants
inhabitants: inhabitants
initiate: initiate,initiated
initiation: initiation
injunction: injunctions
injure: injure
injuriously: injuriously
injury: injuries,injury
inmate: inmates
inmost: inmost
innocent: innocent
innovation: innovation
innovator: innovators
innumerable: innumerable
inquire: inquiring
insight: insight
insignificant: insignificant
insist: insist,insisted
insolent: insolent
inspect: inspected
inspection: inspection
inspire: inspired
instance: instance,instances
instant: instant
instantaneous: instantaneous
instantly: instantly
instigate: instigated
instinct: instinct
instruct: instruct,instructed
insult: insult,insulting
integrity: integrity
intellect: intellect,intellects
intellectual: intellectual
intelligence: intelligence
intelligent: intelligent
intelligible: intelligible
intend: intended
intense: intense
intention: intention,intentioned,intentions
intercede: intercede
intercept: intercept
interchange: interchanged
intercourse: intercourse
interior: interior,interiors
intermarriage: intermarriages
internal: internal
interrupt: interrupt,interrupted
interruption: interruption
intersperse: interspersed
interval: interval,intervals
intervene: intervening
interview: interview,interviews
intestine: intestines
intolerable: intolerable
intoxicate: intoxicated
introduce: introduce,introduced,introducing
introduction: introduction
introductory: introductory
intruder: intruder
invent: invented
investigate: investigated
investigation: investigations
invisible: invisible
invisibly: invisibly
invite: invited
involuntary: involuntary
involve: involves,involving
iota: iota
irrational: irrational
irregular: irregular
irregularity: irregularities,irregularity
irregularly: irregularly
irreparable: irreparable
irrepressible: irrepressible
irresistible: irresistible
irritate: irritate,irritating
irritated: irritated
island: island
isosceles: isosceles
issue: issue,issued
italics: italics
jailer: jailers
jealously: jealously
jealousy: jealousies,jealousy
jest: jest,jests
jesting: jesting
joke: joking
jones: jones
jostle: jostled,jostling
journey: journey
joy: joy
judge: judge,judged,judges
judgment: judgment
judicious: judicious
juggler: juggler
juncture: juncture
junior: junior
justice: justice
justify: justify
keenly: keenly
key: key
kindred: kindred
kinetic: kinetic
kinetical: kinetical
kinetics: kinetics
king: king
kingdom: kingdom
kitchen: kitchen
knowledge: knowledge
labour: labour,laboured,labours
lack: lack
lady: ladies,lady
land: land,lands
landscape: landscape,landscapes
language: language
lapse: lapse
lastly: lastly
late: late
latent: latent
lateral: lateral
laugh: laugh,laughing
lavish: lavish
law: law,laws
laws: laws
lawyer: lawyers
lay: laid,lay,laying
lead: lead,leading,led
leader: leader,leaders
leaderless: leaderless
leading: leading
league: leagues
lean: leaning
leap: leap,leaped
learn: learn,learned
leave: leave,leaves,leaving,left
lecture: lecture
left: left
legal: legal
legislation: legislation
legislative: legislative
legislature: legislature
legitimate: legitimate
lengthiness: lengthiness
lesson: lesson,lessons
level: level
liable: liable
licentious: licentious
lie: lain,lie,lying
life: life,lives
light: light,lights
lilliputian: lilliputian
limit: limit,limited,limits
limitation: limitations
limited: limited
linear: linear
linger: linger
lip: lip,lips
listen: listen,listened,listening
listless: listless
literal: literal
live: live,lived,living
liver: liver
living: living
lo: lo
local: local
lock: lock
logical: logical
logically: logically
london: london
lord: lord,lords
lords: lords
lordship: lordship
lose: loses,losing,lost
loss: loss
lost: lost
lot: lot
loud: louder
loudly: loudly
love: love,loved
loveliness: loveliness
lover: lover,lovers
loving: loving
lucid: lucid
lucky: lucky
luminary: luminary
luminous: luminous
lunatic: lunatic,lunatics
lunch: lunch
lung: lungs
lustre: lustre
lustrous: lustrous
luxury: luxury
lying: lying
mad: mad,maddest
madam: madam
madman: madman
madness: madness
magazine: magazines
magic: magic
magician: magician
magicians: magicians
magistrate: magistrate
magnificence: magnificence
maiden: maiden
mainstay: mainstays
maintain: maintain,maintained,maintaining
majesties: majesties
majority: majority
male: male,males
manage: manage
manhood: manhood
manifest: manifest,manifested
manifestation: manifestation
manifestly: manifestly
mankind: mankind
manner: manner
manufactory: manufactory
margin: margin
mark: mark
market: market
marriage: marriage,marriages
marry: married,marry
marshal: marshal
martial: martial
martyrdom: martyrdom
marvellous: marvellous
mass: mass
massacre: massacre
master: master
masterpiece: masterpiece
masters: masters
mate: mates
maternal: maternal
mathematical: mathematical
mathematician: mathematician
mathematics: mathematics
matter: matter,matters
mature: matured
mauve: mauve
maxim: maxim
maximum: maximum
meaning: meaning
measure: measure,measured,measures
measurement: measurement,measurements
mechanically: mechanically
media: media
medical: medical
meditate: meditated
meet: meet,meeting,meets,met
meeting: meeting,meetings
melancholy: melancholy
memoirs: memoirs
memory: memory
menacing: menacing
mental: mental
mentally: mentally
mention: mention,mentioned
merchant: merchant
merciful: merciful
mercifully: mercifully
mercurial: mercurial
mercy: mercy
mere: mere
merit: merit
merry: merry
message: message
method: method,methods
methought: methought
metropolis: metropolis
middle: middle
midst: midst
mild: mild
mildly: mildly
mildness: mildness
mile: miles
military: military
militia: militia
millenary: millenary
millennial: millennial
millennium: millennium
mind: mind,minds
minded: minded
mindless: mindless
miniature: miniature
minimize: minimize
minor: minor
minority: minority
minute: minute,minutes
misanthropist: misanthropist
misbehave: misbehaved
miscarriage: miscarriage
mischief: mischief
misconduct: misconduct
miserable: miserable
misery: miseries
misguided: misguided
missing: missing
mission: mission
mistake: mistakes,mistook
mixture: mixture
mock: mocked,mocking
mockery: mockeries
model: model
modern: modern
modesty: modesty
modify: modify
modulate: modulated
moisture: moisture
molest: molested
moment: moment,moments
monarch: monarch
money: money
monopolising: monopolising
monotonous: monotonous
monster: monster,monsters
monstrosity: monstrosity
monstrous: monstrous
month: month,months
moodily: moodily
moral: moral
morality: morality
morning: morning
mortal: mortals
mother: mother,mothers
motion: motion,motions
motionless: motionless
mount: mount,mounted
mouth: mouth,mouths
moveable: moveable
movement: movement,movements
multiplication: multiplication
multitude: multitude,multitudes
multitudinous: multitudinous
murder: murders
murmur: murmur,murmurs
muse: musing
mutter: muttered
mutual: mutual
myriad: myriads
mysteries: mysteries
mysterious: mysterious
mystery: mysteries,mystery
narration: narration
narrative: narrative
narrow: narrow
native: native
natural: natural
naturally: naturally
nature: nature
naught: naught
nearer: nearer
necessitate: necessitates,necessitating
necessity: necessity
needful: needful
needle: needle
needless: needless
neglect: neglect,neglected
neglectful: neglectful
neighbour: neighbour,neighbouring,neighbours
neighbourhood: neighbourhood
neighbours: neighbours
nervousness: nervousness
neutral: neutral
news: news
nigh: nigh
night: night
nightfall: nightfall
nightly: nightly
nip: nip
nipping: nipping
nobility: nobility
noble: noble,nobles,noblest
nobleman: nobleman
nobles: nobles
noise: noise
nonsense: nonsense
north: north
northern: northern
northward: northward
note: note,notes,noting
notes: notes
notice: notice,noticed
notion: notion
nuisance: nuisance
numerous: numerous
nurse: nurse,nurses
oath: oath
object: object,objected,objects
objection: objection
oblige: oblige,obliged
obliquity: obliquity
obscurity: obscurity
observation: observation
observe: observed
obstacle: obstacles
obstinate: obstinate
obvious: obvious
occasion: occasion,occasions
occasional: occasional
occasionally: occasionally
occupation: occupation
occupy: occupied
occur: occur,occurred
occurrence: occurrence
ocular: ocular
offence: offence
offensive: offensive
offer: offering
office: office,offices
officer: officer
official: officials
offspring: offspring
oft: oft
oftentimes: oftentimes
omission: omission
omit: omit,omitting
omnipresence: omnipresence
omniscience: omniscience
omnividence: omnividence
oneself: oneself
onset: onset
openly: openly
operation: operation,operations
opinion: opinion
opportunely: opportunely
opportunity: opportunities,opportunity
opposition: opposition
orange: orange
ordain: ordained,ordains
ordinance: ordinance
ordinary: ordinary
organ: organ,organs
organism: organism,organisms
organization: organization
organize: organized
origin: origin
original: original
originate: originate,originates
orphan: orphan
outbreak: outbreak,outbreaks
outspoken: outspoken
oval: oval
overcome: overcome
overleap: overleaps
overtake: overtake
pace: pace
pacify: pacify
pain: pain
painful: painful
painless: painless
painlessly: painlessly
paint: paint,painted
painting: painting
palace: palace
pall: palled
palpable: palpable
paltry: paltry
panic: panic
paper: paper
paradise: paradise
paradox: paradoxes
parallel: parallel
parallelogram: parallelogram
pardon: pardon
parent: parent,parents
parental: parental
particle: particle
partly: partly
partner: partner
party: party
pass: pass,passed,passing
passage: passage
passer: passers
passion: passion
passionately: passionately
pasteboard: pasteboard
patent: patent
path: path
patience: patience
patient: patient
patriotism: patriotism
patron: patrons
pattering: pattering
pause: pause,paused
pay: pay
peace: peace
peal: peal
pedantically: pedantically
pedigree: pedigree,pedigrees
penal: penal
penalty: penalties,penalty
pencil: pencil
pendulum: pendulum
penetrate: penetrate,penetrating
penetration: penetration
penny: penny
pentagon: pentagon,pentagons
pentagonal: pentagonal
pentagons: pentagons
perceive: perceive,perceived,perceives,perceiving
perceptibly: perceptibly
perchance: perchance
perdition: perdition
perfect: perfect
perfection: perfection
perfectly: perfectly
perform: perform
peril: peril
perilous: perilous
perimeter: perimeter
period: period
perish: perish,perished,perishing
permit: permit,permitted
peroration: peroration
perpetrator: perpetrator
perpetual: perpetual
perpetually: perpetually
perplex: perplex
perplexing: perplexing
persevere: persevering
persist: persisted
persistent: persistent
person: people,person,persons
personal: personal
perspective: perspective
persuade: persuaded,persuading
perturb: perturbed
perusal: perusal
pervade: pervade,pervaded
perversity: perversity
pervert: pervert,perverted
phalanx: phalanx
phantasmal: phantasmal
phenomena: phenomena
phenomenon: phenomena
philanthropy: philanthropy
philosopher: philosopher
phonograph: phonographs
phrase: phrase
physical: physical
physically: physically
physician: physician,physicians
pick: pick
pickpocket: pickpockets
picturesque: picturesque
piece: pieces
pierce: pierce
pillar: pillars
pin: pin
pitiable: pitiable
pity: pity
placability: placability
plain: plain,plains
plan: plan
plane: plane
planless: planless
plausible: plausible
play: play,played
plead: plead,pleads
pleased: pleased
pleasure: pleasure,pleasures
plebeian: plebeian
plume: plume,plumes
plunder: plundered
plunge: plunged
plurality: plurality
plurally: plurally
pocket: pocket
poetry: poetry
police: police
policeman: policemen
policy: policy
polite: polite
political: political
politics: politics
pollution: pollution
polygon: polygon,polygons
polygonal: polygonal
polygons: polygons
ponder: pondering
pooh: pooh
poor: poor
populace: populace
popular: popular
popularly: popularly
population: population
portent: portent
portentous: portentous
portrait: portraits
position: position,positions
positive: positive
positively: positively
possess: possess,possessing
possession: possession
possessor: possessor
possibility: possibilities,possibility
post: posts
posterity: posterity
potential: potential
powder: powder
power: power,powers
practical: practical
practically: practically
practice: practice
practise: practised
praise: praise
prattle: prattle
pray: pray
prayer: prayers
preach: preach
prearrangement: prearrangement
precaution: precautions
precede: preceded
precedent: precedent
precept: precept
precious: precious
precipitate: precipitate,precipitated
precise: precise
precisely: precisely
precision: precision
preclude: preclude,precluded
precocious: precocious
precocity: precocity
preconcerted: preconcerted
predominate: predominate,predominates
preface: preface
prefect: prefect
prefects: prefects
prefer: prefer
prejudice: prejudice
prepare: prepare,prepared,preparing
prescribe: prescribes
prescribed: prescribed
presence: presence
presently: presently
preserve: preserved
preside: presiding
president: president
press: pressed,pressing
pressure: pressure
presume: presume
pretend: pretend,pretended,pretending
pretension: pretensions
pretext: pretext
pretty: pretty
prevail: prevail,prevails
prevalent: prevalent
prevent: prevent,prevented
previous: previous
prey: prey
priest: priest
priestly: priestly
priests: priests
principal: principal
print: printed
printers: printers
prison: prison
prisoner: prisoner
pristine: pristine
privacy: privacy
private: private
privilege: privilege,privileges
privileged: privileged
probability: probability
proceed: proceed,proceeded,proceeding,proceeds
process: process
procession: procession
proclaim: proclaim,proclaimed,proclaiming
proclamation: proclamation
procreation: procreation
produce: produce,produced,produces
profess: profess,professed,professing
profession: professions
professional: professional
professors: professors
proficient: proficient
profuse: profuse
progenitor: progenitor,progenitors
progress: progress
progression: progression
progressive: progressive
prohibit: prohibited
prohibition: prohibition
prohibitive: prohibitive
project: project
projection: projections
prolong: prolonged
prometheus: prometheus
promise: promised,promises
promising: promising
promulgator: promulgators
proof: proof
propagate: propagate
propagation: propagation
propel: propelling
proper: proper
prophet: prophets
proportion: proportion
proposal: proposal
propose: proposing
proposition: proposition
propriety: propriety
prosecution: prosecution
prospect: prospect
prospects: prospects
prostrate: prostrating
prove: prove,proved,proving
proverb: proverbs
providence: providence
providential: providential
proximity: proximity
pry: prying
public: public
publication: publication
publisher: publisher
pulsation: pulsation
punish: punished
punishable: punishable
puny: puny
pupil: pupil
pure: pure,purer,purest
purge: purged
purity: purity
purple: purple
purpose: purpose,purposes
purposeless: purposeless
pursue: pursuing
pursuit: pursuit,pursuits
push: push
pyramids: pyramids
qualification: qualification
qualified: qualified
quality: qualities
quarter: quarters
queller: queller
question: question,questioning,questions
quiet: quiet
quietism: quietism
quietly: quietly
quit: quitted
quote: quote
rabble: rabble
race: race
races: races
rage: rage
rain: rain
raise: raise,raised,raising
range: range
rank: rank,ranks
rapid: rapid
rapidly: rapidly
rapt: rapt
rapture: raptures
rare: rare
rarely: rarely
rascal: rascal
rational: rational
ravished: ravished
ravishing: ravishing
reach: reach,reached,reaches
react: react
reaction: reaction
reactionary: reactionary
read: read
reader: reader,readers
reading: reading
ready: ready
real: real
reality: realities,reality
realize: realized
realm: realm
reappear: reappear,reappeared
reason: reason,reasons
reasonable: reasonable
reasoned: reasoned
reasoning: reasoning
reassure: reassure
rebel: rebels
rebellion: rebellion,rebellions
recall: recall,recalling
recede: recede,receded
receive: receive,received,receiving
reciprocal: reciprocal
reckless: reckless
reckon: reckoned
recognise: recognise,recognised
recognition: recognition
recognize: recognize,recognized,recognizing
recoil: recoiling
recollect: recollect
recommend: recommend
reconsider: reconsider
record: recorded
recourse: recourse
recover: recovered
recovery: recovery
recreation: recreation
rectangle: rectangles
red: red
redouble: redoubled
redundant: redundant
refer: refer,refers
reference: reference
reflect: reflect,reflected
reflection: reflection
reform: reform
refrain: refrain
refreshing: refreshing
refuse: refuse,refusing
regain: regained
regard: regard,regarded
regardful: regardful
region: region,regions
register: register,registered
regret: regret,regretted
regular: regular,regulars
regularity: regularity
regularly: regularly
regulate: regulated,regulates
regulation: regulations
reiterate: reiterate,reiterated
reject: reject,rejected
rejoice: rejoiced,rejoices,rejoicing
relapse: relapse,relapses
relate: relate
relation: relations
release: release
relieve: relieved
religious: religious
rely: rely,relying
remain: remain,remained,remaining,remains
remark: remarks
remarkably: remarkably
remedy: remedy
remember: remember,remembered,remembers
remind: reminding
remonstrance: remonstrance
remote: remote,remotest
remove: remove
render: render
renew: renew
repair: repaired
repeat: repeated,repeating
repeatedly: repeatedly
repetition: repetition
reply: replied,reply
report: reported
repose: repose
represent: represent,represented,represents
reproduce: reproduce
reputation: reputation
request: request
require: require,required,requires
required: required
requirement: requirements
rescue: rescue
residence: residence
resistance: resistance
resolution: resolution
resolve: resolve,resolved
resonant: resonant
resort: resort,resorted
resource: resource
respect: respect
respectable: respectable
respectful: respectful
responsibility: responsibility
responsive: responsive
rest: rest,rests
restore: restored
restrain: restraining
restrict: restricted
restriction: restrictions
result: result
resume: resume,resumed
retain: retain,retained
retinue: retinue
retire: retire,retired,retiring
retirement: retirement,retirements
retort: retorted
retract: retract
retreat: retreated,retreating
retrograde: retrograde
retrogression: retrogression,retrogressions
retrospect: retrospect
return: return,returned,returning
reveal: reveal,revealed,revealing
revelation: revelation,revelations
reverence: reverence
reverent: reverent
reverie: reverie
reverse: reverse
review: review
revolt: revolt
revolution: revolution
revolutionist: revolutionists
reward: reward
rhetoric: rhetoric
rheumatism: rheumatism
rhythm: rhythm
rhythmic: rhythmic
rhythmical: rhythmical
rich: rich,richer,richest
richly: richly
rid: rid
rightly: rightly
ripen: ripened
rise: rise,rises,rising
risk: risk
rival: rivalled
road: road
roar: roar
robust: robust
romance: romance
roof: roof,roofs
rotate: rotate,rotating
rough: rough
roughly: roughly
roughness: roughness
rousing: rousing
rove: roving
royal: royal
rude: rude
rudeness: rudeness
rudimentary: rudimentary
ruffle: ruffled
rule: rule
rush: rush,rushed
rustication: rustication
sacred: sacred
sacrifice: sacrifice,sacrificed,sacrifices
sadly: sadly
safe: safe,safes
safeguard: safeguard
safety: safety
sagacity: sagacity
sailor: sailors
sake: sake
sanction: sanctioned,sanctions
sand: sands
sanitary: sanitary
satisfaction: satisfaction
satisfactory: satisfactory
satisfied: satisfied
satisfy: satisfy
save: save,saved
scale: scale
scamp: scamp
scandal: scandal
scarce: scarce
scarcely: scarcely
school: school,schools
schools: schools
science: science,sciences
scientific: scientific
scion: scions
scold: scolding
scolding: scolding
scope: scope
score: score
scorn: scorn,scorned
scornfully: scornfully
scourge: scourge
scout: scouted
scullery: scullery
sea: sea,seas
seal: seal,sealed
search: search
season: season,seasons
seasonable: seasonable
seat: seat,seated
secrecy: secrecy
secret: secret,secrets
secure: secure,secured
sedition: sedition,seditions
seditious: seditious
seek: seek,sought
seemingly: seemingly
seer: seer
seize: seized,seizing
selfish: selfish
semicircle: semicircle
seminary: seminaries
send: send,sending,sends
sensation: sensation
sense: sense
senseless: senseless
sensibly: sensibly
sensitive: sensitive
sensuous: sensuous
sentence: sentence,sentenced,sentencing
sentiment: sentiment
separate: separate
serf: serf,serfs
serfdom: serfdom
series: series
servant: servant,servants
serve: serve,served,serves
service: service,services
set: set,setting
seventh: seventh
severe: severe
sex: sex,sexes
shade: shade,shading
shadow: shadow,shadows
shadowy: shadowy
shake: shake,shaking
shalt: shalt
shame: shame
shape: shape,shapes
shaper: shapers
share: share
sharp: sharp
shatter: shattered
sheet: sheet
shew: shew,shewed
shifting: shifting
shine: shines
shiver: shivered
shock: shock
shooting: shooting
shop: shop
short: short,shorter
shortly: shortly
shout: shout
shriek: shrieked
shrill: shrillest
shrink: shrinks
shrinkage: shrinkage
shudder: shudder
shut: shut
sickening: sickening
sided: sided
sidedness: sidedness
sideways: sideways
sigh: sigh
sight: sight,sights
sign: sign
signal: signal
signify: signifies,signify
silence: silence,silenced
silent: silent
silly: silly
simple: simple,simpler
simplicity: simplicity
simply: simply
simulate: simulating
simulation: simulations
simultaneous: simultaneous
simultaneously: simultaneously
single: single
sink: sinking,sunk
sir: sir
sister: sisters
sit: sat,sit,sitting
situate: situated
situation: situation
sixteen: sixteen
sixth: sixth
size: size,sizes
sized: sized
skilful: skilful
skilfully: skilfully
skill: skill
slang: slang
slaughter: slaughter,slaughtered
slave: slave,slaves
slay: slain
sleep: sleep
slice: slice
slight: slight,slightest
slip: slipping
slowly: slowly
slumber: slumber
smith: smith
smoothly: smoothly
sneeze: sneeze,sneezing
soar: soar,soared
sober: sober
social: social
society: society
soldier: soldier,soldiers
sole: sole,soles
solemn: solemn
solid: solid,solids
soliloquize: soliloquizing
solution: solution
solve: solve
solver: solvers
sombre: sombre
son: son,sons
sonorousness: sonorousness
sons: sons
sophism: sophism
soprano: soprano
sorrowing: sorrowing
sort: sort
soul: soul
sound: sound,sounds
south: south
southern: southern
southward: southward
space: space
spacious: spacious
spare: spared,sparing
speak: speak,speaking,speaks,spoke,spoken
special: special
specimen: specimens
speck: speck
spectator: spectator
speculative: speculative
speech: speech
speechless: speechless
speedily: speedily
speedy: speedy
spell: spell
spend: spend
sphere: sphere,spheres
spheres: spheres
sphinx: sphinx
spirit: spirit,spirits
spiritual: spiritual
spite: spite
spleen: spleen
spread: spread
spring: sprang,sprung
squalor: squalor
square: square,squares,squaring
squares: squares
stab: stab
stagger: staggered
stagnation: stagnation
stake: stake
stamp: stamping
stand: stand,standing,stood
standard: standard
standing: standing
start: start,started
startle: startle
startled: startled
statement: statement,statements
statesman: statesman,statesmen
statesmanship: statesmanship
statesmen: statesmen
static: static
statical: statical
statics: statics
stationary: stationary
statistics: statistics
status: status
stay: stay
stead: stead
steadfastly: steadfastly
steadily: steadily
steal: stealing
stem: stem
step: step,steps
stick: sticking
stifle: stifle
stillness: stillness
stimulate: stimulated,stimulating
stimulus: stimulus
sting: sting
stinging: stinging
stipend: stipend
stir: stir,stirred
stolid: stolid
stomach: stomach,stomachs
stone: stone
story: story
straight: straight
straightway: straightway
strain: strain
strand: strand
strange: strange
stranger: stranger,strangers
strata: strata
stream: stream
street: street,streets
strength: strength
strengthen: strengthened
strengthening: strengthening
stretch: stretch
strict: strict
strictly: strictly
strike: struck
striking: striking
string: string
stringent: stringent
stroke: stroke
strong: strong
structure: structure,structures
struggle: struggling
study: studies,study
stuff: stuff
stunned: stunned
stupid: stupid
style: style
subdued: subdued
subject: subject,subjected,subjects
submission: submission
submit: submit,submitting
subordinate: subordinate,subordinated
substantial: substantial
substitute: substitute
subtle: subtle
subversion: subversion
succeed: succeeded
success: success,successes
successful: successful
successor: successor
succinct: succinct
succumb: succumbed
sudden: sudden
suddenly: suddenly
suffer: suffer,suffered,suffering
suffice: suffice
sufficient: sufficient
suffuse: suffused
suggestion: suggestion
suggestive: suggestive
suicide: suicide
suit: suits
suitable: suitable
sum: summed
summarily: summarily
summary: summary
summon: summon,summoned
sun: sun
superficial: superficial
superfluity: superfluity
superfluous: superfluous
superior: superior
superiority: superiority
superscript: superscripts
supersede: superseded
supervise: supervised
supervision: supervision
supper: supper
supplement: supplemented
supply: supplies,supply
suppose: suppose,supposed,supposing
suppress: suppress,suppressed,suppressing
suppression: suppression
supreme: supreme
supremely: supremely
surely: surely
surety: surety
surface: surface
surgeon: surgeons
surgical: surgical
surpass: surpassing
surprise: surprise,surprised
surprised: surprised
surreptitiously: surreptitiously
surround: surrounded,surrounding
surroundings: surroundings
survey: survey,surveying
survive: survive,survives
susceptible: susceptible
suspect: suspected
suspend: suspended
suspicion: suspicions
suspicious: suspicious
sustain: sustain
sway: swaying
sweep: swept
sweet: sweet,sweetest
sweetmeat: sweetmeats
swing: swing
symmetrical: symmetrical
sympathy: sympathies,sympathy
symptom: symptoms
systematic: systematic
systematically: systematically
table: table,tables
tablet: tablet,tablets
tact: tact
taint: taint
tale: tale,tales
talk: talk
tall: tall
tame: taming
tantalize: tantalized,tantalizing
task: task
taste: tastes
tax: tax
taylor: taylor
teach: taught,teach,teaching
teacher: teacher,teachers
teachers: teachers
teaching: teaching,teachings
tear: tear,tears
technical: technical
tedious: tedious
temper: temper
temperate: temperate
temperature: temperature
tempt: tempted,tempts
temptation: temptation,temptations
tender: tender
tenor: tenor
tenth: tenth
term: term,terms
terminal: terminal
terrible: terrible
terror: terror
theatre: theatre
thee: thee
theology: theology
theoretically: theoretically
theory: theory
thickness: thickness
thievish: thievish
thine: thine
thinker: thinker
thirst: thirst,thirsted
thirteen: thirteen
thousandth: thousandth
threaten: threaten,threatened,threatening
threefold: threefold
threshold: threshold
thrice: thrice
thrill: thrilled
throat: throat,throats
throw: threw,throw,thrown
thunder: thunder,thundered
thy: thy
tick: tick
ticket: ticket
ticking: ticking
time: time,timed,times
tinge: tinge
tinkling: tinkling
tiny: tiny
title: title
toleration: toleration
tombstone: tombstones
tone: tone,tones
topic: topics
torrid: torrid
toss: toss
total: total
touch: touch,touched,touching
town: town,towns
trace: trace
trade: trade
tradesman: tradesman
tradesmen: tradesmen
tradition: tradition
train: trained
training: training
transcriber: transcriber
transfix: transfixed
transient: transient
transmute: transmuted
transparent: transparent
transport: transported
trap: trap
travel: travelling
traveller: traveller
traverse: traverse
treachery: treachery
treason: treason
treasonable: treasonable
treasure: treasures
treat: treat,treated
treatise: treatise
treatment: treatment
treble: treble
tree: trees
tremendous: tremendous
trial: trial,trials
triangle: triangle,triangles
triangles: triangles
triangular: triangular
tribute: tribute
trick: tricks
triennial: triennial
trifle: trifle,trifled,trifles
trifling: trifling
triplet: triplet
triumph: triumph,triumphs
triumphantly: triumphantly
trouble: trouble,troubled
troublesome: troublesome
truce: truce
true: true,truest
trunk: trunks
trust: trust,trusted
trustworthy: trustworthy
truth: truth,truths
tumult: tumults
twin: twins
twitter: twittering
twofold: twofold
type: type
typo: typos
ultimate: ultimate
ultimately: ultimately
ultramarine: ultramarine
umber: umber
unable: unable
unanimously: unanimously
unattainable: unattainable
unbroken: unbroken
unceremonious: unceremonious
uncertified: uncertified
uncle: uncles
unconscious: unconscious
undecided: undecided
underscore: underscores
understand: understand,understands,understood
understanding: understanding
undeserved: undeserved
undeveloped: undeveloped
undulation: undulation
uneducated: uneducated
unemancipable: unemancipable
unequal: unequal
unerringly: unerringly
uneven: uneven
unevenness: unevenness
unexpected: unexpected
unfavourable: unfavourable
unfit: unfit
unfortunate: unfortunate
unhappy: unhappy
unhesitatingly: unhesitatingly
uninjured: uninjured
unintelligible: unintelligible
uninteresting: uninteresting
uninterrupted: uninterrupted
union: union
unite: unites
universal: universal
universally: universally
universe: universe
university: university
unknown: unknown
unlearn: unlearn
unlock: unlocked
unmixed: unmixed
unmoved: unmoved
unnatural: unnatural
unprecedented: unprecedented
unprepared: unprepared
unquestionable: unquestionable
unquestioned: unquestioned
unreasoning: unreasoning
unreflecting: unreflecting
unscientific: unscientific
unseemly: unseemly
unsolved: unsolved
unspeakable: unspeakable
unsuccessful: unsuccessful
unusual: unusual
unusually: unusually
unveil: unveiled
unwary: unwary
unwilling: unwilling
unworthy: unworthy
upper: upper
uproar: uproar
upward: upward
usage: usages
usual: usual
utilize: utilized
utmost: utmost
utter: utter,utters
utterance: utterance,utterances
utterer: utterer
utterly: utterly
uttermost: uttermost
vacation: vacation
vacuum: vacuum
vagabond: vagabond
vain: vain
vainly: vainly
valuable: valuable
vanish: vanished,vanishes,vanishing
vantage: vantage
varied: varied
variegate: variegated
variety: varieties,variety
variously: variously
vary: varied,varies,vary,varying
vast: vast
vegetable: vegetables
vehemence: vehemence
vehemently: vehemently
veil: veil
velocity: velocity
venerable: venerable
vent: vent
ventilator: ventilators
venture: venture,ventured
verification: verification
verify: verifying
vermilion: vermilion
versatility: versatility
version: versions
vertex: vertex,vertices
victim: victim,victims
victory: victory
view: view,views
vigour: vigour
vile: vile
village: village
villager: villagers
violate: violated
violation: violation
violence: violence
violent: violent
violently: violently
virtue: virtue
visible: visible
visibly: visibly
vision: vision,visions
visionary: visionary
visit: visit,visited,visits
visitation: visitations
visitor: visitor
visual: visual
vital: vital
vivacity: vivacity
vocabulary: vocabulary
vocal: vocal
vocally: vocally
voice: voice,voiced,voices
volition: volition
voluble: voluble
volume: volume
vote: votes
vouchsafe: vouchsafe,vouchsafed
voyage: voyage
vulgarise: vulgarise
wait: waiting
wake: wake
walk: walk,walked,walking
wall: wall,walls
wander: wandering
wane: wane
war: war
warfare: warfare
warning: warning
waste: waste,wasted
watch: watched
water: water
waver: wavering
wax: wax,waxed
weak: weak
weakness: weakness
wealthy: wealthiest
weapon: weapons
weary: wearied
wedge: wedge
week: week,weeks
weekly: weekly
weigh: weighs
welfare: welfare
west: west
western: western
whisper: whisper
white: white
wholesome: wholesome
wholly: wholly
wide: wide
widen: widened
wife: wife,wives
wilderness: wilderness
wildfire: wildfire
willingly: willingly
window: windows
windows: windows
wink: winked
wisdom: wisdom
wise: wise,wisest
wit: wit
witness: witness,witnessed,witnesses
woman: woman,women
women: women
wonted: wonted
woo: wooing
wood: wood
wooer: wooer
word: word
workman: workman,workmen
workmen: workmen
worship: worshipped
worth: worth
wound: wound
wrath: wrath
wretch: wretch
wretched: wretched
write: writing,written
writing: writing
wrong: wrong
yard: yards
yesterday: yesterday
yield: yield,yielding
yon: yon
yonder: yonder
youth: youth,youths
youthful: youthful
zest: zest
zone: zones
