abandon: abandoning
abhor: abhorred
abide: abide
abject: abject
abode: abode
abrupt: abrupt
abruptly: abruptly
absence: absence
absorb: absorbed
abstain: abstain
abstractedness: abstractedness
abyss: abyss
accent: accents
accept: accept,accepted,accepting
acceptation: acceptation
access: access,accessed
accessible: accessible
accompany: accompanied,accompanying
accomplishment: accomplishment
account: account,accounts
accurate: accurate
accursed: accursed
accustom: accustomed
accustomed: accustomed
acquaint: acquainted
acquaintance: acquaintance
action: action,actions
active: active
actual: actual
adapt: adapted
add: add
addition: addition,additions
additional: additional
address: address,addressed,addresses
adduce: adduced
admire: admire
adorn: adorned
adultress: adultress
advance: advance,advanced,advancing
advice: advice
affair: affairs
affectation: affectation
affection: affection,affections
affirm: affirmed
afflict: afflicted
affluent: affluent
afraid: afraid
afrits: afrits
age: age,ages
aged: aged
agency: agency
agent: agent,agents
agitate: agitating
agony: agony
agree: agree,agreed
agreement: agreement
airy: airy
ak: ak
alarm: alarm
album: album
alienated: alienated
alike: alike
alive: alive
allude: alluded
alms: alms
aloud: aloud
alps: alps
alteration: alteration
alternate: alternate
altogether: altogether
amply: amply
ancient: ancient
anecdote: anecdotes
animal: animal
animated: animated
annex: annexed
anonymous: anonymous
answer: answer,answered,answers
antagonist: antagonist
antiquarian: antiquarian
antiquary: antiquary
antiquity: antiquities
anxiety: anxiety
anxious: anxious
anxiously: anxiously
apace: apace
apartment: apartment,apartments
apathetic: apathetic
apology: apologies
apparent: apparent
appeal: appealed
appearance: appearance
appetite: appetite
applause: applause
applicable: applicable
apply: apply
appoint: appointed
apprentice: apprentices
approach: approach,approached,approaching
approve: approving
arabian: arabian,arabians
archipelago: archipelago
architect: architect
architecture: architecture
archive: archive
arm: arm,arms
armenian: armenian
arnold: arnold
arrange: arranging
array: array
arrival: arrival
arrive: arrive,arrived
art: art,arts
article: articles
ascertain: ascertained
ascii: ascii
ash: ashes
ashamed: ashamed
assemble: assembled
assembly: assemblies,assembly
assent: assent
assignation: assignation
assist: assist
assistance: assistance
associate: associating
association: associations
assume: assume,assumed
assure: assured
astonish: astonished
astonished: astonished
astonishing: astonishing
ataghan: ataghans
athens: athens
atmosphere: atmosphere
attach: attach,attached,attaching
attack: attacks
attain: attained,attaining
attempt: attempt,attempted
attend: attend,attended,attending
attendance: attendance
attendant: attendant,attendants
attention: attention,attentions
attract: attract,attracted
attribute: attributed,attributing
aubrey: aubrey
aught: aught
austria: austria
author: author
avail: availed
averse: averse
avert: avert
avoid: avoid,avoided
avoidance: avoidance
await: awaiting
aware: aware
awe: awe
awful: awful
awning: awning
baffle: baffled
bailiff: bailiff
balcony: balcony
ball: balls
balustrade: balustrade
banker: banker
banquet: banquet
barbarian: barbarian
bargaining: bargaining
base: base,based
bashfulness: bashfulness
bask: bask
battle: battles
bay: bay
bear: bear,bearing,borne
beautiful: beautiful
beauty: beauties,beauty
bed: bed
bedchamber: bedchamber
beg: beg,begged
beggar: beggar
behold: beholding
belief: belief
belong: belong,belonging,belongs
beloved: beloved
beneath: beneath
benevolence: benevolence
benevolent: benevolent
benumb: benumbed
beseech: besought
bestow: bestowed
bet: betted
bewilder: bewildered
bid: bade
binary: binary
bind: bound
bird: bird
birth: birth
bitter: bitter
black: black
blast: blast
bless: bless
blight: blighted
blood: blood
bloom: bloom
blue: blue
blush: blush
board: board
boast: boast
boat: boat,boats
body: bodies,body
bonnet: bonnet
book: book,books
border: borders
bosom: bosom
boundary: boundaries
bounty: bounties
bradshaw: bradshaw
brain: brain
branch: branch,branches
breach: breach
break: break,broke,broken
breast: breast,breasts
breath: breath
breathe: breathe,breathed,breathing
breeze: breeze
bribe: bribe
bride: bride
bridegroom: bridegroom
bright: bright,brighter
brighten: brightened,brightening
brilliancy: brilliancy
brilliant: brilliant
bring: bring,brought
british: british
broad: broad
broken: broken
bronze: bronze
brother: brother
brow: brow
brushwood: brushwood
brussels: brussels
build: built
bullet: bullets
burial: burial
burn: burned
burst: burst,bursting
bury: buried,bury
bush: bushes
business: business
bust: bust
busy: busy
butterfly: butterfly
byron: byron
cabin: cabin
calais: calais
calculate: calculate,calculated
candle: candles
candour: candour
cane: cane
canopying: canopying
canto: canto
canvass: canvass
capable: capable
card: card
care: care
career: career
caress: caresses
carpet: carpet
carriage: carriage,carriages
carry: carried,carry,carrying
cascade: cascades
cat: cat
catastrophe: catastrophe
cattle: cattle
caution: caution
cave: cave
cease: cease
celebrated: celebrated
censure: censure
centre: centre,centres
certainty: certainty
chair: chair,chairs
chamber: chamber
chance: chanced
change: change,changed
changed: changed
character: character,characters
charge: charge,charges
charitable: charitable
charity: charities,charity
charm: charm,charms
check: check,checks
cheek: cheek
chest: chest
chief: chief
chiefly: chiefly
child: child,children
childe: childe
childhood: childhood
choose: choose
chord: chords
christabel: christabel
christianity: christianity
chronicle: chronicling
church: church,churches
circle: circle,circles
circling: circling
circumstance: circumstance,circumstances
cite: cited
city: city
claim: claim,claimed
classical: classical
cleave: cleaves
clergyman: clergyman
climate: climates
climb: climb
close: close,closed
closely: closely
closet: closet
clothes: clothes
cloud: cloud
cluster: clustering
coarse: coarse
code: codes
coincidence: coincidences
cold: cold
collect: collected
collection: collection
colour: colour,colours
coloured: coloured
combination: combination
combine: combined
comet: comet
comfort: comfort
commander: commander
commercial: commercial
commit: committed
common: common
companion: companion
company: company
compel: compelled
compensation: compensation
compilation: compilation
complain: complained
complete: complete,completed
completely: completely
compliance: compliance
comply: comply,complying
composedly: composedly
compress: compressed
comrade: comrade,comrades
conceal: conceal,concealed
conceive: conceived
concept: concept
concern: concerned
conclude: concluded
conclusion: conclusions
conduct: conduct,conducted
conductor: conductor
conductress: conductress
confess: confess
confine: confine,confined
confirm: confirmed
confirmation: confirmation
congeries: congeries
congratulate: congratulate
conjecture: conjectures
conjure: conjured
conjuring: conjuring
conscience: conscience
conscious: conscious
consent: consented
consequence: consequence
consequential: consequential
considerable: considerable
considerably: considerably
consideration: consideration
consist: consisted
console: consoled
conspire: conspired
constant: constant
constantinople: constantinople
constantly: constantly
construction: construction
consult: consulted
consumption: consumptions
contact: contact
contemplate: contemplated
contemplation: contemplation
contempt: contempt
contemptible: contemptible
content: content
contents: contents
contest: contest
continent: continent
continue: continued
contract: contract
contradiction: contradiction
contrast: contrasted
contribute: contributing
contribution: contributions
convalescence: convalescence
conversation: conversation
converse: converse,conversed
convert: convert
convey: convey,conveyed
convince: convinced
convulsive: convulsive
cool: cooling
coppet: coppet
copying: copying
copyright: copyright
corner: corner
cornice: cornices
corporation: corporation
corpse: corpse
corrupt: corrupt
corruption: corruption
corse: corse,corses
cost: cost,costs
cottage: cottage
cottager: cottager
cotton: cotton
couch: couch
count: count
countenance: countenance,countenances
countess: countess
country: countries,country
countryman: countryman,countrymen
courage: courage
court: court,courting
cover: covered
cow: cow
crag: crags
crashing: crashing
craving: craving
create: created,creating
creation: creation
credible: credible
credit: credit
crime: crime,crimes
critical: critical
cross: cross,crossed,crossing
crowd: crowd
crowded: crowded
crown: crown
cultivate: cultivated
cunning: cunning
curiosity: curiosity
curious: curious
currency: currency
current: current
curse: curse,curses,cursing
custody: custody
customary: customary
cut: cut
dagger: dagger,daggers
daily: daily
dally: dallying
damage: damage
damaged: damaged
damages: damages
damp: damps
dance: dance,danced
dancing: dancing
danger: dangers
dangerous: dangerous
daring: daring
dark: dark
darkness: darkness
datum: data
daughter: daughter,daughters
day: day,days
dead: dead
deadly: deadly
dearly: dearly
death: death
decay: decay
deceased: deceased
decline: decline
decorate: decorated
decrease: decreased
deductible: deductible
deed: deeds
deem: deemed
deep: deeper
deeply: deeply
defect: defect,defects
defective: defective
defence: defence
defend: defended
defile: defile
definite: definite
deformity: deformity
degradation: degradation
degree: degree
delay: delay,delayed
deletion: deletions
delicate: delicate
delicately: delicately
delight: delight
delirious: delirious
delirium: delirium
deliver: deliver
demand: demand
demon: demon
denote: denoting
denounce: denounced
deny: denied
depart: depart,departed
departure: departure
depend: depending,depends
depict: depicted
deposition: deposition
deprive: deprived
depths: depths
derange: deranged
derivative: derivative
derive: derive,derived
descend: descended
description: description,descriptions
deserted: deserted
desire: desire,desired,desiring
desirous: desirous
desolate: desolated
destitute: destitute
destroy: destroy,destroyed
destroyer: destroyer
destructive: destructive
detach: detach
detain: detain,detained
detect: detected
determine: determine,determined
develop: developed
deviation: deviation
devoted: devoted
devouring: devouring
devout: devout
die: died,dying
difference: difference
dining: dining
dinner: dinner
direct: direct,directed
direction: direction
director: director
disappear: disappeared
disbelieve: disbelieve
disclaim: disclaim
disclaimer: disclaimer,disclaimers
disclose: disclose
discontinue: discontinue
discover: discover,discovered
dishonour: dishonoured
disk: disk
dismount: dismounting
disorder: disorder
dispel: dispelled
display: display,displayed,displaying
disposition: disposition
dissertation: dissertations
dissipation: dissipations
distance: distance,distanced
distended: distended
distinctly: distinctly
distinguished: distinguished
distracted: distracted
distress: distress
distribute: distribute,distributed,distributing
distribution: distribution
distributor: distributor
disturb: disturbed
disturbed: disturbed
division: division
doctrine: doctrine
domain: domain
domestic: domestic
dominick: dominick
donate: donate
donation: donation,donations
donor: donors
doom: doomed
door: door
doubt: doubt,doubts
download: downloading
dozen: dozen
drain: drain
draw: drawn,drew
drawing: drawing
dread: dread
dreadful: dreadful
dreadfully: dreadfully
dream: dreams
dress: dress
drink: drinking
drip: drip
drive: driven
drop: drops
dungeon: dungeon
duty: duty
dwell: dwelling,dwelt
eager: eager
eagerness: eagerness
ear: ear,ears
earl: earl
earnest: earnest
earnestly: earnestly
earnestness: earnestness
earth: earth
earthquake: earthquake
easily: easily
east: east
easy: easy
eat: ate,eating
ebb: ebbs
eccentric: eccentric
eccentricity: eccentricities
echo: echoed,echoing
edition: edition,editions
educational: educational
efface: effaced
effort: effort,efforts
effusion: effusion
egypt: egypt
eighteen: eighteen
elapse: elapsed
elasticity: elasticity
elder: elder
elect: elect
electronic: electronic
electronically: electronically
elegantly: elegantly
emaciated: emaciated
email: email
embarrassed: embarrassed
embassy: embassy
embrace: embraces
emerald: emerald
emit: emitting
emotion: emotion
empires: empires
employ: employed,employing
employee: employee,employees
enable: enable
encode: encoding
encounter: encountered
endeavour: endeavoured,endeavouring
enemy: enemies,enemy
engage: engaged,engaging
england: england
english: english
engross: engrossed
enhance: enhance
enjoy: enjoyed,enjoying
ennui: ennui
enormous: enormous
enquire: enquiring
enquiry: enquiries
ensue: ensued,ensuing
ensure: ensure,ensuring
entangled: entangled
enter: enter,entered,entering
entitle: entitled
entity: entity
entrance: entrance
entry: entry
epicure: epicure
epoch: epoch
equality: equality
equipment: equipment
ere: ere
error: error,errors
escape: escape,escaped
establishment: establishment
esteem: esteem
europe: europe
evening: evening,evenings
event: events
evident: evident
evidently: evidently
evil: evil,evils
evince: evinced
exalt: exalted
examination: examination
examine: examining
excellent: excellent
excessive: excessive
exchange: exchanged
excite: excite,excited
excited: excited
excitement: excitement
exclusion: exclusion
excursion: excursion,excursions
excuse: excuse
executive: executive
exempt: exempt
exhibit: exhibit
exist: existed,exists
existence: existence
expend: expend
expense: expense,expenses
experienced: experienced
expire: expire,expired
explain: explain
explanation: explanation
export: exporting
expose: expose,exposed,exposing
express: express,expressing
expression: expression
extant: extant
extend: extend
extensive: extensive
extent: extent
external: external
externally: externally
extract: extract
extraordinary: extraordinary
extravagance: extravagance
extravagant: extravagant
exultant: exultant
exultation: exultation
eye: eye,eyes
eyewitness: eyewitness
facility: facility
faculty: faculties
fade: faded,fading
faint: fainting
fair: fair
fairbanks: fairbanks
fairy: fairy
faithful: faithful
fall: fall,fallen,falling,fell
false: false
fame: fame
family: families,family
fancy: fancy
fantasy: fantasies
farm: farm
faro: faro
farth: farthest
farthing: farthing
fashionable: fashionable
fast: fast
fatal: fatal
fate: fate
father: father,fathers
fatigue: fatigue
fatten: fattened
fault: fault
favour: favour
favourite: favourite
fear: fear,feared,fearing,fears
fearful: fearful
feast: feast
feature: feature,features
federal: federal
fee: fee,fees
feed: fed,feed,feeding
feel: feel,feeling
feeling: feeling,feelings
fellow: fellow
felucca: felucca
female: female,females
fever: fever
field: field
fiend: fiend,fiends
fierce: fierce
figure: figure
file: file,files
financial: financial
finding: finding
fine: fine,finer
finger: fingers
fisherman: fisherman
fit: fit,fitted
fitness: fitness
flake: flakes
flame: flame
flat: flat
flatter: flattered
flee: fled
fleet: fleet
flicker: flickered
flit: flitted
float: floating
floor: floor,floors
florid: florid
flow: flow,flowing
flower: flower,flowers
fluted: fluted
fly: fly
foe: foe
foil: foiled
fold: folds
foliage: foliage
follow: follow
folly: folly
fond: fond,fondest
food: food
foot: feet,foot
footing: footing
force: force,forced,forcing
forest: forest
forewarn: forewarn,forewarned
forget: forget,forgot
forgetfulness: forgetfulness
fork: forked
form: form,formed,forming,forms
format: format,formats
forte: forte
fortunate: fortunate
fortune: fortune
foster: foster
foundation: foundation
fountain: fountain
fourteen: fourteen
fragment: fragment
frail: frail
frank: frank
frankenstein: frankenstein
frankly: frankly
frantic: frantic
freely: freely
freeman: freemen
freeze: freeze,freezes
frequent: frequent,frequented
frequently: frequently
fresh: fresh
fret: fret
friend: friend,friends
fright: fright
frivolity: frivolities
frontier: frontiers
frown: frown
fruit: fruit
fruitless: fruitless
furnish: furnished
furniture: furniture
future: future
gain: gain,gained,gaining,gains
gale: gale
gamble: gambled
gambling: gambling
gather: gather,gathered
gay: gay
gaze: gaze,gazed,gazing
gazelle: gazelle
generation: generations
generosity: generosity
geneva: geneva
genevan: genevan
genius: genius
gentleman: gentleman
german: german
ghastly: ghastly
ghost: ghost
giaour: giaour
gibbon: gibbon
gilder: gilder
girl: girl,girls
glad: glad
gladly: gladly
glance: glance
glare: glare
glass: glass
glassy: glassy
glee: glee
glide: glided
gloom: gloom
glorious: glorious
glory: glory
glow: glowing
glut: glutted
gnash: gnashing
goal: goals
godwin: godwin
govern: govern
grace: grace
gradually: gradually
grant: granted
grape: grapes
grapple: grappled
grasp: grasp
gratefully: gratefully
gratification: gratification
gratified: gratified
grave: grave,graves
grecian: grecian
greece: greece
greek: greek,greeks
green: green
gregory: gregory
grey: grey
grief: grief,griefs
gross: gross
grossly: grossly
ground: ground
grow: grew
guard: guard,guards
guardian: guardian,guardians
guess: guessing
guidance: guidance
guide: guide,guided,guides
guilt: guilt
gun: guns
habit: habits
haft: haft
haggard: haggard
hair: hair
hall: hall
hand: hand,hands
handsome: handsome
hang: hung
happen: happen,happened
happiness: happiness
harass: harass
harbour: harbour
harmless: harmless
harold: harold
hart: hart
haste: haste
hasten: hastened,hastening
hasty: hasty
hatred: hatred
haunt: haunt,haunted,haunts
head: head,heads
health: health
hear: hear,heard,hearing
hearing: hearing
heart: heart
heartbreaking: heartbreaking
hearted: hearted
heated: heated
heavy: heavy
heed: heed,heeding
heedless: heedless
heighten: heighten
heights: heights
heinous: heinous
helpless: helpless
herewith: herewith
hermit: hermits
hero: hero
hide: hidden
hill: hill,hills
hint: hint,hinted
hitherto: hitherto
hold: held,hold
holder: holder
hole: hole
homer: homer
honour: honour
hope: hope,hoped,hoping
horizon: horizon
horrible: horrible
horrified: horrified
horror: horror,horrors
horse: horse,horses
host: host
hour: hour,hours
house: house
hovel: hovel
hue: hue,hues
human: human
hungary: hungary
hungry: hungry
hunter: hunters
hurl: hurled
hurried: hurried
hurry: hurried,hurrying
husband: husband
hut: hut
ida: ida
idea: idea,ideas
identical: identical
identification: identification
identify: identify
idle: idle
illness: illness
illustrate: illustrate
illustrative: illustrative
image: image
imagination: imagination,imaginations
imagine: imagine,imagined
imbibe: imbibed
imitate: imitating
immense: immense
impart: impart
impatience: impatience
impede: impeded
impend: impending
implore: implored
imply: implied,implying
importunity: importunity
impose: imposed
impossibility: impossibility
impossible: impossible
imprecate: imprecate
impressed: impressed
impression: impression
impudence: impudence
impulse: impulses
imputation: imputation
inaccurate: inaccurate
incapable: incapable
incidental: incidental
include: include,included,includes,including
including: including
incoherence: incoherence,incoherences
incomplete: incomplete
inconsolable: inconsolable
increase: increased,increasing
incredulous: incredulous
indemnify: indemnify
indemnity: indemnity
indifferent: indifferent
indigence: indigence
indigent: indigent
indirect: indirect
indirectly: indirectly
individual: individual,individuals
induce: induce,induced
inevitably: inevitably
inexperience: inexperience
infamy: infamy
infancy: infancy
infantile: infantile
infantine: infantine
infernal: infernal
influence: influence,influenced
inform: informed,informing
infringement: infringement
inhabitant: inhabitants
inheritance: inheritance
iniquity: iniquity
injury: injuries
inmate: inmates
innocence: innocence
innocent: innocent
inquire: inquired
inquiry: inquiries
insane: insane
insanity: insanity
inscription: inscription
insist: insisted
inspire: inspired
inspirer: inspirer
instance: instance
instant: instant
instantly: instantly
insulting: insulting
integrity: integrity
intellect: intellect
intellectual: intellectual
intend: intended
intention: intention,intentions
intently: intently
internal: internal
international: international
interpose: interpose
interposition: interposition
interpret: interpreted
interpretation: interpretation
interval: interval,intervals
intervene: intervene
intimacy: intimacy
intimate: intimate
intreat: intreated
intrigue: intrigues
introduce: introduced
introduction: introduction
invalid: invalid
invalidity: invalidity
invent: invent
invite: invited
irregular: irregular
irresistible: irresistible
irs: irs
island: island,islands
isle: isle
iso: iso
isolate: isolated
issue: issuing
italian: italian
italy: italy
john: john
jones: jones
journal: journal
joy: joy
joyous: joyous
judgment: judgment
july: july
jura: jura
justice: justice
justify: justified,justify
kindly: kindly
kindred: kindred
kiss: kissed
knee: knees
kneel: kneeling
knowledge: knowledge
lachryma: lachryma
lady: ladies,lady
ladyship: ladyship
lake: lake
lamentable: lamentable
land: landed
language: language
languish: languishing
late: late
latin: latin
laugh: laugh,laughed,laughing
laughter: laughter
law: law,laws
lay: laid,lay
lead: led
leaden: leaden
leader: leaders
leaf: leaves
lean: leaning
leap: leaps
learn: learn,learned,learnt
leave: leave,leaving,left
left: left
legal: legal
legally: legally
letter: letter,letters
level: level
levity: levity
liability: liability
liable: liable
liberality: liberality
library: library
license: license
licensed: licensed
licentious: licentious
lichen: lichen
lie: lie,lies
lieu: lieu
life: life
lifeless: lifeless
lift: lifted
light: light,lit
lightning: lightning
limb: limbs
lime: limes
limit: limited,limits
limitation: limitation
limited: limited
linen: linen
link: linked,links
lip: lip,lips
lire: lire
listen: listen
literally: literally
literary: literary
litter: litter
live: live,lived,living
livid: livid
living: living
load: loaded
loathe: loathe
locate: located
location: locations
lock: lock
locket: locket
lofty: lofty
london: london
lone: lone
loose: loose
lord: lord,lords
lordship: lordship
lorraine: lorraine
lose: lose,losing,lost
lost: lost
lot: lot
loud: loud
love: love,loved,loves
lovely: lovely
lover: lover,lovers
luckless: luckless
lust: lust
lustre: lustre
luxurious: luxurious
machine: machine
madame: madame
magic: magic
magistrate: magistrates
magnificently: magnificently
mahomet: mahomet
maid: maid
main: main
maintain: maintaining
majestic: majestic
majesty: majesty
malediction: maledictions
malicious: malicious
maniac: maniac
mansion: mansion
mantle: mantle
marble: marble
march: march
marginal: marginal
mark: mark,marked,marking,marks
marriage: marriage
married: married
marry: married,marry,marrying
mask: mask
mass: mass,masses
matron: matron
mattress: mattress
maximum: maximum
measure: measures
medium: medium
meek: meek
meet: meet,met
melancholy: melancholy
memorial: memorial,memorials
memory: memory
mention: mentioned,mentioning
mercenary: mercenary
mercer: mercer
merchantman: merchantmen
merit: merit
messiah: messiah
method: method,methods
michael: michael
middle: middle
midnight: midnight
midst: midst
mile: miles
milliner: milliners
milton: milton
mind: mind
mingle: mingling
mining: mining
minute: minutes
mirror: mirrors
mirth: mirth
mischief: mischief
misery: misery
misfortune: misfortune,misfortunes
mission: mission
mississippi: mississippi
misty: misty
mock: mock,mocked,mocking
mockery: mockery
model: model
modern: modern
modest: modest
modesty: modesty
modification: modification
modify: modified
moment: moment
money: money
monster: monster,monsters
monstrous: monstrous
month: months
monticule: monticule
monument: monuments
moon: moon
moral: moral
morning: morning
morose: morose
mortal: mortal
mortification: mortification
mother: mother,mothers
motive: motive,motives
mount: mount,mounted
mountain: mountain,mountains
mountebank: mountebank
mouse: mouse
mouth: mouth
moveless: moveless
mud: mud
mute: mute
myrtle: myrtle
mystery: mystery
naked: naked
naples: naples
narrate: narrated
narrative: narratives
narrow: narrow
nation: nation
native: native,natives
nature: nature
neck: neck
neglect: neglected,neglecting
negligence: negligence
neighbour: neighbouring
neighbourhood: neighbourhood
network: network
newsletter: newsletter
night: night,nights
nightly: nightly
noble: nobler
nobleman: nobleman
nocturnal: nocturnal
nonproprietary: nonproprietary
noon: noon
north: north
nose: nose
note: note,notes
notice: notice,notices
notify: notifies,notify
notion: notions
notoriety: notoriety
november: november
novice: novice
numerous: numerous
nuptial: nuptial
nuptials: nuptials
nurse: nurse
oath: oath
obedient: obedient
object: object,objects
oblige: obliged
observation: observation,observations
observe: observe,observed,observing
obsolete: obsolete
occasion: occasion,occasions
occupation: occupation
occupied: occupied
occupy: occupied
occur: occur,occurred
october: october
odd: odd
offence: offence
offer: offer,offered,offers
office: office
official: official
offspring: offspring
olive: olive
online: online
openly: openly
opinion: opinion
opportunity: opportunities,opportunity
orange: oranges
orb: orbs
organize: organized
orgy: orgies
original: original
originate: originated
originator: originator
ornament: ornamented
ornamental: ornamental
orphan: orphan
outcast: outcast
outdated: outdated
outline: outline
overcome: overcame
overpower: overpowered
overtake: overtook
owe: owed
owner: owner
pace: paced,paces
pacify: pacify
pain: pain
paint: paint
painter: painter
painting: painting
pair: pair
pale: pale
palermo: palermo
palm: palm
pamphlet: pamphlets
paper: paper,papers
paperwork: paperwork
paradise: paradise
paragraph: paragraph,paragraphs
parent: parents
parlour: parlour
parma: parma
paroxysm: paroxysm
partaker: partakers
participate: participate
particulars: particulars
partner: partner
party: parties,party
pass: pass,passed,passing
passage: passage,passages
passion: passion,passions
patch: patches
paternoster: paternoster
path: path
paul: paul
pay: paid,pay,paying
payment: payments
peaceful: peaceful
peak: peak
peculiar: peculiar
peculiarity: peculiarities
peculiarly: peculiarly
pelting: pelting
pen: pen
pencil: pencil
penetrate: penetrate,penetrating
peninsula: peninsula
pensive: pensive
perceive: perceive,perceived,perceiving
percy: percy
perforce: perforce
perform: perform,performed,performing
performance: performances
peril: peril
periodic: periodic
permanent: permanent
permission: permission
permit: permitted
persist: persisted
person: people,person,persons
personification: personification
perspiration: perspiration
persuade: persuading
peruse: peruse,perused
philanthropy: philanthropy
philosopher: philosopher
phosphoric: phosphoric
phrase: phrase
physical: physical
physician: physician
piano: piano
picture: picture,pictured,pictures
picturesque: picturesque
piece: piece
pierce: pierce
pilgrim: pilgrims
pillar: pillars
pillow: pillow
pilot: pilot
pine: pine
pinnacle: pinnacle
pistol: pistols
plain: plain
plainly: plainly
plan: plan,plans
plausible: plausible
play: play,playing
plead: plead
pleasantry: pleasantry
pleased: pleased
pleasing: pleasing
pleasure: pleasure,pleasures
pledge: pledge
plinth: plinths
poem: poem,poems
poet: poet,poets
poland: poland
pomp: pomp
poor: poor
pore: pores
port: port
portico: portico
portion: portion,portioned
portrait: portrait
positively: positively
possess: possessed
possession: possession
possessor: possessor
possibility: possibility
post: posted
posterity: posterity
postilion: postilions
posting: posting
posture: posture
pour: pour
power: power,powers
practically: practically
praise: praise
pray: praying
precaution: precaution
precede: preceding
precipice: precipices
preparation: preparation
prepare: prepare,prepared
presence: presence
presentation: presentation
presentiment: presentiment
preservation: preservation
preserve: preserve
press: press,pressed
pretence: pretence
pretend: pretended,pretends
pretext: pretext
pretty: pretty
prevail: prevails
prevalent: prevalent
prevent: prevent,prevented,preventing
previous: previous
prey: prey
principal: principal
print: print,printed
printer: printer
proceed: proceed
processing: processing
procure: procured
produce: produce,produced
production: production
profession: profession
professor: professor
profit: profit,profits
profligate: profligate
profuse: profuse
progress: progress
prohibition: prohibition
project: project
prolong: prolong
prometheus: prometheus
prominently: prominently
promise: promise,promised,promises
promote: promoting
promotion: promotion
proof: proof
proofread: proofread
propensity: propensity
proper: proper
property: property
proposal: proposal
propose: proposed
proprietary: proprietary
protect: protect
protection: protection
protector: protector
prove: prove,proved
provide: provide,providing
providence: providence
provision: provision,provisions
public: public
publish: published
punishment: punishment
punitive: punitive
pupil: pupil
pure: pure
purity: purity
purpose: purpose
purposing: purposing
purser: purser
pursuer: pursuer
pursuit: pursuit
push: pushed
quell: quell
quest: quest
question: question
quilt: quilts
quit: quit
race: race
rack: rack
radiate: radiate
rage: rage,raging
rain: rain
raise: raised,raising
ramble: ramble
rambler: rambler
rank: rank
ransom: ransom
rapid: rapid
rapidity: rapidity
rapidly: rapidly
rash: rash
rattle: rattling
rave: rave
ravings: ravings
ray: ray
reach: reach,reached,reaching
read: read,reading
readable: readable
reader: reader
reading: reading
real: real
reality: realities
realm: realm
rear: rear
reason: reason,reasons
reasonable: reasonable
receipt: receipt
receive: receive,received,receiving
recess: recess
recite: recited
recluse: recluse
recognise: recognised
recognize: recognized
recollection: recollection
reconcile: reconciled
record: records
recount: recount
recover: recovered
recovery: recovery
redistribute: redistribute,redistributing
redistributing: redistributing
redistribution: redistribution
reduce: reduced
refer: referred
reference: references
reflection: reflection
refresh: refresh
refuge: refuge
refund: refund
refuse: refused,refusing
regard: regard
register: registered
regret: regret
regulate: regulating
reign: reigned
rejoice: rejoice
relate: relate,relating
relation: relation
relative: relatives
release: release
relieve: relieve
religion: religion
relinquish: relinquish,relinquished
reluctance: reluctance
remain: remain,remained,remaining
remainder: remainder
remains: remains
remark: remarked,remarking,remarks
remarkable: remarkable
remedy: remedies,remedy
remember: remember,remembered
remembrance: remembrance
remonstrance: remonstrance
remove: remove,removed
rename: renamed
render: rendered
rent: rent
repay: repay
repeat: repeated
repent: repent
repentance: repentance
replace: replace
replacement: replacement
repletion: repletion
reply: replied
report: report,reported,reports
repose: repose
represent: represent,represented
representation: representations
reputation: reputation
request: request,requested
require: require,required
requirement: requirements
resemblance: resemblance
reside: reside,resided,resides
residence: residence
resident: resident
resign: resign
resist: resist
resolve: resolved
resort: resort,resorted
respect: respect,respecting
respects: respects
rest: rest,resting
restriction: restrictions
result: result
resume: resume
retain: retained
retire: retired,retiring
retiring: retiring
return: return,returned,returning,returns
reveal: revealed
revel: revels
revenue: revenue
revere: reveres
reverse: reverse
reward: reward
rhine: rhine
rich: rich
rid: rid
ridicule: ridiculed
rightful: rightful
rise: rise,rising,rose
river: river
roam: roam,roamed
robber: robber,robbers
rock: rock,rocks
rodomontade: rodomontade
roll: rolled
romance: romance,romances
romantic: romantic
rome: rome
romp: romping
roof: roof
root: root
rouse: rouse,roused
rousseau: rousseau
row: row
royalty: royalties,royalty
rub: rubbing
ruin: ruin,ruined,ruins
ruiner: ruiner
ruins: ruins
rule: rules
rush: rush,rushed
russian: russian
sacrifice: sacrifice
safety: safety
sail: sailed,sailing,sails
sake: sake
saloon: saloon
salt: salt
satisfied: satisfied
satisfy: satisfy
save: save,saving
scaffold: scaffold
scandalous: scandalous
scarcely: scarcely
scathe: scathed
scatter: scattered
scene: scene,scenes
schiller: schiller
school: school
scribble: scribbled
scruple: scrupled
sea: sea
seal: seal
seaman: seaman
search: search,searched
seat: seat,seated
secret: secret
secure: secure
sedate: sedate
seduction: seduction
seductive: seductive
seek: seek,seeking,sought
seize: seized,seizing
seldom: seldom
sell: sell
send: send,sending
sensation: sensation
sentence: sentence
separation: separation
serpent: serpent
servant: servant,servants
serve: serve,served
service: service
set: set,sets
severely: severely
sex: sex
shade: shade
shake: shakes
shakespeare: shakespeare
shape: shaped
share: share,shared,sharing
sharer: sharer
sharp: sharper
shear: shorn
sheath: sheath
shelly: shelly
shelter: shelter,sheltering
shewn: shewn
shine: shines
ship: ships
shiver: shivering
shock: shock
shore: shore,shores
short: short
shot: shot
shoulder: shoulder
shout: shouts
shriek: shrieks
shrink: shrink
shroud: shroud
shudder: shudder,shuddered
shun: shun
shut: shut
siege: sieges
sight: sight
sign: sign,signs
silence: silence
silent: silent
silk: silk
simply: simply
simultaneously: simultaneously
sinfulness: sinfulness
single: single
singular: singular
singularity: singularities
singularly: singularly
sink: sank,sink,sunk
sire: sire
sister: sister,sisters
sit: sat,sitting
situation: situation
sketch: sketching
skill: skill
skin: skin,skins
sky: skies,sky
slander: slandered
slaughter: slaughter
slave: slaves
sleep: sleep
sleepy: sleepy
slight: slight
slip: slips
slumber: slumber
smile: smile
smoking: smoking
smooth: smooth
smyrna: smyrna
snatch: snatch,snatched
sneer: sneers
snuffing: snuffing
society: society
socket: sockets
sofa: sofa
soil: soil
solely: solely
solemnize: solemnized
solicit: solicit
solicitation: solicitation
solitary: solitary
solitude: solitude
soot: soot
sooth: sooth
soothing: soothing
sorrow: sorrows
sort: sort
soul: soul,souls
sound: sound,sounded,sounds
southern: southern
spacious: spacious
spare: spare
spark: spark
sparkle: sparkled
sparkling: sparkling
speak: speak,speaking,spoke
special: special
specific: specific
speck: specks
spectre: spectre
speechless: speechless
speed: speed
speedily: speedily
spend: spend,spent
sphere: sphere
spirit: spirit
spite: spite
splendour: splendour
spot: spot,spots
spread: spread
spring: sprang,spring
staff: staff
stage: stage,stages
stain: stain,stained
staircase: staircase
stake: stake
stalk: stalking
stamp: stamp
stand: stand,standing,stood
start: start,started
startle: startled
startled: startled
statement: statement,statements
stationers: stationers
status: status
steal: stole
stem: stem
step: step,steps
stifle: stifled,stifling
stillness: stillness
stone: stone
store: stored
storm: storm,storms
story: stories,story
stranger: strangers
straw: straw
stray: strays
stream: stream,streaming
streamlet: streamlet
street: street
strength: strength
stretch: stretched
strict: strict
strike: strike,struck
striking: striking
strive: striving
strong: strong
struck: struck
struggle: struggled
stud: studding
study: study,studying
stuff: stuffed
style: style
subaltern: subalterns
subdue: subdued
subject: subject,subjects
subscribe: subscribe
succeed: succeed,succeeded
success: success
suck: suck,sucked,sucks
sucker: suckers
sudden: sudden
suddenly: suddenly
suffering: sufferings
suffice: suffice
sufficient: sufficient
suited: suited
sullen: sullen
sully: sully
sum: sum
summit: summit,summits
sun: sun
sundays: sundays
superhuman: superhuman
superior: superior
supernatural: supernatural
superstition: superstition
superstitious: superstitious
supply: supply
support: support
suppose: suppose,supposed
supposition: supposition
suppress: suppressed
surprise: surprise,surprised
surprised: surprised
surprize: surprized
surrender: surrendered
surround: surrounded
survive: survive,survived
suspicion: suspicion,suspicions
suspicious: suspicious
swamp: swamp
swear: swear,swore
sweep: swept
swift: swift,swifter
swiftly: swiftly
sylph: sylph
sympathise: sympathise
sympathy: sympathy
symptom: symptoms
synonymous: synonymous
table: table,tables
tablet: tablet
tacit: tacit
tact: tact
tale: tale,tales
talent: talents
talk: talking
tallow: tallow
task: task
taste: taste
tax: tax,taxes
teach: taught
tear: tear,tears,torn
tempest: tempest
temple: temple
tend: tend,tended,tending
tender: tender
tenderness: tenderness
term: term,termed,terms
terminate: terminates
terrible: terrible
terrify: terrified
territory: territory
terror: terror
testament: testaments
testimony: testimony
thatch: thatch
thee: thee
thine: thine
thirst: thirst
thither: thither
tho: tho
thoughtless: thoughtless
thoughtlessness: thoughtlessness
thro: thro
throat: throat
throw: threw,throw,thrown
thunder: thunder,thunders
thwart: thwarted
thy: thy
tideless: tideless
tie: ties
time: time,times
tinge: tinge
tint: tint,tints
title: title
toil: toils
toilette: toilette
tomb: tomb
ton: ton
tongue: tongue
tooth: teeth,tooth
torch: torches
torment: tormented,tormenting
torrent: torrent
touch: touch,touched
tour: tour
town: town,towns
trace: trace,tracing
track: track
trademark: trademark
trader: trader
traditional: traditional
traditionary: traditionary
trait: traits
trample: trampled
transcribe: transcribe
transcription: transcription
travel: travel,travelled,travelling
travels: travels
tread: tread,trod
treatment: treatment
tree: trees
tremendous: tremendous
tress: tresses
tribunal: tribunal
trickle: trickling
trip: tripped
trouble: trouble
true: true
trust: trust,trusting
truth: truth
turkey: turkey
turkish: turkish
twilight: twilight
type: type,types
unaccountable: unaccountable
unaffected: unaffected
unanimously: unanimously
unappalled: unappalled
unattended: unattended
unavailing: unavailing
unbroken: unbroken
unchanging: unchanging
uncivil: uncivil
unclose: unclosed
unconscious: unconscious
unconsciously: unconsciously
uncover: uncovering
understand: understand,understood
undertake: undertaken
underwood: underwood
uneasy: uneasy
uneducated: uneducated
unenforceability: unenforceability
unfeeling: unfeeling
unhallowed: unhallowed
unheeded: unheeded
uniform: uniform
uninteresting: uninteresting
united: united
universal: universal
unknown: unknown
unlink: unlink
unmarried: unmarried
unnoticed: unnoticed
unperceived: unperceived
unpublished: unpublished
unresisting: unresisting
unshadow: unshadowed
unsolicited: unsolicited
unsuccessful: unsuccessful
unsullied: unsullied
update: updated
urge: urged,urging
user: user
usual: usual
ut: ut
utter: utter,uttered
vacancy: vacancy
vagabond: vagabond
vain: vain
vainly: vainly
vampyre: vampyre
vanilla: vanilla
vanity: vanity
variation: variation
variety: variety
vary: varying
vegetable: vegetables
vein: vein,veins
vent: vent
venus: venus
veracious: veracious
version: version
vessel: vessel,vessels
vest: vesting
vibrate: vibrate
vice: vice,vices
vicious: vicious
victim: victim,victims
view: view,viewed,viewing
vigilance: vigilance
villa: villa
vineyard: vineyards
violate: violates
violence: violence
violent: violent
violet: violet
virtue: virtue,virtues
virtuous: virtuous
virus: virus
visible: visible
vision: vision,visions
visit: visit,visited,visits
visitation: visitations
visitor: visitors
vista: vista
vital: vital
voice: voice
void: void
voltaire: voltaire
volume: volumes
volunteer: volunteer,volunteers
voluptuary: voluptuary
voyage: voyage
waft: wafted
wage: wage
wait: waiting
wake: waking
walk: walking,walks
wall: walls
wallow: wallow
wander: wandered,wandering
wanderings: wanderings
war: war
warm: warm,warmer
warmth: warmth
warranty: warranties,warranty
watch: watch,watched,watching
water: waters
watering: watering
wave: wave,waves
wax: wax
weak: weak
weaken: weakened
weakness: weakness
wealth: wealth
weapon: weapon,weapons
wear: worn
weary: weary
weave: weaving
week: week
weigh: weighed
weight: weight
west: west
wet: wet
whatsoever: whatsoever
wherewith: wherewith
whet: whetted
whisper: whisper,whispered
whistle: whistling
wide: wide,widest
wife: wife
wild: wild
william: william
win: win,winning
wind: wind
winding: windings
window: windows
wine: wine,wines
winter: winter
wither: withered
witness: witnessed
woman: woman,women
wonderful: wonderful
wonted: wonted
wood: wood,woods
wooden: wooden
word: word
workings: workings
worthy: worthy
wound: wounded
wounded: wounded
wrap: wrap
wretch: wretch
write: write,writing,written,wrote
writing: writing
yellow: yellow
youth: youth
youthful: youthful
