aback: aback
abaft: abaft
abandon: abandon,abandoned,abandoning
abashed: abashed
abate: abate,abated
abduct: abduct,abducted
abduction: abduction
abductor: abductor
abed: abed
abhor: abhor
abide: abide,abides
ability: ability
abjure: abjure
aboard: aboard
abode: abode
abolish: abolish
abreast: abreast
abruptly: abruptly
absence: absence
absent: absent
absolute: absolute
absolutely: absolutely
absorb: absorbed
abstract: abstract
abstraction: abstraction,abstractions
abundantly: abundantly
abuse: abuse,abused,abusing
accede: accede
accent: accent,accents
accentuate: accentuated
accept: accept,accepted,accepting
access: access,accessed
accessible: accessible
accident: accident,accidents
accidental: accidental
acclaim: acclaim
acclamation: acclamation
accolade: accolade
accompaniment: accompaniment
accompany: accompanied,accompany
accomplish: accomplish,accomplished
accord: accords
account: account,accounted,accounting,accounts
accurse: accursed
accusation: accusation
accuse: accuse,accused,accusing
accuser: accuser
accustomed: accustomed
ache: ache,aches,aching
achieve: achieved,achieving
acknowledge: acknowledge,acknowledged
acknowledgment: acknowledgment
acolyte: acolytes
acquaint: acquainted
acquaintance: acquaintance
acquiescence: acquiescence
acquire: acquire,acquired,acquiring
acquit: acquit
action: action,actions
active: active
actual: actual
acute: acute
add: add,adds
addict: addicted
addition: addition,additions
additional: additional
address: address,addressed,addresses,addressing
adequately: adequately
adjusting: adjusting
administer: administered
admirably: admirably
admiral: admiral
admiration: admiration
admire: admired,admiring
admission: admission
admit: admit,admits,admitted,admitting
admittance: admittance
admonish: admonished
admonition: admonition
adopt: adopt
adoption: adoption
adoration: adoration
adorn: adorned
adornment: adornment
advance: advance,advanced,advancing
advanced: advanced
advancement: advancement
advantage: advantage,advantages
advantageous: advantageous
advantageously: advantageously
advent: advent
adventure: adventure
adventurer: adventurer,adventurers
adventurous: adventurous
adverse: adverse
adversity: adversity
advertise: advertised
advice: advice
advise: advise,advised
advocate: advocate
affair: affair,affairs
affect: affect
affectation: affectation
affection: affection,affections
affectionately: affectionately
affianced: affianced
afflict: afflicted
afford: afford,afforded,affording
affront: affront,affronted
aflame: aflame
afoot: afoot
afore: afore
afraid: afraid
afresh: afresh
africa: africa
african: african
aft: aft
afternoon: afternoon
agate: agate,agates
age: age,ages
aged: aged
ageing: ageing
agent: agent
agglomeration: agglomeration
aggression: aggression
aghast: aghast
agile: agile
agitated: agitated
agitation: agitation,agitations
agleam: agleam
agonizingly: agonizingly
agony: agony
agree: agree,agreed
agreement: agreement
aid: aid,aided
ail: ails
ailment: ailment
aim: aim,aimed,aims
air: air
airy: airy
akimbo: akimbo
akin: akin
alacrity: alacrity
alarm: alarm
alarmed: alarmed
alas: alas
ale: ale
alee: alee
alehouse: alehouse
alert: alert
algerine: algerine
algerines: algerines
algiers: algiers
alight: alight,alighted
alike: alike
alive: alive
allah: allah
allay: allay,allayed
allege: alleged
allegiance: allegiance
alliance: alliance
allot: allotted
allowance: allowance
allude: alluded
allusion: allusion
ally: allied,ally
alms: alms
aloft: aloft
aloofness: aloofness
aloud: aloud
alter: altered
alteration: alteration
altercation: altercation
alternate: alternate
alternative: alternative
altogether: altogether
altruistic: altruistic
amain: amain
amassing: amassing
amazed: amazed
amazement: amazement
amazing: amazing
ambassador: ambassador
amber: amber
ambition: ambitions
amble: amble
ambush: ambush
ameen: ameen
amend: amend,amended,amends
amidship: amidships
amiss: amiss
amity: amity
amorous: amorous
amphora: amphora
ample: ample
amplify: amplify
amuse: amused
amused: amused
amusement: amusement
analogy: analogies
anatomical: anatomical
anchor: anchor,anchored
anchorage: anchorage
anchorite: anchorite
ancient: ancient,ancients
andalusian: andalusian
andrea: andrea
andrew: andrew
anew: anew
angel: angels
angelic: angelic
anger: anger,angered
angle: angle
angrily: angrily
angry: angry
anguish: anguish,anguished
ankle: ankle
anklet: anklet
anne: anne
announcement: announcement
anomalous: anomalous
anon: anon
answer: answer,answered,answering
answerable: answerable
anta: anta
antagonist: antagonist
anthony: anthony
anticipate: anticipated
anticipation: anticipation
anxiety: anxieties,anxiety
anxious: anxious
apathy: apathy
ape: ape
apostasy: apostasy
apostrophize: apostrophizing
appal: appalled
appalled: appalled
appallingly: appallingly
apparel: apparel
apparent: apparent
appeal: appeal,appealed,appealing
appealingly: appealingly
appearance: appearance,appearances
appellation: appellation
append: appends
appetite: appetite
appetizing: appetizing
applause: applause
apple: apple,apples
applicable: applicable
apply: applied,applies,apply
appoint: appoint,appointed
appointment: appointment
appraisingly: appraisingly
apprehend: apprehend
apprehension: apprehension,apprehensions
apprentice: apprentice
approach: approach,approached,approaches,approaching
appropriation: appropriation
approval: approval
approve: approve,approved,approves
approvingly: approvingly
apricot: apricots
aproned: aproned
apt: apt
aptly: aptly
aquila: aquila
aquiver: aquiver
arab: arab,arabs
arabesque: arabesques
arabian: arabian
arabic: arabic
arable: arable
arch: arched
arched: arched
archer: archers
archery: archery
archive: archive,archives
archway: archway,archways
ardent: ardent
ardently: ardently
ardour: ardour
argent: argent
argosy: argosy
argue: argue
argument: argument,arguments
aright: aright
arm: arm,armed,arming,arms
armada: armada
armament: armament,armaments
armed: armed
armour: armour
armoured: armoured
aromatic: aromatic
arouse: arouse,aroused
array: array,arrayed
arrest: arrest,arrested
arrive: arrive,arrived,arrives
arrogance: arrogance
arrogant: arrogant
arrow: arrow,arrows
arsenal: arsenal
art: art,arts
artist: artist
artistic: artistic
ascendancy: ascendancy
ascertain: ascertain
ascii: ascii
ash: ashes
ashamed: ashamed
ashen: ashen
ashore: ashore
asleep: asleep
aspect: aspect
asper: asper
asperser: aspersers
assail: assailed
assailant: assailant
assemble: assemble,assembled
assembly: assembly
assertion: assertion
assiduous: assiduous
assist: assist,assisted
assistance: assistance
assistant: assistants
associate: associate
assorted: assorted
assume: assume,assumed
assumption: assumption
assurance: assurance
assure: assure,assured,assures
assuredly: assuredly
astern: astern
astir: astir
astonishingly: astonishingly
astonishment: astonishment
astounding: astounding
astray: astray
astride: astride
athwart: athwart
atlantic: atlantic
atlas: atlas
atone: atone,atoned
atop: atop
attach: attached
attack: attack,attacked,attacking
attain: attain
attempt: attempt,attempted,attempting,attempts
attend: attend,attended,attending
attendance: attendance
attendant: attendant,attendants
attention: attention
attentively: attentively
attest: attested
attitude: attitude,attitudes
attract: attracted
attribute: attributed
auburn: auburn
audacity: audacity
audience: audience
aught: aught
author: author
authority: authorities,authority
authorship: authorship
auto: auto
autumn: autumn
avail: avail,availed
avarice: avarice
avenge: avenge,avenging
averse: averse
avert: averted
avidly: avidly
avoid: avoid,avoided,avoiding
avoidance: avoidance
avow: avowing
avowal: avowal
await: await,awaited,awaiting,awaits
awake: awake,awoke
awaken: awaken,awakened
aware: aware
awe: awe
awhile: awhile
awkward: awkward
awning: awning
awry: awry
axe: axe
ay: ay
aye: aye
azure: azure
bab: bab
babble: babble,babbled,babbling
babbling: babblings
babe: babe
background: background
bad: bad,worse,worst
bade: bade
baffle: baffled
bag: bag
bagnio: bagnio
bah: bah
bai: bai
bait: bait
baked: baked
balance: balance,balanced,balancing
balanced: balanced
balcony: balcony
bale: bale,bales
balearic: balearic
baleful: baleful
ballad: ballad
balloon: ballooned
baltimore: baltimore
balustrade: balustrade,balustrades
bandage: bandage
bandaging: bandaging
bang: banged
banish: banished
banishment: banishment
bank: bank
banner: banner
baptism: baptism
bar: barred
barbados: barbados
barbarous: barbarous
barbary: barbary
bare: bare,bared
barely: barely
bargain: bargain,bargains
bark: barked
barrel: barrel,barrels
barren: barren
barrier: barrier
bartering: bartering
base: base,based
basely: basely
baseness: baseness
basin: basin
basis: basis
basket: basket
bastard: bastard
bath: bathed
battle: battle,battling
bawl: bawled,bawling
bay: bay
bea: bea
beach: beach
bear: bear,bearing,bears,bore,born,borne
beard: beard
bearded: bearded
beardless: beardless
beardlessness: beardlessness
bearer: bearer
bearing: bearing
beast: beast
beat: beat,beaten,beating
beautiful: beautiful
beauty: beauty
becalmed: becalmed
beckon: beckon,beckoned
becomingly: becomingly
bed: bed
bedew: bedewed
bedouin: bedouin
bedraggled: bedraggled
bee: bees
beetle: beetling
befall: befall,befallen,befalls,befell
befriend: befriended
beg: beg,begged,begging
beget: begat,begot,begotten
beggar: beggar,beggars
begot: begot
begotten: begotten
beguile: beguile
behalf: behalf
behave: behaving
behaviour: behaviour
beheld: beheld
behold: beheld,behold,beholding
belated: belated
belch: belched
belief: belief,beliefs
believer: believer,believers
belike: belike
bell: bell,bells
bellow: bellow,bellowed,bellowing,bellows
belly: belly,bellying
belong: belong,belonged,belonging,belongs
beloved: beloved
bemused: bemused
ben: ben
bench: bench,benches
bend: bend,bent
beneath: beneath
benediction: benedictions
benefit: benefit,benefits
benign: benign
benignity: benignity
bent: bent
berbers: berbers
bereft: bereft
beribbon: beribboned
beribboned: beribboned
beseech: beseech,beseeching,besought
beset: beset
bestow: bestow,bestowed
bestowal: bestowal
bethink: bethink,bethought
betide: betide
betime: betimes
betray: betray,betrayed
betrayal: betrayal
betroth: betrothed
betrothal: betrothal
betwixt: betwixt
bewail: bewail
bewilder: bewildered
bewilderment: bewilderment
bewitch: bewitched
bewitched: bewitched
bias: bias
bid: bade,bid,bidden,bidding,bids
bidding: bidding,biddings
bide: bides
bigness: bigness
bigotry: bigotry
bilbo: bilbo
bilge: bilge
bilging: bilging
binary: binary
bind: bind,binding,binds,bound
bird: bird
birth: birth
birthright: birthright
biscuit: biscuit,biscuits
bismillah: bismillah
bit: bit
bite: biting
bitter: bitter,bitterest
bitterly: bitterly
bitterness: bitterness
black: black,blacks
blackamoor: blackamoors
blacken: blacken
blackness: blackness
bladder: bladder
blade: blade
bladed: bladed
blair: blair
blame: blame
blanch: blanched
blank: blank
blare: blared
blaspheme: blaspheme
blasphemer: blasphemer
blasphemous: blasphemous
blast: blast,blasts
blaze: blaze,blazed,blazing
blazon: blazon
bleat: bleat,bleated,bleats
bleed: bleeding
bleeding: bleeding
blench: blench,blenching
blend: blending
blended: blended
blent: blent
bless: bless,blessed
blessed: blessed
blessing: blessing,blessings
blight: blight
blighting: blighting
blind: blind,blinded,blinds
blindness: blindness
blink: blinked
blister: blistered
blithely: blithely
blizzard: blizzard
blood: blood
bloodshed: bloodshed
bloodshot: bloodshot
bloodstain: bloodstains
bloodthirsty: bloodthirsty
bloody: bloody
blossom: blossoms
blot: blot
blow: blew,blow,blowing,blown,blows
blue: blue
bluebeard: bluebeard
blunder: blundering
blunt: blunt
bluntly: bluntly
blurred: blurred
bluster: bluster,blustering
board: board
boarder: boarders
boarding: boarding
boast: boast,boasted,boasting
boaster: boaster,boasters
boastfulness: boastfulness
boat: boat,boats
boatswain: boatswain,boatswains
bodice: bodice
bodied: bodied
body: bodies,body
bodyguard: bodyguard
boggle: boggle
boil: boil,boiled
bold: bold
boldly: boldly
boldness: boldness
bolt: bolt,bolts
bomb: bomb
bond: bond,bonds
bondage: bondage
bone: bones
bonnet: bonnet
book: book
boom: boom,boomed
boon: boon
boorish: boorish
boot: boot,booted,boots
booth: booths
booty: booty
borak: borak
border: bordering
bosom: bosom
bottle: bottle
bound: bound,bounding,bounds
bounty: bounty
bow: bow,bowed,bowing,bows
bower: bower
bowl: bowl
bowman: bowmen
box: box
boxwood: boxwood
boy: boy
brace: brace,braced,braces,bracing
bracelet: bracelets
braggart: braggart
brain: brain,braining
bramble: bramble
branch: branch
brand: brand,branded
brandish: brandishing
brandy: brandy
brass: brass
brave: brave,braved,bravest
brawl: brawl
brawn: brawn
brawny: brawny
brazenly: brazenly
brazier: brazier
breach: breach
bread: bread
break: break,breaking,broke,broken
breakfast: breakfast
breakneck: breakneck
breast: breast,breasts
breath: breath
breathe: breathe,breathed,breathing
breathing: breathing
breathless: breathless
breathlessly: breathlessly
breeches: breeches
breed: bred
breeze: breeze
brethren: brethren
brew: brewed
bribe: bribed
brick: brick
bridal: bridal
bride: bride
bridge: bridge,bridged
bridle: bridle
bright: bright
brighten: brightened,brightening
brightly: brightly
brightness: brightness
brilliance: brilliance
brilliant: brilliant
brilliantly: brilliantly
brim: brimmed
bring: bring,bringing,brings,brought
briskly: briskly
broach: broached,broaching
broad: broad,broader
broadside: broadside
broil: broiled
broke: broke
broken: broken
brokenly: brokenly
brood: brood,brooding
brooding: brooding
brook: brook
broom: broom
brother: brother,brothers
brotherly: brotherly
brow: brow,brows
brown: brown
browsing: browsing
bruise: bruised
brush: brush,brushed
brusque: brusque
brutal: brutal
brutality: brutality
bubble: bubble
buck: bucks
buckler: buckler
build: build,building,built
building: building
bulge: bulging
bulk: bulk
bull: bull
bullock: bullock
bullrush: bullrushes
bulwark: bulwark,bulwarks
bumper: bumper
bunch: bunches
buoy: buoyed
buoyant: buoyant
burden: burden,burdened,burdening,burdens
burn: burn,burned,burning,burnt
burning: burning
burnish: burnished,burnishing
burst: burst,bursting
bury: buried,bury
bush: bush
bushy: bushy
business: business
bustle: bustle
butcher: butcher,butchered
butt: butt
buttress: buttress,buttresses
buyer: buyer,buyers
cabin: cabin
cable: cable
cactus: cactus
caftan: caftan,caftans
cajolery: cajolery
calculate: calculate,calculated,calculating
calf: calves
calico: calico
caliphate: caliphate
calling: calling
callous: callous
callously: callously
callow: callow
calm: calm
calmly: calmly
calumniator: calumniator
calumny: calumnies,calumny
camel: camel,camels
canary: canary
candle: candle
cane: cane,caned
cannon: cannon
canst: canst
canvas: canvas
cap: cap,caps
capable: capable
caparison: caparisoned
cape: cape
capital: capital
capitan: capitan
capitana: capitana
capon: capon
captain: captain,captains
captaincy: captaincy
captive: captive,captives
captivity: captivity
capture: capture,captured
capturing: capturing
carack: carack
caravel: caravels
card: card
care: care,cared
career: career
careful: careful
carefully: carefully
careless: careless
carelessly: carelessly
caress: caress
cargo: cargo
carouse: carousing
carpet: carpet,carpets
carriage: carriage
carrick: carrick
carrier: carriers
carrion: carrion
carronade: carronade
carry: carried,carries,carry,carrying
carve: carved
casque: casque
cast: cast,casting
caste: castes
castellated: castellated
castilian: castilian
casting: casting
castle: castle,castles
cat: cat
catch: catch,caught
catholic: catholic
catholics: catholics
caution: caution
cautious: cautious
cave: caves
cease: cease,ceased
ceaseless: ceaseless
ceiling: ceiling
celibacy: celibacy
century: century
ceremoniously: ceremoniously
ceremony: ceremony
certainty: certainty
chafe: chafed,chafing
chagrin: chagrin
chain: chain,chained,chains
chair: chair,chairs
challenge: challenge,challenged
challenger: challenger
chamber: chamber
chamberlain: chamberlain
champion: champion
chance: chance,chanced,chances,chancing
change: change,changed,changing
changed: changed
channel: channel
chant: chant,chanted,chanting
chapter: chapter
character: character,characters
characteristic: characteristic
charge: charge,charged,charges
charitable: charitable
charity: charities,charity
charm: charm,charms
charming: charming
charybdis: charybdis
chase: chase
chaste: chaste
chasten: chastening
chastening: chastening
chattel: chattel
chatter: chatter,chattered,chattering
cheap: cheap
cheat: cheat,cheated
check: check,checked,checks
cheek: cheek,cheeks
cheer: cheered
cheerfully: cheerfully
cherish: cherish,cherished
chest: chest,chests
chicken: chicken
chief: chief
chiefly: chiefly
child: child,children
childish: childish
chill: chill
chilled: chilled
chilling: chilling
chime: chimed
chimney: chimneys
chin: chin
chink: chink
chisel: chisel,chisels
chivalry: chivalry
choice: choice
choke: choke,choked,choking
choose: choose,choosing,chose,chosen
chord: chord
chorus: chorus
christendom: christendom
christian: christian,christians
christianity: christianity
christmas: christmas
chronicle: chronicle,chronicles
chronicler: chronicler
chuckle: chuckle,chuckled
church: church
circle: circled
circuit: circuit
circumlocution: circumlocution
circumstance: circumstance,circumstances
cite: cite,cited
citizen: citizen
city: city
claim: claim,claimed,claims
clamber: clambered,clambering
clamorous: clamorous
clamour: clamour,clamoured,clamouring,clamours
clamouring: clamouring
clang: clang
clank: clank,clanked
clapper: clapper
clapping: clapping
claret: claret
clarify: clarified
clasp: clasp,clasping
clasped: clasped
class: class
clatter: clatter,clattered
claw: claw,clawed,clawing,claws
clay: clay
clean: clean
cleanse: cleanse,cleansed
clemency: clemency
clench: clench,clenched
clenched: clenched
clerical: clerical
cliff: cliff,cliffs
climax: climax
climb: climbed
cling: clinging,clings,clung
cloak: cloak,cloaks
clock: clock
cloister: cloisters
cloistered: cloistered
close: close,closed,closer,closest,closing
closely: closely
closet: closeted
closing: closing
clot: clot,clots
cloth: cloth,cloths
clothe: clad
clothes: clothes
cloud: cloud,clouded,clouds
clouded: clouded
cloudless: cloudless
cloudy: cloudy
clue: clue
clump: clumps
clumsily: clumsily
clumsy: clumsy
clustering: clustering
clutch: clutch,clutched
coarse: coarse
coast: coast
coastline: coastline
coat: coat
coax: coax
cobalt: cobalt
cock: cock
cockpit: cockpit
code: codes
coffer: coffer
coil: coil,coiled
coin: coin
cold: cold
coldly: coldly
coldness: coldness
collapse: collapse,collapsed
collapsing: collapsing
collection: collection
colossal: colossal
colour: colour,coloured,colours
coloured: coloured
comb: combing
combat: combat
combatant: combatants
combination: combination
combine: combined
comedy: comedy
comely: comely
comfort: comfort,comforted
comfortable: comfortable
comforting: comforting
coming: coming
command: command,commanded,commanding,commands
commander: commander
commendation: commendation
comment: comment,commented
commerce: commerce
commercial: commercial
commission: commission
commit: committed
common: common
commonly: commonly
commonplace: commonplaces
commotion: commotion
commune: communing
communicate: communicate
communication: communication
companion: companion,companions
companionship: companionship
company: company
comparative: comparative
compare: compare,compared,comparing
comparison: comparison
compartment: compartments
compassion: compassion
compassionate: compassionate
compel: compel,compelled
compelling: compelling
compensation: compensation,compensations
competitor: competitor,competitors
compilation: compilation
complain: complained
complaint: complaint
complete: complete,completed,completest
completely: completely
complexion: complexion
compliance: compliance
compliment: compliment
comply: complied,comply,complying
compose: compose,composed
composedly: composedly
composure: composure
compounded: compounded
compress: compressed
compulsion: compulsion
compunction: compunction
comrade: comrades
comradeship: comradeship
conceal: conceal,concealed
concealment: concealment
conceivable: conceivable
conceive: conceive,conceived,conceives,conceiving
concentrate: concentrated
concentrated: concentrated
concept: concept
conception: conception
concern: concern,concerned,concerns
concerned: concerned
concernedly: concernedly
concerted: concerted
conciliation: conciliation
conciliatory: conciliatory
conclude: conclude,concluded
conclusion: conclusion,conclusions
concurrence: concurrence
condemn: condemn,condemned
condemnation: condemnation
condition: condition,conditions
condone: condone,condoned
conduce: conduce
conduct: conduct,conducted
confess: confess,confessed,confesses
confession: confession
confidence: confidence,confidences
confident: confident
confidential: confidential
confidently: confidently
confine: confine,confined
confinement: confinement
confirm: confirm,confirmed
confirmation: confirmation
confiscation: confiscations
conflict: conflict,conflicting
conform: conform
confound: confound
confront: confront,confronted
confuse: confused
confused: confused
confusion: confusion
congenital: congenital
congratulate: congratulated
congratulation: congratulation
congregation: congregation
conjecture: conjectured
conjointly: conjointly
conjure: conjure
connect: connected,connecting
conquer: conquer,conquered
conqueror: conqueror
conscience: conscience
conscious: conscious
consciousness: consciousness
consent: consent,consented,consenting
consequence: consequence,consequences
consequential: consequential
considerable: considerable
considerate: considerate
consideration: consideration,considerations
consign: consigned
consolation: consolation
console: console,consoled
consort: consort
conspicuity: conspicuity
conspirator: conspirator
constable: constable
constancy: constancy
constant: constant
consternation: consternation
constitute: constitute
constitution: constitution
constrain: constrained
construction: construction
consult: consulting
consume: consumed,consuming
contact: contact
contemplate: contemplate,contemplating
contemplation: contemplation
contemporary: contemporaries
contempt: contempt
contemptible: contemptible
contemptuous: contemptuous
contemptuously: contemptuously
content: content
contents: contents
contest: contested,contesting
contiguity: contiguity
contiguous: contiguous
contingency: contingency
contingent: contingent
continue: continue,continued
contract: contract,contracted
contrary: contrary
contrast: contrast
contribute: contributed
contribution: contributions
contributor: contributor
contritely: contritely
contrition: contrition
contrivance: contrivances
contrive: contrive,contriving
contrived: contrived
contriving: contriving
control: control,controlled,controlling
convenience: convenience
conveniently: conveniently
conversation: conversation
conversely: conversely
conversion: conversion
convert: convert,converted,converting,converts
convey: convey,conveyed,conveys
conviction: conviction,convictions
convince: convince,convinced
convincingly: convincingly
convulsive: convulsive
cooing: cooing
cook: cooked
cool: cool,cooling,cools
cooling: cooling
coolly: coolly
copper: copper
coppery: coppery
copying: copying
copyright: copyright
cord: cord,cords
cork: cork
corner: corner,corners
cornish: cornish
cornishman: cornishman
cornwall: cornwall
corporation: corporation
correct: correct,corrected,correcting
correction: correction
corrupt: corrupt
corsair: corsair,corsairs
corselet: corselet
cost: cost,costs
costly: costly
cottage: cottages
couch: couch
cough: cough,coughing
counsel: counsel,counselled,counsels
counsellor: counsellors
count: count,counted,counting,counts
countenance: countenance,countenances
counter: countered
country: countries,country
countryman: countrymen
countryside: countryside
couple: couple
courage: courage
court: court,courting,courts
courteous: courteous
courtesy: courtesy
courtier: courtier
courtship: courtship
courtyard: courtyard
cousin: cousin
cove: cove,coves
cover: cover,covered
coverlet: coverlet
covet: covet
coveted: coveted
cow: cowed
coward: coward
cowardice: cowardice
cowardly: cowardly
cower: cowered,cowering
cowl: cowl,cowls
cowled: cowled
cozen: cozen
crab: crabbed
crack: crack,cracking
crackle: crackled
craft: craft
craftily: craftily
crafty: craftier,crafty
cramped: cramped
crane: craned
crash: crash,crashed,crashing
craven: craven
craving: craving
crawl: crawled,crawling
creak: creak,creaked
create: create,created,creating
creation: creation
creature: creature,creatures
credit: credit
creed: creed
creep: creep,creeping,creeps,crept
creeper: creepers
crenel: crenels
crescent: crescent
cresset: cressets
crest: crest,crests
crestfallen: crestfallen
crew: crew
crime: crime,crimes
crimson: crimson
cringe: cringe
cripple: cripples
crisp: crisp
crisscross: crisscross
critical: critical
critically: critically
criticism: criticism,criticisms
croak: croak,croaked,croaking
cromwell: cromwell
crone: crone
crooked: crooked
crop: crop
cross: cross,crossed
crossbowmen: crossbowmen
crosstree: crosstree,crosstrees
crouch: crouched,crouching
crow: crowed,crows
crowd: crowd,crowded,crowding
crowded: crowded
crown: crowned
crowning: crowning
crucial: crucial
crucifix: crucifix
crude: crude
cruel: cruel
cruelly: cruelly
cruelty: cruelty
cruise: cruise
crumble: crumbling
crumple: crumpled
crunch: crunched
crush: crush,crushed,crushing
crushed: crushed
cryptic: cryptic
crystal: crystal
cub: cub
cube: cubes
cull: cull,culled
culminate: culminating
culverin: culverin,culverins
cumbrously: cumbrously
cunning: cunning
cunningly: cunningly
cup: cup,cupping
cupboard: cupboard
cupid: cupid
cupidity: cupidity
cur: cur
curb: curb
curfew: curfew
curiosity: curiosity
curious: curious
curiously: curiously
curl: curled,curling
curly: curly
curmudgeon: curmudgeon
current: current
curse: curse,cursed,curses,cursing
cursed: cursed
curt: curt
curtail: curtailed
curtailment: curtailment
curtain: curtain,curtained,curtains
curtained: curtained
curtly: curtly
curved: curved
cushion: cushions
custom: custom
customary: customary
cut: cut,cutting
cutlass: cutlasses
cutlery: cutlery
cynical: cynical
cypress: cypress
dagger: dagger,daggers
daily: daily
daintily: daintily
dam: dam
damage: damage,damaged
damaged: damaged
damages: damages
damn: damn
damnable: damnable
damnably: damnably
damnation: damnation
damned: damned
damp: damp
dan: dan
dance: dance
danger: danger,dangers
dangerous: dangerous
dangle: dangled,dangling
daring: daring
dark: dark,darker,darkest
darken: darkened
darkly: darkly
darkness: darkness
dart: darted
dash: dash,dashed
dastard: dastard
dastardly: dastardly
datum: data
daughter: daughter,daughters
daunted: daunted
dauntless: dauntless
dauntlessness: dauntlessness
david: david
dawn: dawn
day: day,days
daze: dazed
dazzle: dazzle,dazzling
dazzling: dazzling
dead: dead
deadly: deadly
deaf: deaf
deafening: deafening
deal: deal,deals,dealt
dealer: dealer,dealers
dealings: dealings
dearly: dearly
death: death
deathly: deathly
debauched: debauched
debauching: debauching
debility: debility
debt: debt,debts
decay: decaying
decaying: decaying
decease: decease,deceased
deceased: deceased
deceit: deceit
deceive: deceive,deceived
deceiver: deceiver
december: december
decency: decency
decently: decently
decide: decide,decided
decision: decision,decisions
deck: deck,decked,decks
declaration: declaration
declare: declare,declared,declares
decorate: decorated
decree: decree
deductible: deductible
deed: deed,deeds
deem: deem,deemed,deeming
deep: deep,deepest
deepen: deepening
deeply: deeply
deer: deer
defame: defamed
defeat: defeat,defeated
defect: defect,defects
defective: defective
defence: defence,defences
defend: defend,defended,defends
defender: defender
deference: deference
defiance: defiance
defiant: defiant
defiantly: defiantly
defile: defile,defiled
define: define,defined
definite: definite
deflower: deflowered
defraud: defrauded
defy: defied,defy
degree: degree
deign: deigning
dejected: dejected
dejection: dejection
delay: delay,delayed,delaying
deletion: deletions
deliberate: deliberate
deliberately: deliberately
delicate: delicate
delight: delight
deliriously: deliriously
deliver: deliver,delivered,delivering
deliverance: deliverance
delivery: delivery
delude: delude,deluded
demand: demand,demanded,demanding,demands
demarcation: demarcation
demeanour: demeanour
demesne: demesne
denial: denial
denomination: denominations
denounce: denouncing
dense: dense
density: density
denunciation: denunciation
denunciatory: denunciatory
deny: denied,deny,denying
depart: depart,departed,departing
departure: departure
depend: depend,depended,depending,depends
deplorable: deplorable
deplore: deplore,deplored,deplores
depose: depose,deposed
deprive: deprive
depths: depths
deride: deride
derision: derision
derisive: derisive
derisively: derisively
derivative: derivative
derive: derive,derived
descend: descend,descended,descending
description: description
desecration: desecration
desert: desert,deserted,deserts
deserve: deserve,deserved,deserves,deserving
deserved: deserved
design: design,designed
designation: designation
desirably: desirably
desire: desire,desired,desires,desiring
desist: desist
despair: despair
despairing: despairing
desperate: desperate
desperately: desperately
desperation: desperation
despise: despised
despondently: despondently
desponding: desponding
despot: despots
destine: destined
destiny: destinies,destiny
destitution: destitution
destroy: destroy,destroyed,destroying
destruction: destruction
destructive: destructive
detach: detach,detached
detain: detain,detained
detection: detection
detention: detention
determination: determination
determine: determine,determined
determined: determined
detest: detested
detestable: detestable
detestation: detestation
detract: detracted
development: development
device: device,devices
devil: devil,devils
devilry: devilries
devise: devise
devoir: devoirs
devon: devon
devote: devote,devoted,devotes
devotion: devotion
devotions: devotions
devour: devouring
devout: devout
devoutly: devoutly
devoutness: devoutness
dew: dews
dexterity: dexterity
dialect: dialect
dice: dice
dictate: dictate,dictated
didst: didst
die: die,died,dies,dying
difference: difference,differences
difficult: difficult
difficulty: difficulties,difficulty
diffuse: diffusing
dig: dig,dug
digestion: digestion
dignified: dignified
dignity: dignity
digression: digressions
dilate: dilate,dilated,dilating
diligently: diligently
dim: dim
diminish: diminished
dimly: dimly
din: din
dine: dine,dined,dining
dining: dining
dip: dip,dipped,dipping
diplomatic: diplomatic
direct: direct,directed
direction: direction,directions
dirt: dirt
dirty: dirty
disappearance: disappearance
disappoint: disappointed
disappointed: disappointed
disappointment: disappointment
disapproval: disapproval
disapprove: disapprove
disarm: disarm
disaster: disaster
disbelief: disbelief
disbelieve: disbelieved
disburse: disburse
discard: discarded
discern: discern
discharge: discharged
disclaim: disclaim
disclaimer: disclaimer,disclaimers
disclose: disclose,disclosed
discomfiting: discomfiting
discomfiture: discomfiture
discompose: discomposed
disconcerting: disconcerting
discontinue: discontinue
discourse: discourse
discover: discover,discovered,discovering
discovery: discovery
discredit: discredit
discreetly: discreetly
discretion: discretion
discriminate: discriminate
disdain: disdain,disdained,disdains
disdainful: disdainful
disease: disease,diseases
diseased: diseased
disencumber: disencumber
disgrace: disgrace
disgust: disgust
disgusted: disgusted
dish: dish
dishevelled: dishevelled
dishonest: dishonest
dishonour: dishonour,dishonouring
dishonourable: dishonourable
disillusion: disillusion
disinterested: disinterested
disk: disk
dislike: dislike
disloyal: disloyal
disloyalty: disloyalty
dismay: dismay
dismayed: dismayed
dismiss: dismiss,dismissed,dismissing
dismissal: dismissal
dismount: dismounted
disobedient: disobedient
disorder: disorder
disordered: disordered
dispassionately: dispassionately
dispatch: dispatched
dispel: dispel,dispelled
dispense: dispense
dispenser: dispenser
disperse: disperse,dispersed
display: display,displayed,displaying,displays
displeasure: displeasure
disposal: disposal
dispose: dispose,disposed
disposed: disposed
dispute: disputed
disregard: disregarded
dissemble: dissemble,dissembled,dissembling
disservice: disservice
dissimilar: dissimilar
dissolute: dissolute
dissoluteness: dissoluteness
dissolve: dissolve,dissolved
distance: distance
distant: distant
distemper: distemper
distempered: distempered
distort: distorted
distortion: distortions
distracted: distracted
distraction: distraction
distraught: distraught
distress: distress
distribute: distribute,distributed,distributing
distribution: distribution
distributor: distributor
district: district
disturb: disturb,disturbed,disturbing
disturbing: disturbing
divan: divan
diverse: diverse
diversion: diversion
divert: diverted,diverting
divide: divided,dividing
divinely: divinely
division: division
divorce: divorce
divorced: divorced
dizziness: dizziness
djellaba: djellaba,djellabas
djinn: djinn
doa: doa
docile: docile
document: document,documents
doff: doffing
dog: dog,dogs
doings: doings
dole: doling
doleful: doleful
dolores: dolores
domain: domain
dome: dome
dominate: dominated
dominic: dominic
dominion: dominion
donate: donate
donation: donation,donations
donkey: donkeys
donor: donors
doom: doom,doomed,dooming
door: door,doors
doorway: doorway,doorways
doria: doria
dost: dost
dot: dotted
doth: doth
double: doubled
doublet: doublet
doubly: doubly
doubt: doubt,doubted,doubts
dove: doves
downcast: downcast
downfall: downfall
download: downloading
dozen: dozen
drag: drag,dragged,dragging
drain: drained,draining
dramatic: dramatic
draught: draught
draw: draw,drawing,drawn,draws,drew
dread: dread,dreaded,dreading
dreadful: dreadful
dream: dream,dreamed,dreams,dreamt
dreamily: dreamily
dreamy: dreamy
drench: drenched
dress: dress,dressed
dressing: dressing
drift: drift
drink: drank,drink,drinking
drinking: drinking
drip: dripping
dripping: dripping
drive: drive,driven,drives,driving,drove
driver: drivers
drone: drone
droop: drooped,drooping
drop: drop,dropped,dropping,drops
drown: drowned
drug: drugged
drum: drums
drunk: drunk
drunken: drunken
dry: dried,dry
dub: dub,dubbed,dubs
dull: dull
dully: dully
dulness: dulness
duly: duly
dumb: dumb
dumbfounded: dumbfounded
dune: dunes
dung: dung
dupe: dupe,duped
dusk: dusk
dusky: dusky
dust: dust
dutch: dutch
dutchman: dutchman
dutchmen: dutchmen
duty: duties,duty
dwell: dwell,dwelt
dwindle: dwindled,dwindling
eager: eager
eagerly: eagerly
eagerness: eagerness
eagle: eagle
ear: ear,ears
earn: earn,earned,earning
earnest: earnest
earring: earring
earshot: earshot
earth: earth
earthenware: earthenware
earthly: earthly
ease: ease
easily: easily
east: east
easter: easter
easterly: easterly
eastern: eastern
eastward: eastward
easy: easier,easy
eat: ate,eat,eaten,eating
eating: eating
eblis: eblis
ebony: ebony
eccentric: eccentric
echo: echo,echoed,echoing
eclipse: eclipse
edge: edge,edges
edition: edition,editions
educational: educational
educative: educative
efface: efface,effaced,effaces,effacing
effacement: effacement
effective: effective
effort: effort,efforts
effrontery: effrontery
egg: eggs
egoism: egoism
egotism: egotism
eighteen: eighteen
ejaculate: ejaculated
ejaculation: ejaculation
el: el
elaborately: elaborately
elasticity: elasticity
elbow: elbow,elbowed,elbows
elder: elder
elderly: elderly
elect: elect
electronic: electronic
electronically: electronically
elephantine: elephantine
eleventh: eleventh
elopement: elopement
eloquence: eloquence
eloquent: eloquent
eloquently: eloquently
elucidate: elucidate
elude: elude
elusive: elusive
email: email
embattle: embattled
ember: embers
embitter: embitter
embrace: embrace,embraced
embroider: embroidered
embroil: embroiled
emerald: emerald,emeralds
emerge: emerged
emergency: emergencies
eminence: eminence
emit: emit
emotion: emotion,emotions
emotional: emotional
empanoply: empanoply
emphasis: emphasis
employ: employ,employed
employee: employee,employees
employer: employer
emptiness: emptiness
empurpling: empurpling
emulate: emulate
enable: enable,enabled,enabling
encampment: encampment
encase: encased
enchant: enchanted
enchantment: enchantments
encircle: encircled
enclose: enclosed
enclosure: enclosure
encode: encoding
encompass: encompass,encompassing
encounter: encounter
encourage: encouraged,encouraging
encouragingly: encouragingly
encumber: encumbered
encumbrance: encumbrance
endanger: endangering
endearing: endearing
endeavour: endeavour,endeavoured
endless: endless
endow: endowed
endowment: endowments
endurance: endurance
endure: endure,endured,enduring
enemy: enemies,enemy
energy: energies,energy
enforce: enforce
engage: engage,engaged
engagement: engagement,engagements
engender: engendered
engineer: engineer,engineers
england: england
english: english
englishman: englishman
engrossing: engrossing
engulf: engulfed
enhearten: enhearten
enjoin: enjoined,enjoining
enjoy: enjoy,enjoyed
enlarge: enlarge
enlighten: enlighten
enlightenment: enlightenment
enlist: enlist
enmesh: enmesh,enmeshed
enmity: enmities,enmity
enormous: enormous
enormously: enormously
enrage: enraged
enraged: enraged
enrich: enriched
ensample: ensample
ensign: ensign
enslave: enslaved
ensue: ensued,ensuing
ensure: ensure,ensuring
entail: entail,entailed,entailing
enter: enter,entered,enters
enterprise: enterprise
entertain: entertained,entertains
entertaining: entertaining
entertainment: entertainment
enthrone: enthroned
enthusiasm: enthusiasm
entire: entire
entitle: entitled
entity: entity
entrance: entrance
entreat: entreat,entreated
entreaty: entreaty
entrust: entrust,entrusted,entrusting
entwine: entwining
enumerate: enumerated
envelop: envelop
environment: environment
envisage: envisage
ephemeral: ephemeral
epithet: epithets
equal: equal
equally: equally
equip: equip,equipped,equipping
equipment: equipment
equivalent: equivalent
ere: ere
erect: erect,erected
err: erred
errand: errand
error: error,errors
erstwhile: erstwhile
escape: escape,escaped,escaping
escort: escort,escorted
esplanade: esplanades
essay: essay
essence: essence
essential: essentials
establish: established,establishing
estate: estates
esteem: esteem,esteemed
estimate: estimate
estuary: estuary
eternal: eternal
eunuch: eunuch,eunuchs
europe: europe
european: european
evade: evade,evaded
evasively: evasively
eve: eve
evening: evening
event: event,events
eventuality: eventualities
evergreen: evergreen
evidence: evidence,evidences
evil: evil
evilly: evilly
evoke: evoke,evoked
ewer: ewer
exact: exact
exaggerate: exaggerating
exaggeration: exaggeration
exalt: exalt,exalted
exaltation: exaltation,exaltations
examination: examination
examine: examined
exceed: exceeded
excellent: excellent
excellently: excellently
exception: exception
excess: excess,excesses
excessiveness: excessiveness
exchange: exchange,exchanged
excited: excited
excitement: excitement
exclaim: exclaim,exclaimed,exclaiming
exclamation: exclamation
exclusion: exclusion
excuse: excuse,excuses
execute: execute,executed,executing
execution: execution
executioner: executioner
exempt: exempt
exert: exert,exerted,exerting
exertion: exertion
exhalation: exhalations
exhaust: exhausted
exhaustion: exhaustion
exhort: exhort,exhorted
exhortation: exhortation
exile: exile
exist: exist,existed,exists
existence: existence
expansive: expansive
expect: expect,expected,expecting
expectant: expectant
expectantly: expectantly
expectation: expectations
expediently: expediently
expedition: expedition
expend: expend
expense: expense,expenses
experience: experience,experienced,experiences
experienced: experienced
expiate: expiate
expire: expiring
explain: explain,explained,explaining
explanation: explanation,explanations
explode: exploded
exploit: exploits
explosion: explosion
export: exporting
expose: exposed
exposure: exposure
expound: expound
express: express,expressed,expressing
expression: expression,expressions
expressionless: expressionless
extend: extended,extends
extended: extended
extent: extent
extinction: extinction
extinguish: extinguish,extinguished
extract: extract,extracted
extraordinary: extraordinary
extravagance: extravagances
extravagant: extravagant
extreme: extreme
extremely: extremely
extremity: extremity
exultant: exultant
exultantly: exultantly
exultation: exultation
eye: eye,eyes
eyeball: eyeballs
eyebrow: eyebrows
eyed: eyed
eyelid: eyelids
eyewitness: eyewitness
eyrie: eyrie
fable: fable
fabric: fabrics
facade: facade
faced: faced
facility: facility
factor: factor
faculty: faculty
fade: faded,fading
fail: fail,failed,failing
faint: faint,faintest,fainting
faintly: faintly
fair: fair
fairness: fairness
faith: faith
faithful: faithful
faithfully: faithfully
faithless: faithless
faithlessness: faithlessness
falconry: falconry
fall: fall,fallen,falling,fell
fallen: fallen
false: false
falsehood: falsehood
falsely: falsely
falseness: falseness
falsify: falsified
falter: faltered,faltering
fame: fame,famed
familiar: familiar
family: families,family
famous: famous
fan: fan,fans
fancy: fancied,fancy
fang: fangs
fantastic: fantastic
fare: fare
farthing: farthing
farthingale: farthingale
fashion: fashion,fashioned
fast: fast,faster
fasten: fasten,fastened
fasting: fasting
fat: fat
fatalist: fatalist
fatalistic: fatalistic
fate: fate,fates
fateful: fateful
father: father,fathered,fathers
fatigue: fatigue
fault: fault
faun: faun
favour: favour,favoured,favouring
favourable: favourable
favourite: favourite
fawn: fawn,fawned,fawning
fear: fear,feared,fearing,fears
fearful: fearful
fearfully: fearfully
fearless: fearless
fearlessly: fearlessly
fearsome: fearsome
feast: feasted
feature: featured
federal: federal
fee: fee,fees
feeble: feeble
feebly: feebly
feed: fed,feed,feeding
feel: feel,feeling
feeling: feeling,feelings
feign: feigned
fell: felled
fellow: fellow,fellows
fender: fender
ferment: ferment
fern: fern,ferns
ferocious: ferocious
ferociously: ferociously
ferry: ferry
fertile: fertile
fertilize: fertilized
fervent: fervent
fervently: fervently
fervour: fervour
fester: festering
festering: festering
fetch: fetch,fetched
fetter: fetters
feud: feud
feudatory: feudatory
fever: fever
feverishly: feverishly
fibre: fibres
fidelity: fidelity
fiend: fiend,fiends
fierce: fierce,fiercer
fiercely: fiercely
fierceness: fierceness
fiery: fiery
fight: fight,fighting,fights,fought
fighter: fighter,fighters
fighting: fighting
figure: figure
filch: filched,filching
file: file,files
film: filming
filter: filtered
filth: filth
filthy: filthier,filthy
final: final
finality: finality
finally: finally
financial: financial
fine: fine
finely: finely
finger: finger,fingering,fingers
firelit: firelit
fireplace: fireplace
fireside: fireside
firm: firm
firmly: firmly
fisherman: fishermen
fishing: fishing
fist: fist,fists
fit: fit,fitted,fittest,fitting
fitfully: fitfully
fitness: fitness
fitting: fitting
flack: flack
flag: flag,flagged
flagon: flagon
flagrantly: flagrantly
flame: flame,flames,flaming
flank: flank,flanked,flanks
flap: flap,flapping
flash: flash,flashed,flashing
flat: flat,flatter
flattery: flattery
flee: fled,flee
fleet: fleet,fleets
fleetly: fleetly
flesh: flesh
fleshed: fleshed
flicker: flicker,flickered,flickering
flight: flight,flights
flimsy: flimsy
fling: fling,flinging,flung
flippant: flippant
float: floated,floating
flock: flock
flog: flogged
flood: flood,flooded
floor: floor
florid: florid
flounder: floundering
flout: flout,flouted
flow: flow,flowed,flowing
flower: flower
fluent: fluent
flung: flung
flush: flush,flushed,flushing
fly: flew,flies,flown,fly,flying
foam: foam
foe: foe,foes
fold: folded,folding
foliage: foliage
folio: folio
folk: folk
follow: follow
follower: follower,followers
folly: folly
fomenter: fomenter
fond: fond
fondly: fondly
fondness: fondness
food: food
fool: fool,fooled,fools
foolish: foolish
foolishly: foolishly
foot: feet,foot
footing: footing
footstep: footsteps
foppishness: foppishness
forbear: forbears
forbearance: forbearance
forbearing: forbearing
forbid: forbade,forbid,forbidden,forbidding
forbidden: forbidden
forbore: forbore
force: force,forced,forces,forcing
forcibly: forcibly
fore: fore
forearm: forearmed
foreboding: foreboding
forecastle: forecastle
forefather: forefathers
foregone: foregone
foreign: foreign
forelock: forelock
foremast: foremast,foremasts
foremost: foremost
foresee: foresaw,foresee,foreseen
forest: forest
forestall: forestall
foretell: foretold
forewarn: forewarned
forewarned: forewarned
forfeit: forfeit,forfeited
forge: forge,forged
forget: forget,forgetting,forgot,forgotten
forgive: forgive,forgiven,forgiving
forgiveness: forgiveness
forgo: forgo
fork: forked
forlorn: forlorn
form: form,formed,forming,forms
formal: formal
format: format,formats
formation: formation
formidable: formidable
forswear: forsworn
forthcoming: forthcoming
forthwith: forthwith
fortify: fortified
fortitude: fortitude
fortress: fortress
fortuitously: fortuitously
fortunate: fortunate
fortunately: fortunately
fortune: fortune
foster: foster,fostered
foul: foul,fouler
foully: foully
foulness: foulness,foulnesses
foundation: foundation,foundations
founder: founder,foundering
fount: fount
fountain: fountain
fourth: fourth
fowl: fowling
fragment: fragment,fragments
fragrance: fragrance
fragrant: fragrant
fragrantly: fragrantly
frail: frail
frame: frame
franca: franca
france: france
frank: frank
frankish: frankish
frankly: frankly
frankness: frankness
frantic: frantic
fratricide: fratricide
fraught: fraught
freckle: freckles
freedom: freedom
freely: freely
freeze: froze,frozen
freight: freights
french: french
frenchmen: frenchmen
frenzy: frenzy
frequently: frequently
fresh: fresh
fretted: fretted
friction: friction
friend: friend,friends
friendliness: friendliness
friendly: friendly
friendship: friendship
frightened: frightened
fringe: fringed
fro: fro
frog: frogs
frostily: frostily
frosty: frosty
froth: frothing
froward: froward
frown: frown,frowned,frowning
frozen: frozen
fruit: fruit,fruits
fruitless: fruitless
frustrated: frustrated
frustrating: frustrating
frustration: frustration
fuddle: fuddled
fugitive: fugitive
fulcrum: fulcrum
fulfil: fulfilled
fume: fumes
fumigation: fumigation
furious: furious
furiously: furiously
furl: furling
furnace: furnace
furnish: furnish,furnished
furrow: furrow,furrowed
furtive: furtive
furtively: furtively
fury: fury
futile: futile
future: future
gag: gag,gagged
gain: gain,gained,gaining,gains
gainer: gainer
gait: gait
gale: gale
gall: gall
gallant: gallant,gallants
gallantly: gallantly
gallantry: gallantry
galleon: galleon
gallery: gallery
galley: galley,galleys
galliot: galliot
gallop: gallop,galloping
gallows: gallows
gamble: gambled
game: game
games: games
gangway: gangway
gaol: gaol
gap: gap
gape: gape,gaped,gaping
garb: garb
garden: garden,gardens
gardener: gardener,gardeners
garment: garments
garner: garnered
garrison: garrison
gasp: gasp,gasped
gate: gate,gates
gatekeeper: gatekeeper
gates: gates
gateway: gateway
gather: gather,gathered,gathering
gathering: gathering
gaudy: gaudy
gauge: gauge,gauged
gaunt: gaunt
gauze: gauze
gay: gay
gaze: gaze,gazing
gazelle: gazelle
gehenna: gehenna
gem: gems
generation: generations
generosity: generosity
generous: generous
generously: generously
genoa: genoa
genoese: genoese
gentle: gentle
gentleman: gentleman,gentlemen
gentleness: gentleness
gentler: gentler
gentlewoman: gentlewoman
gently: gently
genuine: genuine
genuineness: genuineness
gesticulation: gesticulation
gesture: gesture,gestures
ghastly: ghastly
ghetto: ghettos
ghost: ghost
ghostly: ghostly
giant: giant
gibe: gibed
gibraltar: gibraltar
gift: gift,gifts
gifted: gifted
gigantic: gigantic
gilded: gilded
gimbri: gimbri
gird: girt
girdle: girdle
girl: girl,girls
girlishness: girlishness
glad: glad
gladden: gladden,gladdened
gladdened: gladdened
gladly: gladly
gladness: gladness
glance: glance,glanced,glances
glare: glare,glared,glaring
glaring: glaring
glass: glass
glazing: glazing
gleam: gleam,gleamed,gleaming
glean: glean,gleaned
glibly: glibly
glide: glided,gliding
glimmer: glimmered
glimpse: glimpse
glint: glint
glisten: glistened,glistening
glitter: glittered,glittering
gloat: gloat,gloated
gloom: gloom
gloomily: gloomily
gloomy: gloomy
glorify: glorifying
glorious: glorious
glory: glories,glory
glow: glow,glowed,glowing
glower: glowered,glowering
gloze: gloze
glut: glutted
gnarled: gnarled
gnaw: gnawing
goad: goad,goading
goal: goal,goals
goat: goat,goats
goatherd: goatherd
goatskin: goatskin
god: god,gods
gold: gold
golden: golden
gorgeous: gorgeous
gorgeously: gorgeously
gospel: gospel
gossip: gossip
gothic: gothic
govern: govern
gown: gown
grace: grace
graceful: graceful
gracefully: gracefully
gradually: gradually
grain: grain
grand: grand
granite: granite
grant: grant,granted,granting
grapnel: grapnels
grapple: grapple,grappling
grappling: grappling
grasp: grasp,grasped,grasping
grasshopper: grasshopper
grateful: grateful
gratefully: gratefully
gratification: gratification
gratify: gratify
gratitude: gratitude
grave: grave,graver
gravely: gravely
gravity: gravity
gray: gray
graze: grazing
grease: grease
greased: greased
greasy: greasy
greatly: greatly
greatness: greatness
greed: greed
greedily: greedily
greedy: greedy
greek: greeks
green: green
greet: greet,greeted
greeting: greeting
gregory: gregory
grey: grey
greyhound: greyhound,greyhounds
greyness: greyness
grief: grief
grievance: grievance
grieve: grieved
grievous: grievous
grievously: grievously
grim: grim
grimace: grimacing
grimly: grimly
grimy: grimy
grin: grin,grinned,grinning
grip: grip,gripped,gripping,grips
groan: groan,groaned,groans
groaning: groaning
groom: groom,grooms
gropingly: gropingly
gross: gross
grossness: grossness
grotesque: grotesque
ground: ground
grounds: grounds
grove: groves
grovel: grovelled,grovelling
grow: grew,grow,growing,grown,grows
growl: growl,growled
grown: grown
growth: growth
grudge: grudge
gruffly: gruffly
grumble: grumbled
grunt: grunt,grunted
guarantee: guarantee
guard: guard,guarded,guards
guardian: guardian
guardianship: guardianship
guess: guess,guessed,guessing
guest: guest,guests
guffaw: guffaw
guide: guide,guided
guile: guile
guileful: guileful
guileless: guileless
guilt: guilt
guilty: guilty
gum: gums
gun: gun,guns
gunner: gunner,gunners
gunpowder: gunpowder
gust: gust,gusts
ha: ha
habit: habit,habits
habitual: habitual
hack: hacked,hacking
hadst: hadst
haggard: haggard
haggardness: haggardness
haggle: haggling
hail: hail,hailed
hair: hair
haired: haired
hairy: hairy
hale: hale,haled
halfway: halfway
hall: hall
halloo: hallooed
halt: halt,halted
halter: halter
hamlet: hamlet
hammer: hammer
hammered: hammered
hamper: hampered
hand: hand,handed,hands
handed: handed
handful: handful
handiwork: handiwork
handle: handle,handled
handsome: handsome
handsomely: handsomely
hang: hang,hanged,hanging,hangs,hung
hanging: hanging
hangman: hangman
haply: haply
happen: happen,happened,happening
happening: happenings
happiness: happiness
happy: happy
harass: harass
harbour: harbour,harboured,harbours
hard: hard,harder
harden: hardened
hardy: hardy
hare: hare
hareem: hareem
hark: hark
harlot: harlot,harlots
harm: harm
harmless: harmless
harry: harry
harrying: harrying
harsh: harsh
harshly: harshly
harshness: harshness
hart: hart
hast: hast
haste: haste
hasten: hasten,hastened
hastily: hastily
hasty: hasty
hat: hat
hatch: hatches
hatchway: hatchway,hatchways
hate: hate,hated,hates,hating
hateful: hateful
hath: hath
hatred: hatred,hatreds
haughtiness: haughtiness
haughty: haughty
haul: hauled
haunt: haunt,haunted
haunting: haunting
hawk: hawk,hawks
hawker: hawker
hawkins: hawkins
hazard: hazard,hazards
hazardous: hazardous
haze: haze
hazy: hazy
head: head,headed,heading,heads
headland: headland
headlong: headlong
headpiece: headpiece
headstone: headstone
headstrong: headstrong
heal: heal,healed
healing: healing
health: health
healthy: healthy
heap: heap
hear: hear,heard,hearing
hearing: hearing
heart: heart
hearted: hearted
heartedly: heartedly
heartedness: heartedness
hearten: heartened
heartily: heartily
heartlessness: heartlessness
hearty: hearty
heat: heat
heated: heated
heath: heath
heathen: heathen,heathens
heave: heave,heaved,hove
heaven: heaven,heavens
heavens: heavens
heavily: heavily
heaving: heaving
heavy: heavier,heavy
hebrew: hebrew
hectic: hectic
hector: hector,hectoring
hedge: hedges
heed: heed,heeded,heeding
heedless: heedless
heel: heel,heels
height: height,heights
heighten: heightened
hellcat: hellcat
helm: helm
helmsman: helmsmen
helpless: helpless
hemp: hemp
henceforth: henceforth
henceforward: henceforward
henna: henna
henry: henry
herald: herald,heralded,heralding
heraldry: heraldry
herb: herb
herculean: herculean
hercules: hercules
herd: herd
heresy: heresy
heretic: heretics
heretics: heretics
heroism: heroism
heron: heron
herring: herrings
hesitancy: hesitancy
hesitate: hesitate,hesitated,hesitating
hesitation: hesitation
hesperides: hesperides
hidden: hidden
hide: hidden,hide,hides
hideous: hideous
hideousness: hideousness
highland: highlands
hill: hill,hills
hillside: hillside
hilltop: hilltop
hilt: hilt,hilted
hinder: hinder,hindering
hinge: hinges
hint: hint
hire: hire,hired
hiss: hissing
hisself: hisself
hissing: hissing
history: history
hit: hit
hitherto: hitherto
ho: ho
hoarse: hoarse
hoarsely: hoarsely
hoist: hoisted
hold: held,hold,holding,holds
holder: holder
hole: hole
hollow: hollow
hollowest: hollowest
holy: holy
homeward: homeward
honest: honest
honesty: honesty
honey: honey,honeyed
honour: honour,honoured,honours
honourable: honourable
honoured: honoured
hooded: hooded
hoodwink: hoodwink
hoof: hooves
hook: hooks
hope: hope,hoped,hopes,hoping
hopeless: hopeless
horde: horde
horizon: horizon
horizontal: horizontal
horizontally: horizontally
horn: horn,horns
horrible: horrible
horribly: horribly
horrid: horrid
horror: horror,horrors
horse: horse,horses
hose: hose
hospitality: hospitality
hostile: hostile
hostility: hostilities,hostility
hot: hot
hotly: hotly
hound: hound,hounds
hounds: hounds
hour: hour,hours
house: house,housed,houses
housetops: housetops
hover: hovered,hovering
howl: howling
hubbub: hubbub
huckster: huckster,hucksters
huddle: huddle,huddled
hue: hue
hued: hued
hug: hug,hugged,hugging
huge: huge
hulk: hulk
hull: hull
hum: hum,hummed
human: human
humane: humane
humble: humble
humbly: humbly
humiliate: humiliated
humiliation: humiliation
humility: humility
humour: humour,humours
humoured: humoured
hunch: hunched
hunger: hunger
hunt: hunt
hunter: hunter
hunting: hunting
hurl: hurled,hurling
hurry: hurried,hurry,hurrying
hurt: hurt,hurting
hurtle: hurtling
husband: husband
hush: hush
huskily: huskily
hut: huts
hypocrisy: hypocrisy
hypocrite: hypocrite
hypothetical: hypothetical
ice: ice
icy: icy
idea: idea
identical: identical
identification: identification
identify: identify
identity: identity
idle: idle,idling
idleness: idleness
idler: idlers
idly: idly
idolize: idolizing
ignite: ignited
ignominy: ignominy
ignorance: ignorance
ignorant: ignorant
iii: iii
illumine: illumine,illumined
image: image,images
imagery: imagery
imagination: imagination
imagine: imagine,imagined
imagining: imaginings
imbrue: imbrued
immaculate: immaculate
immensely: immensely
immensity: immensity
imminent: imminent
immodest: immodest
immortal: immortal
immovable: immovable
immunity: immunity
impact: impact
impart: imparting
impartial: impartial
impassive: impassive
impassively: impassively
impatience: impatience
impatient: impatient
impatiently: impatiently
impeach: impeach
impel: impelled
impending: impending
impenetrable: impenetrable
imperative: imperative
imperceptibly: imperceptibly
imperil: imperilled,imperils
imperilling: imperilling
imperious: imperious
impertinence: impertinence
impervious: impervious
impetuosity: impetuosity
impetuous: impetuous
impetuously: impetuously
impetuousness: impetuousness
impiety: impiety
impinge: impinge
impious: impious
impish: impish
implant: implanted
implication: implication,implications
implicit: implicit
implore: implore,implored,imploring
imply: implied
import: import,imported
importunity: importunities
impose: impose,imposed
imposing: imposing
impossibility: impossibility
impossible: impossible
impracticable: impracticable
impress: impress,impressed
impression: impression
impressiveness: impressiveness
impudence: impudence
imputation: imputation
impute: impute
imputed: imputed
inability: inability
inaccurate: inaccurate
inadequate: inadequate
inadvertently: inadvertently
inarticulate: inarticulate
inarticulately: inarticulately
inauspicious: inauspicious
incapable: incapable
incarnate: incarnate
incarnation: incarnation
incense: incense
inch: inch
incident: incident
incidental: incidental
inclination: inclination,inclinations
incline: inclined
include: include,included,includes,including
including: including
incoherency: incoherencies
incomplete: incomplete
inconceivable: inconceivable
inconsiderable: inconsiderable
incontestably: incontestably
increase: increase,increased,increases,increasing
incredible: incredible
incredulity: incredulity
incredulous: incredulous
incumbent: incumbent
indebtedness: indebtedness
indefinitely: indefinitely
indemnify: indemnify
indemnity: indemnity
indescribable: indescribable
indescribably: indescribably
indication: indication,indications
indies: indies
indifference: indifference
indifferent: indifferent
indifferently: indifferently
indignant: indignant
indignantly: indignantly
indignation: indignation
indignity: indignity
indirect: indirect
indirectly: indirectly
indiscreet: indiscreet
indite: indite,indited
individual: individual
indolence: indolence
indolent: indolent
indomitably: indomitably
indoor: indoors
indrawn: indrawn
induce: induce,induced,inducing
induct: inducted
induction: induction
indulge: indulge,indulging
indulgence: indulgence
inevitable: inevitable
inevitably: inevitably
inexorable: inexorable
inextricably: inextricably
infamous: infamous
infamy: infamy
infanta: infanta
infect: infected
infection: infection,infections
infer: infer
inference: inference
inferior: inferior
infest: infested
infidel: infidel,infidels
infidelity: infidelities,infidelity
infinite: infinite
infirm: infirm
inflame: inflamed
inflamed: inflamed
influence: influence,influenced,influences
inform: inform,informed,informing
infringement: infringement
infusing: infusing
ingenuity: ingenuity
ingenuously: ingenuously
ingratiatingly: ingratiatingly
inhabit: inhabited
inherently: inherently
inherit: inherited
inheritance: inheritance
inheritor: inheritor
inhumanity: inhumanity
initiative: initiative
inject: injected
injunction: injunction
injure: injure,injuring
injury: injury
injustice: injustice
inkling: inkling
inky: inky
inlaid: inlaid
inland: inland
inn: inn
innocence: innocence
innocent: innocent
innuendo: innuendo,innuendoes
inquire: inquire,inquired,inquiring
inquiry: inquiries,inquiry
inquisition: inquisition
inquisitive: inquisitive
insatiable: insatiable
inscribe: inscribe
inscrutable: inscrutable
insecure: insecure
insensate: insensate
insensibility: insensibility
insensible: insensible
insidious: insidious
insight: insight
insinuate: insinuated
insinuation: insinuations
insist: insist,insisted,insisting
insistent: insistent
insistently: insistently
insolent: insolent
inspect: inspect
inspection: inspection
inspiration: inspiration
inspire: inspire,inspired
inspirer: inspirer
instance: instance
instant: instant
instantly: instantly
instinct: instinct,instincts
instinctively: instinctively
instruction: instructions
instrument: instrument,instruments
instrumental: instrumental
insufferable: insufferable
insult: insult,insults
insulting: insulting
intangible: intangible
intellectual: intellectual
intelligence: intelligence
intend: intend,intended,intending,intends
intended: intended
intense: intense
intensely: intensely
intensity: intensity
intent: intent
intention: intention,intentions
intently: intently
intercept: intercept,intercepted,intercepting
intercession: intercession
intercourse: intercourse
interfere: interfered
interference: interference,interferences
interior: interior
interlock: interlocked,interlocking
interlocutor: interlocutor
interminable: interminable
intermingle: intermingled
intermission: intermission
intermittent: intermittent
intermittently: intermittently
internal: internal
international: international
interpose: interposed
interpret: interpret,interpreted
interpretation: interpretation
interrogatively: interrogatively
interrupt: interrupt,interrupted
interruption: interruption,interruptions
intersperse: interspersed
intervene: intervene,intervened
intervener: intervener
interview: interview
intimate: intimate
intolerant: intolerant
intone: intoned
intrepid: intrepid
intrepidity: intrepidity
intrigue: intrigue,intrigued
intrigued: intrigued
intriguing: intriguing
introduce: introduced
introduction: introduction
intrude: intrude
intruder: intruder,intruders
intrusion: intrusion
intuition: intuition,intuitions
inure: inured
invade: invaded
invaded: invaded
invalidity: invalidity
invaluable: invaluable
invariable: invariable
invective: invective
inveigh: inveighed
invent: invent
invest: invested
investigate: investigate
investigation: investigation,investigations
inveterately: inveterately
invincible: invincible
inviolable: inviolable
inviolate: inviolate
invisible: invisible
invitation: invitation
invite: invited,inviting
invitingly: invitingly
invoke: invoked
involve: involve,involved
inwardly: inwardly
ireland: ireland
iron: iron,irons
ironic: ironic
ironical: ironical
ironically: ironically
irony: irony
irrefutably: irrefutably
irrepressible: irrepressible
irresistible: irresistible
irrevocable: irrevocable
irrevocably: irrevocably
irritability: irritability
irritate: irritate
irs: irs
islam: islam
island: island
isles: isles
israelite: israelite
issue: issue,issued,issuing
italian: italian,italians
italianate: italianate
italy: italy
item: item
itinerant: itinerant
iv: iv
ivory: ivory
ix: ix
jack: jack
jackal: jackal
jacket: jacket
jade: jade
january: january
jar: jar,jarred
jargon: jargon
jasper: jasper
jaundiced: jaundiced
javelin: javelin
jaw: jaw,jaws
jealous: jealous
jealousy: jealousy
jeer: jeer,jeered,jeers
jeeringly: jeeringly
jelly: jelly
jennet: jennet
jeopardize: jeopardize,jeopardizing
jeopardized: jeopardized
jeopardy: jeopardy
jerk: jerked
jessamine: jessamine
jest: jest
jester: jester
jew: jew
jewel: jewel,jewels
jewelled: jewelled
jewish: jewish
jews: jews
john: john
jointly: jointly
jolly: jolly
jostle: jostling
journey: journey
jowl: jowl
joy: joy
joyous: joyous
juan: juan
jubilant: jubilant
jubilation: jubilation
judge: judge,judged,judges,judging
judging: judging
judgment: judgment,judgments
judicial: judicial
june: june
jurisdiction: jurisdiction
jurisprudence: jurisprudence
justice: justice,justices
justices: justices
justification: justification
justified: justified
justify: justified,justify
jut: jutted,jutting
kadi: kadi
kasbah: kasbah
keel: keel
keen: keen,keener
keener: keener
keeping: keeping
keg: keg,kegs
kerchief: kerchief
key: key
kick: kicked
kidnap: kidnap,kidnapped
kidnapping: kidnapping
kidney: kidney
kill: kill,killed,killing
killing: killing
kin: kin
kindle: kindle,kindled
kindling: kindling
kindly: kindly
kindness: kindness
king: king
kingdom: kingdom
kiss: kiss,kissed
knave: knave,knaves
knead: kneaded
knee: knee,knees
kneel: kneel,kneeling
knife: knife
knight: knight,knighted
knighthood: knighthood
knightly: knightly
knights: knights
knit: knit
knock: knocked
knot: knot
knoweth: knoweth
knowing: knowing
knowledge: knowledge
koran: koran
label: label,labelled
laboriously: laboriously
labour: labour,laboured,labouring,labours
labyrinth: labyrinth
lace: laced
lack: lack,lacked,lacking,lacks
lackaday: lackaday
lackey: lackey
laconic: laconic
lad: lad,lads
laden: laden
lady: ladies,lady
lagoon: lagoon
lake: lake
lamb: lamb
lame: lame
lament: lamented
lamentable: lamentable
lamp: lamp,lamps
land: land,landed,landing
landing: landing
lane: lane
language: language
languid: languid
languish: languish
languorous: languorous
lantern: lantern,lanterns
lap: lap
larboard: larboard
lark: lark
las: las
lash: lash,lashed,lashes,lashing
late: late
lateen: lateen
lateness: lateness
lath: laths
latitude: latitude
lattice: lattice,latticed,lattices
laugh: laugh,laughed,laughing
laughter: laughter
launch: launch,launched
lavender: lavender
lavish: lavished
law: law,laws
lawn: lawns
lax: lax
laxity: laxity
lay: laid,lay,laying
layer: layer
lazily: lazily
lead: lead,leading,leads,led
leaden: leaden
leader: leader
leaf: leaves
league: leagues
lean: lean,leaned,leaning,leant
leaning: leaning
leap: leap,leaping,leapt
leapt: leapt
learn: learn,learned,learning,learns,learnt
learning: learning
leash: leash
leashed: leashed
leather: leather
leave: leave,leaves,leaving,left
leaven: leavened
ledge: ledge
lee: lee
leer: leered
leering: leering
leeward: leeward
left: left
leg: leg,legs
legal: legal
legally: legally
legend: legend
legged: legged
legion: legion
leigh: leigh
leisure: leisure
lend: lend,lending,lent
lengthen: lengthen,lengthening
leopard: leopard
lepanto: lepanto
lessen: lessened
lessening: lessening
lesson: lesson
lethal: lethal
lethargy: lethargy
letter: letter,letters
levantine: levantine
level: level,levelled
lever: lever
liability: liability
liable: liable
liar: liar,liars
liberate: liberating
liberation: liberation
liberty: liberty
library: library
licence: licence,licences
license: license,licensed
licensed: licensed
lick: licked
lid: lid
lie: lain,lie,lied,lies,lying
lieu: lieu
lieutenant: lieutenant,lieutenants
life: life,lives
lifeless: lifeless
lifetime: lifetime
lift: lift,lifted
light: light,lighted,lighter,lights
lighten: lightened
lighting: lighting
lightly: lightly
lightning: lightning
lily: lilies
limb: limb,limbs
limbed: limbed
lime: limes
limit: limit,limited,limits
limitation: limitation
limited: limited
limp: limp
limpid: limpid
limply: limply
linen: linen
linger: linger,lingered,lingering
lingua: lingua
link: link,linked,links
linstock: linstock,linstocks
lintel: lintel
lion: lion
lionel: lionel
lioness: lioness
lip: lip,lips
lipped: lipped
liquidation: liquidation
liquor: liquor
lisbon: lisbon
lissom: lissom
list: list,listed,lists
listen: listen,listened,listening
listless: listless
listlessly: listlessly
listlessness: listlessness
literary: literary
lithe: lithe
lithely: lithely
litter: litter
littoral: littoral
live: live,lived,lives,living
lively: lively
livid: livid
lividly: lividly
living: living
lizard: lizard
load: load,loaded,loads
loading: loading
loaf: loaves
loathe: loathe
loathing: loathing
loathly: loathly
loathsome: loathsome
locate: located
location: locations
lock: lock,locked,locking,locks
locust: locust,locusts
lodge: lodged
loftily: loftily
lofty: lofty
log: log,logs
logic: logic
logically: logically
loin: loin
loincloth: loincloth,loincloths
london: london
loneliness: loneliness
lonely: lonely
longing: longing,longings
loom: loomed,looming
loophole: loophole
loose: loose,loosed,loosing
loosely: loosely
loosen: loosen,loosened
lord: lord
lordship: lordship
lose: lose,losing,lost
loser: loser,losers
loss: loss
lot: lot
lotus: lotus
loud: loud,louder
loudly: loudly
lounge: lounged,lounging
lounging: lounging
lousy: lousy
lout: louts
louvre: louvre
love: love,loved,loving
loveliness: loveliness
lovely: lovely
lover: lover
loving: loving
loyal: loyal
loyally: loyally
loyalty: loyalty
lozenge: lozenge
lubberly: lubberly
luck: luck
luckless: luckless
lucky: luckier,lucky
luff: luff,luffed
luke: luke
luminous: luminous
lump: lumps
lung: lungs
lurch: lurched
lure: lure,lured
lurid: lurid
luridly: luridly
lurk: lurk,lurked,lurking
luscious: luscious
lust: lust
lustful: lustful
lustre: lustre
lusty: lustiest,lusty
luxuriate: luxuriating
luxury: luxury
machine: machine
mad: mad
madam: madam
madden: maddened
madman: madmen
madness: madness
magnet: magnet
magnificent: magnificent
magnificently: magnificently
magnify: magnified
mahogany: mahogany
mahomet: mahomet
mahound: mahound
maid: maid
maiden: maiden,maidens
mail: mail
maim: maimed
main: main
mainmast: mainmast
maintain: maintain,maintained,maintaining
maintopmast: maintopmast
majestic: majestic
majestically: majestically
majesty: majesty
majority: majority
maker: maker
malaga: malaga
male: male
malice: malice
malicious: malicious
malign: malign,maligned
maligned: maligned
mallet: mallets
malta: malta
manacle: manacle,manacles
manager: manager
manhood: manhood
manifest: manifest,manifested
mankind: mankind
manned: manned
manner: manner
manoeuvre: manoeuvre,manoeuvred
manor: manor
mansion: mansion
mantelshelf: mantelshelf
mantle: mantle
manufacture: manufacture
manumission: manumissions
manumit: manumit,manumitted
manumitted: manumitted
mar: mar
marble: marble,marbles
march: march,marched
maria: maria
mariner: mariner,mariners
mark: mark,marked,marking,marks
marked: marked
market: market
marksman: marksman,marksmen
marksmanship: marksmanship
marriage: marriage
marry: married,marry
marshal: marshal,marshalled
martial: martial
martyr: martyr
marvel: marvel,marvelled,marvels
marvellous: marvellous
marvellously: marvellously
mask: mask,masked
mass: massed
massive: massive
mast: mast
masted: masted
master: master,mastered
masterful: masterful
masterfulness: masterfulness
mat: mat,matted
match: match
mate: mate,mates
material: material
maternal: maternal
matter: matter,mattered,matters
maudlin: maudlin
mauretanian: mauretanian
maximum: maximum
mayest: mayest
maze: mazed
meadow: meadow
meagre: meagre
meal: meal
meaning: meaning
measure: measure,measured
meat: meat,meats
mecca: mecca
medallion: medallion
meddle: meddle
medicine: medicine
meditate: meditate
mediterranean: mediterranean
medium: medium
medley: medley
meek: meek
meet: meet,meeting,met
meeting: meeting
melancholy: melancholy
mellow: mellow,mellowing
melodious: melodious
melon: melon
memory: memories,memory
menace: menace,menaced
menacing: menacing
mend: mend
menial: menial
mental: mental
mentally: mentally
mention: mention,mentioned,mentions
mentor: mentor
mephitic: mephitic
merchant: merchant,merchants
merchantability: merchantability
merciful: merciful
mercy: mercy
mere: mere
merge: merge,merged
merit: merits
merited: merited
mess: messes
message: message,messages
messenger: messenger
messer: messer
metal: metal
metallic: metallic
metamorphosis: metamorphosis
mete: meted
method: method,methods
michael: michael
middle: middle
midnight: midnight
midsummer: midsummer
mien: mien
mighty: mighty
mild: mild
mildness: mildness
mile: mile,miles
milk: milk
minaret: minaret
mince: mince
mind: mind,minds
minded: minded
mingle: mingle,mingled
minister: minister
minorca: minorca
minute: minute,minutes
minuteness: minuteness
miracle: miracle,miracles
miraculous: miraculous
miraculously: miraculously
mirror: mirror
mirroring: mirroring
mirth: mirth
misanthropist: misanthropist
misanthropy: misanthropy
misbegotten: misbegotten
miscarry: miscarried
mischance: mischance
mischief: mischief
misconception: misconception
miserable: miserable
miserably: miserably
misery: misery
misfortune: misfortune
misgiving: misgivings
misguided: misguided
misjudge: misjudge,misjudged
mislead: mislead,misled
mislike: misliked
misread: misread,misreading
misrepresent: misrepresent
misrepresentation: misrepresentations
mission: mission
mississippi: mississippi
mistake: mistake,mistaken,mistaking
mistaken: mistaken
mistook: mistook
mistress: mistress
mistrust: mistrust,mistrusted,mistrusting
mistrustful: mistrustful
misunderstand: misunderstand,misunderstood
misuse: misusing
mizzen: mizzen
moan: moan,moaned
mob: mob
mock: mock,mocked,mocking
mockery: mockeries,mockery
mockingly: mockingly
mode: mode
model: modelled
moderate: moderate
modesty: modesty
modification: modification
modify: modified
mohammed: mohammed
mole: mole
molest: molested
moment: moment,moments
momentary: momentary
momentous: momentous
money: money,moneys
mongrel: mongrel
monotonous: monotonous
monster: monster
monstrous: monstrous
month: month,months
mood: mood,moods
moodily: moodily
moody: moody
moon: moon
moonlight: moonlight
moor: moor,moored,moors
mooring: moorings
moorish: moorish
moors: moors
mop: mopped
mope: moped,moping
moral: moral
morion: morion,morions
morisco: morisco
morning: morning
morrow: morrow
mort: mort
mortal: mortal
mortally: mortally
mortgage: mortgaged
mortification: mortification
mortified: mortified
mosaic: mosaics
moslem: moslem
mother: mother
motion: motioned
motionless: motionless
motive: motives
motley: motley
mould: mould
mount: mounted,mounting,mounts
mountainous: mountainous
mourn: mourning
mourning: mourning
mouth: mouth,mouths
movement: movement,movements
mud: mudded
mueddin: mueddin
muffle: muffle,muffled
muffled: muffled
muhammad: muhammad
mulberry: mulberries
mule: mule,mules
mull: mulled
mullion: mullioned
mullioned: mullioned
multitude: multitude
mummery: mummery
munitions: munitions
murder: murder,murdered,murdering
murderer: murderer
murderous: murderous
murmur: murmur,murmured,murmuring,murmurs
muscle: muscle,muscles
muscular: muscular
muse: musing
musical: musical
musing: musing,musings
muslim: muslim,muslims
mustering: mustering
mute: mute
mutineer: mutineer,mutineers
mutineers: mutineers
mutinous: mutinous
mutiny: mutiny
mutter: muttered,muttering
muttered: muttered
mutton: mutton
muzzle: muzzles
myriad: myriad
nag: nag
nail: nailed,nails
naked: naked
nape: nape
napkin: napkin
naples: naples
narcissus: narcissus
narrative: narrative
narrow: narrow,narrowed,narrower,narrowing
narrowing: narrowing
nasal: nasal
native: native
natural: natural
naturally: naturally
nature: nature,natures
natured: natured
naught: naught
nauseate: nauseated
navigate: navigate,navigated
navigation: navigation
navigator: navigator
navy: navy
nearer: nearer
necessaries: necessaries
necessity: necessity
neck: neck,necks
necked: necked
neglect: neglect,neglected,neglects
negligence: negligence
negligible: negligible
negress: negress
negro: negro,negroes
neighbour: neighbour,neighbours
neighbourhood: neighbourhood
neighbourly: neighbourly
nephew: nephew
nerve: nerves
nervous: nervous
nervously: nervously
nestle: nestled
nethermost: nethermost
network: network
neutral: neutral
newly: newly
news: news
newsletter: newsletter
nicely: nicely
nicety: nicety
niche: niches
nicholas: nicholas
nick: nick
niggardly: niggardly
nigh: nigh
night: night,nights
nightingale: nightingale
nimble: nimble
nimbleness: nimbleness
nimbus: nimbus
noble: noble
nobly: nobly
nod: nodded,nodding
noisy: noisy
noll: noll
nonproprietary: nonproprietary
noon: noon
noontide: noontide
noose: noose
normal: normal
north: north
northern: northern
northerner: northerners
nose: nose,noses
nosed: nosed
nostalgia: nostalgia
nostril: nostrils
note: note
notice: notice,noticed
notify: notifies
notion: notion,notions
notoriety: notoriety
notorious: notorious
notoriously: notoriously
nourish: nourished
nourished: nourished
nowadays: nowadays
nubian: nubian
numb: numb,numbed
nuptials: nuptials
nurse: nurse,nursing
nymph: nymphs
oak: oak,oaks
oaken: oaken
oar: oar,oars
oarsman: oarsmen
oath: oath,oaths
obedience: obedience
obedient: obedient
obediently: obediently
obey: obey,obeyed,obeying
object: object,objects
objection: objection
objective: objective
obliterate: obliterated
oblivion: oblivion
obscene: obscene
observe: observe,observed,observing
obsolete: obsolete
obstacle: obstacle,obstacles
obvious: obvious
occasion: occasion,occasioned,occasions
occasionally: occasionally
occupation: occupation
occupy: occupied,occupy,occupying
occur: occur,occurred,occurring
ocean: ocean
octagon: octagon
october: october
od: od
odd: odd
oddly: oddly
odds: odds
odious: odious
offal: offal
offence: offence,offences
offend: offended,offending
offender: offender
offer: offer,offered,offering,offers
offering: offering
office: office
officer: officer,officers
official: official
oft: oft
oftener: oftener
oil: oil
ol: ol
olive: olive,olives
oliver: oliver
omen: omened
ominous: ominous
ominously: ominously
omission: omission,omissions
omniscience: omniscience
online: online
onslaught: onslaught
onward: onward
ooze: oozing
opal: opal
openly: openly
opine: opined,opines
opinion: opinion,opinions
opportunely: opportunely
opportunity: opportunities,opportunity
oppose: oppose,opposed,opposing
opposition: opposition
oppress: oppressed,oppressing
oppressed: oppressed
oppression: oppression
oppressor: oppressor
optimism: optimism
orange: orange
orb: orb
orchard: orchard
ordeal: ordeal
ordinary: ordinary
organize: organized
oriental: oriental
origin: origin
original: original
originator: originator
orison: orisons
ornament: ornaments
osprey: osprey
ostentatiously: ostentatiously
ostrich: ostrich
ounce: ounce
outbid: outbid,outbidden
outbidden: outbidden
outburst: outburst,outbursts
outcome: outcome
outcry: outcry
outdated: outdated
outfit: outfit
outlandish: outlandish
outline: outline
outnumber: outnumbered
outrage: outrage,outraging
outraged: outraged
outrageous: outrageous
outrageously: outrageously
outright: outright
outset: outset
outstretched: outstretched
outward: outward
outwardly: outwardly
outwards: outwards
outweigh: outweigh
outwit: outwitted
overbear: overbear
overbearing: overbearing
overboard: overboard
overborne: overborne
overcast: overcast
overcome: overcame,overcome
overdue: overdue
overflow: overflowed
overhang: overhanging,overhung
overhead: overhead
overhear: overhear,overheard
overjoyed: overjoyed
overlong: overlong
overlook: overlook,overlooked,overlooking
overmantel: overmantel
overmuch: overmuch
overpast: overpast
overpower: overpowered
overreach: overreached
overrun: overrun
overseas: overseas
overset: overset
overshadow: overshadow,overshadowing
overspread: overspread
overstate: overstate
overtake: overtake,overtaken,overtaking,overtook
overtax: overtax
overthrow: overthrew,overthrow
overtop: overtopped
overwhelm: overwhelm,overwhelmed,overwhelming
overwhelmed: overwhelmed
overwhelming: overwhelming
overwrought: overwrought
owe: owed
owner: owner
oyster: oyster
pace: pace,paced,paces,pacing
paced: paced
pacing: pacing
pack: pack,packed
padded: padded
pageant: pageants
pain: pain,pains
painless: painless
paint: painting
pair: pair
palace: palace
pale: pale,paled,paling
paling: paling
pallid: pallid
pallor: pallor
palm: palm,palms
palmetto: palmetto
paltriest: paltriest
paltry: paltry
pampered: pampered
pang: pang
panic: panic
pannier: pannier
panoply: panoply
pant: panted
panther: panther
panting: panting
paper: paper
paperwork: paperwork
parade: paraded
paradise: paradise
paragon: paragon
paragraph: paragraph,paragraphs
paralyze: paralyzing
paralyzed: paralyzed
parapet: parapet
parch: parching
parched: parched
parchment: parchment
pardon: pardon
parent: parent,parents
park: park,parks
parliament: parliament
parlour: parlour
parsimony: parsimony
parson: parson
partial: partial
participate: participated,participating
particulars: particulars
partition: partition
partly: partly
partner: partner,partners
partridge: partridge
party: party
pasha: pasha
pass: pass,passed,passes,passing
passage: passage
passing: passing
passion: passion
passionate: passionate
passivity: passivity
pastime: pastime
pasture: pasture
pat: patted
paternal: paternal
path: path
patience: patience
patient: patient
patiently: patiently
patrimony: patrimony
patron: patrons
patter: patter,pattered,pattering
paunch: paunch
pause: pause,paused,pausing
pave: paved
pavilion: pavilions
pay: paid,pay,paying
payer: payers
payment: payment,payments
peace: peace
peaceful: peaceful
peak: peak,peaks
peal: peal
pear: pear
pearl: pearl,pearls
pearliness: pearliness
pearly: pearly
peasant: peasant
pediment: pediment
pedlar: pedlar
peel: peeling
peep: peep,peeped,peeping,peeps
peeping: peeping
peer: peer,peered,peering
pellucid: pellucid
pen: pen,penned,pens,pent
penalty: penalty
penance: penance
pencil: pencilled
penetrate: penetrating
penetration: penetration
penitence: penitence
pennant: pennant
pensive: pensive
pensively: pensively
penthouse: penthouse
perceive: perceive,perceived,perceiving
perception: perceptions
perchance: perchance
perdition: perdition
peremptorily: peremptorily
peremptory: peremptory
perfect: perfect
perfecting: perfecting
perfectly: perfectly
perfervidly: perfervidly
perforce: perforce
perform: perform,performed,performing
performance: performance,performances
perfume: perfume,perfumes
perfumed: perfumed
perfunctorily: perfunctorily
peril: peril,perils
perilous: perilous
period: period,periods
periodic: periodic
perish: perish,perished
permanent: permanent
permanently: permanently
permission: permission
permit: permit,permits,permitted
perpetual: perpetual
perpetuate: perpetuate
perplex: perplexed
persecute: persecute
persecution: persecution
persevere: persevere
persian: persian
persist: persist,persisted,persisting
persistence: persistence
persistent: persistent
person: people,person
personal: personal
personality: personality
perspective: perspective
perspicuity: perspicuity
perspicuous: perspicuous
persuade: persuade,persuaded
persuasion: persuasions
pert: pert
perturb: perturb,perturbed
perturbation: perturbation
pervadingly: pervadingly
perverseness: perverseness
pervert: perverted
perverter: perverter
pet: pet
petal: petals
peter: peter
petition: petition,petitioned
petty: petty
petulance: petulance
petulant: petulant
petulantly: petulantly
philip: philip
philosophical: philosophical
phrase: phrase
physical: physical
pick: picked,picking
picture: picture
picturesque: picturesque
piece: piece,pieces
pierce: pierce,pierced,pierces
piety: piety
pig: pig,pigs
pigeon: pigeons
pike: pike,pikes
pilaster: pilastered
pile: pile,piled
pillar: pillar
pillared: pillared
pillow: pillows
pimpish: pimpish
pincers: pincers
pinion: pinioned,pinions
pink: pink
pint: pint
pious: pious
pipe: pipe,piped
piracy: piracy
pirate: pirate,pirates
piratical: piratical
pish: pish
pit: pit
pitch: pitch
pitching: pitching
piteous: piteous
pitiful: pitiful
pitifully: pitifully
pitiless: pitiless
pitilessness: pitilessness
pity: pity,pitying
plague: plague,plagued
plaguily: plaguily
plain: plain,plainer
plainly: plainly
plaint: plaint,plaints
plaintive: plaintive
plaintively: plaintively
plaited: plaited
plan: plan,planned,plans
plank: plank
plant: planted
plantation: plantations
plate: plates
platform: platform
platter: platter,platters
play: play,played,playing,plays
plaything: plaything
plea: plea
plead: plead,pleaded,pleading
pleading: pleading,pleadings
pleasant: pleasant
pleasantry: pleasantries
pleased: pleased
pleasing: pleasing
pleasure: pleasure
pledge: pledge,pledged
plentiful: plentiful
plight: plight,plighted
plot: plot,plots
plough: ploughed,ploughing
pluck: pluck,plucked,plucking
plucking: plucking
plumb: plumb
plumbing: plumbing
plume: plume,plumes
plumed: plumed
plump: plump
plunder: plunder,plundering
plunge: plunge,plunged,plunging
ply: plied,ply,plying
pocket: pocket,pocketing
poet: poet
poetic: poetic
poetically: poetically
poignantly: poignantly
poise: poised
poison: poison,poisoned,poisoning
poisonous: poisonous
policy: policy
polished: polished
pomander: pomander
pomegranate: pomegranate
ponder: ponder,pondered,pondering
pondered: pondered
poniard: poniard
pooh: pooh
pool: pool
poop: poop,poops
poor: poor
poplar: poplars
por: por
porous: porous
port: port,ports
portal: portal
portend: portend
portentously: portentously
porter: porter,porters
portion: portion
portly: portly
portrait: portrait,portraits
portugal: portugal
position: position,positions
positive: positive
possess: possess,possessed
possession: possession,possessions
posset: posset
possibility: possibility
post: post,posted,posts
postern: postern
postpone: postpone
pot: pot
potent: potent
pounce: pounced
pound: pound,pounded,pounds
pour: pour,poured,pouring
powder: powder
power: power
powerful: powerful
powerless: powerless
practical: practical
practically: practically
practice: practice
practise: practise,practised
praise: praise,praised,praises
prate: prate
pray: pray,prayed,praying
prayer: prayer,prayers
preach: preach,preaches
prearrange: prearranged
precaution: precaution,precautions
precede: preceded
preceptor: preceptor
precious: precious
precipitate: precipitate,precipitated
precise: precise
precisely: precisely
preclude: precluded
preconceive: preconceived
preconcerted: preconcerted
predestined: predestined
predilection: predilection,predilections
prefer: prefer,preferred,preferring
preferment: preferment
pregnant: pregnant
pregnantly: pregnantly
prelate: prelate
preliminary: preliminary
prelude: prelude
premeditated: premeditated
premonitory: premonitory
preparation: preparation,preparations
preparatory: preparatory
prepare: prepare,prepared,preparing
preposterous: preposterous
prescience: prescience
prescribe: prescribes
presence: presence
presently: presently
preserve: preserve,preserved
preside: preside,presided,presiding
press: press,pressed,pressing
pressed: pressed
pressure: pressure
presume: presume,presumed
presumption: presumption
presumptuous: presumptuous
pretence: pretence
pretend: pretend,pretended,pretending
preternaturally: preternaturally
pretext: pretext
pretty: pretty
prevail: prevail,prevailed,prevailing
prevent: prevent,prevented
previous: previous
prey: prey,preyed
price: price,prices
prick: prick
pride: pride
priest: priest
prime: prime,primed
prince: prince,princes
print: print,printed
prise: prised
prison: prison
prisoner: prisoner,prisoners
private: private
privilege: privilege
prize: prize
probability: probability
probable: probable
probe: probe
proceed: proceed,proceeded,proceeds
proceedings: proceedings
process: process
processing: processing
procession: procession
proclaim: proclaim,proclaimed,proclaiming
procure: procure,procured
prodigal: prodigal
prodigality: prodigality
prodigious: prodigious
prodigy: prodigies
produce: produce,produced
production: production
profanity: profanity
profess: profess,professed
professor: professor
proffer: proffered
profit: profit,profited,profits
profitable: profitable
profound: profound,profoundest
profoundly: profoundly
profusely: profusely
prognostication: prognostication
progress: progress
prohibition: prohibition
project: project,projected,projecting
prolific: prolific
prolixity: prolixity
prominence: prominence
prominent: prominent
prominently: prominently
promise: promise,promised,promises
promontory: promontory
promote: promoting
promotion: promotion
prompt: prompt,prompted,prompting,prompts
prompting: promptings
prone: prone
proneness: proneness
pronounce: pronounce,pronounced
pronounced: pronounced
pronouncement: pronouncement
proof: proof,proofs
proofread: proofread
proper: proper
properly: properly
property: property
prophesy: prophesy
prophet: prophet
propitious: propitious
proportion: proportion,proportions
proposal: proposal,proposals
propose: propose,proposed,proposing
proprietary: proprietary
prospect: prospect
prospective: prospective
prosper: prosper,prospered
prosperity: prosperity
prosperous: prosperous
prostrate: prostrate,prostrated
protect: protect,protected,protects
protection: protection
protector: protector,protectors
protest: protest,protested,protesting,protests
protestation: protestation,protestations
protract: protract,protracted
protrude: protruding
proudly: proudly
prove: prove,proved,proven,proves,proving
provide: provide,providing
provision: provision,provisions
provocation: provocation
provoke: provoke,provoked,provoking
prow: prow
prowess: prowess
prudence: prudence
prune: prunes
pshaw: pshaw
public: public
publication: publication
publish: publish
pull: pull,pulled,pulling
pulp: pulp
pulse: pulse
pummel: pummelled
pump: pumped
pungent: pungent
punish: punish,punished
punishable: punishable
punishment: punishment
punitive: punitive
pup: pup
pupil: pupil
purchase: purchase,purchased,purchases
purchaser: purchaser
pure: pure
purely: purely
purge: purged
purify: purified
purple: purple
purport: purport
purpose: purpose,purposes
purse: purse,pursed
pursue: pursue,pursued
pursuit: pursuit
quadrangle: quadrangle
quadrangular: quadrangular
quail: quailed,quailing
quaking: quaking
qualified: qualified
quality: qualities,quality
quarrel: quarrel,quarrelled,quarrelling,quarrels
quarrelsome: quarrelsome
quarry: quarry
quarter: quarter,quarters
quartering: quarterings
quaver: quaver,quavering
queen: queen,queened
queer: queer
quell: quell,quelled
quench: quench,quenched,quenching
querulously: querulously
quest: quest
questing: questing
question: question,questioned,questioning,questions
questioning: questioning
quibble: quibble
quick: quick
quicken: quicken,quickened,quickening
quiet: quiet,quieting
quietly: quietly
quit: quit,quits,quitted,quitting
quits: quits
quiver: quiver,quivered,quivering
quote: quote
quoth: quoth
rabble: rabble
race: race,raced,races,racing
racing: racing
rack: rack,racked
radiance: radiance
rafael: rafael
rag: rags
rage: rage,rages,raging
ragged: ragged
raid: raid,raided,raiding,raids
raider: raider
raiding: raiding
rail: rail
raiment: raiment
rain: rain,rains
rainbow: rainbow
raise: raise,raised,raising
rally: rallied,rally
ralph: ralph
ram: ram
ramble: rambled
rancour: rancour
range: range,ranged
rank: rank,ranks
rankle: rankled,rankling
ransom: ransom,ransoming
rap: rapped
rapid: rapid
rapidly: rapidly
rapier: rapier
rare: rare
rarely: rarely
rascal: rascal,rascals
rascally: rascally
rash: rash
rashly: rashly
rasp: rasped
rat: rat,rats
rate: rate
rating: rating
ration: rations
ratlin: ratlines
ratline: ratline
rave: raved
ravish: ravished
ravisher: ravisher
ray: ray,rays
reach: reach,reached,reaching
reaction: reaction,reactions
read: read,reading
readable: readable
readiness: readiness
reading: reading
readjust: readjusted
ready: ready
real: real
realization: realization
realize: realize,realized,realizing
reaper: reaper
reappear: reappeared
reappearance: reappearance
rear: rear,reared
reason: reason,reasoned,reasons
reasonable: reasonable
reasonableness: reasonableness
reasoning: reasoning
reassuring: reassuring
rebel: rebel
rebellion: rebellion
rebellious: rebellious
rebuff: rebuff
rebuild: rebuild
rebuke: rebuke,rebuked,rebuking
rebut: rebutted
recall: recall,recalled,recalling
recede: receding
receipt: receipt
receive: receive,received,receiving
reception: reception
recipient: recipient
recital: recitals
recite: recite,recited,reciting
reck: reck,recking,recks
reckless: reckless
recklessness: recklessness
reckon: reckon
reckoning: reckoning
recline: reclined,reclining
recognition: recognition
recognize: recognize,recognized,recognizing
recoil: recoiled,recoiling,recoils
recollection: recollection
recommendation: recommendation
recompense: recompense
reconciliation: reconciliation
reconstruct: reconstruct
record: recorded
recourse: recourse
recover: recover,recovered,recovering
recovery: recovery
recruit: recruit,recruits
red: red
redden: reddening
redeem: redeem,redeemed
redistribute: redistribute,redistributing
redistributing: redistributing
redistribution: redistribution
redouble: redoubled
redoubtable: redoubtable
reduce: reduce,reduced,reducing
reed: reed
reef: reef,reefed,reefs
reek: reek,reeking
reel: reel,reeled,reeling
reenter: reenter
refect: refected
refer: refer,referring
reference: references
reflect: reflect,reflected,reflecting
reflection: reflection
reflectively: reflectively
refrain: refrained,refrains
refresh: refreshed
refuge: refuge
refugee: refugees
refund: refund
refusal: refusal
refuse: refuse,refused,refuses,refusing
regal: regal
regard: regard,regarded
regiment: regiment
register: registered
regret: regret,regretted,regretting
regular: regular
regulate: regulating
rehabilitation: rehabilitation
rein: rein,reins
reinstatement: reinstatement
reis: reis
reject: reject,rejected
rejection: rejection
rejoice: rejoice,rejoicing
rejoin: rejoined
relate: relate
relation: relation,relations
relax: relaxed
relaxed: relaxed
release: release,released
relentless: relentless
relentlessly: relentlessly
relentlessness: relentlessness
relief: relief
relieve: relieved,relieving
relieved: relieved
religion: religion,religions
religious: religious
relinquish: relinquish,relinquished,relinquishing
reluctance: reluctance
reluctant: reluctant
reluctantly: reluctantly
remain: remain,remained,remaining,remains
remains: remains
remark: remark,remarked
remarkable: remarkable
remedy: remedies,remedy
remember: remember,remembered,remembering
remind: remind,reminded,reminding
reminder: reminder
reminiscence: reminiscences
reminiscent: reminiscent
remonstrance: remonstrance,remonstrances
remonstrate: remonstrate,remonstrated
remorse: remorse
remote: remote
removal: removal
remove: remove,removed,removing
rename: renamed
rend: rend
render: render,rendered
renegade: renegade,renegades
renegado: renegado,renegadoes
renew: renew,renewed
renounce: renounce
renown: renown
rent: rent
reopen: reopen,reopened
repair: repair,repaired,repairing
reparation: reparation
repast: repast
repay: repaid,repay
repeat: repeat,repeated,repeating
repel: repel,repelled
repellent: repellent
repent: repented
repentance: repentance
repercussion: repercussion
repine: repine,repining
replace: replace,replaced,replacing
replacement: replacement
reply: replied,reply,replying
report: report,reported,reporting,reports
repose: reposed
represent: represented,represents
representation: representations
representative: representative
repress: repress,repressed
reproach: reproach,reproached,reproaching
reproachful: reproachful
reproof: reproof
reprove: reproved
reputation: reputation
repute: repute
reputed: reputed
request: request
require: require,required
requirement: requirements
rescue: rescue,rescued
resent: resent,resenting
resentful: resentful
resentment: resentment,resentments
reserve: reserve,reserves
reside: reside
residence: residence
resign: resigned
resignedly: resignedly
resist: resist,resisted
resistance: resistance
resolute: resolute
resolutely: resolutely
resolve: resolve,resolved,resolves
resounding: resounding
resource: resources
respect: respect,respected
respectfully: respectfully
respite: respite
resplendent: resplendent
respond: respond,responding
response: response
responsibility: responsibility
responsible: responsible
responsive: responsive
rest: rest,rested,resting,rests
restorative: restoratives
restore: restore,restored
restrain: restrain,restrained,restraining
restraint: restraint
restriction: restrictions
result: result
resume: resume,resumed
resumption: resumption
retail: retailed
retain: retain,retained
retaliate: retaliate
reticence: reticence
retinue: retinue
retirement: retirement
retort: retort,retorted
retrace: retrace
retreat: retreat
retribution: retribution
retro: retro
return: return,returned,returning,returns
reveal: revealed,revealing,reveals
revelation: revelation,revelations
revelatory: revelatory
revenge: revenge
revenue: revenue
reverence: reverence
reverently: reverently
revert: reverted,reverting
review: reviewed
revile: reviled,reviling
revive: revive,revived,reviving
revolt: revolt
revolting: revolting
revulsion: revulsion
reward: reward,rewarded
rhythmically: rhythmically
rib: ribs
ribald: ribald
rice: rice
rich: rich,richer
riches: riches
richly: richly
rid: rid
riddle: riddle
riddled: riddled
ride: ridden,ride,rides,riding,rode
ridicule: ridicule
riding: riding
rift: rift
rig: rigged
righteous: righteous
rightly: rightly
rigidity: rigidity
rigidly: rigidly
rim: rim
rinse: rinsed
riot: riot,rioted
rip: ripped
ripe: ripe
ripen: ripening
riposte: riposte
ripple: rippled,rippling
rise: rise,risen,rising,rose
risk: risk,risked,risking,risks
rival: rival
rivalry: rivalry
river: river,rivers
rivet: rivet
road: road,roads
roam: roamed
roar: roar,roared,roaring
roasted: roasted
rob: rob,robbed
robber: robber
robbery: robbery
robe: robed,robes
robed: robed
robust: robust
rock: rock,rocked,rocking,rocks
rocky: rocky
rod: rod,rods
roger: roger
rogue: rogue,rogues
roll: rolled,rolling
rolling: rolling
roman: roman
roof: roof
root: root,roots
rope: rope,ropes
rose: rose,roses
rosebush: rosebush
rosy: rosy
rot: rot
rotten: rotten
rottenness: rottenness
rough: rough
roughly: roughly
roughness: roughness
rounded: rounded
rouse: rouse,roused
rousing: rousing
route: routed
rove: rove,roving
rover: rover,rovers
roving: rovings
row: row,rowed,rows
rower: rower,rowers
rowing: rowing
royal: royal
royalty: royalties,royalty
rub: rub,rubbed
rubbish: rubbish
ruddily: ruddily
ruddy: ruddy
rude: rude
rudeness: rudeness
ruffian: ruffians
ruffianly: ruffianly
ruffle: ruffle,ruffled,ruffling
rugged: rugged
ruin: ruin,ruined
rule: rule,ruled,rules
rumble: rumbling
rumour: rumour
runnel: runnels
ruse: ruse
rush: rush
rustic: rustic,rustics
rustle: rustle
rustling: rustling
ruthless: ruthless
ruthlessness: ruthlessness
sable: sable
sacerdotal: sacerdotal
sack: sack
sacrament: sacrament
sacred: sacred
sacrifice: sacrifice,sacrificed,sacrifices
sad: sad
sadden: saddened
saddle: saddle
sadly: sadly
safe: safe,safer
safely: safely
safety: safety
sail: sail,sailed,sailing,sails
sailing: sailing
sailor: sailor,sailors
saint: saint
saintly: saintly
sake: sake
salaam: salaam,salaamed,salaaming,salaams
salaaming: salaaming
sale: sale
salient: salient
sallow: sallow
sally: sallied,sally
salt: salt
salute: salute
salvation: salvation
samphire: samphire
san: san
sanbenito: sanbenito
sanctify: sanctified
sanction: sanction
sanctuary: sanctuary
sandalwood: sandalwood
sandy: sandy
sane: sane
sanity: sanity
sapphire: sapphire,sapphires
sardonic: sardonic
satan: satan
satisfaction: satisfaction
satisfied: satisfied
satisfy: satisfies,satisfy,satisfying
saunter: sauntered
savagely: savagely
save: save,saved,saving
saviour: saviour
savour: savour,savouring
savoury: savoury
sayest: sayest
scan: scan,scanned,scanning
scandal: scandal
scant: scant
scar: scar,scarred,scars
scarce: scarce
scarcely: scarcely
scare: scared
scared: scared
scarf: scarf,scarves
scarlet: scarlet
scarred: scarred
scatter: scattered
scavenge: scavenging
scene: scene,scenes
scent: scented,scenting
scented: scented
sceptical: sceptical
scholar: scholar
school: school,schooled
scimitar: scimitar,scimitars
scoff: scoffed
sconce: sconces
scope: scope
score: score
scorn: scorn,scorned
scornful: scornful
scornfully: scornfully
scorpion: scorpions
scour: scour,scoured
scourge: scourge
scowl: scowl,scowled,scowling
scrap: scrap
scratch: scratch
scream: scream,screamed
screech: screeching
screen: screen,screened,screening
screening: screening
scrimmage: scrimmage
scripture: scriptures
scrub: scrubbed
scrupulous: scrupulous
scrupulously: scrupulously
scrutinize: scrutinize,scrutinizing
scrutiny: scrutiny
scurry: scurrying
scurvy: scurvy
scuttle: scuttled,scuttling
scylla: scylla
sdeath: sdeath
sea: sea,seas
seaboard: seaboard
seagull: seagulls
seal: seal,sealed
seaman: seaman,seamen
seamen: seamen
search: search,searching
searchingly: searchingly
season: season
seasoning: seasoning
seat: seat,seated
seaward: seaward
secluded: secluded
seclusion: seclusion
secret: secret,secrets
secretly: secretly
secular: secular
secure: secure
securely: securely
security: security
sedge: sedges
seductive: seductive
seed: seed
seek: seek,seeking,sought
seeker: seekers
seemly: seemly
seethe: seething
seething: seething
seize: seize,seized
selfish: selfish
selfishness: selfishness
sell: sell,sold
seller: seller
send: send,sending,sends
senor: senor
senora: senora
sensation: sensations
sense: sense
senseless: senseless
sensibly: sensibly
sensuous: sensuous
sentence: sentence
sentinel: sentinel
separate: separate,separating
september: september
serene: serene
serenely: serenely
serpent: serpent
serried: serried
servant: servant,servants
serve: serve,served,serves,serving
service: service
serviceable: serviceable
servitude: servitude
set: set,sets,setting
setting: setting
settle: settle,settled,settling
seventeen: seventeen
sever: severing
sex: sex
shackle: shackled,shackles
shade: shade,shaded
shadow: shadow,shadows
shadowy: shadowy
shaft: shaft,shafts
shaggy: shaggy
shaitan: shaitan
shake: shake,shaken,shaking,shook
shallow: shallow
shalt: shalt
shame: shame,shamed,shames
shameful: shameful
shamefully: shamefully
shamelessness: shamelessness
shank: shanked,shanks
shanked: shanked
shape: shape,shaped
shapely: shapely
share: share,shared,sharing
sharp: sharp,sharper
sharply: sharply
shatter: shattered
shave: shaved
shaven: shaven
sheath: sheath
sheathe: sheathe,sheathed
sheep: sheep
sheepskin: sheepskin,sheepskins
sheer: sheer
sheet: sheet
sheik: sheik
shelf: shelf,shelves
shelter: shelter,sheltered,sheltering
sherbet: sherbet
sherry: sherry
shield: shield
shift: shift,shifted,shifting,shifts
shifting: shifting
shilha: shilha
shimmering: shimmering
shine: shine,shone
ship: ship,ships
shirt: shirt
shiver: shivered
shock: shock
shocked: shocked
shocking: shocking
shoe: shod,shoe,shoes
shoot: shoot,shoots,shot
shooting: shooting,shootings
shore: shore,shores
short: short,shorter
shortcoming: shortcomings
shorten: shorten
shortly: shortly
shot: shot,shots
shoulder: shoulder,shoulders
shouldst: shouldst
shout: shout,shouted,shouting,shouts
shower: shower,showered
shred: shreds
shrew: shrew
shrewd: shrewd
shrewdly: shrewdly
shrewish: shrewish
shriek: shriek
shrill: shrill,shrilled
shrink: shrank
shrinking: shrinking
shroud: shroud,shrouded,shrouds
shrug: shrug,shrugged
shrugging: shrugging
shrunken: shrunken
shudder: shuddered,shuddering
shuddering: shuddering
shuffle: shuffled
shuffling: shuffling
shut: shut
shutter: shutters
shuttle: shuttle
sicilian: sicilian
sicily: sicily
sick: sick
sickle: sickle
sidelong: sidelong
sidle: sidled
sigh: sigh,sighed
sighing: sighing
sight: sight,sighted
sign: sign,signed,signs
signal: signal,signalled
signature: signature
significance: significance
signify: signifies,signify
silence: silence,silenced
silent: silent
silently: silently
silhouetted: silhouetted
silk: silk,silks
silken: silken
sill: sill
silver: silver
silvery: silvery
simper: simper
simple: simple
simpleton: simpleton
simplicity: simplicity
simply: simply
simulate: simulated
sin: sin,sinned,sins
sincerity: sincerity
sinew: sinew,sinews
sinewy: sinewy
sinful: sinful
sing: sang,sing
singing: singing
single: single,singled
singular: singular
singularly: singularly
sinister: sinister
sink: sank,sink,sinking,sunk,sunken
sinner: sinner
sinuous: sinuous
sir: sir,sirs
sire: sire
siren: siren
sirrah: sirrah
sister: sister
sit: sat,sit,sitting
situate: situated
situation: situation
sixteen: sixteen
size: size
sizzle: sizzling
skilfully: skilfully
skill: skill
skilled: skilled
skim: skimmed,skimming
skin: skin,skinned
skinful: skinful
skinned: skinned
skipper: skipper
skull: skull
sky: skies,sky
slack: slack
slacken: slackened
slam: slammed
slant: slanting
slap: slapped
slash: slashed
slave: slave,slaves
slavery: slavery
slavish: slavish
slay: slain,slay
slayer: slayer
slaying: slaying
sleek: sleek
sleep: sleep,sleeping,slept
sleeper: sleeper
sleepless: sleepless
sleeplessness: sleeplessness
sleeve: sleeve,sleeves
slender: slender
slew: slew
slide: slide
slight: slight,slightest
slim: slim
sling: slung
slink: slinking
slip: slipped,slipping
slipper: slipper,slippers
slippered: slippered
slippery: slippery
slit: slit
slope: slope,slopes
slow: slow
slowly: slowly
sluggish: sluggish
sluggishly: sluggishly
slumber: slumber,slumbering
slumbering: slumbering
sly: sly
slyly: slyly
smash: smashed
smear: smear,smeared
smell: smell,smelt
smile: smile,smiled,smiles,smiling
smirch: smirch
smite: smite,smitten,smote
smith: smith
smoke: smoke,smoking
smoking: smoking
smooth: smooth,smoothed,smoother
smoothly: smoothly
smote: smote
smother: smother
smoulder: smouldered,smouldering
smouldering: smouldering
smuggle: smuggle
snake: snakes
snap: snap,snapped
snarl: snarl,snarled,snarling
snatch: snatch,snatched
sneer: sneer,sneered,sneering
sneering: sneering
sniff: sniffs
snore: snoring
snort: snort
snow: snow,snows
snowy: snowy
snug: snug
soar: soared
soaring: soarings
sob: sob,sobbed,sobs
sober: sober
soberly: soberly
sodden: sodden
soft: soft,softer,softest
soften: soften,softened
softly: softly
softness: softness
soho: soho
soil: soil
sojourn: sojourn
soldier: soldier,soldiers
sole: sole
solemn: solemn
solemnity: solemnity
solemnly: solemnly
solicit: solicit,soliciting
solicitation: solicitation
solitary: solitary
solve: solved
sombre: sombre
sombrely: sombrely
son: son,sons
song: song
soothe: soothe,soothing
soothing: soothing
sophistry: sophistry
sordid: sordid
sore: sores
sorely: sorely
sorrow: sorrow
sorrowfully: sorrowfully
sorrowing: sorrowing
sort: sort
sough: sough
soul: soul,souls
soulless: soulless
sound: sound,sounded,sounding,sounds
sounder: sounder
soundly: soundly
sour: sour,soured
source: source,sources
sourly: sourly
south: south
southern: southern
southward: southward
sovereign: sovereign
sow: sowed,sown
space: space,spaces
spacious: spacious
spain: spain
span: span
spaniard: spaniard
spaniards: spaniards
spanish: spanish
spar: spars
spare: spare,spared,sparing
sparingly: sparingly
spark: spark
sparkle: sparkled
spatter: spattered
speak: speak,speaking,speaks,spoke,spoken
spear: spear,spears
spearlike: spearlike
special: special
specially: specially
specie: specie
specious: specious
speck: speck
spectacle: spectacle
spectator: spectator,spectators
speech: speech
speechless: speechless
speed: sped,speed,speeding
speedily: speedily
speedy: speedy
spell: spell,spells
spelling: spelling
spend: spend,spending,spent
spice: spices
spike: spike
spin: spun
spirit: spirit
spiritless: spiritless
spit: spat,spit
spite: spite
splash: splash,splashed
splendid: splendid
splendour: splendour
splintering: splintering
split: split,splitting
spoil: spoil,spoils
spoke: spoke
sponsor: sponsor
sport: sport
spot: spot,spots,spotted
spotless: spotless
sprawl: sprawled,sprawling
spread: spread,spreading
spring: sprang,spring,springing,springs,sprung
sprinkle: sprinkle
spur: spur,spurred,spurs
spurn: spurned
spy: spy
spying: spying
square: square
squarely: squarely
squat: squat,squatted,squatting
squeal: squealed
squelch: squelched
squirm: squirmed
stab: stab,stabbed
stable: stabled,stables
stack: stacked
staff: staff
stagger: staggered,staggering
stain: stain,stained,stains
stair: stair,stairs
staircase: staircase
stake: stake,staked,stakes
stale: stale
stalk: stalked,stalking
stalwart: stalwart
stamp: stamped
stanch: stanch
stand: stand,standing,stands,stood
standard: standard
staple: staple
star: star,stars
starboard: starboard
stare: stare,stared,staring
stark: stark
starred: starred
start: start,started
startle: startled,startling
startled: startled
startlingly: startlingly
stately: stately
statement: statement,statements
station: station,stationed
statue: statues
statuesque: statuesque
status: status
staunch: staunch
stave: staves
stay: stay,stayed
stead: stead
steadfast: steadfast
steadily: steadily
steady: steady
stealthy: stealthy
steam: steaming
steel: steel
steely: steely
steer: steer,steering
steering: steering
steersman: steersmen
steersmen: steersmen
stem: stemming
stench: stench
step: step,stepped,stepping,steps
stern: stern
sternly: sternly
sternness: sternness
stertorous: stertorous
stew: stew
stiff: stiff
stiffen: stiffen,stiffened
stiffly: stiffly
stifle: stifle,stifled
stillness: stillness
stimulate: stimulated
sting: stung
stinger: stingers
stir: stir,stirred,stirring
stirring: stirring
stirrup: stirrup,stirrups
stitch: stitch
stock: stock
stoicism: stoicism
stolid: stolid
stomach: stomach,stomachs
stone: stone,stoned,stones
stony: stony
stool: stool
stoop: stooped,stooping
stopper: stopper
store: store,stored,stores
storied: storied
stork: stork
storm: storm,stormed
stormy: stormy
story: stories,story
stout: stout,stouter,stoutest
stoutly: stoutly
straggle: straggled,straggling
straight: straight
straighten: straightening
straightly: straightly
straightway: straightway
strain: strain,strained,straining
strained: strained
strait: straits
straits: straits
strand: strand,strands
strange: strange
strangely: strangely
strangle: strangle,strangled
stray: stray,strayed
streak: streak,streaks
stream: stream,streamed,streams
street: streets
strength: strength
strengthen: strengthen
stress: stress
stretch: stretch,stretched,stretches
stretcher: stretcher
strew: strewn
stricken: stricken
strict: strict
strictly: strictly
stricture: stricture
stride: stride,strode
strife: strife
strike: strike,strikes,striking,struck
striking: striking
strip: strip,strips
stripe: stripe
stripling: stripling
strive: strive,striving
stroke: stroke,stroked,strokes,stroking
strong: strong,stronger
structure: structures
struggle: struggle,struggled,struggles,struggling
strumpet: strumpet
stuart: stuart
stubble: stubble,stubbled
stubborn: stubborn
stud: studded
student: student
studiously: studiously
study: studied,study
stuff: stuff
stumble: stumble,stumbled
stun: stun,stunned
stunt: stunted
stupidity: stupidity
stupidly: stupidly
stupor: stupor
sturdy: sturdy
suasion: suasion
subconscious: subconscious
subconsciously: subconsciously
subconsciousness: subconsciousness
subdued: subdued
subject: subject,subjected,subjects
sublime: sublime
submission: submission
submissive: submissive
submit: submit,submitted,submitting
suborn: suborned
subscribe: subscribe
subsequent: subsequent
substance: substance
substantiate: substantiated
subterfuge: subterfuge
subtle: subtle
subtlety: subtlety
subtract: subtract
succeed: succeed,succeeded,succeeding
success: success
successful: successful
succession: succession
successor: successor
succumb: succumbed
suck: sucked,sucks
sudden: sudden
suddenly: suddenly
suddenness: suddenness
sue: sue,suing
suffer: suffer,suffered,suffering
suffering: suffering,sufferings
suffice: suffice,sufficed,suffices
sufficient: sufficient
suffocate: suffocating
suffuse: suffuse,suffused
suggestion: suggestion,suggestions
suggestive: suggestive
suit: suit,suits
suitable: suitable
suited: suited
suitor: suitor
suk: suk
sulking: sulking
sulky: sulky
sullen: sullen
sullenly: sullenly
sullenness: sullenness
sultan: sultan,sultans
sum: sum,summed
summarize: summarized
summary: summary
summer: summer
summit: summit
summon: summon,summoned,summoning
summons: summons
sun: sun,sunning
sunburned: sunburned
sunken: sunken
sunlight: sunlight
sunlit: sunlit
sunny: sunnier,sunny
sunrise: sunrise
sunset: sunset
sunshine: sunshine
supercilious: supercilious
superficial: superficial
superfluous: superfluous
superhuman: superhuman
superintend: superintending
superior: superior
supersede: superseded
superseding: superseding
supervision: supervision
supine: supine
supper: supper
supping: supping
supple: supple
supplement: supplemented
supplest: supplest
suppliant: suppliant
supply: supplied,supply
support: support,supported,supporting
suppose: suppose,supposed,supposing
supposition: supposition
suppress: suppressed,suppressing
supreme: supreme
supremely: supremely
surcharge: surcharged
surely: surely
surety: surety
surface: surface
surfeit: surfeit
surge: surge,surged
surgeon: surgeon
surmise: surmise
surmount: surmounted
surpass: surpassing
surprise: surprise,surprised
surprised: surprised
surprising: surprising
surprisingly: surprisingly
surrender: surrender,surrendered
surround: surround,surrounded,surrounding
survey: surveyed
survive: survive,survived,surviving
survivor: survivor
sus: sus
suspect: suspect,suspected,suspecting,suspects
suspense: suspense
suspicion: suspicion,suspicions
suspicious: suspicious
suspiciously: suspiciously
sustain: sustain,sustained
swaddle: swaddling
swain: swain,swains
swallow: swallow,swallowed
swamp: swamp
swarm: swarmed,swarming,swarms
swarthier: swarthier
swarthiness: swarthiness
swarthy: swarthy
swathe: swathed
sway: sway,swayed,swaying
swear: swear,swore,sworn
sweat: sweat,sweated,sweating
sweep: sweeping,swept
sweeping: sweeping
sweet: sweet,sweets
sweetheart: sweetheart
sweetly: sweetly
swell: swelled,swelling,swollen
swift: swift,swifter
swiftly: swiftly
swim: swam,swim,swimming
swimmer: swimmer
swimming: swimming
swine: swine
swing: swing,swinging,swung
swinging: swinging
swirl: swirl
swish: swish
swoon: swoon,swooned,swooning
swoop: swoop
sword: sword,swords
swordsman: swordsmen
swounds: swounds
sycophant: sycophant
syllable: syllable
sylvan: sylvan
symbolic: symbolic
sympathy: sympathy
synonymous: synonymous
systematically: systematically
table: table,tables
tacit: tacit
tack: tack
tackle: tackling
tactical: tactical
tagus: tagus
tail: tail,tails
tailor: tailoring
taint: taint
tale: tale,tales
talent: talents
talk: talk,talked,talking,talks
tall: tall,taller
tallowy: tallowy
talon: talons
tame: taming
tan: tan,tanned
tangled: tangled
tap: tap,tapping
taper: taper
tapestry: tapestries
tapia: tapia
tar: tar
tardily: tardily
tardy: tardy
tarry: tarried,tarry
tartly: tartly
task: task,tasks
taste: taste,tasted,tastes,tasting
taunt: taunt,taunted,taunting,taunts
taut: taut
tavern: tavern
tawny: tawny
tax: tax,taxed,taxes
te: te
teach: taught,teach,teaching
tear: tear,tears,tore,torn
tedious: tedious
telling: telling
temerity: temerity
temp: tempest
temper: temper,tempered
temperament: temperament
temple: temples
temporarily: temporarily
temptation: temptation
temptingly: temptingly
tenant: tenanted,tenants
tend: tend,tended
tender: tender
tenderness: tenderness
tenet: tenets
tenor: tenor
tense: tense
tensely: tensely
tent: tents
tentatively: tentatively
tenuous: tenuous
tepid: tepid
term: term,terms
terrace: terrace,terraces
terrible: terrible
terribly: terribly
terrific: terrific
terrified: terrified
terrify: terrified
terror: terror,terrors
testify: testified,testify
testily: testily
testimony: testimony
thankful: thankful
thankless: thankless
thanksgiving: thanksgiving
thee: thee
thenceforward: thenceforward
thereunto: thereunto
thew: thews
thicken: thickened
thickly: thickly
thieve: thieving
thimble: thimble
thine: thine
thinking: thinking
thinly: thinly
thirst: thirst,thirsted
thirsty: thirsty
thither: thither
thoughtful: thoughtful
thoughtfully: thoughtfully
thoughtlessness: thoughtlessness
thraldom: thraldom
thread: thread,threaded,threads
threat: threat,threats
threaten: threaten,threatened,threatening
threatening: threatening
threateningly: threateningly
threshold: threshold
thrice: thrice
thrill: thrill
throat: throat,throats
throb: throbbed,throbbing
throbbing: throbbing
throne: throne
throng: throng,thronged
throw: threw,throw,throwing,thrown
thrum: thrummed
thrust: thrust,thrusting
thud: thud,thudded,thudding,thuds
thudding: thudding
thumb: thumb
thumbscrew: thumbscrew
thunder: thunder,thundered,thundering
thunderbolt: thunderbolt
thwart: thwart,thwarted,thwarting
thwarting: thwarting
thy: thy
thyself: thyself
tide: tide
tideless: tideless
tiding: tidings
tie: tied,ties
tier: tier
tiger: tiger
tigerish: tigerish
tight: tight,tighter
tighten: tightened,tightening
tightening: tightening
tile: tiles
timber: timber,timbered,timbers
time: time,timed,times
timely: timely
times: times
timid: timid
timidly: timidly
tinge: tinge
tinkle: tinkled
tint: tints
tinted: tinted
tiny: tiny
tirade: tirade
tire: tire
title: title
titter: titter
toad: toad
tobacco: tobacco
tobias: tobias
toe: toe,toes
toil: toil,toiled,toiling,toils
toiler: toilers
token: token
tolerable: tolerable
tolerate: tolerated
toll: toll
tom: tom,toms
tome: tomes
tomorrow: tomorrow
tone: tone,tones
tong: tongs
tongue: tongue,tongues
tool: tool
tooth: teeth,tooth
topic: topic
topmost: topmost
topsail: topsails
torch: torches
torment: torment,tormented,torments
torrent: torrent
torso: torso
torture: torture,tortured,tortures,torturing
toss: toss,tossed
total: total
touch: touch,touched,touching
tower: towering
town: town
toy: toy,toyed
trace: trace,traces
track: track,tracked,tracks
tract: tracts
trade: trade,traded,trades
trademark: trademark
trader: traders
trading: trading
traditional: traditional
traffic: traffic
trafficker: trafficker
tragic: tragic
trail: trail,trailed,trailing
trailing: trailing
train: train
training: training
traitor: traitor,traitors
tramp: tramp,tramped
trample: trample,trampled
tramples: tramples
trance: trance
tranquillity: tranquillity
tranquilly: tranquilly
transcend: transcended,transcends
transcribe: transcribe
transcription: transcription
transform: transformed
transition: transition
translate: translate
translucent: translucent
transmute: transmute,transmuting
trap: trap,trapped
travel: travelled
travesty: travesty
treacherous: treacherous
treachery: treachery
tread: tread,treading,trod
treason: treason
treasure: treasure,treasures
treasury: treasury
treat: treat,treated
treatment: treatment
treaty: treaty
tree: tree,trees
tremble: tremble,trembled,trembling
tremor: tremor
trepan: trepanned,trepanning
trepanned: trepanned
tress: tresses
trial: trial
tribute: tribute
trick: trick
trickle: trickled
trifle: trifle,trifled,trifling
trifling: trifling
trill: trills
trilling: trilling
trim: trimmed
trinket: trinket,trinkets
trip: trip
triumph: triumph
trivial: trivial
trod: trod
trodden: trodden
troop: troop
troops: troops
trophy: trophies
troth: troth
troubadour: troubadour
trouble: trouble,troubled,troubles
troubled: troubled
troublesome: troublesome
truce: truce
true: true,truer
trump: trumped
trumpet: trumpet,trumpets
truss: trussed
trust: trust,trusted,trusting
trustworthy: trustworthy
trusty: trusty
truth: truth,truths
truthfully: truthfully
tub: tub
tuck: tucked
tuft: tuft,tufted
tug: tugged,tugging
tumult: tumult
tumultuous: tumultuous
tunic: tunic,tunics
tunis: tunis
turban: turban,turbaned,turbans
turbaned: turbaned
turbulence: turbulence
turbulent: turbulent
turf: turf
turk: turk
turkey: turkey
turkish: turkish
turks: turks
turmoil: turmoil
turntail: turntail
turret: turret,turreted
tutelage: tutelage
twain: twain
twentieth: twentieth
twere: twere
twig: twigs
twilight: twilight
twill: twill
twin: twin
twinkle: twinkled,twinkling
twinkling: twinkling
twist: twist,twisted
twisted: twisted
twitch: twitched
twitching: twitching
twofold: twofold
type: types
tyrant: tyrant
ugh: ugh
ugliness: ugliness
ugly: ugliest,ugly
ultimately: ultimately
unabashed: unabashed
unable: unable
unaccountably: unaccountably
unanswerable: unanswerable
unavenged: unavenged
unavoidable: unavoidable
unawares: unawares
unbar: unbarred
unbeliever: unbeliever,unbelievers
unbelieving: unbelieving
unblinking: unblinking
unbroken: unbroken
unclasp: unclasped
uncomely: uncomely
uncomplaining: uncomplaining
uncompromising: uncompromising
uncompromisingly: uncompromisingly
unconquerable: unconquerable
unconscionable: unconscionable
unconscious: unconscious
unconsciousness: unconsciousness
uncontradicted: uncontradicted
undaunted: undaunted
undecided: undecided
undercurrent: undercurrent,undercurrents
underfoot: underfoot
underlie: underlay,underlying
understand: understand,understanding,understood
understanding: understanding
understate: understate
undertake: undertake,undertaken
undertaking: undertaking
undeserved: undeserved
undesirable: undesirable
undeterred: undeterred
undignified: undignified
undismay: undismayed
undisturbed: undisturbed
undo: undo,undone
undoubtedly: undoubtedly
unduly: unduly
uneasily: uneasily
uneasiness: uneasiness
uneasy: uneasy
unenforceability: unenforceability
unequal: unequal
unexpected: unexpected
unfaith: unfaith
unfaltering: unfaltering
unfamiliar: unfamiliar
unfastened: unfastened
unfitting: unfitting
unfortunate: unfortunate,unfortunates
unfriendly: unfriendly
unfulfilled: unfulfilled
unfurl: unfurled
unfurling: unfurling
ungenerous: ungenerous
ungloved: ungloved
ungracious: ungracious
ungrateful: ungrateful
unhallowed: unhallowed
unheeded: unheeded
unheralded: unheralded
unhesitatingly: unhesitatingly
unhinge: unhinged
unholy: unholy
uniform: uniform
uniformity: uniformity
union: union
unite: united
united: united
unity: unity
unjust: unjust
unjustly: unjustly
unkempt: unkempt
unknown: unknown
unlawful: unlawful
unlink: unlink
unloved: unloved
unmelodious: unmelodious
unmerciful: unmerciful
unmolested: unmolested
unmoved: unmoved
unnatural: unnatural
unnaturalness: unnaturalness
unnecessarily: unnecessarily
unnecessary: unnecessary
unobserved: unobserved
unopened: unopened
unpaved: unpaved
unperceived: unperceived
unpleasantly: unpleasantly
unprecedented: unprecedented
unpremeditated: unpremeditated
unprepossessing: unprepossessing
unprotected: unprotected
unpublished: unpublished
unpunished: unpunished
unquestioned: unquestioned
unread: unread
unreasonably: unreasonably
unrefreshing: unrefreshing
unrivalled: unrivalled
unruffled: unruffled
unsay: unsay
unseen: unseen
unshackle: unshackle
unsheathe: unsheathe,unsheathed
unshorn: unshorn
unsmirched: unsmirched
unsolicited: unsolicited
unspeakable: unspeakable
unsteadily: unsteadily
unsteady: unsteady
unsupported: unsupported
unsuspected: unsuspected
unsuspicious: unsuspicious
unswerving: unswerving
untether: untethered
untimely: untimely
untold: untold
untrammelled: untrammelled
untrue: untrue
untrussed: untrussed
unusual: unusual
unutterable: unutterable
unvarying: unvarying
unveil: unveil,unveiled
unwashed: unwashed
unwavering: unwavering
unwise: unwise
unwittingly: unwittingly
unwonted: unwonted
unworthily: unworthily
unworthiness: unworthiness
unworthy: unworthy
upbraid: upbraid
update: updated
uphold: upheld,upholding
uplift: uplifted
uppermost: uppermost
upright: upright
uproar: uproar
uproot: uprooted
upstairs: upstairs
upstart: upstart
upturned: upturned
upward: upward
urge: urge,urged,urges,urging
urgency: urgency
urgent: urgent
urgently: urgently
useless: useless
user: user
usher: ushered
usual: usual
usurp: usurp,usurping
usurper: usurper
ut: ut
utmost: utmost
utter: utter,uttered
utterance: utterance,utterances
utterer: utterer
utterly: utterly
uttermost: uttermost
vacant: vacant
vacantly: vacantly
vade: vade
vague: vague
vaguely: vaguely
vain: vain
vainly: vainly
vale: vale
valediction: valediction
valiant: valiant
valley: valley
valorous: valorous
valour: valour
valuable: valuable
vampire: vampire
van: van
vanilla: vanilla
vanish: vanish,vanished
vanity: vanity
vantage: vantage
variance: variance
variegate: variegated
variety: variety
vast: vast
vastly: vastly
vault: vault,vaulted
veer: veer
vehemence: vehemence
vehement: vehement
veil: veil,veiled
veiled: veiled
velvet: velvet
venal: venal
vendor: vendors
vengeance: vengeance
vengeful: vengeful
venice: venice
venom: venom
venomous: venomous
vent: vent,vents
venture: venture,ventured,ventures,venturing
verily: verily
verse: versed
version: version
vessel: vessel,vessels
vest: vest
vex: vex
vexation: vexation
vibrate: vibrated
vicariously: vicariously
vicegerent: vicegerents
vicious: vicious
viciously: viciously
victim: victim
victorious: victorious
victoriously: victoriously
victory: victories,victory
view: view,viewed,viewing
vigilantly: vigilantly
vigorous: vigorous
vigour: vigour
vii: vii
viii: viii
vile: vile,vilest
vileness: vileness
village: village
villain: villain
villainous: villainous
villainy: villainy
vincent: vincent
vindictive: vindictive
vindictively: vindictively
vindictiveness: vindictiveness
vinegar: vinegar
vintner: vintner
viol: viol
violate: violate,violates
violation: violation
violence: violence
violent: violent
violet: violet
virgin: virgin
virility: virility
virtually: virtually
virtue: virtue,virtues
virtuous: virtuous
virus: virus
visage: visage
visible: visible
visibly: visibly
vision: vision
visit: visit,visited,visiting,visits
visitor: visitor
vital: vital
vitally: vitally
vocal: vocal
voice: voice,voiced,voices,voicing
void: void
volcanic: volcanic
volley: volley
volume: volumes
voluminous: voluminous
voluntarily: voluntarily
volunteer: volunteer,volunteers
voluptuous: voluptuous
vouchsafe: vouchsafe,vouchsafed,vouchsafing
vow: vow,vowed
voyage: voyage,voyaged
vulgar: vulgar
vulturine: vulturine
wa: wa
waft: wafted
wag: wag
wage: wage,waged
wager: wager
wages: wages
wail: wail
waist: waist,waists
wait: wait,waited,waiting,waits
waiting: waiting
wake: wake,waking
wakeful: wakeful
walk: walk,walked,walking,walks
walker: walker
wall: wall,walls
wander: wandering
wanderer: wanderer
wane: wanes,waning
wanton: wanton
wantonness: wantonness
war: war
ward: ward
wares: wares
warm: warm,warmed,warmer,warms
warmly: warmly
warmth: warmth
warn: warn,warned,warning
warning: warning,warnings
warp: warp
warrant: warrant
warranty: warranties,warranty
warrior: warrior,warriors
wary: wary
wash: wash,washed
waste: waste,wasted,wasting
wasteful: wasteful
watch: watch,watched,watches,watching
watcher: watcher
watchful: watchful
watchman: watchman
water: water,waters
waterside: waterside
waterwheel: waterwheel
wattle: wattles
wave: wave,waved,waves,waving
wavelet: wavelets
wax: waxes
waxen: waxen
weak: weak,weaker
weaken: weakening
weakening: weakening
weakling: weakling,weaklings
weakness: weakness
wealth: wealth
wealthy: wealthier,wealthy
weapon: weapon,weapons
weaponless: weaponless
wear: wear,wearing,wears,wore,worn
wearily: wearily
weariness: weariness
weary: wearies,weary,wearying
weather: weather,weathered
weave: woven
wedding: wedding
wedlock: wedlock
week: week,weeks
weep: weep,weeping,wept
weevilled: weevilled
weigh: weigh,weighed,weighing
weight: weight
weld: weld
wellnigh: wellnigh
welter: welter
wench: wench
west: west
wester: westering
western: western
westward: westward
wet: wet
whatsoever: whatsoever
wheal: wheal
wheat: wheat
wheel: wheel,wheeled
whelm: whelmed,whelming
whelp: whelp
whereabouts: whereabouts
whereat: whereat
whet: whetted
whey: whey
whimper: whimpered
whine: whine,whining
whip: whip,whipped,whipping,whips
whiplash: whiplash
whirl: whirled,whirling
whisk: whisked
whisper: whisper,whispered
whistle: whistle,whistles
whit: whit
white: white,whiter
whiteness: whiteness
whitewashed: whitewashed
whithersoever: whithersoever
whitish: whitish
whittle: whittled
whorl: whorl
wick: wick
wicked: wicked
wide: wide,wider,widest
widen: widen
widespread: widespread
widow: widowed
wield: wield,wielded
wife: wife,wives
wifeless: wifeless
wild: wild
wilderness: wilderness
wildly: wildly
wildness: wildness
wilful: wilful
wilfulness: wilfulness
willingly: willingly
willy: willy
wilt: wilt
wily: wily
win: win
wince: wince,winced
wind: wind,winds,wound
window: window,windows
windowless: windowless
windward: windward
wine: wine
wing: wing,wings
winter: winter
wipe: wipe,wiped,wiping
wisdom: wisdom
wise: wise,wiser
wisely: wisely
wistful: wistful
wistfully: wistfully
wistfulness: wistfulness
wit: wit,wits
witchcraft: witchcraft
withdraw: withdraw,withdrawing,withdrawn,withdrew
withdrawal: withdrawal
wither: wither,withered,withering
withered: withered
withhold: withheld,withhold
withstand: withstand,withstood
witness: witness,witnessed,witnesses
woe: woe
woefully: woefully
woefulness: woefulness
woman: woman,women
womanhood: womanhood
womanish: womanish
womanlike: womanlike
womb: womb
wonderfully: wonderfully
wondrous: wondrous
woo: wooed,wooing
wood: wood,woods
wooded: wooded
wooden: wooden
wool: wool
word: word
wormwood: wormwood
worn: worn
worship: worship,worshipped,worshipping
worth: worth
worthless: worthless
worthy: worthy
wot: wot
wouldst: wouldst
wound: wound,wounded,wounds
wounded: wounded
wrap: wrap,wrapped
wrath: wrath
wrathfully: wrathfully
wreak: wreak
wreck: wrecked,wrecking
wrench: wrenched
wrest: wrest,wrested
wrestler: wrestler
wretch: wretch,wretches
wretched: wretched
wring: wrung
wringing: wringing
wrinkle: wrinkle,wrinkled,wrinkles
wrist: wrist,wrists
writ: writ
write: write,writes,writing,written,wrote
writer: writer
writhe: writhe,writhed,writhing
writing: writing
writings: writings
wrong: wrong,wronged,wrongs
wry: wry
xi: xi
xii: xii
xiii: xiii
xiv: xiv
xix: xix
xvi: xvi
xvii: xvii
xviii: xviii
xx: xx
xxi: xxi
xxii: xxii
xxiii: xxiii
xxiv: xxiv
xxv: xxv
ya: ya
yard: yard,yards
yardarm: yardarm
yearly: yearly
yell: yell,yells
yellow: yellow,yellowing
yesterday: yesterday
yesternight: yesternight
yield: yield,yielded,yielding,yields
yoke: yoked
yond: yonder
yonder: yonder
youngster: youngster
youth: youth
zeal: zeal
zer: zer
zest: zest
