abandon: abandon,abandoned,abandons
abandonment: abandonment
abdomen: abdomen,abdomens
abet: abet,abetted
abide: abide
ability: ability
abject: abject
aboard: aboard
abode: abode
abolish: abolished
abolition: abolition
abolitionist: abolitionists
aboriginal: aboriginal
aborigine: aborigines
abound: abounded
abrupt: abrupt
abruptly: abruptly
abs: abs
absence: absence
absent: absent
absolute: absolute
absolutely: absolutely
absorb: absorb,absorbed,absorbing
abstain: abstain
abstemiousness: abstemiousness
abstinence: abstinence
abstract: abstract
abstraction: abstraction
abundance: abundance
abundant: abundant
abuse: abuse,abused
abut: abuts,abutted
abutment: abutment
acanthus: acanthus
accent: accent,accented
accept: accept,accepted
access: access
accessible: accessible
accident: accident
accidental: accidental
accidentally: accidentally
accompaniment: accompaniment
accompany: accompanied,accompanies,accompany
accomplish: accomplish,accomplished,accomplishing
accomplishment: accomplishment
account: account,accounted,accounts
accumulate: accumulate,accumulated,accumulating
accuracy: accuracy
accurately: accurately
accurse: accursed
accuse: accuse
accustom: accustomed
accustomed: accustomed
acheron: acheron
achillean: achillean
achilles: achilles
acid: acid
acknowledge: acknowledged
acorn: acorn,acorns
acquaint: acquainted
acquaintance: acquaintance,acquaintances
acquire: acquire,acquired,acquires,acquiring
acre: acre,acres
action: action,actions
active: active
activity: activity
acton: acton
actor: actor
actual: actual
actuate: actuated
acuteness: acuteness
adam: adam
adapt: adapt,adapted
add: add,adding,adds
addition: addition
additional: additional
address: address,addressed
adelaide: adelaide
adequate: adequate
adhere: adhere
adjacent: adjacent
adjoining: adjoining
adjunct: adjunct
admetus: admetus
administrator: administrator
admirable: admirable
admirably: admirably
admiration: admiration
admire: admire,admired,admiring
admit: admit,admits,admitted
admittance: admittance
ado: ado
adopt: adopt,adopting,adopts
adorn: adorn,adorned,adorns
adult: adult
advance: advance,advanced,advances
advantage: advantage,advantages
advent: advent
adventure: adventure,adventures
adventurer: adventurers
adventurous: adventurous
adventurously: adventurously
adversary: adversary
advertise: advertised
advertisement: advertisement
advice: advice,advices
advise: advise,advised
aerial: aerial
afar: afar
affair: affair,affairs
affect: affect
affection: affection,affections
affirm: affirmed
afflict: afflict,afflicted
afford: afford,afforded,affording,affords
afoot: afoot
aforethought: aforethought
afraid: afraid
africa: africa
african: african
afternoon: afternoon,afternoons
afterward: afterward
age: age,ages
agent: agent,agents
ages: ages
aggregate: aggregate
aggrieved: aggrieved
agitate: agitated
agitated: agitated
agree: agree
agreeable: agreeable
agricultural: agricultural
agriculture: agriculture
aguish: aguish
aid: aid,aids
ail: ail,ailed,ails
ailment: ailment
aim: aim,aiming,aims
air: air,airs
airy: airy
aisle: aisles
akin: akin
alabaster: alabaster
alacrity: alacrity
alarm: alarm,alarmed,alarming
alas: alas
alburnum: alburnum
aldebaran: aldebaran
alder: alder,alders
alderman: alderman
aldermanic: aldermanic
alert: alert
alexander: alexander
algonquins: algonquins
alienate: alienate
alight: alight,alighted
alike: alike
aliment: aliment
alive: alive
alkali: alkali
allegiance: allegiance
alley: alley
alligator: alligator
allowance: allowance
alloy: alloy
allure: allure
alluvion: alluvion
ally: allied
almanac: almanac
almond: almond,almonds
alms: alms
almshouse: almshouse
aloft: aloft
aloof: aloof
aloud: aloud
alphabet: alphabet
altair: altair
alter: alter,altering
altered: altered
alternate: alternating
alternately: alternately
alternative: alternative
alto: alto
altogether: altogether
amateur: amateur
amazement: amazement
ambassador: ambassador,ambassadors
amber: amber
ambition: ambition
ambitious: ambitious
ambrosial: ambrosial
amend: amend,amends
america: america
american: american,americans
ammiral: ammiral
amnesty: amnesty
amok: amok
amphitheatre: amphitheatre
ample: ample
amuse: amuse,amused
amusement: amusement,amusements
analogy: analogy
analytic: analytic
ancestor: ancestor,ancestors
anchor: anchor,anchored,anchors
ancient: ancient,ancients
anciently: anciently
andiron: andirons
anew: anew
angel: angel,angels
angelo: angelo
angle: angle,angles
angler: angler
angrily: angrily
angry: angry
animal: animal,animals
animalized: animalized
animals: animals
animate: animate
animated: animated
annihilation: annihilation
annual: annual
annually: annually
anon: anon
answer: answer,answered,answering,answers
ant: ant,ants
ante: ante
anthropic: anthropic
anticipate: anticipate,anticipated
anticipation: anticipation
antiquary: antiquaries
antique: antique
antiquity: antiquity
anxiety: anxiety
anxious: anxious
anxiously: anxiously
apace: apace
apartment: apartment,apartments
apex: apex,apexes
apios: apios
apology: apologies,apology
apotheosize: apotheosized
apparent: apparent
appeal: appeal
appearance: appearance,appearances
appendage: appendages
appetite: appetite,appetites
applaud: applauded
apple: apple,apples
appliance: appliances
applicable: applicable
application: applications
apply: apply,applying
appoint: appointed
appointment: appointment
appreciation: appreciation
apprehend: apprehend,apprehending
approach: approach,approached,approaches,approaching
approve: approving
approximation: approximation
april: april
apt: apt
arab: arab,arabs
arabia: arabia
arabian: arabian
arbitrarily: arbitrarily
arc: arc
arcadia: arcadia
arch: arch
arching: arching
architect: architect,architects
architectural: architectural
architecture: architecture
arctic: arctic
ardor: ardor
argument: arguments
aristocracy: aristocracy
arithmetic: arithmetic
arm: arm,armed,arms
armful: armful
army: army
arouse: aroused,arousing
arrange: arrange,arranged
arrangement: arrangement,arrangements
arrival: arrival,arrivals
arrive: arrive,arrived,arriving
arrow: arrow
arrowhead: arrowheads
arrowy: arrowy
art: art,arts
artery: artery
arthur: arthur
article: article,articles
articulation: articulation
artificer: artificer
artificial: artificial
artillery: artillery
artist: artist
artistic: artistic
ascend: ascend
ascertain: ascertain,ascertained
ascetic: ascetic
ash: ash,ashes
ashamed: ashamed
ashore: ashore
asia: asia
asiatic: asiatic
asleep: asleep
aspect: aspect
aspen: aspens
aspiration: aspirations
aspire: aspire,aspires
aspiring: aspiring
ass: ass
assert: assert,asserted,asserting,asserts
assessment: assessment
assessor: assessors
assiduously: assiduously
assign: assign,assigned
assimilate: assimilated
assist: assist,assisted
assistance: assistance
associate: associating
association: associations
associations: associations
assuage: assuage,assuaged
assume: assume,assumed
assurance: assurance
assure: assure,assured
assyria: assyria
astonish: astonish,astonished
astonished: astonished
astonishing: astonishing
astonishment: astonishment
astor: astor
astounding: astounding
astray: astray
astrologically: astrologically
astronomer: astronomers
astronomically: astronomically
astronomy: astronomy
athlete: athletes
athwart: athwart
atlantic: atlantic
atlantis: atlantis
atlas: atlas
atmosphere: atmosphere
atmospheric: atmospheric
atom: atoms
atone: atoning
atropos: atropos
attach: attached,attaches
attack: attacked
attain: attain,attained,attaining
attempt: attempt,attempted
attend: attend,attended
attendance: attendance
attention: attention
attitude: attitude,attitudes
attorney: attorney
attract: attract,attracted,attracts
attraction: attraction,attractions
attractive: attractive
auction: auction
audit: audited
auditor: auditor
augean: augean
auger: auger
august: august
aunt: aunts
aurora: aurora
auroral: auroral
austere: austere
austerity: austerity
austerlitz: austerlitz
australian: australians
author: author,authors
authority: authorities,authority
autumn: autumn
autumnal: autumnal
auxiliary: auxiliaries
avail: avail,avails
avarice: avarice
avast: avast
avenge: avenge,avenged,avenging
avenger: avenger
avenue: avenues
average: average
aversion: aversion
avoid: avoid,avoided,avoiding
await: await,awaited,awaiting,awaits
awake: awake,awakes,awoke
awaken: awakened,awakens
awakening: awakening
aware: aware
awe: awe
awed: awed
awful: awful
awning: awning
axe: axe
axil: axils
axis: axes
ay: ay
aye: aye
azure: azure
baboon: baboons
baby: baby
babylon: babylon
backgammon: backgammon
bacon: bacon
bad: bad,worse,worst
badge: badge
bag: bag,bags
bagdad: bagdad
baggage: baggage
bait: bait,baited
bake: bake,baked,bakes
baker: baker
baking: baking
balance: balance,balanced,balancing
bald: baldest
bale: bales
balk: balked
ball: ball,balls
balloon: balloon
baltimore: baltimore
band: bands
bandbox: bandbox
banish: banish,banished
bank: bank,banks
bankrupt: bankrupt
bankruptcy: bankruptcy
banks: banks
banner: banner
bar: bar,barred,bars
barb: barb
barbaric: barbaric
barbarous: barbarous
barber: barber
barberry: barberry
bare: bare
barefooted: barefooted
bargain: bargain
bark: bark,barked,barking,barks
barn: barn,barns
barrel: barrel,barrels
barrow: barrow,barrows
barter: barter
bartram: bartram
base: base,based
basin: basin
basis: basis
basket: basket,baskets
bass: bass
bath: bath,bathed
bathe: bathe
bather: bather
bathing: bathing
battering: battering
battle: battle,battles
bay: bay,bays
baying: baying
bayou: bayou
bayous: bayous
beach: beach,beaches
beacon: beacon,beacons
bead: beads
beam: beam,beams
bean: bean,beans
beans: beans
bear: bear,bearing,bears,bore,born,borne
beard: beard
bearer: bearers
bearing: bearing,bearings
beast: beast,beasts
beastly: beastly
beat: beat,beaten
beautiful: beautiful
beautifully: beautifully
beauty: beauty
beaux: beaux
bed: bed,bedded,beds
bedford: bedford
bedstead: bedstead,bedsteads
bee: bee,bees
beech: beech
beechen: beechen
beef: beef
beet: beets
befall: befell
befriend: befriended
beggar: beggar,beggars
beggarly: beggarly
beginner: beginners
behalf: behalf
behave: behave,behaved
behavior: behavior,behaviors
behindhand: behindhand
behold: beheld,behold,beholding,beholds
beholder: beholder
behoove: behooves
behove: behoves
belfry: belfry
belie: belies
belief: belief
bell: bell,bells
bella: bella
belle: belles
bellied: bellied
bellow: bellowing,bellows
bellum: bellum
belly: belly
belong: belong,belonged,belonging,belongs
beloved: beloved
belt: belt,belts
ben: ben
bench: bench
bencher: bencher
bend: bend,bending,bends,bent
bended: bended
bender: benders
bene: bene
beneath: beneath
benefactor: benefactor,benefactors
beneficence: beneficence
beneficent: beneficent
benefit: benefit,benefited
benevolence: benevolence
bent: bent
benvenuto: benvenuto
bequeath: bequeathed
berry: berries,berry,berrying
beseechingly: beseechingly
beset: beset
bestow: bestow,bestowed,bestows
bestower: bestower
bet: betting
betime: betimes
betray: betray,betrayed,betraying,betrays
beverage: beverage
beware: beware
bey: bey
bibber: bibbers
bible: bible,bibles
biblical: biblical
bicolor: bicolor
bid: bade
bidding: bidding
biennial: biennials
bight: bights
billow: billows
bind: bound
biography: biography
biped: biped
birch: birch,birches
bird: bird,birds
birth: birth
bison: bison
bit: bit,bits
bite: bite
biting: biting
bitter: bitter
bittern: bittern
black: black,blacks
blackberry: blackberries,blackberry
blacker: blacker
blacksmith: blacksmith
blade: blade,blades
blake: blake
blame: blame
blanch: blanched
blast: blast,blasted,blasts
bleach: bleach
bleak: bleak
bleat: bleating
bleed: bleeds
bless: bless,blessed
blessing: blessing
blind: blind,blinds
blindly: blindly
blister: blistered
bloated: bloated
block: block,blocks
blood: blood,bloods
blooded: blooded
bloodsucker: bloodsucker
bloody: bloody
bloom: bloom,blooming
blossom: blossom,blossoming,blossoms
blotting: blotting
blow: blew,blow,blowing,blown,blows
blowing: blowing
blue: blue,bluer,bluest
blueberry: blueberries,blueberry
bluebird: bluebird
blues: blues
bluish: bluish
blunder: blunder,blundering
blunt: blunt
blush: blush,blushes
blustering: blustering
board: board,boarded,boards
boarding: boarding
boast: boast,boasting
boat: boat
bodily: bodily
body: bodies,body
bog: bog,bogging,bogs
boggy: boggy
boil: boil,boiled
boiling: boiling
boisterous: boisterous
bold: bold,bolder
boldly: boldly
bole: bole
bolster: bolsters
bolt: bolt,bolted,bolts
bombay: bombay
bone: bone,bones
bonfire: bonfire
bonnet: bonnet
bony: bony
boo: boo
booby: booby
book: book,books
boom: boom,boomed,booming
booming: booming
boot: boots
bopeep: bopeep
bor: bor
border: border,borders
borderer: borderers
bore: bored,bores
borrow: borrow,borrowed
borrowing: borrowing
bose: bose
bosom: bosom
boston: boston
botanic: botanic
bother: bother
bottle: bottle,bottles
bottomless: bottomless
bottomlessness: bottomlessness
bough: bough,boughs
bounce: bounce
bound: bound,bounded,bounding,bounds
boundary: boundaries,boundary
boundless: boundless
bounteous: bounteous
bouquet: bouquet
bout: bout
bow: bow,bows
bowels: bowels
bower: bower,bowers
bowl: bowl,bowls
bowlder: bowlders
box: box,boxes
boy: boy,boys
boyhood: boyhood
brace: bracing
brag: brag
brahma: brahma
brahmin: brahmins
brain: brain,brains
brake: brakes
brakeman: brakemen
bran: bran
branch: branch,branches
brand: brands
brandy: brandy
brass: brass
brat: brat
brave: brave
bravely: bravely
bravery: bravery
brazen: brazen
bread: bread
breadstuff: breadstuffs
breadth: breadth
breadthwise: breadthwise
break: break,breaking,breaks,broke,broken
breakfast: breakfast,breakfasts
breaking: breaking
bream: bream,breams
breast: breast,breasts
breastplate: breastplate
breath: breath
breathe: breathe,breathed,breathes,breathing
breeches: breeches
breed: bred,breed
breeder: breeder
breeze: breeze,breezes
brick: brick,bricks
bridge: bridge,bridged,bridges
brier: briers
bright: bright,brighter
brighten: brighten
brightly: brightly
brightness: brightness
brilliant: brilliant
bring: bring,bringing,brings,brought
bristle: bristling
britain: britain
british: british
brittle: brittle
broad: broad,broader,broadest
broadcast: broadcast
broadway: broadway
broken: broken
broker: broker
bronze: bronze
brood: brood
brook: brook,brooks
broom: broom
brother: brother,brothers
brothers: brothers
brow: brow,brows
brown: brown
brownish: brownish
browse: browsed
browsing: browsing
brush: brush
brushy: brushy
brutal: brutal
brute: brute,brutes
brutish: brutish
bubble: bubble,bubbles
buck: buck
bucket: bucket,buckets
buckle: buckled
bud: bud,buds
budding: budding
budget: budget
buffalo: buffalo
buffet: buffet
bug: bug,bugs
build: build,builded,building,builds,built
builder: builder,builders
building: building,buildings
bulk: bulk
bull: bull
bullet: bullet
bullfrog: bullfrogs
bulrush: bulrush
bumble: bumble
bunch: bunch
bundle: bundle
bunker: bunker
buoy: buoys
buoyancy: buoyancy
buoyant: buoyant
bur: burs
burden: burden
burgher: burghers
burgoyne: burgoyne
burn: burn,burned,burning,burnt
burning: burning
burr: burrs
burrow: burrow,burrowing,burrows
burst: burst,bursting,bursts
bury: buried,buries,bury,burying
bush: bush,bushes
bushel: bushel,bushels
bushy: bushy
business: business
busk: busk
bust: bust
bustle: bustle
bustling: bustling
busy: busy
butcher: butcher,butchers
butt: butt
butter: butter
butterfly: butterflies,butterfly
buttermilk: buttermilk
buzz: buzzing
cabbage: cabbage
cabin: cabin,cabins
cable: cable
cackle: cackle,cackling
cackling: cackling
cadaverous: cadaverous
cadis: cadis
cage: caged
cake: cake,cakes
calculable: calculable
calculate: calculate,calculated
calculation: calculation
calculator: calculator,calculators
calcutta: calcutta
calf: calf,calves
california: california
caliph: caliphs
calk: calked
calling: calling
callous: callous
callow: callow
calm: calm
cambridge: cambridge
camp: camp,camped,camps
canada: canada
canadian: canadian
canal: canal
candidate: candidate,candidates
candle: candles
canine: canine
canker: canker
cannibal: cannibal,cannibals
cannon: cannon
canoe: canoe
canter: cantering
canvas: canvas
cap: cap
capable: capable
capacious: capacious
capacity: capacities,capacity
cape: cape,capes
capital: capital
captain: captain
capture: captured
car: car,cars
caravansary: caravansary
caraway: caraway
carbuncle: carbuncles
card: card,cards
care: care,cared,cares
career: career,careering
careful: careful
carefully: carefully
careless: careless
carelessly: carelessly
caribou: caribou
carlos: carlos
carmine: carmine
carnage: carnage
carnivorous: carnivorous
carol: carols
carolina: carolina
carpenter: carpenter
carpentry: carpentry
carpet: carpet,carpeted,carpets
carriage: carriage
carrier: carrier
carrion: carrion
carry: carried,carry,carrying
cart: cart,carting,carts
cartload: cartloads
carve: carve,carved
cashier: cashiered
casing: casings
cask: casks
casket: casket
cassiopeia: cassiopeia
cast: cast,casting,casts
castalian: castalian
castle: castle,castles
casual: casual
casualty: casualties
cat: cat,cats
catch: catch,catching,caught
catechism: catechism
caterpillar: caterpillar,caterpillars
catholic: catholic
cattle: cattle
causeway: causeway
cave: cave,caves
cavern: cavern
cavernous: cavernous
caviller: cavillers
caving: caving
cavity: cavities,cavity
cease: cease,ceased,ceases,ceasing
ceaseless: ceaseless
ceaselessly: ceaselessly
cedar: cedar
ceiling: ceiling
celebrate: celebrate,celebrated,celebrates,celebrating
celebrated: celebrated
celestial: celestial
cell: cell,cells
cellar: cellar,cellars
cellular: cellular
celt: celt
celtis: celtis
cement: cement,cements
cemetery: cemeteries
cent: cent,cents
centipede: centipede
central: central
centre: centre
century: centuries,century
cerasus: cerasus
cerberus: cerberus
cereal: cereal
cerealian: cerealian
ceremony: ceremonies,ceremony
ceres: ceres
certainty: certainty
cerulean: cerulean
cessation: cessation
chaff: chaff
chain: chain,chained,chains
chair: chair,chairs
chaise: chaise,chaises
chalk: chalk
chamber: chamber,chambers
champion: champion
champlain: champlain
chance: chance,chanced
change: change,changed,changing
changeable: changeable
channel: channel,channels
chant: chanted
chanticleer: chanticleer
chaos: chaos
chap: chaps
chapman: chapman
chapter: chapter
char: char
character: character,characters
characteristic: characteristic
charge: charge,charged
chariot: chariot
charitable: charitable
charity: charity
charleston: charleston
charm: charm,charmed
charming: charming
chart: chart,charts
chase: chase
chasm: chasm
chaste: chaste
chastity: chastity
chat: chat,chatted
chatter: chattering
chaucer: chaucer
che: che
cheap: cheap,cheaper,cheapest
cheaply: cheaply
cheat: cheat,cheated
check: checked
checker: checker
checkered: checkered
cheek: cheek,cheeks
cheep: cheeping
cheer: cheer,cheered,cheering,cheers
cheerful: cheerful
cheerfully: cheerfully
cheering: cheering
cheese: cheese
chemic: chemic
chemistry: chemistry
chequer: chequers
cherish: cherish,cherished
cherry: cherries,cherry
chest: chest
chestnut: chestnut,chestnuts
chew: chew,chewed
chewer: chewers
chewink: chewink
chiccory: chiccory
chickadee: chickadee,chickadees
chickaree: chickaree
chicken: chicken,chickens
chide: chiding
chief: chief
chiefly: chiefly
child: child,children
childhood: childhood
childish: childish
chill: chilling
chilled: chilled
chimney: chimney
chin: chin
china: china
chinamen: chinamen
chinese: chinese
chink: chinks
chip: chip,chips
chirp: chirp
chirrup: chirruped,chirruping
chisel: chisel
chivalry: chivalry
chocolate: chocolate
choice: choice,choicest
choir: choir
choke: chokes
choose: choose,chose,chosen
chop: chop,chopped,chopping
chopper: chopper
chowder: chowder
christ: christ
christen: christen
christian: christian
christianity: christianity
chronology: chronologies
chuckle: chuckle,chuckling
church: church,churches
churn: churn
cider: cider
ciderish: ciderish
cigar: cigar
cimeter: cimeter
cinder: cinders
cinderella: cinderella
cinquefoil: cinquefoil
cipher: cipher
circle: circle,circled,circles,circling
circling: circling
circuit: circuit
circular: circular
circulate: circulate,circulated,circulating
circulation: circulation,circulations
circumference: circumference
circumspection: circumspection
circumstance: circumstance,circumstances
circumstantial: circumstantial
citadel: citadel
citizen: citizen,citizens
city: cities,city
civil: civil
civility: civility
civilization: civilization
civilized: civilized
clad: clad
claim: claim,claimed,claims
clammy: clammy
clamor: clamor
clangor: clangor
clarify: clarified,clarifying
clarion: clarions
clarke: clarke
clasp: clasp
class: class,classed,classes
classic: classic,classics
claw: claws
clay: clay
clean: clean,cleaned,cleaner,cleanest,cleaning
cleanse: cleanse,cleansed
clearing: clearing
cleavage: cleavages
cleaver: cleaver
cleft: cleft
clergyman: clergyman
clerk: clerk
clever: clever
cliff: cliff,cliffs
cliffy: cliffy
climate: climate,climates
climb: climb,climbed,climbing
clime: climes
clinch: clinch,clinched
cling: cling,clinging
clock: clock,clocks
clog: clogs
close: close,closed,closer,closes,closest,closing
closely: closely
closet: closet
cloth: cloth,cloths
clothe: clad,clothe,clothed
clothes: clothes
clothing: clothing
cloud: cloud,clouds
cloudy: cloudy
clout: clout
cluck: cluck
clucking: clucking
clue: clue
clumsy: clumsy
cluster: clusters
clutch: clutched
cluttered: cluttered
coarse: coarse,coarser,coarsest
coarsely: coarsely
coast: coast
coastwise: coastwise
coat: coat,coats
cobbler: cobbler
cobs: cobs
cobweb: cobweb
cock: cock
cockerel: cockerel,cockerels
cocoa: cocoa
cod: cod
coddling: coddling
code: code
codman: codman
coeval: coeval
coffee: coffee
coffin: coffin
cognate: cognate
cohabit: cohabit
coil: coil
coin: coin,coins
coincide: coincide
coincidence: coincidence
coincident: coincident
cold: cold,colder,coldest
colic: colic
collapse: collapsed
collect: collect,collected
collection: collection
collections: collections
collectively: collectively
college: college,colleges
collins: collins
colloquy: colloquies
colonel: colonel
colony: colonies,colony
color: color,colored,colors
colorado: colorado
colored: colored
coloring: coloring
colorless: colorless
columbia: columbia
columbus: columbus
column: columns
colymbus: colymbus
comb: comb,combed
combat: combat
combatant: combatants
combine: combine,combined
combustion: combustion
comet: comet
comfort: comfort,comforts
comfortable: comfortable
comfortably: comfortably
coming: comings
comitatus: comitatus
command: command,commanded,commanding
commander: commander
commemorate: commemorate
commence: commence,commenced,commences
comment: comment
commentator: commentator
commerce: commerce
commercial: commercial
commit: commit,committed
committed: committed
committee: committee
commodious: commodious
commodity: commodities,commodity
commodore: commodore
common: common,commonest
commonly: commonly
commonness: commonness
commune: commune
communicable: communicable
communicate: communicate,communicated,communicating
communication: communication,communications
community: communities,community
compact: compact
compactly: compactly
companion: companion,companions
companionable: companionable
company: company
comparable: comparable
comparative: comparative
comparatively: comparatively
compare: compare,compared
comparison: comparison,comparisons
compass: compass
compassion: compassion
compel: compel,compelled
compeller: compeller
compensate: compensated
compensation: compensation
complacency: complacency
complacent: complacent
complain: complain,complained,complaining
complaint: complaint,complaints
complemental: complemental
complete: complete,completed
completely: completely
completeness: completeness
complex: complex
complexion: complexion
complicated: complicated
compliment: compliment,complimented
compose: compose,composed
composition: composition
compost: compost
compound: compound
comprehend: comprehend,comprehended
compromise: compromise
computation: computation
comrade: comrade,comrades
conceal: conceal,concealed,conceals
concealment: concealment
concede: concede
conceited: conceited
conceive: conceive,conceiving
concentrate: concentrated
concentrated: concentrated
concentric: concentric
conception: conceptions
concern: concern,concerned,concerns
concerned: concerned
conclude: conclude,concluded,concluding
conclusion: conclusion,conclusions
concord: concord
concur: concur,concurring
condemn: condemn,condemned
condense: condensed
condescend: condescended
condiment: condiment
condition: condition,conditioned,conditions
conduce: conduces
conduct: conduct,conducted
conductor: conductor
cone: cone,cones
confederacy: confederacy
confess: confess,confessed,confesses
confession: confessions
confidence: confidence
confident: confident
confidently: confidently
confine: confine,confined
confinement: confinement
confines: confines
confirm: confirm,confirmed
conflagration: conflagrations
conflict: conflict,conflicting
confluent: confluent
conform: conform,conforming,conforms
conformably: conformably
conformity: conformity
confound: confound,confounded
confront: confronts
confucius: confucius
confused: confused
confusion: confusion
congeal: congealed
congenial: congenial
congratulate: congratulate
congratulation: congratulation
congregate: congregate
congregation: congregation
congress: congress
conical: conical
conjecture: conjecture,conjectured,conjecturing
conjure: conjure
connect: connect,connected,connecting
connecticut: connecticut
connection: connection
conquer: conquer,conquered
consanguinity: consanguinity
conscience: conscience,consciences
conscientious: conscientious
conscious: conscious
consciously: consciously
consciousness: consciousness
consecrate: consecrate,consecrated
consecrated: consecrated
consent: consent,consented,consenting
consequence: consequence,consequences
consequent: consequent
considerable: considerable
considerably: considerably
considerate: considerate
consideration: consideration
consist: consist,consisted,consisting
consistency: consistency
consistent: consistent
consolation: consolation,consolations
console: console,consoled
conspicuous: conspicuous
conspiracy: conspiracies
conspire: conspires
constable: constables
constant: constant
constantly: constantly
constellation: constellation,constellations
constituent: constituents
constitute: constitute,constitutes
constitution: constitution,constitutions
constitutional: constitutional
constrain: constrain
construct: construct,constructed,constructing
construction: construction
consult: consulted,consulting
consultation: consultation
consume: consume,consumed,consumes
consumer: consumer
consummate: consummate
contact: contact
contagion: contagion
contemplate: contemplate,contemplated,contemplating
contemplation: contemplation,contemplations
contemporary: contemporaries,contemporary
contend: contending
content: content
contented: contented
contentedly: contentedly
contentment: contentment
contents: contents
contest: contested
contiguous: contiguous
continent: continent,continents
continual: continual
continually: continually
continuance: continuance
continue: continue,continued,continues
contract: contract,contracted,contracting
contractor: contractor
contrast: contrast
contribute: contribute,contributed
contribution: contributions
contrive: contriving
control: control
convenience: convenience,conveniences
convenient: convenient
conventicle: conventicle
convention: convention,conventions
conversant: conversant
conversation: conversation,conversations
converse: converse,conversed,conversing
convert: converted
convey: convey,conveying
conveyance: conveyance
convict: convicted
convince: convince,convinced,convinces
convinced: convinced
conviviality: conviviality
convulse: convulse
convulsion: convulsion
convulsive: convulsive
cook: cook,cooked,cooks
cookery: cookery
cooking: cooking
cool: cool,cooled,coolest
cooly: cooly
copartnership: copartnership
cope: cope
copernicus: copernicus
copious: copious
copper: copper
copse: copse
coral: coral
cord: corded,cords
corded: corded
cordial: cordials
core: core
cormorant: cormorants
corn: corn
corner: corner,corners
cornfield: cornfield,cornfields
cornice: cornice,cornices
coronet: coronet
corporal: corporal
corporation: corporation,corporations
corpse: corpse
correct: correct,corrected
correction: correction
correspondent: correspondent
corrosion: corrosion
corrugation: corrugations
corrupt: corrupt,corrupted
cortex: cortex
cosmical: cosmical
cosmogonal: cosmogonal
cosmography: cosmography
cosmopolite: cosmopolite
cosmos: cosmos
cost: cost,costs
costly: costly
costume: costume
cottage: cottage,cottages
cotton: cotton
couch: couch
cough: cough
council: council
count: count,counting
countenance: countenance,countenanced
counter: counter
counterbalance: counterbalanced
counting: counting
country: countries,country
countryman: countryman,countrymen
county: county
couple: couple
courage: courage
courageous: courageous
coursing: coursing
court: court,courts
courtier: courtier
cousin: cousin,cousins
cove: cove,coves
cover: cover,covered,covering,covers
covered: covered
coveted: coveted
cow: cow,cows
coward: cowards
cowbird: cowbirds
cower: cowers
cowhide: cowhide
crack: crack,cracked,cracking,cracks
crackling: crackling
cradle: cradle
craft: craft
crag: crag
cranberry: cranberries,cranberry
crane: cranes
crank: crank
crash: crash
crave: crave
crawl: crawl,crawling,crawls
crazy: crazy
creak: creaking
cream: cream
crease: creased
create: create,created
creation: creation,creations
creator: creator
creature: creature,creatures
credit: credit
creditor: creditors
creep: creeping,crept
crest: crest
crevice: crevice,crevices
crew: crew
crimpled: crimpled
crimson: crimson
crippled: crippled
crisis: crisis
crisp: crisp
critical: critical
critically: critically
criticism: criticism
croak: croaking
cromwell: cromwell
crooked: crooked
crop: crop,cropping,crops
cross: cross,crossed,crossing
crotchet: crotchets
crow: crow,crowing
crowd: crowd,crowded,crowding,crowds
crowded: crowded
crown: crown
crucify: crucify
crudity: crudity
cruise: cruise
crumb: crumbs
crumble: crumbled,crumbling
crusader: crusaders
crush: crushed,crushes,crushing
crust: crust
crusty: crusty
crystal: crystal,crystals
crystalline: crystalline
crystallization: crystallization
cubic: cubic
cuckoo: cuckoos
cuff: cuffs
culinary: culinary
culminate: culminates
cultivate: cultivate,cultivated,cultivating
cultivation: cultivation
cultivator: cultivator,cultivators
culture: culture
cumbrous: cumbrous
cunning: cunning
cunningly: cunningly
cup: cup,cups
cupbearer: cupbearer
cupboard: cupboard
cupreous: cupreous
cur: cur
curacy: curacy
cure: cure,cured,cures
curiosity: curiosity
curious: curious
curl: curled,curls
current: current,currents
curry: curry
curse: curse,cursed,curses
cursing: cursing
curtain: curtain,curtains
curve: curve,curves
cushion: cushion,cushions
custom: custom,customs
customer: customer,customers
cut: cut,cuts,cutting
cuticle: cuticle
cutter: cutters
cutting: cutting
cylindrically: cylindrically
cynosure: cynosure
cypress: cypress
czar: czar
dabble: dabbling
dace: dace
daily: daily
dainty: dainty
daisy: daisies
dale: dale
dam: dam,dams
damage: damage
dame: dame
damnable: damnable
dance: dance
dancing: dancing
dandelion: dandelion
danger: danger,dangers
dangerous: dangerous
dangle: dangled
dank: dank
dark: dark,darker,darkest
darken: darkened,darkening
darkness: darkness
dart: dart,darting
darwin: darwin
dash: dash,dashed,dashes,dashing
dashed: dashed
daub: daubed
daughter: daughter
daunt: daunted
david: david
davis: davis
dawn: dawn,dawning,dawns
day: day,days
daylight: daylight
dazzle: dazzled,dazzling
dazzling: dazzling
deacon: deacon
dead: dead
deadly: deadly
deaf: deaf
deal: deal,dealing
dealings: dealings
dearly: dearly
dearth: dearth
death: death
debate: debate
debauched: debauched
debt: debt
debtor: debtor
decay: decay,decayed,decaying
deceive: deceived
december: december
decent: decent
decently: decently
decide: decide,decided
decipher: decipher
decision: decision
deck: deck
declare: declare,declared,declares
decline: decline,declined
deduct: deducting
deed: deed,deeds
deem: deem,deemed
deep: deep,deeper,deepest
deepen: deepened,deepens
deer: deer
deface: defaced
defeat: defeated
defect: defect
defence: defence
defend: defend,defended
defender: defender
defensive: defensive
defiant: defiant
deficiency: deficiency
deficient: deficient
defile: defiled,defiling
define: defined,defines
definite: definite
definition: definition
deform: deformed
defraud: defrauding
defraying: defraying
defy: defying
degeneracy: degeneracy
degenerate: degenerate
degrade: degraded
degraded: degraded
degree: degree,degrees
deity: deity
dejection: dejection
del: del
delay: delay,delayed
delectable: delectable
deliberate: deliberate,deliberating
deliberately: deliberately
deliberation: deliberation
delicacy: delicacy
delicate: delicate
delicious: delicious
delight: delight,delights
deliquium: deliquium
delirium: delirium
deliver: deliver
dell: dells
delude: deluded
deluge: deluge
delusion: delusion,delusions
delve: delved
demagogue: demagogue
demand: demand,demanded,demands
demigod: demigod,demigods
democracy: democracy
democratic: democratic
demon: demon
demoniac: demoniac
demoniacally: demoniacally
demur: demurred
denial: denial
denizen: denizens
denomination: denomination
dense: dense
densely: densely
dent: dent,dents
deny: denied,deny,denying
depart: departed,departing
departure: departure
depend: depend,depends
deposit: deposited,depositing,deposits
depot: depot
depreciate: depreciated
depth: depth
depths: depths
der: der
derision: derision
derivation: derivation
derivative: derivative
derive: derive,derived,deriving
dervish: dervish
des: des
descend: descend,descended,descending
descendant: descendants
descent: descent
description: description
desert: desert,deserted,deserts
deserted: deserted
deserter: deserters
deserve: deserve,deserves
design: design,designed,designs
desirable: desirable
desire: desire,desired,desires
desirous: desirous
desk: desk
despair: despair,despaired,despairs
despaired: despaired
despatch: despatch,despatched
desperate: desperate
desperation: desperation
despicable: despicable
despise: despised
desponding: desponding
dessert: dessert
destination: destination
destine: destined
destiny: destiny
destroy: destroy,destroyed,destroying,destroys
destruction: destruction
detain: detain,detained
detect: detect,detected
deter: deter,deterred,deterring
determine: determine,determined,determines
determined: determined
detriment: detriment
deucalion: deucalion
devastation: devastation
develop: developed,developing
development: development
devil: devil,devils
devilish: devilish
devise: devised
devote: devote,devoted,devotes,devoting
devoted: devoted
devotion: devotion
devour: devour,devoured
dew: dew,dews
dewy: dewy
diabolical: diabolical
diagonal: diagonal
dialect: dialect,dialects
dialogue: dialogues
diameter: diameter,diameters
diamond: diamond,diamonds
dictate: dictates
dictionary: dictionary
die: die,died,dies,dying
diet: diet
dietetic: dietetic
difference: difference
difficult: difficult
difficulty: difficulties,difficulty
diffuse: diffused
dig: dig,digging,dug
digest: digest,digested
digestive: digestive
digging: digging
dignified: dignified
dignitary: dignitary
dignity: dignity
dilapidated: dilapidated
dilate: dilating
dilettantism: dilettantism
diligent: diligent
diligently: diligently
dilute: dilute
diluvian: diluvian
dim: dim
dimension: dimensions
diminish: diminish,diminished
dimly: dimly
dimple: dimple,dimples,dimpling
dimpling: dimpling
din: din,dinning
dine: dined,dining
dingy: dingy
dining: dining
dinner: dinner,dinners
dip: dip,dipped
dipper: dipper
direct: direct,directed
direction: direction,directions
dirt: dirt
dirty: dirty
disadvantage: disadvantage
disappear: disappear,disappeared,disappearing,disappears
disappoint: disappointed
disappointed: disappointed
disapprove: disapprove
discern: discern,discerned,discerns
discharge: discharge,discharged,discharges
discipline: discipline
discolor: discolored
discomfiture: discomfiture
disconsolate: disconsolate
discontent: discontent
discontented: discontented
discord: discords
discordant: discordant
discourage: discourage
discourse: discourse,discoursed
discover: discover,discovered,discovering,discovers
discoverer: discoverers
discovery: discoveries,discovery
discretion: discretion
discriminate: discriminates
discriminating: discriminating
discrimination: discrimination
discuss: discussed
disease: disease,diseases
diseased: diseased
disgorge: disgorge
disgrace: disgrace,disgracing
disguise: disguise
disgust: disgust,disgusts
dish: dish,dishes
dishabille: dishabille
dishearten: disheartens
dishonest: dishonest
disinterested: disinterested
disk: disk
dismal: dismal
dismiss: dismiss
disobedience: disobedience
disorder: disorder
disown: disown
dispel: dispel
dispense: dispense,dispensing
disperse: disperse,dispersed,disperses,dispersing
display: displayed,displaying
dispose: dispose,disposed
disposed: disposed
disposition: disposition
dispute: dispute,disputed
disregard: disregard,disregarded,disregards
disreputable: disreputable
dissipate: dissipate,dissipated,dissipates,dissipating
dissipation: dissipation
dissolve: dissolve,dissolved,dissolves
distance: distance,distances
distant: distant
distantly: distantly
distend: distend
distended: distended
distention: distention
distil: distilled
distiller: distiller
distinct: distinct
distinction: distinction,distinctions
distinctly: distinctly
distinguish: distinguish,distinguished,distinguishes
distinguishable: distinguishable
distinguished: distinguished
distort: distorted
distract: distract,distracted
distraction: distraction
distress: distress
distressed: distressed
distribute: distribute,distributed
disturb: disturb,disturbed,disturbing,disturbs
disturbance: disturbance
disturber: disturber
ditch: ditch
ditcher: ditcher
ditty: ditty
divan: divans
dive: dive,dived,dives
diverge: diverged,diverging
divert: divert
divest: divest,divested
divide: divided,divides,dividing
divided: divided
divider: dividers
divine: divine,divining
divining: divining
divinity: divinity
division: division,divisions
divulge: divulge
dobbin: dobbin
dobson: dobson
dock: docks
doctor: doctor,doctors
doctrine: doctrine,doctrines
dodge: dodged
dodona: dodona
dog: dog,dogging,dogs
dogwood: dogwood
doleful: doleful
dolia: dolia
dollar: dollar,dollars
dolphin: dolphin
domestic: domestic
domesticate: domesticated
domesticated: domesticated
door: door,doors
doorway: doorway
dormant: dormant
dose: doses
dost: dost
dot: dots,dotted
double: double,doubled
doubleness: doubleness
doubly: doubly
doubt: doubt,doubted
doubtless: doubtless
dough: dough
dove: dove,doves
dovecot: dovecots
downward: downward
downy: downy
dozen: dozen
drab: drab
drag: drag,dragged,dragging
draggle: draggle
dragon: dragon
drain: drain,drained
drama: drama
drastic: drastic
draught: draught,draughts
draw: draw,drawing,drawn,draws,drew
drawing: drawing
dread: dread
dream: dream,dreamed,dreaming,dreams
drear: drear
dreary: dreary
drench: drenched
drenching: drenching
dresden: dresden
dress: dress,dressed
dressing: dressing
dressmaker: dressmaker
drift: drift,drifted,drifts
driftwood: driftwood
drill: drill
drink: drank,drink,drinking,drinks,drunk
drinking: drinking
drip: dripping
dripping: dripping
drivable: drivable
drive: drive,driven,driving,drove
driver: driver
driving: driving
drone: drone
drool: drooling
droop: droop,drooped,drooping
drop: drop,dropped,dropping,drops
dropsical: dropsical
dross: dross
drove: droves
drover: drovers
drown: drown,drowned,drowning
drowsiness: drowsiness
drowsy: drowsy
drudgery: drudgery
druids: druids
drum: drum
drummer: drummer
drumstick: drumsticks
drunk: drunk
drunkard: drunkard
drunkenness: drunkenness
dry: dried,drier,dry
drying: drying
dryness: dryness
dubious: dubious
duck: duck,ducking,ducks
duckling: duckling
dull: dull,dullest
dulness: dulness
dum: dum
dumb: dumb
dump: dumps
dun: dun
duncan: duncan
duration: duration
durum: durum
dusk: dusk
dusky: dusky
dust: dust,dusted
dusty: dusty
dutch: dutch
duty: duties,duty
dwarf: dwarfs
dwell: dwell,dwelling,dwells,dwelt
dwelling: dwelling,dwellings
dwelt: dwelt
dwindle: dwindled
dye: dyed
dying: dying
dynasty: dynasties,dynasty
dyspepsia: dyspepsia
eager: eager
eagerly: eagerly
eagle: eagles
ear: ear,ears
earn: earn,earned,earning
earnest: earnest
earnestly: earnestly
earning: earning
earth: earth,earths
earthen: earthen
earthiness: earthiness
earthly: earthly
earthy: earthy
ease: ease
easily: easily
east: east
eastern: eastern
eastward: eastward
easy: easier,easiest,easy
eat: ate,eat,eaten,eating,eats
eater: eater
eating: eating
eaves: eaves
ebriosity: ebriosity
echo: echo,echoed,echoes
economic: economic
economical: economical
economize: economized
economy: economy
ecstasy: ecstasy
eden: eden
edge: edge,edged,edges
edifying: edifying
edit: edit
edition: edition
editor: editor,editors
educate: educate,educated
education: education
eel: eels
effective: effective
effectively: effectively
effectual: effectual
effectually: effectually
effeminate: effeminate
effete: effete
effort: effort,efforts
egg: egg,eggs
egotism: egotism
egypt: egypt
egyptian: egyptian
eighteen: eighteen
eighth: eighth,eighths
eightieth: eightieth
ejaculate: ejaculates
ejaculation: ejaculation
eke: eke
elaborate: elaborate
elaborateness: elaborateness
elapse: elapsed
elastic: elastic
elasticity: elasticity
elbow: elbow,elbows
elder: elder
elderly: elderly
elect: elect
election: election
electrify: electrifying
elegance: elegance
element: element,elements
elemental: elemental
elevate: elevate,elevated,elevating
elevated: elevated
elevation: elevation
elicit: elicited
elizabeth: elizabeth
elizabethan: elizabethan
elm: elm,elms
eloquence: eloquence
eloquent: eloquent
eloquently: eloquently
elysian: elysian
emancipation: emancipation
emasculate: emasculated
embankment: embankment
ember: embers
embodiment: embodiment
embrace: embraced,embraces,embracing
embroider: embroidered
embryo: embryo
emerald: emerald
emerge: emerged,emerges
eminent: eminent
emit: emit,emits
emperor: emperor,emperors
emphasis: emphasis
emphasize: emphasizing
empire: empire,empires
employ: employ,employed,employing,employs
employee: employee
employer: employer
employment: employment,employments
emptiness: emptiness
emulate: emulate
enable: enable,enabled
enact: enacted
encircle: encircling
encounter: encountered
encourage: encourage,encouraging
encouragement: encouragement
encouraging: encouraging
encroachment: encroachments
encumber: encumbered
encumbrance: encumbrance,encumbrances
endanger: endangered
endeavor: endeavor,endeavored,endeavoring,endeavors
endless: endless
endow: endowed
endurance: endurance
endure: endure,enduring
enemy: enemies,enemy
energetically: energetically
energy: energy
enervate: enervates
engage: engage,engaged
engaged: engaged
engagement: engagement,engagements
engine: engine,engines
engineer: engineer,engineers
england: england
englander: englander
english: english
englishman: englishman
englishmen: englishmen
engraven: engraven
enhance: enhance,enhanced
enjoy: enjoy,enjoyed,enjoying,enjoys
enjoyment: enjoyment
enlighten: enlighten
enlightened: enlightened
enlist: enlist
ennui: ennui
enormity: enormity
enormous: enormous
enrich: enriched
enslave: enslave
entangle: entangled
enter: enter,entered,entering
enterprise: enterprise,enterprised,enterprises
enterprising: enterprising
entertain: entertain,entertained,entertains
entertained: entertained
entertainment: entertainment,entertainments
enthusiasm: enthusiasm
entire: entire
entireness: entireness
entitle: entitled,entitles
entity: entity
entomologist: entomologists
entrance: entrance
entry: entries,entry
enumerate: enumerating
envelop: envelop
environ: environ
epaulet: epaulet
epidermis: epidermis
epitaph: epitaph
epitome: epitome
epoch: epochs
equable: equable
equal: equal,equalled,equals
equally: equally
equilibrium: equilibrium
equipage: equipage
equivalent: equivalent
era: era,eras
eradication: eradication
ere: ere
erect: erect,erected
errand: errand,errands
error: error
eruption: eruption
escape: escape,escaped
escort: escort
esculent: esculents
esoteric: esoteric
esquire: esquire
esse: esse
essence: essence
essential: essential,essentials
essentially: essentially
establish: establish,established
establishment: establishment
estate: estate,estates
esteem: esteem,esteemed,esteeming
esteemed: esteemed
estimate: estimate,estimated,estimates,estimating
estimation: estimation
estivate: estivate
eternal: eternal
eternity: eternities,eternity
etesian: etesian
ether: ether
ethereal: ethereal
ethic: ethics
etiquette: etiquette
eulogies: eulogies
europe: europe
european: european
eurus: eurus
evangelist: evangelist
evaporate: evaporate
evaporation: evaporation,evaporations
eve: eve
evelyn: evelyn
evening: evening,evenings
event: event,events
eventful: eventful
eventide: eventide
evergreen: evergreen,evergreens
everlasting: everlasting
everlastingly: everlastingly
evidence: evidence,evidences
evident: evident
evidently: evidently
evil: evil,evils
evince: evincing
evitable: evitable
exact: exact
exacting: exacting
exaggerate: exaggerate
exalt: exalted
examine: examine,examined,examining
exceed: exceeds
exceedingly: exceedingly
excellent: excellent
exception: exception,exceptions
excess: excess
excessive: excessive
exchange: exchange,exchanged
excitable: excitable
excite: excite,excited
excited: excited
excitement: excitement
exciting: exciting
exclaim: exclaim,exclaimed
exclude: exclude,excluded,excluding
exclusion: exclusion
exclusively: exclusively
exclusiveness: exclusiveness
excommunicate: excommunicate
excrement: excrement,excrements
excrementitious: excrementitious
excursion: excursion,excursions
excuse: excuse,excused
execute: execute,executed
execution: execution
exempt: exempted
exercise: exercise
exert: exert,exerts
exertion: exertion,exertions
exhalation: exhalations
exhaust: exhausted
exhausted: exhausted
exhaustion: exhaustion
exhibit: exhibit,exhibited,exhibiting
exhibition: exhibition
exhilarate: exhilarating
exhilarating: exhilarating
exist: exist,existed,existing,exists
existence: existence
exogenous: exogenous
exorbitant: exorbitant
exoteric: exoteric
expand: expand,expanded
expanse: expanse
expansion: expansion
expect: expect,expected,expecting,expects
expectation: expectation,expectations
expecter: expecter
expediency: expediency
expedient: expedient
expedition: expedition,expeditions
expeditious: expeditious
expel: expelled
expense: expense,expenses
expensive: expensive
experience: experience,experienced,experiences
experienced: experienced
experiment: experiment,experiments
experimentalist: experimentalists
expert: expert
expiate: expiating
expiatory: expiatory
explain: explain
explore: explore,exploring
export: export,exports
expose: expose,exposed,exposing
exposed: exposed
express: express,expressed,expresses,expressing
expression: expression
expressive: expressive
expulsion: expulsion
extend: extend,extended,extends
extensive: extensive
extent: extent
exterminate: exterminated
external: external
externally: externally
extinct: extinct
extinguish: extinguish,extinguished
extra: extra
extract: extract,extracting
extraction: extraction
extravagant: extravagant
extravagantly: extravagantly
extreme: extreme,extremes
extremely: extremely
extremity: extremities,extremity
exuberance: exuberance
exude: exude
eye: eye,eyes
eyelash: eyelashes
eyry: eyry
fable: fable,fables
fabulous: fabulous
faced: faced
factitious: factitious
factory: factories,factory
faculty: faculties,faculty
fade: fade
fagot: fagots
fail: fail,failed,failing,fails
failure: failure,failures
fain: fain
faint: faint,faintest
faintly: faintly
fair: fair,fairer,fairest
fairy: fairy
faith: faith
faithful: faithful
faithfully: faithfully
falconry: falconry
fall: fall,fallen,falling,falls,fell
fallow: fallow
falls: falls
false: false
falsehood: falsehood
falsely: falsely
fame: fame
familiar: familiar
family: families,family
famine: famine
famous: famous
fan: fan
fancied: fancied
fanciful: fanciful
fancifully: fancifully
fancy: fancied,fancy
fantastic: fantastic
fare: fare
farewell: farewell
farm: farm,farms
farmer: farmer,farmers
farmhouse: farmhouses
farming: farming
farth: farthest
fashion: fashion,fashions
fashionable: fashionable
fashioned: fashioned
fast: fast,fasted,faster
fasten: fasten,fastened
fasting: fasting
fat: fat
fatal: fatal
fatalist: fatalist
fatally: fatally
fate: fate,fates
fates: fates
father: father,fathers
fatherland: fatherland
fathom: fathom,fathomed,fathoms
fatigued: fatigued
fatness: fatness
fatted: fatted
fatten: fattened
fault: fault,faults
faun: fauns
faux: faux
favor: favor,favored,favoring
favorable: favorable
fear: fear,feared,fearing,fears
feast: feast
feather: feather,feathers
feature: feature,featured,features
february: february
fed: fed
feeble: feeble,feebler,feeblest
feebly: feebly
feed: fed,feed
feeder: feeder
feeding: feeding
feel: feel,feeler,feeling,feels
feeler: feelers
feeling: feeling,feelings
fell: felled,felling
feller: fellers
fellow: fellow,fellows
female: female
fence: fence,fenced,fences
fencing: fencing
fermentation: fermentations
fern: fern
ferocity: ferocity
ferrule: ferrule
fertile: fertile
fertility: fertility
fertilize: fertilizing
festal: festal
festival: festival
festive: festive
festoon: festoons
fetch: fetch,fetched
fetter: fetters
fibre: fibre
fibrous: fibrous
fictile: fictile
fiction: fiction
fidelity: fidelity
field: field,fields
fiercely: fiercely
fiery: fiery
fight: fight,fights,fought
figure: figure,figures
file: file
filth: filth
fin: fins
final: final
finally: finally
finance: finance
finder: finder
fine: fine,finer,finest
finely: finely
fineness: fineness
finger: finger,fingers
finish: finish,finished,finishes,finishing
fir: fir
fireman: firemen
fireplace: fireplace
fireside: fireside
firing: firing
firkin: firkin
firm: firm,firmer
firma: firma
firmament: firmament
firmly: firmly
firstly: firstly
fish: fish,fished,fishes,fishing
fisher: fisher,fishers
fisherman: fisherman,fishermen
fishery: fisheries
fishing: fishing
fit: fit,fits,fitted,fittest,fitting
fitness: fitness
fitting: fitting
fixture: fixture
flabbiest: flabbiest
flag: flag,flags
flake: flakes
flame: flame,flames
flannel: flannel
flap: flap,flapped,flapping
flash: flash,flashes
flat: flat,flatter
flatter: flattered
flattering: flattering
flattish: flattish
flatulency: flatulency
flavor: flavor
flaxen: flaxen
flee: flee
fleet: fleet,fleets
fleeting: fleeting
flesh: flesh,fleshed
fleshy: fleshy
flicker: flickering
flight: flight,flights
flint: flint
flit: flit,flitted,flitting
float: float,floated,floating,floats
flock: flock,flocks
flood: flood
floor: floor
flooring: flooring
flounder: floundered,floundering
flour: flour
flourish: flourish,flourishes,flourishing
flourishing: flourishing
flow: flow,flowed,flowing,flows
flower: flower,flowers
flowering: flowering
flowery: flowery
fluctuate: fluctuating
fluctuation: fluctuation
fluid: fluid
flurry: flurries
flute: flute
flutter: flutter,fluttered,fluttering
fluviatile: fluviatile
fly: flew,flies,fly,flying
flying: flying
fodder: fodder,foddering
foe: foe,foes
fog: fog,fogs
foggy: foggy
foist: foist
fold: folds
foliaceous: foliaceous
foliage: foliage
folk: folks
follow: follow
follower: follower
fondness: fondness
food: food
fool: fool
foolish: foolish
foolishly: foolishly
foolishness: foolishness
foot: feet,foot
footpath: footpath
footstep: footsteps
forbid: forbid,forbidden
forbidden: forbidden
force: force,forced,forces
forcibly: forcibly
fore: fore
foreboding: forebodings
forefather: forefathers
foreground: foreground
foreign: foreign
foreigner: foreigner
foreknowledge: foreknowledge
foremost: foremost
forenoon: forenoon
foresee: foresee
forest: forest,forests
forester: forester
forge: forge,forged
forget: forget,forgetting,forgot,forgotten
forgive: forgiven,forgiving
fork: forked,forks
forlorn: forlorn
form: form,formed,forming,forms
formal: formal
formula: formula
forsake: forsake,forsaken
forsaking: forsaking
forsooth: forsooth
fort: fort,forts
forthwith: forthwith
fortitude: fortitude
fortnight: fortnight
fortune: fortune,fortunes
forum: forum
fossil: fossil
foundation: foundation,foundations
founder: founder
fountain: fountain
fourteen: fourteen
fourth: fourth
fowl: fowl,fowling,fowls
fowling: fowling
fox: fox,foxes
fraction: fraction
fragile: fragile
fragment: fragment
fragrance: fragrance
fragrant: fragrant
frame: frame,framed
france: france
frankincense: frankincense
franklin: franklin
frankness: frankness
freeborn: freeborn
freedom: freedom
freely: freely
freeman: freeman
freeze: freeze,freezes,freezing,froze,frozen
freezing: freezing
freight: freight
french: french
frequency: frequency
frequent: frequent,frequented,frequenting,frequents
frequenter: frequenter
frequently: frequently
fresco: fresco
fresh: fresh,fresher
freshet: freshet,freshets
freshly: freshly
freshness: freshness
fret: fretted
friction: friction
friday: friday
fridays: fridays
friend: friend,friends
friendliness: friendliness
friendly: friendly
friendship: friendship
frightening: frightening
fringe: fringe,fringed
frisk: frisk
fritter: frittered
frivolous: frivolous
frizzled: frizzled
fro: fro
frock: frock
frog: frog,frogs
frond: fronds
frontier: frontier
fronting: fronting
frost: frost,frosts
frostbitten: frostbitten
frosty: frosty
frozen: frozen
frugal: frugal
fruit: fruit,fruits
fruitful: fruitful
fry: fried,fry
frying: frying
fuel: fuel
fugitive: fugitive
fulfil: fulfil,fulfilled
fume: fumes
function: function,functions
fund: fund
funeral: funeral
fungus: fungi,fungus
fur: fur,furring
furious: furious
furnace: furnace
furnish: furnish,furnished,furnishes
furniture: furniture
furrow: furrow,furrowing,furrows
fut: fut
future: future
futurity: futurity
gabardine: gabardine
gain: gain,gained,gains
gainer: gainer
gala: gala
gale: gale,gales
gales: gales
gallery: gallery
gallows: gallows
game: game,games
gaming: gaming
gang: gang
gange: ganges
gantlet: gantlet
gap: gap,gaps
garb: garb
garden: garden,gardens
garlic: garlic
garment: garment,garments
garret: garret,garrets
gasp: gasping
gate: gate
gateway: gateway
gather: gather,gathered,gathering,gathers
gatherer: gatherer
gauge: gauge
gauging: gauging
gaunt: gaunt
gay: gay
gaze: gaze,gazed
gazer: gazers
gazette: gazette,gazettes
gelatinous: gelatinous
gem: gem,gems
generate: generated
generation: generation,generations
generative: generative
generosity: generosity
generous: generous
generously: generously
genial: genial
genius: genius
gentle: gentle
gentleman: gentleman,gentlemen
gentleness: gentleness
gently: gently
genuine: genuine
genus: genus
geological: geological
geologist: geologist,geologists
george: george
georgia: georgia
germ: germ,germs
german: german
gesture: gesture
gewgaw: gewgaws
ghastly: ghastly
ghost: ghosts
ghoul: ghouls
giant: giant,giants
gift: gift,gifts
gig: gigs
gild: gilding
gilded: gilded
gill: gill
gilt: gilt
ginger: ginger
gingerbread: gingerbread
gingham: ginghams
giraffe: giraffe,giraffes
gird: gird,girded
girdle: girdled,girdling
girl: girl,girls
girth: girth,girths
gizzard: gizzard
glad: glad
gladly: gladly
glance: glances,glancing
glass: glass,glasses
glassy: glassy
glaucous: glaucous
glb: glb
gleam: gleam,gleamed,gleaming
glean: gleaning
glee: glee,glees
glen: glen
glide: glide,gliding
glimmer: glimmer
glimpse: glimpse
glisten: glistening
globe: globe
globule: globule
globus: globus
glorify: glorify
glorious: glorious
glory: glory
glow: glow,glowing,glows
glowing: glowing
glue: glue
glutton: glutton
gluttonous: gluttonous
gnarled: gnarled
gnaw: gnaw,gnawed,gnawing
goad: goaded
goal: goal
goat: goat
gobble: gobble
god: god,gods
goddess: goddess
godlike: godlike
godspeed: godspeed
gold: gold
golden: golden
goldenrod: goldenrod
gong: gong
goodness: goodness
goody: goody
goose: geese,goose
gorge: gorge
gorgon: gorgon
gorry: gorry
gosh: gosh
gossamer: gossamer
gossip: gossip,gossips
gothic: gothic
gouge: gouged
gourd: gourds
govern: govern,governed,governs
government: government,governments
governor: governor
gown: gown
grace: grace,graces
graceful: graceful
gracefully: gracefully
gracefulness: gracefulness
gradation: gradations
grade: grades,grading
gradual: gradual
gradually: gradually
graduate: graduated
grain: grain,grains
granada: granada
granary: granaries,granary
grand: grand,grander,grandest
grandeur: grandeur
grandfather: grandfather
grandly: grandly
grandmother: grandmother
granite: granite
grant: granted
granum: granum
grape: grape,grapes
graphically: graphically
grapple: grappling
grasp: grasp,grasping
grass: grass,grasses
grasshopper: grasshoppers
grassy: grassy
grate: grate,grating
grateful: grateful
gratification: gratification
gratuitous: gratuitous
gratuitously: gratuitously
grave: grave,graves
gravelly: gravelly
gravely: gravely
graveyard: graveyard
gravitate: gravitate
gravity: gravity
gray: gray
grease: grease
greasy: greasy
greatcoat: greatcoat
greatly: greatly
greatness: greatness
grecian: grecian
greece: greece
greedily: greedily
greedy: greedy
greek: greek,greeks
green: green,greener
greenish: greenish
greenness: greenness
greet: greet
gregariousness: gregariousness
grenadier: grenadiers
grey: grey
grief: grief,griefs
grievance: grievance
grieve: grieve,grieved
grind: grind
grist: grist
grocery: groceries,grocery
groove: groove,grooves
grope: groped,groping
gross: gross,grossest
grosse: grosse
grotesque: grotesque
ground: ground
groundnut: groundnut
grounds: grounds
grove: grove,groves
grovel: grovelling
grow: grew,grow,growing,grown,grows
growl: growl
growth: growth
grub: grub,grubbing
gruel: gruel
guard: guard,guarded
guardian: guardian
guess: guess,guessed
guest: guest,guests
guidance: guidance
guide: guide,guided,guides
guile: guile
guilt: guilt
guilty: guilty
guinea: guinea
guise: guise
gulf: gulf
gull: gull
gulp: gulped
gum: gum
gun: gun,guns
gunny: gunny
gurgle: gurgling
gush: gushed
guttural: guttural
guy: guy
gypsy: gypsy
gyrinus: gyrinus
habet: habet
habit: habit,habits
habitat: habitat
habitation: habitation
habitually: habitually
hack: hack
hacking: hacking
haddock: haddock
hag: hags
hair: hair,hairs
hall: hall,halls
halo: halo
hamlet: hamlet,hamlets
hammer: hammer,hammered,hammering,hammers
hammered: hammered
hand: hand,handed,hands
handed: handed
handful: handful
handkerchief: handkerchief
handle: handle,handles
handling: handling
handselled: handselled
handsome: handsome
handsomely: handsomely
handsomer: handsomer
handwriting: handwriting
handy: handy
hang: hang,hanging,hangs,hung
happen: happen,happened
happily: happily
happiness: happiness
happy: happy
harass: harass,harassed
harbor: harbor,harbored,harbors
harborless: harborless
hard: hard,harder,hardest
hardiness: hardiness
hardness: hardness
hardship: hardship
hardy: hardier,hardy
hare: hare,hares
harem: harem
hark: hark
harlequin: harlequin
harm: harm
harmless: harmless
harmonious: harmonious
harmonize: harmonized
harmony: harmony
harness: harness,harnessed
harp: harp
harper: harper
harpy: harpy
harrier: harriers
harrow: harrowed
harrowing: harrowing
harry: harry
harsh: harsh
harshly: harshly
harvest: harvest,harvested
harvesting: harvesting
hast: hast
haste: haste
hasten: hasten,hastens
hastily: hastily
hasty: hasty
hat: hat
hatch: hatched,hatches
hatching: hatching
hate: hate
hatred: hatred
haughty: haughty
haul: haul,hauled
haunt: haunt,haunted,haunts
hawk: hawk,hawks
hay: hay
haying: haying
haze: haze
hazel: hazel
hazy: hazy
head: head,headed,heads
headed: headed
headland: headlands
headlong: headlong
headway: headway
health: health
healthy: healthy
heap: heap,heaps
hear: hear,heard,hearing,hears
hearer: hearer
hearing: hearing
heart: heart,hearts
hearted: hearted
hearth: hearth
heartily: heartily
hearty: heartiest,hearty
heat: heat
heathen: heathen
heathenish: heathenish
heave: heave,heaved
heaven: heaven,heavens
heavenly: heavenly
heaving: heaving
heavy: heaviest,heavy
hebe: hebe
hebrews: hebrews
hector: hector
heedless: heedless
heedlessly: heedlessly
heedlessness: heedlessness
heel: heel,heels
height: height,heights
heir: heir
helena: helena
helm: helm
helpless: helpless
helve: helve
hemlock: hemlock
hemp: hemp
hen: hen,hens
henceforth: henceforth
henry: henry
herald: herald,heralds
herb: herb,herbs
herba: herba
herculean: herculean
hercules: hercules
herd: herd,herds
herdsman: herdsman
hereabouts: hereabouts
hermit: hermit
hero: hero,heroes
heroic: heroic
heroism: heroism
heron: herons
hesitate: hesitate,hesitated
hesperides: hesperides
hew: hewed,hewing,hewn
hezekiah: hezekiah
hic: hic
hickory: hickories,hickory
hide: hide,hides
hideous: hideous
hieroglyphic: hieroglyphic
highway: highway,highways
hilarious: hilarious
hill: hill,hills
hills: hills
hillside: hillside,hillsides
hinder: hinder,hindered
hindoo: hindoo
hindrance: hindrance,hindrances
hinge: hinges
hint: hint
hippocrates: hippocrates
hire: hire,hired,hires,hiring
hireling: hireling
hirundo: hirundo
hissing: hissing
historical: historical
history: histories,history
hit: hit
hitherto: hitherto
hive: hive,hives
hoarse: hoarse
hoary: hoary
hobble: hobble
hoe: hoe,hoed,hoeing
hoeing: hoeing
hog: hog,hogs
hogshead: hogshead
hold: held,hold,holding,holds
holder: holder,holders
hole: hole,holes
holiday: holiday,holidays
holiness: holiness
hollander: hollander
hollow: hollow,hollowed,hollows
holly: holly
holy: holiest,holy
homage: homage
homer: homer,homers
homeric: homeric
homesick: homesick
homestead: homestead,homesteads
homeward: homeward
hominy: hominy
honest: honest
honestly: honestly
honesty: honesty
honey: honey
honeycombed: honeycombed
honk: honk
honking: honking
honor: honor,honored,honors
honorable: honorable
hoo: hoo
hook: hook,hooks
hooked: hooked
hooting: hooting
hop: hop
hope: hope,hoped,hopes,hoping
hopeful: hopeful
hopeless: hopeless
hopper: hoppers
horizon: horizon
horizontal: horizontal
horizontally: horizontally
horn: horn,horned,horns
hornbeam: hornbeam
horny: horny
horrid: horrid
horror: horrors
horse: horse,horses
hospitable: hospitable
hospitality: hospitality
host: host
hot: hot,hotter
hotel: hotel
hound: hound,hounds
hounding: hounding
hour: hour,hours
hourly: hourly
house: house,housed,houses
household: household,households
housekeeper: housekeeper,housekeepers
housekeeping: housekeeping
housewife: housewife,housewives
housework: housework
hover: hovering
howard: howard
howl: howl,howls
huckleberry: huckleberries,huckleberry
hudson: hudson
hue: hue,hues
hug: hugs
huge: huge
hugh: hugh
hum: hum,hummed,humming
human: human
humane: humane
humanely: humanely
humanest: humanest
humanity: humanity
humanized: humanized
humble: humble,humbler
humbly: humbly
humility: humility
hummock: hummock
humor: humor
humorous: humorous
hung: hung
hunger: hunger
hungry: hungry
hunt: hunt,hunted,hunting
hunter: hunter,hunters
hunting: hunting
hurl: hurled
hurry: hurried,hurry
hurt: hurt
husbandman: husbandman,husbandmen
husbandry: husbandry
hush: hush,hushed
husk: husks
hustling: hustling
hut: hut,huts
hyades: hyades
hybrid: hybrid,hybrids
hyde: hyde
hydra: hydra
hygeia: hygeia
hymn: hymn,hymns
hyperborean: hyperborean
hypocrisy: hypocrisy
icarian: icarian
ice: ice,ices
iceland: iceland
ichthyologist: ichthyologists
icicle: icicles
icy: icy
idea: idea,ideas
idealist: idealists
identical: identical
identify: identified
idiot: idiots
idiotic: idiotic
idle: idle
idleness: idleness
idly: idly
ignoble: ignoble
ignorance: ignorance
ignorant: ignorant
iliad: iliad
illiterate: illiterate
illiterateness: illiterateness
illumine: illumines
illusion: illusion
illusive: illusive
illusory: illusory
illustrate: illustrated,illustrates
illustrious: illustrious
image: image
imaginable: imaginable
imaginary: imaginary
imagination: imagination
imagine: imagine,imagined,imagining
imaging: imaging
imbibe: imbibes
imbricate: imbricated
imbrute: imbrute
imitate: imitate,imitated
immeasurable: immeasurable
immense: immense
immerse: immersed
immigrant: immigrant
immoral: immoral
immortal: immortal
immortality: immortality
imp: imps
impale: impaling
impart: impart,imparted,imparts
impartial: impartial
impartially: impartially
impatient: impatient
impel: impelled
imperfect: imperfect
imperfection: imperfection,imperfections
imperialist: imperialists
imperishable: imperishable
impersonal: impersonal
impertinent: impertinent
impervious: impervious
impetuous: impetuous
implement: implements
imply: implied,implies,imply
import: import,importing,imports
impose: impose,imposed
impossible: impossible
impound: impounded
impoverish: impoverishing
impoverished: impoverished
impress: impress,impressed
impressed: impressed
impressible: impressible
impression: impression
impressive: impressive
impressively: impressively
imprison: imprisoned,imprisons
imprisonment: imprisonment
improperly: improperly
impropriety: impropriety
improvable: improvable
improve: improve,improved,improving
improved: improved
improvement: improvement,improvements
improvidence: improvidence
impudent: impudent
impulse: impulse,impulses
impunity: impunity
impure: impure
impurity: impurity
inaccessible: inaccessible
inadequacy: inadequacy
inanimate: inanimate
inaudible: inaudible
incapacitate: incapacitated
incase: incased
incense: incense
incessant: incessant
incessantly: incessantly
inch: inch,inches
incident: incident,incidents
incidental: incidental
inclination: inclination,inclinations
incline: incline,inclined,inclines
inclined: inclined
include: included,including
income: income
inconceivable: inconceivable
inconsiderable: inconsiderable
inconsistency: inconsistencies,inconsistency
inconsistent: inconsistent
inconsolable: inconsolable
inconsolably: inconsolably
inconvenience: inconvenience
inconveniency: inconveniency
inconvenient: inconvenient
incorporate: incorporated
increase: increase,increased,increases,increasing
incredible: incredible
incredibly: incredibly
incredulity: incredulity
incur: incur,incurred
incurable: incurable
inde: inde
indefinite: indefinite
indefinitely: indefinitely
indentation: indentation
indented: indented
independence: independence
independent: independent,independents
independently: independently
indescribable: indescribable
indescribably: indescribably
indestructible: indestructible
indeterminable: indeterminable
indeterminate: indeterminate
india: india
indian: indian,indians
indicative: indicative
indies: indies
indifference: indifference
indifferent: indifferent
indifferently: indifferently
indigence: indigence
indigenous: indigenous
indirect: indirect
indirectly: indirectly
indispensable: indispensable
indistinct: indistinct
indistinctly: indistinctly
individual: individual,individuals
individualize: individualize
indolence: indolence
indra: indra
inducement: inducement
indulge: indulge,indulged,indulges,indulging
industrious: industrious
industriously: industriously
industry: industry
indweller: indweller
ineffable: ineffable
ineffectual: ineffectual
ineffectually: ineffectually
inefficiency: inefficiency
inequality: inequalities
inert: inert
inevitable: inevitable
inevitably: inevitably
inexhaustible: inexhaustible
inexpedient: inexpedient
inexpressible: inexpressible
infancy: infancy
infant: infant,infants
infanta: infanta
infer: infer,inferred
inferior: inferior
infernal: infernal
infest: infest
infinite: infinite
infinitely: infinitely
infinitesimal: infinitesimal
infirm: infirm
infirmity: infirmity
inflame: inflame
inflate: inflated
inflexible: inflexible
influence: influence,influences
influx: influx
inform: inform,informed,informing
informant: informant
infringe: infringed
ingenious: ingenious
ingenuity: ingenuity
ingredient: ingredient
inhabit: inhabit
inhabitant: inhabitant,inhabitants
inhabitants: inhabitants
inhale: inhaling
inherent: inherent
inherit: inherit,inherited
inheritance: inheritance
inhospitable: inhospitable
inhospitality: inhospitality
inhumane: inhumane
injure: injure,injuring
injury: injury
injustice: injustice
ink: ink
inland: inland
inlet: inlet,inlets
inn: inn
innate: innate
innocence: innocence
innocent: innocent,innocents
innumerable: innumerable
inoffensive: inoffensive
inorganic: inorganic
inquire: inquire,inquired
inquiry: inquiries,inquiry
inquisitive: inquisitive
inquisitively: inquisitively
insane: insane
insanity: insanity
inscribe: inscribed
insect: insect,insects
insectivorous: insectivorous
insensibility: insensibility
insensible: insensible
insensibly: insensibly
inseparable: inseparable
insert: inserting
insight: insight
insignificant: insignificant
insist: insist,insisting
insolvent: insolvent
inspect: inspecting
inspector: inspector
inspiration: inspiration
inspire: inspire,inspired,inspires,inspiring
inspiring: inspiring
instance: instance,instances
instant: instant
instantaneous: instantaneous
instantaneously: instantaneously
instantly: instantly
instil: instilling
instinct: instinct
instinctively: instinctively
institute: institute
institution: institution,institutions
instruct: instructed
instructor: instructor
instrument: instrument,instruments
insufficiency: insufficiency
insufficient: insufficient
insular: insular
insulate: insulated
insult: insult
insurance: insurance
insure: insured
insurrection: insurrection
intangible: intangible
integrity: integrity
integument: integument
intellect: intellect,intellects
intellectual: intellectual
intellectually: intellectually
intellectualness: intellectualness
intelligence: intelligence,intelligences
intelligent: intelligent
intemperate: intemperate
intend: intend,intended,intending
intense: intense
intention: intention,intentions
intentionally: intentionally
intercourse: intercourse
interfere: interfere,interfered,interferes
interior: interior
interlace: interlace
intermediate: intermediate
intermit: intermitting
intermix: intermixed
internal: internal
internally: internally
internecine: internecine
interpret: interpreted
interpretation: interpretation
interrupt: interrupt,interrupted
interrupted: interrupted
interruption: interruption
intersect: intersect,intersected
interval: interval,intervals
intervene: intervene,intervening
intervert: interverting
interweave: interwoven
intimate: intimate
intimation: intimation
intoxicate: intoxicated
intoxicating: intoxicating
intoxication: intoxication
intra: intra
introduce: introduce,introduced
introduction: introduction
intruder: intruder
invade: invading
invariably: invariably
invective: invective
invent: invent,invented
inventor: inventor
invert: invert
investment: investment,investments
inveterate: inveterate
invidious: invidious
invigorate: invigorates
inviolable: inviolable
invisible: invisible
invitation: invitation
invite: invite,invites
invoke: invoke
involuntary: involuntary
involve: involved
inwardly: inwardly
ireland: ireland
iris: iris
irish: irish
irishman: irishman
irishmen: irishmen
irksome: irksome
iron: iron,irons
irrecoverable: irrecoverable
irregular: irregular
irregularity: irregularity
irrepressible: irrepressible
irresistible: irresistible
irretrievably: irretrievably
irreverent: irreverent
irruption: irruption
island: island,islands
islander: islander
islanders: islanders
islands: islands
isle: isle
islet: islet
israel: israel
issue: issue
isthmus: isthmus
italy: italy
itch: itch
itching: itching
item: item,items
iteration: iteration
ivy: ivy
jack: jack
jacket: jacket
jackknife: jackknife
jail: jail
jailer: jailer,jailers
jam: jammed
james: james
january: january
japan: japan,japanned
jar: jarring
jarred: jarred
jaw: jaw,jaws
jay: jay,jays
jelly: jelly
jerk: jerk
jersey: jersey
jest: jest
jesting: jesting
jesuits: jesuits
jesus: jesus
jewel: jewels
jeweller: jeweller
jingle: jingle
job: job,jobs
john: john
johnson: johnson
joint: joint,joints
joke: joking
jonas: jonas
jonathan: jonathan
jonsonian: jonsonian
jostle: jostled
journal: journal
journey: journey
jove: jove
jowl: jowl
joy: joy,joys
judge: judge,judged,judging
judgment: judgment
jug: jug
juga: juga
july: july
jump: jump,jumped,jumping
june: june
juniper: juniper
junk: junk
juno: juno
jupiter: jupiter
justice: justice
kaleidoscope: kaleidoscopes
kalpa: kalpa
keel: keel
keen: keen
keenly: keenly
keeper: keeper,keepers
keeping: keeping
kenelm: kenelm
kennel: kennels
kernel: kernel,kernels
kettle: kettle,kettles
kick: kicks
kill: kill,killed,kills
kindle: kindled
kindling: kindlings
kindness: kindness
kindred: kindred
kindredship: kindredship
king: king,kings
kingdom: kingdom
kingly: kingly
kirby: kirby
kitchen: kitchen,kitchens
kite: kite
kitten: kittens
kittly: kittly
knead: knead,kneaded
knee: knee,knees
kneel: kneeling
knife: knife,knives
knight: knights
knob: knob,knobs
knock: knock,knocked
knot: knot,knots
knowledge: knowledge
labium: labium
labor: labor,labored,laboring,labors
laboratory: laboratory
laborer: laborer,laborers
laborious: laborious
laboriously: laboriously
labyrinth: labyrinth
laciniate: laciniated
lack: lack
ladder: ladder
laden: laden
lading: lading
lady: ladies,lady
lake: lake,lakes
lamb: lambs
lamp: lamp
lamplight: lamplight
lamprey: lampreys
lance: lance
land: land,landed,lands
landlord: landlord
landscape: landscape,landscapes
lane: lanes
language: language,languages
lap: lap,lapped,laps
laplander: laplander
lapse: lapse,lapses
lapsing: lapsing
lapsus: lapsus
lard: lard
larder: larder
lark: lark
larva: larva
larynx: larynx
latch: latch
late: late
lateral: lateral
lath: lath,laths
lathing: lathing
latin: latin
latins: latins
latitude: latitude
latitudes: latitudes
laugh: laugh,laughed,laughing,laughs
laughter: laughter
launch: launch,launched
lava: lava
lave: laves
lavishly: lavishly
law: law,laws
lawfully: lawfully
lawgiver: lawgiver
lawyer: lawyer,lawyers
laxly: laxly
lay: laid,lay,laying,lays
layer: layers
lazy: lazy
le: le
lea: lea
leach: leach,leached
lead: lead,leading,leads,led
leaden: leaden
leader: leader,leaders
leaf: leaf,leaves
league: league
leak: leak,leaked
leaky: leakiest
lean: lean,leaned,leaning
leap: leap,leaped,leaping,leaps
learn: learn,learned,learning,learns
learning: learning
leave: leave,leaves,leaving,left
leaven: leaven
leavening: leavening
lecture: lecture,lectures,lecturing
lecturer: lecturer
ledger: ledger
ledges: ledges
leek: leek
left: left
leg: leg,legs
legally: legally
legged: legged
legible: legible
legion: legion,legions
legislate: legislate
legislation: legislation
legislative: legislative
legislator: legislator,legislators
legislature: legislature
legitimately: legitimately
leisure: leisure
lend: lend
lengthen: lengthen
lengthwise: lengthwise
lenticular: lenticular
leopard: leopard
lepus: lepus
lethargy: lethargy
letter: letter,letters
lettuce: lettuce
level: level,levelled,levelling
lever: lever
levity: levity
lewis: lewis
liability: liability
liable: liable
liber: liber
liberal: liberal
liberality: liberality
liberalize: liberalizing
liberally: liberally
liberty: liberties,liberty
library: library
license: license
lichen: lichen,lichens
lick: lick,licks
lid: lid,lids
lie: lain,lie,lies,lying
liebig: liebig
life: life,lives
lifelong: lifelong
lifetime: lifetime
lift: lift,lifting
ligature: ligatures
light: light,lighted,lighting,lights,lit
lightning: lightning
liken: likened
lilac: lilac
lily: lily
limb: limbs
limbed: limbed
lime: lime
limestone: limestone
limit: limited,limits
limited: limited
limpid: limpid
lincoln: lincoln
linen: linen
linger: lingered,lingering
lingua: lingua
link: link,links
lintel: lintel
lion: lion
lip: lip,lips
liquid: liquid,liquids
liquor: liquor
lisp: lisps
lisping: lisping
list: list
listen: listen,listened,listening,listens
literal: literal
literally: literally
literary: literary
literature: literature,literatures
live: live,lived,lives,living
lived: lived
livelihood: livelihood
liver: liver
livery: livery
living: living
lo: lo
load: load,loaded,loads
loaf: loaf,loaves
loafer: loafer
loath: loath
lobe: lobe,lobed,lobes
lobed: lobed
locality: locality
location: location
loch: loch
lock: lock,locked,locks
locomotive: locomotive
locust: locust,locusts
lodge: lodge,lodged
lodging: lodging
lofty: loftier,lofty
log: log,logged,logs
logarithmic: logarithmic
logic: logic
loin: loins
loiter: loiter
loitering: loitering
london: london
lone: lone
loneliness: loneliness
lonely: lonely
lonesome: lonesome
looker: looker
loom: loomed
loon: loon,loons
loose: loose
loosely: loosely
loquacious: loquacious
lord: lord,lords
lore: lore
lose: lose,loses,losing,lost
loss: loss
lot: lot
lotus: lotus
loud: loud,louder
loudly: loudly
louisiana: louisiana
lounge: lounge
love: love,loved,loves,loving
lover: lover,lovers
lowing: lowing
lucid: lucid
luck: luck
lucky: lucky
ludicrous: ludicrous
lull: lull,lulled,lulls
lumber: lumber,lumbering
lump: lump
lumpish: lumpish
lunatic: lunatics
lunch: lunch
luncheon: luncheon
lung: lungs
lurk: lurk
lustily: lustily
lusty: lusty
luther: luther
luxuriance: luxuriance
luxuriant: luxuriant
luxuriantly: luxuriantly
luxurious: luxurious
luxuriously: luxuriously
luxuriousness: luxuriousness
luxury: luxuries,luxury
lyceum: lyceum
lyre: lyre
machine: machine,machines
machinery: machinery
mad: mad
madam: madam
madness: madness
madras: madras
magazine: magazines
maggot: maggot
magic: magic
magnanimity: magnanimity
magnetic: magnetic
magnetism: magnetism
magnificence: magnificence
magnificent: magnificent
magnificently: magnificently
magnify: magnified
magnitude: magnitude
magnus: magnus
maid: maids
maiden: maiden
main: main
maine: maine
mainspring: mainspring
maintain: maintain,maintained,maintaining
majesty: majesties
majority: majorities,majority
maker: maker,makers
malaria: malaria
malays: malays
male: male
malefactor: malefactors
mameluke: mameluke
mammoth: mammoth
manage: manage,managed,manages
management: management
manager: manager
mangy: mangy
manhood: manhood
maniac: maniac
maniacal: maniacal
manifest: manifest,manifested
manifestation: manifestation
manifestly: manifestly
manikin: manikins
manilla: manilla
mankind: mankind
manly: manlier,manliest,manly
manner: manner
manners: manners
mansion: mansion,mansions
mantel: mantel
mantle: mantle
manufacture: manufactured,manufactures
manufacturer: manufacturers
manurance: manurance
manure: manure,manured,manures
manus: manus
map: map,mapped
maple: maple,maples
marble: marble,marbles
march: march,marching
marching: marching
margin: margin
marine: marine
mariner: mariners
mark: mark,marked,marks
market: market,markets
marmot: marmots
marrow: marrow
marrowy: marrowy
marsh: marsh,marshes
marten: marten
martial: martial
martin: martins
martyr: martyrs
marvellousness: marvellousness
mary: mary
mason: mason
masonry: masonry
masquerade: masquerade
mass: mass,masses
massachusetts: massachusetts
massive: massive
mast: mast
master: master,mastered,masters
mat: mat,mats,matted
match: match
matchless: matchless
mate: mate
material: material,materials
materially: materially
mathematical: mathematical
mathematics: mathematics
matter: matter,matters
mature: mature,maturing
maturer: maturer
maturity: maturity
mausoleum: mausoleum
mavis: mavis
mayflower: mayflower
mead: meads
meadow: meadow,meadows
meagre: meagre
meal: meal,meals
meander: meandering
meandering: meandering
meaning: meaning
meanly: meanly
meanness: meanness
measure: measure,measured,measures,measuring
measuring: measuring
meat: meat,meats
mechanic: mechanics
mechanical: mechanical
meddle: meddling
medical: medical
medicine: medicine,medicines
mediocrity: mediocrity
meditation: meditation,meditations
mediterranean: mediterranean
medium: medium
meekness: meekness
meet: meet,meets,met
meeting: meeting
melancholy: melancholy
melodious: melodious
melodiousness: melodiousness
melody: melody
melt: melt,melted,melting,melts
mem: mem
membrane: membrane
memnon: memnon
memoirs: memoirs
memorable: memorable
memory: memories,memory
menagerie: menagerie
mend: mended
mended: mended
mending: mending
mental: mental
mention: mention,mentioned
mentor: mentors
mercenary: mercenary
merchandise: merchandise
merchant: merchant,merchants
mercurial: mercurial
mercury: mercury
mercy: mercies,mercy
mere: mere
meridian: meridian
merit: merit
merlin: merlin
merry: merry
mesopotamia: mesopotamia
mess: mess
message: messages
messenger: messenger,messengers
metal: metal,metals
metallurgy: metallurgy
metamorphose: metamorphose
metaphor: metaphor,metaphors
metaphysical: metaphysical
methinks: methinks
method: method,methods
methought: methought
methuselah: methuselah
mew: mewing
mexican: mexican,mexicans
mexico: mexico
michael: michael
microcosm: microcosm
microscope: microscope
middle: middle
middling: middling
midnight: midnight
midst: midst
midsummer: midsummer
midwinter: midwinter
mighty: mighty
migrate: migrate,migrates,migrating
mild: mild
mildewy: mildewy
mildness: mildness
mile: mile,miles
military: military
militia: militia
milk: milk,milked,milking
milkweed: milkweed
milky: milky
millet: millet
milton: milton
mince: minced
mind: mind,minded,minding,minds
minded: minded
mineral: mineral
minerva: minerva
mingle: mingle,mingled
minister: ministers
ministerial: ministerial
mink: mink,minks
minority: minority
minstrel: minstrels
mint: mint
minute: minute,minutes
miracle: miracle,miracles
miraculously: miraculously
mirage: mirage
mirror: mirror
mirth: mirth
misanthrope: misanthrope
miscalculate: miscalculated
mischief: mischief
mischievous: mischievous
misconception: misconception
miserable: miserable
misery: misery
misfortune: misfortune
misgive: misgiving
mishap: mishap
mislead: misled
mission: mission
missionary: missionaries,missionary
mississippi: mississippi
missouri: missouri
mist: mist,mists
mistake: mistake,mistakes
mistaken: mistaken
mistress: mistress
misty: misty
mitten: mittens
mix: mix,mixed
mixture: mixture
moan: moaning,moans
mob: mob
mock: mock,mocking
mode: mode,modes
model: model
moderate: moderate
modern: modern,moderns
modulate: modulated
moiling: moiling
moist: moist
moisture: moisture
molasses: molasses
mole: mole,moles
molest: molest,molested
molten: molten
moment: moment,moments
momentarily: momentarily
momentary: momentary
momus: momus
monarch: monarch
monarchy: monarchy
money: money
monkey: monkey,monkeys
monopoly: monopoly
monotonous: monotonous
monster: monster,monsters
monstrous: monstrous
month: month,months
monthly: monthly
monument: monument,monuments
mood: mood,moods
moon: moon
moonless: moonless
moonlight: moonlight
moore: moore
moose: moose
mop: mop
moral: moral
morally: morally
morning: morning,mornings
morrow: morrow
morsel: morsel
mortal: mortal,mortals
mortality: mortality
mortar: mortar
mortgage: mortgaged,mortgaging
mortification: mortification
mortise: mortised
mosquito: mosquito
moss: moss
mossy: mossy
mote: mote,motes
moth: moth
mother: mother,mothers
motion: motion,motions
motionless: motionless
motive: motive
mottled: mottled
motto: motto
mould: mould,moulds
moulder: mouldering
moult: moult
moulting: moulting
mound: mounds
mount: mounted,mounting,mounts
mountain: mountain,mountains
mountainous: mountainous
mountains: mountains
mourn: mourning
mourning: mourning
mouse: mice,mouse
mouth: mouth,mouths
movable: movable
mower: mower
mowing: mowing
muck: muck
mud: mud
muddy: muddied,muddier,muddy
muff: muff
muffled: muffled
muggy: muggy
mullein: mullein,mulleins
multiply: multiplied
multitude: multitude
mummy: mummy
mungo: mungo
munitions: munitions
munity: munity
murder: murder,murdered,murders
murmur: murmur
muscle: muscles
muse: muse
museum: museum
mushroom: mushroom
music: music
musical: musical
musician: musicians
musing: musing
musket: musket
muskrat: muskrat,muskrats
musky: musky
muslin: muslins
musquash: musquash
mussulman: mussulman
musty: musty
mutter: muttering
mutual: mutual
muzzle: muzzle
myriad: myriad,myriads
myrmidons: myrmidons
mysterious: mysterious
mystery: mystery
mythological: mythological
mythology: mythology
nail: nail,nailed,nails
naked: naked
nakedly: nakedly
nakedness: nakedness
nameless: nameless
nap: nap,napping
nape: nape
napkin: napkin
napoleon: napoleon
narrow: narrow,narrowest
narrowly: narrowly
narrowness: narrowness
nasal: nasal
nation: nation,nations
national: national
native: native,natives
natural: natural
naturalist: naturalist,naturalists
naturalize: naturalized
naturally: naturally
nature: nature,natures
naught: naught,naughts
navigation: navigation
navigator: navigators
navy: navy
nearer: nearer
nearest: nearest
nearness: nearness
neat: neat,neatest
neatly: neatly
nebuchadnezzar: nebuchadnezzar
necessaries: necessaries
necessitate: necessitated
necessity: necessities,necessity
neck: neck
needle: needle,needles
needlessly: needlessly
needy: needy
neglect: neglect,neglected
negro: negro
neigh: neigh
neighbor: neighbor,neighboring,neighbors
neighborhood: neighborhood
neighboring: neighboring
neighborliness: neighborliness
neptune: neptune
nerve: nerve,nerves
nervii: nervii
nervous: nervous
nest: nest,nested,nests
nettle: nettle
neutral: neutral
nevada: nevada
newfoundland: newfoundland
newly: newly
news: news
newspaper: newspaper,newspapers
newton: newton
nibble: nibble,nibbled,nibbling
nicholas: nicholas
nick: nick
nigh: nigh
night: night,nights
nightfall: nightfall
nightly: nightly
nights: nights
nile: nile
nilometer: nilometer
nimbly: nimbly
nimrod: nimrod
nineteenth: nineteenth
ninth: ninth
nip: nip,nipped
nipping: nipping
noble: noble,nobler,nobles,noblest
nobleman: nobleman,noblemen
nobleness: nobleness
nocturnal: nocturnal
nocumentum: nocumentum
nod: nod
noise: noise
noiseless: noiseless
noisy: noisier,noisy
nomenclature: nomenclature
nominal: nominal
nonsense: nonsense
nook: nook,nooks
noon: noon,noons
noose: noose
normal: normal
norman: norman
north: north
northerly: northerly
northern: northern
norwegian: norwegian
nose: nose
nostril: nostrils
notability: notabilities
notable: notable
notch: notch,notched
note: note,notes
notice: notice,noticed
noticeable: noticeable
notify: notified
notion: notion,notions
nourish: nourish,nourished
noveldom: noveldom
novelist: novelist
novelty: novelty
november: november
nowadays: nowadays
nucleus: nuclei
nuisance: nuisances
numb: numb,numbed
numbness: numbness
numerous: numerous
nun: nun
nurses: nurses
nut: nut,nuts
nutshell: nutshell
nutting: nutting
nymph: nymph,nymphs
oak: oak,oaks
oakum: oakum
oar: oar,oars
oats: oats
obedience: obedience
obedient: obedient
obediently: obediently
obelisk: obelisk
obey: obey,obeyed,obeys
object: object,objected,objects
objection: objection,objections
oblation: oblations
obligation: obligation
oblige: obliged
obliterate: obliterate,obliterated
oblong: oblong
obscene: obscene
obscurity: obscurities,obscurity
obsequious: obsequious
observance: observance
observation: observation
observatory: observatory
observe: observe,observed,observes,observing
observer: observer,observers
obsoletely: obsoletely
obstacle: obstacle,obstacles
obstinacy: obstinacy
obstinately: obstinately
obstruction: obstruction,obstructions
obtrude: obtrude
obvious: obvious
occasion: occasion,occasioned,occasions
occasional: occasional
occasionally: occasionally
occupant: occupant,occupants
occupation: occupation
occupied: occupied
occupy: occupied,occupies,occupy,occupying
occur: occur,occurred,occurs
ocean: ocean,oceans
october: october
odd: odd
ode: ode
odor: odor,odors
odorous: odorous
odyssey: odyssey
offence: offence,offences
offend: offend
offender: offender
offensive: offensive
offer: offer,offered,offering,offers
offering: offering
office: office,offices
officer: officer,officers
oftener: oftener
oftenest: oftenest
ohio: ohio
oil: oil
olive: olive,olives
olympus: olympus
omit: omit
omnipresent: omnipresent
ooze: oozed,oozes,oozing
opaque: opaque
operate: operate,operated
operation: operations
operative: operative,operatives
opinion: opinion,opinions
opium: opium
opponent: opponents
opportunity: opportunities,opportunity
oppose: opposed
opposition: opposition
oppress: oppressed
oppression: oppression
oracle: oracle,oracles
oracular: oracular
orator: orator,orators
oratorio: oratorios
orb: orb
orbit: orbit
orchard: orchard,orchards
ordinance: ordinances
ordinary: ordinary
ore: ore
organ: organ,organs
organic: organic
organization: organization,organizations
organize: organized,organizes,organizing
oriental: oriental,orientals
orientals: orientals
origin: origin
original: original
originality: originality
originally: originally
oriole: oriole
orleans: orleans
ornament: ornament,ornaments
ornamental: ornamental
ornamented: ornamented
ornithology: ornithology
orphan: orphan,orphans
orpheus: orpheus
oscillation: oscillation
ostrich: ostriches
otter: otter
ottoman: ottomans
oust: oust
outdoors: outdoors
outer: outer
outgo: outgoes
outgrow: outgrow
outlandish: outlandish
outlet: outlet,outlets
outline: outline,outlines
outlive: outlive,outlived
outlying: outlying
outmost: outmost
outright: outright
outset: outset
outskirts: outskirts
outward: outward
outwardly: outwardly
outweigh: outweigh
outwit: outwit
ova: ova
oven: oven
overarching: overarching
overcast: overcast
overcome: overcame,overcome
overflow: overflow,overflowed,overflowing
overgrown: overgrown
overhang: overhang,overhanging,overhung
overhead: overhead
overlap: overlap,overlapping
overlay: overlaid
overlook: overlooked,overlooking
overrate: overrated,overrates
overrun: overrun
oversee: oversee
overseer: overseer,overseers
overshadow: overshadow,overshadowed,overshadows
oversight: oversights
overtake: overtake,overtook
overwhelmed: overwhelmed
overwhelming: overwhelming
owe: owed
owl: owl,owls
owner: owner,owners
ox: ox
oxen: oxen
oxford: oxford
pace: pace,paces
pacific: pacific
pacing: pacing
pack: pack,packed
pad: pad
paddle: paddle,paddled,paddling
pagoda: pagoda
pail: pail
pailful: pailful,pailfuls
pain: pain,pains
painful: painful
paint: paint,painted
painter: painter,painters
painting: paintings
pair: pair,pairs
palace: palace,palaces
palatable: palatable
palate: palate
palaver: palaver
pale: pale
palestine: palestine
palm: palm
palpitation: palpitation
paltry: paltry
pampas: pampas
pan: pan,pans
panacea: panacea
pang: pangs
pantaloon: pantaloon
pantaloons: pantaloons
panting: panting
pantry: pantry
pants: pants
pap: pap
paper: paper,papers
par: par
parable: parable
parade: parade
paradise: paradise
parasitic: parasitic
parasol: parasol
parch: parching
parched: parched
parching: parching
parchment: parchment
pardon: pardon
pare: pare
parent: parent,parents
paring: parings
paris: paris
parish: parish
parisian: parisian
park: park
parliamentary: parliamentary
parlor: parlor,parlors
parole: parole
parrs: parrs
parsnip: parsnips
parson: parson
partake: partakes,partook
partial: partial
partially: partially
particle: particles
particulars: particulars
partition: partition,partitions
partly: partly
partridge: partridge,partridges
party: parties,party
pass: pass,passed,passes,passing
passable: passable
passably: passably
passage: passage,passages
passenger: passengers
passer: passers
passion: passion,passions
passive: passive
password: password
pastime: pastime
pastoral: pastoral
pasture: pasture,pastures,pasturing
patagonian: patagonian
patch: patch,patches
patent: patent,patented
path: path,paths
pathetically: pathetically
patience: patience
patriarch: patriarch
patrick: patrick
patriot: patriot,patriots
patriotic: patriotic
patriotism: patriotism
patroclus: patroclus
patron: patron,patrons
patterer: patterer
pattering: pattering
pattern: patterns
paunch: paunched,paunches
pauper: pauper
pause: pause,paused,pauses,pausing
pave: pave,paving
paved: paved
pavement: pavement
paver: paver
paw: paw,paws
pay: paid,pay,paying,pays
pea: peas
peace: peace
peaceable: peaceable
peaceably: peaceably
peaceful: peaceful
peak: peak,peaks
peaked: peaked
pear: pear
pearl: pearl,pearls
pearly: pearly
peasant: peasant
peat: peat
pebble: pebble
pebbly: pebbly
peck: peck,pecked
peculiar: peculiar
peculiarity: peculiarities,peculiarity
peculiarly: peculiarly
pecunia: pecunia
pecuniary: pecuniary
pedagogue: pedagogue
pedantic: pedantic
peddle: peddled,peddles
pedestal: pedestal
pedro: pedro
peel: peel,peeled,peeling
peep: peep,peeping
peeping: peeping
peer: peering
peetweet: peetweets
peg: peg
peleus: peleus
pellicle: pellicle
pellucid: pellucid
pelting: pelting
pen: pen
penalty: penalty
penance: penance
pencil: pencil
pendant: pendants
penetrate: penetrate,penetrated,penetrates
peninsular: peninsular
penitent: penitent
penknife: penknife
penny: penny
penobscot: penobscot
people: peopling
pepper: peppered
perceive: perceive,perceived
perceptible: perceptible
perceptibly: perceptibly
perception: perception
perch: perch,perching
perchance: perchance
perennial: perennial
perennially: perennially
perfect: perfect,perfected
perfection: perfection
perfectly: perfectly
perform: perform,performed
performance: performance,performances
perfumed: perfumed
peril: perils
period: period,periods
periodical: periodical
periplus: periplus
permanent: permanent
permanently: permanently
permission: permission
permit: permit,permits,permitted
perpendicular: perpendicular
perpetual: perpetual
perpetuate: perpetuate
perplex: perplexed
perplexity: perplexity
perseverance: perseverance
persevere: persevere
persian: persian
person: people,person,persons
personal: personal
perspiration: perspiration
persuade: persuade,persuaded
persuasion: persuasion
persuasiveness: persuasiveness
pertinacity: pertinacity
pertinent: pertinent
pertinently: pertinently
perturbation: perturbation
pervade: pervade,pervaded
pervert: perverted
pest: pest
petersburg: petersburg
petition: petition,petitioning
petty: petty
pewee: pewee
phaeton: phaeton
pharaohs: pharaohs
pheasant: pheasant
phenomena: phenomena
phenomenon: phenomena,phenomenon
phil: phil
philadelphia: philadelphia
philanthropic: philanthropic
philanthropist: philanthropist,philanthropists
philanthropy: philanthropies,philanthropy
philosopher: philosopher,philosophers
philosophical: philosophical
philosophy: philosophy
phrase: phrase
physical: physical
physically: physically
piazza: piazza
pick: pick,picked,picking,picks
pickerel: pickerel
picture: picture
picturesque: picturesque
piece: piece,pieces
piecemeal: piecemeal
pier: pier
pierce: pierce
piety: piety
pig: pig
pigeon: pigeons
pigweed: pigweed
pike: pike
pile: pile,piled,piles,piling
pilgrim: pilgrim,pilgrims
pilgrimage: pilgrimage
pill: pill
pillar: pillars
pillow: pillow
pilot: pilot,pilots
pilpay: pilpay
pin: pinned
pine: pine,pines
pinion: pinions
pink: pink
pinnate: pinnate
pint: pint
pinweed: pinweeds
piny: piny
pious: pious
pipe: pipe
piper: piper
pipewort: pipewort
pirouetting: pirouetting
piscine: piscine
pistol: pistol
pit: pit,pitted
pitch: pitch
pitiful: pitiful
pity: pitied,pity
pius: pius
placid: placid
plain: plain,plains
plainly: plainly
plan: plan,planning
plane: plane,planed
planet: planet
planetary: planetary
plank: plank,planks
plant: plant,planted,planting,plants
plantation: plantation
planting: planting
plaster: plaster,plastered,plastering
plasterer: plasterer
plastering: plastering
plastic: plastic
plate: plate,plates
plateau: plateau
platform: platform
plato: plato
play: play,played,playing,plays
plead: plead
pleading: pleadings
pleasant: pleasant,pleasantest
pleasanter: pleasanter
pleasantly: pleasantly
pleased: pleased
pleasing: pleasing
pleasure: pleasure,pleasures
plectrum: plectrum
pledge: pledged
pleiades: pleiades
plenty: plenty
plod: plodding
plot: plots
plough: plough,ploughing,ploughs
ploughing: ploughing
ploughmen: ploughmen
ploughshare: ploughshare
plow: plow,plowed
pluck: plucked,plucks
plug: plug
plum: plum
plumage: plumage
plume: plumes
plump: plump,plumper
plunge: plunge,plunges
plutus: plutus
plymouth: plymouth
pocket: pocket,pockets
pod: pods
poem: poem
poesy: poesy
poet: poet,poets
poetic: poetic
poetry: poetry
poison: poison
poisonous: poisonous
poke: poked
polar: polar
pole: pole,poles
polestar: polestar
policy: policy
polish: polish,polished
polite: polite
politeness: politeness
political: political
politician: politicians
politics: politics
polk: polk
poll: poll
pollen: pollen
pomp: pomp
pond: pond,ponds
ponds: ponds
pontificate: pontificate
pool: pool,pools
poor: poor,poorer,poorest
pop: pop
pope: pope
popgun: popguns
poplar: poplar
population: population
populous: populous
porch: porch
pore: pore,pores
pork: pork
porridge: porridge
port: port,ports
portentous: portentous
portico: porticoes
portion: portion,portions
portionless: portionless
portugal: portugal
portulaca: portulaca
position: position
positive: positive
posse: posse
possess: possess,possessed
possession: possession
possessor: possessor
possibility: possibility
post: post,posts
postage: postage
posterity: posterity
postpone: postpone
posture: posture
pot: pot,pots
potash: potash
potato: potato,potatoes
potatoes: potatoes
potter: potter
pottery: pottery
poultry: poultry
pound: pound,pounds
pour: poured
pout: pout,pouts
poverty: poverty
pow: pow
powder: powder
powdery: powdery
power: power,powers
powerful: powerful
powerless: powerless
practical: practical
practically: practically
practice: practice,practiced
practise: practise,practised,practising
prairie: prairie,prairies
praise: praise,praised,praises
prank: pranks
pray: pray,prayed
prayer: prayer,prayers
preach: preach,preaching
preacher: preacher
precede: precede,preceded,precedes,preceding
precedent: precedents
precept: precept,precepts
precious: precious
precise: precise
precisely: precisely
precision: precision
precocious: precocious
precursor: precursors
predecessor: predecessors
predicament: predicament
predict: predict
preface: preface
prefer: prefer,preferred,preferring
pregnant: pregnant
prejudice: prejudice,prejudices
premise: premises
premium: premium
prepare: prepare,prepared,prepares,preparing
preparedly: preparedly
prescribe: prescribe,prescribed
presence: presence
presentable: presentable
presently: presently
preservation: preservation
preserve: preserve,preserved,preserves,preserving
preside: presided
presidency: presidency
president: president
press: press,pressed,pressing
pressure: pressure
presume: presume,presuming
presumption: presumption
pretend: pretend,pretending,pretends
pretensions: pretensions
pretext: pretext
pretty: pretty
prevail: prevail,prevailed,prevailing,prevails
prevalence: prevalence
prevalent: prevalent
prevent: prevent,prevented,prevents
previous: previous
prey: prey,preying
price: price,prices
priceless: priceless
pride: pride
priest: priest,priests
prime: prime
primer: primers
primeval: primeval
primitive: primitive
prince: prince,princes
princess: princess
principal: principal
principle: principle,principles
print: print,printed,prints
printing: printing
prison: prison,prisons
prisoner: prisoner,prisoners
privacy: privacy
private: private,privates
privilege: privilege,privileges
privileged: privileged
prize: prize,prized
probability: probability
probable: probable
probe: probe
proceed: proceed,proceeded,proceeding,proceeds
proceeds: proceeds
process: process
procession: procession
proclaim: proclaim,proclaimed
procure: procure,procured,procuring
produce: produce,produced,produces,producing
producing: producing
product: product,products
production: production,productions
productive: productive
profane: profaned
profanity: profanity
profess: profess,professed,professing
profession: profession,professions
professor: professor,professors
profile: profiles
profit: profit,profited,profits
profitably: profitably
profound: profound
progenitor: progenitors
progress: progress,progressing
project: project,projecting
prolific: prolific
prolong: prolonged
prominent: prominent
promise: promise,promised,promises,promising
promising: promising
promontory: promontories,promontory
prompt: prompt,prompting
pronoun: pronoun
pronounce: pronounce,pronounced
pronunciation: pronunciation
proof: proof
prop: prop,propped
proper: proper
properly: properly
propertied: propertied
property: property
prophesy: prophesied
prophet: prophets
propitious: propitious
proportion: proportion,proportions
proportionally: proportionally
proportionate: proportionate
propose: propose,proposed,proposes
proprietor: proprietor,proprietors
propriety: propriety
prospect: prospect
prospecting: prospecting
prospects: prospects
prosperity: prosperity
prostrate: prostrate
protect: protect,protected
protection: protection
prototype: prototype
protract: protracted
prove: prove,proved,proves,proving
provender: provender
proverb: proverb
provide: provide,providing
providence: providence
province: province,provinces
provincial: provincial
provision: provisions
provocation: provocations
provoke: provoke,provoked
prowl: prowling
prowling: prowling
prudence: prudence
prudent: prudent
pry: pried
psalm: psalm
public: public
publican: publicans
publish: publish,published
pudding: pudding,puddings
puddle: puddle,puddles
puff: puff
puffball: puffball
pull: pull,pulled,pulling,pulls
pulley: pulley
pulp: pulp
pulpy: pulpy
pulse: pulse
pulsing: pulsing
pump: pump,pumped
pumpkin: pumpkin,pumpkins
punctuality: punctuality
punish: punish,punished
punishment: punishment,punishments
puny: puny
pup: pups
pupil: pupil
purana: purana
purchase: purchase
purchaser: purchaser
pure: pure,purer,purest
purely: purely
purgative: purgative
puri: puri
purification: purification
purify: purified,purifies,purify,purifying
puritan: puritan
purity: purity
purlin: purlins
purple: purple
purpose: purpose,purposes
purposely: purposely
purse: purse
purslane: purslane
pursue: pursue,pursued,pursuing
pursuer: pursuers
pursuit: pursuit,pursuits
push: pushed,pushes,pushing
putrid: putrid
putty: putty
puzzle: puzzle,puzzled
pygmy: pygmies,pygmy
pyramid: pyramids
pyramids: pyramids
pyrrha: pyrrha
pythagorean: pythagorean
quack: quack,quacks
quadruped: quadrupeds
quaff: quaffs
quaking: quaking
qualified: qualified
quality: qualities,quality
quantity: quantities,quantity
quarrel: quarrel
quart: quarts
quarter: quarter,quarters
quartz: quartz
queen: queen,queens
queer: queer
queerest: queerest
quench: quenched
question: question,questioned,questions
questionable: questionable
quick: quick
quicksand: quicksands
quicksilver: quicksilver
quiet: quiet,quieted
quietly: quietly
quirk: quirks
quiver: quivering
quota: quota
quote: quote,quoted
rabbit: rabbit,rabbits
raccoon: raccoon
race: race,races
rack: racked
radiate: radiated
radical: radicals
radicle: radicle
radii: radii
raft: raft
rafter: rafters
rag: rags
rage: rage,raging
ragged: ragged
raggedly: raggedly
rail: rail,rails
railroad: railroad,railroads
rain: rain,rained,rains
rainbow: rainbow
rainy: rainiest,rainy
raise: raise,raised,raises,raising
raiser: raisers
raisin: raisins
raising: raising
rake: rake,raked,rakes
ram: rams
ramble: ramble,rambled,rambles
rambler: rambler
rambling: rambling
rampart: ramparts
range: range,ranged,ranges,ranging
rank: rank,ranks
rapid: rapid
rapidly: rapidly
rapt: rapt
rare: rare,rarer,rarest
rarefy: rarefies
rarely: rarely
rash: rash
raspberry: raspberries
rat: rat,rats
rate: rate,rated,rates
ration: rations
rattle: rattle,rattled,rattles
rattling: rattling
ravage: ravaged
ravine: ravines
raw: raw
rawness: rawness
ray: ray,rays
reach: reach,reached,reaches,reaching
react: react,reacted
read: read,reading,reads
reader: reader,readers
reading: reading
ready: ready
real: real
reality: realities,reality
realization: realization
realize: realize,realized
realm: realm
reap: reaped
reaper: reapers
reappear: reappearing
rear: rear
rearmost: rearmost
reason: reason,reasons
reasonable: reasonable
reawaken: reawaken
rebel: rebel,rebels
recall: recall
recede: receded,receding
receive: receive,received,receiving
recess: recess,recesses
recipe: recipe
reckless: reckless
reckon: reckon,reckoned
reckoning: reckoning
reclaim: reclaimed
recognition: recognition
recognize: recognize,recognized,recognizing
recollect: recollect
recollection: recollection
recommend: recommend,recommended,recommending,recommends
reconcile: reconciled
reconnoitre: reconnoitre
record: record,recorded
records: records
recover: recover,recovered,recovering,recovers
recovery: recovery
recreate: recreate
recreation: recreation
recruit: recruit
rectitude: rectitude
recur: recurred
red: red
reddening: reddening
redding: redding
reddish: reddish
redeem: redeem
redeemer: redeemers
redolent: redolent
redress: redressing
reduce: reduce,reduced,reduces
reed: reed
reef: reefs
reel: reel,reels
refer: refer,referred,refers
refine: refine,refined
refined: refined
refinement: refinement
refit: refit
reflect: reflect,reflected,reflecting,reflects
reflection: reflection,reflections
reform: reform,reformed,reforming,reforms
reformer: reformer,reformers
refresh: refreshed
refreshing: refreshing
refuge: refuge
refusal: refusal
refuse: refuse,refused,refuses
regal: regal
regard: regard,regarded
region: region,regions
regna: regna
regret: regret,regrets,regretted,regretting
regular: regular
regularity: regularity
regularly: regularly
regulate: regulate,regulated,regulates,regulating
rei: rei
reign: reign,reigns
rein: reins
reinvigorate: reinvigorated
reject: rejected,rejecting
rejoice: rejoice
relate: relates
relation: relation,relations
relative: relative
release: release,released
reliance: reliance
relic: relic,relics
relief: relief
relieve: relieve,relieved
relieved: relieved
relievo: relievo
religion: religion
religious: religious
religiously: religiously
relinquish: relinquish,relinquished,relinquishing
relish: relish
rely: rely
remain: remain,remained,remaining,remains
remainder: remainder
remark: remark,remarked
remarkable: remarkable
remarkably: remarkably
remedy: remedy,remedying
remember: remember,remembered,remembering,remembers
remembrance: remembrance
remind: remind,reminded,reminding,reminds
reminiscence: reminiscence,reminiscences
remissness: remissness
remnant: remnant,remnants
remote: remote
remoteness: remoteness
removal: removal
remove: remove,removed,removing
remunerate: remunerate
rend: rending
render: render,rendered,renders
renew: renew
rent: rent,rents
repair: repair,repairs
repairer: repairer
repast: repast
repeat: repeat,repeated,repeating,repeats
repeatedly: repeatedly
repent: repent
repeople: repeopled
repetition: repetition
reply: replied,reply
report: report,reported,reports
reporter: reporter
repose: repose,reposes
represent: represent,represented,represents
representative: representative
reprint: reprints
reproach: reproach
reproof: reproof,reproofs
reprove: reprove
reptile: reptile
republican: republicans
repudiation: repudiation
repugnance: repugnance
reputation: reputation
request: request,requested
requiem: requiem
require: require,required,requires
requisition: requisitions
rescue: rescue
resemble: resemble,resembled,resembling
reservedly: reservedly
reside: reside
residence: residence
residual: residual
resign: resign,resigned
resignation: resignation
resist: resist,resisted,resisting
resistance: resistance
resistless: resistless
resolute: resolute
resolutely: resolutely
resolution: resolution
resolve: resolve,resolved,resolves
resonance: resonance
resort: resort,resorted
resound: resound,resounded,resounds
resounding: resounding
resource: resources
respect: respect,respected,respecting
respectable: respectable
respected: respected
respective: respective
respects: respects
respite: respite
resplendent: resplendent
respond: responded
response: responses
responsibility: responsibility
responsible: responsible
rest: rest,rested,resting
resting: resting
restless: restless
restlessness: restlessness
restore: restore,restored,restoring
restrain: restrain,restrained
restrict: restricted
result: result
resume: resume,resumed
resurrection: resurrection
retain: retain,retained,retains
retainer: retainer
retard: retard,retarded
retinue: retinue
retire: retired,retires
retirement: retirement
retract: retracting
retreat: retreat,retreated
return: return,returned,returning,returns
reveal: reveal,revealed,reveals
revel: revel
revelation: revelation,revelations
revenge: revenge
reverence: reverence,reverenced,reverencing
reverend: reverend
reverently: reverently
reverse: reversed
revery: revery
review: review,reviews
revise: revising
revisit: revisit
revive: revive,revived,revives,reviving
revolution: revolution,revolutions
revolutionary: revolutionary
revolutionize: revolutionize
revolve: revolve
reward: reward
reynard: reynard
rhetoric: rhetoric
rhine: rhine
rhus: rhus
rhyme: rhyme,rhymes
rib: ribbed,ribs
ribbed: ribbed
ribbon: ribbon
ricardo: ricardo
rice: rice
rich: rich,richer,richest
riches: riches
ricochet: ricochet
rid: rid
ride: ridden,ride,rides,riding
rider: rider
ridge: ridge,ridges
ridiculous: ridiculous
rife: rife
rifle: rifles
rift: rifts
rig: rigged
rightfully: rightfully
rightly: rightly
rigid: rigid
rigmarole: rigmarole
rill: rill,rills
rime: rime
rind: rind
riot: riot
rip: ripped
ripe: ripe
ripen: ripened,ripens
ripeness: ripeness
ripple: ripple,rippled,ripples,rippling
rippled: rippled
rise: rise,risen,rises,rising,rose
risk: risks
rite: rites
river: river,rivers
rivet: rivet
rivulet: rivulets
roach: roach
road: road
roam: roam
roar: roar,roars
roast: roast,roasting
roasted: roasted
rob: robbed,robbing,robs
robber: robber
robbery: robbery
robe: robe
robed: robed
robin: robin
robinson: robinson
robust: robust
rock: rock,rocks
rod: rod,rods
roil: roiling
roll: roll,rolled,rolling,rolls
roman: roman,romans
romance: romance
rome: rome
roof: roof,roofed,roofs
roost: roost,roosts
root: root,rooted,roots
rope: rope
rose: rose
rosette: rosettes
rot: rot,rotted
rotten: rotten
rough: rough
roughly: roughly
roundabout: roundabout
rounded: rounded
rouse: roused
rout: rout
route: route,routes
routine: routine
roving: roving
row: row,rows
rub: rub,rubbed,rubbing
rubber: rubber
ruddy: ruddy
rude: rude,rudest
rudely: rudely
ruder: ruder
rudiment: rudiment
rudimental: rudimental
ruffle: ruffled
rug: rug
ruin: ruin,ruined,ruins
ruinous: ruinous
rule: rule,rules
ruler: ruler,rulers
rum: rum
rumble: rumble,rumbling
rumor: rumor
runaway: runaway
running: running
rupture: rupture
rush: rush,rushes
russet: russet
russia: russia
rust: rust
rustic: rustic
rustle: rustle
rustling: rustling
rusty: rusty
rut: ruts
ruthlessly: ruthlessly
rye: rye
sabbath: sabbath
saccharine: saccharine
sacrament: sacrament
sacred: sacred
sacredness: sacredness
sacrifice: sacrifice,sacrificed,sacrifices,sacrificing
sad: sad
sadden: saddens
saddle: saddle
sadi: sadi
sadly: sadly
sadness: sadness
safe: safe,safest
safely: safely
safety: safety
saffron: saffron
sagacity: sagacity
sage: sage,sages
sahara: sahara
sail: sail,sailed,sailing,sails
sailing: sailing
sailor: sailor,sailors
saint: saint,saints
saith: saith
sake: sake
sal: sal
salable: salable
salamander: salamander
salem: salem
saloon: saloons
salt: salt,salted
salutary: salutary
salutation: salutation
salute: salute,saluted,salutes
sam: sam
samuel: samuel
sanctify: sanctify
sanction: sanction
sand: sand,sanded,sands
sandwich: sandwich
sandy: sandy
sane: sane,saner,sanest
sap: sap
sapling: sapling
sappy: sappy
sapwood: sapwood
sardanapalus: sardanapalus
sardine: sardines
satellite: satellite,satellites
satin: satin
satire: satire
satirical: satirical
satisfaction: satisfaction,satisfactions
satisfactory: satisfactory
satisfied: satisfied
satisfy: satisfy
saturate: saturated
saturation: saturation
saturday: saturday
saturn: saturn
satyr: satyrs
saucer: saucer
saunter: sauntered,sauntering
savage: savage,savages
savageness: savageness
save: save,saves,saving
savor: savor,savors
savoriness: savoriness
sawdust: sawdust
saxon: saxon
scald: scalded
scale: scale,scales
scallop: scalloped
scant: scant
scanty: scanty
scarce: scarce
scarcely: scarcely
scarcity: scarcity
scare: scared,scares,scaring
scarecrow: scarecrow
scarlatina: scarlatina
scarlet: scarlet
scatter: scattered,scattering
scene: scene,scenes
scenery: scenery
scent: scent,scented
scented: scented
scheme: schemes
scholar: scholar,scholars
school: school,schools
schoolmaster: schoolmaster
schooner: schooner
science: science,sciences
scientific: scientific
scintillation: scintillation
sciurus: sciurus
scorch: scorched
score: score,scores
scorn: scorned
scornful: scornful
scotland: scotland
scour: scour
scourge: scourge
scrap: scrap,scraps
scrape: scrape
scratch: scratching
scream: scream,screaming,screams
screech: screech
screw: screws
scripture: scripture,scriptures
scrub: scrubbed
scrutinize: scrutinize
scrutiny: scrutiny
scud: scud
scullion: scullion
sculptor: sculptors
scurf: scurf
scurvy: scurvy
scuttle: scuttle
scyphus: scyphus
sea: sea,seas
seaboard: seaboard
sealer: sealers
seam: seam,seams
seamless: seamless
sear: seared
search: search,searched
seashore: seashore
season: season,seasoned,seasons
seasonable: seasonable
seasoning: seasoning
seat: seat,seated,seats
secluded: secluded
secondary: secondary
secrecy: secrecy
secret: secret,secrets
secretary: secretary
secrete: secreted
sect: sect
secure: secure,secured,secures
securely: securely
sedge: sedge,sedges
sedgy: sedgy
sediment: sediment
sedulously: sedulously
seed: seed,seeds
seek: seek,seeking,seeks,sought
seemingly: seemingly
seer: seer
seething: seething
segment: segment
seize: seize,seized,seizes,seizing
seizure: seizure
seldom: seldom
select: select,selected,selecting
selection: selection
selectman: selectmen
selectmen: selectmen
selfish: selfish
selfishness: selfishness
sell: sell,selling,sells,sold
selvage: selvage
semblance: semblance
senate: senate
send: send,sending,sends
senior: seniors
seniority: seniority
sense: sense
sensibly: sensibly
sensitive: sensitive
sensual: sensual
sensualist: sensualist
sensuality: sensuality
sensually: sensually
sensuous: sensuous
sentence: sentence,sentences
sentiment: sentiments
sentimental: sentimental
sentinel: sentinels
separate: separate,separated,separates,separating
separately: separately
september: september
serenade: serenade,serenaded
serene: serene
serenely: serenely
serenity: serenity
serf: serfs
sergeant: sergeant
seriousness: seriousness
sermon: sermon,sermons
serpent: serpent
servant: servant,servants
serve: serve,served,serves,serving
service: service,services
servile: servile
serving: serving
servitor: servitor
servitude: servitude
set: set,sets,setting
setting: setting
settle: settle,settled,settles,settling
settlement: settlement
settler: settler,settlers
settling: settling
seventeen: seventeen
seventieth: seventieth
sever: severed
severe: severe
severely: severely
seville: seville
sewing: sewing
sex: sex
sexton: sexton
shade: shade,shaded
shades: shades
shadow: shadow,shadows
shadowy: shadowy
shady: shadiest,shady
shaft: shafts
shake: shake,shaking,shook
shakespeare: shakespeare
shallow: shallow,shallower,shallowest
shallows: shallows
sham: shams
shame: shame
shams: shams
shanty: shanties,shanty
shape: shape,shaped
share: share,shared,sharing
sharp: sharp,sharper
sharpen: sharpening
sharply: sharply
shave: shave
shaving: shaving,shavings
sheaf: sheaf
shear: shear,shorn
sheen: sheen
sheep: sheep
sheer: sheer
sheet: sheet,sheets
sheik: sheik
shelf: shelf,shelves
shellfish: shellfish
shelter: shelter,sheltered
sheltered: sheltered
shelve: shelving
shelving: shelving
shepherd: shepherd
sheriff: sheriff
shield: shield
shift: shift
shiftless: shiftless
shiftlessness: shiftlessness
shilling: shillings
shine: shine,shines,shining,shone
shiner: shiner,shiners
shingle: shingle,shingled,shingles
ship: ship
shipload: shiploads
shipping: shipping
shipwreck: shipwrecked
shipwrecked: shipwrecked
shiraz: shiraz
shire: shire
shirk: shirking
shirt: shirt,shirts
shiver: shivered,shivers
shoal: shoal
shoe: shoe,shoes
shoemaker: shoemaker
shoestring: shoestrings
shoot: shoot,shoots,shot
shop: shop,shops
shore: shore,shores
short: short,shorter,shortest
shortcoming: shortcomings
shortly: shortly
shoulder: shoulder,shouldered,shoulders
shout: shout,shouted,shouts
shove: shoved
shovel: shovel
shower: shower,showered,showers
shrewdness: shrewdness
shriek: shriek
shrill: shrill
shrine: shrines
shrink: shrinking
shrub: shrub,shrubs
shuffle: shuffled
shun: shun
shut: shut,shuts,shutting
shutter: shutter
shy: shy
siberia: siberia
sibyl: sibyl
sic: sic
sick: sick
sickness: sickness
sidewalk: sidewalk
sierra: sierra
siesta: siesta
sieve: sieve
sift: sifting
sigh: sigh,sighed,sighs
sight: sight,sights
sign: sign,signed,signs
signal: signal
signify: signified,signify
silence: silence,silences
silent: silent
silently: silently
silicate: silicates
silicious: silicious
silk: silk,silks
sill: sill
sills: sills
silly: silly
silver: silver
silvery: silvery
simmer: simmer
simoom: simoom
simple: simple,simpler,simples,simplest
simplicity: simplicity
simplify: simplifies,simplify
simply: simply
sin: sin,sinned,sinning,sins
sincerely: sincerely
sincerity: sincerity
sinecure: sinecure
sinew: sinews
sing: sang,sing,singing,sings,sung
singing: singing
single: single
singleness: singleness
singular: singular
singularly: singularly
sink: sank,sink,sinking,sinks,sunk
sinner: sinner
sippio: sippio
sir: sir
sirens: sirens
sister: sister
sit: sat,sit,sits,sitting
situate: situated
situation: situation
sixteen: sixteen
sixth: sixth
sizable: sizable
size: size
sized: sized
skate: skated,skating
skater: skater,skaters
skeleton: skeletons
skewer: skewer
skilful: skilful
skilfully: skilfully
skill: skill
skilled: skilled
skillet: skillet
skim: skim,skimmed,skims
skin: skin,skinned,skins
skip: skip,skipping
skirt: skirts
skulk: skulk
skunk: skunk
sky: skies,sky
skylight: skylight
skyrocket: skyrockets
slack: slack,slacked
slag: slag
slant: slanted,slanting
slate: slate
slaughter: slaughter,slaughtering
slave: slave,slaves
slavery: slavery
sled: sled,sledded,sleds
sledge: sledge
sleep: sleep,sleeps,slept
sleeper: sleeper,sleepers
sleepy: sleepy
sleety: sleety
sleeve: sleeve,sleeves
sleigh: sleigh,sleighs
slender: slender
slenderness: slenderness
slew: slew
slice: slice
slide: slid,slide,slides,sliding
slight: slight,slightest
slimy: slimy
slink: slink,slinks
slip: slip,slipped,slips
slit: slit
slop: slop
slope: slope,slopes,sloping
sloth: sloth
slothful: slothful
slough: slough,sloughing,sloughs
slow: slow,slower
slowly: slowly
sluggish: sluggish
sluggishly: sluggishly
slumber: slumber,slumbered,slumbering,slumbers
slumbering: slumbering
slumberous: slumberous
slush: slush
slut: slut
sly: sly
smear: smeared
smell: smell,smelled,smelling,smells
smelt: smelted
smile: smile,smiled,smiles,smiling
smite: smitten
smith: smith
smoke: smoke,smoked
smoking: smoking
smoky: smoky
smooth: smooth,smoothed,smoother
smoothly: smoothly
smoothness: smoothness
smother: smothered
smoulder: smouldering
snake: snake,snakes
snap: snapped,snapping
snare: snares,snaring
snarl: snarl
sneak: sneaking,sneaks
snipe: snipe
snipes: snipes
snivel: snivel
snore: snoring
snort: snort
snout: snout
snow: snow,snows
snowflake: snowflake
snows: snows
snowy: snowy
snug: snug
soak: soak,soaked,soaking
soaking: soaking
soar: soar,soaring,soars
sob: sobs
sober: sober,sobered
sociable: sociable
social: social
societies: societies
society: societies,society
sod: sod,sods
soda: soda
soft: soft
soften: softened
softened: softened
soil: soil,soiled
sojourner: sojourner
soldering: soldering
soldier: soldier,soldiers
sole: sole
solely: solely
solemn: solemn
solemnity: solemnity
solemnly: solemnly
solid: solid
solidago: solidago
solidify: solidified
solidly: solidly
soliloquize: soliloquizing
solitary: solitary
solitude: solitude
solomon: solomon
solve: solve,solved
sombre: sombre
somerset: somerset,somersets
somnolence: somnolence
son: son,sons
song: song,songs
songster: songsters
sonorous: sonorous
sonorously: sonorously
sons: sons
soot: soot
soothe: soothed
soothing: soothing
sordid: sordid
sorrel: sorrel
sorrow: sorrow
sorrowful: sorrowful
sort: sort,sorts
soul: soul,souls
sound: sound,sounded,soundest,sounding,sounds
sounding: soundings
sour: sour
source: source,sources
souring: souring
south: south
southerly: southerly
southern: southern
southward: southward
sovereign: sovereign
sow: sow,sown
sower: sower
space: space,spaces
spacious: spacious
spade: spade,spaded,spades
spain: spain
spanish: spanish
spar: spars
spare: spare,spared
spark: spark,sparks
sparkle: sparkle,sparkles,sparkling
sparrow: sparrow
spartan: spartan
speak: spake,speak,speaking,speaks,spoke,spoken
speaker: speaker
spear: spear
special: special
species: species
specific: specific
specimen: specimens
spectacle: spectacle
spectator: spectator,spectators
spectatordom: spectatordom
speculate: speculate,speculates
speculation: speculation,speculations
speculator: speculator
speech: speech
speed: speed,speeding
speedy: speedy
spell: spell,spells,spelt
spelling: spelling
spence: spence
spend: spend,spending,spent
spending: spending
sphere: sphere,spheres
spherical: spherical
sphinx: sphinx
spica: spica
spider: spider,spiders
spike: spikes
spin: spin,spins,spun
spinning: spinning
spiral: spiral
spire: spiring
spirit: spirit,spirited,spirits
spiritual: spiritual
spiritus: spiritus
spit: spit,spitting
spite: spite
splash: splash
splendid: splendid
splendor: splendor
splinter: splinter
split: split,splits,splitting
splitting: splitting
spoil: spoil,spoiled,spoils
spoken: spoken
spontaneously: spontaneously
spoon: spoon,spoons
sport: sport,sported,sporting,sports
sportsman: sportsman,sportsmen
spot: spot,spots
spotted: spotted
spray: spray,sprays
spread: spread,spreading,spreads
sprightly: sprightly
spring: sprang,spring,springing,springs,sprung
springboard: springboards
springing: springing
springly: springly
springy: springy
sprinkle: sprinkle,sprinkled
sprout: sprout,sprouts
spruce: spruce
spy: spied,spy,spying
squalidness: squalidness
square: square,squares
squashed: squashed
squat: squat,squatted,squatting
squatter: squatter
squaw: squaw
squeak: squeak,squeaking
squeamish: squeamish
squeeze: squeeze
squint: squinting
squire: squire
squirm: squirming
squirrel: squirrel,squirrels
squirrels: squirrels
stable: stable,stables
stabler: stabler
stack: stack,stacked,stacking
staff: staff
stage: stage
stagnant: stagnant
stagnate: stagnate
stagnation: stagnation
stain: stain,stained
stake: stake,staked,stakes
stalactite: stalactite,stalactites
stalk: stalked,stalks
stall: stall
stamp: stamp,stamped,stamping
stampede: stampede
stand: stand,standing,stands,stood
standard: standard
standing: standing
staple: staple,staples
star: star,stars
starch: starch
stare: stared,staring
stark: stark
starry: starry
start: start,started,starting,starts
startle: startled
startling: startling
startlingly: startlingly
starve: starve,starved,starving
starveling: starveling
stately: stately
statement: statement
statesman: statesmen
station: station,stationed
stationery: stationery
statistics: statistics
statuary: statuary
statue: statue
stay: stay,stayed,staying
stead: stead
steadfastness: steadfastness
steadily: steadily
steady: steadier,steady
steal: steal,stealing,steals,stole,stolen
stealthily: stealthily
stealthy: stealthy
steam: steam
steamboat: steamboat
steed: steed
steel: steel
steep: steep
steeple: steeple
steer: steer,steered,steers
steering: steering
stem: stem,stemmed,stems
step: step,stepped,stepping,steps
steppe: steppes
stereotype: stereotype,stereotyped
stereotyped: stereotyped
sterile: sterile
stern: stern
stick: stick,sticks,stuck
stiff: stiff
stiffness: stiffness
stillness: stillness
sting: sting
stint: stint
stir: stir,stirring
stirp: stirp
stirring: stirring
stitch: stitch,stitches
stock: stock,stocked,stocking,stocks
stocking: stockings
stomach: stomach
stone: stone,stoned,stones
stony: stony
stool: stools
stopple: stopples
storage: storage
store: store,stored,stores
storm: storm,stormed,storms
stormy: stormy
story: stories,story
stout: stout
stove: stove,stoves
straggle: straggling
straight: straight
straighten: straighten,straightening
straightway: straightway
strain: strain,strained,straining,strains
strainer: strainer
strait: strait
strand: stranded,strands
strange: strange
strangeness: strangeness
stranger: stranger,strangers
strap: strap
stratum: stratum
straw: straw
strawberry: strawberries,strawberry
stray: stray,straying
streak: streaks
stream: stream,streaming,streams
streamer: streamer
streaming: streaming
street: street,streets
strength: strength
strengthen: strengthened
stress: stress
stretch: stretch,stretched,stretches,stretching
strew: strewed,strewing,strewn
stricken: stricken
strict: strict
strictly: strictly
stride: strides
strike: strike,strikes,striking,struck
string: string,strings,strung
strip: strip,stripped,strips
stripe: stripes
striped: striped
strive: strive,strives
strix: strix
stroke: stroke
stroll: stroll,strolled,strolling
strong: strong,stronger,strongest
structure: structure,structures
struggle: struggle,struggled,struggles,struggling
stubborn: stubborn
stud: studs
student: student,students
studious: studious
study: studied,studies,study,studying
stuff: stuff
stumble: stumble
stump: stump,stumps
stumps: stumps
stun: stunned
stupendous: stupendous
stupid: stupid
stupidity: stupidity
sturdily: sturdily
sturdy: sturdiest,sturdy
sty: sties
stygian: stygian
style: style,styled
styx: styx
subdue: subdue
subject: subject,subjected,subjects
sublime: sublime
sublimity: sublimity
submission: submission
submit: submit
subscribe: subscribed
subscription: subscription
subsequent: subsequent
subside: subsided
subsidence: subsidence
subsistence: subsistence
substance: substance
substantial: substantial
substitute: substitute,substituted,substitutes
subtile: subtile
subtle: subtle
subtler: subtler
subtract: subtract,subtracted
suburban: suburban
succedaneous: succedaneous
succeed: succeed,succeeded,succeeding,succeeds
success: success
successful: successful
succession: succession
successive: successive
successively: successively
successor: successors
succinct: succinct
suck: suck,sucking
sucker: suckers
suckle: suckled
sudden: sudden
suddenly: suddenly
suent: suent
suffer: suffer,suffered,suffering,suffers
sufferance: sufferance
sufferer: sufferer
suffering: suffering
suffice: suffice,sufficed
sufficient: sufficient
suffocate: suffocated
sugar: sugar
suggestion: suggestions
suggestive: suggestive
suicide: suicide
suit: suit,suited
suitable: suitable
sullen: sullen
sulphur: sulphur
sultry: sultry
sum: sum
sumach: sumach,sumachs
summer: summer,summers
summery: summery
summons: summons
sun: sun,sunning,suns
sunburnt: sunburnt
sunday: sunday
sundays: sundays
sunder: sundered
sundown: sundown
sunny: sunny
sunrise: sunrise
sunset: sunset
sunshine: sunshine
superficial: superficial
superfluity: superfluities,superfluity
superfluous: superfluous
superfluously: superfluously
superintend: superintend
superintendent: superintendent
superior: superior,superiors
supernal: supernal
supernumerary: supernumerary
supersede: supersede
superstition: superstition,superstitions
superstructure: superstructure
supper: supper
supple: supple
suppliant: suppliant
supply: supplied,supply,supplying
support: support,supported,supporting,supports
supporter: supporters
suppose: suppose,supposed,supposing
suppress: suppressed
supreme: supreme
surely: surely
surety: surety
surface: surface,surfaces
surfeit: surfeit
surpass: surpass,surpassed,surpassing
surprise: surprise,surprised
surprised: surprised
surprising: surprising
surround: surround,surrounded,surrounding,surrounds
survey: survey,surveyed,surveying,surveys
surveyor: surveyor
survive: survive,survived
survivor: survivor
suspect: suspect,suspected,suspecting
suspend: suspend,suspended
sustain: sustain,sustained,sustaining,sustains
swaddle: swaddling
swallow: swallow,swallowed,swallows
swamp: swamp,swamps
sward: sward
swarm: swarm,swarmed
swath: swath
sway: swaying
swear: swear
sweat: sweat,sweats
sweden: sweden
sweep: sweep,sweeping,sweeps,swept
sweeping: sweeping
sweet: sweet,sweeter,sweetest
sweeten: sweeten
sweetish: sweetish
sweetness: sweetness
swell: swell,swelled,swelling
swelter: sweltering
swift: swift,swiftest
swim: swam,swim,swimming,swims,swum
swimming: swimming
swine: swine
swing: swing
swoop: swoop
sword: sword
syllable: syllable,syllables
sylvan: sylvan
sylvius: sylvius
symbol: symbol,symbols
sympathetic: sympathetic
sympathize: sympathize,sympathized
sympathy: sympathies,sympathy
synonymous: synonymous
synthetic: synthetic
systematically: systematically
table: table,tables
tablecloth: tablecloth
tack: tack
tackle: tackle,tackled
tadpole: tadpoles
tafferel: tafferel
tail: tail,tails
tailor: tailor,tailors
tailoress: tailoress
taint: taint,tainted,tainting
talaria: talaria
tale: tale,tales
talent: talent
talk: talk,talked,talking,talks
talker: talkers
tall: tall,taller
tallow: tallow
talon: talons
tame: tame
tamely: tamely
tan: tan
tanager: tanager
tangent: tangent
tantivy: tantivy
tap: tapping
tapeworm: tapeworm
tare: tare
target: target
tarn: tarn
tartar: tartar
tartarus: tartarus
tartary: tartary
task: task,tasked
taste: taste,tasted,tastes,tasting
tatters: tatters
tattooing: tattooing
tavern: tavern
tax: tax,taxed,taxes
taxation: taxation
tea: tea
teach: taught,teach,teaches
teacher: teacher
team: team,teams
teamster: teamster
tear: tearing,tears,torn
tearful: tearful
tearless: tearless
tedium: tedium
teem: teem
telegraph: telegraph
telescope: telescope
temper: tempered
temperament: temperament
temperance: temperance
temperate: temperate
temperately: temperately
temperature: temperature
tempest: tempest,tempests
tempestuous: tempestuous
temple: temple,temples
temporal: temporal
temporary: temporary
tempt: tempt,tempted,tempts
tenant: tenant
tend: tended,tending
tendency: tendencies
tender: tender
tenderly: tenderly
tenderness: tenderness
tendril: tendrils
tenement: tenement
tenon: tenoned
tent: tent,tents
tenth: tenth,tenths
tenure: tenure
term: term,terms
terminate: terminated,terminating
terminus: terminus
ternate: ternate
terra: terra
terrestrial: terrestrial
terrible: terrible
terribly: terribly
terrific: terrific
terrify: terrified
territory: territory
terror: terror
testament: testament
testify: testified
tether: tethered
tetrao: tetrao
texas: texas
texture: texture
thallus: thalluses
thankful: thankful
thanksgivings: thanksgivings
thaw: thaw,thawing
thawing: thawing
theatre: theatre
theatrical: theatrical
thee: thee
theme: theme,themes
theoretically: theoretically
theory: theory
therefor: therefor
thermometer: thermometer
theseus: theseus
thief: thief,thieves
thieving: thieving
thimble: thimble
thinker: thinkers
thinking: thinking
thinly: thinly
thirst: thirst
thirsty: thirsty
thirteen: thirteen
thistle: thistle
thither: thither
thitherward: thitherward
thor: thor
thoughtfully: thoughtfully
thoughtless: thoughtless
thousandth: thousandth
thrasher: thrasher
thread: thread,threaded,threading,threads
threat: threat
threaten: threaten,threatened,threatening,threatens
threescore: threescore
threnody: threnodies
threshing: threshing
thrice: thrice
thrifty: thrifty
thrill: thrill,thrilled,thrills
thrilling: thrilling
thrive: thrive,thrived
throat: throat,throats
throe: throes
throw: threw,throw,throwing,thrown
thrush: thrush
thrust: thrust,thrusting
thumb: thumb
thump: thump
thunder: thunder,thundered,thundering,thunders
thunderbolt: thunderbolt
thundering: thundering
thy: thy
thyself: thyself
tick: ticks
ticket: ticket
ticking: ticking
tickle: tickled
tid: tid
tide: tide,tides
tidy: tidy
tie: tie,tied,tying
tiger: tiger
tight: tight,tighter
tigris: tigris
tile: tiles
tillage: tillage
timber: timber,timbers
time: time,times
times: times
timid: timid
timidly: timidly
tin: tin
tinder: tinder
tinge: tinge,tinged,tinges,tinging
tinker: tinker,tinkering
tinkle: tinkled,tinkling
tinkling: tinkling
tint: tint,tints
tinted: tinted
tintinnabulum: tintinnabulum
tiptoe: tiptoe
tired: tired
tissue: tissue
tit: tit
titanic: titanic
title: title,titles
tittle: tittle
toad: toad,toads
tobacco: tobacco
toe: toe,toes
toil: toil,toiling
toilet: toilet
tol: tol
tolerable: tolerable
tolerate: tolerate,tolerated,tolerates
tom: tom
tomb: tomb,tombs
tomorrow: tomorrow
ton: tons
tone: tone
tong: tongs
tongue: tongue,tongues
tonic: tonic
tonight: tonight
tool: tool,tools
tooth: teeth,tooth
topmost: topmost
topographical: topographical
topple: topple
torch: torch
tormentor: tormentors
torpid: torpid
torrent: torrent
torrid: torrid
tortoise: tortoise,tortoises
torture: torture
toss: toss,tossed
total: total
totanus: totanus
totem: totem
totter: tottering
touch: touch,touched,touches,touching
tough: tough
toughness: toughness
tour: tour
tower: towered,towers
towers: towers
town: town,towns
townsfolk: townsfolk
township: township
townsman: townsman,townsmen
townsmen: townsmen
toy: toys
trace: trace,traced,traces
track: track,tracks
tract: tracts
trade: trade,trades
trader: trader,traders
tradesman: tradesmen
tradition: tradition,traditions
tragedy: tragedies,tragedy
tragic: tragic
trail: trail,trailing
train: train,trains
trainer: trainers
training: training
tramp: tramp,tramped
tranquil: tranquil
tranquillity: tranquillity
transact: transact
transcend: transcends
transcendent: transcendent
transcript: transcript
transfer: transfer,transferred
transfix: transfixes
transform: transformed
transformation: transformation
transgress: transgress,transgressed
transgression: transgressions
transient: transient
transitory: transitory
translate: translate,translated,translates
translation: translation,translations
transmigration: transmigration
transmit: transmit,transmitted
transmute: transmute
transparency: transparency
transparent: transparent
transpire: transpire
transport: transported
transportation: transportation
transverse: transverse
trap: trap,traps
trapper: trapper
trappings: trappings
travel: travel,travelled,travelling,travels
traveler: traveler
traveller: traveller,travellers
travels: travels
treacherously: treacherously
tread: tread,trod
treasure: treasure,treasures
treasured: treasured
treasury: treasury
treat: treat,treated,treating,treats
tree: tree,trees
treed: treed
tremble: tremble,trembles,trembling
tremendous: tremendous
tremulous: tremulous
trench: trenches
trend: trend
trespass: trespass
trespasser: trespassers
tress: tresses
tret: tret
trial: trial
triangle: triangles
tribe: tribe,tribes
tribute: tribute
trick: tricks
trickle: trickling
trifle: trifle,trifles,trifling
trifler: trifler
trifling: trifling
trig: trig
trigonometrical: trigonometrical
trill: trill,trilled
trim: trim
trimming: trimmings
trinity: trinity
trip: tripped
trivial: trivial
trivialness: trivialness
trod: trod
trodden: trodden
trojan: trojan,trojans
troop: troop
trope: trope,tropes
trophy: trophies,trophy
tropic: tropic
tropical: tropical
trot: trot,trots,trotting
trotter: trotters
trouble: trouble,troubled
trough: trough
trousers: trousers
trout: trout
trowel: trowel,trowels
troy: troy
truce: truce
true: true,truer
trump: trump
trumpery: trumpery
trumpet: trumpet,trumpeted,trumpets
trunk: trunk,trunks
trust: trust,trusted,trusting
trustworthy: trustworthy
truth: truth,truths
truthfulness: truthfulness
tu: tu
tub: tub,tubs
tube: tube
tuber: tuber
tuck: tuck,tucked
tuition: tuition
tumble: tumbled,tumbling
tumbler: tumbler
tumbling: tumblings
tumid: tumid
tumult: tumult
tumultuous: tumultuous
tune: tune
tunnel: tunnel
turdus: turdus
turf: turf
turkey: turkey
turkish: turkish
turnip: turnip,turnips
turnout: turnout
turtle: turtle,turtles
tusk: tusks
twang: twang
twig: twig,twigs
twiggy: twiggy
twilight: twilight
twin: twin
twinkle: twinkle,twinkling
twist: twist
twitter: twittering
type: type,types
typical: typical
tyranny: tyranny
tyrant: tyrant
ubi: ubi
ugly: ugly
ulysses: ulysses
umbel: umbels
umbilicaria: umbilicaria
umbrageous: umbrageous
umbrella: umbrellas
unable: unable
unaccountable: unaccountable
unaccountably: unaccountably
unalterable: unalterable
unarmed: unarmed
unbeliever: unbelievers
unblushingly: unblushingly
unbroken: unbroken
uncertain: uncertain
uncertainty: uncertainties,uncertainty
unchanged: unchanged
unchronicled: unchronicled
uncle: uncle,uncles
unclean: unclean
uncleanness: uncleanness
uncleansed: uncleansed
uncommitted: uncommitted
uncommon: uncommon
uncommonly: uncommonly
unconcerned: unconcerned
unconscious: unconscious
unconsciously: unconsciously
uncorrected: uncorrected
uncultivated: uncultivated
undeceived: undeceived
undefined: undefined
underbred: underbred
undergo: undergoing,underwent
underlie: underlie
underside: underside
undersized: undersized
understand: understand,understood
understanding: understanding,understandings
understandingly: understandingly
undertake: undertake,undertaken,undertook
undertaking: undertaking
underwriter: underwriter
undeveloped: undeveloped
undiluted: undiluted
undiscovered: undiscovered
undistinguishable: undistinguishable
undisturbed: undisturbed
undo: undone
undoubted: undoubted
undoubtedly: undoubtedly
undue: undue
undulated: undulated
undulating: undulating
undulation: undulation,undulations
undusted: undusted
unearthly: unearthly
uneasy: uneasy
unelastic: unelastic
unendurable: unendurable
unequal: unequal
unequalled: unequalled
uneven: uneven
unexhausted: unexhausted
unexpected: unexpected
unexpectedly: unexpectedly
unexplorable: unexplorable
unexplored: unexplored
unfathomable: unfathomable
unfathomed: unfathomed
unfenced: unfenced
unfinished: unfinished
unfledged: unfledged
unfold: unfold,unfolding
unfortunate: unfortunate
unfrequented: unfrequented
ungainly: ungainly
unhealthy: unhealthy
unhesitatingly: unhesitatingly
unhurried: unhurried
uniform: uniform
unimaginable: unimaginable
unimpaired: unimpaired
unimproved: unimproved
uninhabited: uninhabited
uninstructive: uninstructive
unintended: unintended
uninterrupted: uninterrupted
uninterruptedly: uninterruptedly
unio: unio
union: union
unite: united
united: united
universal: universal
universally: universally
universe: universe
university: universities,university
unjust: unjust
unjustly: unjustly
unkempt: unkempt
unknown: unknown
unleavened: unleavened
unlimited: unlimited
unlucky: unlucky
unmarked: unmarked
unmerchantable: unmerchantable
unmistakable: unmistakable
unmixed: unmixed
unmolested: unmolested
unmoral: unmoral
unmusical: unmusical
unnatural: unnatural
unnaturally: unnaturally
unnecessary: unnecessary
unobscure: unobscured
unobserved: unobserved
unobstructed: unobstructed
unoccupied: unoccupied
unpatched: unpatched
unplastered: unplastered
unpleasant: unpleasant
unpleasantly: unpleasantly
unprepared: unprepared
unpretending: unpretending
unprincipled: unprincipled
unprofaned: unprofaned
unprofitable: unprofitable
unquestionable: unquestionable
unquestionably: unquestionably
unreasonable: unreasonable
unrelaxed: unrelaxed
unremembered: unremembered
unrepentant: unrepentant
unrestrained: unrestrained
unroof: unroofed,unroofs
unruffled: unruffled
unsatisfied: unsatisfied
unscrupulous: unscrupulous
unsophisticated: unsophisticated
unspeakable: unspeakable
unspeakably: unspeakably
unsuitable: unsuitable
unsurveyed: unsurveyed
unsuspected: unsuspected
unsuspecting: unsuspecting
untenable: untenable
untimely: untimely
untold: untold
untried: untried
unusual: unusual
unusually: unusually
unutterable: unutterable
unweariable: unweariable
unwearied: unwearied
unweariedly: unweariedly
unwieldy: unwieldy
unwilling: unwilling
unwillingly: unwillingly
unwise: unwise
unwittingly: unwittingly
upland: upland,uplands
upper: upper
upright: upright
uprightness: uprightness
upset: upset
upward: upward
urge: urged
urgent: urgent
urine: urine
urn: urn
useless: useless
usher: usher,ushered
usnea: usnea
usual: usual
utensil: utensils
uti: uti
utilitarian: utilitarian
utility: utility
utmost: utmost
utopian: utopian
utter: utter,uttered
vacancy: vacancies
vacate: vacate
vacation: vacation
vagabond: vagabond
vague: vague
vaguely: vaguely
vain: vain
vainly: vainly
vale: vale,vales
valet: valet
valhalla: valhalla
valiant: valiant
valid: valid
valley: valley,valleys
valor: valor
valuable: valuable
vanish: vanish
vanity: vanity
vantage: vantage
vapor: vapor,vapors
vaporous: vaporous
variation: variation
varied: varied
variety: varieties,variety
variously: variously
vary: varies,vary
vase: vase
vast: vast,vaster
vastness: vastness
vault: vaults
veer: veer
veery: veery
vegetable: vegetable,vegetables
vegetate: vegetate
vegetation: vegetation
veil: veil,veils
veiling: veiling
vein: vein,veins
velocity: velocity
velvet: velvet
velvety: velvety
venerable: venerable
venetian: venetian
venison: venison
venture: venture,ventured,ventures,venturing
verdure: verdure
verge: verge
vermin: vermin
vermont: vermont
verse: verse,verses
versicolor: versicolor
vert: vert
vertical: vertical
vertically: vertically
vespers: vespers
vessel: vessel,vessels
vest: vest
vestal: vestal
veto: veto
vex: vexed
vexing: vexing
vial: vials
viand: viand
vibration: vibration
vibratory: vibratory
vicar: vicars
vice: vice,vices
vicinity: vicinity
victorious: victorious
victory: victory
victualling: victualling
view: view,viewed,views
vigilant: vigilant
vigor: vigor
vigorous: vigorous
vile: vilest
villa: villa,villas
village: village,villages
villager: villager,villagers
vine: vine,vines
vinegar: vinegar
vineyard: vineyards
vintage: vintage
violence: violence
violent: violent
violet: violet
virgil: virgil
virgin: virgin
virid: virid
virile: virile
virtually: virtually
virtue: virtue,virtues
virtuous: virtuous
virtuti: virtuti
virus: virus
vishnu: vishnu
visible: visible
vision: vision,visions
visit: visit,visited,visits
visitation: visitation
visitor: visitor,visitors
visitors: visitors
vista: vista,vistas
vital: vital,vitals
vitality: vitality
vitally: vitally
vitals: vitals
vitiate: vitiated
vitreous: vitreous
vivacious: vivacious
vivid: vivid
vocal: vocal
vocation: vocation
voice: voice,voices
void: void
volatile: volatile
volume: volume,volumes
voluntarily: voluntarily
voluntary: voluntary
voluptuous: voluptuous
voracious: voracious
voraciously: voraciously
vote: vote,votes,voting
voter: voters
voting: voting
voyage: voyage,voyages
voyaging: voyaging
vulcan: vulcan
vulgar: vulgar
vulpine: vulpine
vulture: vulture
wade: wade,waded,wading
wader: wader
waft: wafted
wager: wager
wages: wages
wagon: wagon,wagons
waif: waifs
wail: wailing
wainscot: wainscot
wait: wait,waited,waiting
waiter: waiters
waive: waive
wake: wake,waked,wakes,waking
wakeful: wakeful
waldenses: waldenses
walk: walk,walked,walking,walks
walking: walking
wall: wall,walls
walled: walled
walnut: walnut,walnuts
wand: wand
wander: wander,wandered,wandering
wanderer: wanderer
wanderings: wanderings
wantonly: wantonly
war: war,wars
warble: warble
warden: warden
wardrobe: wardrobe
ware: ware
warehouse: warehouse
wares: wares
warily: warily
warm: warm,warmed,warmer,warmest,warms
warming: warming
warmth: warmth
warn: warn,warned,warning
warning: warning
warp: warp
warped: warped
warrant: warrant
warrior: warrior
wash: wash,washed
washing: washing
washington: washington
wasp: wasps
wassailer: wassailers
wast: wast
waste: waste,wasted,wasting
watch: watch,watched,watching
watchman: watchmen
water: water,watered,waters
waterlogged: waterlogged
waterloggedness: waterloggedness
waterloo: waterloo
watermelon: watermelon
watery: watery
wave: wave,waved,waves,waving
waveless: waveless
wavy: wavy
wax: waxed
waxen: waxen
waxwork: waxwork
wayland: wayland
weak: weak
weakness: weakness
wealth: wealth
wealthy: wealthy
weapon: weapon
wear: wear,wearing,wears,wore,worn
wearer: wearer
wearisome: wearisome
weary: weary
weather: weather,weathered,weathers
weathercock: weathercock,weathercocks
weave: weave,weaves,woven
weaving: weaving
webster: webster
wedge: wedge
wee: wee
weed: weed,weeding,weeds
weedy: weedy
week: week,weeks
weevil: weevil
wei: wei
weigh: weigh,weighed,weighing
weight: weight
weighty: weighty
wen: wen
wend: wending
west: west
westerly: westerly
western: western
westward: westward
wet: wet
wether: wether
whang: whang
wharf: wharf
whatsoever: whatsoever
wheat: wheat
wheaten: wheaten
wheel: wheel,wheeled
wheelbarrow: wheelbarrow
whereabouts: whereabouts
whereon: whereon
whet: whetted
whimsical: whimsical
whippoorwill: whippoorwill,whippoorwills
whir: whir,whirring
whirl: whirled
whirled: whirled
whirlpool: whirlpool
whirlwind: whirlwind
whisper: whisper,whispered,whispering
whistle: whistle,whistles,whistling
whit: whit
white: white,whiter,whitest
whiteness: whiteness
whitewash: whitewashed
whitish: whitish
whittle: whittled
whittling: whittlings
whiz: whizzing
wholesome: wholesome
wholesomer: wholesomer
wholly: wholly
whoop: whoop
whooping: whooping
wide: wide,wider,widest
widen: widen,widens
widow: widowed,widows
wife: wife
wigwam: wigwam,wigwams
wild: wild,wilder
wilder: wilder
wilderness: wilderness
wildest: wildest
wildly: wildly
wildness: wildness
willed: willed
william: william
willingly: willingly
willow: willow,willows
wind: wind,winded,winding,winds
window: window,windows
windy: windy
wine: wine,wines
wing: wing,winged,wings
winged: winged
winkle: winkles
winnow: winnowed
winnowing: winnowing
winslow: winslow
winter: winter,winters
wintry: wintry
wipe: wipe
wiry: wiry
wisdom: wisdom
wise: wise,wiser,wisest
wiseacre: wiseacre
wisely: wisely
wiser: wiser
wiss: wiss
wit: wit,wits
witch: witches
withal: withal
withdraw: withdraw,withdrawing,withdrawn,withdraws,withdrew
withe: withe
wither: withered
withered: withered
withstand: withstood
witness: witness,witnessed,witnessing
witted: witted
wolf: wolf
wolfish: wolfish
woman: woman,women
wonderful: wonderful
wonderfully: wonderfully
wonted: wonted
wood: wood,woods
woodchopper: woodchopper
woodchuck: woodchuck,woodchucks
woodcock: woodcocks
woodcraft: woodcraft
woodcutter: woodcutters
wooded: wooded
wooden: wooden
woodenness: woodenness
woodland: woodland
woodlot: woodlot
woodman: woodman
woodpecker: woodpecker,woodpeckers
woods: woods
wool: wool
woollen: woollen
word: word
wordy: wordy
workhouse: workhouse
workman: workman,workmen
workshop: workshop
worldly: worldly
worm: worm,worms
wormwood: wormwood
wormy: wormy
worn: worn
worry: worry
worship: worship,worships
worshipper: worshipper
worth: worth
worthily: worthily
worthless: worthless
worthy: worthier,worthies,worthiest,worthy
wound: wound,wounded,wounds
wow: wow
wrap: wrapped,wrapping
wrath: wrath
wreath: wreath,wreaths
wreck: wreck,wrecked,wrecks
wrest: wrested
wrestle: wrestled
wretch: wretch
wretchedness: wretchedness
wrinkle: wrinkle,wrinkled
write: write,writes,writing,written,wrote
writer: writer,writers
writing: writing
writings: writings
written: written
wrong: wrong,wrongs
yankee: yankee
yankees: yankees
yard: yard,yarded,yards
yawn: yawned
yearning: yearning
yeast: yeast
yellow: yellow
yellowish: yellowish
yellowstone: yellowstone
yelp: yelp
yesterday: yesterday
yield: yield,yielded,yielding,yields
yonder: yonder
yore: yore
york: york
youth: youth,youths
youthful: youthful
zag: zag
zanzibar: zanzibar
zephyr: zephyr,zephyrs
zig: zig
zoroaster: zoroaster
