abandon: abandon,abandoned,abandoning,abandons
abandonment: abandonment
abasement: abasement
abate: abated
abatement: abatement
abbess: abbess
abbey: abbey
abduct: abducted
abduction: abduction
abductor: abductor
abe: abed
abed: abed
abhor: abhors
abhorred: abhorred
abide: abiding
abjure: abjure
ablest: ablest
ably: ably
aboard: aboard
abode: abode,abodes
abominable: abominable
abreast: abreast
abridged: abridged
absence: absence,absences
absent: absent,absented
absolute: absolute
absolutely: absolutely
absolution: absolution
absorb: absorbed,absorbs
abstinence: abstinence
abstract: abstracted
abundance: abundance
abundant: abundant
abundantly: abundantly
abuse: abuse,abused,abusing
abyss: abyss,abysses
academy: academy
accelerate: accelerate
accent: accent
accept: accept,accepted,accepting
access: access
accessory: accessory
accident: accident,accidents
accidental: accidental
acclamation: acclamations
accommodate: accommodated
accompany: accompanied,accompanies,accompany,accompanying
accomplice: accomplice,accomplices
accomplish: accomplish,accomplished,accomplishing
accomplishment: accomplishment
accord: accord,accorded
accost: accosted
account: account,accounts
accountable: accountable
accuracy: accuracy
accurate: accurate
accurse: accursed
accursed: accursed
accusation: accusation,accusations
accuse: accuse,accused,accuses,accusing
accuser: accuser
accustom: accustom,accustomed
accustomed: accustomed
ace: aces
achieve: achieved
achilles: achilles
acknowledge: acknowledge,acknowledged,acknowledges,acknowledging
acolyte: acolyte
acquaint: acquainted
acquaintance: acquaintance,acquaintances
acquiesce: acquiesced
acquire: acquired
acquit: acquit,acquitted
action: action,actions
active: active
actively: actively
activity: activity
actor: actor,actors
actress: actress
acts: acts
actuate: actuated
acuteness: acuteness
add: add,adding
adder: adder
addition: addition
additional: additional
additionally: additionally
address: address,addressed,addressing
adieu: adieu
adieux: adieux
adjoin: adjoining
adjoining: adjoining
adjure: adjure
adjust: adjust,adjusted
admirable: admirable
admirably: admirably
admiral: admiral
admiralty: admiralty
admiration: admiration
admire: admire,admired,admiring
admirer: admirer
admission: admission
admit: admit,admitted,admitting
admonition: admonitions
ado: ado
adolescence: adolescence
adopt: adopt
adorable: adorable
adore: adore,adored,adores
adored: adored
adorn: adorn,adorned
adornment: adornment
advance: advance,advanced,advances,advancing
advanced: advanced
advancement: advancement
advantage: advantage,advantages
advantageous: advantageous
advantageously: advantageously
adventure: adventure,adventures
adventurer: adventurer,adventurers
adventurous: adventurous
adversary: adversaries,adversary
adversity: adversity
advice: advice
advise: advise,advised,advising
afar: afar
affable: affable
affair: affair,affairs
affect: affect
affectation: affectation,affectations
affectedly: affectedly
affectingly: affectingly
affection: affection
affectionate: affectionate
affectionately: affectionately
affianced: affianced
affirm: affirm,affirmed
affirmation: affirmation
affirmative: affirmative
affix: affixed
affliction: affliction
affluence: affluence
afford: afford,afforded
affright: affright
affrighted: affrighted
affront: affront
afoot: afoot
aforesaid: aforesaid
afraid: afraid
afresh: afresh
afternoon: afternoon
afterthought: afterthought
afterward: afterward
age: age,ages
agent: agent,agents
aggravate: aggravated
aggressor: aggressors
agile: agile
agility: agility
agitate: agitate,agitated,agitating
agitated: agitated
agitation: agitation
agony: agony
agree: agree,agreed,agreeing
agreeable: agreeable
agreeably: agreeably
agreement: agreement
ahem: ahem
aid: aid
ailment: ailment
aim: aim,aimed,aiming
aimless: aimless
air: air,airs
ajar: ajar
ajax: ajax
alabaster: alabaster
alacrity: alacrity
alarm: alarm,alarmed
alarmed: alarmed
alas: alas
alcove: alcove
alderman: aldermen
alert: alert
alibi: alibi
alight: alighted,alighting
alike: alike
alive: alive
allege: alleging
alleviate: alleviate
alley: alley
alliance: alliance,alliances
allurement: allurement
allusion: allusion
ally: allied,allies,ally
almond: almond,almonds
almoner: almoner
alms: alms
aloud: aloud
altar: altar
alter: alter,altered
alteration: alteration
altered: altered
alternately: alternately
altogether: altogether
amazed: amazed
amazement: amazement
ambassador: ambassador,ambassadors
ambiguous: ambiguous
ambition: ambition
ambitious: ambitious
ambuscade: ambuscade,ambuscades
ambush: ambush,ambushes
amen: amen
amend: amends
amenity: amenity
america: america
amiable: amiable
amiss: amiss
amorous: amorous
amours: amours
ample: ample
amsterdam: amsterdam
amuse: amuse,amused,amuses,amusing
amused: amused
amusement: amusement,amusements
amusing: amusing
analysis: analysis
analyze: analyzed
ancestor: ancestor,ancestors
anchor: anchor
ancient: ancient,ancients
andalusian: andalusian
anew: anew
angel: angel,angels
angelic: angelic
anger: anger,angers
angers: angers
angle: angle,angles
angry: angrier,angry
anguish: anguish
animal: animal,animals
animate: animated
animated: animated
animation: animation
animosity: animosity
anjou: anjou
anne: anne
annex: annex
annihilate: annihilated
anniversary: anniversary
announcement: announcement
annoy: annoy,annoyed,annoys
annoyance: annoyance,annoyances
annoyed: annoyed
annoying: annoying
anoint: anointed
answer: answer,answered,answering,answers
ant: ant
antagonist: antagonist,antagonists
antecedent: antecedents
antechamber: antechamber,antechambers
anterior: anterior
antichrist: antichrist
anticipate: anticipate,anticipated,anticipating
anticipation: anticipation
antidote: antidote
antipathy: antipathy
antique: antique
anxiety: anxiety
anxious: anxious
anxiously: anxiously
apartment: apartment,apartments
aperture: aperture
apiece: apiece
apocalypse: apocalypse
apology: apologies,apology
apostasy: apostasy
apostrophize: apostrophized
apothecary: apothecary
apparel: apparel
apparent: apparent
apparition: apparition,apparitions
appeal: appeal
appearance: appearance,appearances
appease: appease,appeased
appetite: appetite,appetites
appetizing: appetizing
applaud: applauded
applause: applause
application: application
apply: applied,applies,apply,applying
appoint: appoint,appointed,appointing
appointment: appointment,appointments
appreciation: appreciation
apprehend: apprehended
apprentice: apprentice
apprenticeship: apprenticeship
apprise: apprised
approach: approach,approached,approaching
approbation: approbation
approve: approve,approved,approves,approving
april: april
aptitude: aptitude
arabesque: arabesques
arabian: arabian
aramis: aramis
arc: arc
arcade: arcade
arch: arch,arched,arches
archangel: archangels
arched: arched
archer: archers
archimedes: archimedes
archipelago: archipelago
archive: archives
ardent: ardent
ardently: ardently
ardor: ardor
argue: argue,argued,arguing
argument: argument,arguments
argumentum: argumentum
aright: aright
aristocracy: aristocracy
aristocratic: aristocratic
arm: arm,armed,arms
armament: armaments
armchair: armchair
armed: armed
armenia: armenia
armida: armida
armor: armor
army: armies,army
arouse: aroused
arquebus: arquebus
arrange: arrange,arranged,arranging
arrangement: arrangement,arrangements
arras: arras
arrears: arrears
arrest: arrest,arrested,arresting
arrival: arrival
arrive: arrive,arrived,arrives,arriving
art: art
artful: artful
article: article
artifice: artifices
artificial: artificial
ascend: ascend,ascended,ascending
ascendancy: ascendancy
ascent: ascent
ascertain: ascertain,ascertained
ash: ashes
ashamed: ashamed
ashore: ashore
asleep: asleep
aspect: aspect,aspects
aspire: aspire
ass: ass
assailant: assailants
assassin: assassin,assassins
assassinate: assassinate,assassinated,assassinating
assassination: assassination
assault: assault,assaulted
assemblage: assemblage
assemble: assembled
assembly: assembly
assent: assent
assert: assert,asserted,asserts
assertion: assertion
assiduously: assiduously
assign: assign,assigned,assigning
assist: assist,assisted,assisting
assistance: assistance
assistant: assistant
associate: associate
association: association
assorted: assorted
assortment: assortment
assume: assume,assumed,assuming
assurance: assurance,assurances
assure: assure,assured,assures,assuring
assuredly: assuredly
assyrians: assyrians
astarte: astarte
astonish: astonish,astonished,astonishes
astonished: astonished
astonishing: astonishing
astonishment: astonishment
astounded: astounded
astray: astray
astrologer: astrologer
astute: astute
atmosphere: atmosphere
atmospheric: atmospheric
atom: atoms
atrocious: atrocious
attach: attach,attached,attaches,attaching
attachment: attachment
attack: attack,attacked,attacking,attacks
attain: attain,attained
attainment: attainment
attempt: attempt,attempted,attempting,attempts
attend: attend,attended,attending
attendant: attendant,attendants
attention: attention,attentions
attentive: attentive
attentively: attentively
attest: attest,attested,attesting,attests
attitude: attitude,attitudes
attorney: attorney
attract: attract,attracted
attraction: attraction,attractions
attractive: attractive
attribute: attribute,attributed,attributes
auberge: auberge
audacity: audacity
audible: audible
audibly: audibly
audience: audience
auditor: auditor,auditors
augment: augmented
augury: augury
august: august
augustine: augustine
aunt: aunt
austere: austere
austerity: austerity
austria: austria
austrian: austrian
author: author,authors
authority: authorities,authority
authorization: authorization
authorize: authorize,authorized
autumn: autumn
aux: aux
auxiliary: auxiliary
avail: avail,availed
avant: avant
avarice: avarice
avaricious: avaricious
avenge: avenge,avenged,avenging
avenger: avenger,avengers
avenue: avenue,avenues
aversion: aversion
aves: aves
avidity: avidity
avoid: avoid,avoided,avoiding
avow: avow
await: await,awaited,awaiting,awaits
awake: awake,awaking,awoke
awaken: awaken,awakened,awakens
awakening: awakening
aware: aware
awful: awful
awhile: awhile
awkward: awkward
awkwardly: awkwardly
ax: ax
ay: ay
azure: azure
baal: baal
babble: babble
baboon: baboon
bac: bac
background: background
bacon: bacon
bad: bad,worse,worst
badly: badly
bag: bag,bags
baggage: baggage
bah: bah
bailiff: bailiff,bailiffs
bait: bait
balance: balance,balancing
balcony: balcony
baldric: baldric
balk: balked
ball: ball,balls
ballad: ballads
ballet: ballet
balm: balm
balmy: balmy
balsam: balsam
balsamic: balsamic
balustrade: balustrade
band: bands
bandage: bandages
bandit: bandit
bandy: bandy
banish: banishes
bank: bank,banks
banquet: banquet
banter: bantering
bar: bar,barred,bars
barbarous: barbarous
bare: bare
barely: barely
bargain: bargain
bargaining: bargaining
bark: bark,barking
baron: baron
baroness: baroness,baronesses
baronne: baronne
barrack: barrack
barracks: barracks
barrel: barrel,barrels
barren: barren
barricade: barricaded
barrier: barrier
bartholomew: bartholomew
base: base
basely: basely
baseness: baseness
basis: basis
basket: basket
bassette: bassette
bastille: bastille
bastion: bastion,bastions
bat: bat
bath: bath,bathed
battery: batteries
battle: battle,battles
bay: bay
beach: beach
beam: beam,beamed,beaming,beams
bean: beans
bear: bear,bearing,bears,bore,born,borne
beard: beard
bearer: bearer,bearers
bearing: bearing
beast: beast,beasts
beat: beat,beaten,beating,beats
beatific: beatific
beating: beating
beautiful: beautiful
beauty: beauties,beauty
beaver: beaver
becomingly: becomingly
bed: bed,beds
bedchamber: bedchamber
bedpost: bedposts
bedroom: bedroom
bedside: bedside
bedstead: bedstead
beef: beef
beer: beer
befall: befall,befallen,befalling,befell
befriend: befriends
beg: beg,begged,begging
beggar: beggar
beggarly: beggarly
begone: begone
behalf: behalf
behave: behave,behaved,behaves
behold: beheld,behold,beholding
behoove: behooved
belated: belated
belfry: belfry
belgium: belgium
belial: belial
belief: belief
believer: believers
bell: bell,bells
belles: belles
belly: belly
belong: belong,belonged,belonging,belongs
beloved: beloved
belt: belt,belted
bench: bench,benches
bend: bend,bending,bent
beneath: beneath
benediction: benediction,benedictions
benefactor: benefactor
benefactress: benefactress
benefit: benefit,benefited
benevolent: benevolent
bent: bent
berrichon: berrichon
berry: berry
beseech: beseech
beset: besetting
besiege: besiege,besieged,besieging
besieger: besiegers
bespeak: bespeak
bestow: bestow,bestowed
bet: bet
betray: betray,betrayed,betraying,betrays
betrayal: betrayal
bettor: bettor
beware: beware
bewilder: bewildered
bewilderment: bewilderment
bias: bias
bible: bible
bid: bade,bid,bidden,bidding
bidding: bidding
bigamist: bigamist
bile: bile
bilious: bilious
billet: billet
bind: bind,binding,bound
bird: bird,birds
birth: birth
birthday: birthday
biscuit: biscuit
bishop: bishop
bit: bit
bite: bit,bite,biting,bitten
bitter: bitter
bitterly: bitterly
bitterness: bitterness
black: black
blacken: blackened
blackguard: blackguard
blackness: blackness
blade: blade,blades
blame: blame,blamed
blanche: blanche
bland: bland
blank: blank
blaspheme: blasphemed,blaspheming
blasphemy: blasphemies
blast: blast,blasted
blaze: blazing
bleed: bled,bleed,bleeds
bleeding: bleeding
blemish: blemish
bless: bless,blessed,blesses
blessed: blessed
blessing: blessing,blessings
bleu: bleu
blind: blind,blinded,blinds
blindly: blindly
blink: blinking
blockade: blockade,blockaded
blockhead: blockhead
blond: blond
blood: blood
bloodshed: bloodshed
bloodstain: bloodstain
bloody: bloody
blow: blew,blow,blowing,blows
blue: blue
bluish: bluish
blunder: blunders
blush: blush,blushed,blushes,blushing
bluster: blustering
board: board,boards
boarder: boarder,boarders
boast: boast,boasted
boastful: boastful
boat: boat
boatman: boatman
boatswain: boatswains
bodily: bodily
body: bodies,body
bohemian: bohemian
boil: boiled,boiling
bois: bois
bold: bold
boldly: boldly
bolster: bolster
bolt: bolt,bolted,bolting,bolts
bond: bonds
bone: bone,bones
boniface: boniface
bonnes: bonnes
bons: bons
bony: bony
booby: booby
book: book,books
boor: boor
boot: boot,booted,boots
bordeaux: bordeaux
border: border
bore: bored
bored: bored
borrow: borrow,borrowed
borrowing: borrowing
bosom: bosom,bosoms
botany: botany
bother: bother
bottle: bottle,bottles
boudoir: boudoir
bound: bound,bounded,bounds
bourgeois: bourgeois
bow: bow,bowed,bowing
box: box
boy: boy,boys
braggart: braggart,braggarts
braiding: braiding
brain: brain,brains
branch: branch,branches
brand: brand,branded
brandy: brandy
brass: brass
brave: brave,braves,bravest
bravely: bravely
bravery: bravery
bravo: bravo
brawl: brawl,brawls
brazen: brazen
breach: breach
bread: bread
break: break,breaking,breaks,broke,broken
breaker: breakers
breakfast: breakfast,breakfasted,breakfasting
breaking: breaking
breast: breast
breath: breath
breathe: breathe,breathed,breathes,breathing
breathing: breathing
breathless: breathless
breed: bred
breeze: breeze
brest: brest
brethren: brethren
breviary: breviary
brevity: brevity
bridge: bridge
bridle: bridle,bridles
brig: brig
brigadier: brigadier
brigand: brigand,brigands
bright: bright,brightest
brighten: brightening
brilliancy: brilliancy
brilliant: brilliant,brilliants
brilliantly: brilliantly
bring: bring,bringing,brings,brought
brisk: brisk
briskly: briskly
bristly: bristly
britain: britain
britannic: britannic
british: british
brittany: brittany
broach: broached
broad: broad
broken: broken
bronze: bronze
broom: broom
brother: brother,brothers
brotherly: brotherly
brow: brow,brows
brown: brown
bruise: bruised
brush: brush,brushed
brussels: brussels
brutal: brutal
brutality: brutality
brutalize: brutalize
brute: brute
brutus: brutus
bucephalus: bucephalus
buckler: buckler
budge: budge
buff: buff
buffet: buffet
build: build,built
building: building
bull: bull
bullet: bullet,bullets
bulwark: bulwark
bunch: bunches
bundle: bundle
bungling: bungling
burden: burden
burgundy: burgundy
burial: burial
burn: burn,burned,burning,burns
burning: burning
burrow: burrow
burst: burst,bursting
bury: buried,bury,burying
business: business
busk: busk
bustle: bustle
busy: busied,busy
butler: butler
butt: butts
buttercup: buttercup
butterfly: butterfly
button: buttoned
buzz: buzzing
buzzing: buzzing
bypath: bypath
byroad: byroad
cabal: cabal
cabaret: cabaret,cabarets
cabin: cabin
cabinet: cabinet
cadet: cadet
cage: cage
cajolery: cajolery
cake: cake
calais: calais
calculate: calculate,calculated
calculation: calculation,calculations
calf: calves
caliber: caliber
calm: calm,calmed,calmer,calming
calmly: calmly
calmness: calmness
calotte: calotte
calumniator: calumniators
calumny: calumny
calvinism: calvinism
calvinist: calvinist
cambric: cambric
camp: camp
campaign: campaign,campaigns
candidate: candidate
candidly: candidly
candle: candles
candlestick: candlestick
candor: candor
cane: cane
cannon: cannon
cannonade: cannonade
canon: canon
canopy: canopy
canter: cantered
canto: canto
cap: cap,caps
capable: capable
capacity: capacity
caparison: caparison
caper: caper
capital: capital
capitally: capitally
capitulation: capitulation
capon: capon
caprice: caprice,caprices
capricious: capricious
captain: captain,captains
captive: captive,captives
captivity: captivity
capture: capture,captured
capuchin: capuchin
capuchins: capuchins
car: car
caracole: caracole
caracoling: caracoling
carafe: carafe
caravan: caravan
carbuncle: carbuncles
carcass: carcass
card: cards
cardinal: cardinal,cardinals
cardinalist: cardinalist
care: care,cared,cares,caring
career: career
careful: careful
carefully: carefully
careless: careless
carelessly: carelessly
carelessness: carelessness
caress: caressed,caresses,caressing
caring: caring
carmelite: carmelite
carousal: carousal,carousals
carp: carp
carpenter: carpenters
carpet: carpet
carriage: carriage,carriages
carry: carried,carries,carry,carrying
cart: cart
carte: carte
carter: carters
cartridge: cartridges
casement: casement
cash: cash
cask: cask,casks
casket: casket
cassette: cassette
cassock: cassock
cast: cast,casting,casts
caster: caster,casters
castle: castle
casuist: casuist
cat: cat,cats
catalogue: catalogue
catarrh: catarrh
catastrophe: catastrophes
catch: catch,catching,caught
categorically: categorically
catholic: catholic
catholics: catholics
caution: caution
cautious: cautious
cavalcade: cavalcade
cavalier: cavalier,cavaliers
cavalierly: cavalierly
cavern: cavern
ce: ce
cease: cease,ceased,ceasing
ceiling: ceiling
celebrated: celebrated
celerity: celerity
celestial: celestial
cell: cell,cells
cellar: cellar
cemetery: cemetery
censure: censure
cent: cent
center: center
century: centuries,century
ceremonial: ceremonial
ceremoniously: ceremoniously
ceremony: ceremonies,ceremony
certainty: certainty
certes: certes
cerulean: cerulean
cervantes: cervantes
chafe: chafed,chafing
chaffinch: chaffinch
chagrin: chagrin
chain: chain,chained,chains
chair: chair,chairs
chaise: chaise
challenge: challenge,challenged,challenging
chamber: chamber,chambers
chambermaid: chambermaid,chambermaids
chambertin: chambertin
chambre: chambre
champagne: champagne
champion: champion
chance: chance,chanced,chances
chanced: chanced
chancellor: chancellor
change: change,changed,changing
channel: channel
chant: chant,chanted
chantilly: chantilly
chaos: chaos
chapel: chapel
chaplet: chaplet
chapter: chapter
character: character,characters
characteristic: characteristic
charge: charge,charged,charges,charging
charger: charger
chariot: chariots
charity: charity
charlemagne: charlemagne
charles: charles
charlotte: charlotte
charm: charm,charmed,charms
charmed: charmed
charmer: charmer
charming: charming
charter: chartered,chartering
chartreux: chartreux
chase: chase,chased,chasing
chaste: chaste
chastise: chastise,chastised,chastises,chastising
chastised: chastised
chastisement: chastisement
chastity: chastity
chat: chat,chatted,chatting
chatter: chattered
cheap: cheap
check: check,checked,checking,checks
cheek: cheek,cheeks
cheer: cheer,cheered
cheerful: cheerful
cheerfully: cheerfully
cheerfulness: cheerfulness
cheese: cheese
cherish: cherish
cherry: cherry
chess: chess
chest: chest,chests
chestnut: chestnut
chevalier: chevalier
chevaliers: chevaliers
chicken: chicken,chickens
chief: chief
child: child,children
childhood: childhood
chill: chill,chills
chilly: chilly
chimera: chimeras
chimney: chimney
chimneypiece: chimneypiece
chin: chin
chink: chinked,chinks
chisel: chiseled
chivalric: chivalric
chivalrous: chivalrous
chocolate: chocolate
choice: choice
choir: choir
choking: choking
choler: choler
choose: choose,chose,chosen
chop: chops
chorus: chorus
christian: christian,christians
chronicle: chronicle
chronicler: chronicler
chronological: chronological
chuckle: chuckled
church: church,churches
churchman: churchman,churchmen
cinder: cinder
cipher: cipher
circe: circe
circle: circle
circuit: circuit
circular: circular
circulate: circulate
circumstance: circumstance,circumstances
circumstantial: circumstantial
circumvallation: circumvallation
circus: circus
citadel: citadel
cite: cited
citizen: citizen,citizens
city: cities,city
civil: civil
civilian: civilians
civility: civilities,civility
civilization: civilization
claim: claim,claimed,claiming
clamor: clamor
clang: clang
clank: clanking
clap: clap,clapped
clapping: clapping
clash: clashed,clashing
clasp: clasping,clasps
clasped: clasped
class: class,classes
classical: classical
claude: claude
clean: clean
cleanse: cleansed
clematis: clematis
clemency: clemency
clement: clement
clench: clenched
clenched: clenched
clerk: clerk,clerks
clever: clever
client: clients
clientage: clientage
cliff: cliff
climb: climb,climbed
climbing: climbing
cling: clinging,clung
clipper: clipper
cloak: cloak,cloaks
clock: clock,clocks
cloister: cloister
close: close,closed,closing
closed: closed
closely: closely
closet: closet,closeted,closets
closing: closing
cloth: cloth
clothe: clothed
clothes: clothes
cloud: cloud,clouds
clouded: clouded
club: club
clue: clue
clump: clump
clutch: clutched
coach: coach
coachman: coachman
coalition: coalition
coarse: coarse
coast: coast,coasts
coastguard: coastguard
coat: coat,coats
cob: cob
cock: cock,cocking
cocked: cocked
coffer: coffer
coin: coin,coining
coiner: coiner,coiners
cold: cold
coldly: coldly
coldness: coldness
collar: collar
collation: collation
collect: collected,collecting
collection: collection
colombier: colombier
colonel: colonels
colony: colonies
color: color,colored,coloring
colored: colored
coloring: coloring
column: column
combat: combat
combatant: combatants
combine: combined
comedian: comedian
comedy: comedy
comfort: comfort
comfortable: comfortable
comfortably: comfortably
command: command,commanded,commanding,commands
commandant: commandant
commander: commander
commanding: commanding
commandment: commandment
commence: commence,commenced,commencing
commencement: commencement
commend: commend,commended
comment: comments
commentary: commentary
commissary: commissaries,commissary
commission: commission,commissioned,commissions
commit: commit,committed,committing
commode: commode
common: common
commonly: commonly
commotion: commotion
communicate: communicate,communicated,communicates
communication: communication
communicative: communicative
community: community
commute: commute
compact: compact
companion: companion,companions
company: companies,company
comparative: comparative
compare: compared
comparison: comparison
compassion: compassion
compassionate: compassionate
compatriot: compatriot,compatriots
compeer: compeer
compel: compelled,compels
complacent: complacent
complacently: complacently
complain: complain,complained,complaining
complaint: complaint,complaints
complaisance: complaisance
complaisant: complaisant
complete: complete,completed
completely: completely
complexion: complexion
compliance: compliance
compliantly: compliantly
complicate: complicated
complicated: complicated
complicity: complicity
compliment: compliment,compliments
compline: complines
comply: complied,comply,complying
compose: compose,composed,composing
comprehend: comprehend,comprehended,comprehending
comprehensible: comprehensible
compress: compress,compressed
comprise: comprised
compromise: compromise,compromised,compromises,compromising
comrade: comrade,comrades
comte: comte
comtes: comtes
comtesse: comtesse
conceal: conceal,concealed,concealing,conceals
concealment: concealment
conceit: conceit
conceive: conceive,conceived,conceives
concentrate: concentrate
concentrated: concentrated
concern: concern,concerned,concerns
concerned: concerned
concerted: concerted
concierge: concierge
conciliate: conciliate,conciliated
conciliation: conciliation
conciseness: conciseness
conclude: concluded
conclusion: conclusion,conclusions
condemn: condemn,condemned,condemns
condemnation: condemnation
condescend: condescend,condescended
condescension: condescension
condition: condition,conditions
condolence: condolence
conduct: conduct,conducted,conducting,conducts
confer: confer,conferred,conferring
conference: conference
confess: confess,confessed,confessing
confession: confession,confessions
confessor: confessor
confidant: confidant,confidants
confide: confide,confided,confides,confiding
confidence: confidence,confidences
confident: confident
confidential: confidential
confine: confine,confined
confinement: confinement
confines: confines
confirm: confirmed
confiscate: confiscated
conflagration: conflagration
conflict: conflict
conflicting: conflicting
conformity: conformity
confound: confound,confounded,confounds
confront: confronted
confuse: confuse,confused,confuses
confused: confused
confusion: confusion
congratulate: congratulate,congratulated,congratulating
conjecture: conjectures
conjugal: conjugal
conjure: conjure,conjured
connect: connected
connection: connection,connections
connoisseur: connoisseur,connoisseurs
conquer: conquer,conquered,conquering
conqueror: conqueror,conquerors
conquest: conquest
conscience: conscience,consciences
conscientiousness: conscientiousness
conscious: conscious
consciousness: consciousness
consecrate: consecrate,consecrated
consent: consent,consented
consequence: consequence,consequences
considerable: considerable
consideration: consideration
consign: consigned
consigning: consigning
consist: consist,consisted,consisting,consists
consistent: consistent
consolation: consolation
console: console,consoled,consoling
conspicuous: conspicuous
conspiracy: conspiracy
conspirator: conspirators
conspire: conspire,conspired,conspires,conspiring
constable: constable
constance: constance
constancy: constancy
constant: constant
constantly: constantly
consternation: consternation
constitute: constitute,constituted,constitutes
constrain: constrained
constriction: constriction
construct: constructed
consult: consult,consulted,consulting
consultation: consultation
consume: consumed
consummate: consummated
consumption: consumption
contact: contact
contaminate: contaminated
contemplate: contemplate,contemplated,contemplates,contemplating
contemplation: contemplation
contemplative: contemplative
contemporary: contemporary
contempt: contempt
contemptible: contemptible
contemptuous: contemptuous
contemptuously: contemptuously
contend: contend,contended
content: content,contenting
contented: contented
contents: contents
contest: contest
contiguous: contiguous
continent: continent
continually: continually
continuation: continuation
continue: continue,continued,continues,continuing
continued: continued
continuous: continuous
contortion: contortions
contract: contract,contracted
contraction: contraction
contradict: contradict
contradiction: contradiction
contrary: contrary
contrast: contrast,contrasted,contrasts
contribution: contributions
contrite: contrite
contrive: contrive
contrived: contrived
control: control
controversy: controversy
convalescence: convalescence
convalescent: convalescent,convalescents
convenient: convenient
convent: convent,convents
conversant: conversant
conversation: conversation
converse: converse,conversed,conversing
conversion: conversion
convert: converted
convey: convey,conveyed,conveying
conviction: conviction
convince: convince,convinced
convinced: convinced
convincing: convincing
convulse: convulsed
convulsion: convulsion,convulsions
convulsive: convulsive
convulsively: convulsively
cook: cook,cooked
cool: cool,cooler
coolly: coolly
coolness: coolness
cooperation: cooperation
coppery: coppery
coquetry: coquetry
coquette: coquette
coquettish: coquettish
coral: coral
corbleu: corbleu
cord: cord
cordial: cordial
cordiality: cordiality
cordially: cordially
corn: corn
corner: corner,corners
cornet: cornet
coronet: coronet,coronets
corps: corps
corpse: corpse,corpses
correct: correct,corrected
correction: corrections
correctly: correctly
correctness: correctness
correspond: correspond,corresponded
correspondence: correspondence,correspondences
corridor: corridor,corridors
corroborate: corroborated
corrupt: corrupt,corrupted,corrupting
corruption: corruption
corselet: corselet
cost: cost,costing
costume: costume,costumes
cottage: cottage
cotton: cotton
couch: couch
cough: cough,coughed
council: council
counsel: counsel,counseled,counsels
count: count,counted,counting,counts
countenance: countenance,countenances
counterfeit: counterfeit
countermand: countermand
countermine: countermine
counterscarp: counterscarp
countersign: countersign,countersigned
countess: countess,countesses
country: countries,country
couple: couple
couplet: couplet
courage: courage
courageous: courageous
courier: courier,couriers
courser: coursers
court: court,courts
courteous: courteous
courteously: courteously
courtesan: courtesan
courtesy: courtesy
courtier: courtier,courtiers
courtyard: courtyard
cousin: cousin,cousins
cover: cover,covered,covering,covers
coverlet: coverlet
covet: coveted
coward: coward,cowards
cowardice: cowardice
cowardly: cowardly
crack: crack,cracked,cracking
craft: craft
cram: cram,crammed
cramp: cramps
crash: crash
crawl: crawl,crawling
creak: creak,creaking
crease: creased
create: create,created
creator: creator
creature: creature,creatures
credit: credit,credited
creditor: creditor
credulous: credulous
creed: creed
creep: creep,crept
crevice: crevice
crew: crew
crime: crime,crimes
criminal: criminal,criminals
crimson: crimson
crisis: crises,crisis
critic: critic
critical: critical
criticize: criticized
crockery: crockery
crooked: crooked
crop: crop
cross: cross,crossed,crosses,crossing
crossbones: crossbones
crossing: crossing
crossroad: crossroad
crossroads: crossroads
crossway: crossways
crouch: crouches,crouching
crow: crows
crowd: crowd
crowded: crowded
crown: crown,crowned,crowns
crucifix: crucifix
cruel: cruel
cruelly: cruelly
cruelty: cruelty
cruiser: cruisers
crumple: crumpled
crush: crush,crushed
crust: crusts
crystal: crystal
cuirass: cuirass
culpa: culpa
culpability: culpability
culpable: culpable
cultivate: cultivated
cunning: cunning
cunningly: cunningly
cup: cup
cupboard: cupboard
cupid: cupid
cupidity: cupidity
curacy: curacy
curate: curate
cure: cure,cured,curing
curiosity: curiosity
curious: curious
curl: curl,curled,curls
current: current
curse: curse,cursed,curses,cursing
cursed: cursed
curtain: curtain,curtains
curtly: curtly
curtsy: curtsy
curvet: curvets
cushion: cushion,cushions
custom: custom,customs
customarily: customarily
customary: customary
customer: customers
cut: cut,cutting
cutlet: cutlets
cutter: cutter
cutting: cutting
cynical: cynical
daily: daily
damage: damage
damask: damask
dame: dame
damn: damn
damnation: damnation
damned: damned
damp: damp
dance: dance,danced,dancing
dancer: dancer
dancing: dancing
danger: danger,dangers
dangerous: dangerous
dangerously: dangerously
dangle: dangling
daredevil: daredevils
daring: daring
dark: dark,darker,darkest
darken: darkened,darkening
darkness: darkness
dart: dart,darted,darting
dash: dash,dashed,dashing
daughter: daughter,daughters
dauphine: dauphine
dawn: dawn,dawned
day: day,days
daybreak: daybreak
daylight: daylight
daytime: daytime
dazzle: dazzled,dazzling
deacon: deacons
dead: dead
deaden: deadened
deadly: deadly
deaf: deaf
deafen: deafen
deal: deal,dealt
dealer: dealer
dearly: dearly
death: death
deathlike: deathlike
debate: debate,debated
debauch: debauch
debauchee: debauchee
debauchery: debaucheries
debt: debt,debts
decamp: decamp
decanter: decanters
decapitate: decapitated
deceit: deceit
deceive: deceive,deceived,deceives
deceiver: deceiver
december: december
deception: deception
decide: decide,decided,deciding
decidedly: decidedly
decision: decision
decisive: decisive
deck: deck
declaration: declaration
declare: declare,declared,declaring
decline: decline,declined,declining
decree: decreed,decrees
deed: deed,deeds
deem: deemed
deep: deep,deeper,deepest
deeply: deeply
default: default
defeat: defeat,defeated,defeats
defend: defend,defended,defending
defender: defender
defense: defense
defensive: defensive
defer: deferred
deference: deference
defiance: defiance
deficient: deficient
defile: defile,defiled,defiles,defiling
define: defined
deform: deformed
defray: defray
defunct: defunct
defy: defy
degenerate: degenerated,degenerates
degradation: degradation
degrading: degrading
degree: degree,degrees
deign: deign,deigning
deity: deity
delay: delay,delayed,delaying
delegate: delegated
deliberate: deliberate,deliberating
delicacy: delicacies,delicacy
delicate: delicate
delicious: delicious
delight: delight
delighted: delighted
delightful: delightful
delilah: delilah
delirious: delirious
delirium: delirium
deliver: deliver,delivered
deliverance: deliverance
dell: dell
delude: deludes
delusion: delusion
demand: demand,demanded,demanding
demigod: demigod,demigods
demolish: demolished
demon: demon,demons
demoniacal: demoniacal
demonstration: demonstration,demonstrations
denial: denial
denier: denier
denis: denis
denmark: denmark
denote: denote,denoted,denotes,denoting
denounce: denounce,denounced
denunciating: denunciating
deny: denied,denies,deny,denying
depart: depart,departed,departing
departure: departure
depend: depend,depended,depends
deposit: deposited
deprecating: deprecating
depress: depressed
depressed: depressed
depression: depression
deprivation: deprivation
deprive: deprive,deprived,deprives,depriving
depth: depth
depths: depths
deputy: deputies
derange: deranged
derive: derive,derived,derives,deriving
des: des
descend: descend,descended,descending
descent: descent
description: description,descriptions
desert: desert,deserted,deserting,deserts
deserted: deserted
deserter: deserter
deserve: deserve,deserved,deserves
desiderium: desiderium
design: design,designs
designate: designate,designated
desirable: desirable
desire: desire,desired,desires,desiring
desirous: desirous
desk: desk,desks
desolately: desolately
desolation: desolation
despair: despair,despaired
despairing: despairing
desperate: desperate
desperately: desperately
despise: despised
despoil: despoiled
desponding: desponding
despotic: despotic
dessert: dessert
destination: destination
destine: destined,destines
destiny: destinies,destiny
destitute: destitute
destroy: destroy,destroyed,destroying
destruction: destruction
detach: detach,detached,detaching
detachment: detachment
detain: detain,detained
detect: detect,detected
detention: detention
deter: deter
determination: determination
determine: determine,determined
determined: determined
detest: detest,detested,detests
detonation: detonation
detour: detour
detract: detracted
detractor: detractors
deuce: deuce
devastation: devastation
develop: develop,developed
development: development,developments
deviate: deviated
device: device
devil: devil,devils
devilish: devilish
devilishly: devilishly
devise: devise,devised
devote: devoted
devoted: devoted
devotedness: devotedness
devotion: devotion
devour: devour,devoured,devouring,devours
devourer: devourers
devouring: devouring
devout: devout
dew: dew,dews
diabolical: diabolical
dialect: dialect
dialogue: dialogue
diamond: diamond,diamonds
diaphanous: diaphanous
dice: dice
dicer: dicers
dictate: dictated
didactic: didactic
die: die,died,dies,dying
difference: difference,differences
difficult: difficult
difficulty: difficulties,difficulty
diffidence: diffidence
dig: digging,dug
digestion: digestion
dignified: dignified
dignitary: dignitaries
dignity: dignity
dilate: dilate,dilated
dilemma: dilemma
diligence: diligence
diminish: diminish,diminished
diminished: diminished
dine: dine,dined,dines
diner: diners
dining: dining
dinner: dinner,dinners
dinnertime: dinnertime
dip: dip,dipped,dipping
direct: direct,directed,directing
direction: direction,directions
director: director
dirt: dirt
disable: disable,disabled
disabled: disabled
disadvantage: disadvantage
disagreeable: disagreeable
disagreeableness: disagreeableness
disappear: disappear,disappeared
disappearance: disappearance,disappearances
disappoint: disappointed
disappointment: disappointment
disapproving: disapproving
disarm: disarm,disarmed
disastrous: disastrous
discharge: discharge,discharged
discipline: discipline,disciplined
disclose: disclosed,disclosing
disclosure: disclosure
disconcert: disconcerted
disconcerted: disconcerted
discontent: discontent
discourage: discourage,discouraged
discouragement: discouragement
discourse: discourse
discover: discover,discovered,discovering
discovery: discovery
discreet: discreet
discreetly: discreetly
discretion: discretion
discuss: discussing
discussion: discussion
disdain: disdain,disdained
disdained: disdained
disdainful: disdainful
disdainfully: disdainfully
disease: disease
disembarrass: disembarrass
disengage: disengaged,disengaging
disgorge: disgorging
disgrace: disgrace,disgraces
disgraceful: disgraceful
disguise: disguise,disguised,disguises
disgust: disgust,disgusted
disgusted: disgusted
dish: dish,dishes
disheartening: disheartening
disheveled: disheveled
dishonor: dishonor,dishonored
disinterested: disinterested
dislike: dislike
dislodge: dislodge
dismal: dismal
dismantle: dismantling
dismiss: dismiss,dismissed
dismissal: dismissal
dismount: dismount,dismounted,dismounting
disobedience: disobedience
disobey: disobey
disoblige: disobliged,disobliging
disobliging: disobliging
disorder: disorder,disordered
dispatch: dispatch,dispatched,dispatches
dispel: dispel
dispense: dispense
disperse: disperse
display: display,displayed,displaying
displease: displease,displeases,displeasing
displeasing: displeasing
displeasure: displeasure
disposal: disposal
dispose: dispose,disposed,disposes
disposed: disposed
disposition: disposition
dispossess: dispossessed
dispute: dispute,disputed,disputes
disquiet: disquiet,disquieted
disregard: disregard
dissatisfied: dissatisfied
dissemble: dissemble,dissembling
dissension: dissensions
dissimulation: dissimulation
dissipate: dissipate,dissipated
dissolve: dissolve,dissolved
dissuade: dissuaded
distance: distance
distant: distant
distil: distills
distinct: distinct
distinction: distinction
distinguish: distinguish,distinguished,distinguishing
distinguished: distinguished
distort: distorted
distract: distracted
distraction: distraction,distractions
distress: distress
distressed: distressed
distribute: distribute,distributed
distrust: distrusts
disturb: disturb,disturbed,disturbs
disturbance: disturbance,disturbances
disturbed: disturbed
ditch: ditch
ditty: ditty
diurnal: diurnal
diverge: diverged
diversion: diversion
divert: divert,diverted
divide: divide,divided
divided: divided
divine: divine,divined
divinity: divinity
division: divisions
divorce: divorce
dix: dix
doctor: doctor
doctrine: doctrines
dog: dog,dogs
dogmatic: dogmatic
dolorous: dolorous
domestic: domestic,domestics
domicile: domicile,domiciles
dominate: dominated
domination: domination
dona: dona
donate: donated
donna: donna
doom: doomed
door: door,doors
doorcase: doorcase
doorway: doorway
dost: dost
dot: dotted
double: double,doubled,doubles
doublet: doublet,doublets
doubly: doubly
doubt: doubt,doubted,doubts
doubtless: doubtless
doubtlessly: doubtlessly
dove: dove
dovecot: dovecot
dover: dover
downcast: downcast
downstairs: downstairs
downward: downward
downy: downy
dowry: dowry
dozen: dozen
drag: drag,dragged,dragging,drags
dragoon: dragoon,dragoons
drama: drama
draper: drapers
draught: draught
draw: draw,drawing,drawn,draws,drew
drawer: drawers
drawing: drawing
dread: dread,dreaded,dreading,dreads
dreadful: dreadful
dream: dream,dreamed,dreaming,dreams
dress: dress,dressed,dresses,dressing
dressed: dressed
dressing: dressing
drift: drift
drink: drank,drink,drinking,drinks,drunk
drinkable: drinkable
drinker: drinker,drinkers
drinking: drinking
dripping: dripping
drive: drive,driven,drives,driving,drove
droll: droll
drolly: drolly
droop: drooped,drooping
drop: drop,dropped,drops
drown: drown
drowsiness: drowsiness
drum: drum,drums
drumhead: drumhead
drunk: drunk
drunkard: drunkards
drunken: drunken
drunkenness: drunkenness
dry: dried,dry
dryly: dryly
du: du
duality: duality
dubious: dubious
duc: duc
ducatoon: ducatoon
duchess: duchess,duchesses
duchesse: duchesse
duchy: duchy
duel: duel,dueling,duels
duelist: duelist
duke: duke
dull: dull
dumas: dumas
dumb: dumb
dunce: dunce
dungeon: dungeon,dungeons
dupe: dupe,duped,dupes
duplicity: duplicity
durable: durable
duration: duration
dust: dust
dusty: dusty
duty: duties,duty
dwarf: dwarfs
dwell: dwell,dwelling,dwelt
dweller: dweller
dwelling: dwelling,dwellings
dwelt: dwelt
dying: dying
dyke: dyke
eager: eager
eagerly: eagerly
eagerness: eagerness
eagle: eagle
ear: ear,ears
earn: earned
earnest: earnest
earnestly: earnestly
earnestness: earnestness
earring: earrings
earth: earth
earthly: earthly
earthworm: earthworm
ease: ease
easily: easily
east: east
easy: easier,easiest,easy
eat: ate,eat,eaten,eating,eats
eating: eating
ebony: ebony
eccentric: eccentric
ecclesiastic: ecclesiastics
ecclesiastical: ecclesiastical
echelle: echelle
echo: echo
eclipse: eclipse
economy: economy
ecstasy: ecstasy
ecstatic: ecstatic
edge: edge
edict: edict,edicts
education: education
eel: eels
efface: efface,effaced
effective: effective
effectually: effectually
effervescence: effervescence
efficacious: efficacious
effort: effort,efforts
effrontery: effrontery
egg: eggs
egotistical: egotistical
eighteen: eighteen
eighteenth: eighteenth
eighth: eighth
eject: eject
el: el
elaboration: elaboration
elapse: elapsed
elated: elated
elbow: elbow,elbows
eld: elder,eldest
elder: elder
elderly: elderly
elect: elect
electrify: electrified
elegance: elegance
elegant: elegant
elevated: elevated
elongate: elongated
eloquence: eloquence
eloquent: eloquent
emanation: emanations
emancipate: emancipating
embargo: embargo
embark: embark,embarked
embarkation: embarkation
embarrass: embarrassed
embarrassed: embarrassed
embarrassing: embarrassing
embarrassment: embarrassment,embarrassments
embellishment: embellishments
emblazon: emblazoned
embolden: emboldened
emboss: embossed
embrace: embrace,embraced,embraces
embrasure: embrasure
embroider: embroidered
embroidery: embroideries,embroidery
embroil: embroil,embroiled
emerald: emerald,emeralds
eminence: eminence
eminently: eminently
emissary: emissaries,emissary
emit: emitted
emotion: emotion,emotions
emperor: emperor,emperors
emphasis: emphasis
emphasize: emphasized,emphasizing
emphatically: emphatically
empire: empire
employ: employ,employed,employing,employs
employment: employment
emulation: emulation
emulator: emulator
en: en
enable: enabled
enamel: enameled
enamoured: enamoured
enchant: enchanted
enchanted: enchanted
enchanting: enchanting
enchantment: enchantment,enchantments
enchantress: enchantress,enchantresses
encircle: encircled
enclose: enclose,enclosed
enclosure: enclosure
encounter: encounter,encountered,encounters
encourage: encourage,encouraged,encouraging
encouraged: encouraged
encouragement: encouragement
encrust: encrusted
encumber: encumber
endeavor: endeavor,endeavored,endeavoring,endeavors
endorse: endorsed
endow: endowed
endure: endure,endured
enemy: enemies,enemy
energetic: energetic
energy: energies,energy
enfants: enfants
engage: engage,engaged,engaging
engaged: engaged
engagement: engagement,engagements
engender: engender
engineer: engineers
england: england
english: english
englishman: englishman,englishmen
englishmen: englishmen
englishwoman: englishwoman
engrave: engrave,engraved
enigma: enigma
enjoin: enjoin
enjoy: enjoy,enjoyed,enjoying,enjoys
enjoyment: enjoyment
enlarge: enlarge,enlarging
enlighten: enlightened,enlightens
enlightened: enlightened
enliven: enlivened
enmity: enmities,enmity
ennui: ennui
enormous: enormous
enormously: enormously
enrage: enrage
enrol: enrolled
ensign: ensign
ensue: ensue
entail: entail
entangle: entangled
enter: enter,entered,entering,enters
entered: entered
enterprise: enterprise,enterprises
enterprising: enterprising
entertain: entertain,entertained,entertaining,entertains
entertainment: entertainment
enthusiasm: enthusiasm
enthusiast: enthusiasts
enthusiastically: enthusiastically
entire: entire
entrance: entrance
entreat: entreat,entreated
entrenchment: entrenchment
entrust: entrust
entry: entry
enumerate: enumerated,enumerating
envelop: enveloped
environs: environs
envoy: envoy
envy: envy
ephemeral: ephemeral
epidermis: epidermis
epilogue: epilogue
episode: episode
epistle: epistle
epithet: epithet
epoch: epoch
equal: equal,equals
equality: equality
equally: equally
equanimity: equanimity
equerry: equerry
equip: equip,equipped
equipage: equipage
equipment: equipment,equipments
equity: equity
era: era
erat: erat
erect: erect,erected
errand: errand
errant: errant
error: error
erudition: erudition
escalade: escalade
escape: escape,escaped,escapes,escaping
escort: escort,escorted
espouse: espoused
esquire: esquire
essay: essayed
essence: essence
essential: essential
est: est
establish: established,establishing
establishment: establishment,establishments
estate: estate,estates
esteem: esteem,esteemed
estimable: estimable
estimate: estimated
estimation: estimation
eternal: eternal
eternally: eternally
eternity: eternity
etiquette: etiquette
eulogium: eulogium
eulogy: eulogy
europe: europe
european: european
evacuate: evacuated
evade: evade,evaded
evaporate: evaporated
eve: eve
evening: evening,evenings
event: event,events
evidence: evidence
evident: evident
evidently: evidently
evil: evil
evince: evinced
exact: exact
exactness: exactness
exaggerate: exaggerate,exaggerated
exaggerated: exaggerated
exalt: exalted
examination: examination,examinations
examine: examine,examined,examining
exasperate: exasperate,exasperated
exasperated: exasperated
exasperation: exasperation
exceed: exceed,exceeded
exceedingly: exceedingly
excel: excelled
excellency: excellencies,excellency
excellent: excellent
exception: exception
excess: excess
excessive: excessive
excessively: excessively
exchange: exchange,exchanged,exchanging
excitation: excitation
excite: excite,excited,excites
excited: excited
excitement: excitement,excitements
exclaim: exclaimed,exclaiming
exclamation: exclamation
exclude: exclude
excursion: excursion,excursions
excuse: excuse,excused,excuses,excusing
execrate: execrate
execration: execration
execute: execute,executed,executing
execution: execution
executioner: executioner,executioners
exemplary: exemplary
exempt: exempt,exempted
exercise: exercise,exercised,exercises
exert: exert,exerted
exertion: exertion
exhale: exhaled
exhaust: exhaust,exhausted
exhausted: exhausted
exhibit: exhibited,exhibiting
exigency: exigencies
exile: exile,exiled,exiles
exist: exist,existed,exists
existence: existence,existences
exorcism: exorcisms
exordium: exordium
expansive: expansive
expatiate: expatiated
expatriate: expatriated
expect: expect,expected,expecting,expects
expectation: expectation,expectations
expedient: expedient
expedition: expedition,expeditions
expeditious: expeditious
expend: expend,expended
expense: expense,expenses
experience: experience,experienced,experiencing
experienced: experienced
experiment: experiment
experimental: experimental
expert: expert,experts
expiate: expiate
expiation: expiation
expiration: expiration
expire: expired
explain: explain,explained,explaining,explains
explanation: explanation,explanations
explanatory: explanatory
explicative: explicative
explicit: explicit
exploit: exploit
explosion: explosion
expose: expose,exposed,exposes
exposition: exposition
express: express,expressed,expressing
expression: expression,expressions
expressive: expressive
expressly: expressly
exquisite: exquisite
extend: extend,extended
extended: extended
extensive: extensive
extent: extent
exterior: exterior
exterminate: exterminate,exterminating
external: external
extinct: extinct
extinguish: extinguish,extinguished
extort: extorted
extortioner: extortioner
extra: extra
extraction: extraction
extraordinary: extraordinary
extravagance: extravagances
extravagant: extravagant
extreme: extreme
extremely: extremely
extremity: extremities,extremity
extricate: extricate,extricated,extricating
exultation: exultation
eye: eye,eyes
eyebrow: eyebrow,eyebrows
eyelash: eyelashes
eyelid: eyelids
eyetooth: eyetooth
fable: fable,fables
fabulous: fabulous
faculty: faculties,faculty
fade: faded
fagot: fagots
fail: fail,failed,failing,fails
failure: failure
faint: faint,fainted,fainter,fainting
fainting: fainting
faintly: faintly
faintness: faintness
fair: fair
faith: faith
faithful: faithful
faithfully: faithfully
faithless: faithless
falcon: falcon,falcons
falconer: falconers
falconry: falconry
fall: fall,fallen,falling,falls,fell
fallen: fallen
false: false
falsehood: falsehood
falter: faltered,faltering
familiar: familiar
familiarity: familiarity
familiarize: familiarized
familiarly: familiarly
family: families,family
famine: famine
famished: famished
famous: famous
famously: famously
fan: fan
fanatic: fanatic,fanatics
fanaticism: fanaticism
fancifully: fancifully
fancy: fancied,fancies,fancy
fantastic: fantastic
farcy: farcy
fare: fare,fares,faring
farewell: farewell
farmer: farmer
fascinate: fascinate,fascinated
fascinating: fascinating
fascination: fascination
fashion: fashion,fashions
fashionable: fashionable
fashioned: fashioned
fast: fast,faster,fasts
fasten: fasten,fastened,fastening
fastening: fastenings
fastidious: fastidious
fat: fat
fatal: fatal
fatality: fatalities,fatality
fate: fate
father: father,fathers
fathom: fathom
fatigue: fatigue,fatigues
fatigued: fatigued
fatuity: fatuity
faubourg: faubourg
faucet: faucet
fault: fault,faults
fauteuil: fauteuil
favor: favor,favored
favorable: favorable
favorably: favorably
favored: favored
favorite: favorite,favorites
fear: fear,feared,fearing,fears
fearful: fearful
fearfully: fearfully
feast: feast,feasts
feasting: feasting
feat: feats
feather: feather,feathers
feature: feature,features
fee: fee
feeble: feeble
feebly: feebly
feed: fed,feed
feeding: feeding
feel: feel,feeling,feels
feeling: feeling,feelings
feign: feigned,feigning
feigned: feigned
feint: feint,feints
felicitate: felicitating
felicitation: felicitations
felicity: felicity
fellow: fellow,fellows
fellowship: fellowship
felucca: feluccas
female: female
feminine: feminine
fence: fence,fenced
fencer: fencers
fencing: fencing
ferment: fermented,ferments
ferocious: ferocious
ferocity: ferocity
ferry: ferry
ferryman: ferryman
fervent: fervent
fervor: fervor
fester: fester
festival: festival
fetch: fetch
feud: feud
fever: fever
feverish: feverish
fickle: fickle
fiction: fiction
fictitious: fictitious
fidelis: fidelis
fidelity: fidelity
fie: fie
field: field,fields
fierce: fierce
fiercely: fiercely
fiery: fiery
fifteenth: fifteenth
fight: fight,fighting,fights,fought
fighting: fighting
figure: figure,figured,figures
filbert: filberts
file: file,filed
fillet: fillet
filthy: filthy
finally: finally
finances: finances
fine: fine,finer
finely: finely
fineness: fineness
finger: finger,fingers
finish: finish,finished,finishing
finished: finished
firebrand: firebrands
firm: firm
firmly: firmly
firmness: firmness
fish: fish
fisherman: fisherman,fishermen
fist: fist
fit: fit,fits,fitted
fixed: fixed
flag: flag,flags
flagon: flagon
flambeau: flambeau
flambeaux: flambeaux
flame: flame,flaming
flanders: flanders
flank: flanks
flap: flap
flash: flash,flashed,flashes,flashing
flask: flask,flasks
flat: flat,flatter
flatten: flattened
flatter: flattered
flattering: flattering
flattery: flattery
flee: fled,flee
fleet: fleet
fleeting: fleeting
flesh: flesh
fleshy: fleshy
fleur: fleur
flexible: flexible
flight: flight,flights
flinch: flinch
flirtation: flirtation
float: float,floated,floating
flock: flocked,flocking
floor: floor
florentine: florentine
flourish: flourish,flourished,flourishes
flow: flow,flowed,flowing
flower: flower,flowered,flowers
flush: flushed,flushing
flutelike: flutelike
fly: flew,flies,fly,flying
foam: foamed,foaming
fob: fob
focus: focus
fog: fog
foil: foiled,foils
fold: folded,folding,folds
foliage: foliage
folio: folio
folk: folks
follow: follow
follower: followers
folly: follies,folly
fond: fond
font: font
food: food
fool: fool,fools
foolhardy: foolhardy
foolish: foolish
foot: feet,foot
foothold: foothold
footing: footing
footman: footman
footstep: footstep,footsteps
forage: forages
forbearance: forbearance
forbid: forbade,forbid,forbidden,forbids
force: force,forced,forces
forcibly: forcibly
ford: forded
fore: fore
forefinger: forefinger
forehead: forehead
foreign: foreign
foreigner: foreigner,foreigners
foremost: foremost
foresee: foresee,foreseeing,foreseen
foresight: foresight
forest: forest
foretell: foretold
forewarn: forewarned
forfend: forfend
forge: forged
forger: forgers
forgery: forgery
forges: forges
forget: forget,forgets,forgetting,forgot,forgotten
forgetful: forgetful
forgetfulness: forgetfulness
fork: fork
forlorn: forlorn
form: form,formed,forming,forms
formality: formalities,formality
formation: formation
formidable: formidable
formidably: formidably
formula: formula
formulate: formulate
forsake: forsake,forsook
fort: fort
fortification: fortifications
fortify: fortify
fortis: fortis
fortnight: fortnight
fortunate: fortunate
fortunately: fortunately
fortune: fortune,fortunes
foster: fostered
foul: foul
foundation: foundation
fountain: fountain
fourteen: fourteen
fourth: fourth
fowl: fowl,fowling
fox: fox
fragile: fragile
fragility: fragility
fragment: fragments
frail: frail
frame: frame,framed
franc: francs
france: france
francis: francis
frank: frank
frankly: frankly
frankness: frankness
frantic: frantic
fraternal: fraternal
fraternize: fraternize,fraternizes
fray: frayed
freed: freed
freedom: freedom
freely: freely
freeze: frozen
french: french
frenchman: frenchman,frenchmen
frenchmen: frenchmen
frenchwoman: frenchwoman
frequency: frequency
frequent: frequent,frequented
frequenter: frequenters
frequently: frequently
fresh: fresh
freshness: freshness
fricandeau: fricandeau
friday: friday
friend: friend,friends
friendly: friendly
friendship: friendship,friendships
fright: fright
frighten: frighten,frightened,frightens
frightened: frightened
frightful: frightful
frightfully: frightfully
frigidly: frigidly
fringe: fringe
frock: frock
frontier: frontiers
frown: frown,frowned,frowning
frugal: frugal
fruit: fruit,fruits
fruitful: fruitful
fruitless: fruitless
fugitive: fugitive,fugitives
fulfil: fulfilling
fulfill: fulfill
function: functions
functionary: functionary
fund: fund,funds
fundamental: fundamental
funeral: funeral
funereal: funereal
furious: furious
furlough: furlough,furloughs
furnace: furnace
furnish: furnish,furnished,furnishes
furnished: furnished
furniture: furniture
furrow: furrowed
furtive: furtive
furtively: furtively
fury: furies,fury
fusillade: fusillade
future: future
gad: gad,gadding
gag: gag,gagged
gaiety: gaiety
gaily: gaily
gain: gain,gained,gaining,gains
gait: gait
gala: gala
gallant: gallant
gallantly: gallantly
gallantry: gallantries,gallantry
gallery: gallery
gallop: gallop,galloped,galloping
gallows: gallows
gambler: gambler
game: game
gamekeeper: gamekeeper
gaming: gaming
gamut: gamut
gape: gaping
gaper: gapers
garden: garden,gardens
gardener: gardener
garlic: garlic
garment: garments
garnish: garnished
garret: garret
garrison: garrison
gascon: gascon,gascons
gasconade: gasconade
gastronomic: gastronomic
gastronomy: gastronomy
gate: gate,gates
gatekeeper: gatekeepers
gateway: gateway,gateways
gather: gather,gathered,gathers
gay: gay
gaze: gaze,gazed,gazing
gem: gem
gendarme: gendarme
genealogical: genealogical
genealogy: genealogy
generosity: generosity
generous: generous
generously: generously
genet: genet
genius: genius,geniuses
genteelly: genteelly
gentiles: gentiles
gentle: gentle
gentleman: gentleman,gentlemen
gentlemanly: gentlemanly
gently: gently
genuine: genuine
george: george
gerfalcon: gerfalcon
germain: germain
german: german,germans
gervais: gervais
gesture: gesture,gestures
ghastly: ghastly
ghost: ghost,ghosts
giant: giant,giants
giddy: giddy
gift: gift,gifts
gigantic: gigantic
gild: gilds
gilded: gilded
gilt: gilt
gin: gins
gird: girded
girdle: girdle
girl: girl
giver: giver
glad: glad
glance: glance,glanced,glances,glancing
glander: glanders
glandered: glandered
glare: glared
glass: glass,glasses
glassy: glassy
glazed: glazed
gleam: gleamed
glide: glide,glided,gliding
glimmer: glimmer
glimpse: glimpse
glitter: glitter,glittered,glittering,glitters
globe: globe
gloom: gloom
gloomy: gloomy
glorify: glorifying
glorious: glorious
glory: glory
gloss: gloss,glosses
glove: glove,gloves
glow: glow
glue: glued
gnaw: gnawed,gnawing
goal: goal
goat: goat,goats
god: god,gods
goddaughter: goddaughter
goddess: goddess
godfather: godfather
godsend: godsend
gold: gold
golden: golden
goldsmith: goldsmith
goldwork: goldwork
goodness: goodness
goose: goose
gore: gore
gospel: gospel
gossip: gossip
gourmand: gourmands
govern: governed
government: government
governor: governor
gown: gown,gowns
gownsman: gownsmen
grace: grace,graces
graceful: graceful
gracefully: gracefully
gracious: gracious
graciously: graciously
grain: grain
grand: grand
grandee: grandee
grandeur: grandeur
grandfather: grandfather
grandly: grandly
grands: grands
granite: granite
grant: grant,granted,granting
grape: grape
grasp: grasp,grasped
grass: grass
grate: grating
grateful: grateful
gratification: gratification
gratify: gratify
grating: gratings
gratitude: gratitude
grave: grave
gravel: gravel
gravely: gravely
gravity: gravity
gray: gray
graze: grazed
grazing: grazing
grease: grease
greasy: greasy
greatly: greatly
greatness: greatness
greedily: greedily
greedy: greedy
greek: greeks
green: green
greet: greet,greeted
grief: grief,griefs
grievously: grievously
grimace: grimace
grin: grin,grinned,grinning
grind: grinding,ground
gris: gris
grisette: grisette
groan: groan,groaned,groaning,groans
groaning: groaning
grocer: grocer
groom: groom,grooming,grooms
gross: gross,grossest
ground: ground
grow: grew,grow,growing,grows
growl: growl,growled,growls
grown: grown
grumble: grumbled,grumbling
grumblingly: grumblingly
guarantee: guarantee,guarantees
guard: guard,guarded,guards
guardian: guardian
guardianship: guardianship
guardroom: guardroom
guards: guards
guardsman: guardsman,guardsmen
guardsmen: guardsmen
guess: guess,guessed,guessing
guest: guest,guests
guide: guide,guided
guilty: guilty
guise: guise
gule: gules
gull: gull
gulliver: gulliver
gun: gun,guns
gunshot: gunshot
ha: ha
haberdasher: haberdasher
haberdashery: haberdashery
habit: habit,habits
habitual: habitual
habitually: habitually
haft: haft
hail: hail,hailed
hair: hair,hairs
hall: hall
halloo: halloo
hallucination: hallucination
halo: halo
halt: halt,halted,halts
halted: halted
halter: halter
ham: ham,hams
hammer: hammer
hamper: hamper
hand: hand,handed,handing,hands
handed: handed
handful: handful
handkerchief: handkerchief,handkerchiefs
handle: handle,handles
handsome: handsome,handsomest
handsomely: handsomely
handwriting: handwriting
handy: handy
hang: hang,hanged,hanging,hangs,hung
hanging: hanging
hangman: hangman,hangmen
happen: happen,happened,happening
happily: happily
happiness: happiness
happy: happier,happiest,happy
harangue: harangued
harbor: harbor
hard: hard,harder
hare: hare
haricot: haricot
hark: hark
harm: harm
harmless: harmless
harmonious: harmonious
harmoniously: harmoniously
harmony: harmony
harness: harness,harnessed,harnesses
harrow: harrow
harsh: harshest
harshly: harshly
harshness: harshness
hart: hart
hast: hast
haste: haste
hasten: hasten,hastened,hastening
hastily: hastily
hasty: hasty
hat: hat,hats
hate: hate,hated,hates
hatefully: hatefully
hatred: hatred,hatreds
haughtily: haughtily
haughty: haughty
haunt: haunting
haunting: haunting
hauteur: hauteur
hawk: hawk,hawking,hawks
hazard: hazarded,hazards
hazardous: hazardous
haze: haze
head: head,headed,heads
headed: headed
headlong: headlong
headsman: headsman
headstrong: headstrong
heal: healed
health: health,healths
healthy: healthy
heap: heap,heaped
hear: hear,heard,hearing,hears
hearer: hearers
hearing: hearing
heart: heart,hearts
heartbreaking: heartbreaking
heartbroken: heartbroken
hearted: hearted
hearth: hearth
heartily: heartily
heartrending: heartrending
hearty: hearty
heat: heat,heated
heath: heath
heave: heaved
heaven: heaven,heavens
heavenly: heavenly
heavily: heavily
heaving: heaving
heavy: heavy
hebrews: hebrews
hectic: hectic
hedge: hedge,hedges
heed: heed,heeded
heedless: heedless
heel: heel,heels
height: height
heighten: heightened
hein: hein
heir: heir
helm: helm
helpless: helpless
hem: hem
henceforth: henceforth
henceforward: henceforward
henry: henry
heraldry: heraldry
herb: herbs
herculean: herculean
heresiarch: heresiarch
heresy: heresies,heresy
heretic: heretics
hermetically: hermetically
hero: hero,heroes
heroic: heroic
heroically: heroically
heron: heron
hesitate: hesitate,hesitated,hesitates,hesitating
hesitatingly: hesitatingly
hesitation: hesitation
hey: hey
heyday: heyday
hide: hidden,hide,hides,hiding
hideous: hideous
hiding: hiding
hierarchy: hierarchy
highly: highly
highness: highness
highway: highway
hilarity: hilarity
hill: hill,hills
hilt: hilt,hilts
hinder: hinder
hinge: hinges
hint: hint,hinted,hints
hip: hip,hipped
hippolytus: hippolytus
hire: hired
hissing: hissing
historian: historian
historical: historical
history: history
hit: hit,hitting
hitherto: hitherto
hoarse: hoarse
hobble: hobble
hobnob: hobnob
hola: hola
hold: held,hold,holding,holds
hole: hole,holes
holiness: holiness
holland: holland
holloa: holloa
hollow: hollow
holofernes: holofernes
holster: holsters
holy: holy
homeward: homeward
homicidal: homicidal
homicide: homicide
honest: honest
honey: honey
honor: honor,honored,honors
honorable: honorable
honorably: honorably
hood: hood
hoof: hoofs
hooked: hooked
hooting: hooting
hope: hope,hoped,hopes,hoping
horizon: horizon
horn: horn
horrible: horrible
horribly: horribly
horrid: horrid
horror: horror,horrors
hors: hors
horse: horse,horses
horseback: horseback
horseflesh: horseflesh
horseman: horseman,horsemen
horsemanship: horsemanship
hose: hose
hospitality: hospitality
host: host
hostage: hostage
hostel: hostel
hostelry: hostelry
hostess: hostess
hostility: hostilities,hostility
hostler: hostler
hot: hot
hounds: hounds
hour: hour,hours
hourly: hourly
house: house,houses
household: household
housekeeping: housekeeping
houses: houses
housewife: housewife
housing: housing
hover: hovered,hovering
howl: howl,howled,howling
hubbub: hubbub
hue: hue
huguenot: huguenot
huguenots: huguenots
hullabaloo: hullabaloo
hum: hum
human: human
humane: humane
humanity: humanity
humble: humble,humbled
humbly: humbly
humid: humid
humiliate: humiliate,humiliated,humiliating
humiliating: humiliating
humiliation: humiliation,humiliations
humility: humility
humor: humor
humph: humph
hunger: hunger
hungry: hungry
hunt: hunt,hunting
hunter: hunter
hunting: hunting
huntress: huntress
hurl: hurled,hurling
hurrah: hurrah
hurricane: hurricane
hurry: hurried,hurry
hurt: hurt
husband: husband
hush: hush,hushed
hussy: hussy
hut: hut
hypocrisy: hypocrisy
hypocrite: hypocrite
hypocritical: hypocritical
ice: ice
icy: icy
idea: idea,ideas
ideal: ideal
idem: idem
identify: identified
identity: identity
idiot: idiot
idle: idle
ignominy: ignominy
ignorance: ignorance
ignorant: ignorant
iii: iii
iliad: iliad
illness: illness
illuminate: illuminated
illumine: illumined
illusion: illusion,illusions
illustrious: illustrious
image: image,images
imaginable: imaginable
imaginary: imaginary
imagination: imagination
imagine: imagine,imagined,imagining
imbecile: imbecile,imbeciles
imbecility: imbecility
imitate: imitate,imitated,imitating
immaculate: immaculate
immense: immense
immensely: immensely
immensity: immensity
immoderate: immoderate
immodesty: immodesty
immovable: immovable
impar: impar
impart: impart,imparted,imparting
impartial: impartial
impartially: impartially
impassibility: impassibility
impassive: impassive
impassiveness: impassiveness
impassivity: impassivity
impatience: impatience
impatient: impatient
impatiently: impatiently
impediment: impediment,impediments
impel: impelled,impels
impend: impending
impenetrable: impenetrable
imperative: imperative
imperceptible: imperceptible
imperceptibly: imperceptibly
imperial: imperial
imperious: imperious
imperiously: imperiously
impertinent: impertinent
imperturbable: imperturbable
impetuous: impetuous
impious: impious
implacable: implacable
implant: implanted
implicit: implicit
implore: implore,implored,imploring
impolitic: impolitic
importunate: importunate
impose: impose,imposed,imposing
imposing: imposing
impossibility: impossibilities
impossible: impossible
impotent: impotent
impracticable: impracticable
imprecation: imprecations
impregnable: impregnable
imprescriptible: imprescriptible
impress: impress,impressed
impressed: impressed
impression: impression,impressions
imprint: imprinted
imprison: imprison,imprisoned
imprisonment: imprisonment
improbable: improbable
improper: improper
improvise: improvised
imprudence: imprudence
imprudent: imprudent
imprudently: imprudently
impulse: impulse
impunity: impunity
imputed: imputed
inaccessible: inaccessible
inamorata: inamorata
inarticulate: inarticulate
inauspicious: inauspicious
incapable: incapable
incarceration: incarceration
incense: incense
incertainty: incertainty
incessantly: incessantly
inch: inches
incident: incidents
incitement: incitement
inclination: inclination
incline: incline,inclined,inclining
inclined: inclined
include: include,included
incognito: incognito
incoherence: incoherence
income: income
incommode: incommoded
incommoding: incommoding
incomparable: incomparable
inconceivable: inconceivable
incongruity: incongruities
inconsiderate: inconsiderate
inconstant: inconstant
incontestable: incontestable
inconvenience: inconvenience,inconvenienced
inconvenient: inconvenient
incorrectly: incorrectly
incorrigible: incorrigible
increase: increase,increased,increasing
incredible: incredible
incredulity: incredulity
incredulous: incredulous
inculcate: inculcated
inculpate: inculpated
incur: incur,incurred
indebted: indebted
indecent: indecent
indecision: indecision
indefinable: indefinable
indelible: indelible
indelicacy: indelicacy
indemnification: indemnification
indemnify: indemnified
independence: independence
indescribable: indescribable
india: india
indian: indian
indifference: indifference
indifferent: indifferent
indignation: indignation
indignity: indignity
indiscreet: indiscreet
indiscretion: indiscretion
indispensable: indispensable
indispose: indisposed
indisposed: indisposed
indistinct: indistinct
individual: individual,individuals
indubitably: indubitably
induce: induce,induced,inducing
induction: induction
indulge: indulging
indulgence: indulgence
indulgent: indulgent
ineffaceable: ineffaceable
inert: inert
inevitable: inevitable
inevitably: inevitably
inexorable: inexorable
inexperience: inexperience
inexpressible: inexpressible
inextinguishable: inextinguishable
infallibility: infallibility
infallible: infallible
infamous: infamous
infamously: infamously
infamy: infamy
infanta: infanta
infer: inferred
inferior: inferior,inferiors
infernal: infernal
infidelity: infidelities,infidelity
infinite: infinite
infinitely: infinitely
inflame: inflamed
inflamed: inflamed
inflexible: inflexible
inflict: inflict,inflicted
influence: influence,influenced
inform: inform,informed,informing
informed: informed
infraction: infraction
infuse: infuse
ingenious: ingenious
ingenuous: ingenuous
ingenuousness: ingenuousness
ingrate: ingrate
ingratitude: ingratitude
ingredient: ingredients
inhabit: inhabited
inhabitant: inhabitant,inhabitants
inhale: inhale
inherit: inherit,inherited
inheritance: inheritance
iniquitous: iniquitous
iniquity: iniquities
initial: initials
initiate: initiated
injunction: injunction
injure: injure,injured,injures,injuring
injured: injured
injurious: injurious
injury: injury
injustice: injustice
ink: ink
inlaid: inlaid
inlay: inlaid
inn: inn,inns
innkeeper: innkeeper,innkeepers
innocence: innocence
innocent: innocent
innocently: innocently
inquietude: inquietude
inquire: inquire,inquired,inquiring
inquiringly: inquiringly
inquiry: inquiries,inquiry
inquisition: inquisition
inquisitive: inquisitive
inquisitor: inquisitors
insane: insane
insanity: insanity
inscriptions: inscriptions
insensate: insensate
insensibility: insensibility
insensible: insensible
insensibly: insensibly
inseparables: inseparables
insight: insight
insinuate: insinuate,insinuated
insinuating: insinuating
insinuation: insinuation,insinuations
insist: insist,insisted,insists
insistence: insistence
insolence: insolence
insolent: insolent
inspection: inspection
inspiration: inspirations
inspire: inspire,inspired,inspires,inspiring
install: installed
instance: instance,instances
instant: instant,instants
instantaneously: instantaneously
instantly: instantly
instigation: instigation
instinct: instinct,instincts
instinctive: instinctive
instinctively: instinctively
instruct: instruct,instructed
instruction: instructions
instructive: instructive
instrument: instrument,instruments
insufficient: insufficient
insult: insult,insulted,insults
insulting: insulting
insupportable: insupportable
insupportably: insupportably
intact: intact
intellectual: intellectual
intelligence: intelligence
intelligent: intelligent
intend: intend,intended,intends
intense: intense
intensely: intensely
intention: intention,intentions
intentionally: intentionally
intently: intently
inter: inter,interred
intercede: intercede
intercept: intercept
interception: interception
interdict: interdicted
interfere: interfere
interference: interference
interior: interior
interlocutor: interlocutor,interlocutors
interminable: interminable
interpose: interposed
interpret: interpret,interpreted,interpreting
interrogate: interrogate,interrogated,interrogates,interrogating
interrogation: interrogation
interrogator: interrogator
interrogatory: interrogatories,interrogatory
interrupt: interrupt,interrupted,interrupting
interrupted: interrupted
interruption: interruption
interstice: interstices
interval: interval,intervals
intervene: intervening
interview: interview
intimacy: intimacy
intimate: intimate,intimated,intimates
intimately: intimately
intimidate: intimidate,intimidated
intimidation: intimidation
intonation: intonation
intoxicate: intoxicated
intoxicated: intoxicated
intoxication: intoxication
intrepid: intrepid
intrepidity: intrepidity
intricate: intricate
intrigante: intrigante
intrigue: intrigue,intrigues
intriguer: intriguers
introduce: introduce,introduced
introduction: introduction
intruder: intruder,intruders
intrusion: intrusion
intuition: intuition
inutile: inutile
invade: invade,invaded
invalid: invalids
invaluable: invaluable
invent: invent,invented
inventive: inventive
inventiveness: inventiveness
invest: invested
investigate: investigating
investigation: investigation,investigations
investigator: investigator
inveterate: inveterate
invigorate: invigorating
invincible: invincible
invincibly: invincibly
invisible: invisible
invitation: invitation
invite: invite,invited,inviting
invoke: invoke,invoking
involuntarily: involuntarily
involuntary: involuntary
involve: involving
inwardly: inwardly
irascibility: irascibility
ire: ire
irishman: irishman
iron: iron,irons
ironical: ironical
ironically: ironically
irony: irony
irreproachable: irreproachable
irresistible: irresistible
irresolution: irresolution
irrevocable: irrevocable
irrevocably: irrevocably
irritate: irritate
irritated: irritated
irritation: irritations
island: island,islands
isle: isle
isolate: isolated
isolated: isolated
isolation: isolation
issue: issue,issued,issuing
italian: italian
italy: italy
iv: iv
ivory: ivory
ix: ix
jack: jack
jackanapes: jackanapes
jackson: jackson
jacques: jacques
jailer: jailer,jailers
james: james
jar: jar
jauntily: jauntily
jaw: jaw,jaws
jealous: jealous
jealousy: jealousy
jean: jean
jeer: jeer,jeered,jeering
jeering: jeering
jeopardy: jeopardy
jerusalem: jerusalem
jest: jest,jested,jests
jester: jester
jesting: jesting
jesuit: jesuit
jesuits: jesuits
jesus: jesus
jet: jet
jetty: jetty
jew: jew
jewel: jewel,jewels
jeweler: jeweler
jewess: jewess
jingle: jingled,jingling
joan: joan
job: job
jocular: jocular
john: john
joint: joint
joist: joists
joke: joke,jokes,joking
joker: joker
jolly: jolly
joseph: joseph
journal: journal
journey: journey,journeyed,journeys
journeys: journeys
jours: jours
joy: joy,joys
joyful: joyful
joyous: joyous
jubilation: jubilation
judas: judas
judge: judge,judged,judges
judgment: judgment
judicial: judicial
judicious: judicious
judith: judith
jug: jug
july: july
jump: jump,jumped
jumping: jumping
juncture: juncture
june: june
jupiter: jupiter
justice: justice
justification: justification
justify: justified,justify
justly: justly
justness: justness
juvenile: juvenile
keen: keen
keeper: keeper
keepsake: keepsake
kerchief: kerchief
key: key
keyhole: keyhole
kick: kick,kicking
kickshaw: kickshaw
kidney: kidney
kill: kill,killed,killing,kills
kindle: kindle,kindled
kindly: kindly
kindness: kindness,kindnesses
king: king,kings
kingdom: kingdom,kingdoms
kiss: kiss,kissed,kisses,kissing
kitchen: kitchen,kitchens
kitty: kitty
knee: knee,knees
kneel: kneeling,knelt
knife: knife
knight: knight,knights
knightly: knightly
knit: knit,knitted,knitting
knob: knob
knock: knock,knocked,knocking
knocker: knocker
knot: knotted
knowingly: knowingly
knowledge: knowledge
labor: labors
laboratory: laboratory
laborer: laborers
labyrinth: labyrinths
lace: lace,laced,laces
laced: laced
lack: lack,lacked
lackey: lackey,lackeys
laconic: laconic
lad: lad,lads
ladder: ladder
lady: ladies,lady
ladyship: ladyship
lamb: lamb,lambs
lamentable: lamentable
lamentation: lamentations
lamp: lamp,lamps
lance: lances
land: land,landed,landing
landing: landing,landings
landlord: landlord
landscape: landscapes
lane: lane
language: language
languidly: languidly
languish: languishing
languor: languor
lanky: lanky
lansquenet: lansquenet
lantern: lanterns
lapse: lapse
larded: larded
larding: larding
lass: lass
lasso: lasso
lastly: lastly
late: late
lath: laths
latin: latin
laud: lauds
laugh: laugh,laughed,laughing,laughs
laughable: laughable
laughter: laughter
launch: launched
laundress: laundress
law: law,laws
lawsuit: lawsuits
lawyer: lawyer
lax: lax
lay: laid,lay,laying,lays
le: le
lead: lead,leading,leads,led
leader: leader,leaders
leaf: leaves
league: league,leagues
lean: lean,leaned,leaning
leap: leap,leaped
learn: learn,learned,learning,learns
learning: learning
leather: leather
leave: leave,leaves,leaving,left
leaven: leaven
lees: lees
left: left
leg: leg,legs
legend: legends
legion: legion
legitimate: legitimate
leisure: leisure
lend: lend,lends,lent
lending: lending
les: les
lessen: lessened
lesson: lesson,lessons
letter: letter,letters
leu: leu
levee: levees
level: leveled
leveling: leveling
lever: lever
levy: levied
liar: liar
liberal: liberal
liberality: liberality
liberally: liberally
liberate: liberated
liberation: liberation
liberator: liberator
libertine: libertine
liberty: liberty
library: library
license: license
lid: lids
lie: lie,lied,lies,lying
lieutenancy: lieutenancy
lieutenant: lieutenant
life: life,lives
lift: lift,lifted,lifting
light: light,lighted,lighter,lightest,lights,lit
lighted: lighted
lighten: lighten,lightened
lightly: lightly
lightness: lightness
lightning: lightning
likeness: likenesses
liking: liking
lily: lily
limb: limbs
limit: limit,limits
limp: limping
linden: linden
linen: linen
lining: lining
lint: lint
lion: lion,lions
lioness: lioness
lip: lip,lips
liquid: liquid
liquor: liquor
list: list
listen: listen,listened,listening
listener: listener
listening: listening
literally: literally
literature: literature
litter: littered
liv: liv
live: live,lived,lives,living
lively: liveliest,lively
livery: liveries,livery
livid: livid
living: living
livre: livre,livres
lizard: lizards
load: load,loaded,loading
loadstone: loadstone
loaf: loaf,loaves
loan: loan
locality: locality
lock: lock,locked
lodge: lodge,lodged,lodges
lodger: lodger
lodging: lodging
lodgings: lodgings
lofty: loftier,lofty
log: log
logbook: logbook
loin: loins
london: london
lonely: lonely
lookout: lookout
loophole: loophole,loopholes
loose: loose,loosed,loosing
loosen: loosen,loosened,loosening
looseness: looseness
lord: lord,lords
lordly: lordly
lordship: lordship
lorraine: lorraine
lose: lose,losing,lost
loss: loss
lost: lost
lot: lot,lots
lottery: lottery
loud: loud,louder
loudly: loudly
loudness: loudness
louis: louis
louvre: louvre
love: love,loved,loves,loving
lovely: lovely
lover: lover,lovers
loving: loving
lowly: lowly
loyal: loyal
loyally: loyally
loyalty: loyalty
lucid: lucid
luck: luck
luckily: luckily
lucky: lucky
lucretia: lucretia
luggage: luggage
lugubrious: lugubrious
lull: lull
luminous: luminous
lung: lungs
lunge: lunge
luster: luster
luxembourg: luxembourg
luxury: luxuries,luxury
lx: lx
lynx: lynx
lys: lys
macbeth: macbeth
machination: machination,machinations
machine: machine
mad: mad
madame: madame
madcap: madcap
mademoiselle: mademoiselle
madhouse: madhouse
madman: madman,madmen
madmen: madmen
madness: madness
madrid: madrid
magdalens: magdalens
magic: magic
magisterial: magisterial
magistracy: magistracy
magnanimity: magnanimity
magnetic: magnetic
magnificence: magnificence
magnificent: magnificent
magnifying: magnifying
magpie: magpie
maid: maid
mail: mail
main: main
mainspring: mainspring
maintain: maintain,maintained,maintaining
majestic: majestic
majestically: majestically
majesties: majesties
majesty: majesties,majesty
major: major
majority: majority
maladroit: maladroit
maladroitly: maladroitly
malady: malady
malaga: malaga
malcontent: malcontent,malcontents
malefactor: malefactor
malice: malice
maliciously: maliciously
maltreat: maltreat,maltreated
manage: manage,managed
manager: managers
manchester: manchester
mane: mane
maneuver: maneuver,maneuvered,maneuvers
manger: manger
mania: mania
maniac: maniac
maniacal: maniacal
manifest: manifested
manifestation: manifestation
manlike: manlike
manner: manner
manners: manners
mansion: mansion
mantelpiece: mantelpiece
mantle: mantle
mantua: mantua
manual: manual
manus: manus
manuscript: manuscript
map: map
mar: marring
marble: marble,marbled
march: march,marched,marches,marching
marchioness: marchioness,marchionesses
marie: marie
marine: marine,marines
marion: marion
mark: mark,marked,marks
marked: marked
market: market
marksman: marksmen
marque: marque
marquis: marquis
marriage: marriage
marrow: marrow
marry: married,marry,marrying
marsh: marshes
marshal: marshals
martial: martial
martin: martin
martingale: martingale
martyr: martyr,martyrs
martyrdom: martyrdom
marvelous: marvelous
marvelously: marvelously
mask: mask,masked,masks
masquerade: masquerade
mass: mass,masses
massacre: massacre
masses: masses
massive: massive
mast: mast,masts
master: master,masters
masthead: masthead
match: match
mate: mate
material: material
matins: matins
matter: matter,matters
mattock: mattocks
mattress: mattress
maxillary: maxillary
maxim: maxim,maxims
mayor: mayor
maze: maze
mea: mea
meal: meal,meals
meaning: meaning
meanness: meanness
measure: measure,measures
meat: meat,meats
mechanically: mechanically
mecum: mecum
meddle: meddle,meddling
meditate: meditated,meditating
meditation: meditation,meditations
medusa: medusa
meek: meek
meekness: meekness
meet: meet,meeting,meets,met
meeting: meeting
melancholy: melancholy
melodious: melodious
melt: melt
memoirs: memoirs
memorial: memorial
memory: memory
menace: menace,menaces
menaced: menaced
menacing: menacing
menacingly: menacingly
mend: mend
mendicant: mendicant,mendicants
mental: mental
mentally: mentally
mention: mention,mentioned
mercer: mercer
merchant: merchant,merchants
merchantman: merchantmen
merciful: merciful
merciless: merciless
mercy: mercy
mere: mere
merit: merit,merited,merits
meritorious: meritorious
merry: merry
mesh: meshes
mess: mess
message: message,messages
messenger: messenger,messengers
messiah: messiah
messieurs: messieurs
metal: metal
metaphysics: metaphysics
method: method
mexico: mexico
michel: michel
midday: midday
middle: middle
midi: midi
midnight: midnight
midst: midst
mien: mien
milady: milady
mild: mild,milder
mildness: mildness
mile: miles
milestone: milestones
militant: militant
military: military
miller: miller
millionaire: millionaire
mind: mind,minds
minded: minded
minerva: minerva
mingle: mingle,mingled,mingling
mining: mining
minion: minions
minister: minister,ministers
minute: minute,minutes,minutest
minuteness: minuteness
minx: minxes
miracle: miracle,miracles
miraculous: miraculous
mirror: mirror
mirth: mirth
misadventure: misadventure
misanthropic: misanthropic
misanthropy: misanthropy
mischance: mischance
mischief: mischief
miserable: miserable
misery: miseries,misery
misfortune: misfortune,misfortunes
misgiving: misgivings
mislead: mislead
missal: missal
mission: mission
missive: missive
mist: mist
mistake: mistake,mistaken,mistakes,mistaking
mistaken: mistaken
mistress: mistress,mistresses
mistrust: mistrust,mistrusted,mistrusts
mistrustful: mistrustful
misunderstand: misunderstand,misunderstood
mix: mixed
mixed: mixed
mixture: mixture
moan: moan,moaning,moans
mobile: mobile
mobility: mobility
mode: mode
model: model,modeled
moderate: moderated
moderately: moderately
moderation: moderation
modern: modern
modest: modest
modestly: modestly
modesty: modesty
modulation: modulations
mogul: mogul
mohammed: mohammed
moist: moist
moisten: moistened
mold: molds
molding: moldings
molten: molten
moment: moment,moments
momentary: momentary
monastery: monastery
monastic: monastic
monday: monday
money: money
moneybag: moneybag
monk: monk,monks
monkey: monkey
monotonous: monotonous
monseigneur: monseigneur
monsieur: monsieur
monster: monster,monsters
monstrous: monstrous
montague: montague
month: month,months
montmorency: montmorency
mood: mood
moon: moon
moonbeam: moonbeam
moonlight: moonlight
moral: moral,morals
moralist: moralist
morality: morality
moralizing: moralizing
morally: morally
morbleu: morbleu
mordieu: mordieu
morning: morning
morrow: morrow
morsel: morsel
mortal: mortal
mortar: mortar
mortification: mortification
mortify: mortify
morts: morts
mortuary: mortuary
moses: moses
mother: mother
motion: motion,motions
motionless: motionless
motive: motive,motives
motto: motto
mount: mount,mounted,mounting
mountain: mountain,mountains
mouse: mice,mouse
mousetrap: mousetrap,mousetraps
moustache: moustache
mouth: mouth,mouths
mouthful: mouthfuls
movement: movement,movements
mud: mud
muddy: muddy
muffle: muffled
mule: mule,mules
multiply: multiplied
mumble: mumbled
mundane: mundane
murder: murder,murdered
murderer: murderer
murderous: murderous
murmur: murmur,murmured,murmuring,murmurs
muscle: muscles
musingly: musingly
musket: musket,muskets
musketeer: musketeer,musketeers
musketeers: musketeers
musketoon: musketoon
mustache: mustache
muster: mustered
mute: mute
mutineer: mutineers
mutiny: mutiny
mutter: muttering
muttering: muttering
mutton: mutton
mutual: mutual
muzzle: muzzle
mysterious: mysterious
mystery: mysteries,mystery
mystical: mystical
mystification: mystification
mystifier: mystifier
mystify: mystified,mystifying
mythological: mythological
nag: nag,nags
nail: nail,nailed,nailing,nails
naked: naked
nameless: nameless
napkin: napkin,napkins
napless: napless
narcissus: narcissus
narcotic: narcotic
narration: narrations
narrative: narrative
narrator: narrator
narrow: narrow
narrowly: narrowly
nation: nation,nations
national: national
native: native,natives
natural: natural
naturally: naturally
nature: nature,natures
natured: natured
nauseous: nauseous
naval: naval
nave: nave
navigation: navigation
navigator: navigator
navy: navy
nearer: nearer
neatness: neatness
necessitate: necessitate
necessity: necessity
neck: neck,necks
necklace: necklace
needful: needful
needless: needless
needlessly: needlessly
negative: negative
negatively: negatively
neglect: neglect,neglected,neglects
negligence: negligence
negligently: negligently
negotiation: negotiation,negotiations
negotiator: negotiator
negro: negro
neigh: neighed,neighing
neighbor: neighbor,neighboring,neighbors
neighborhood: neighborhood
neighboring: neighboring
neighbourhood: neighbourhood
nerve: nerved
nervous: nervous
nest: nest
nestor: nestor
network: network
neutral: neutral
newcomer: newcomer
newly: newly
news: news
nice: nice
nicely: nicely
nicety: niceties,nicety
niche: niche
nick: nick
niece: niece
night: night,nights
nightcap: nightcap
nightmare: nightmare
nimble: nimble
nimbly: nimbly
nineteen: nineteen
ninny: ninny
nobility: nobility
noble: noble,nobler,nobles
nobleman: nobleman
nobly: nobly
nocturnal: nocturnal
nod: nod,nodded,nodding
noise: noise
noisy: noisy
nonsense: nonsense
noon: noon
noose: noose,nooses
norman: norman,normans
north: north
nose: nose,noses
nostril: nostrils
note: note,notes
noteworthy: noteworthy
notice: notice,noticed
notify: notified,notify
notre: notre
noun: noun
nourish: nourish
nourishment: nourishment
november: november
novice: novice,novices
novitiate: novitiate
nowadays: nowadays
numerical: numerical
numerous: numerous
nun: nun,nuns
nuptial: nuptial
nurse: nurse
nut: nut
oak: oak
oar: oars
oath: oath,oaths
obedience: obedience
obedient: obedient
obey: obey,obeyed,obeying
object: object,objected,objects
objection: objection
obligation: obligation
obligatory: obligatory
oblige: obliged,obliging
obliged: obliged
oblong: oblong
obolus: obolus
obscure: obscure
obscurely: obscurely
obscurity: obscurity
observable: observable
observance: observances
observant: observant
observation: observation
observatory: observatory
observe: observe,observed,observing
observer: observer,observers
obstacle: obstacle,obstacles
obstinacy: obstinacy
obstinate: obstinate
occasion: occasion,occasions
occasionally: occasionally
occupation: occupation,occupations
occupy: occupied,occupy,occupying
occur: occur,occurred,occurs
ocean: ocean
october: october
odd: odd
oddly: oddly
odious: odious
odor: odor
odoriferous: odoriferous
offend: offended
offended: offended
offense: offense
offensive: offensive
offer: offer,offered,offering,offers
offering: offering
office: office,offices
officer: officer,officers
official: official,officials
offshore: offshore
offspring: offspring
ogle: ogle
ogre: ogres
oil: oil
olive: olive
olympian: olympian
omelet: omelet
omer: omer
omission: omission
omit: omitting
omni: omni
onshore: onshore
opal: opal
opaque: opaque
ope: ope
openly: openly
operate: operated
operation: operation,operations
opinion: opinion,opinions
opportunity: opportunities,opportunity
oppose: oppose,opposed,opposing
opposition: opposition
oppress: oppressed
oppressive: oppressive
optimist: optimist
orange: orange
ordain: ordained
ordeal: ordeal
ordinance: ordinance,ordinances
ordinarily: ordinarily
ordinary: ordinaries,ordinary
ordination: ordination
organization: organization,organizations
organize: organized
orifice: orifice
origin: origin
original: original
originality: originality
ornament: ornament,ornamented,ornaments
ornamental: ornamental
orphan: orphan
orthodox: orthodox
orthography: orthography
ortolan: ortolans
os: os
oscillation: oscillation
ostensible: ostensible
ostentatious: ostentatious
outbreak: outbreak
outburst: outbursts
outfit: outfit,outfits
outlet: outlet,outlets
outline: outline,outlined
outlook: outlook
outnumber: outnumbered
outrage: outraged,outrages
outraged: outraged
outskirts: outskirts
outwit: outwitted
overcome: overcame,overcome
overflow: overflow,overflowed,overflowing
overhear: overheard
overlook: overlook
overpersuade: overpersuaded
overpower: overpowered
overtake: overtake,overtaking,overtook
overthrow: overthrow,overthrown
overturn: overturn,overturned,overturning
overwhelm: overwhelm
overwhelmed: overwhelmed
overwhelming: overwhelming
owe: owe,owed,owes
owl: owl
owner: owner,owners
pace: pace,paced,paces
pacific: pacific
pack: pack,packed
package: packages
packet: packet
packing: packing
pagan: pagan,pagans
pagans: pagans
pah: pah
pain: pain,pains
painful: painful
painfully: painfully
paint: paint,painted
pair: pair
palace: palace
paladin: paladins
palais: palais
palate: palate,palates
pale: pale
paleness: paleness
paler: paler
pallid: pallid
palm: palms
palpitating: palpitating
paltry: paltry
pampas: pampas
pan: pan
pane: panes
pang: pang
panic: panics
pant: pant
panther: panther
panting: panting
pantomime: pantomime
paper: paper,papers
par: par
parade: parade,paraded
paradise: paradise
parallel: parallel
paralyze: paralyze,paralyzed
parbleu: parbleu
parched: parched
parchment: parchment
pardieu: pardieu
pardon: pardon,pardoned,pardoning,pardons
parent: parent
paris: paris
parisian: parisian
park: park
parliament: parliament
parody: parodying
parole: parole
paroxysm: paroxysm
parry: parried,parries,parry,parrying
parsimonious: parsimonious
partake: partake
partial: partial
partiality: partiality
partially: partially
partisan: partisan,partisans
partition: partition
partly: partly
partner: partner
partook: partook
partridge: partridges
party: parties,party
pass: pass,passed,passes,passing
passage: passage,passages
passant: passant
passe: passe
passenger: passenger,passengers
passer: passers
passing: passing
passion: passion,passions
passionate: passionate
passionately: passionately
passive: passive
passport: passport,passports
password: password
paste: paste
pastime: pastime,pastimes
pastry: pastry
pasture: pasture
patch: patches
patent: patent
paternal: paternal
path: path
pathway: pathway
patience: patience
patient: patient
patiently: patiently
patois: patois
patrick: patrick
patrol: patrol
patron: patron
patronage: patronage
patronize: patronize
pau: pau
paul: paul
paulin: paulin
pause: pause,paused
pave: paved,paving
pavement: pavement
pavia: pavia
pavilion: pavilion
paw: paws
pay: paid,pay,paying,pays
payment: payment
peace: peace
peaceable: peaceable
peaceful: peaceful
peach: peach
pearl: pearl,pearls
pearly: pearly
peasant: peasant,peasants
peculiar: peculiar
peculiarity: peculiarities
peep: peep,peeped,peeping
peg: peg
pen: pen,pens
penalty: penalty
pencil: pencil,penciled
pendant: pendant
penetrate: penetrate,penetrated,penetrates,penetrating
penetration: penetration
penitent: penitent
penny: penny
pensive: pensive
pensively: pensively
pepper: pepper
perambulation: perambulations
perceive: perceive,perceived,perceives,perceiving
perception: perception,perceptions
perch: perch
perchance: perchance
perdition: perdition
peregrination: peregrination,peregrinations
perfect: perfect,perfecting
perfection: perfection
perfectly: perfectly
perfidious: perfidious
perfidiously: perfidiously
perfidy: perfidy
perforate: perforate
perform: perform,performed,performing
performance: performance
perfume: perfume,perfumes
perfumed: perfumed
peril: peril,perils
perilous: perilous
period: period,periods
periodical: periodical
perish: perish,perished
perjure: perjured
permissible: permissible
permission: permission
permit: permit,permits,permitted,permitting
perpendicular: perpendicular
perpetual: perpetual
perplex: perplexed
perplexed: perplexed
perplexing: perplexing
perplexity: perplexity
persecute: persecuted,persecutes
persecution: persecution,persecutions
persecutor: persecutor,persecutors
perseverance: perseverance
persevere: persevering
persian: persian
persist: persist,persisted,persists
persistence: persistence
persistency: persistency
person: people,person,persons
personage: personage,personages
personal: personal
personality: personality
personally: personally
personify: personified
perspicacity: perspicacity
perspicuous: perspicuous
perspiration: perspiration
persuade: persuade,persuaded
persuasion: persuasion
persuasive: persuasive
perusal: perusal
pervade: pervaded,pervading
perverse: perverse
pervert: pervert
pessimist: pessimist
peste: peste
pet: pet
peter: peter
petits: petits
petrified: petrified
petticoat: petticoat,petticoats
petty: petty
phantom: phantom,phantoms
phase: phases
philander: philandering
philistines: philistines
philosopher: philosopher,philosophers
philosophize: philosophizing
philosophy: philosophy
phlegm: phlegm
phlegmatic: phlegmatic
phlegmatically: phlegmatically
phrase: phrase
physical: physical
physically: physically
physician: physician
physiognomist: physiognomist
physiognomy: physiognomy
physique: physique
picard: picard
pick: pick,picked,picking
pickax: pickaxes
picture: pictures,picturing
picturesque: picturesque
piece: piece,pieces
piedmont: piedmont
pier: pier
pierce: pierce,pierced,piercing
pierced: pierced
pierre: pierre
pig: pigs
pigeon: pigeon,pigeons
pike: pike
pile: pile,piled
pillager: pillager
pillar: pillar
pillow: pillow
pin: pin
pinch: pinched,pinching
pink: pink
pinnacle: pinnacles
pioneer: pioneers
pious: pious
pipe: pipe
piquant: piquant
pique: pique,piqued
piquette: piquette
pistol: pistol,pistols
pistole: pistole,pistoles
pitchfork: pitchfork
piteously: piteously
pitiable: pitiable
pitiless: pitiless
pity: pitied,pity,pitying
plague: plague
plain: plain,plains
plainly: plainly
plan: plan,plans
planchet: planchet
plank: plank,planks
planning: planning
plant: plant
plash: plashing
plate: plate
platform: platform,platforms
plausible: plausible
play: play,played,playing,plays
player: player,players
plaything: playthings
plead: plead,pleaded,pleads
pleading: pleadings
pleasant: pleasant
pleasantry: pleasantry
pleased: pleased
pleasing: pleasing
pleasure: pleasure,pleasures
pledge: pledge,pledged,pledging
plenty: plenty
pleurisy: pleurisy
plot: plot,plots,plotting
pluck: pluck
plume: plume,plumes
plumed: plumed
plump: plump
plunder: plundered
plunge: plunged,plunging
pluribus: pluribus
poacher: poacher
pocket: pocket,pocketed,pockets
pocketbook: pocketbook
poem: poem,poems
poet: poet,poets
poetical: poetical
poetry: poetry
pointe: pointe
poison: poison,poisoned
poisoner: poisoner,poisoners
poisoning: poisoning
polecat: polecat
polemic: polemic
police: police
policy: policy
polish: polished
polished: polished
polite: polite,politest
politely: politely
politeness: politeness
political: political
politician: politician
politics: politics
poltroon: poltroon
pomegranate: pomegranate
pomme: pomme
pommel: pommel,pommels
pomp: pomp
pompey: pompey
pompous: pompous
pompously: pompously
pond: ponds
ponder: pondered
poniard: poniard,poniarded,poniards
pont: pont
pony: ponies,pony
poor: poor,poorest
pope: pope,popes
poplar: poplars
populace: populace
popular: popular
population: population
porch: porch
port: port,ports
porter: porter
portion: portion,portions
portionless: portionless
portmanteau: portmanteau
portrait: portrait,portraits
pose: pose
position: position
positive: positive
positively: positively
posse: posse,posses
possess: possess,possessed,possesses
possession: possession,possessions
possessor: possessor
possibility: possibility
post: post,posted,posts
posterity: posterity
postillion: postillion
postpone: postpone,postponed
postponement: postponement
postscript: postscript
poultice: poultices
pounce: pounce
pour: pour,poured,pouring,pours
poverty: poverty
powder: powder
power: power,powers
powerful: powerful
powerless: powerless
practical: practical
practice: practice,practiced,practices,practicing
praise: praise,praised
prance: prancing
pray: pray,prayed,praying
prayer: prayer,prayers
preacher: preacher,preachers
precarious: precarious
precaution: precaution,precautions
precede: precede,preceded,precedes,preceding
precious: precious
precipitate: precipitate,precipitated
precipitately: precipitately
precipitation: precipitation
precise: precise
precisely: precisely
precision: precision
precursor: precursor
predecessor: predecessor
predestination: predestination
predict: predicted
predilection: predilection
predominate: predominated
preface: preface
prefer: prefer,preferred,prefers
preference: preference
prejudice: prejudice,prejudiced,prejudices
prejudiced: prejudiced
preliminarily: preliminarily
preliminary: preliminaries,preliminary
prelude: prelude
premature: premature
prematurely: prematurely
preoccupation: preoccupation
preoccupied: preoccupied
preoccupy: preoccupied
preparation: preparations
prepare: prepare,prepared,preparing
prepared: prepared
prepossess: prepossess
presage: presaged
presence: presence
presentation: presentations
presentiment: presentiment,presentiments
presently: presently
preserve: preserve,preserved,preserves
preserver: preserver
preside: preside,presided
president: president
press: press,pressed,presses,pressing
pressing: pressing
pressure: pressure,pressures
presume: presume,presumed
presumption: presumption
presumptuous: presumptuous
pretend: pretend,pretended,pretending,pretends
pretendedly: pretendedly
pretense: pretense
pretension: pretensions
pretext: pretext,pretexts
prettily: prettily
pretty: prettier,prettiest,pretty
prevail: prevail,prevailed,prevails
prevent: prevent,prevented,preventing,prevents
previous: previous
prey: prey
price: price
prick: pricking
pride: pride
priedieu: priedieu
priest: priest,priests
priestess: priestess
prime: prime,primed
priming: priming
primitive: primitive
prince: prince,princes
princess: princess,princesses
principal: principal
principle: principles
print: print,printed
prior: prior
priority: priority
prison: prison
prisoner: prisoner,prisoners
private: private,privates
privilege: privilege
privileged: privileged
prize: prize
probability: probability
probable: probable
probity: probity
proceed: proceed,proceeded,proceeding
proceeding: proceeding
proceedings: proceedings
procession: procession
proclaim: proclaim
procurator: procurator,procurators
procure: procure,procured,procures,procuring
prodigal: prodigal
prodigiously: prodigiously
produce: produce,produced,produces,producing
production: productions
profanation: profanation
profane: profane
profession: profession
professional: professional
profile: profiled
profit: profit,profited,profiting
profitable: profitable
profound: profound,profoundest
profoundly: profoundly
profuse: profuse
profusion: profusion
program: program
progress: progress
prohibit: prohibited
project: project,projected,projecting,projects
prolong: prolonged,prolongs
prolonged: prolonged
promenade: promenade
promise: promise,promised,promises,promising
promote: promote
promotion: promotion
prompt: prompt,prompted
promptitude: promptitude
promptness: promptness
promulgate: promulgated
pronounce: pronounce,pronounced,pronouncing
pronounced: pronounced
proof: proof,proofs
prop: prop
proper: proper
properly: properly
property: property
prophesy: prophesied
prophet: prophet
proportion: proportion,proportioned,proportions
propos: propos
proposal: proposal,proposals
propose: propose,proposed,proposing
proposition: proposition
proprietor: proprietor
propriety: propriety
prosecute: prosecute
prosecution: prosecution
prosody: prosody
prosperity: prosperities,prosperity
prosperous: prosperous
prosperously: prosperously
prostitute: prostitute,prostitutes
prostrate: prostrate,prostrating
protect: protect,protected,protecting,protects
protection: protection
protector: protector
protest: protest
protestant: protestant,protestants
protestation: protestations
protrude: protruded,protruding
proudly: proudly
prove: prove,proved,proves
proverb: proverb
proverbial: proverbial
provide: provide,providing
providence: providence
provident: provident
province: province,provinces
provincial: provincial
provision: provision,provisions
provisionally: provisionally
provocation: provocation,provocations
provoke: provoke,provoked,provokes
provost: provost
prudence: prudence
prudent: prudent
prune: prune,prunes
pry: pry
ps: ps
psalm: psalm,psalms
pseudonym: pseudonyms
public: public
publicly: publicly
publish: publish,published
publisher: publisher
puddle: puddles
pull: pulled,pulling
pulse: pulse
punctilious: punctilious
punctual: punctual
punctuality: punctuality
punish: punish,punished,punishing
punishment: punishment,punishments
pupil: pupils
purchase: purchase,purchased,purchases
purchaser: purchaser
pure: pure,purest
purely: purely
puritan: puritan
puritans: puritans
purity: purity
purple: purple
purpose: purpose
purse: purse,purses
pursue: pursue,pursued,pursues,pursuing
pursuit: pursuit,pursuits
purveyor: purveyor
push: push,pushed,pushing
puzzle: puzzled
quai: quai
quality: qualities,quality
quantity: quantity
quarrel: quarrel,quarreled,quarreling,quarrels
quarreler: quarrelers
quarrelsome: quarrelsome
quarter: quarter,quartered,quarters
quay: quay,quays
queen: queen,queens
queenly: queenly
quest: quest
question: question,questioned,questions
questioner: questioner
questioning: questioning
qui: qui
quick: quick
quickness: quickness
quickset: quickset
quiet: quiet,quieted
quietly: quietly
quill: quill
quince: quinces
quit: quit,quitted,quitting
quixote: quixote
quotation: quotation
quote: quote,quoted,quoting
rabbit: rabbit,rabbits
race: race
rack: racking
radiance: radiance
radiant: radiant
rag: rags
rage: rage,raged,raging
ragged: ragged
rail: rail
raillery: raillery
rain: rain,rained
rainy: rainy
raise: raise,raised,raises,raising
raising: raising
rally: rallied,rally
ram: ram
rampart: rampart
rancor: rancor
random: random
range: range,ranged,ranges,ranging
rank: rank,ranks
ransom: ransom
rap: rap,rapping
rapid: rapid
rapidity: rapidity
rapidly: rapidly
rapier: rapier,rapiers
rare: rare,rarest
rarely: rarely
rascal: rascal
rascally: rascally
rash: rash
rashly: rashly
rat: rats
rate: rate
ratify: ratify
rattle: rattle,rattled,rattling
rattling: rattling
ravager: ravager
ravisher: ravisher
ray: ray,rays
reach: reach,reached,reaching
read: read,reading,reads
reader: reader,readers
readiness: readiness
reading: reading
ready: ready
real: real
reality: reality
realize: realized
reap: reap
reappear: reappear,reappeared,reappearing
reappearance: reappearance
rear: rear
reascend: reascended
reason: reason,reasons
reasonable: reasonable
reasoning: reasoning
reassure: reassure,reassured
reassured: reassured
rebel: rebel,rebels
rebellion: rebellion
rebellious: rebellious
rebuke: rebuke
recall: recall,recalled,recalling,recalls
recede: receding
receive: receive,received,receives,receiving
reception: reception
recipe: recipe
reciprocally: reciprocally
recital: recital
reckon: reckon,reckoned,reckoning,reckons
reckoning: reckoning
reclaim: reclaim,reclaiming
reclamation: reclamation
recline: reclined,reclining
recognition: recognition
recognize: recognize,recognized,recognizes,recognizing
recoil: recoil,recoiled,recoiling
recollect: recollect,recollected
recollection: recollection,recollections
recommence: recommenced
recommend: recommend,recommended,recommending,recommends
recommendation: recommendation
recompense: recompense,recompensed
reconcile: reconciled,reconciles
reconciliation: reconciliation
reconduct: reconduct
reconnoiter: reconnoitering
reconstruct: reconstruct
recount: recounted
recourse: recourse
recover: recover,recovered,recovering,recovers
recovered: recovered
recovery: recovery
recreation: recreation
recrimination: recriminations
recruit: recruit,recruited,recruiting,recruits
recuperate: recuperate
recur: recurred,recurring
recurrence: recurrence
red: red
redden: reddened,reddening
reddish: reddish
redeem: redeem
redemption: redemption
redness: redness
redouble: redouble,redoubled
reduce: reduce,reduced
reduction: reduction
reenter: reentered
refer: refer,referring,refers
refill: refilling
refined: refined
reflect: reflect,reflected,reflecting,reflects
reflection: reflection,reflections
reflective: reflective
refractory: refractory
refrain: refrain
refresh: refresh,refreshed
refreshment: refreshment
refuge: refuge
refusal: refusal
refuse: refuse,refused,refuses,refusing
regain: regain,regained,regaining
regard: regard,regarded
regiment: regiment
regimental: regimental
register: register,registered,registering
registrar: registrar
regret: regret,regrets,regretted
regular: regular
regularity: regularity
regularly: regularly
regulate: regulate,regulated
reign: reign,reigned,reigns
reinforce: reinforced
reinforcement: reinforcement
reject: reject,rejected
rejoice: rejoiced,rejoicing
rejoin: rejoin,rejoined,rejoining
relate: relate,relates,relating
relation: relation,relations
relationship: relationship
relative: relative,relatives
relax: relaxed
relaxation: relaxation
relay: relay,relays
release: release,released
reliance: reliance
relic: relic
relief: relief
relieve: relieve,relieved
religion: religion,religions
religious: religious
religiously: religiously
relinquish: relinquish,relinquished
reload: reload,reloaded
rely: rely
remain: remain,remained,remaining,remains
remainder: remainder
remains: remains
remark: remark,remarked,remarking,remarks
remarkable: remarkable
remarkably: remarkably
remedy: remedy
remember: remember,remembered,remembering,remembers
remembrance: remembrance,remembrances
remind: remind,reminded,reminds
remit: remitting
remnant: remnants
remonstrance: remonstrances
remonstrate: remonstrated
remorse: remorse
remote: remote
remount: remounted,remounting
remove: remove,removed,removing
render: render,rendered,rendering,renders
rendezvous: rendezvous
renew: renew,renewed,renewing
renounce: renounce
renown: renown
renowned: renowned
rent: rent
reopen: reopened,reopening
repair: repair,repaired
reparation: reparation
repass: repassed,repassing
repast: repast,repasts
repay: repaid,repay,repaying
repeat: repeat,repeated,repeating
repeatedly: repeatedly
repellent: repellent
repent: repent,repented
repentance: repentance
repentant: repentant
repetition: repetition
replace: replace,replaced,replacing
reply: replied,replies,reply,replying
report: report,reports
repose: repose,reposed
reprehend: reprehend
represent: represent,represented,representing,represents
representative: representatives
repress: repress,repressed
reprimand: reprimand,reprimanded,reprimands
reprisal: reprisals
reproach: reproach,reproached,reproaches
reproachful: reproachful
repudiate: repudiated
repugnance: repugnance
repugnant: repugnant
repulse: repulse,repulsed
repulsive: repulsive
reputation: reputation
request: request,requested,requests
require: require,required,requires
requisite: requisite
reread: reread
rescue: rescue,rescued
reseat: reseated
resemblance: resemblance,resemblances
resemble: resemble,resembled,resembles,resembling
resentment: resentment
reserve: reserve
reside: resided,resides
residence: residence,residences
resign: resigned
resignation: resignation
resigned: resigned
resist: resist,resisted,resisting,resists
resistance: resistance
resolute: resolute
resolutely: resolutely
resolution: resolution,resolutions
resolve: resolve,resolved
resound: resound,resounded
resource: resource,resources
respect: respect,respected,respecting
respectable: respectable
respectful: respectful
respectfully: respectfully
respective: respective
respects: respects
respiration: respiration
resplendent: resplendent
respond: respond,responded
response: response
responsibility: responsibility
responsible: responsible
rest: rest,rested,resting,rests
restaurant: restaurants
restitution: restitution
restless: restless
restoration: restoration
restore: restore,restored,restoring
restrain: restrain,restrained
restrained: restrained
result: result
resume: resume,resumed,resuming
resuscitate: resuscitated
retain: retain,retained,retaining
retake: retaken
reticence: reticence
retire: retire,retired,retiring
retired: retired
retrace: retraced
retract: retract
retreat: retreat,retreated,retreating
retrograde: retrograde
return: return,returned,returning
returned: returned
retwist: retwisted
reunion: reunion
reunite: reunited
reveal: reveal,revealed,revealing
revel: revels
revelation: revelation,revelations
revenge: revenge,revenged,revenges
revengeful: revengeful
revere: revered,reveres
reverence: reverence,reverences
reverend: reverend
reverie: reverie,reveries
reverse: reverse,reverses
revert: revert,reverted,reverts
review: review,reviewed
revive: revived,revives
revocation: revocation
revoir: revoir
revolt: revolt
revolution: revolution
revolve: revolving
reward: reward
rheumatism: rheumatism
rib: rib,ribs
ribbon: ribbon,ribbons
rich: rich,richest
richebourg: richebourg
riches: riches
richly: richly
richness: richness
rid: rid
riddle: riddled
ride: ridden,ride,riding,rode
rider: rider,riders
ridicule: ridicule,ridiculed
ridiculous: ridiculous
rightly: rightly
rigid: rigid
rigor: rigor
rigorous: rigorous
rigorously: rigorously
riot: riot,riots
rioter: rioters
riotous: riotous
rip: rip,ripped,ripping
ripe: ripe
ripple: ripples
rise: rise,risen,rises,rising,rose
risk: risk,risked
rite: rites
ritual: ritual
rival: rival,rivaled,rivals
river: river
riverside: riverside
rivulet: rivulet
road: road,roads
roadside: roadside
roadstead: roadstead
roam: roaming
roan: roan
roar: roar,roaring,roars
roaring: roaring
roast: roast
roasted: roasted
rob: robbed
robber: robbers
robbery: robbery
robe: robe,robes
robert: robert
roche: roche
rochelle: rochelle
rock: rock,rocked,rocks
rogue: rogue
roll: roll,rolled,rolling,rolls
rolling: rolling
romance: romance
romantic: romantic
rondeau: rondeau
roof: roof,roofs
root: roots
rope: rope,ropes
rose: rose
rosemary: rosemary
rosewood: rosewood
rosinante: rosinante
rosy: rosy
rot: rot,rotting
rotation: rotation
rouen: rouen
rouge: rouge
rough: rough
roughness: roughness
rounded: rounded
rouse: rouse,roused
roussillon: roussillon
route: route
rove: roved
row: row,rowed
rowel: rowels
rower: rowers
royal: royal
royale: royale
royalist: royalist,royalists
royalty: royalty
rub: rub,rubbed,rubbing
rubens: rubens
ruby: ruby
rudder: rudder
ruddy: ruddy
rude: rude
rudiment: rudiments
rudimental: rudimental
rue: rue
ruff: ruff
ruffian: ruffians
ruin: ruin,ruined,ruining,ruins
rule: rule,ruled,rules
rum: rum
rummage: rummaged,rummaging
running: running
rupture: rupture
rush: rush,rushed,rushing
rut: ruts
saber: saber
sable: sable
sack: sack
sacred: sacred
sacrifice: sacrifice,sacrificed,sacrifices,sacrificing
sacrilege: sacrilege
sacristan: sacristans
sad: sad,sadder,saddest
saddle: saddle,saddled,saddles,saddling
sadly: sadly
sadness: sadness
safe: safe,safer
safeguard: safeguard
safely: safely
safety: safety
sagacity: sagacity
sail: sail,sailed,sailing
sailor: sailor,sailors
saint: saint
saints: saints
sake: sake
sale: sale
salient: salient
saloon: saloon
salt: salt,salts
salutary: salutary
salutation: salutation,salutations
salute: salute,saluted,saluting
salvation: salvation
salver: salver
samaritan: samaritan
samson: samson
samuel: samuel
sanctity: sanctity
sanctuary: sanctuary
sand: sand
sanguinary: sanguinary
sapphire: sapphire,sapphires
saraband: saraband
sarcastic: sarcastic
sardanapalus: sardanapalus
satan: satan
satellite: satellites
satin: satin
satirical: satirical
satisfaction: satisfaction
satisfactory: satisfactory
satisfied: satisfied
satisfy: satisfied,satisfy,satisfying
satyr: satyrs
saul: saul
sausages: sausages
savage: savage
save: save,saved,saving
saved: saved
saving: saving
savings: savings
savor: savored,savoring,savors
scabbard: scabbard,scabbards
scaffold: scaffold,scaffolds
scale: scale,scaled
scamper: scamper
scan: scanning
scandal: scandal
scandalize: scandalized
scandalous: scandalous
scantiness: scantiness
scapegrace: scapegrace
scar: scar
scarcely: scarcely
scatter: scattered
scattered: scattered
scene: scene
scent: scent,scented
scholar: scholars
scholastic: scholastic
school: school,schools
schoolboy: schoolboy
science: science,sciences
scimitar: scimitar
scissors: scissors
scold: scold,scolded,scolding
scorn: scorn
scotch: scotch
scots: scots
scotsman: scotsman
scoundrel: scoundrel,scoundrels
scout: scout
scrap: scraps
scrape: scrape,scraped,scrapes
scratch: scratch,scratched,scratches
scream: scream,screamed,screaming
screen: screened,screening
screw: screw
scripture: scripture,scriptures
scruple: scruple
scrupulously: scrupulously
scrutinize: scrutinizing
sculptor: sculptor
sea: sea
seal: seal,sealed,seals
seals: seals
seamstress: seamstress
seaport: seaport
search: search,searched,searching
searching: searching
seashore: seashore
seasickness: seasickness
season: season
seasoned: seasoned
seat: seat,seated,seating,seats
secluded: secluded
seclusion: seclusion
secondary: secondary
secrecy: secrecy
secret: secret,secrets
secretary: secretaries,secretary
secretly: secretly
sect: sect
secure: secure,secured,securing
security: security
seduce: seduce,seduced,seducing
seduction: seduction,seductions
seed: seed,seeds
seek: seek,seeking,seeks,sought
seeker: seeker,seekers
seemingly: seemingly
seigneur: seigneur
seine: seine
seize: seize,seized,seizing
seizure: seizure
seldom: seldom
select: selected,selects
selfish: selfish
selfishness: selfishness
sell: sell,selling,sold
seminary: seminary
send: send,sending,sends
sensation: sensation,sensations
sense: sense
senseless: senseless
sensibly: sensibly
sensitive: sensitive
sensuality: sensuality
sentence: sentence
sententiously: sententiously
sentiment: sentiment,sentiments
sentimental: sentimental
sentimentally: sentimentally
sentinel: sentinel,sentinels
separate: separate,separated,separates
separation: separation
september: september
sepulcher: sepulcher
sepulchral: sepulchral
sequel: sequel
serenity: serenity
sergeant: sergeant,sergeants
series: series
seriousness: seriousness
sermon: sermon
serpent: serpent,serpents
servant: servant,servants
serve: serve,served,serves,serving
service: service,services
serviceable: serviceable
set: set,sets,setting
setting: setting
settle: settle,settled,settling
settled: settled
seventeenth: seventeenth
seventh: seventh
severe: severe
severely: severely
severity: severity
sewing: sewing
sextus: sextus
shabby: shabby
shade: shade,shaded
shades: shades
shadow: shadow,shadows
shady: shady
shake: shake,shaken,shaking,shook
shame: shame
shameless: shameless
shape: shape,shaped
share: share,shared,sharing
sharp: sharp
sharpen: sharpened
sharply: sharply
sheath: sheath,sheaths
sheathe: sheathe,sheathed
sheep: sheep
sheet: sheet,sheets
sheffield: sheffield
shelter: sheltered
shepherd: shepherds
sherbet: sherbet
shield: shield
shift: shift
shilling: shillings
shine: shine,shone
ship: ship,ships
shipmaster: shipmaster
shipwrecked: shipwrecked
shirt: shirt
shiver: shiver,shivered,shivers
shock: shock,shocked
shoe: shoes
shoot: shoots,shot
shore: shore,shores
short: short,shorter
shorten: shortens
shortly: shortly
shot: shot,shots
shoulder: shoulder,shoulders
shout: shouted,shouting
shovel: shovels
shower: shower
shrewd: shrewd
shrewdness: shrewdness
shriek: shriek,shrieked
shrill: shrill
shrimp: shrimps
shrink: shrink
shrug: shrugged,shrugging
shudder: shudder,shuddered,shuddering,shudders
shuddering: shuddering
shun: shun
shut: shut,shutting
shutter: shutter,shutters
shutting: shutting
sibyl: sibyl
sick: sick
sickly: sickly
siege: siege,sieges
siesta: siesta
sieur: sieur
sigh: sigh,sighed,sighing,sighs
sight: sight
sign: sign,signed,signs
signal: signal,signals
signature: signature
signify: signified,signifies,signify
signor: signor
silence: silence,silenced
silent: silent
silently: silently
silk: silk
silken: silken
sill: sill
silly: silly
silver: silver,silvered
simon: simon
simper: simpering
simple: simple,simplest
simpleton: simpleton
simplicity: simplicity
simplify: simplified,simplifies,simplifying
simply: simply
simulated: simulated
sin: sin,sinned
sincerely: sincerely
sincerity: sincerity
sing: sang,sing,singing
singer: singer
singing: singing
single: single
singly: singly
singular: singular
singularly: singularly
sinister: sinister
sink: sank,sink,sinking,sunk
sinner: sinner
sip: sipped,sipping
sir: sir
sire: sire
sirrah: sirrah
sister: sister,sisters
sit: sat,sit,sitting
sitting: sitting
situate: situated
situation: situation
sixteen: sixteen
sixteenth: sixteenth
sixth: sixth
sixtus: sixtus
size: size
skeleton: skeleton
skeptic: skeptic
sketch: sketch,sketching
skill: skill
skilled: skilled
skillful: skillful
skillfully: skillfully
skin: skin,skins
skirmish: skirmish
skirt: skirt,skirted,skirting
skullcap: skullcap
sky: sky
slacken: slacken,slackened
slake: slake
slam: slammed
slanderer: slanderers
slang: slang
slantingly: slantingly
slap: slapping
slash: slashed,slashes
slate: slated
slave: slave
slavery: slavery
slay: slay
slayer: slayer
sleek: sleek
sleep: sleep,sleeping,sleeps,slept
sleeper: sleeper
sleepiness: sleepiness
sleeping: sleeping
sleepless: sleepless
sleeplessness: sleeplessness
sleeve: sleeve,sleeves
slender: slender
slice: slice
slight: slight,slightest
slip: slip,slipped,slipping,slips
slipper: slipper,slippers
slit: slit
sloop: sloop
slow: slow
slowly: slowly
slowness: slowness
slumber: slumber
sly: sly
slyly: slyly
smallness: smallness
smallpox: smallpox
smart: smart
smell: smell,smelled,smelling
smile: smile,smiled,smiles,smiling
smilingly: smilingly
smoke: smoke,smoking
smoking: smoking
smoky: smoky
smooth: smooth
snail: snail
snare: snare,snares
snatch: snatch,snatched
sneak: sneaks
snow: snow
snug: snug
snugly: snugly
sob: sobbed,sobbing,sobs
social: social
society: societies,society
socket: sockets
sofa: sofa
soft: soft,softest
soften: soften,softened,softening
softened: softened
softly: softly
softness: softness
soil: soil,soiling
sojourn: sojourn
soldier: soldier,soldiers
sole: sole,soles
solely: solely
solemn: solemn
solemnity: solemnity
solicit: solicit,solicited,soliciting
solicitation: solicitations
solicitude: solicitude
solid: solid
solidity: solidity
soliloquize: soliloquizing
solitarily: solitarily
solitary: solitary
solitude: solitude
solomon: solomon
somber: somber
somnambulism: somnambulism
son: son,sons
song: song,songs
sonorous: sonorous
sooner: sooner
soothe: soothe
soporific: soporific
sordid: sordid
sorrow: sorrow,sorrows
sorrowfully: sorrowfully
sort: sort,sorts
sortie: sortie,sorties
sou: sou
soubise: soubise
soubrette: soubrette
soul: soul,souls
sound: sound,sounded,sounding,sounds
soundly: soundly
soup: soup
source: source,sources
sous: sous
south: south
southern: southern
souvenir: souvenir
sovereign: sovereign
sovereignty: sovereignty
sow: sow,sown
space: space
spain: spain
spaniard: spaniard
spaniards: spaniards
spanish: spanish
spare: spare,spared
sparingly: sparingly
spark: spark
sparkle: sparkle,sparkled,sparkles,sparkling
sparrow: sparrow
spartan: spartan
spasm: spasm
speak: speak,speaking,speaks,spoke,spoken
speaker: speaker
speaking: speaking
special: special
species: species
specimen: specimens
speck: speck
spectacle: spectacle
spectator: spectator,spectators
specter: specter
spectre: spectre
speculate: speculate
speech: speech,speeches
speechless: speechless
speed: speed
speedy: speedy
spend: spend,spent
spice: spices
spill: spilling
spinach: spinach
spirit: spirit,spirits
spiritless: spiritless
spit: spit,spitted
spite: spite
splash: splashes
splendid: splendid
splendidly: splendidly
splendor: splendor,splendors
split: split
spoil: spoil,spoils
spoiled: spoiled
spoke: spoke
sponge: sponge
spoonful: spoonful
sport: sport,sported,sports
sporting: sporting
spot: spot,spots
spotless: spotless
spouse: spouse
sprain: sprain
spread: spread,spreads
spring: sprang,spring,springing,sprung
sprinkle: sprinkled
sprinkler: sprinklers
spur: spur,spurred,spurs
spy: spied,spies,spy
squabble: squabble
square: square,squares
squeeze: squeeze,squeezing
squib: squibs
stab: stab,stabbed,stabbing
stable: stable,stables
staff: staff
stag: stag
stage: stage,stages
stagger: staggered
stain: stained,staining,stains
stair: stair,stairs
staircase: staircase,staircases
stake: stake,staked,staking
stammer: stammered,stammering
stamp: stamp,stamped,stamping
stand: stand,standing,stands,stood
standard: standard
standing: standing
star: star,stars
stark: stark
start: start,started,starting
startling: startling
starve: starve
station: stationed
statue: statue,statues
stature: stature
stave: staves
stay: stay,stayed,staying
stead: stead
steadfastly: steadfastly
steady: steady
steal: steal,stealing,stole,stolen
steed: steed,steeds
steel: steel,steeled
steep: steep
steer: steered
step: step,stepping,steps
stern: stern
sternly: sternly
stew: stews
stewpan: stewpans
stick: stick,sticks,stuck
stickle: stickled
sticky: sticky
stiff: stiff
stiffened: stiffened
stifle: stifle,stifled,stifles
stifling: stifling
stiletto: stiletto
stimulate: stimulated
sting: stung
stinginess: stinginess
stingy: stingy
stir: stir,stirred
stirrup: stirrup,stirrups
stock: stock
stocking: stocking,stockings
stoical: stoical
stolen: stolen
stomach: stomach,stomachs
stone: stone,stones
stony: stony
stool: stool,stools
stoop: stoop,stooped,stooping
store: store
storm: storm
stormy: stormy
story: stories,story
stout: stout
stoutly: stoutly
stove: stove
stovepipe: stovepipe
stovepipes: stovepipes
straight: straight
straightforward: straightforward
strain: strain,strained,strains
strained: strained
strange: strange
strangely: strangely
stranger: stranger,strangers
strangle: strangle,strangled
strangulation: strangulation
strap: strap
strategic: strategic
straw: straw
stray: stray,strayed
stream: stream,streamed,streaming
streaming: streaming
street: street,streets
strength: strength
strengthen: strengthen,strengthened,strengthens
stretch: stretch,stretched,stretches,stretching
strew: strewed
strict: strict,strictest
strictly: strictly
strictness: strictness
stride: strides,strode
strike: strike,strikes,striking,struck
striking: striking
string: strings
strip: strip
stripling: stripling
strive: strive
stroke: stroke,strokes
stroll: strolled
strong: strong,stronger,strongest
strongbox: strongbox
struggle: struggle,struggled,struggles,struggling
strumpet: strumpet
stud: studded,studs
study: studied,studies,study,studying
stuff: stuffed
stumble: stumbled,stumbles
stump: stump
stun: stunned
stunned: stunned
stunt: stunted
stupefaction: stupefaction
stupefied: stupefied
stupefy: stupefied
stupid: stupid
stupidity: stupidity
stupor: stupor
style: style,styled,styles,styling
suave: suave
subdue: subdue,subdued
subdued: subdued
subject: subject,subjects
sublimate: sublimated
sublime: sublime
submission: submission
submissive: submissive
submit: submit,submitted
subside: subside
substance: substance
substitute: substitute,substituted
substitution: substitution
subterranean: subterranean
subterraneously: subterraneously
subtle: subtle
suburb: suburb
suburban: suburban
succeed: succeed,succeeded
success: success
succession: succession,successions
successive: successive
successively: successively
successor: successor,successors
succor: succor
succulent: succulent
succumb: succumb,succumbed
suck: suck
sudden: sudden
suddenly: suddenly
suffer: suffer,suffered,suffering
suffering: sufferings
suffice: suffice,sufficed,suffices
sufficient: sufficient
suffocate: suffocated
suggestion: suggestion
suicide: suicide
suit: suit,suited,suits
suitable: suitable
suite: suite,suites
sum: sum
summer: summer
summit: summit
summon: summoned,summoning
summons: summons
sumptuous: sumptuous
sun: sun
sunday: sunday
sundry: sundry
superb: superb
superficial: superficial
superficially: superficially
superfluous: superfluous
superhuman: superhuman
superintend: superintend,superintended
superior: superior,superiors
superiority: superiority
supernatural: supernatural
superscription: superscription
superstitious: superstitious
supper: supper
supplant: supplant
suppliant: suppliant
supplicant: supplicant
supplicate: supplicate,supplicating
supplication: supplication
supply: supplied,supplies,supply
support: support,supported,supporting
suppose: suppose,supposed,supposing
supposition: supposition
suppress: suppress,suppressed,suppressing
suppression: suppression
supreme: supreme
surely: surely
surf: surf
surface: surface
surgeon: surgeon,surgeons
surmise: surmised,surmises
surmount: surmount,surmounted
surpass: surpassing
surpassingly: surpassingly
surprise: surprise,surprised,surprises
surprised: surprised
surprising: surprising
surrender: surrender,surrendered,surrendering
surround: surround,surrounded,surrounding,surrounds
surroundings: surroundings
surtout: surtout
survey: survey,surveyed,surveying
survive: survive,survived,surviving
survivor: survivor
susceptibility: susceptibility
suspect: suspect,suspected,suspecting,suspects
suspend: suspend,suspended,suspending
suspended: suspended
suspense: suspense
suspicion: suspicion,suspicions
suspicious: suspicious
suspiciously: suspiciously
sustain: sustain,sustained
swaggering: swaggering
swallow: swallow,swallowed,swallowing
swam: swam
swarm: swarms
swarthy: swarthy
swear: swear,swearing,swore,sworn
swearing: swearing
sweat: sweat
sweep: sweep,swept
sweet: sweet,sweetest
sweetness: sweetness
swell: swell,swelled,swelling,swollen
swerve: swerved
swiftness: swiftness
swim: swam,swimming,swims
swing: swing
swiss: swiss
swollen: swollen
swoon: swoon,swooned,swoons
sword: sword,swords
swordplay: swordplay
swordsman: swordsman,swordsmen
swordsmanship: swordsmanship
sycamore: sycamores
syllable: syllable,syllables
syllogism: syllogism
sympathy: sympathies,sympathy
symptom: symptoms
table: table
taciturn: taciturn
tack: tacked
tactic: tactics
tail: tail,tails
tailor: tailor,tailors
tale: tale
talent: talents
talisman: talisman
talk: talk,talked,talking,talks
talkative: talkative
talker: talkers
tall: tall,taller
tap: tap,tapped,tapping,taps
tapestry: tapestry
tarnished: tarnished
task: task
taste: taste,tasted,tastes
tasty: tasty
tattoo: tattoo
tavern: tavern,taverns
te: te
teach: taught,teach,teaching
tear: tear,tearing,tears,tore,torn
tearful: tearful
tediousness: tediousness
teller: teller
temper: temper,tempered
temperament: temperaments
tempest: tempest
tempestuous: tempestuous
temple: temple
temporarily: temporarily
temporary: temporary
temporize: temporizing
tempt: tempt,tempted
temptation: temptation,temptations
tempter: tempter
tempting: tempting
tenacious: tenacious
tenaciously: tenaciously
tenacity: tenacity
tenant: tenant
tendency: tendency
tender: tender
tenderly: tenderly
tenderness: tenderness
tennis: tennis
tense: tense
tent: tent
tenth: tenth
term: term,termed,terms
terminate: terminate,terminated,terminates
terrace: terrace
terrestrial: terrestrial
terrible: terrible
terribly: terribly
terrified: terrified
terrify: terrified,terrifies,terrify
terror: terror,terrors
testify: testify
testimonial: testimonials
testimony: testimony
thankfully: thankfully
theater: theater
thee: thee
theologian: theologian,theologians
theological: theological
theologize: theologize
theology: theology
theory: theory
thereabout: thereabouts
therewith: therewith
thesis: theses,thesis
thew: thews
thicken: thicken,thickens
thickness: thickness
thief: thief,thieves
thigh: thigh
thine: thine
thinking: thinking
thirst: thirst,thirsting
thirsty: thirsty
thirteen: thirteen
thirteenth: thirteenth
thither: thither
thoughtful: thoughtful
thoughtfulness: thoughtfulness
thrash: thrash,thrashed,thrashing
thread: thread,threaded,threads
threat: threat,threats
threaten: threaten,threatened,threatening,threatens
threatening: threatening
threshold: threshold
thrice: thrice
throat: throat
throw: threw,throw,throwing,thrown,throws
thrust: thrust,thrusting,thrusts
thunder: thunder,thunders
thursday: thursday
thwart: thwart,thwarted
thy: thy
thyself: thyself
ticket: ticket,ticketed
ticklish: ticklish
tide: tide
tiding: tidings
tie: tie,tied,ties
tiercel: tiercels
tiger: tiger
tigerlike: tigerlike
tight: tight
tightly: tightly
tigress: tigress
time: time,timed,times
timid: timid
timidity: timidity
timidly: timidly
tin: tin
tincture: tincture
tinge: tinge
tingle: tingle
tint: tints
tinted: tinted
tippler: tipplers
tirade: tirade
tire: tire,tired
tired: tired
tiresome: tiresome
title: title
toast: toast
toilet: toilet
token: token,tokens
tolerable: tolerable
tolerably: tolerably
toll: tolled
tomb: tomb
tombstone: tombstones
tomorrow: tomorrow
tone: tone,tones
tong: tongs
tongue: tongue,tongues
tonight: tonight
tool: tool,tools
tooth: teeth,tooth
topaz: topaz
topography: topography
topsy: topsy
torment: tormented,torments
torn: torn
torpor: torpor
torrent: torrent,torrents
tortoise: tortoise
torture: torture,tortured,tortures
toss: tossing
total: total
totally: totally
touch: touch,touched,touches,touching
touching: touching
tour: tour
tours: tours
tout: touts
towel: towel
tower: tower,towers
town: town,towns
trace: trace,traced,traces,tracing
track: track,tracks
tracy: tracy
trade: trade,traded
tradesman: tradesman
tragedy: tragedy
tragic: tragic
train: train,trained,trains
traitor: traitor,traitors
traitorous: traitorous
trample: trampled
trampled: trampled
tranquil: tranquil
tranquility: tranquility
tranquillity: tranquillity
tranquilly: tranquilly
transact: transact
transfer: transfer
transfix: transfixing
transform: transformed
translate: translated,translates
transmission: transmission
transmit: transmit,transmitted
transparency: transparency
transparent: transparent
transport: transport,transported,transporting,transports
transportation: transportation
trap: traps
travel: travel,traveled,traveling
traveler: traveler,travelers
traverse: traverse,traversed
treacherously: treacherously
treachery: treachery
tread: tread,trod
treason: treason
treasure: treasure,treasures
treasurer: treasurer
treasury: treasury
treat: treat,treated,treating,treats
treatise: treatise
treatment: treatment
tree: tree,trees
tremble: tremble,trembled,trembles,trembling
tremblingly: tremblingly
tremor: tremor
tremulous: tremulous
trench: trench,trenches
trial: trial
tribunal: tribunal,tribunals
trick: trick,tricked,tricks
trickle: trickle
trifle: trifle,trifled,trifles
trifling: trifling
trigger: trigger
trip: trip
triple: triple
tristan: tristan
triumph: triumph,triumphed,triumphing
triumphal: triumphal
triumphant: triumphant
triumphantly: triumphantly
troop: troop
troops: troops
trophy: trophies,trophy
trot: trot,trotted,trotting
trouble: trouble,troubles,troubling
troubled: troubled
troublesome: troublesome
trousers: trousers
true: true
trumpet: trumpet
truncate: truncated
trunk: trunk,trunks
truss: truss
trust: trust,trusted
trustful: trustful
trustworthy: trustworthy
truth: truth
truthful: truthful
truthfulness: truthfulness
tuck: tucked
tumble: tumbled
tumult: tumult
tumultuous: tumultuous
tun: tun
turbulent: turbulent
turks: turks
turnstile: turnstile
turret: turret
turvy: turvy
twentieth: twentieth
twilight: twilight
twist: twist,twisted,twisting
twisted: twisted
twisting: twisting
tyburn: tyburn
type: type
tyranny: tyranny
tyrant: tyrants
ugly: ugly
unable: unable
unaccountable: unaccountable
unacquainted: unacquainted
unalterable: unalterable
unanimous: unanimous
unarmed: unarmed
unasked: unasked
unbelieving: unbelieving
unbound: unbound
unceasingly: unceasingly
unceremoniously: unceremoniously
uncertain: uncertain
unchanged: unchanged
uncle: uncle
unclosed: unclosed
uncock: uncock
uncomfortable: uncomfortable
uncomfortably: uncomfortably
uncommon: uncommon
unconsciously: unconsciously
uncontrollable: uncontrollable
uncork: uncork,uncorked
uncover: uncovered
unction: unction
undeceive: undeceive
undeceived: undeceived
undecided: undecided
undeniably: undeniably
undergo: undergo,undergoing,undergone
underground: underground
underlip: underlip
understand: understand,understanding,understood
understanding: understanding
undertake: undertake,undertaken,undertaking,undertook
undertaking: undertaking,undertakings
undertone: undertone
underwood: underwood
undiluted: undiluted
undisciplined: undisciplined
undispersed: undispersed
undoubted: undoubted
undoubtedly: undoubtedly
undress: undressed,undressing
undressed: undressed
undulation: undulations
uneasily: uneasily
uneasiness: uneasiness
uneasy: uneasy
unequal: unequal
unexpected: unexpected
unexpectedly: unexpectedly
unfaithful: unfaithful
unfasten: unfastened
unfavorable: unfavorable
unfold: unfold,unfolded,unfolds
unforeseen: unforeseen
unfortunate: unfortunate
ungrateful: ungrateful
unhappy: unhappy
unharness: unharnessed
unheard: unheard
unhurt: unhurt
uniform: uniform
unimpeachable: unimpeachable
unimportant: unimportant
unintelligible: unintelligible
union: union
unison: unison
unite: unite,united,unites,uniting
united: united
unjust: unjust
unjustly: unjustly
unkindly: unkindly
unknown: unknown
unlimited: unlimited
unlock: unlocked
unlucky: unlucky
unmistakably: unmistakably
unmixed: unmixed
unmounted: unmounted
unmoved: unmoved
unnecessary: unnecessary
unparalleled: unparalleled
unpardonable: unpardonable
unpaved: unpaved
unperceived: unperceived
unpleasant: unpleasant
unpolished: unpolished
unravel: unravel,unraveled
unreasonable: unreasonable
unroll: unrolled,unrolling
unsaddle: unsaddle
unseal: unsealed
unseasonable: unseasonable
unskilled: unskilled
unspeakable: unspeakable
unspoken: unspoken
unsteady: unsteady
unsuitable: unsuitable
unthinkingly: unthinkingly
untie: untie,untied
unusual: unusual
unveil: unveiled
unwilling: unwilling
unworthy: unworthy
upper: upper
upright: upright
upset: upset
upsetting: upsetting
upstairs: upstairs
upward: upward
urbanity: urbanity
urge: urged,urges,urging
urgency: urgency
urgent: urgent
usage: usages
useless: useless
uselessly: uselessly
usher: usher
usual: usual
usurer: usurers
usurp: usurped
usury: usury
utility: utility
utmost: utmost
utter: utter,uttered,uttering
utterance: utterance
vacant: vacant
vade: vade
vagabond: vagabond
vague: vague
vaguely: vaguely
vain: vain
vainglorious: vainglorious
vainly: vainly
valet: valet,valets
valiant: valiant
valise: valise,valises
valor: valor
valuable: valuable
vanguard: vanguard
vanish: vanished
vanity: vanity
vanquish: vanquished
vapor: vapor
variation: variations
varied: varied
variety: varieties,variety
varnish: varnish
vase: vase,vases
vast: vast
vastly: vastly
vault: vault,vaulted,vaults
veal: veal
vegetable: vegetables
vehemence: vehemence
vehement: vehement
vehicle: vehicle
veil: veil,veiled
veiled: veiled
vein: vein,veins
veins: veins
velvet: velvet
velvety: velvety
venal: venal
venerable: venerable
venerate: venerate
veneration: veneration
venery: venery
vengeance: vengeance
vent: vent
ventilate: ventilating
venture: venture,ventured,ventures,venturing
veracious: veracious
verb: verb
verbal: verbal
verdant: verdant
verify: verify
veritable: veritable
vermillion: vermillion
verse: verse,versed,verses
verses: verses
vertigo: vertigo
vessel: vessel,vessels
vest: vest
vestibule: vestibule
vestige: vestige
vestment: vestments
veterinary: veterinary
vex: vexed,vexes
vexation: vexation
vial: vial
viand: viands
vibrate: vibrated
vice: vice
vicinity: vicinity
vicious: vicious
victim: victim,victims
victory: victories,victory
vie: vied
view: view,viewed,views
vigilance: vigilance
vigilant: vigilant
vigorous: vigorous
vigorously: vigorously
vii: vii
viii: viii
vile: vile
village: village
villain: villain
villainous: villainous
villainy: villainy
ville: ville
vindictive: vindictive
violence: violence,violences
violent: violent
violently: violently
violet: violet
violin: violins
viper: viper
virgin: virgin,virgins
virtue: virtue,virtues
virtuous: virtuous
visage: visage
visible: visible
visibly: visibly
vision: vision
visionary: visionary
visit: visit,visited,visits
visitor: visitor,visitors
vitry: vitry
vivacious: vivacious
vocation: vocation
voce: voce
vociferate: vociferated
vociferous: vociferous
vociferously: vociferously
voice: voice,voices
void: void
voiture: voiture
volume: volume,volumes
voluntarily: voluntarily
volunteer: volunteer,volunteers
voluptuous: voluptuous
voluptuousness: voluptuousness
vortex: vortex
vouch: vouch
vouchsafe: vouchsafing
vow: vow,vowed,vows
voyage: voyage,voyages
voyager: voyagers
vulgar: vulgar
vulnerable: vulnerable
wager: wager,wagered
wagon: wagon
wagoner: wagoner
wainscot: wainscot
waist: waist
wait: wait,waited,waiting,waits
waiter: waiter
waiting: waiting
wake: wake,waked,wakes
waken: waken
wales: wales
walk: walk,walked,walking,walks
walking: walking
wall: wall,walls
wander: wandered,wanders
wanderer: wanderer
wanderings: wanderings
war: war,wars
wardrobe: wardrobe
warm: warm,warmer
warmly: warmly
warmth: warmth
warn: warn,warned,warning
warning: warning,warnings
warranty: warranty
wars: wars
wash: wash
waste: waste
watch: watch,watched,watches,watching
watchfulness: watchfulness
watchword: watchword
water: water,watered,waters
wave: waved,waves,waving
waver: wavering
wax: wax
weak: weak,weaker,weakest
weaken: weaken,weakened,weakens
weakness: weakness
wealth: wealth
weapon: weapon,weapons
wear: wear,wearing,wears,wore,worn
wearied: wearied
weariness: weariness
weary: wearied,weary
weather: weather
weathercock: weathercock
wedding: wedding
week: week,weeks
weep: weep,weeping,wept
weigh: weighed,weighing,weighs
weight: weight
welfare: welfare
wharf: wharf
wheedle: wheedling
wheel: wheel,wheels
wherewithal: wherewithal
whew: whew
whip: whip
whirl: whirling
whisker: whiskers
whisper: whisper,whispered,whispers
whistle: whistle,whistled,whistling
white: white
whiteness: whiteness
whites: whites
wholesome: wholesome
wholly: wholly
wi: wi
wicked: wicked
wicket: wicket,wickets
wide: wide
widow: widow
wife: wife,wives
wild: wild
willed: willed
willingly: willingly
willy: willy
win: win,winning,wins
wind: wind,winding,winds,wound
windgall: windgalls
winding: windings
windmill: windmills
window: window,windows
windows: windows
windsor: windsor
wine: wine,wines
wing: wing,wings
wink: wink,winking
winnings: winnings
winter: winter
wire: wire
wisdom: wisdom
wise: wise,wiser,wisest
wisely: wisely
wit: wit,wits
withdraw: withdraw,withdrawing,withdrawn,withdrew
withhold: withheld,withholding
witness: witness,witnesses
wittily: wittily
witty: witty
woe: woe,woes
wolf: wolves
woman: woman,women
womanly: womanly
wonderfully: wonderfully
wood: wood,woods
wooden: wooden
woolen: woolen
word: word
workman: workmen
workroom: workroom
workshop: workshop
worldly: worldly
worm: worm
worry: worries,worry
worshipper: worshipper
worth: worth
worthily: worthily
worthy: worthy
wound: wound,wounded,wounding,wounds
wounded: wounded
wrap: wrap,wrapped
wrath: wrath
wreck: wrecks
wrest: wresting
wretch: wretch,wretches
wretched: wretched
wriggle: wriggling
wringing: wringing
wrinkle: wrinkled
wrist: wrist,wrists
write: write,writes,writing,written,wrote
writing: writing
writings: writings
written: written
wrong: wrong,wrongs
wrongfully: wrongfully
wrongly: wrongly
xi: xi
xii: xii
xiii: xiii
xiv: xiv
xix: xix
xvi: xvi
xvii: xvii
xviii: xviii
xx: xx
xxi: xxi
xxii: xxii
xxiii: xxiii
xxiv: xxiv
xxv: xxv
xxx: xxx
yard: yard,yards
yellow: yellow
yesterday: yesterday
yez: yez
yield: yield,yielded,yielding,yields
yonder: yonder
youngster: youngster
youth: youth
youthfulness: youthfulness
zeal: zeal
zealous: zealous
zenith: zenith
zounds: zounds
