abandon: abandon,abandoned
abandonment: abandonment
abdicate: abdicated
abettor: abettors
abide: abide
ability: abilities,ability
ablest: ablest
ably: ably
abolish: abolished,abolishing
abolition: abolition
aboriginal: aboriginal
abound: abound,abounds
abridge: abridge,abridged
absence: absence
absent: absent
absolute: absolute
absolutely: absolutely
absorb: absorbed
absurd: absurd
abundance: abundance
abundant: abundant
abuse: abuse,abused,abuses
abused: abused
academic: academic
academies: academies
academy: academy
acapulco: acapulco
accelerate: accelerated
accept: accept,accepted,accepting
acceptance: acceptance
access: access,accessed
accessible: accessible
accessory: accessories
acclaim: acclaim
accommodate: accommodated
accompany: accompanied,accompany,accompanying
accomplish: accomplish,accomplished
account: account,accounts
accounts: accounts
accumulate: accumulated
accumulation: accumulation
accuracy: accuracy
accurate: accurate
accurately: accurately
accuse: accused
accustom: accustomed
achieve: achieved,achieving
achievement: achievement,achievements
acknowledge: acknowledge,acknowledged
acknowledgment: acknowledgment
acquaint: acquaint,acquainted
acquaintance: acquaintance
acquire: acquired,acquires,acquiring
acquisition: acquisition
acta: acta
action: action,actions
active: active
actively: actively
activity: activities,activity
actual: actual
adapt: adapted
add: add,adds
addition: addition,additions
additional: additional
address: address,addressed,addresses
adelantado: adelantado
aden: aden
adequate: adequate
adhere: adhered,adheres,adhering
adjacent: adjacent
adjoin: adjoining
administer: administer,administered
administration: administration,administrations
administrative: administrative
administrator: administrator,administrators
admirable: admirable
admirably: admirably
admiral: admiral
admiration: admiration
admission: admission
admit: admit,admitted
adopt: adopt
adoption: adoption
adoration: adoration
adriatic: adriatic
adult: adults
advance: advance,advanced,advances,advancing
advanced: advanced
advancement: advancement
advantage: advantage,advantages
advantageous: advantageous
adventure: adventure,adventures
adventurer: adventurer,adventurers
adventurous: adventurous
adviser: advisers
advocate: advocate,advocates
afar: afar
affair: affair,affairs
affairs: affairs
affection: affection
afflict: afflicted
afford: afford,afforded,affords
afresh: afresh
africa: africa
african: african,africans
age: age,ages
aged: aged
agency: agencies
agent: agent,agents
ages: ages
aggression: aggression
aggressive: aggressive
agitate: agitated,agitating
agitated: agitated
agitation: agitation
agitator: agitators
agree: agree,agreed
agreement: agreement
agricultural: agricultural
agriculture: agriculture
agriculturist: agriculturists
aguinaldo: aguinaldo
aid: aid,aided
aim: aim,aimed,aims
ak: ak
alarm: alarm,alarmed
alaska: alaska
albany: albany
albuquerque: albuquerque
alcalde: alcalde,alcaldes
alcazar: alcazar
alcedo: alcedo
alexander: alexander
alien: aliens
alienate: alienate
alike: alike
alive: alive
allegiance: allegiance
alleviate: alleviate
alliance: alliance,alliances
allot: allotted
allowance: allowance
alluring: alluring
ally: allied,allies,ally
almighty: almighty
alonso: alonso
alonzo: alonzo
alphabet: alphabet,alphabets
alps: alps
alteration: alteration
alternate: alternate
alternative: alternative
amass: amassing
amaze: amaze
amazement: amazement
amazing: amazing
amazon: amazon
ambassador: ambassador,ambassadors
amber: amber
ambition: ambition,ambitions
ambitious: ambitious
amboina: amboina
amboyna: amboyna
ambrosian: ambrosian
amend: amend
america: america
american: american,americans
americas: americas
amigo: amigo
amigos: amigos
ammunition: ammunition
amnesty: amnesty
amoretti: amoretti
amoy: amoy
amsterdam: amsterdam
anarchy: anarchy
ancestor: ancestor,ancestors
ancestry: ancestry
anchor: anchor,anchored,anchors
anchoring: anchoring
ancient: ancient
anda: anda
andaman: andaman
andrew: andrew
anew: anew
anger: anger,angered
angles: angles
animal: animal,animals
animated: animated
anitos: anitos
anna: anna
annex: annexed,annexing
annexation: annexation
annoying: annoying
annual: annual
annually: annually
annul: annulled,annulling
answer: answer,answered
antagonism: antagonism
antagonist: antagonist
antagonize: antagonized
antilles: antilles
anton: anton
antonia: antonia
antonio: antonio
antwerp: antwerp
anxiety: anxieties,anxiety
anxious: anxious
anxiously: anxiously
apiece: apiece
apostle: apostles
apothecary: apothecaries
appal: appalled
appalachians: appalachians
apparent: apparent
apparition: apparition
appeal: appeal,appeals
appearance: appearance
appease: appeased
appellative: appellative
appendix: appendix
applicable: applicable
application: application
apply: applied,apply,applying
appoint: appoint,appointed
appointment: appointment
apportionment: apportionment
appreciation: appreciation
apprehension: apprehension
approach: approach,approached,approaches,approaching
april: april
aquinas: aquinas
arab: arab,arabs
arabia: arabia
arabian: arabian
arabic: arabic
arch: arches
archbishop: archbishop
archduke: archduke
archeology: archeology
archipelago: archipelago,archipelagoes
architecture: architecture
archive: archive,archives
archives: archives
ardent: ardent
ardor: ardor
argue: argued,argues,arguing
argument: arguments
arias: arias
aristocracy: aristocracy
aristocratic: aristocratic
arithmetic: arithmetic,arithmetics
arithmetical: arithmetical
arithmetics: arithmetics
arizona: arizona
arm: arm,armed,arms
armada: armada
armament: armament,armaments
armed: armed
armor: armor
armored: armored
army: armies,army
arouse: arouse,aroused,arousing
arquebus: arquebus,arquebuses
arrange: arranged,arranging
arrangement: arrangement
array: array
arrest: arrest,arrested,arrests
arrival: arrival,arrivals
arrive: arrive,arrived,arriving
arrogant: arrogant
arrow: arrow,arrows
arsenal: arsenal,arsenals
art: art,arts
arte: arte
arthur: arthur
article: articles
artificial: artificial
artillerist: artillerist,artillerists
artillery: artillery
artisan: artisans
artist: artist
artistically: artistically
ascendancy: ascendancy
ascendency: ascendency
ascii: ascii
ascribe: ascribe
ash: ashes
ashore: ashore
asia: asia
asian: asian
asiatic: asiatic
aspiration: aspirations
aspire: aspired,aspiring
assail: assailed
assailant: assailant
assassin: assassins
assassinate: assassinated
assassination: assassination
assault: assault,assaulted,assaults
assemble: assembled,assembling
assembling: assembling
assembly: assembly
assert: asserted
assessor: assessor
assign: assigned
assignment: assignment
assisi: assisi
assist: assist,assisted
assistance: assistance
assistant: assistants
associate: associates
association: association
assume: assume,assumed
assurance: assurance,assurances
assure: assure,assured
astonished: astonished
astonishing: astonishing
astrolabe: astrolabe
astronomic: astronomic
asylum: asylum
atlantic: atlantic
atoll: atolls
attach: attached,attaching
attachment: attachment
attack: attack,attacked,attacks
attain: attained
attainment: attainments
attempt: attempt,attempted,attempting,attempts
attend: attend,attended,attending
attendance: attendance
attention: attention
attire: attired
attitude: attitude
attract: attracted
attraction: attraction,attractions
attractive: attractive
attribute: attributed
audacity: audacity
audiencia: audiencia
auditor: auditor
augment: augmented
august: august
augustin: augustin
augustinian: augustinian
australia: australia
austria: austria
author: author
authoritative: authoritative
authority: authorities,authority
authorization: authorization
authorize: authorized
autocratic: autocratic
aux: aux
availability: availability
avarice: avarice
avenge: avenge
avenue: avenues
average: average
averse: averse
avoid: avoid,avoided
avowed: avowed
await: await,awaited
awake: awoke
awaken: awaken
award: awards
awful: awful
ax: ax
axe: axe
axis: axes
ayuntamiento: ayuntamiento
azores: azores
bachelor: bachelor
bacteriological: bacteriological
bad: bad,worse,worst
badly: badly
bagdad: bagdad
baja: baja
bajan: bajan
bajau: bajau
balance: balance
balboa: balboa
baldwin: baldwin
bali: bali
ball: ball
baltic: baltic
bamboo: bamboo
ban: ban
banana: bananas
banca: banca
band: band,banded,bands
banish: banished
banishment: banishment
bank: bank,banks
banner: banners
bantam: bantam
baptism: baptism
baptize: baptize,baptized,baptizing
bar: barring
barangay: barangay
barba: barba
barbarian: barbarians
barbarism: barbarism
barbarous: barbarous
barber: barbers
barcelona: barcelona
barefooted: barefooted
bark: bark
baron: baron
barong: barong
barracks: barracks
barracoon: barracoon
barren: barren
barrier: barriers
barrio: barrio,barrios
barrows: barrows
barter: barter,bartered
bartholomew: bartholomew
base: base,based
basin: basin
basis: basis
bastion: bastions
bataan: bataan
bathala: bathala
battalion: battalion
batter: battered
battery: batteries
battle: battle,battles
battleship: battleship
bay: bay,bays
bayonet: bayoneted
beach: beach
bead: beads
bean: beans
bear: bear,bearing,bore,born,borne
beard: beard
bearer: bearer,bearers
beast: beasts
beat: beat,beaten,beating
beautiful: beautiful
beautifully: beautifully
beauty: beauty
bed: bed
befriend: befriended
beg: begged
behead: beheading
beheading: beheading
behold: behold
belgium: belgium
belief: belief
belittle: belittled
bell: bell,bells
bello: bello
bells: bells
belong: belong,belonged,belonging
belt: belt
beneath: beneath
beneficent: beneficent
beneficial: beneficial
benefit: benefit,benefits
bengal: bengal
bent: bent
benzoin: benzoin
beri: beri
bernard: bernard
beset: beset
bestow: bestow,bestowed
betel: betel
betterment: betterment
bias: bias
biblical: biblical
bibliographical: bibliographical
bibliography: bibliographies,bibliography
bigot: bigot
binary: binary
bind: bound
binding: bindings
biographer: biographer
bird: bird,birds
birth: birth
birthplace: birthplace
bisayan: bisayan
bishop: bishop,bishops
bishopric: bishopric
bit: bit
bitter: bitter
bitterly: bitterly
bitterness: bitterness
black: black,blacks
blackboard: blackboard
blacken: blackened
blackmail: blackmail
blair: blair
blame: blame
blanco: blanco
blanket: blankets
blaze: blazed
bleak: bleak
blessing: blessing
block: block,blocked
blockhouse: blockhouses
blood: blood
bloodless: bloodless
bloodshed: bloodshed
bloody: bloodiest,bloody
blow: blow,blown,blows
blue: blue
boar: boar
board: board,boarded
boast: boasted
boasting: boasting
boat: boat,boats
body: bodies,body
bogota: bogota
bohemia: bohemia
bokhara: bokhara
bold: bold
boldly: boldly
bombard: bombarded
bond: bond,bonds
bondage: bondage
bone: bone,bones
book: book,books
booth: booths
booty: booty
border: bordering
borneo: borneo
borrow: borrowed
botanist: botanist
botany: botany
bound: bounded,bounds
boundary: boundaries
boundless: boundless
bounteously: bounteously
bourbon: bourbon
bow: bow
bowl: bowl
bowman: bowmen
box: box
boy: boy,boys
brahmin: brahmin
brahminism: brahminism
branch: branch,branches
brand: brands
brass: brass
brave: brave,bravest
bravery: bravery
bravo: bravo
brazil: brazil
brazilian: brazilian
breach: breach
breadfruit: breadfruit
break: breaking,broke,broken
breast: breast
breathe: breathes
breeder: breeders
breeding: breeding
brethren: brethren
brick: brick
bridge: bridge,bridges
bridle: bridle
brigade: brigade
brigadier: brigadier
bright: bright
brighten: brighten
brilliant: brilliant
brilliantly: brilliantly
bring: bring,bringing,brings,brought
brisk: brisk
britain: britain
british: british
broad: broad,broader
brocade: brocades
bronze: bronze
brooke: brooke
brother: brother
brotherhood: brotherhood
brown: brown
brunt: brunt
brush: brush
brutality: brutality
bu: bu
buddha: buddha
buddhism: buddhism
buddhist: buddhist
buffalo: buffalo
build: build,building,built
building: building,buildings
bulk: bulk
bull: bull
bullet: bullet
bullion: bullion
burden: burden,burdened,burdens
burdensome: burdensome
bureau: bureau,bureaus
burgundy: burgundy
burial: burial
burma: burma
burn: burned,burning,burnt
burning: burning
burst: burst
busily: busily
business: business
busy: busy
butchery: butchery
buttress: buttresses
cabildo: cabildo
cabinet: cabinet
cabot: cabot,cabots
cabots: cabots
cacao: cacao
cacique: caciques
cagayan: cagayan
cage: cages
calculate: calculate,calculated,calculating
calculation: calculations
calcutta: calcutta
caldera: caldera
calf: calf
calicut: calicut
california: california
calling: callings
calm: calm,calms
calmly: calmly
calvin: calvin
cambodia: cambodia
cambridge: cambridge
camel: camels
camote: camote
camp: camp,camped
campa: campa
campaign: campaign,campaigning
campaigner: campaigners
campaigns: campaigns
camphor: camphor
campo: campo
canal: canal
canaries: canaries
canary: canaries
cancel: cancel
candle: candle
candlestick: candlesticks
cane: cane,canes
cannibal: cannibals
cannibalism: cannibalism
cannon: cannon
cannonading: cannonading
canoe: canoe,canoes
canon: canons
canonization: canonization
cantar: cantar
canter: canter
canton: canton
capable: capable
capacity: capacities,capacity
caparison: caparisoned
cape: cape
capes: capes
capital: capital,capitals
capitan: capitan
capitulate: capitulated
capon: capons
captain: captain,captains
captive: captive,captives
capture: capture,captured,captures,capturing
carabao: carabaos
caravan: caravan
card: card
care: care,cared
career: career
careful: careful
carefully: carefully
cargador: cargador
cargo: cargo,cargoes
cargoes: cargoes
carlos: carlos
caroline: caroline,carolines
carolines: carolines
carry: carried,carry,carrying
casa: casa,casas
casas: casas
caspian: caspian
cast: cast,casting
castaway: castaways
caste: castes
castile: castile
castilla: castilla
castillo: castillo
casting: casting
castle: castle
cat: cats
catalog: catalog
catalogue: catalogue
catastrophe: catastrophe
catch: catch
catechise: catechised
catechism: catechisms
catechist: catechists
cathay: cathay
cathedral: cathedral
catholic: catholic
catholicism: catholicism
cattle: cattle
caution: caution
cautiously: cautiously
cavalry: cavalry
cavendish: cavendish
cease: cease,ceased
cede: cede,ceded
cedula: cedula,cedulas
cedulas: cedulas
celebes: celebes
celebrate: celebrated
celebrated: celebrated
cement: cemented
censorship: censorship
census: census
cent: cent,cents
center: center,centered,centers
centimeter: centimeters
central: central
century: centuries,century
cereal: cereal
ceremonial: ceremonial,ceremonials
ceremony: ceremonies,ceremony
cessation: cessation
cession: cession,cessions
ceylon: ceylon
chagrin: chagrin
chain: chains
chalice: chalices
challenge: challenged
champion: champion,champions
chan: chan
change: change,changed,changing
changing: changing
channel: channel,channels
chant: chanted
chao: chao
chap: chap
chapel: chapel
chapter: chapter,chapters
character: character,characters
characteristic: characteristic,characteristics
characterize: characterize,characterized
charge: charge,charged,charges
charitable: charitable
charity: charities,charity
charles: charles
chart: chart,charted,charting,charts
chase: chase
chattel: chattels
chaucer: chaucer
cheap: cheap
check: check,checked,checks
chemical: chemical
chest: chest
chewing: chewing
chicago: chicago
chicken: chicken,chickens
chief: chief,chiefs
chiefly: chiefly
chieftain: chieftain,chieftains
child: child,children
chili: chili
chin: chin
china: china
chine: chine
chinese: chinese
chinos: chinos
chirino: chirino
choice: choice
cholera: cholera
choose: choose,chose,chosen
christ: christ
christendom: christendom
christian: christian,christians
christianity: christianity
christianize: christianize,christianized,christianizing
christianized: christianized
christmas: christmas
christopher: christopher
chronicle: chronicles
church: church,churches
churchill: churchill
churchman: churchmen
churchmen: churchmen
cid: cid
cincinnati: cincinnati
cinnamon: cinnamon
cipango: cipango
circle: circle
circuit: circuit
circuitous: circuitous
circular: circular
circulation: circulation
circum: circum
circumcision: circumcision
circumference: circumference
circumnavigate: circumnavigate
circumnavigation: circumnavigation
circumstance: circumstances
citadel: citadel
cite: cited,cites
cities: cities
citizen: citizens
citizenship: citizenship
citron: citron
city: cities,city
civil: civil
civilian: civilian
civilization: civilization,civilizations
civilized: civilized
civilizing: civilizing
claim: claim,claimed,claims
clamor: clamored
clara: clara
clark: clark
clash: clashes
class: class,classes
classic: classic,classics
classical: classical
claudio: claudio
clausum: clausum
clay: clay
clean: clean
cleanly: cleanly
clearing: clearings
clement: clement
clergy: clergy
clerical: clerical
climate: climate
climax: climax
cling: clung
clique: clique
clive: clive
close: close,closed,closes,closest,closing
closed: closed
closely: closely
closet: closeted
closing: closing
cloth: cloth,cloths
clothe: clad,clothe
clothes: clothes
clove: clove,cloves
clumsy: clumsy
cluster: cluster,clusters
coal: coals
coalition: coalition
coan: coan
coast: coast,coasted,coasts
coastal: coastal
coat: coat
cock: cock
cocoanut: cocoanut,cocoanuts
code: code,codes
coffee: coffee
cogon: cogon
coin: coin
coincidence: coincidence
cold: cold,colder
colin: colin
collect: collect,collected,collecting
collecting: collecting
collection: collection,collections
collectively: collectively
collector: collectors
college: college,colleges
colonels: colonels
colonial: colonial
colonies: colonies
colonist: colonist,colonists
colonization: colonization
colonize: colonize,colonized,colonizing
colonizer: colonizers
colony: colonies,colony
colophon: colophon
color: color,colored,colors
columbus: columbus
column: column
comandante: comandante
comb: combs
combat: combat
combe: combes
combes: combes
combine: combined,combining
comer: comers
comestible: comestibles
comfort: comforts
coming: coming
command: command,commanded,commanding,commands
commander: commander,commanders
commemorate: commemorated
commence: commence,commenced
commencement: commencement
commerce: commerce
commercial: commercial
commercialism: commercialism
commission: commission,commissioned,commissions
commissioner: commissioner,commissioners
commit: committed
commodity: commodities
commodore: commodore
common: common
commonly: commonly
commons: commons
commonwealth: commonwealth,commonwealths
communicate: communicate,communicated,communicating
communication: communication
community: communities,community
commute: commuted
compact: compact
compania: compania
companion: companions
company: companies,company
comparatively: comparatively
compare: compare,compared
compass: compass
compassionate: compassionate
compatible: compatible
compel: compel,compelled,compels
compensation: compensation
competition: competition
compilation: compilation
complain: complained
complaint: complaints
complete: complete,completed
completely: completely
completion: completion,completions
compliance: compliance
compliant: compliant
complicate: complicated
complicity: complicity
comply: comply,complying
compose: composed
composition: composition
comprehensive: comprehensive
compress: compressed
comprise: comprise,comprises,comprising
compulsory: compulsory
computation: computation
compute: computed
conceal: conceal
concede: conceded
conceive: conceiving
concentrate: concentrated
concept: concept
conception: conceptions
concern: concern,concerned
conclude: concluded
conclusion: conclusion,conclusions
concur: concurred
concurrence: concurrence
condemn: condemned
condemnation: condemnation
condensed: condensed
condition: condition,conditions
conduct: conduct,conducted,conducting
confederate: confederated,confederates
confer: confer
confess: confessed
confession: confession
confidence: confidence
confine: confined
confirm: confirm,confirmed
confirmation: confirmation
confiscate: confiscated
confiscation: confiscation
conflagration: conflagration
conflict: conflict,conflicts
conform: conform
confront: confronted
confuse: confused
confusion: confusion
congress: congress
connect: connect,connected,connects
connection: connection
connivance: connivance
conquer: conquer,conquered,conquering
conqueror: conqueror,conquerors
conquest: conquest,conquests
conquests: conquests
conquistador: conquistadores
conscience: conscience
consent: consent
consequence: consequence,consequences
consequential: consequential
conservatism: conservatism
conservative: conservative
considerable: considerable
considerably: considerably
consideration: consideration
consist: consisted,consisting,consists
consonant: consonant,consonants
conspicuous: conspicuous
conspiracy: conspiracy
conspirator: conspirator,conspirators
constabulary: constabulary
constant: constant
constantine: constantine
constantinople: constantinople
constantly: constantly
constitute: constitute,constituted
constitution: constitution
constitutional: constitutional
construct: construct,constructed,constructing
construction: construction
consulate: consulate
consult: consult,consulted
consume: consume,consumed,consumes
contact: contact
contemplate: contemplate,contemplated
contemplation: contemplation
contemporary: contemporary
contemptuous: contemptuous
content: content
contents: contents
contest: contest,contests
continent: continent,continents
continental: continental
continual: continual
continually: continually
continue: continue,continued,continuing
continued: continued
continuous: continuous
continuously: continuously
contra: contra
contraband: contraband
contract: contract
contradict: contradicted
contrary: contrary
contrast: contrast
contribute: contributed
contribution: contributions
contributor: contributor
control: control,controlled,controlling
controversy: controversy
convenient: convenient
convent: convent,convents
convention: conventions
converse: converse
conversion: conversion,conversions
convert: convert,converted,converts
convey: convey
conviction: convictions
convinced: convinced
convulse: convulse,convulsing
cook: cook,cooked
cooking: cooking
cool: cool
coolie: coolies
copious: copious
copper: copper
copra: copra
copying: copying
copyright: copyright
coral: coral
cordillera: cordillera
cordon: cordon
corn: corn
cornelius: cornelius
corner: corner
cornish: cornish
coromandel: coromandel
corporation: corporation
corps: corps
corral: corrals
correct: correct
correction: correction,corrections
corrections: corrections
correctly: correctly
corregidor: corregidor,corregidors
correo: correo
correspondence: correspondence
correspondingly: correspondingly
corrupt: corrupt
corruption: corruption
corsair: corsair
cortes: cortes
corvee: corvee
cosmographer: cosmographer
cosmography: cosmography
cosmopolitan: cosmopolitan
cost: cost,costs
costly: costly
cotton: cotton
council: council,councils
councillor: councillors
councilor: councilors
counsel: counsel,counseled,counsels
count: count,counted
countenance: countenance
counting: counting
countinghouse: countinghouse
countries: countries
country: countries,country
countryman: countryman,countrymen
county: counties,county
couple: couple,coupled
courage: courage
courageous: courageous
courageously: courageously
court: court,courts
courtesy: courtesy
courts: courts
covenant: covenant
cover: cover,covered,covering
covet: coveted
coveted: coveted
cowardice: cowardice
cowardly: cowardly
craft: craft
create: create,created,creating
creation: creation
creator: creator
credible: credible
credit: credit
creditable: creditable
creese: creese
creeses: creeses
crest: crest,crests
crew: crew,crews
crime: crime,crimes
criminal: criminal
cripple: cripple
crippling: crippling
critical: critical
critically: critically
criticism: criticism
crocodile: crocodile
crop: crop,crops
cross: cross,crossed,crosses,crossing
crowd: crowded
crown: crown
crowning: crowning
crucify: crucified
cruel: cruel
cruelty: cruelty
cruise: cruised,cruising
crusade: crusades
crusader: crusaders
crusaders: crusaders
crusades: crusades
crush: crushed,crushing
cuartel: cuartel
cuba: cuba
cuban: cuban,cubans
cuesta: cuesta
culminate: culminated
culpable: culpable
culprit: culprits
cult: cult
cultivate: cultivated,cultivating
cultivation: cultivation
culture: culture,cultured
cupidity: cupidity
cura: cura
curacy: curacies,curacy
curate: curate,curates
cure: cured,cures
curious: curious
curiously: curiously
curly: curly
currency: currency
current: current,currents
curse: curse
custom: custom,customs
customary: customary
customs: customs
cut: cut,cuts,cutting
da: da
dado: dado
daily: daily
daimio: daimios
damage: damage
damaged: damaged
damages: damages
damask: damask
dampness: dampness
dance: dances
danger: danger,dangers
dangerous: dangerous
dangers: dangers
dante: dante
danube: danube
daring: daring
daringly: daringly
dark: dark
darken: darkened
darkness: darkness
dastardly: dastardly
dato: dato,datos
datos: datos
datum: data
daughter: daughter
david: david
day: day,days
dead: dead
deadly: deadly
deal: deal,dealing,deals,dealt
dealer: dealers
dealings: dealings
dean: dean,deans
death: death,deaths
debar: debarred
debate: debate,debated
debauchery: debauchery
debt: debt,debts
decade: decade,decades
decadence: decadence
decadent: decadent
decay: decay,decayed,decaying
december: december
decently: decently
decide: decide,decided
decision: decision,decisions
decisive: decisive
deck: deck,decked
declaration: declaration
declare: declared,declaring
decline: decline,declined,declining
decorator: decorators
decrease: decreased,decreasing
decree: decree,decreed,decreeing,decrees
dedit: dedit
deductible: deductible
deed: deeds
deep: deep
deepen: deepening
deeply: deeply
deer: deer
defalcation: defalcations
default: default
defaulter: defaulters
defeat: defeat,defeated
defect: defect,defects
defective: defective
defend: defend,defended,defending
defense: defense
defensive: defensive
defer: defer
defiant: defiant
defiantly: defiantly
deficient: deficient
deficit: deficits
define: defined,defining
definition: definitions
defy: defied
degenerate: degenerate
degeneration: degeneration
degrade: degrades
degree: degree,degrees
deity: deities,deity
del: del
delay: delayed,delaying
delegate: delegates
delete: deleted
deletion: deletions
delhi: delhi
deliberately: deliberately
delicate: delicate
delight: delight
delighted: delighted
deliver: delivering
delivery: delivery
delver: delver
demand: demand,demanded,demanding,demands
demarcation: demarcation
democracy: democracy
democrat: democrat
democratic: democratic
demon: demon
demonstrate: demonstrated
demoralization: demoralization
denounce: denounced
dense: densest
deny: denied,deny
department: department,departments
departure: departure
depend: depend,depended,depends
dependence: dependence
dependency: dependency
dependent: dependent,dependents
depiction: depiction
deplorable: deplorable
depopulate: depopulated
depopulation: depopulation
deportation: deportation
depose: deposed
depreciation: depreciation
depredation: depredation
depressed: depressed
depression: depression
deprive: deprive,deprived
der: der
derivation: derivation
derivative: derivative
derive: derive,derived
des: des
descend: descended
descendant: descendants
descent: descent
description: description,descriptions
descriptive: descriptive
desert: desert,deserted
deserving: deserving
design: designed,designs
designate: designate,designated,designating
desirable: desirable
desire: desire,desired,desires
desirous: desirous
desolate: desolate,desolated
despair: despair
desperate: desperate
desperately: desperately
despise: despising
despoil: despoiled,despoiling
destine: destined
destitute: destitute
destroy: destroy,destroyed,destroying
destruction: destruction
destructive: destructive
detach: detach
detachment: detachments
detailed: detailed
detect: detect
deter: deter
determination: determination
determine: determine,determined,determining
determined: determined
detestable: detestable
detriment: detriment
develop: develop,developed,develops
developed: developed
development: development
device: device
devil: devil
devise: devised
devoid: devoid
devon: devon
devote: devote,devoted,devoting
devoted: devoted
devotedly: devotedly
devotion: devotion
devotional: devotional
devout: devout
dewey: dewey
dexterous: dexterous
di: di
dialect: dialect,dialects
diary: diary
dichas: dichas
dictation: dictation
dictatorship: dictatorship
dictionaries: dictionaries
dictionary: dictionaries,dictionary
dido: dido
die: die,died
diego: diego
diet: diet
difference: differences
difficult: difficult
difficulty: difficulties,difficulty
diffuse: diffused
diffused: diffused
dig: dug
digital: digital
dignify: dignify
dignitary: dignitaries
dignity: dignities,dignity
dimension: dimensions
diminish: diminishing
diminution: diminution
din: din
diocesan: diocesan
diocese: diocese
diplomacy: diplomacy
diplomatic: diplomatic
dire: dire
direct: direct,directed,directing
direction: direction,directions
director: director
disadvantage: disadvantages
disaffection: disaffection
disappear: disappear,disappeared
disappoint: disappointed
disappointed: disappointed
disappointment: disappointment
disaster: disaster
disastrous: disastrous
disbelieve: disbelieved
discharge: discharge,discharging
disclaim: disclaim
disclaimer: disclaimer,disclaimers
disclose: disclosed
discontinue: discontinue
discord: discord
discouragement: discouragement
discouraging: discouraging
discouragingly: discouragingly
discover: discover,discovered
discoveries: discoveries
discovery: discoveries,discovery
discretion: discretion
discuss: discussed,discussing
discussion: discussion
disease: disease,diseases
diseases: diseases
disembark: disembarked
disengage: disengaged
disfavor: disfavor
disgrace: disgraced
disgust: disgust
dish: dishes
disintegration: disintegration
disinter: disinterred
disinterested: disinterested
disk: disk
dislodge: dislodge
dismay: dismayed
dismiss: dismiss,dismissed
disorder: disorder,disorders
disorganized: disorganized
dispatch: dispatch,dispatched
dispense: dispense,dispensed,dispenses
dispersal: dispersal
disperse: dispersed
dispirited: dispirited
display: display,displayed,displaying
disposal: disposal
dispose: disposed,disposing
disposed: disposed
disposition: disposition
dispossess: dispossessed
dispute: dispute,disputed,disputes
disseminate: disseminated
dissension: dissension,dissensions
dissolution: dissolution
dissolve: dissolved
distance: distance,distances
distant: distant
distinct: distinct
distinction: distinction
distinctly: distinctly
distinguish: distinguish,distinguished,distinguishes
distinguishing: distinguishing
distress: distress
distressing: distressing
distribute: distribute,distributed,distributing
distribution: distribution
distributor: distributor
district: district,districted,districts
distrust: distrust
disturb: disturb,disturbed
disturbance: disturbance,disturbances
disturbed: disturbed
disunited: disunited
ditch: ditch,ditches
divide: divide,divided,divides
divinity: divinity
division: division
diwata: diwata
dock: docks
doctor: doctor,doctors
doctrine: doctrine,doctrines
document: document,documents
documentary: documentary
dog: dogs
dollar: dollar,dollars
domain: domain
domesticated: domesticated
dominant: dominant
dominate: dominated
domination: domination
dominic: dominic
dominican: dominican,dominicans
dominion: dominion,dominions
donate: donate
donation: donation,donations
donor: donors
door: door,doors
dormant: dormant
dot: dotted
dotted: dotted
double: double,doubled
doubt: doubt,doubted,doubts
doubtless: doubtless
download: downloaded,downloading
downplay: downplayed
dowry: dowry
dozen: dozen
drafting: drafting
drag: dragged
dragon: dragon
drain: drained
drake: drake
dramatic: dramatic
draper: draper
draw: draw,drawn,drew
drawing: drawings
dread: dread,dreaded
dreaded: dreaded
dreadful: dreadful
dream: dream,dreamed
dreary: dreary
dress: dressed
drill: drill
drink: drank
drive: drive,driven,driving,drove
driving: driving
drop: drop,dropped
drum: drum
drunk: drunk
drunkenness: drunkenness
du: du
ducat: ducats
duchy: duchy
duke: duke
dull: dull
durable: durable
durably: durably
dust: dust
dutch: dutch
duty: duties,duty
dwarf: dwarfs
dwell: dwell,dwelling,dwelt
dweller: dwellers
dwelt: dwelt
dwindle: dwindled
dye: dyed
dyewood: dyewood
dynasty: dynasty
eager: eager
eagerness: eagerness
earnestly: earnestly
earnings: earnings
earring: earrings
earth: earth
earthenware: earthenware
earthquake: earthquake
ease: ease
easily: easily
east: east
eastern: eastern
eastward: eastward
easy: easy
eat: ate,eat,eating
eater: eaters
ecclesiastic: ecclesiastic,ecclesiastics
ecclesiastical: ecclesiastical
ecclesiasticism: ecclesiasticism
economic: economic
economically: economically
economy: economy
edge: edge
edict: edict,edicts
edifice: edifices
edit: edited
edition: edition,editions
editor: editor
editorship: editorship
educate: educate,educated
educated: educated
education: education
educational: educational
educator: educators
edward: edward
effective: effective
effectively: effectively
effectiveness: effectiveness
effects: effects
effectually: effectually
efficiency: efficiency
efficient: efficient
effigy: effigy
effort: effort,efforts
egbert: egbert
egg: egg
egypt: egypt
eighteen: eighteen
eighteenth: eighteenth
eighth: eighth
el: el
elaborate: elaborate
elapse: elapse,elapsed
elect: elect,elected
electricity: electricity
electrify: electrified
electronic: electronic
electronically: electronically
elegance: elegance
elegant: elegant
element: element,elements
elementary: elementary
elephant: elephants
elevate: elevate,elevated,elevating
elevated: elevated
elevation: elevation
elude: elude
email: email
embark: embarked
embassy: embassies,embassy
embody: embodying
embrace: embrace,embraced,embracing
embrasure: embrasures
embroidery: embroideries
emerge: emerged,emerging
emigrant: emigrants
emigration: emigration
eminence: eminence
emolument: emoluments
emotion: emotions
emotional: emotional
emperor: emperor,emperors
emperorship: emperorship
emphasize: emphasizing
empire: empire,empires
employ: employed
employee: employee,employees
employment: employments
emporium: emporium
en: en
enable: enable,enabled
encode: encoded,encoding
encomendero: encomendero
encomienda: encomienda,encomiendas
encomiendas: encomiendas
encompass: encompassing
encounter: encounter,encountered,encountering
encourage: encouraged,encouraging
encouragement: encouragement
endeavor: endeavored,endeavors
endless: endless
endow: endowed
endowment: endowment
endure: enduring
enemy: enemies,enemy
energy: energy
enfeebled: enfeebled
enforce: enforce,enforced,enforcing
enforcement: enforcement
engage: engage,engaged
engaged: engaged
engagement: engagement,engagements
engender: engendered
engineer: engineer
engineering: engineering
england: england
english: english
englishman: englishman
englishmen: englishmen
engraving: engraving
enjoy: enjoy,enjoyed
enjoyment: enjoyment
enlightened: enlightened
enlightenment: enlightenment
enlist: enlisted
enmity: enmity
enormous: enormous
enrich: enrich,enriching
enrichment: enrichment
enslave: enslaved,enslaving
enslavement: enslavement
ensue: ensued
ensure: ensuring
enter: enter,entered,entering,enters
enterprise: enterprise,enterprises
enterprising: enterprising
entertained: entertained
entertainment: entertainment
enthusiasm: enthusiasm
enticing: enticing
entire: entire
entity: entity
entrada: entrada
entrance: entrance,entrances
enumeration: enumeration
epidemic: epidemic
episcopal: episcopal
epitome: epitome
epoch: epoch
equal: equal
equality: equality
equally: equally
equator: equator
equatorial: equatorial
equip: equipped,equipping
equipment: equipment,equipments
equipped: equipped
era: era,eras
erect: erected,erecting
erection: erection
erroneous: erroneous
error: error,errors
eruption: eruption,eruptions
escape: escape,escaped,escaping
escarpment: escarpment
escorial: escorial
escort: escort
essay: essay
essential: essential
establish: establish,established,establishing
establishment: establishment,establishments
estado: estado
estate: estates
esteem: esteem
estella: estella
estimate: estimate,estimated
estuary: estuaries,estuary
ethnographic: ethnographic
ethnology: ethnology
euphrates: euphrates
europe: europe
european: european,europeans
evacuation: evacuation
evasion: evasions
evening: evening
event: event,events
eventually: eventually
everyday: everyday
evidence: evidence,evidenced
evident: evident
evidently: evidently
evil: evil,evils
evilly: evilly
evoke: evoked
exact: exact
exaggerate: exaggerated
exalt: exalted
examination: examination,examinations
examine: examine,examined
exasperate: exasperated,exasperating
exceedingly: exceedingly
excellent: excellent
exception: exception,exceptions
exceptional: exceptional
excess: excess
excessive: excessive
exchange: exchange,exchanged,exchanges
excite: excited
excitement: excitement
exciting: exciting
exclaim: exclaimed,exclaims
exclude: exclude,excluded
exclusion: exclusion
exclusive: exclusive
exclusively: exclusively
excommunicate: excommunicated
excommunication: excommunication
excursion: excursions
excuse: excuse
execute: execute,executed
execution: execution,executions
executive: executive
exemplary: exemplary
exempt: exempt,exempted
exercise: exercise,exercised
exertion: exertions
exhaust: exhaust,exhausted
exhaustive: exhaustive
exhibit: exhibit,exhibited
exhume: exhumed
exile: exile,exiled
exist: exist,existed,existing,exists
existence: existence
exorbitant: exorbitant
exorcism: exorcism
expand: expanded
expansion: expansion
expect: expected,expecting
expectation: expectations
expedition: expedition,expeditions
expel: expel,expelled,expelling
expend: expend,expended
expenditure: expenditure,expenditures
expense: expense,expenses
expensive: expensive
experience: experience,experienced
experienced: experienced
experiment: experiment,experiments
expert: expert
expiration: expiration
expire: expired
explain: explained,explaining,explains
explanation: explanation
explode: exploded
exploit: exploit,exploited,exploiting,exploits
exploitation: exploitation
exploration: exploration,explorations
explorations: explorations
explore: explore,explored,exploring
explorer: explorer,explorers
explorers: explorers
export: export,exported,exporting,exports
exportation: exportation
expose: expose,exposed
express: express,expressed
expression: expression,expressions
expulsion: expulsion
extend: extend,extended,extending,extends
extension: extension
extensive: extensive
extensively: extensively
extent: extent
exterior: exterior
extermination: extermination
external: external
extinct: extinct
extinction: extinction
extinguish: extinguish
extirpate: extirpate
extort: extorted
extortion: extortion
extortionate: extortionate
extract: extracts
extraordinary: extraordinary
extravagant: extravagant
extreme: extreme,extremes
extremely: extremely
extremity: extremity
eye: eye,eyes
ezekiel: ezekiel
fabian: fabian
fabric: fabrics
fabulous: fabulous
facility: facility
factor: factor,factors
factory: factories,factory
fail: fail,failed,failing
failure: failure
fair: fair
fairbanks: fairbanks
faith: faith
faithfully: faithfully
fall: fall,fallen,falling,fell
falsity: falsity
fame: fame,famed
famed: famed
familiar: familiar
familiarity: familiarity
family: families,family
famine: famine
famous: famous
fanatical: fanatical
fanaticism: fanaticism
farmer: farmers
farming: farming
farsightedness: farsightedness
farth: farthest
fascinate: fascinate
fascination: fascination
fashion: fashion,fashioned
fast: fast
fastness: fastness
fat: fat
fatality: fatality
fatally: fatally
fate: fate
fated: fated
father: father,fathers
fatuously: fatuously
fault: fault
favor: favor
favorable: favorable
favorably: favorably
favorite: favorites
fear: fear,feared,fears
fearful: fearful
fearless: fearless
fearlessly: fearlessly
feast: feast
feasting: feasting
feat: feats
feather: feather,feathers
feature: feature,features
february: february
federal: federal
federation: federations
fee: fee,fees
feeble: feeble
feebly: feebly
feel: feel,feeling
feeling: feeling,feelings
felix: felix
fell: felling
fellow: fellow
fernando: fernando
ferocious: ferocious
fertile: fertile
fertilize: fertilized
festival: festivals
fetish: fetish,fetishes
feud: feud
feudal: feudal
feudalism: feudalism
fever: fever
fiber: fiber
fidelity: fidelity
fief: fief
field: field,fields
fierce: fierce,fiercest
fiercely: fiercely
fierceness: fierceness
fiery: fiery
fiesta: fiestas
fifteenth: fifteenth
fight: fight,fighting,fights,fought
fighter: fighters
fighting: fighting
figure: figure,figures
file: file,files
filibuster: filibusters
filipina: filipina
filipino: filipino,filipinos
fin: fins
final: final
finally: finally
finance: finance
finances: finances
financial: financial
financier: financiers
finding: finding
fine: fine
finely: finely
finished: finished
firearm: firearm,firearms
firing: firing
firm: firm
firmly: firmly
fiscal: fiscal
fish: fish,fishing
fisherman: fisherman,fishermen
fishery: fisheries
fishing: fishing
fit: fitted,fitting
fitness: fitness
flag: flag
flagship: flagship
flame: flamed
flanders: flanders
flanking: flanking
flattering: flattering
flavoring: flavorings
flee: fled,fleeing
fleet: fleet,fleets
flemish: flemish
flesh: flesh
flexible: flexible
flight: flight
flock: flocked
flood: floods
floor: floor
flora: flora
florence: florence
florida: florida
flourish: flourished
flow: flow,flows
flume: flumes
fly: fly,flying
focus: focus
foe: foes
folk: folk
follow: follow
follower: followers
folly: folly
fond: fond
font: font
food: food,foods
foodstuff: foodstuffs
foot: feet
foothold: foothold
footing: footing
footnote: footnotes
foray: forays
forbid: forbade,forbidden
force: force,forced,forces
foreign: foreign
foreigner: foreigners
foreman: foreman
foremost: foremost
foresee: foresee
foresight: foresight
forest: forest,forests
forestry: forestry
forget: forget
form: form,formed,forming,forms
formal: formal
formality: formality
formally: formally
format: format,formats
formation: formation
formidable: formidable
forsake: forsaken,forsaking
fort: fort,forts
fortification: fortifications
fortified: fortified
fortify: fortified,fortify
fortress: fortress,fortresses
forts: forts
fortunate: fortunate
fortunately: fortunately
fortune: fortune,fortunes
forwarding: forwarding
foster: fostered
foul: foul
foundation: foundation,foundations
founder: founder
founding: founding
foundry: foundry
fourteen: fourteen
fourteenth: fourteenth
fourth: fourth
fowl: fowls
fraction: fraction
frail: frail
frame: frame,framed,framing
france: france
francis: francis
franciscan: franciscan,franciscans
francisco: francisco
frank: frank
franklin: franklin
frankly: frankly
franks: franks
fraternity: fraternity
fray: fray
fred: fred
freebooter: freebooter,freebooters
freedmen: freedmen
freedom: freedom
freely: freely
freight: freighted
french: french
frenchman: frenchmen
frequency: frequency
frequent: frequent,frequented
frequently: frequently
fresh: fresh
freshen: freshened
freshly: freshly
friar: friar,friars
friars: friars
friday: friday
friend: friend,friends
friendliness: friendliness
friendly: friendly
friendship: friendship
frigate: frigate,frigates
frightfully: frightfully
frontier: frontier,frontiers
frontiersman: frontiersman
fruit: fruits
fruitful: fruitful
fruitless: fruitless
fulfil: fulfilled
function: function
functionary: functionaries
fund: funds
fundamental: fundamental
furious: furious
furiously: furiously
furnish: furnish,furnished
furniture: furniture
fury: fury
futile: futile
future: future
gabriel: gabriel
gain: gain,gained,gaining,gains
gallant: gallant
galleon: galleon,galleons
galleons: galleons
galley: galley,galleys
game: games
gamma: gamma
gang: gangs
gange: ganges
garb: garb
garden: garden,gardens
garment: garment,garments
garrison: garrison,garrisons
garrote: garrote
gaspar: gaspar
gate: gate,gates
gateway: gateway
gather: gather,gathered
gathering: gathering
gay: gay
gem: gems
generation: generation,generations
generosity: generosity
generous: generous
generously: generously
geneva: geneva
genius: genius
genoa: genoa
genoese: genoese
gentiles: gentiles
gentleman: gentlemen
geodetic: geodetic
geographer: geographer,geographers
geographical: geographical
geographically: geographically
geography: geographies,geography
german: german,germans
germany: germany
ghana: ghana
gibbon: gibbon
gift: gift,gifts
gifted: gifted
gigantic: gigantic
gil: gil
ginger: ginger
girl: girls
glass: glass
glazed: glazed
globe: globe
gloomy: gloomy
glorify: glorify
glory: glory
goa: goa
goal: goals
goat: goats
gobi: gobi
goblet: goblet
god: god
gold: gold
gong: gong,gongs
gonzalo: gonzalo
goodly: goodly
goose: geese
gospel: gospel
goths: goths
govern: govern,governed,governs
governing: governing
government: government,governments
governor: governor,governors
governorship: governorship,governorships
graceful: graceful
grade: grade,graded
gradual: gradual
gradually: gradually
grammar: grammars
grand: grand
grande: grande
grandfather: grandfather
grandson: grandson
grant: grant,granted,granting
granting: granting
graphic: graphic
grassy: grassy
gratefully: gratefully
gratify: gratifying
grave: grave
greatly: greatly
grecian: grecian
greed: greed
greedy: greedy
greek: greek,greeks
green: green
gregory: gregory
grenada: grenada
grievance: grievances
grieve: grieves
grievous: grievous
gross: gross
ground: ground
grounds: grounds
grove: groves
grow: grew,grow,growing,grown
growing: growing
growth: growth
guam: guam
guarantee: guarantee,guaranteed
guard: guard,guarded,guards
guardian: guardian
gue: gue
guess: guess
guest: guests
guidance: guidance
guide: guide,guided,guides
guido: guido
guillermo: guillermo
guilty: guilty
guinea: guinea
guitar: guitar
gulf: gulf
gum: gums
gun: gun,guns
gunboat: gunboats
gunner: gunners
ha: ha
habit: habit
habitat: habitat
habitation: habitations
hacienda: hacienda,haciendas
hail: hailed
hair: hair
haired: haired
haiti: haiti
halfway: halfway
hall: hall
halt: halt
hamal: hamal
hamlet: hamlet
hand: hand,handed,hands
handed: handed
handicraft: handicraft
handle: handle
handsome: handsome
handwriting: handwriting
handy: handy
hang: hangs,hung
happen: happened
happily: happily
happiness: happiness
harass: harassed
harbor: harbor,harbored,harbors
hard: hard,harder
hardihood: hardihood
hardship: hardship,hardships
harmless: harmless
harmony: harmony
harp: harp
harry: harrying
harshness: harshness
hart: hart
harvard: harvard
harvest: harvest,harvests
hasten: hastened
hastily: hastily
hate: hated
hatred: hatred
haunt: haunt,haunted
havana: havana
hawaiian: hawaiian
haystack: haystack
hazardous: hazardous
head: head,headed,heads
headhunter: headhunters
headland: headlands
headquarters: headquarters
headwater: headwaters
health: health
healthy: healthy
hear: hear,heard,hears
heart: heart,hearts
hearted: hearted
heartily: heartily
hearty: hearty
heathen: heathen
heathenism: heathenism
heaven: heaven
heavenly: heavenly
heavily: heavily
heavy: heavy
hebrew: hebrew
hebrewism: hebrewism
heedless: heedless
height: height
heir: heir,heirs
helmet: helmet
helpful: helpful
helpless: helpless
hem: hem,hemmed
hemisphere: hemisphere,hemispheres
hemp: hemp
henry: henry
herd: herds
hereditary: hereditary
heresy: heresy
heretic: heretic,heretics
heretical: heretical
heretofore: heretofore
heritage: heritage
hermit: hermit
hermitage: hermitage
hero: hero
heroic: heroic
hesitate: hesitated,hesitating
hewing: hewing
hic: hic
hide: hides
highborn: highborn
highly: highly
hill: hill,hills
hillman: hillmen
hillside: hillsides
hindu: hindu
hinduism: hinduism
hindus: hindus
hispaniola: hispaniola
historian: historian,historians
historic: historic
historical: historical
historically: historically
history: histories,history
hitherto: hitherto
ho: ho
hog: hogs
hold: held,hold,holding,holds
holder: holder
holding: holding
hole: holes
holland: holland
hollanders: hollanders
holy: holier,holy
homely: homely
homeward: homeward
honda: honda
honestly: honestly
honesty: honesty
honey: honey
hongkong: hongkong
honor: honor,honored,honors
honorable: honorable
honorably: honorably
hope: hope,hoped,hopes,hoping
hopeful: hopeful
horde: hordes
horizon: horizon
horn: horns
horrible: horrible
horribly: horribly
horror: horror
horse: horse,horses
horseback: horseback
horseman: horsemen
hospital: hospital,hospitals
hospitals: hospitals
hostile: hostile
hostilities: hostilities
hostility: hostilities,hostility
hour: hour,hours
house: house,houses
household: household
howitzer: howitzer
hudson: hudson
huge: huge
human: human
humane: humane
humanely: humanely
humanitarian: humanitarian
humble: humble,humbled
humbly: humbly
humiliating: humiliating
humiliation: humiliation
hunger: hunger
huns: huns
hunt: hunt,hunting
hunter: hunters
hunting: hunting
hurl: hurled
husband: husband,husbands
husbandman: husbandman
husk: husk
hut: hut
hydrographic: hydrographic
ibanag: ibanag
ibilao: ibilao
ice: ice
ide: ide
idea: idea,ideas
ideal: ideal,ideals
ideas: ideas
identification: identification
identify: identify
idol: idols
idolatrous: idolatrous
ifugao: ifugao
ignatius: ignatius
ignorance: ignorance
ignorant: ignorant
igorot: igorot
iii: iii
illano: illano
illegal: illegal
illiberal: illiberal
illustrate: illustrate,illustrated,illustrating
illustration: illustrations
illustrious: illustrious
ilocano: ilocano
image: image,images
imagine: imagine,imagined
imagining: imaginings
imbitter: imbitter,imbittered
imbue: imbued
imitation: imitation
immeasurably: immeasurably
immemorial: immemorial
immense: immense
immensely: immensely
immigration: immigration
immortal: immortal
impassioned: impassioned
impatient: impatient
imperative: imperative
imperfectly: imperfectly
imperial: imperial
imperialism: imperialism
impetuous: impetuous
impetus: impetus
implicate: implicated
imply: implied
impolitic: impolitic
import: import,imported,imports
importation: importation,importations
impose: impose,imposed,imposing
imposing: imposing
impossible: impossible
impost: imposts
impotent: impotent
impregnable: impregnable
impressed: impressed
impressive: impressive
imprint: imprinted
imprison: imprisoned
imprisonment: imprisonment
improve: improve,improved,improving
improvement: improvement,improvements
improvements: improvements
impulse: impulse
inability: inability
inaccurate: inaccurate
inactivity: inactivity
inadequate: inadequate
inaugurate: inaugurated
incalculable: incalculable
incapacity: incapacity
incense: incensed
incentive: incentive
incessant: incessant
incidental: incidental
incite: incited,inciting
inclination: inclination
incline: inclined
inclose: inclosed
include: include,included,includes,including
including: including
income: income
incomparable: incomparable
incomparably: incomparably
incompatible: incompatible
incomplete: incomplete
incorporate: incorporating
incorporated: incorporated
incorruptible: incorruptible
increase: increase,increased,increasing
incredible: incredible
incur: incur
indebted: indebted
indefinitely: indefinitely
indemnify: indemnify
indemnity: indemnity
independence: independence
independent: independent
independently: independently
indescribable: indescribable
india: india
indian: indian,indians
indies: indies
indifference: indifference
indignantly: indignantly
indignity: indignity
indirect: indirect
indirectly: indirectly
indispensable: indispensable
individual: individual,individuals
induce: induced,inducing
inductive: inductive
indulge: indulged
indus: indus
industrial: industrial
industrious: industrious
industry: industries,industry
ineffective: ineffective
ineffectiveness: ineffectiveness
inertia: inertia
inexpressible: inexpressible
inf: infest
infallibly: infallibly
infant: infants
infante: infante
infantry: infantry
inferior: inferior
inferiority: inferiority
infidel: infidel
infidelity: infidelity
infinite: infinite
infirm: infirm
infirmary: infirmary
inflame: inflame,inflamed
inflamed: inflamed
inflict: inflict
influence: influence,influenced,influences
influential: influential
inform: informed,informs
informed: informed
infraction: infractions
infringe: infringe
infringement: infringement
infuriate: infuriated
infuse: infuse
inhabit: inhabit,inhabited
inhabitant: inhabitants
inherit: inherited
inheritance: inheritance,inheritances
inhuman: inhuman
inhumanity: inhumanity
inhumanly: inhumanly
injudiciously: injudiciously
injure: injured
injury: injury
injustice: injustice
ink: ink
inn: inn
innumerable: innumerable
inquire: inquire
inquiry: inquiry
inquisition: inquisition
inquisitor: inquisitor
insane: insane
insignificant: insignificant
insist: insisted,insisting
inspector: inspector
inspiration: inspiration
inspire: inspire,inspired
inspiring: inspiring
instance: instance,instances
instantly: instantly
institution: institution,institutions
instruct: instructed
instruction: instruction,instructions
instrument: instrument,instruments
insufficient: insufficient
insular: insular
insurance: insurance
insurgent: insurgent,insurgents
insurrection: insurrection
integral: integral
integrity: integrity
intellectual: intellectual
intelligence: intelligence
intelligent: intelligent
intend: intended
intendencia: intendencia
intense: intense
intensify: intensified
intent: intent
intention: intentions
inter: interred
intercept: intercept,intercepted
interchange: interchange
intercourse: intercourse
interfere: interfere
interference: interference
interior: interior,interiors
intermediate: intermediate
internal: internal
international: international
internet: internet
interpret: interpret,interpreted
interpreter: interpreter
interrogate: interrogated
interrupt: interrupted
interruption: interruption
intersect: intersected
interval: interval
intervene: intervening
intimidate: intimidate
intimidation: intimidation
intolerance: intolerance
intoxication: intoxication
intrepid: intrepid
intrigue: intrigue,intrigues
introduce: introduce,introduced
introduction: introduction
introductory: introductory
intruder: intruder
intrust: intrust,intrusted
invade: invade,invaded,invading
invader: invaders
invalid: invalid
invalidity: invalidity
invaluable: invaluable
invariably: invariably
invasion: invasion
invent: invented
invest: invested
investigate: investigate
investigation: investigation,investigations
invite: invited,inviting
involve: involved
involved: involved
inwardly: inwardly
iron: iron
ironical: ironical
irreconcilable: irreconcilable
irregular: irregular
irresistible: irresistible
irresistibly: irresistibly
irretrievable: irretrievable
irrigation: irrigation
irritatingly: irritatingly
irs: irs
isabel: isabel
isabella: isabella
islam: islam
island: island,islands
islander: islanders
islands: islands
isles: isles
islet: islets
isolate: isolate,isolated
isolated: isolated
isolation: isolation
issue: issued
isthmus: isthmus
ita: ita
italian: italian
italon: italon
italy: italy
iv: iv
ivory: ivory
ix: ix
jail: jail
james: james
jan: jan
janeiro: janeiro
january: january
japan: japan
japanese: japanese
jar: jars
java: java
javanese: javanese
jealous: jealous
jealousy: jealousies,jealousy
jerusalem: jerusalem
jesuit: jesuit
jesuits: jesuits
jesus: jesus
jews: jews
john: john
joseph: joseph
journal: journal
journalism: journalism
journey: journey,journeys
joy: joy
joyfully: joyfully
ju: ju
juan: juan
judge: judge,judges
judgment: judgment,judgments
judicial: judicial
julian: julian
july: july
june: june
jungle: jungle,jungles
junk: junk,junks
junks: junks
junta: junta,juntas
jurisdiction: jurisdiction
jurist: jurist
justice: justice,justices
justification: justification
justified: justified
justify: justified,justify
justly: justly
kafirs: kafirs
katipunan: katipunan
keen: keen,keenest
kenton: kenton
kentucky: kentucky
kill: kill,killed,killing
kindly: kindly
kindness: kindness
king: king,kings
kingdom: kingdom,kingdoms
kinky: kinky
knickknack: knickknacks
knife: knives
knight: knight,knights
knights: knights
knowledge: knowledge
koran: koran
kris: kris
kua: kua
kue: kue
kyoto: kyoto
labor: labor,labored,labors
laboratories: laboratories
laboratory: laboratories
laborer: laborers
laborious: laborious
labrador: labrador
lack: lack,lacking
laden: laden
ladrone: ladrone
ladrones: ladrones
lady: ladies,lady
laguna: laguna
lair: lairs
lake: lake
lamentable: lamentable
lanao: lanao
lance: lance,lances
land: land,landed,landing,lands
landing: landing
lands: lands
language: language,languages
languages: languages
lantaka: lantaka
lao: lao
lapse: lapsed
las: las
lastly: lastly
late: late
latent: latent
latin: latin
latitude: latitude
launch: launched
lava: lava
law: law,laws
lawrence: lawrence
laws: laws
lawton: lawton
laxity: laxity
lay: laid,lay
lazarus: lazarus
le: le
lead: lead,leading,leads,led
leader: leader,leaders
leadership: leadership
leaf: leaf,leaves
league: league,leagues
learn: learn,learned,learning
learning: learning
leather: leather
leave: leave,leaving,left
lecture: lectures
left: left
leg: leg
legal: legal
legally: legally
legislate: legislate
legislating: legislating
legislation: legislation
legislative: legislative
legislature: legislature,legislatures
lei: lei
lend: lending
lending: lending
lengthen: lengthened
lenient: lenient
leon: leon
leonardo: leonardo
leone: leone
lepanto: lepanto
leper: leper,lepers
lessen: lessen
lesson: lesson,lessons
lessons: lessons
letter: letter,letters
lettering: lettering
levant: levant
level: level
levy: levied
ley: ley
liability: liability
liable: liable
lib: lib
liberal: liberal
liberality: liberality
liberalize: liberalize,liberalized,liberalizing
liberate: liberated
liberation: liberation
liberty: liberty
library: libraries,library
license: license
licensed: licensed
lie: lie,lies,lying
lieu: lieu
lieutenant: lieutenant,lieutenants
life: life,lives
lifetime: lifetime
lift: lift,lifted
light: light,lights
lighted: lighted
liking: liking
lima: lima
lime: lime
limit: limit,limited,limiting,limits
limitation: limitation,limitations
limited: limited
lineage: lineage
linen: linen,linens
linger: linger,lingered
link: linked,links
lino: lino
lip: lips
lisbon: lisbon
list: list
literary: literary
literati: literati
literature: literature,literatures
live: live,lived,lives,living
livestock: livestock
living: living
lo: lo
load: loaded
loathsome: loathsome
lobo: lobo
local: local
locality: locality
locate: located
location: location,locations
locksmith: locksmiths
lodge: lodge
lofty: loftier,loftiest,lofty
log: log
logical: logical
london: london
longitude: longitude
loose: loose
loosen: loosening
loosening: loosening
loot: loot,looted,looting
looting: looting
lord: lord,lords
lords: lords
lorenzo: lorenzo
lose: lose,losing,lost
loss: loss,losses
lot: lot
louisiana: louisiana
love: love
lowland: lowlands
lowlands: lowlands
loyal: loyal
loyalty: loyalty
lucia: lucia
luckless: luckless
lucrative: lucrative
luis: luis
luke: luke
luna: luna
lurk: lurking
lust: lust
luther: luther
luxurious: luxurious
luxury: luxuries,luxury
macao: macao
macassar: macassar
macedonian: macedonian
machine: machine
machinery: machinery
madagascar: madagascar
madeira: madeira
madeiras: madeiras
madras: madras
madre: madre
madrid: madrid
maestro: maestro
magazine: magazine
magellan: magellan
magistrate: magistrate
magnificence: magnificence
magnificent: magnificent
magnificently: magnificently
magnify: magnified
mail: mail,mailed
main: main
maine: maine
mainland: mainland
mainspring: mainspring
maintain: maintain,maintained,maintaining
maintenance: maintenance
maize: maize
majesty: majesty
major: major
majority: majority
maker: maker
malabar: malabar
malacca: malacca
malagasy: malagasy
malate: malate
malay: malay
malayan: malayan,malayans
malays: malays
malaysia: malaysia
malaysian: malaysian
malignant: malignant
malta: malta
manage: manage,managed
management: management
manchus: manchus
mandarin: mandarins
mandate: mandates
mangrove: mangrove
manhood: manhood
manifest: manifested
manila: manila
mankind: mankind
manned: manned
manner: manner
manners: manners
manobo: manobo
manuel: manuel
manufacture: manufacture
manufacturer: manufacturers
manufacturing: manufacturing
manuscript: manuscript
map: map,mapped,maps
maps: maps
mar: mar,marred
marauder: marauders
marcello: marcello
march: march,marched,marching
marching: marching
marco: marco
mare: mare,mares
margin: margin
maria: maria
marina: marina
marine: marine
mariner: mariners
maritime: maritime
mark: mark,marked,marks
marked: marked
markedly: markedly
market: market,markets
maroon: marooned
marquis: marquis
marriage: marriage
marry: married,marry
marsh: marshes
marshal: marshal,marshals
mart: mart,marts
martin: martin
martinez: martinez
marvellously: marvellously
marvelous: marvelous
mas: mas
mason: masons
masonic: masonic
masonry: masonry
mass: mass,masses
massacre: massacre
mast: masts
master: master,mastered,masters
masterful: masterful
mastery: mastery
mat: mats
material: material,materials
materialize: materialized
materially: materially
matter: matter,matters
maximum: maximum
mayor: mayor
meaning: meanings
measure: measure,measures
meat: meat
mecati: mecati
mechanical: mechanical
medicine: medicine
medina: medina
mediterranean: mediterranean
medium: medium
meet: meet,met
meeting: meeting
melanesia: melanesia
melanesian: melanesian
membership: membership
memorable: memorable
memorial: memorial
memory: memory
menace: menace
mental: mental
mention: mention,mentioned
merchandise: merchandise,merchandises
merchant: merchant,merchants
merchants: merchants
merciful: merciful
mercifully: mercifully
merciless: merciless
mercy: mercy
mere: mere
meridian: meridian
merino: merino
mesopotamia: mesopotamia
message: message
mestizo: mestizos
metal: metal,metals
meteorology: meteorology
method: method,methods
metric: metric
metropolis: metropolis
mexican: mexican,mexicans
mexico: mexico
mi: mi,mis
michael: michael
micronesia: micronesia
micronesian: micronesian
middle: middle
mighty: mighty
migration: migration
migratory: migratory
miguel: miguel
mikado: mikado
milan: milan
mile: mile,miles
military: military
militia: militia
mind: mind,minds
minded: minded
ming: ming
mingle: mingled,mingling
mingling: mingling
minimize: minimize
mining: mining
minister: minister,ministered,ministers
ministration: ministration,ministrations
ministry: ministry
minor: minor
minute: minute
miraculous: miraculous
misapprehension: misapprehension
mischief: mischief
misdirect: misdirected
miserable: miserable
miserably: miserably
misery: misery
misfortune: misfortune,misfortunes
misrule: misrule
mission: mission,missions
missionary: missionaries,missionary
mississippi: mississippi
mist: mist
mistake: mistake,mistakes,mistook
mistaken: mistaken
mistress: mistress
misunderstand: misunderstanding
misunderstanding: misunderstanding
mitigate: mitigated
mitigation: mitigation
mix: mixed
mixed: mixed
moat: moats
mob: mob
mode: mode
model: models
moderate: moderate
modern: modern
modernize: modernized
modification: modification
modify: modified,modify
mogul: mogul
mohammed: mohammed
mohammedan: mohammedan
mohammedanism: mohammedanism
molest: molesting
molto: molto
molucca: molucca
moment: moment,moments
monarch: monarch,monarchs
monarchical: monarchical
monarchs: monarchs
monarchy: monarchies,monarchy
monastery: monasteries,monastery
monastic: monastic
monasticism: monasticism
money: money
mongol: mongol
mongols: mongols
monk: monks
monkey: monkeys
monopolize: monopolizing
monopoly: monopoly
monotony: monotony
monroe: monroe
monsoon: monsoon,monsoons
monte: monte
montero: montero
month: month,months
monument: monument,monuments
mood: mood
moon: moon
moor: moors
moors: moors
moral: moral
morales: morales
morality: morality
morga: morga
mormon: mormon
morning: morning
moro: moro
morocco: morocco
morones: morones
morris: morris
morrow: morrow
mortality: mortality
moses: moses
mota: mota
mother: mother
motion: motion
motive: motives
motto: motto
mount: mount,mounted,mounting
mountain: mountain,mountains
mountaineer: mountaineers
mountainous: mountainous
mountains: mountains
mouth: mouth
movement: movement,movements
mulberry: mulberry
mule: mules
multitude: multitude
municipal: municipal
municipality: municipalities,municipality
munitions: munitions
murder: murder,murdered,murdering
murillo: murillo
murphy: murphy
muscular: muscular
museum: museum
musical: musical
musk: musk
musket: muskets
musketeer: musketeers
mussel: mussels
mutinous: mutinous
mutiny: mutiny
mutual: mutual
mysterious: mysterious
mystery: mysteries
myth: myth
mythical: mythical
mythological: mythological
nagasaki: nagasaki
naked: naked
naming: naming
naples: naples
napoleon: napoleon
narrate: narrated
narrative: narrative
narrow: narrow
narrowly: narrowly
nation: nation,nations
national: national
nationalist: nationalist
nationality: nationality
native: native,natives
natural: natural
naturalist: naturalists
naturally: naturally
nature: nature
naval: naval
navigation: navigation
navigator: navigator,navigators
navy: navies,navy
necessaries: necessaries
necessitate: necessitated,necessitates
necessity: necessity
neck: neck
needle: needles
neglect: neglect,neglected
negligence: negligence
negligent: negligent
negotiate: negotiated,negotiating
negotiation: negotiations
negrito: negrito
negro: negro,negroes
negroes: negroes
negros: negros
neighbor: neighbors
neighborhood: neighborhood
neighboring: neighboring
nest: nest,nests
netherlands: netherlands
network: network
neutral: neutral
newly: newly
news: news
newsletter: newsletter
newspaper: newspaper,newspapers
night: night
nightly: nightly
nineteenth: nineteenth
nipa: nipa
nobility: nobility
noble: noble,nobles,noblest
nominally: nominally
nominate: nominate,nominated
nonproprietary: nonproprietary
normal: normal
north: north
northeast: northeast
northeasterly: northeasterly
northeastward: northeastward
northern: northern
northward: northward
northwards: northwards
northwest: northwest
notable: notable
note: note,notes
noteworthy: noteworthy
notice: notice,noticed
notify: notifies
notorious: notorious
noun: nouns
november: november
novus: novus
nowadays: nowadays
nucleus: nucleus
nullify: nullified
numeral: numerals
numerous: numerous
nun: nuns
nurse: nurse,nurses
nurture: nurtured
nut: nuts
nutmeg: nutmeg
oar: oars
oarsman: oarsmen
oasis: oasis
oath: oath
obedience: obedience
obey: obey
obispo: obispo
object: object,objects
objective: objective
obligation: obligation,obligations
oblige: obliged
obscure: obscure
obscurity: obscurities,obscurity
observation: observation
observatory: observatory
observe: observed
obsolete: obsolete
obtainable: obtainable
occasion: occasion,occasioned,occasions
occasional: occasional
occasionally: occasionally
occupation: occupation,occupations
occupy: occupied,occupy,occupying
occur: occur,occurred
occurrence: occurrence,occurrences
ocean: ocean,oceans
oceanic: oceanic
october: october
odium: odium
offer: offer,offered,offers
office: office,offices
officer: officer,officered,officers
official: official,officials
oil: oil
oklahoma: oklahoma
oman: oman
ominous: ominous
online: online
onset: onset
openly: openly
operate: operating
operation: operations
opinion: opinion,opinions
opponent: opponent,opponents
opportunity: opportunities,opportunity
oppose: oppose,opposed
opposed: opposed
opposition: opposition
oppress: oppressed
oppressed: oppressed
oppression: oppression
oppressive: oppressive
oral: oral
orang: orang
orange: oranges
orator: orator
orderly: orderly
ordinarily: ordinarily
ordinary: ordinary
organ: organ
organization: organization,organizations
organizations: organizations
organize: organize,organized,organizing
organized: organized
organizer: organizer
orient: orient
origin: origin
original: original
originally: originally
originate: originate,originated,originating
originator: originator
ornament: ornament,ornamented,ornaments
ornamental: ornamental
orphan: orphan
orphanage: orphanage,orphanages
orthodox: orthodox
orthodoxy: orthodoxy
orthography: orthography
ostentation: ostentation
otis: otis
ottomans: ottomans
outbreak: outbreak
outcome: outcome
outdated: outdated
outline: outlines,outlining
outnumber: outnumbered,outnumbering
outpost: outpost
outrage: outrage,outrages
outrageous: outrageous
outrigger: outrigger
outsail: outsailed
outward: outward
outweigh: outweighed
overawe: overawe
overcome: overcame,overcome
overcrowding: overcrowding
overdrawn: overdrawn
overestimate: overestimated
overhaul: overhauled
overland: overland
overlook: overlooked
overlord: overlord
overpower: overpowering
overpowering: overpowering
overrun: overrun
overseer: overseers
overthrow: overthrew,overthrow,overthrown
overture: overtures
overwhelm: overwhelm,overwhelmed
overwhelmed: overwhelmed
overwhelming: overwhelming
overwork: overworked
owe: owe,owed,owes
owner: owner,owners
ownership: ownership
oxford: oxford
pablo: pablo
pacific: pacific
pacification: pacification
pacify: pacified,pacify
paco: paco
padre: padre
padres: padres
pagan: pagan,pagans
paint: painted
painter: painters
painting: painting,paintings
pais: pais
palace: palace,palaces
paler: paler
palestine: palestine
palm: palm,palms
pampanga: pampanga
pampangan: pampangan
pampango: pampango
pamphlet: pamphlet,pamphlets
pan: pans
panama: panama
pander: pandering
pangasinan: pangasinan
panic: panic
papacy: papacy
papal: papal
paper: paper,papers
papers: papers
paperwork: paperwork
papua: papua
papuan: papuan,papuans
par: par
para: para
paragraph: paragraph,paragraphs
paraguay: paraguay
parallel: paralleled
paralyze: paralyzed,paralyzing
pardo: pardo
pardon: pardon,pardoned
parent: parent,parents
parentage: parentage
parian: parian
paris: paris
parish: parish,parishes
parliament: parliament
parliamentary: parliamentary
parma: parma
parte: parte
partiality: partiality
partially: partially
participant: participants
participate: participate,participated
participation: participation
partisan: partisan
partition: partition,partitioned
partly: partly
party: parties,party
pascual: pascual
paseo: paseo
pass: pass,passed,passes,passing
passage: passage,passages
passenger: passengers
passer: passers
passing: passing
passion: passion,passions
passionate: passionate
passionately: passionately
pastoral: pastoral
paternal: paternal
path: path
patience: patience
patient: patient
patriot: patriots
patriotic: patriotic
patriotism: patriotism
patron: patron
patronage: patronage
pattern: pattern,patterns
paul: paul
paula: paula
pay: paid,pay,paying
payable: payable
payment: payment,payments
peace: peace,peaces
peaceable: peaceable
peaceful: peaceful
pearl: pearl,pearls
peasant: peasant
peasantry: peasantry
peculation: peculation,peculations
peculiar: peculiar
peculiarity: peculiarities
peculiarly: peculiarly
pedagogical: pedagogical
pedro: pedro
pekin: pekin
peking: peking
pelew: pelew
pen: pen
penalty: penalties,penalty
penetrate: penetrated
peninsula: peninsula
penitent: penitent
people: people,peopled,peoples
peoples: peoples
pepper: pepper
perceive: perceive
perfect: perfect,perfecting
perfection: perfection
perform: perform,performed,performing
performance: performance,performances
peril: peril,perils
perilous: perilous
period: period,periods
periodic: periodic
periodical: periodicals
periodically: periodically
perish: perish,perished
permanence: permanence
permanent: permanent
permanently: permanently
permission: permission
permit: permit,permits,permitted
perpetual: perpetual
perpetuate: perpetuate
perry: perry
persecute: persecuted
persecution: persecution,persecutions
persia: persia
persian: persian,persians
persist: persists
persistence: persistence
persistent: persistent
persistently: persistently
person: people,person,persons
personal: personal
pertain: pertaining
peru: peru
peso: peso,pesos
pest: pest
peters: peters
petition: petition,petitioned,petitioning,petitions
petty: petty
phase: phase
philip: philip
philippine: philippine
philippines: philippines
philologist: philologist
philosopher: philosophers
philosophy: philosophy
phonetic: phonetic
phrase: phrase
physical: physical
physician: physician,physicians
pi: pi
pick: pick
picket: pickets
picture: picture
picturesque: picturesque
picul: piculs
piece: piece,pieces
piety: piety
pig: pig,pigs
pilar: pilar
pile: piles
pillage: pillage
pillaging: pillaging
pillory: pillories,pillory
pilot: pilot,piloted
pine: pine
pint: pints
pintados: pintados
pioneer: pioneers
pious: pious
piracy: piracies,piracy
pirate: pirate,pirates,pirating
pirates: pirates
piratical: piratical
pisa: pisa
pitched: pitched
piteous: piteous
pitiless: pitiless
plain: plain,plains
plan: plan,planned,planning,plans
plane: plane
planet: planets
plant: plant,planted,planting,plants
planting: planting
plateau: plateau
play: play,played
playa: playa
plaza: plaza,plazas
pleasant: pleasant
pledge: pledged
plot: plot,plots,plotted,plotting
plotter: plotters
plume: plumes
plunder: plunder,plundered
po: po
poblacion: poblacion
pocket: pocket
poem: poems
poet: poet
poetry: poetry
police: police
policy: policy
polished: polished
politeness: politeness
political: political
politically: politically
politician: politician,politicians
politico: politico,politicos
politics: politics
polo: polo,polos
polynesian: polynesian
pomp: pomp
ponce: ponce
pontiff: pontiff
pontifical: pontifical
pony: pony
poor: poor,poorest
pope: pope
populace: populace
popular: popular
popularity: popularity
populate: populated
populated: populated
population: population,populations
populous: populous
por: por
porcelain: porcelain
pork: pork
port: port,ports
portable: portable
porter: porters
portion: portion,portioned,portions
porto: porto
ports: ports
portugal: portugal
portuguese: portuguese
position: position,positions
possess: possess,possessed,possesses
possession: possession,possessions
possibility: possibilities,possibility
post: post,posted,posts
postern: postern,posterns
posts: posts
pot: pots
potato: potato
pottery: pottery
poultry: poultry
pound: pounded
pour: poured,pouring
poverty: poverty
powder: powder
power: power,powers
powerful: powerful
powerless: powerless
practicable: practicable
practical: practical
practically: practically
practice: practice,practiced,practices
praise: praise
prao: prao,praos
prayer: prayers
preach: preach,preached,preaching
preacher: preachers
preaching: preaching
precede: preceded,preceding
precedent: precedent
precious: precious
precipitate: precipitated
precipitous: precipitous
precisely: precisely
precision: precision
predecessor: predecessor,predecessors
preface: preface
prefer: prefer
preference: preference
prehistoric: prehistoric
prejudice: prejudice,prejudices,prejudicing
prejudicial: prejudicial
prelate: prelate,prelates
preliminary: preliminary
premium: premiums
preparation: preparation,preparations
preparatory: preparatory
prepare: prepare,prepared,preparing
preparedness: preparedness
prepay: prepaid
prescribe: prescribed
presence: presence
presentation: presentation
presently: presently
preservation: preservation
preserve: preserve,preserved,preserving
preside: presided
president: president
presidio: presidio,presidios
press: press,pressed,pressing
prestige: prestige
pretension: pretensions
pretty: pretty
prevail: prevail,prevailed,prevailing,prevails
prevalence: prevalence
prevalent: prevalent
prevent: prevent,prevented
previous: previous
prey: prey,preying
price: price,prices
priceless: priceless
pride: pride
priest: priest,priests
priestess: priestesses
priesthood: priesthood
priests: priests
primary: primary
primer: primer
primitive: primitive
primo: primo
primus: primus
prince: prince,princes
princess: princess
principal: principal
principality: principalities,principality
principle: principle,principles
print: print,printed
printer: printers
printing: printing
prison: prison,prisons
prisoner: prisoner,prisoners
private: private
privateer: privateer
privilege: privilege,privileges
privileged: privileged
prize: prize,prized,prizes
probable: probable
procedure: procedure
proceed: proceed,proceeded,proceeding
proceedings: proceedings
process: process,processes
processing: processing
proclaim: proclaimed
proclamation: proclamation
procure: procure,procured
produce: produce,produced,producing
product: product,products
production: production,productions
productive: productive
profane: profaned
profess: professed,professing
profession: profession,professions
professor: professor
profit: profit,profits
profitable: profitable
profitless: profitless
profound: profound
profoundly: profoundly
progress: progress,progressed,progressing
progressive: progressive
prohibit: prohibit
prohibition: prohibition,prohibitions
project: project,projects
prominence: prominence
prominent: prominent
prominently: prominently
promise: promise,promised,promises,promising
promising: promising
promote: promoted,promoting
promotion: promotion
prompt: prompt
pronounce: pronounce,pronounced,pronouncing
pronunciation: pronunciation,pronunciations
proof: proof
proofread: proofread
proofreading: proofreading
propagation: propagation
proper: proper
properly: properly
property: properties,property
prophet: prophet
prophetic: prophetic
propitiate: propitiate
proportion: proportion,proportions
propose: proposed
proprietary: proprietary
prosecute: prosecuted,prosecuting
prosecution: prosecution
prospect: prospect
prosperity: prosperity
prosperous: prosperous
protect: protect,protected,protects
protection: protection
protective: protective
protector: protectors
protest: protest,protested,protests
protestant: protestant,protestants
protestantism: protestantism
proudly: proudly
prove: proved,proven
provide: provide,providing
province: province,provinces
provincial: provincial
provision: provision,provisioned,provisions
provisional: provisional
prowl: prowled
proximity: proximity
ptolemy: ptolemy
pu: pu
public: public
publica: publica
publication: publication,publications
publicly: publicly
publish: published
publishers: publishers
pueblo: pueblo,pueblos
puerto: puerto
punish: punish,punished,punishing
punishment: punishment,punishments
punitive: punitive
punta: punta
pupil: pupil,pupils
purchase: purchase,purchased
pure: pure
purely: purely
purify: purifying
purity: purity
purpose: purpose,purposes
purse: purse
pursue: pursue,pursued,pursuing
pursuer: pursuers
pursuit: pursuit,pursuits
push: pushed
pygmy: pygmies
quaint: quaint
quality: qualities,quality
quantity: quantities,quantity
quarrel: quarrel,quarrels
quarter: quarter,quarters
quartering: quartering
quebec: quebec
queen: queen
quest: quest
question: question,questions
queue: queue
qui: qui
quiangan: quiangan
quiapo: quiapo
quiet: quiet,quieted
quietly: quietly
quotation: quotations
quote: quote,quoted
race: race,races
races: races
radical: radical
rafael: rafael
raffle: raffles
raffles: raffles
rage: raged
raid: raided,raids
railroad: railroad
rain: rain,rains
rainy: rainy
raise: raise,raised,raising
raising: raising
raja: raja,rajas
rajah: rajah
ramon: ramon
rampart: rampart
ramsey: ramsey
range: range,ranges
rank: rank,ranked,ranks
ransom: ransom,ransomed
rapid: rapid
rapidity: rapidity
rapidly: rapidly
rare: rare
rarely: rarely
rashly: rashly
rattan: rattan
ravage: ravage,ravaged,ravaging
ravages: ravages
raven: raven
raw: raw
raze: razed
reach: reach,reached,reaches,reaching
react: react
reactionary: reactionary
read: read,reading,reads
readable: readable
reader: reader
readiness: readiness
reading: reading
ready: ready
reaffirm: reaffirmed
real: real,reales
reales: reales
realize: realize,realized
reap: reap
reason: reason,reasons
reasonable: reasonable
reasoning: reasoning
rebel: rebel,rebels
rebellion: rebellion,rebellions
rebellious: rebellious
rebirth: rebirth
rebuild: rebuilt
recall: recalled
receipt: receipt
receive: receive,received,receiving
reception: reception
recharter: rechartered
reckless: reckless
recklessly: recklessly
recognition: recognition
recognize: recognize,recognized,recognizes
recollect: recollect,recollects
recollects: recollects
reconcile: reconcile
reconquer: reconquer,reconquered
reconstruct: reconstructed
reconstruction: reconstruction
record: record,recorded,records
recount: recount,recounted,recounting,recounts
recover: recovered
recreation: recreation
recruit: recruited
recuperate: recuperating
recuperation: recuperation
red: red
rediscover: rediscovered
redistribute: redistribute,redistributing
redistributing: redistributing
redistribution: redistribution
reduce: reduce,reduced
redundant: redundant
reef: reefs
refer: referred
reference: reference,references
reflect: reflected,reflects
reform: reform,reformed,reforming,reforms
reformation: reformation
reformer: reformer
refound: refounded
refounded: refounded
refounding: refounding
refuge: refuge
refund: refund
refuse: refuse,refused
regain: regained
regalo: regalo
regard: regard,regarded
regent: regent
regidor: regidor
regiment: regiment,regiments
regiments: regiments
region: region,regions
register: registered
registration: registration
regrettable: regrettable
regular: regular,regulars
regularly: regularly
regulate: regulate,regulating
regulation: regulations
reign: reign,reigning
reina: reina
reinforcement: reinforcements
reinstate: reinstate
reiterate: reiterated
relapse: relapse,relapses
relation: relation,relations
relationship: relationship,relationships
relative: relative
relaxed: relaxed
release: release,released
reliable: reliable
relic: relics
relief: relief
relieve: relieve,relieved
relieved: relieved
religion: religion,religions
religious: religious
relinquish: relinquish
rely: relied,rely
remain: remain,remained,remaining,remains
remainder: remainder
remarkable: remarkable
remedy: remedied,remedies,remedy
remember: remember,remembered
remnant: remnant
remodel: remodeled
remonstrance: remonstrances
remorselessly: remorselessly
remote: remote,remotest
remove: remove,removed
renaissance: renaissance
rename: renamed
render: render,renders
rendezvous: rendezvous
renewal: renewal
renounce: renounced,renouncing
rental: rental
reoccupation: reoccupation
reoccupy: reoccupied
reorganization: reorganization
reorganize: reorganize,reorganized
repeal: repeal
repeat: repeated
repeated: repeated
repentance: repentance
replace: replace,replaced
replacement: replacement
reply: replied
report: report,reported,reports
reports: reports
repose: repose
represent: represent,represented,representing,represents
representation: representation,representations
representative: representative,representatives
repress: repress,repressed
repression: repression
reprint: reprint,reprinted,reprints
reprisal: reprisal
reproduce: reproduced
republic: republic,republics
republication: republication
repugnant: repugnant
repulse: repulse,repulsed
reputation: reputation
repute: reputed
request: request,requested
require: require,required,requires
requirement: requirements
requisite: requisite
rescue: rescue,rescued
resemble: resemble,resembling
resent: resented
reserve: reserve
reset: reset
reside: reside
residence: residences
residencia: residencia
resident: resident,residents
resinous: resinous
resist: resist,resisted,resisting,resists
resistance: resistance
resolute: resolute
resolution: resolution
resolve: resolved
resort: resort,resorted
resource: resources
respect: respect,respected
respectable: respectable
respective: respective
respects: respects
respond: responded
responsible: responsible
rest: rest,rested,rests
resting: resting
restitution: restitution
restlessness: restlessness
restoration: restoration
restore: restore,restored,restoring
restrict: restricted
restricted: restricted
restriction: restriction,restrictions
result: result
resume: resumed
retain: retain,retained,retaining
retainer: retainers
retake: retook
retaliate: retaliate,retaliated
retaliation: retaliation
retaliatory: retaliatory
retinue: retinue
retire: retire,retired,retiring
retirement: retirement
retreat: retreat,retreated
return: return,returned,returning,returns
returned: returned
reveal: reveal,revealed,reveals
revelation: revelation
revenge: revenge
revenue: revenue,revenues
reverence: reverenced
reverse: reverses
review: review,reviewed
revise: revised,revising
revision: revision
revive: revive,revived,reviving
revocation: revocation
revoke: revoke,revoked
revolt: revolt,revolted,revolts
revolting: revolting
revolution: revolution,revolutions
revolutionary: revolutionary
revolutionist: revolutionist,revolutionists
revolutionize: revolutionize,revolutionized
reward: reward,rewards
rewon: rewon
rhine: rhine
rice: rice
rich: rich,richer,richest
richard: richard
riches: riches
richly: richly
rid: rid
ride: riding,rode
ridge: ridge
rife: rife
rifle: rifles
rightly: rightly
rigidly: rigidly
rigorous: rigorous
rigorously: rigorously
rio: rio
riot: riot
ripe: ripe
rise: rise,risen,rising,rose
risk: risk,risking,risks
rite: rite,rites
ritual: ritual
rival: rival,rivaled,rivals
rivalry: rivalry
river: river,rivers
road: road,roads
roam: roam
roan: roan
roast: roast
rob: robbed
robed: robed
rock: rocks
rodriguez: rodriguez
roman: roman
romantic: romantic
rome: rome
roof: roof
root: root,roots
rope: rope
rosa: rosa
rosario: rosario
rosary: rosary
rot: rotted
rota: rota
rough: rough
roughly: roughly
rouse: roused
route: route,routed,routes
rover: rovers
row: row,rowed,rows
rower: rowers
royal: royal
royalty: royalties,royalty
rude: rude,rudest
rudely: rudely
ruder: ruder
rudiment: rudiments
rug: rugs
rugged: rugged
ruin: ruin,ruined,ruining,ruins
rule: rule,ruled,rules,ruling
ruler: ruler,rulers
russia: russia
sack: sacked
sacking: sacking
sacrament: sacraments
sacred: sacred
sacrifice: sacrifice,sacrificed,sacrifices
sad: sad
sadness: sadness
safe: safe
safely: safely
sagacity: sagacity
sago: sago
sahara: sahara
sail: sail,sailed,sailing,sails
sailing: sailing
sailor: sailor,sailors
sails: sails
saint: saint
salary: salaries,salary
sale: sale
sally: sally
salt: salt
samal: samal
samarkand: samarkand
sampaloc: sampaloc
samurai: samurai
san: san
sanctify: sanctified
sandalwood: sandalwood
sandy: sandy
sane: sane
sanitarium: sanitariums
sanitation: sanitation
sanskrit: sanskrit
santa: santa
santiago: santiago
santo: santo
sapan: sapan
saracens: saracens
sardine: sardines
sarong: sarong,sarongs
satin: satins
satisfaction: satisfaction
satisfactorily: satisfactorily
satisfied: satisfied
satisfy: satisfy
saturday: saturday
savage: savage,savages
save: save,saved
saxon: saxons
saxony: saxony
scabbard: scabbard
scale: scale,scales
scandalous: scandalous
scandinavia: scandinavia
scanty: scanty
scar: scars
scarce: scarce
scarcely: scarcely
scarcity: scarcity
scatter: scattered,scattering
scattered: scattered
scene: scenes
scent: scented
scepter: scepter
scheme: schemes
schism: schism
scholar: scholar,scholars
scholarship: scholarship
school: school,schools
schoolboy: schoolboy
schoolhouse: schoolhouses
schools: schools
science: science,sciences
scientific: scientific
scientifically: scientifically
scientist: scientist,scientists
score: scores
scour: scoured
scourge: scourged
script: script
sculptor: sculptors
sea: sea,seas
seaboard: seaboard
seacoast: seacoast
seal: seal
seaman: seamen
seamanship: seamanship
search: search,searching
seashell: seashell
season: season
seat: seat
sebastian: sebastian
secret: secret
secretary: secretary
secrete: secreted
secretly: secretly
sectarian: sectarian
secular: secular
secure: secure,secured,securing
securely: securely
security: securities,security
sedition: sedition
seditious: seditious
seek: seek,seeking,sought
seize: seize,seized
seizure: seizure
seldom: seldom
select: selected
selfish: selfish
selfishness: selfishness
seljuk: seljuk
sell: sell,selling,sells,sold
seminary: seminary
semitic: semitic
send: send,sending
senegal: senegal
sense: sense
sensitiveness: sensitiveness
sentence: sentence,sentenced
sentiment: sentiment
sentry: sentry
separate: separate,separated
separation: separation
september: september
sepulcher: sepulcher
sequel: sequel
ser: ser
serf: serfs
series: series
sermon: sermons
serrano: serrano
servant: servants
serve: serve,served,serves
service: service,services
serviceability: serviceability
servitor: servitors
set: set,sets,setting
settle: settle,settled,settling
settled: settled
settlement: settlement,settlements
settler: settlers
seventeen: seventeen
seventeenth: seventeenth
seventh: seventh
severe: severe,severest
severity: severities,severity
seville: seville
sextant: sextant
shake: shake
shallow: shallow
shame: shame
shape: shape,shaped,shaping
share: share,shared,sharing
sharing: sharing
shark: shark
shatter: shattered
shave: shave
sheath: sheath
sheep: sheep
sheet: sheets
shelter: shelter
sherif: sherif
shield: shield,shields
shift: shifted,shifting
shifting: shifting
ship: ship,ships
shipbuilder: shipbuilders
shipload: shipload
shipment: shipment
shipping: shipping
shipwreck: shipwrecked
shipyard: shipyard,shipyards
shoemaker: shoemakers
shogun: shogun,shoguns
shoot: shoot,shot
shooting: shooting
shop: shops
shore: shore,shores
short: short,shortest
shortly: shortly
shortsighted: shortsighted
shout: shouted,shouting
shower: showered
shrewdly: shrewdly
shrine: shrine
siam: siam
siberia: siberia
sick: sick
sickness: sickness,sicknesses
sided: sided
siege: siege
sierra: sierra
sight: sight,sighted
sign: sign,signed
signal: signal
signature: signature
significance: significance
signify: signify
silent: silent
silk: silk,silks
silva: silva
silver: silver
silversmith: silversmiths
similarity: similarity
simon: simon
simple: simple
simplified: simplified
simply: simply
sincerity: sincerity
sing: sang,sing
singapore: singapore
single: single
singly: singly
sink: sank,sunk
sir: sir
sister: sisters
sit: sat,sit
situate: situated
situation: situation
sixteen: sixteen
sixteenth: sixteenth
sixth: sixth
size: size
skill: skill
skilled: skilled
skillful: skillful
skin: skin,skins
skirmisher: skirmishers
skirt: skirted
slacken: slackened
slaughter: slaughter
slave: slave,slaves,slaving
slaver: slavers
slavery: slavery
slay: slain,slay
sleep: sleeping
sleepless: sleepless
slender: slender
slew: slew
slight: slighted,slightest
sling: slings
slip: slipped
slope: slopes
sloth: sloth
slow: slow
slowly: slowly
slug: slug
smith: smith
smolder: smoldering
smooth: smooth
smuggle: smuggled
snake: snakes
social: social
society: society
soften: softened
soil: soil
solano: solano
soldier: soldier,soldiers
soldiery: soldiery
sole: sole
solely: solely
solemn: solemn
solemnity: solemnity
soler: soler
solicit: solicit,solicited
solicitation: solicitation
solicitous: solicitous
solid: solid
solitary: solitary
solomon: solomon
solution: solution
son: son
song: song,songs
sore: sore
sort: sort
soul: soul,souls
sound: sound,sounds
source: source,sources
south: south
southeast: southeast
southeastern: southeastern
southeastward: southeastward
southern: southern
southward: southward
southwestern: southwestern
sovereign: sovereign,sovereigns
sovereignty: sovereignty
sow: sow
sowing: sowing
space: space
spacious: spacious
spain: spain
spaniard: spaniard
spaniards: spaniards
spanish: spanish
spare: spared
sparse: sparse
sparsely: sparsely
sparsity: sparsity
speak: speak,speaking,speaks,spoke,spoken
spear: spear,speared
special: special
specially: specially
species: species
specific: specific
speech: speech
speedily: speedily
speedy: speedy
spencer: spencer
spend: spent
sphere: sphere
spice: spice,spices
spirit: spirit,spirits
spirited: spirited
spiritual: spiritual
spirituality: spirituality
spite: spite
splendid: splendid
splendidly: splendidly
splendor: splendor
spoil: spoil,spoils
sport: sport
spot: spot
spray: sprays
spread: spread,spreading
spring: sprang,spring
squadron: squadron,squadrons
square: square
stability: stability
staff: staff
stage: stage
stain: stains
stand: stand,stands,stood
standard: standard,standards
standing: standing
standpoint: standpoint
start: start,started
startled: startled
starvation: starvation
statehood: statehood
statement: statement,statements
statesman: statesman,statesmen
statesmanlike: statesmanlike
station: station,stations
stationers: stationers
statistics: statistics
stature: stature
status: status
statute: statutes
stay: stay,stayed,staying
steadily: steadily
steal: stealing
steam: steam
steamer: steamer,steamers
steelyard: steelyard
steer: steered
step: step,steps
stern: stern
stimulate: stimulate,stimulated,stimulating
stimulus: stimulus
stipulate: stipulated
stir: stirred,stirring
stock: stock
stockade: stockade
stone: stone,stones
stoop: stoop
storage: storage
store: store,stored,stores
storehouse: storehouses
storm: storm,stormed,storms
storms: storms
stormy: stormy
story: stories,story
stout: stout
straight: straight
strain: strain,straining
strait: strait,straits
straits: straits
strange: strange
stranger: stranger
strategic: strategic
stream: stream
street: street,streets
strength: strength
strengthen: strengthen,strengthened,strengthening
strenuously: strenuously
stretch: stretched,stretches,stretching
strict: strict
strife: strife
strike: strike,struck
striking: striking
strip: stripped
strive: striving,strove
strong: strong,stronger,strongest
stronghold: stronghold,strongholds
strongholds: strongholds
structure: structure
struggle: struggle,struggled,struggles,struggling
stud: studded
student: student,students
study: studied,studies,study,studying
stupid: stupid
subdue: subdued,subduing
subject: subject,subjected,subjects
subjection: subjection
subjugate: subjugate
subjugation: subjugation
submission: submission
submissive: submissive
subordinate: subordinate
subscribe: subscribe
subsequent: subsequent
subsequently: subsequently
subsidize: subsidized
subsidy: subsidy
substantial: substantial
suburb: suburb,suburbs
succeed: succeed,succeeded,succeeding
success: success,successes
successful: successful
succession: succession
successive: successive
successively: successively
successor: successor,successors
succor: succor
suck: sucked
sudden: sudden
suddenly: suddenly
sue: sue,sued
suez: suez
suffer: suffered,suffering
sufferer: sufferer
suffering: suffering,sufferings
suffice: suffice
sufficient: sufficient
sugar: sugar
sugarcane: sugarcane
suggestion: suggestion,suggestions
suit: suit,suited
suitable: suitable
suitably: suitably
sullen: sullen
sultan: sultan,sultans
sultana: sultana
sulu: sulu
suluan: suluan
sum: sum,sums
sumatra: sumatra
summary: summary
summer: summer
summit: summit
summon: summoned
sun: sun
sunday: sunday
superfluous: superfluous
superintendent: superintendent
superior: superior
superiority: superiority
superlative: superlative
superstition: superstitions
superstitious: superstitious
supervision: supervision
supervisor: supervisor
supine: supine
supplant: supplanted
supplement: supplement
supply: supplied,supplies,supply
support: support,supported
suppose: suppose,supposed,supposing
supposedly: supposedly
suppress: suppress,suppressed,suppressing
suppression: suppression
supreme: supreme
sur: sur
surely: surely
surgeon: surgeons
surgery: surgery
surname: surnamed
surpass: surpassed,surpassing
surprise: surprise
surprising: surprising
surprisingly: surprisingly
surrender: surrender,surrendered,surrendering,surrenders
surround: surround,surrounded,surrounding
surroundings: surroundings
surveillance: surveillance
survey: survey
survive: survive,survived,surviving
survivor: survivors
suspect: suspected,suspecting,suspects
suspend: suspended
suspicion: suspicion,suspicions
suspicious: suspicious
sustain: sustain,sustained,sustaining
swamp: swamp,swamps
swampy: swampy
swarm: swarmed,swarming
sway: sway
swear: swore,sworn
sweep: sweep,sweeping,swept
sweet: sweet
swift: swift
switzerland: switzerland
swollen: swollen
sword: sword,swords
syllabary: syllabaries,syllabary
syllable: syllables
symmetry: symmetry
sympathize: sympathizing
sympathy: sympathy
synonym: synonyms
synonymous: synonymous
syria: syria
systems: systems
ta: ta
taal: taal
tablas: tablas
table: table,tables
tablet: tablets
tact: tact
taft: taft
tagal: tagal
tagala: tagala
tagalog: tagalog
tagbanua: tagbanua
tai: tai
tailor: tailors
talent: talent
talented: talented
talk: talk
tall: tall
tame: tame
tan: tan
taotai: taotai
tapestry: tapestries
taro: taro
tartar: tartar
task: task,tasks
taste: tastes
tattoo: tattooing
tattooing: tattooing
tax: tax,taxes
taxation: taxation
te: te
teach: taught,teach,teaches,teaching
teacher: teacher,teachers
teaching: teaching,teachings
team: team
tear: tore
tedious: tedious
teem: teem,teeming
temper: tempered
temperament: temperament
temperate: temperate
tempest: tempests
temple: temples
temporal: temporal
temporarily: temporarily
temporary: temporary
tempting: tempting
tenant: tenants
tend: tend
tendency: tendencies
teniente: teniente
tenth: tenth
term: term,terms
termination: termination
ternate: ternate
terrace: terraces
terraced: terraced
terrible: terrible
terribly: terribly
terrify: terrified
territorial: territorial
territory: territories,territory
terror: terror
terrorism: terrorism
terrorize: terrorized
terse: terse
teutonic: teutonic
thames: thames
thatch: thatched
theatrical: theatrical
theft: thefts
theocratic: theocratic
theological: theological
theoretical: theoretical
theoretically: theoretically
theory: theories,theory
thicket: thickets
thief: thieves
thinking: thinking
thirst: thirst
thirteen: thirteen
thirteenth: thirteenth
thomas: thomas
thread: thread
threat: threat
threaten: threatened,threatening
threatened: threatened
threatening: threatening
thrifty: thriftiest
thrive: thrive,thriven
thriving: thriving
throne: throne,thrones
throng: thronged
throw: threw,throw,throwing,thrown,throws
thrust: thrust
ti: ti
tibet: tibet
tide: tide,tides
tiding: tidings
tie: ties
tight: tighter
tile: tile,tiles
tillable: tillable
timber: timber
timbered: timbered
time: time,times
timely: timely
timid: timid
timor: timor
tin: tin
tiny: tiny
tired: tired
tireless: tireless
title: title,titled,titles
tobacco: tobacco
toil: toil,toils
toiler: toiler
tolerate: tolerated
toleration: toleration
tomas: tomas
ton: tons
tondo: tondo
tone: tone
tongue: tongue,tongues
tool: tool
tooth: teeth,tooth
torment: torment,torments
torpedo: torpedo
tortoise: tortoise
toston: toston
total: total
totally: totally
touch: touched,touching
tower: towers
town: town,towns
township: township
townsman: townsmen
trace: trace,traces
track: track
trade: trade,traded,trades,trading
trademark: trademark
trader: trader,traders
trading: trading
tradition: tradition,traditions
traditional: traditional
traffic: traffic
tragedy: tragedy
trail: trail
train: trained,training
training: training
trait: traits
transcribe: transcribe,transcribed
transcription: transcription
transfer: transfer,transferred
transference: transference
transformation: transformation
transition: transition
translate: translated
translation: translation,translations
transpire: transpired
transport: transport,transported,transports
transportation: transportation
trap: traps
travel: travel,traveled,traveling,travels
traveller: travellers
travels: travels
traverse: traverse,traversed,traversing
treacherous: treacherous
treason: treason
treasonable: treasonable
treasure: treasure,treasures
treasurer: treasurer
treasury: treasury
treat: treat,treated,treating,treats
treatment: treatment
treaty: treaties,treaty
tree: tree,trees
treetop: treetops
tremendous: tremendous
trench: trenches
trent: trent
trial: trial
trias: trias
tribe: tribe,tribes
tribes: tribes
tribunal: tribunal
tribute: tribute,tributes
trick: tricks
trifling: trifling
trinidad: trinidad
trip: trips
triumph: triumph
triumphal: triumphal
triumphant: triumphant
trivial: trivial
troops: troops
trophy: trophies
tropical: tropical
tropics: tropics
trouble: trouble,troubled,troubles
truce: truce
true: true,truer
trunk: trunks
trust: trust,trusted,trusting
truth: truth
truthfully: truthfully
truthfulness: truthfulness
tu: tu
tuber: tubers
tucks: tucks
tuition: tuition
tumult: tumult
turbulence: turbulence
turkey: turkey
turks: turks
turret: turrets
tuscan: tuscan
type: type,types
typhoon: typhoons
typical: typical
tyrannical: tyrannical
tyrannically: tyrannically
tyrant: tyrant,tyrants
tyre: tyre
ud: ud
ugly: ugly
ultimate: ultimate
umbrella: umbrellas
unabated: unabated
unable: unable
unattractive: unattractive
unbroken: unbroken
unbrokenly: unbrokenly
unburied: unburied
uncertain: uncertain
unchristianized: unchristianized
uncivilized: uncivilized
unclaimed: unclaimed
uncle: uncle
underestimate: underestimated
undergo: underwent
underlie: underlying
understand: understand,understanding,understood
understanding: understanding
understood: understood
undertake: undertake
undertaking: undertaking,undertakings
undertone: undertone
undeveloped: undeveloped
undisciplined: undisciplined
undisturbed: undisturbed
undoubtedly: undoubtedly
uneducated: uneducated
unending: unending
unenforceability: unenforceability
unenlightened: unenlightened
unequal: unequal
unexpected: unexpected
unexplored: unexplored
unfair: unfair
unfaltering: unfaltering
unfavorable: unfavorable
unfitted: unfitted
unfortunate: unfortunate
unfrequented: unfrequented
unfurl: unfurl
ungenerous: ungenerous
ungoverned: ungoverned
unhappy: unhappy
unholy: unholy
uniform: uniform,uniforms
uninhabited: uninhabited
uninterrupted: uninterrupted
uninviting: uninviting
union: union,unions
unique: unique
unit: unit
unite: unite,united
united: united
unity: unity
universal: universal
university: universities,university
unjust: unjust
unknown: unknown
unlettered: unlettered
unlink: unlink
unmolested: unmolested
unoccupied: unoccupied
unparalleled: unparalleled
unpopularity: unpopularity
unpopulated: unpopulated
unprepared: unprepared
unproductive: unproductive
unprofitable: unprofitable
unprotected: unprotected
unproven: unproven
unquestionable: unquestionable
unquestionably: unquestionably
unreadiness: unreadiness
unrebuked: unrebuked
unrelieved: unrelieved
unremittingly: unremittingly
unremunerated: unremunerated
unruly: unruly
unsafe: unsafe
unsatisfactory: unsatisfactory
unscrupulous: unscrupulous
unselfish: unselfish
unselfishness: unselfishness
unshod: unshod
unsolicited: unsolicited
unspeakable: unspeakable
unstudied: unstudied
unsubdued: unsubdued
unsuccessful: unsuccessful
untried: untried
untrue: untrue
untruthfulness: untruthfulness
unusual: unusual
unusually: unusually
unutilized: unutilized
unwalled: unwalled
unwholesome: unwholesome
unwilling: unwilling
unwisdom: unwisdom
unworthy: unworthy
update: updated
upper: upper
uprightness: uprightness
uprising: uprising,uprisings
urge: urged
usage: usage
useless: useless
uselessness: uselessness
user: user
usual: usual
usurp: usurped,usurping
usurper: usurper
ut: ut
utilization: utilization
utmost: utmost
utterly: utterly
vacate: vacate
valley: valley,valleys
valor: valor
valuable: valuable
valueless: valueless
van: van
vanilla: vanilla
variation: variation
varied: varied
variety: variety
variously: variously
vary: varied,varying
vase: vases
vassal: vassal,vassals
vassalage: vassalage
vast: vast
vastly: vastly
vehemently: vehemently
vein: veins
veneration: veneration
venetian: venetian,venetians
vengeance: vengeance
venice: venice
venison: venison
venture: venture,ventured
vera: vera
verde: verde
verdi: verdi
veritable: veritable
version: version
versos: versos
vespucci: vespucci
vessel: vessel,vessels
vest: vested
vestige: vestige,vestiges
vex: vexed
vexatious: vexatious
viceregent: viceregent
viceroy: viceroy,viceroys
vicinity: vicinity
vicious: vicious
victim: victim
victoria: victoria
victorious: victorious
victory: victories,victory
vie: vied
view: view,viewed,viewing,views
vigilance: vigilance
vigilant: vigilant
vigor: vigor
vigorous: vigorous
vigorously: vigorously
vii: vii
viii: viii
village: village,villages
vine: vines
vinta: vinta
violate: violated,violates
violation: violation
violence: violence
violent: violent
virgin: virgin
virtue: virtues
virus: virus
visayan: visayan
visible: visible
visionary: visionary
visit: visit,visited,visiting,visits
visitation: visitations
vital: vital
vocabulary: vocabulary
voice: voice
void: void
volcanic: volcanic
volume: volume,volumes
voluminous: voluminous
volunteer: volunteer,volunteers
von: von
vote: vote
vouch: vouched
vow: vows
vowel: vowel,vowels
voyage: voyage,voyages
voyager: voyagers
voyagers: voyagers
voyages: voyages
wage: wage,waged,waging
wait: wait,waited
walk: walk,walks
wall: wall,walls
walled: walled
wan: wan
wander: wandered,wandering
wane: wane,waned,waning
wanton: wanton
wantonly: wantonly
war: war,warring,wars
warehouse: warehouses
wares: wares
warfare: warfare
warlike: warlike
warm: warm
warn: warned
warranty: warranties,warranty
warrior: warrior,warriors
wars: wars
warship: warships
wash: washed
washington: washington
waste: waste,wasted
water: water,watered,waters
waterloo: waterloo
wave: wave
waver: wavering
wax: wax
waylay: waylay
wayward: wayward
weak: weak,weaker,weakest
weaken: weakening
weakness: weakness
wealth: wealth
wealthy: wealthy
weapon: weaponed,weapons
wear: wear,wore,worn
wearied: wearied
wearisome: wearisome
weather: weather
weave: weave,woven
weaver: weavers
webster: webster
week: weeks
weep: wept
weigh: weighed,weighing,weighs
weight: weight,weights
welfare: welfare
wellington: wellington
west: west
westerly: westerly
western: western
westernmost: westernmost
westward: westward
whatsoever: whatsoever
wheat: wheat
whip: whipped
whisper: whisper
white: white
wholesome: wholesome
wholly: wholly
wicked: wicked
wickedness: wickedness
wicket: wicket,wickets
wide: wide,wider,widest
widen: widen
widening: widening
widespread: widespread
wife: wife,wives
wild: wild
wilderness: wilderness
willed: willed
william: william
win: win,winning
wind: wind,winding,winds
wine: wine
winter: winter
wisdom: wisdom
wise: wise
wisely: wisely
withdraw: withdraw,withdrew
withstand: withstand
witness: witness,witnessed
wolf: wolves
woman: woman,women
wonderful: wonderful
wonderfully: wonderfully
wondrous: wondrous
wood: wood,woods
wooden: wooden
wooly: wooly
worcester: worcester
word: word
worker: workers
workmanship: workmanship
worm: worms
worms: worms
worn: worn
worry: worried
worship: worship,worshiped
worshiper: worshipers
worth: worth
worthy: worthiest,worthy
wound: wound,wounded,wounds
wrath: wrath
wrathful: wrathful
wreck: wrecked
wrest: wrest,wrested
wretched: wretched
wright: wright
write: write,writes,writing,written,wrote
writer: writer,writers
writers: writers
writing: writing
writings: writings
wrong: wrong,wrongs
xi: xi
xii: xii
xiii: xiii
xiv: xiv
xvii: xvii
xylophone: xylophone
ya: ya
yacht: yacht
yam: yams
yang: yang
yangtze: yangtze
yankton: yankton
yap: yap
yard: yard,yards
yearly: yearly
yell: yelling
yellow: yellow
yellowish: yellowish
yi: yi
yield: yield,yielded,yielding,yields
yo: yo
yoke: yoke
yokohama: yokohama
york: york
youth: youths
yule: yule
zanzibar: zanzibar
zeal: zeal
zealand: zealand
zealous: zealous
zebu: zebu
zenith: zenith
zest: zest
zone: zone,zones
