abandon: abandon,abandoned
abase: abase
abate: abated,abating
abhorrence: abhorrence
abide: abide
ability: abilities,ability
abject: abject
ablutions: ablutions
abode: abode
abominable: abominable
abound: abound
abrupt: abrupt
abruptly: abruptly
abscond: absconded
absence: absence,absences
absent: absent,absenting
absorb: absorbed
absorbing: absorbing
abstain: abstain,abstained
abstracted: abstracted
abstractedly: abstractedly
abstraction: abstraction
absurd: absurd
absurdity: absurdity
abundance: abundance
abundantly: abundantly
abuse: abuse,abused
abut: abuts,abutting
abyss: abyss
accede: acceded,acceding
accent: accent,accents
accept: accept,accepting
accessory: accessory
accident: accident
accidental: accidental
accidentally: accidentally
accidently: accidently
accommodate: accommodate,accommodated
accommodation: accommodation
accompany: accompanied,accompany,accompanying
accompanyist: accompanyist
accomplice: accomplice
accomplish: accomplish,accomplished
accomplished: accomplished
accord: accord
accost: accosted
account: account,accounted,accounts
accumulate: accumulate,accumulated
accuracy: accuracy
accurate: accurate
accusation: accusation
accustom: accustomed
accustomed: accustomed
acerbity: acerbity
ache: ached,aching
achieve: achieve,achieved
acknowledge: acknowledged
acknowledgment: acknowledgment
acquaint: acquainted,acquainting
acquaintance: acquaintance,acquaintances
acquiesce: acquiesced
acquiescence: acquiescence
acquire: acquire,acquired
acquisition: acquisition
acquit: acquitted
action: action,actions
active: active
actively: actively
actor: actor,actors
actual: actual
actuate: actuated
acute: acute,acutest
acuteness: acuteness
adage: adage
add: add,adding
addition: addition
additional: additional
address: address,addressed,addressing
adept: adept
adequate: adequate
adhere: adhere,adhered
adieus: adieus
adjacent: adjacent
adjective: adjective
adjoin: adjoining
adjoining: adjoining
adjourn: adjourned
adjust: adjusted,adjusting
administer: administered,administering
admirably: admirably
admiration: admiration
admire: admire,admiring
admirer: admirers
admission: admission,admissions
admit: admit,admitted,admitting
admonish: admonished
admonition: admonition,admonitions
admonitory: admonitory
ado: ado
adornment: adornment
adult: adult
advance: advance,advanced,advancing
advanced: advanced
advancement: advancement
advantage: advantage,advantages
advantageous: advantageous
adventure: adventure,adventures
adversity: adversity
adverting: adverting
advertise: advertise
advertisement: advertisement
advertiser: advertiser
advice: advice
advisability: advisability
advisable: advisable
advise: advise,advised
adviser: adviser
advocate: advocate,advocated
affability: affability
affair: affair,affairs
affairs: affairs
affect: affect
affectation: affectation
affection: affection,affections
affectionate: affectionate
affectionately: affectionately
affinity: affinity
affirm: affirm,affirmed
affirmative: affirmative
affix: affix
afflict: afflicted
affliction: affliction
afford: afford,afforded,affording,affords
affright: affright
afore: afore
aforesaid: aforesaid
afraid: afraid
afresh: afresh
afternoon: afternoon
age: age,ages
aged: aged
agent: agent,agents
aggravate: aggravated
aggravated: aggravated
aggravating: aggravating
aggravation: aggravation
aghast: aghast
agility: agility
agin: agin
agitate: agitated
agitated: agitated
agitation: agitation
agnes: agnes
agonised: agonised
agonising: agonising
agony: agony
agree: agreed
agreeable: agreeable
agreeably: agreeably
agreement: agreement
ague: ague
aha: aha
aid: aid
aim: aim,aimed,aiming
air: air,aired,airs
airy: airy
akin: akin
alabaster: alabaster
alacrity: alacrity
alarm: alarm,alarmed
alarmed: alarmed
alarming: alarming
alas: alas
ale: ale
alert: alert
alight: alighted
alike: alike
alive: alive
allay: allay
alleviate: alleviate
alley: alley,alleys
allot: allotted
allowable: allowable
allowance: allowance
allusion: allusion
almighty: almighty
aloft: aloft
aloof: aloof
aloud: aloud
alphabet: alphabet
alphabetical: alphabetical
altar: altar
alter: alter,altered
alteration: alteration,alterations
altercation: altercations
altered: altered
alternate: alternate
alternately: alternately
alternation: alternation
alternative: alternative
altogether: altogether
amazed: amazed
amazement: amazement
amazingly: amazingly
ambition: ambition
ambitious: ambitious
amen: amen
amend: amend
amendment: amendment
amiability: amiability
amiable: amiable
amicably: amicably
amiss: amiss
amorous: amorous
amphitheatre: amphitheatre
ample: ample
amuse: amuse,amused
amused: amused
amusement: amusement,amusements
amusing: amusing
ancient: ancient
anciently: anciently
andrew: andrew
anew: anew
angel: angel,angels
anger: anger,angering
angle: angle,angles
angrily: angrily
angry: angry
anguish: anguish
animal: animal,animals
animate: animate,animating
animated: animated
animation: animation
animosity: animosity
ankle: ankle
annoy: annoying
annoyance: annoyance
annoying: annoying
annuity: annuity
anoint: anointed
anon: anon
answer: answer,answered,answering,answers
antagonist: antagonist
anteroom: anteroom
antic: antic
anticipate: anticipated,anticipating
anticipation: anticipation
antimonial: antimonial
antipathy: antipathy
anxiety: anxieties,anxiety
anxious: anxious
anxiously: anxiously
apace: apace
apartment: apartment
aperture: aperture,apertures
apiece: apiece
apology: apology
apostrophe: apostrophe
apothecary: apothecary
appal: appalled
appalling: appalling
apparatus: apparatus
apparel: apparel
apparent: apparent
apparition: apparition
appeal: appeal,appealed,appealing,appeals
appealing: appealing
appearance: appearance,appearances
appendage: appendage
appertain: appertained,appertaining
appetite: appetite,appetites
applause: applause
apple: apples
applicant: applicants
application: application,applications
apply: applied,apply,applying
appoint: appoint,appointed
appointment: appointment
appreciation: appreciation
apprehend: apprehend,apprehended,apprehending
apprehension: apprehension,apprehensions
apprehensively: apprehensively
apprentice: apprentice,apprenticed
apprenticeship: apprenticeship
approach: approach,approached,approaches,approaching
approbation: approbation
approval: approval
approve: approve,approved,approving
approver: approver
approvingly: approvingly
apron: apron
apt: apt
arbitrary: arbitrary
arch: arch
archway: archway
ardent: ardent
ardently: ardently
ardour: ardour
argue: argued
argument: argument,arguments
aright: aright
arithmetical: arithmetical
arm: arm,arms
arouse: aroused
arrange: arrange,arranged,arranging
arrangement: arrangement,arrangements
array: array
arrears: arrears
arrival: arrival
arrive: arrive,arrived,arrives,arriving
arrow: arrow
art: art,arts
arter: arter
artful: artful
article: article,articles
articulate: articulate,articulated
artificial: artificial
artist: artist
artless: artless
ascend: ascend,ascended
ascertain: ascertain,ascertained,ascertaining
ash: ashes
ashamed: ashamed
ashy: ashy
askance: askance
asleep: asleep
aspect: aspect
asperity: asperities,asperity
ass: ass
assail: assail,assailed
assailant: assailant
assassin: assassin
assault: assault
assemblage: assemblage
assemble: assembled,assembling
assent: assent
assert: assert,asserted,asserting
assertion: assertion
asseveration: asseveration,asseverations
assiduity: assiduity
assiduously: assiduously
assign: assign,assigned
assist: assist,assisted,assisting
assistance: assistance
assistant: assistant,assistants
associate: associate,associates,associating
associates: associates
association: associations
assorted: assorted
assume: assume,assumed,assuming
assumption: assumption
assurance: assurance,assurances
assure: assure,assured,assures,assuring
assured: assured
assuredly: assuredly
astonish: astonished,astonishes
astonished: astonished
astonishing: astonishing
astonishment: astonishment
astounded: astounded
asunder: asunder
asylum: asylum
atmosphere: atmosphere
atone: atones
atonement: atonement
atones: atones
atrocious: atrocious
atrociously: atrociously
atrocity: atrocity
attach: attach,attached,attaching
attachment: attachment
attack: attack
attain: attain,attained
attempt: attempt,attempted,attempting
attend: attend,attended,attending
attendance: attendance
attendant: attendant,attendants
attention: attention,attentions
attentive: attentive
attentively: attentively
attenuate: attenuated
attest: attesting
attire: attire,attired
attitude: attitude
attorney: attorney
attract: attract,attracted,attracting
attraction: attractions
attractive: attractive
attribute: attribute,attributed,attributes
audacious: audacious
audible: audible
audience: audience
auditor: auditor
aught: aught
augury: auguries
aunt: aunt,aunts
auspicious: auspicious
author: author,authors
authority: authorities,authority
authorship: authorship
autumn: autumn
avail: avail,availed
avaricious: avaricious
avenge: avenge
avenue: avenues
averse: averse
aversion: aversion
avert: averted,averting
avidity: avidity
avocation: avocation,avocations
avoid: avoid,avoided,avoiding
avowal: avowal
avowed: avowed
await: awaited,awaiting
awake: awake,awoke
awaken: awaken,awakened,awakens
awakening: awakening
aware: aware
awe: awe
awed: awed
awful: awful
awfulness: awfulness
awhile: awhile
awkward: awkward
awkwardness: awkwardness
axiom: axiom
ay: ay
aye: aye
babble: babbling
babe: babe,babes
baby: baby
bachelor: bachelor
background: background
bacon: bacon
bad: bad,worse,worst
bade: bade
badge: badge,badged
badger: badger
badly: badly,worse
baffle: baffled
bag: bag,bags
bah: bah
bail: bail
bailey: bailey
bait: bait
baker: baker
balance: balance,balancing
bald: bald
ball: ball
ballad: ballad
ballast: ballast
balmy: balmy
balustrade: balustrade
bamboo: bamboo
band: band
bandage: bandage,bandaged
bank: bank,banks
banker: banker
bankrupt: bankrupts
banquet: banquet
banter: banter,bantered
baptize: baptized
bar: bar,barred,barring,bars
barber: barber
barbican: barbican
bare: bare
barefoot: barefoot
barely: barely
bargain: bargain
bark: bark,barking
barker: barker,barkers
barney: barney
baron: baron
barrel: barrel
barrier: barriers
bartlemy: bartlemy
base: base
bashful: bashful
bashfully: bashfully
basin: basin
bask: basking
basket: basket,baskets
bastard: bastard
bates: bates
bath: bathed
battery: battery
battle: battle
battledore: battledore
bawl: bawled
beadle: beadle,beadles
beadlehood: beadlehood
beadles: beadles
beadleship: beadleship
beak: beak,beaks
beam: beam,beaming,beams
bear: bear,bearing,bears,bore,born,borne
beard: beard
bearer: bearer,bearers
beast: beast,beasts
beat: beat,beaten,beating,beats
beating: beating
beau: beau
beautiful: beautiful
beautifully: beautifully
beauty: beauties,beauty
beaver: beaver
beck: beck
beckon: beckoned,beckoning
becky: becky
bed: bed,beds
bedroom: bedroom,bedrooms
bedside: bedside
bedstead: bedstead
beef: beef
beer: beer
befall: befall,befallen
befit: befitted
befitting: befitting
beg: beg,begged,begging
beget: begets
beggar: beggar
beginner: beginner
beguile: beguile,beguiling
behalf: behalf
behave: behave,behaved
behaviour: behaviour
behindhand: behindhand
behold: beheld,behold,beholding
beholder: beholder,beholders
belcher: belcher
belief: belief
bell: bell,bells
bellow: bellowed,bellows
bellowing: bellowing
belong: belong,belonged
beloved: beloved
ben: ben
bench: bench,benches
bend: bended,bending,bends,bent
beneath: beneath
benefactor: benefactor,benefactors
benefactress: benefactress
beneficial: beneficial
benefit: benefit,benefits
benevolence: benevolence
benevolent: benevolent
benignly: benignly
bent: bent
bequeath: bequeathed
bereft: bereft
beseech: beseeching
beseechingly: beseechingly
besmear: besmeared
besought: besought
bespeak: bespeak,bespeaking
bespoke: bespoke
besprinkle: besprinkled
bestow: bestow,bestowed,bestowing,bestows
bestowal: bestowal
bet: bet
betake: betake,betook
bethink: bethinking,bethought
betime: betimes
betoken: betoken,betokened
betook: betook
betray: betray,betrayed
betsy: betsy
betters: betters
betwixt: betwixt
bewail: bewail,bewailing
bewilder: bewildered
bewildering: bewildering
bible: bible
bid: bade,bid,bidding,bids
bidding: bidding
bide: bide
bier: bier
bind: bind,bound
binding: binding
biographer: biographer
biography: biography
bird: bird,birds
birmingham: birmingham
birth: birth
birthday: birthday
birthplace: birthplace
bishop: bishop
bister: bister
bit: bit,bits
bite: bit,bites,biting
bitter: bitter,bitterest
bitterly: bitterly
bitterness: bitterness
blab: blab
black: black,blackest,blacking
blacken: blacken,blackened
blackhearted: blackhearted
blacking: blacking
blame: blame
blanch: blanched
blandly: blandly
blandness: blandness
blank: blank
blanket: blanket
blaspheme: blasphemed
blasphemy: blasphemy
blathers: blathers
blaze: blaze,blazed,blazes,blazing
bleak: bleak
bleat: bleating
bleed: bleeds
bleeding: bleeding
blend: blended,blending
bless: bless,blessed
blessed: blessed
blessing: blessing,blessings
blight: blight,blighted
blind: blind,blinded,blinder,blinds
blindness: blindness
blink: blinking
blithesome: blithesome
block: block,blocked
blood: blood,bloods
bloodless: bloodless
bloodshed: bloodshed
bloodshot: bloodshot
bloody: bloody
bloom: bloom,blooming
blossom: blossomed,blossoms
blot: blot,blotted
blow: blew,blow,blowing,blows
blubber: blubbered,blubbering
blucher: bluchers
bludgeon: bludgeons
blue: blue
bluff: bluff
bluish: bluish
blunder: blunder,blundering
blunderbuss: blunderbuss
blunt: blunt
blush: blush,blushed,blushing
board: board,boards
boarding: boarding
boast: boast,boasts
boat: boat,boats
bob: bob
bode: boded
bodily: bodily
body: bodies,body
boil: boiled,boiling,boils
boisterous: boisterous
bold: bold,bolder,boldest
boldly: boldly
boldness: boldness
bolt: bolt,bolted,bolting,bolts
bolter: bolter
bombazeen: bombazeen
bond: bond
bondage: bondage
bone: boned,bones
bonnet: bonnet
bony: bony
book: book,booked,books
bookseller: bookseller
bookstall: bookstall
boom: boom
boot: boot,booted,boots
booty: booty
border: bordered,bordering
bore: bore
born: born
borough: borough
bosom: bosom,bosoms
botanical: botanical
bother: bother
bottle: bottle,bottles
bough: boughs
bounce: bouncing
bounceably: bounceably
bound: bound,bounded,bounding,bounds
boundary: boundaries
bow: bow,bowed,bowing,bows
bowl: bowl,bowls
box: box,boxed,boxes
boy: boy,boys
boyish: boyish
bracelet: bracelets
braid: braided
brain: brain,brains
brake: brake
bran: bran,brans
branch: branch,branches
brand: branding
brandish: brandishing
brandy: brandy
brass: brass
brat: brat,brats
brave: brave,braved,braves
bravely: bravely
bravery: bravery
brawling: brawling
brawny: brawny
brazen: brazen
bread: bread
break: break,breaking,broke,broken
breaker: breaker,breakers
breakfast: breakfast
breaking: breaking
breast: breast
breath: breath,breaths
breathe: breathe,breathed
breathing: breathing
breathless: breathless
breathlessness: breathlessness
breeches: breeches
breed: bred,breed
breeding: breeding
brewery: brewery
brewing: brewing
bribe: bribes
brick: brick,bricked,bricks
bride: bride
bridewell: bridewell
bridge: bridge,bridges
bridle: bridle
brier: brier
bright: bright,brighter,brightest
brighten: brightened,brightening
brightly: brightly
brightness: brightness
brilliant: brilliant
brim: brim,brimmed
bring: bring,bringing,brings,brought
brink: brink,brinks
brisk: brisk
briskly: briskly
brittle: brittle
brittles: brittles
broad: broad
broken: broken
brooch: brooches
brood: brooding
brook: brooked
broth: broth
brother: brother,brothers
brow: brow,brows
browed: browed
brown: brown
bruise: bruise,bruised,bruises
brush: brushed,brushing
brutal: brutal
brutality: brutality
brute: brute
bubble: bubble
bucket: buckets
buffet: buffeted
build: built
building: building,buildings
bulk: bulk
bulky: bulky
bull: bull
bullet: bullet
bully: bully
bullying: bullying
bulrush: bulrush
bumble: bumble
bunch: bunch,bunches
bundle: bundle,bundles
buoy: buoyed
burden: burden,burdened
burglar: burglars
burglarious: burglarious
burglary: burglary
burial: burial
burly: burly
burn: burn,burning,burnt
burning: burning
burst: burst,bursting,bursts
bury: buried,bury
bush: bushes
busily: busily
business: business
bust: bust,busting
busted: busted
bustle: bustle,bustled
bustling: bustling
busy: busied,busy,busying
butcher: butcher,butchers
butler: butler
butt: butt
butter: butter,buttered
button: button,buttoned,buttoning,buttons
buyer: buyers
bye: bye
bystander: bystander,bystanders
byway: byways
cabbage: cabbage
cabin: cabin
cabriolet: cabriolet
cad: cad
cadaverous: cadaverous
caddy: caddy
cage: cage,cages
cake: cake,cakes
calamity: calamities,calamity
calculate: calculated
calculation: calculation,calculations
calendar: calendar
calf: calves
calico: calico
calling: calling
calm: calm,calmer,calming
calmness: calmness
cambric: cambric
camden: camden
canal: canal
canary: canary
candidate: candidate
candle: candle,candles
candlestick: candlestick
cane: cane
canker: cankered
canvas: canvas
cap: cap,caps
capable: capable
capacious: capacious
capacity: capacity
cape: cape
capital: capital,capitals
capitulate: capitulated
captain: captain
captivate: captivating
captive: captive
capture: capture,captured
car: car
carcase: carcase
carcass: carcasses
card: card,cards
care: care,cares,caring
career: career,careered,careering
careful: careful
carefully: carefully
careless: careless
carelessly: carelessly
carelessness: carelessness
carol: carolling
carpenter: carpenter,carpenters
carpentering: carpentering
carpet: carpet
carriage: carriage
carrier: carrier
carry: carried,carries,carry,carrying
cart: cart,carts
carter: carter
carve: carved
casement: casement
cash: cash
cask: cask
cast: cast,casting,casts
castanets: castanets
caste: caste
castle: castle
castor: castor
cat: cat
catalogue: catalogue
catastrophe: catastrophe
catch: catch,catching,caught
catechism: catechism
cathedral: cathedral
cattle: cattle
caustically: caustically
caution: caution
cautious: cautious
cautiously: cautiously
cavern: caverns
cease: cease,ceased,ceasing
ceaseless: ceaseless
ceiling: ceiling,ceilings
cell: cell,cells
cellar: cellar,cellars
censure: censure
centre: centre
ceremony: ceremonies,ceremony
certainty: certainty
certify: certify
cessation: cessation
chafe: chafed,chafing
chagrin: chagrin
chain: chain,chained
chair: chair,chairs
chairman: chairman
chaise: chaise
chalk: chalk,chalked
challenge: challenge
chamber: chamber,chambers
chance: chance,chanced,chances,chancing
chancery: chancery
chandler: chandler
change: change,changed,changing
changed: changed
channel: channel,channels
chap: chap,chaps
chapel: chapel,chapels
chapter: chapter
char: char
character: character,characters
characteristic: characteristic,characteristics
characters: characters
charge: charge,charged,charges
chargeable: chargeable
chariot: chariot
charitable: charitable
charity: charity
charles: charles
charley: charley
charlotte: charlotte
charm: charms
charmed: charmed
charming: charming
chase: chase
chaste: chaste
chatter: chatter,chattered,chattering
cheap: cheap,cheaper,cheapest
cheat: cheat
check: check,checked,checking
cheek: cheek,cheeks
cheer: cheer,cheers
cheerful: cheerful
cheerfully: cheerfully
cheerfulness: cheerfulness
cheerless: cheerless
cheese: cheese
chequer: chequered
cherish: cherish,cherished
chest: chest
chester: chester
chickweed: chickweed
chief: chief
chiefly: chiefly
child: child,children
childhood: childhood
childish: childish
childishness: childishness
chill: chill
chilled: chilled
chillness: chillness
chimbley: chimbley
chime: chime,chimed,chiming
chimney: chimney,chimneys
chin: chin,chins
chink: chinks
chinking: chinking
chip: chips
chitling: chitling
choice: choice
choke: choke,choked
choleric: choleric
choose: choose,choosing,chose,chosen
choosing: choosing
chord: chord
chorus: chorus
christian: christian,christians
christmas: christmas
chuck: chucking,chucks
chuckle: chuckle,chuckled,chuckling
church: church,churches
churchyard: churchyard
cinder: cinder
circle: circle,circles
circuit: circuit
circuitous: circuitous
circulate: circulated
circumference: circumference
circumlocution: circumlocution,circumlocutions
circumspect: circumspect
circumspection: circumspection
circumstance: circumstance,circumstanced,circumstances
circumstantial: circumstantial
circumstantially: circumstantially
citizen: citizens
city: city
civil: civil
civility: civilities,civility
claim: claim,claimed,claiming
clammy: clammy
clank: clanking
clap: clapped
clapping: clapping
clash: clash
clasp: clasp,clasping
clasped: clasped
class: class,classes
classic: classic
clatter: clattering
clause: clause
claw: claw
clay: clay
clean: clean,cleaned,cleaning
cleaning: cleaning
cleave: clove
cleft: cleft
clench: clenched,clenching
clenched: clenched
clergyman: clergyman
clerk: clerk
clever: clever
climb: climb,climbed,climbing
cling: cling,clinging,clung
clink: clinking
cloak: cloak
clock: clock,clocks
clog: clog
close: close,closed,closer,closing
closed: closed
closely: closely
closeness: closeness
closet: closet,closeted
closing: closing
clot: clots
cloth: cloth
clothe: clad,clothed
clothes: clothes
clothesman: clothesman
clothing: clothing
cloud: cloud,clouds
cloudy: cloudy
club: club
clue: clue
clung: clung
cluster: cluster,clusters
clustered: clustered
clutch: clutched,clutching
coach: coach,coaches
coachman: coachman
coal: coal,coals
coarse: coarse,coarsest
coast: coast
coat: coat,coated,coats
coating: coating
coaxingly: coaxingly
cock: cock
cocked: cocked
cod: cod
code: code
codger: codger
coffee: coffee
coffin: coffin,coffins
cogitate: cogitating
cognizant: cognizant
coherent: coherent
coil: coil,coiled,coiling
coin: coin,coins
coincidence: coincidence
cold: cold,colder,coldest
coldly: coldly
coldness: coldness
collar: collar,collaring
colleague: colleague
collect: collect,collected,collecting
collectedly: collectedly
collection: collection
collier: colliers
colloquy: colloquy
colony: colony
color: colors
colour: colour,coloured,colouring,colours
coloured: coloured
colouring: colouring
colourless: colourless
comb: comb
combination: combination
combine: combined
comer: comer,comers
comfort: comfort,comforted,comforts
comfortable: comfortable
comfortably: comfortably
comforting: comforting
comic: comic
comical: comical
command: command,commanded,commanding
commence: commenced
commencement: commencement
commend: commend,commending
commendation: commendations
commercial: commercial
commiseration: commiseration
commission: commission
commit: committed,committing
committed: committed
committee: committee
common: common,commonest,commons
commonly: commonly
commons: commons
commotion: commotion
commune: commune,communing
communicate: communicate,communicated,communicating
communication: communication,communications
communicative: communicative
community: community
compact: compact
companion: companion,companions
companionship: companionship
company: companies,company
comparative: comparative
comparatively: comparatively
compare: compare,compared,comparing
comparison: comparison
compass: compass
compassion: compassion
compassionate: compassionate
compassionately: compassionately
compel: compel,compelled
compelling: compelling
complacency: complacency
complacent: complacent
complacently: complacently
complain: complain,complained,complaining
complaint: complaint,complaints
complete: complete,completed
completely: completely
completest: completest
compliance: compliance
complicated: complicated
compliment: compliment,compliments
complimentary: complimentary
comply: complied,comply
compose: compose,composed,composing
composedly: composedly
composition: composition
composure: composure
compound: compound,compounded
comprehend: comprehend,comprehended,comprehending
comprehension: comprehension
comprehensive: comprehensive
compress: compressed
comprise: comprised,comprising
compromise: compromise,compromising
computation: computation
comrade: comrade
conceal: conceal,concealed,concealing
concealment: concealment
concede: concede,conceded
conceive: conceived,conceiving
concentrate: concentrated
conception: conception
concern: concern,concerned
concerned: concerned
concession: concession,concessions
conciliate: conciliate
conciliatory: conciliatory
concise: concise
conclave: conclave
conclude: concluded,concluding
conclusion: conclusion,conclusions
conclusive: conclusive
concourse: concourse
concurrence: concurrence
concurrent: concurrent
condemn: condemned,condemning
condescend: condescended
condescending: condescending
condescendingly: condescendingly
condescension: condescension
condition: condition
conditioned: conditioned
condolence: condolence
conducive: conducive
conduct: conduct,conducted
conductor: conductor,conductors
confederate: confederate
conference: conference
confess: confess,confessed
confession: confession
confidant: confidant
confide: confide,confided,confiding
confidence: confidence
confident: confident
confidential: confidential
confine: confined
confinement: confinement
confirm: confirm,confirmed
confirmatory: confirmatory
confiscate: confiscated
conflict: conflict
confound: confound,confounded
confront: confront,confronted,confronting
confuse: confused
confused: confused
confusion: confusion
congratulate: congratulated
conjecture: conjecture
conjure: conjure
conjurer: conjurers
connect: connected
connection: connection,connections
conscience: conscience
conscious: conscious
consciousness: consciousness
consent: consent,consented
consequence: consequence,consequences
consequent: consequent
considerable: considerable
considerably: considerably
considerate: considerate
consideration: consideration,considerations
consign: consign,consigned
consist: consist,consisted
consistent: consistent
consolation: consolation,consolations
consolatory: consolatory
console: console,consoled,consoles
consort: consort
conspicuous: conspicuous
conspiracy: conspiracy
constable: constable
constant: constant
constantly: constantly
constitute: constituted
constraint: constraint
construction: construction
construe: construed
consult: consult,consulted,consulting
consultation: consultation
consume: consumed
consummation: consummation
contagious: contagious
contemplate: contemplated,contemplating
contemplation: contemplation
contempt: contempt
contemptible: contemptible
contemptuous: contemptuous
contemptuously: contemptuously
contend: contend,contends
content: content
contented: contented
contents: contents
contest: contest
continental: continental
contingency: contingency
continuation: continuation
continue: continue,continued,continues,continuing
continuous: continuous
contortion: contortions
contract: contract,contracted,contracts
contraction: contraction
contractor: contractors
contradict: contradict,contradicted,contradicting
contradiction: contradiction,contradictions
contradictory: contradictory
contrary: contrary
contrast: contrast,contrasted
contrition: contrition
contrive: contrive
contrived: contrived
control: control
controvert: controverted
convenient: convenient
conversation: conversation,conversations
converse: converse,conversed,conversing
convert: convert,converted,converting
convey: convey,conveyed
conveyance: conveyance
convict: convict,convicted
conviction: conviction
convince: convinces
convinced: convinced
convivial: convivial
convulse: convulsed,convulsing
convulsion: convulsion
convulsively: convulsively
cook: cook
cooking: cooking
cool: cool,cooling,cools
cooling: cooling
coolly: coolly
cooly: cooly
copious: copious
copper: copper,coppers
coppice: coppice
cord: cord
cordially: cordially
corduroy: corduroy
core: core
cork: cork,corked
corkscrew: corkscrew
corn: corn
corner: corner,corners
cornice: cornices
corporeal: corporeal
corpse: corpse,corpses
corpulent: corpulent
correct: correct
correction: correction
correctly: correctly
corroborate: corroborate,corroborated,corroborating
corroboration: corroboration
corroborative: corroborative
cosily: cosily
cosmetic: cosmetics
cost: cost
costly: costly
costume: costume
coterie: coterie
cottage: cottage,cottages
cottager: cottagers
cotton: cotton
couch: couch
cough: cough,coughed,coughing
council: council,councils
counsel: counsel
counsellor: counsellor
count: count,counted,counting
countenance: countenance,countenanced,countenances
counter: counter,counters
counteract: counteracting
counterfeit: counterfeit
counterpane: counterpane
country: country
countryman: countryman,countrymen
county: county
couple: couple,coupled,coupling
courage: courage
court: court,courts
cove: cove,coves
covent: covent
cover: cover,covered,covering,covers
covered: covered
covering: covering
coverlet: coverlet
coverlid: coverlid
covert: covert
covertly: covertly
covetous: covetous
covey: covey
cow: cowed
coward: coward
cowardice: cowardice
cowardly: cowardly
cower: cowered,cowering
crack: crack
crackle: crackled
crackling: crackling
cracksman: cracksman
cradle: cradle
craft: craft
craftily: craftily
crafty: crafty
cram: crammed
crape: crape
crash: crash,crashing
cravat: cravat
craven: craven
crawl: crawl,crawled,crawling
crazy: crazy
creak: creaking
create: created
creator: creator
creature: creature,creatures
credence: credence
credit: credit
creditable: creditable
creek: creek
creep: creep,creeping,crept
crevice: crevice,crevices
crib: crib
cribbage: cribbage
cricket: cricket
crime: crime,crimes
criminal: criminal,criminals
criminate: criminate
crimp: crimp
crimson: crimson
cripple: cripple,cripples
cripples: cripples
crisis: crisis
critic: critics
critical: critical
criticise: criticise
croak: croaked
crone: crone,crones
crop: crop,cropped
cross: cross,crossed,crosses,crossing
crouch: crouch,crouched,crouching
crow: crow
crowbar: crowbar
crowd: crowd,crowded,crowding,crowds
crowded: crowded
crown: crown
cruel: cruel
cruelty: cruelty
crumb: crumb,crumbs
crumble: crumbled,crumbling
crush: crushed,crushing
crushed: crushed
crust: crust
cub: cub
cudgel: cudgelling
cuff: cuff,cuffed,cuffs
cull: culled
culprit: culprits
cultivate: cultivate
cunning: cunning
cup: cup,cups
cupboard: cupboard,cupboards
cupidity: cupidity
cur: cur,curs
cure: cure,cured
curiosity: curiosity
curious: curious
curl: curl,curled,curling,curls
current: current
curse: curse,cursed,curses,cursing
cursed: cursed
cursory: cursory
curtain: curtain,curtained,curtains
curtsey: curtsey
custody: custody
custom: custom,customs
customary: customary
customer: customer
cut: cut,cutting
daffy: daffy
dagger: dagger
daily: daily
dainty: dainty
damage: damage,damaged
damages: damages
damme: damme
damn: damn
damp: damp,damped
dance: danced,dancing
danger: danger,dangers
dangerous: dangerous
dangle: dangle,dangled,dangling
dangling: dangling
dark: dark,darker,darkest
darken: darkened
darkly: darkly
darkness: darkness
darky: darkies
darling: darling
darn: darned
dart: dart,darted,darting
dash: dash,dashed,dashes,dashing
daub: daub
daughter: daughter,daughters
daunted: daunted
dawn: dawn,dawned,dawning
day: day,days
daybreak: daybreak
daydream: daydreams
daylight: daylight
dazzle: dazzling
dead: dead
deadly: deadly
deaf: deaf
deafen: deafened
deal: deal,dealing,deals,dealt
dearest: dearest
dearly: dearly
death: death,deaths
deathbed: deathbed
deathlike: deathlike
debased: debased
debt: debts
decanter: decanters
decay: decay,decaying
decayed: decayed
decease: decease
deceased: deceased
deceitful: deceitful
deceive: deceive,deceived,deceiving
decent: decent
deception: deception
decide: decide,decided
decidedly: decidedly
decision: decision
decisive: decisive
declaration: declaration,declarations
declare: declare,declared,declaring
decline: decline,declined,declines
decorate: decorate,decorated
decoration: decoration
decrease: decreasing
decrepitude: decrepitude
deed: deed,deeds
deem: deem,deemed,deems
deep: deep,deeper,deepest
deepen: deepening
deeply: deeply
defaced: defaced
defeat: defeated
defence: defence
defend: defend,defended,defending
deference: deference
deferential: deferential
deferentially: deferentially
defiance: defiance
deficiency: deficiency
define: defined
deformation: deformation
defy: defied,defy
degradation: degradation
degrade: degraded
degree: degree,degrees
deign: deigned
dejected: dejected
dejectedly: dejectedly
delay: delay
delegate: delegate,delegated
deliberately: deliberately
deliberation: deliberation
delicate: delicate
delicious: delicious
delight: delight,delighted
delighted: delighted
delightful: delightful
delinquent: delinquent
delirious: delirious
deliver: deliver,delivered,delivering
delivery: delivery
demand: demand,demanded,demands
demeanor: demeanor
demeanour: demeanour
demolition: demolition
demon: demon
demoniacal: demoniacal
demonstrate: demonstrated
demonstration: demonstration
demur: demur
den: den,dens
denial: denial
denizen: denizens
denominate: denominated
denote: denote,denoted
dense: dense
densely: densely
deny: denied,deny,denying
depart: depart,departed,departing
department: department
departure: departure
depend: depend
dependent: dependent
depict: depict,depicted
deplore: deploring
deport: deport
deportment: deportment
deposit: deposit,deposited,depositing
deposition: depositions
depravity: depravity
depredator: depredator
depress: depressed
depressing: depressing
deprive: deprive,deprived
depth: depth
deputy: deputy
derivable: derivable
derive: derived
descend: descend,descended,descending
description: description,descriptions
descry: descried
desert: desert,deserted,deserting
deserted: deserted
deserve: deserve,deserved,deserves
design: design,designing,designs
designate: designated
designation: designation
desirable: desirable
desire: desire,desired
desirous: desirous
desist: desist
desisted: desisted
desk: desk
desolate: desolate
desolation: desolation
despair: despair
despairing: despairing
despatch: despatch,despatched
desperate: desperate
desperation: desperation
despise: despise,despised
despondency: despondency
despondingly: despondingly
destination: destination
destine: destined
destiny: destiny
destitute: destitute
destroy: destroyed
destruction: destruction
destructive: destructive
detach: detach,detached
detain: detained,detaining
detection: detection
determination: determination
determine: determine,determined,determining
determined: determined
detest: detested
detract: detracted
detraction: detraction
develop: developed
device: device
devil: devil,devils
devilish: devilish
devious: devious
devise: devised
devolve: devolved
devote: devote,devoted,devoting
devoted: devoted
devotedly: devotedly
devotion: devotion
devotional: devotional
devour: devour,devoured
dew: dew
dexterity: dexterity
dexterous: dexterous
dexterously: dexterously
dial: dial
dialogue: dialogue
diamond: diamond
dick: dick
dickens: dickens
dictate: dictate
die: die,died,dies,dying
diem: diem
diet: diet
dietary: dietary
difference: difference
difficult: difficult
difficulty: difficulties,difficulty
diffuse: diffusing
digger: digger
dignified: dignified
dignitary: dignitary
dignity: dignity
dilapidated: dilapidated
dilate: dilated
dilemma: dilemmas
dim: dim,dimmed
diminish: diminish,diminished,diminishing
diminutive: diminutive
din: din
dine: dined
dinner: dinner,dinners
dint: dint
dip: dip,dipped
direct: direct,directed,directing
direction: direction,directions
dirt: dirt
dirty: dirtier,dirtiest,dirty
disadvantage: disadvantage
disagree: disagree
disagreeable: disagreeable
disappear: disappear,disappeared,disappearing
disappearance: disappearance
disappoint: disappoint,disappointed
disappointed: disappointed
disappointment: disappointment,disappointments
discard: discarded
discern: discern
discernible: discernible
discharge: discharge,discharged
disclose: disclose,disclosed,disclosing
disclosure: disclosure
discolour: discoloured
discomfort: discomforts
discomposure: discomposure
disconcerted: disconcerted
disconsolately: disconsolately
discontent: discontent
discontented: discontented
discordant: discordant
discourse: discourse
discover: discover,discovered,discovering
discovery: discoveries,discovery
discreet: discreet
discrimination: discrimination
discursive: discursive
discuss: discuss,discussed
discussion: discussion
disdain: disdain
disease: disease
disengage: disengage,disengaged,disengaging
disfigured: disfigured
disgrace: disgrace,disgraced
disgraceful: disgraceful
disguise: disguise,disguised,disguising
disgust: disgust
dish: dish
dishonesty: dishonesty
dishonour: dishonour
disinclination: disinclination
disjointed: disjointed
dislike: dislike,disliked
dismal: dismal
dismally: dismally
dismantle: dismantled
dismay: dismay
dismayed: dismayed
dismiss: dismissed
dismount: dismount,dismounted
disorder: disorder
disordered: disordered
disparagement: disparagement
dispatch: dispatch,dispatched
dispel: dispel,dispelled
dispensary: dispensary
disperse: dispersed
display: display,displayed,displaying
displeasure: displeasure
disposal: disposal
dispose: dispose,disposed,disposing
disposed: disposed
disposition: disposition
dispute: dispute,disputed,disputes,disputing
disregard: disregard
disreputable: disreputable
disrespect: disrespect
dissemble: dissemble
dissertation: dissertation
dissimulation: dissimulation
dissipate: dissipated
dissolute: dissolute
dissuade: dissuade
distance: distance
distant: distant
distended: distended
distiller: distiller
distinct: distinct
distinction: distinction
distinctly: distinctly
distinctness: distinctness
distinguish: distinguish
distinguishable: distinguishable
distinguished: distinguished
distort: distorted,distorting
distorted: distorted
distract: distract,distracted
distracted: distracted
distractedly: distractedly
distraction: distraction,distractions
distress: distress,distresses
distressed: distressed
distribution: distribution
district: district
distrust: distrust,distrusted
disturb: disturb,disturbed
disturbance: disturbance
ditch: ditch,ditches
diurnal: diurnal
dive: dive,dived,dives
diver: divers
diverge: diverged
diversity: diversity
divert: diverting
divide: divide,divided,dividing
divine: divine
divorce: divorce
dizzy: dizzy
doat: doats
dock: dock
dockhead: dockhead
doctor: doctor,doctors
document: document
dodge: dodge,dodged
dodger: dodger
dodgers: dodgers
dog: dog,dogs
dogged: dogged
doggedly: doggedly
dome: dome
domestic: domestic
domesticate: domesticated
domicile: domicile,domiciled
domination: domination
donkey: donkey
doom: doom
door: door,doors
doorless: doorless
doorstep: doorstep
doorway: doorway,doorways
dose: dose,doses
dot: dot,dotted
dote: doting
double: double,doubled,doubles
doubly: doubly
doubt: doubt,doubts
doubtfully: doubtfully
doubtless: doubtless
dove: dove
dow: dow
downright: downright
downstairs: downstairs
downy: downiest
doze: doze,dozed,dozing
dozen: dozen
drab: drab,drabs
drag: drag,dragged,dragging
drain: drain,drained
dram: dram
drat: drat
draught: draught,draughts
draw: draw,drawing,drawn,drew
drawback: drawback,drawbacks
drawer: drawer,drawers
drawing: drawing
dread: dread,dreaded,dreading
dreadful: dreadful
dreadfully: dreadfully
dream: dream,dreamed,dreaming
dreary: dreary
dress: dress,dressed,dressing
dressed: dressed
dressing: dressing
drift: drift,drifted
drily: drily
drink: drank,drink,drinking,drinks
drinking: drinking
drive: drive,driven,driving,drove
driver: driver
drizzle: drizzling
droll: droll,drollest
droop: drooped,drooping
drop: drop,dropped,dropping,drops
drover: drovers
drown: drown,drowned
drowsily: drowsily
drowsy: drowsy
drubbing: drubbing
drudge: drudge
drunk: drunk
drunken: drunken
drunkeness: drunkeness
drunkenness: drunkenness
dry: dried,dry
duck: duck,ducked
duel: duel
duet: duet
duff: duff
dull: dull
dullness: dullness
duly: duly
dumb: dumb
dummy: dummy
dungeon: dungeons
dupe: dupe,duped
duplicate: duplicate
duration: duration
dusk: dusk
dusky: dusky
dust: dust,dusting
dusty: dusty
duteous: duteous
dutiful: dutiful
duty: duties,duty
dwarf: dwarf
dwell: dwell,dwelling
dweller: dwellers
dwelling: dwelling
dwindle: dwindling
dye: dye
dying: dying
eager: eager
eagerly: eagerly
eagerness: eagerness
eagle: eagle
ear: ear,ears
earn: earn,earning,earns
earnest: earnest
earnestly: earnestly
earnestness: earnestness
earth: earth
earthly: earthly
earthy: earthy
earwig: earwigged
ease: ease,eased
easily: easily
east: east
eastern: eastern
easy: easy
eat: ate,eat,eaten,eating,eats
eatable: eatable
eatables: eatables
eating: eating
ebullition: ebullition
eccentric: eccentric
echo: echo,echoed
ecod: ecod
economy: economy
ecstasy: ecstasies,ecstasy
eddy: eddies,eddying
edge: edge,edged
edifying: edifying
educate: educated
education: education
edward: edward
edwin: edwin
eel: eel
effective: effective
effectual: effectual
effectually: effectually
efficacy: efficacy
efficient: efficient
effort: effort,efforts
eighteen: eighteen
ejaculate: ejaculated
ejaculation: ejaculations
elapse: elapsed
elastic: elastic
elated: elated
elbow: elbow,elbowed,elbowing,elbows
elder: elder
elderly: elderly
election: election
elegance: elegance
elegant: elegant
element: element
elevate: elevating
elevated: elevated
elevation: elevation
elicit: elicit,elicited
eligible: eligible
elm: elm
eloquence: eloquence
elucidative: elucidative
elude: eluded
elysium: elysium
emanate: emanated
embarrassed: embarrassed
embarrassment: embarrassment
embellish: embellished
embellishment: embellishment
embolden: emboldened
embrace: embrace,embraced,embraces,embracing
emerge: emerged,emerging
emergency: emergency
emit: emitted
emotion: emotion,emotions
emphasis: emphasis
emphatic: emphatic
emphatically: emphatically
employ: employ,employed,employing,employs
employer: employer
employment: employment
emporium: emporium
enable: enable,enabled
encase: encased
encircle: encircled
enclose: enclosed
encomium: encomiums
encompass: encompasses
encounter: encounter,encountered
encounters: encounters
encourage: encourage,encouraged,encouraging
encouraged: encouraged
encouragement: encouragements
encouraging: encouraging
encrust: encrusted
encumber: encumbered
endanger: endangered
endearing: endearing
endeavour: endeavour,endeavoured,endeavouring
endless: endless
endow: endowed
endowment: endowments
endurance: endurance
endure: enduring
enemy: enemies,enemy
energetically: energetically
energy: energies,energy
enforce: enforce
engage: engage,engaged
engaged: engaged
engaging: engaging
engender: engendered
engine: engine,engines
england: england
english: english
englishman: englishman
engrave: engraved
enhance: enhanced
enjoy: enjoy
enlighten: enlighten,enlightened
enmity: enmity
enormous: enormous
enshrine: enshrine
enshroud: enshrouded
ensnare: ensnared
ensue: ensued
entangle: entangled
enter: enter,entered,entering
enterprise: enterprise
entertain: entertain,entertained,entertains
entertainment: entertainment
enthrone: enthroned
enthusiasm: enthusiasm
enthusiastic: enthusiastic
entice: enticed
entire: entire
entitle: entitled
entrance: entrance
entreat: entreated,entreating
entreaty: entreaties
entry: entries,entry
entwine: entwined
envelop: enveloped
enviable: enviable
epitaph: epitaph
epithet: epithets
equal: equal,equals
equally: equally
equanimity: equanimity
equip: equipped
ere: ere
erect: erect,erected
err: erring
errand: errand,errands
erring: erring
error: error,errors
escape: escape,escaped,escaping
escort: escorted
espial: espial
esquire: esquire
essay: essayed,essaying
essential: essential
establish: established,establishing
establishment: establishment
estate: estate
esteem: esteem
estimate: estimate,estimated
evade: evading
evaporate: evaporated
evasion: evasion
evasive: evasive
evasively: evasively
eve: eve
evening: evening
event: event,events
eventually: eventually
evidence: evidence,evidences
evident: evident
evidently: evidently
evil: evil,evils
evince: evince,evinced,evincing
evolution: evolution
exact: exact
exaggeration: exaggerations
exalt: exalt,exalted
examination: examination
examine: examine,examined
exasperate: exasperated
exceed: exceed,exceeded,exceeding
exceedingly: exceedingly
excellence: excellence,excellences
excellent: excellent
exception: exceptions
excess: excess
excessive: excessive
exchange: exchange,exchanged,exchanging
excitable: excitable
excite: excite,excited
excited: excited
excitement: excitement
exciting: exciting
exclaim: exclaimed
exclamation: exclamation,exclamations
exclude: excluded
exclusive: exclusive
excruciating: excruciating
excuse: excuse,excused
execration: execration,execrations
execute: execute,executed,executing
execution: execution
exempt: exempt
exercise: exercise,exercises
exert: exerted
exertion: exertion,exertions
exhalation: exhalation
exhaust: exhausted
exhausted: exhausted
exhausting: exhausting
exhaustion: exhaustion
exhibit: exhibited
exhibiting: exhibiting
exist: exist,existed,existing,exists
existence: existence
exonerate: exonerate
expand: expand
expansion: expansion
expatiate: expatiate,expatiated,expatiating
expect: expect,expected,expecting
expectancy: expectancy
expectation: expectation,expectations
expected: expected
expediency: expediency
expedient: expedient,expedients
expedition: expedition,expeditions
expeditiously: expeditiously
expend: expended,expending
expenditure: expenditure
expense: expense
expensive: expensive
experience: experience,experienced,experiences
experienced: experienced
experimental: experimental
expert: expert
expiration: expiration
expire: expiring
explain: explain,explained,explaining
explanation: explanation
explanatory: explanatory
explicit: explicit
explorer: explorer
explosion: explosion
expose: exposed
exposure: exposure
express: express,expressed,expressing
expression: expression,expressions
expressive: expressive
expressively: expressively
exquisite: exquisite
exquisitely: exquisitely
extant: extant
extend: extended,extending
extended: extended
extensive: extensive
extent: extent
extenuation: extenuation
external: external
extinguish: extinguished
extort: extort,extorted
extra: extra
extract: extract,extracting
extraneous: extraneous
extraordinary: extraordinary
extreme: extreme
extremely: extremely
extricate: extricate
exultation: exultation
exultingly: exultingly
eye: eye,eyeing,eyes
eyebrow: eyebrows
eyed: eyed
eyelid: eyelids
faced: faced
facetious: facetious
facetiousness: facetiousness
facilitate: facilitate
factory: factory
faculty: faculty
fade: fade,faded,fading
fagin: fagin
fail: fail,failed,failing,fails
failure: failure
fain: fain
faint: faint,fainted,faintest,fainting,faints
fainting: fainting
faintly: faintly
fair: fair,fairest
faithful: faithful
faithfully: faithfully
fall: fall,fallen,falling,falls,fell
false: false
falsehood: falsehood
falter: faltered,faltering,falters
fame: fame
familiar: familiar
familiarity: familiarity
familiarly: familiarly
family: families,family
famine: famine
famous: famous
fan: fanning
fancied: fancied
fancy: fancied,fancies,fancy
fang: fang,fangs
fantastic: fantastic
farewell: farewell
farm: farm,farmed
farmer: farmer,farmers
farming: farming
farthing: farthing,farthings
fascination: fascination
fascinator: fascinator
fashion: fashion
fashioned: fashioned
fast: fast,faster
fasten: fastened,fastening
fastening: fastening,fastenings
fat: fat,fattest
fatal: fatal
fate: fate
father: father,fathers
fatigue: fatigue,fatigues,fatiguing
fatigued: fatigued
fatten: fatten
faugh: faugh
fault: fault,faults
favour: favour,favoured,favours
favourable: favourable
favoured: favoured
favourite: favourite
fear: fear,feared,fearing,fears
fearful: fearful
fearfully: fearfully
feasible: feasible
feat: feat,feats
featherweight: featherweight
feature: feature,features
fee: fee
feeble: feeble
feebly: feebly
feed: fed,feed
feeding: feeding
feel: feel,feeling,feels
feeling: feeling,feelings
feign: feigning
feigned: feigned
feint: feint
felicity: felicity
fell: felled
feller: feller,fellers
fellow: fellow,fellows
fellowship: fellowship
felon: felon,felons
felony: felony
female: female
feminine: feminine
fence: fence
fender: fender
ferocious: ferocious
ferocity: ferocity
ferry: ferry
fertile: fertile
fertility: fertility
fervency: fervency
fervent: fervent
fervently: fervently
fervour: fervour
fester: festered
festive: festive
fetch: fetch,fetched,fetching
fetter: fetters
fever: fever,fevers
fevered: fevered
feverish: feverish
feverishly: feverishly
fiction: fiction
fictitious: fictitious
fiddle: fiddle
field: field,fields
fierce: fierce,fiercer
fiercely: fiercely
fifteenth: fifteenth
fiftieth: fiftieth
fight: fights,fought
fighting: fighting
figure: figure,figured,figures,figuring
file: file,filed,files
filth: filth
filthy: filthiest,filthy
final: final
finally: finally
finances: finances
finding: finding
fine: fine,finest
finger: finger,fingers
finish: finished
finished: finished
firearm: firearms
fireman: firemen
fireplace: fireplace
fireside: fireside
firm: firm,firmer
firmament: firmament
firmly: firmly
firmness: firmness
fish: fish,fishes
fishing: fishing
fist: fist
fit: fit,fits,fitted,fittest
fitting: fitting
fixedly: fixedly
flame: flame,flames
flannel: flannel
flapped: flapped
flare: flaring
flash: flash,flashed,flashing
flat: flat
flatly: flatly
flaunt: flaunting
flavour: flavour
flee: fled
fleeting: fleeting
fleming: fleming
flesh: flesh
flight: flight,flights
flinching: flinching
fling: flinging,flung
float: floating
flock: flock
flog: flog,flogged
flood: flood
floor: floor,floors
flooring: flooring
flounce: flounced
flourish: flourish,flourished,flourishing
flourishing: flourishing
flow: flow
flower: flower,flowers
flurried: flurried
flush: flush,flushed
flute: flute
flutter: flutter,fluttered,fluttering
fly: flew,flies,fly,flying
foam: foam,foaming
fob: fob
foe: foes
fog: fog
foggy: foggy
fogle: fogle
foible: foibles
fol: fol
fold: fold,folded,folding,folds
folk: folks
follow: follow
folly: folly
fond: fond
fondling: fondlings
fondly: fondly
fondness: fondness
food: food
fool: fool
foolery: foolery
foolish: foolish
foot: feet,foot
footing: footing
footman: footmen
footpath: footpath
footprint: footprints
footstep: footstep,footsteps
forasmuch: forasmuch
forbearance: forbearance
forbid: forbid
forbore: forbore
force: force,forced,forcing
forcibly: forcibly
fore: fore
forefinger: forefinger
forego: foregoing
foregone: foregone
forehead: forehead
foreign: foreign
foremost: foremost
forenoon: forenoon
forerunner: forerunner
foresee: foresaw,foresee,foreseeing
foresight: foresight
forest: forest
forestall: forestall
foretaste: foretaste
forge: forged
forget: forget,forgetting,forgot,forgotten
forgetfulness: forgetfulness
forgive: forgive,forgiven
fork: fork
form: form,formed,forming,forms
formal: formal
formality: formalities,formality
formally: formally
formidable: formidable
forsake: forsook
fort: fort
forthwith: forthwith
fortify: fortifying
fortin: fortin
fortitude: fortitude
fortnight: fortnight
fortunate: fortunate
fortunately: fortunately
fortune: fortune,fortunes
forwards: forwards
foul: foulest
foundation: foundations
foundling: foundling
fourpenny: fourpenny
fourteen: fourteen
fourth: fourth
fowl: fowls
fraction: fraction
fracture: fractured
fragment: fragment,fragments
fragrance: fragrance
frail: frail
frame: frame
france: france
frank: frank
fraud: fraud
fraudulently: fraudulently
fray: frayed
freak: freak
freedom: freedom
freely: freely
freeze: frozen
french: french
frequent: frequent,frequented,frequenting
frequently: frequently
fresh: fresh,fresher
freshness: freshness
fret: fret,fretted
friday: friday
friend: friend,friends
friendless: friendless
friendliness: friendliness
friendly: friendly
friendship: friendship
fright: fright
frighten: frighten,frightened
frightened: frightened
frightening: frightening
frightful: frightful
frightfully: frightfully
frill: frill
frivolity: frivolities
fro: fro
frock: frock,frocks
frog: frog
frolicsome: frolicsome
frown: frown,frowned,frowning
frowning: frowning
frowsy: frowsy
fruit: fruit
fruitless: fruitless
fry: fried
frying: frying
fulfil: fulfilled
fulfilment: fulfilment
fulness: fulness
fumble: fumbling
fume: fumes
fumigate: fumigating
fun: fun
function: functions
functionary: functionaries,functionary
funeral: funeral,funerals
funny: funnier,funny
fur: fur
furious: furious
furiously: furiously
furnish: furnish,furnished,furnishes
furnished: furnished
furniture: furniture
furtively: furtively
fury: fury
fustian: fustian
future: future
gab: gab
gable: gable,gables
gad: gad
gadso: gadso
gaiety: gaiety
gaily: gaily
gain: gain,gained,gaining
gait: gait
gaiter: gaiters
gal: gal
gall: gall,galled
gallant: gallant
gallantly: gallantly
gallantry: gallantries,gallantry
gallery: galleries,gallery
galling: galling
gallop: gallop,galloped,galloping
gallows: gallows
galvanic: galvanic
gamble: gambled
game: game
gammon: gammon
gang: gang
gap: gap,gaps
gape: gape
garb: garb
garbage: garbage
garden: garden,gardens
gardener: gardener
gardening: gardening
garland: garlands
garment: garment,garments
garnish: garnish,garnished
garret: garret
gas: gas
gash: gash
gasp: gasped,gasping
gate: gate,gates
gateway: gateway
gather: gather,gathered,gathering
gaudy: gaudy
gaunt: gaunt
gay: gay,gayest
gaze: gaze,gazed,gazing
gazer: gazers
gazette: gazette
gen: gen
genealogy: genealogy
generation: generation
generosity: generosity
generous: generous
geneva: geneva
genii: genii
genius: genius
genteel: genteel
gentility: gentility
gentle: gentle,gentlest
gentleman: gentleman,gentlemen
gentlemanly: gentlemanly
gentleness: gentleness
gently: gently
genuine: genuine
george: george
gesticulation: gesticulation
gesture: gesture,gestures
ghastly: ghastly
ghost: ghost,ghosts
giant: giant
gibbet: gibbet
gift: gift,gifted
gig: gig
gigantic: gigantic
gild: gilding
giles: giles
gilt: gilt
gin: gin
ginger: ginger
girl: girl,girls
glad: glad
gladden: gladden
gladly: gladly
gladness: gladness
glance: glance,glanced,glances,glancing
glare: glare,glaring
glaring: glaring
glass: glass,glasses
glassful: glassful
glassy: glassy
gleam: gleam,gleamed,gleaming
glean: glean
glee: glee
gleefully: gleefully
glide: glided,gliding
glim: glim
glimmer: glimmered,glimmering
glimmering: glimmering
glimpse: glimpse
glisten: glistened,glistening
gloom: gloom
gloomy: gloomy
glorious: glorious
glory: glory
glove: gloves
glow: glow,glowing
glut: glut
goad: goaded
goblin: goblin
god: god
gold: gold
goodness: goodness
gore: gore
gorgeously: gorgeously
govern: governed
government: government
governor: governor
gown: gown
grab: grabbed
grace: grace
graceful: graceful
gracious: gracious
graciously: graciously
grade: grade
gradual: gradual
gradually: gradually
grain: grain,grains
grandeur: grandeur
grandfather: grandfather
grandmother: grandmothers
grandson: grandson
grant: granted,grants
grasp: grasp,grasped,grasping
grass: grass
grate: grate,grated,grating
grateful: grateful
grater: grater
gratification: gratification
gratified: gratified
gratify: gratified,gratify,gratifying
gratitude: gratitude
gratuitous: gratuitous
grave: grave,graves
gravely: gravely
gravestone: gravestones
gravity: gravity
gray: gray
grazier: grazier
grease: grease
greasy: greasy
greatly: greatly
greediness: greediness
greedy: greedy
green: green
greenland: greenland
greet: greet,greeted,greeting
grey: grey
grief: grief,griefs
grieving: grieving
grievously: grievously
grim: grim
grimace: grimaces
grimly: grimly
grimy: grimy
grin: grin,grinned,grinning
grind: grind,grinding
grip: grip
grizzled: grizzled
grizzly: grizzly
groan: groan,groaned,groans
grope: groped,groping
gross: gross
grotesque: grotesque
ground: ground
grounds: grounds
groundsel: groundsel
grovel: grovelling
grow: grew,grow,growing,grown,grows
growl: growl,growled,growling
growling: growling
growth: growth
grub: grub
gruel: gruel
gruff: gruff
gruffly: gruffly
grumble: grumbling
grunt: grunt,grunting
guard: guard,guarded
guardianship: guardianship
guess: guess,guessed,guesses,guessing
guest: guest,guests
guide: guide,guided
guile: guile
guileless: guileless
guilt: guilt
guilty: guilty
guinea: guineas
guineas: guineas
guise: guise
gulf: gulf
gulp: gulp
gum: gums
gun: gun
gunpowder: gunpowder
gurgle: gurgling
gush: gushing
gust: gust
gutter: gutter
gymnastic: gymnastic
ha: ha
habit: habit,habits
habitation: habitation
habitual: habitual
hack: hack
hackney: hackney
hag: hag,hags
haggard: haggard
haggardness: haggardness
haggle: haggling
hah: hah
hail: hail,hailed
hair: hair,hairs
haired: haired
halfpence: halfpence
halfpenny: halfpenny
hall: hall
hallo: hallo
halloa: halloa
hallowed: hallowed
halt: halt,halted,halting
halter: halter
ham: ham
hammer: hammer,hammering,hammers
hammersmith: hammersmith
hand: hand,handed,handing,hands
handcuffs: handcuffs
handed: handed
handful: handful
handiwork: handiwork
handkercher: handkercher
handkerchief: handkerchief,handkerchiefs
handle: handle,handles
handsome: handsome
handsomely: handsomely
handy: handy
hang: hang,hanged,hanging,hung
hanging: hanging
happen: happen,happened,happening
happily: happily
happiness: happiness
happy: happier,happy
hard: hard,harder,hardest
harden: harden,hardened
hardened: hardened
hardihood: hardihood
hardy: hardy
hark: hark
harm: harm
harmless: harmless
harness: harness,harnessed
harridan: harridan,harridans
harry: harry
harsh: harsh,harshest
harshly: harshly
harshness: harshness
haste: haste
hasten: hastened,hastening,hastens
hastily: hastily
hastiness: hastiness
hasty: hasty
hat: hat,hats
hatband: hatband
hate: hate,hated,hates
hatred: hatred
haughtiness: haughtiness
haughty: haughtiest,haughty
haul: haul,hauled,hauling
haunt: haunt,haunted,haunts
hawk: hawk,hawking
hawker: hawkers
hay: hay
haymaker: haymakers
haystack: haystack
hazard: hazard,hazarded,hazarding
hazardous: hazardous
head: head,headed,heads
headed: headed
headlong: headlong
heal: healing
health: health
healthy: healthy
heap: heap,heaped,heaps
hear: hear,heard,hearing,hears
hearer: hearers
hearing: hearing
hearse: hearse
heart: heart,hearts
hearted: hearted
hearth: hearth
heartily: heartily
hearty: hearty
heat: heat,heated
heath: heath
heave: heave,heaved
heaven: heaven,heavens
heaver: heaver,heavers
heavily: heavily
heaviness: heaviness
heaving: heaving
heavy: heavier,heavy
hedge: hedge,hedged,hedges
heed: heed,heeded,heeding
heedless: heedless
heel: heel,heels
height: height
heighten: heightened
helpless: helpless
helplessness: helplessness
helpmate: helpmate
hem: hem,hemmed
hen: hen
henceforth: henceforth
herald: herald
herd: herd
heretofore: heretofore
hero: hero
heroic: heroic
heroine: heroine
heroism: heroism
hesitate: hesitate,hesitated,hesitates,hesitating
hesitation: hesitation
hey: hey
hidden: hidden
hide: hidden,hide,hiding
hideous: hideous
hideously: hideously
hiding: hiding
highly: highly
highway: highway
hill: hill,hills
hind: hind
hinge: hinges
hint: hint,hinted,hinting,hints
hiss: hissed
hissing: hissing
hist: hist
historian: historian
history: history
hit: hit
hitch: hitched
hitherto: hitherto
ho: ho
hoarse: hoarse
hoarser: hoarser
hob: hob
hobble: hobbling
hoist: hoist,hoisted
hold: held,hold,holding,holds
hole: hole,holes
holiday: holiday
holiness: holiness
holler: holler
hollow: hollow
homeless: homeless
homely: homely
homeopathic: homeopathic
homeward: homeward
homewards: homewards
hone: hones
honest: honest
honestly: honestly
honeysuckle: honeysuckle
honour: honour,honoured,honours
honourable: honourable
honourably: honourably
hoof: hoof,hoofs
hook: hook
hope: hope,hoped,hopes,hoping
hopeful: hopeful
hopeless: hopeless
hopelessness: hopelessness
hor: hor
horn: horn
horrible: horrible
horrid: horrid
horror: horror,horrors
horse: horse,horses
horseback: horseback
horses: horses
hosier: hosier
hospital: hospital
host: host,hosts
hostler: hostler
hot: hot
hotbrained: hotbrained
hotel: hotel
hound: hound
hour: hour,hours
house: house,housed,houses
housebreaker: housebreaker
housebreaking: housebreaking
housekeeper: housekeeper
houseless: houseless
housemaid: housemaid,housemaids
housetops: housetops
hovel: hovel,hovels
hover: hovered,hovering,hovers
howl: howl,howled,howling
huddle: huddle,huddled
hue: hue,hues
hug: hugged
huge: huge
hulk: hulks
hullo: hullo
human: human
humane: humane
humanely: humanely
humanity: humanity
humble: humble,humbler
humbly: humbly
humiliate: humiliated
humility: humility
humorous: humorous
humour: humour,humours
humoured: humoured
hump: hump
humph: humph
hunchback: hunchback
hunger: hunger
hungry: hungry
hunk: hunk
hunt: hunt,hunting
hunter: hunter
hurl: hurl,hurled
hurrah: hurrah
hurried: hurried
hurriedly: hurriedly
hurry: hurried,hurry,hurrying
hurt: hurt,hurts
husband: husband,husbands
hush: hush,hushed
husky: husky
hussy: hussies
hut: huts
huzzah: huzzah
hyde: hyde
hydraulic: hydraulic
hysteric: hysterics
hysterical: hysterical
hysterically: hysterically
ice: ice
idea: idea,ideas
identical: identical
identify: identified,identify,identifying
identity: identity
idiot: idiot
idiotic: idiotic
idle: idle
idler: idlers
idly: idly
ignominious: ignominious
ignorance: ignorance
ignorant: ignorant
iii: iii
illegal: illegal
illegitimate: illegitimate
illness: illness
illuminate: illuminated
illusion: illusion
illustrate: illustrated,illustrating
illustration: illustration
illustrative: illustrative
image: images
imaginable: imaginable
imaginary: imaginary
imagination: imagination
imagine: imagine,imagined,imagining
imitate: imitate
imitation: imitation
immeasurable: immeasurable
immeasurably: immeasurably
immense: immense
immensely: immensely
immoderately: immoderately
immoveable: immoveable
imp: imp
impair: impair,impaired
impart: impart,imparted,imparting,imparts
impartial: impartial
impartially: impartially
impatience: impatience
impatient: impatient
impatiently: impatiently
impeach: impeach
impede: impeded
impel: impelled
imperatively: imperatively
imperceptible: imperceptible
imperfectly: imperfectly
imperiously: imperiously
impertinence: impertinences
impertinent: impertinent
impetuosity: impetuosity
impetuous: impetuous
impetuously: impetuously
impetus: impetus
impiety: impiety
impious: impious
implant: implanted
implement: implement,implements
implicitly: implicitly
implore: implored,imploring
imply: imply
import: import
importunate: importunate
impose: impose,imposed,imposing
imposing: imposing
impossibility: impossibilities,impossibility
impossible: impossible
imposter: imposter
impostor: impostor
impotence: impotence
impotent: impotent
imprecation: imprecation,imprecations
impregnate: impregnated
impress: impressing
impressed: impressed
impression: impression
impressive: impressive
impressively: impressively
imprint: imprinted,imprinting
imprinting: imprinting
imprison: imprisoned
imprisonment: imprisonment
improbable: improbable
improper: improper
impropriety: improprieties,impropriety
improve: improve,improved,improving
improvement: improvement,improvements
improving: improving
impudence: impudence
impudent: impudent
impulse: impulse,impulses
imputation: imputation
inability: inability
inadvertently: inadvertently
inanimate: inanimate
inaudible: inaudible
incapable: incapable
incarceration: incarceration
incertitude: incertitude
incessantly: incessantly
inch: inch,inches
incident: incident
incidental: incidental
inclination: inclination,inclinations
incline: inclined,inclining
inclined: inclined
inclose: inclosed
include: include
incoherent: incoherent
incoherently: incoherently
incomplete: incomplete
inconsiderable: inconsiderable
inconsolable: inconsolable
incontestable: incontestable
inconvenience: inconvenience
inconveniently: inconveniently
incorrigible: incorrigible
increase: increase,increased,increases,increasing
incredible: incredible
incredulous: incredulous
incredulously: incredulously
incur: incurred
incurable: incurable
indemnify: indemnified
indenture: indentures
independence: independence
independent: independent
indescribable: indescribable
indication: indication,indications
indies: indies
indifference: indifference
indigence: indigence
indignant: indignant
indignantly: indignantly
indignation: indignation
indirectly: indirectly
indispensably: indispensably
indistinct: indistinct
individual: individual,individuals
indolent: indolent
indolently: indolently
indubitably: indubitably
induce: induce,induced,inducing
inducement: inducement,inducements
indulge: indulge,indulged,indulging
industrious: industrious
ineffable: ineffable
ineffectual: ineffectual
ineffectually: ineffectually
inestimable: inestimable
inevitably: inevitably
inexcusable: inexcusable
inexhaustible: inexhaustible
inexplicable: inexplicable
infallible: infallible
infallibly: infallibly
infamous: infamous
infamy: infamy
infancy: infancy
infant: infant,infants
infatuation: infatuation
infect: infected
inferior: inferior,inferiors
inferiority: inferiority
infernal: infernal
infirmary: infirmary
infirmity: infirmities,infirmity
inflame: inflaming
inflammatory: inflammatory
inflexible: inflexible
inflict: inflict,inflicted,inflicting
influence: influence,influenced,influences
inform: inform,informed,informing
informant: informant
informer: informer
infuriate: infuriate,infuriated
ingenious: ingenious
ingeniously: ingeniously
ingenuity: ingenuity
ingratitude: ingratitude
inhabit: inhabited
inhabitant: inhabitants
inhale: inhaling
inherit: inherit,inherited
inheritance: inheritance
inhuman: inhuman
initiate: initiated
injunction: injunction,injunctions
injure: injure,injured
injured: injured
injurious: injurious
injury: injuries,injury
injustice: injustice
inkstand: inkstand
inland: inland
inlet: inlet
inmate: inmates
inmost: inmost
inn: inn
innermost: innermost
innocence: innocence
innocent: innocent
innocently: innocently
inquest: inquest
inquire: inquire,inquired,inquires,inquiring
inquiry: inquiries,inquiry
inquisitive: inquisitive
inscription: inscription
insect: insects
insecure: insecure
insensible: insensible
insensibly: insensibly
inseparable: inseparable
insert: insert,inserted
insinuate: insinuating
insist: insist,insisted
insolent: insolent
inspect: inspect,inspected,inspecting
inspection: inspection
instance: instance
instant: instant
instantaneous: instantaneous
instantaneously: instantaneously
instantly: instantly
instil: instilling
instinct: instinct
instinctively: instinctively
instruct: instructed
instruction: instructions
instrument: instrument
instrumental: instrumental
insult: insult,insults
insulting: insulting
insupportable: insupportable
intellectual: intellectual
intelligence: intelligence
intelligent: intelligent
intelligible: intelligible
intend: intend,intended,intends
intense: intense
intensely: intensely
intensity: intensity
intent: intent
intention: intention,intentions
intently: intently
intercession: intercession
interchange: interchange,interchanging
interfere: interfere,interfered
interference: interference
interior: interior
interment: interment
interminable: interminable
internal: internal
interpose: interpose,interposed,interposing
interpret: interpret,interpreted
interrogation: interrogations
interrogatory: interrogatory
interrupt: interrupt,interrupted,interrupting,interrupts
interrupted: interrupted
interruption: interruption,interruptions
intersperse: interspersed
interval: interval,intervals
intervene: intervening
interview: interview
intimacy: intimacy
intimate: intimate,intimated,intimating
intimately: intimately
intimation: intimation
intolerably: intolerably
intoxicate: intoxicated
intricacy: intricacies
intricate: intricate
introduce: introduce,introduced,introduces
introduces: introduces
introduction: introduction
introductory: introductory
intrude: intrude
intrusion: intrusion
intrusively: intrusively
invalid: invalid
invaluable: invaluable
invariable: invariable
invariably: invariably
invective: invectives
invent: invented
inventory: inventory
invest: invests
investigate: investigated
investigation: investigation
invincible: invincible
invitation: invitation,invitations
invite: invited
invoke: invoked,invoking
involuntarily: involuntarily
involuntary: involuntary
involve: involve,involved,involves,involving
involved: involved
inwardly: inwardly
inwards: inwards
irascible: irascible
ire: ire
irish: irish
iron: iron,irons
ironical: ironical
irrelevant: irrelevant
irrepressible: irrepressible
irresistible: irresistible
irresistibly: irresistibly
irresolute: irresolute
irresolution: irresolution
irreverent: irreverent
irritable: irritable
irritate: irritating
irritation: irritation
island: island
issue: issue,issued
item: item
iv: iv
ivy: ivy
ix: ix
jack: jack
jackanapes: jackanapes
jacket: jacket
jacob: jacob
jade: jade
jaded: jaded
jagged: jagged
jail: jail,jails
jailer: jailer
jailor: jailor
jamaica: jamaica
japan: japanning
jaundiced: jaundiced
jaw: jaw,jaws
jealous: jealous
jealousy: jealousy
jeer: jeering,jeers
jem: jem
jemmy: jemmies
jerk: jerk,jerked,jerking
jessamine: jessamine
jest: jest,jests
jew: jew
jewel: jewels
jewellery: jewellery
jingle: jingling
job: job
jocosity: jocosity
jocularity: jocularity
joe: joe
jog: jogged,jogging
john: john
joint: joint
jointed: jointed
joke: joke,joked,jokes,joking
jolly: jolly
jorum: jorum
jostle: jostled,jostling
journey: journey,journeyed
jove: jove
joviality: joviality
joy: joy
joyful: joyful
joyfully: joyfully
joyous: joyous
joyously: joyously
joyousness: joyousness
judge: judge,judged,judges
judges: judges
judging: judging
judgment: judgment,judgments
jug: jug
jumble: jumbled
jump: jump,jumped,jumping
juncture: juncture
junior: junior
jury: juries,jury
juryman: juryman,jurymen
justice: justice
justified: justified
justify: justified,justify
justly: justly
juvenile: juvenile
keen: keen
keenly: keenly
keeper: keeper
keeping: keeping
ken: ken,kens
kennel: kennel,kennels
kensington: kensington
kep: kep
ketch: ketch
kettle: kettle,kettles
key: key
keyhole: keyhole
kick: kick,kicked,kicking
kid: kid
kidnap: kidnapped
kidnapping: kidnapping
kill: kill,killed
kinchin: kinchin
kindle: kindled
kindly: kindly
kindness: kindness,kindnesses
kindred: kindred
king: king
kingdom: kingdom
kingston: kingston
kiss: kiss,kissed,kissing
kitchen: kitchen
kitten: kitten,kittens
knack: knack
knavery: knavery
knee: knee,knees
kneed: kneed
kneel: kneel,kneeling,knelt
knell: knell
knife: knife
knit: knitting
knock: knock,knocked,knocking
knocker: knocker
knot: knot,knots
knotted: knotted
knotty: knottiest
knowing: knowing
knowledge: knowledge
knuckle: knuckle,knuckles
labour: labour,laboured,labouring,labours
labourer: labourers
labyrinth: labyrinth
lace: lace,laced
laced: laced
lack: lacking
lad: lad,lads
ladder: ladder,ladders
laden: laden
ladle: ladle,ladled
lady: ladies,lady
lag: lag,lagged,lagging
lagging: lagging
lair: lair
lairy: lairy
lamb: lamb
lame: lame,lamed
lament: lamented
lamentable: lamentable
lamentation: lamentations
lamp: lamp,lamps
land: land
landing: landing
landlady: landlady
landlord: landlord
landscape: landscape
lane: lane,lanes
languid: languid
languidly: languidly
languish: languish,languishing
languor: languor
lank: lank
lantern: lantern
lap: laps
lapse: lapse
larceny: larceny
lark: lark
lash: lash,lashed
lasting: lasting
latch: latch
late: late
latent: latent
lattice: lattice,latticed
laudable: laudable
laudanum: laudanum
laugh: laugh,laughed,laughing,laughs
laughter: laughter
launch: launched
lavender: lavender
lavish: lavished
law: law,laws
lawn: lawn
lawyer: lawyer,lawyers
lay: laid,lay,laying,lays
layer: layers
lazy: lazy
lazybone: lazybones
lead: lead,leading,leads,led
leaden: leaden
leader: leader
leaf: leaf,leaves
leafless: leafless
leaky: leaky
lean: lean,leaned,leaning,leant
leaning: leaning
leap: leap,leaped,leaping
learn: learn,learned,learnt
leather: leather,leathers
leathern: leathern
leave: leave,leaves,leaving,left
lecture: lecture
lee: lee
leer: leer
leetle: leetle
left: left
leg: leg,legs
legal: legal
legally: legally
legged: legged
leggings: leggings
leisure: leisure
lend: lend,lent
lengthen: lengthen,lengthened,lengthens
leniency: leniency
leniently: leniently
lessen: lessen
lesson: lesson,lessons
letter: letter,letters
level: level,levelled
levity: levity
liable: liable
liar: liar,liars
libel: libel
liberal: liberal
liberality: liberality
liberty: liberties,liberty
license: license,licensed
lick: licking
licking: licking
lid: lid
lie: lain,lie,lies,lying
lieu: lieu
life: life,lives
lifeless: lifeless
lifer: lifer
lift: lift,lifted,lifting
light: light,lighted,lighter,lighting,lights,lit
lighted: lighted
lighten: lighten
lightly: lightly
lightning: lightning
lightsome: lightsome
likeness: likeness,likenesses
liking: liking
limb: limb,limbs
limbed: limbed
lime: lime
limit: limits
limited: limited
limp: limped
limping: limping
lineament: lineament,lineaments
linen: linen
linger: linger,lingered,lingering,lingers
link: linked
lip: lip,lips
liquid: liquids
liquor: liquor
list: listed
listen: listen,listened,listening
listener: listener,listeners
listening: listening
listless: listless
listlessly: listlessly
literally: literally
literary: literary
literature: literature
live: live,lived,lives,living
livelihood: livelihood
livelong: livelong
lively: livelier,lively
livered: livered
livery: livery
livid: livid
living: living
load: load,loaded
loaded: loaded
loading: loading
loaf: loaf,loaves
loathe: loathe
loathing: loathing
loathsome: loathsome
local: local
locality: localities,locality
lock: lock,locked,locking,locks
locket: locket
locking: locking
lodge: lodge,lodged,lodges
lodging: lodging
lodgings: lodgings
lofty: lofty
loiter: loiter,loitered
loitering: loitering
loll: lolled
london: london
loneliness: loneliness
lonely: lonely
lonesomeness: lonesomeness
loo: loo
looker: looker,lookers
loop: loop
loophole: loophole
loose: loose
loosely: loosely
loosen: loosened
loquacious: loquacious
loquacity: loquacity
lor: lor
lord: lord,lorded,lords
lose: lose,loses,losing,lost
loss: loss,losses
lost: lost
lot: lot,lots
lotte: lotte
loud: loud,louder,loudest
loudly: loudly
lounge: lounging
lounging: lounging
love: love,loved,loves,loving
loveliness: loveliness
lovely: loveliest,lovely
lover: lover,lovers
lovingly: lovingly
lowly: lowly
lubberly: lubberly
luck: luck
luckily: luckily
lucky: lucky
lucrative: lucrative
ludicrous: ludicrous
lug: lugged
luggage: luggage
lull: lulled
lumber: lumbering
lummy: lummy
lump: lump
lung: lungs
lurk: lurking
lushed: lushed
lustily: lustily
lustre: lustre
lustreless: lustreless
luxuriance: luxuriance
luxuriant: luxuriant
luxury: luxury
lying: lying
lynx: lynx
machine: machine
machinery: machinery
mad: mad
madden: maddened
madhouse: madhouse
madly: madly
madman: madman,madmen
madness: madness
magic: magic
magisterial: magisterial
magistrate: magistrate,magistrates
magnanimously: magnanimously
magnificent: magnificent
magnitude: magnitude
magnus: magnus
magpie: magpie
maid: maid,maids
mail: mail
maiming: maiming
main: main
maintain: maintain,maintained,maintaining
majestic: majestic
majestically: majestically
majesty: majesty
maker: maker
male: male
malice: malice
malicious: malicious
maliciously: maliciously
malignantly: malignantly
malignity: malignity
maltreat: maltreated
manage: manage,managed,managing
mandate: mandate
manifest: manifesting
manifestation: manifestations
manifold: manifold
mankind: mankind
mann: mann
manner: manner
mannered: mannered
manners: manners
mansion: mansion
mantel: mantel
mantelpiece: mantelpiece
mantelshelf: mantelshelf
mantle: mantle
manual: manual
manufactory: manufactory
manufacture: manufacture
mar: mar
marble: marble,marbles
march: marched
mark: mark,marked,marking,marks
marked: marked
market: market
marriage: marriage
married: married
marry: married,marry,marrying
marshal: marshal
marshy: marshy
martha: martha
martin: martin
marvel: marvel,marvelling
marvellously: marvellously
mask: mask
mass: mass
massive: massive
master: master,mastered,mastering,masters
masterpiece: masterpiece
mastership: mastership
mat: mat,matted
match: match
mate: mate
material: material,materials
materially: materially
matrimonial: matrimonial
matrimony: matrimony
matron: matron,matrons
matter: matter,matters
mattress: mattress
mature: mature
maudlin: maudlin
maxim: maxim
mayor: mayors
maze: maze
meadow: meadow,meadows
meagre: meagre
meal: meal,meals
mealtime: mealtimes
mealy: mealy
meaning: meaning
meanly: meanly
meanness: meanness
measles: measles
measure: measure,measured
meat: meat
mechanically: mechanically
meddle: meddled
mediately: mediately
medical: medical
medicine: medicine
meditate: meditated,meditating
meditation: meditation,meditations
meditative: meditative
medium: medium
meek: meek
meekly: meekly
meekness: meekness
meet: meet,meeting,met
meeting: meeting
melancholy: melancholy
mell: mell
melodrama: melodramas
melodramatic: melodramatic
melody: melody
melt: melt
melting: melting
memoirs: memoirs
memory: memories,memory
menace: menaced
menacing: menacing
mend: mend,mended,mending
menial: menial
mental: mental
mentally: mentally
mention: mention,mentioned,mentioning
merchandise: merchandise
merchant: merchant,merchants
merciful: merciful
mercy: mercies,mercy
mere: mere,merest
merino: merino
merit: merit,merited,merits
meritorious: meritorious
merriment: merriment
merry: merriest,merry
message: message
messenger: messenger
metal: metal
metallic: metallic
metropolis: metropolis
metropolitan: metropolitan
middle: middle
midnight: midnight
midst: midst
midwifery: midwifery
mighty: mighty
mild: mild
mildew: mildew
mildewy: mildewy
mildly: mildly
mildness: mildness
mile: mile,miles
milestone: milestone
military: military
milk: milk
milkman: milkman
mills: mills
millstone: millstone
mimic: mimic
mind: mind,minds
minded: minded
mindful: mindful
mindfulness: mindfulness
mingle: mingle,mingled,mingling
mingles: mingles
minister: ministers
minority: minority
minute: minute,minutes,minutest
minx: minx
miracle: miracle
miraculous: miraculous
mire: mire
mirth: mirth
mis: mis
mischance: mischance
mischief: mischief
miser: miser
miserable: miserable
misery: miseries,misery
misfortune: misfortune,misfortunes
misgiving: misgivings
missile: missiles
mission: mission
missis: missis
mist: mist
mistake: mistake,mistakes,mistaking
mistaken: mistaken
mister: mister
mistering: mistering
mistress: mistress
mistrust: mistrust
misty: misty
mix: mix,mixed,mixing
mixed: mixed
mixture: mixture
moan: moan,moaned,moaning,moans
mob: mob
mock: mock
mockery: mockery
mode: mode
model: model,models
moderate: moderate
moderately: moderately
modern: modern
modest: modest
modestly: modestly
moist: moist
moisture: moisture
mollify: mollified
molten: molten
moment: moment,moments
momentary: momentary
momentous: momentous
monday: monday
money: money
mongrel: mongrel
monk: monks
monks: monks
monosyllable: monosyllable
monster: monster
monstrous: monstrous
month: month,months
mood: mood
moodily: moodily
moon: moon
moonlit: moonlit
moor: moored
moral: moral
moralise: moralising
morality: morality
morally: morally
morning: morning
morrice: morrice
morris: morris
morsel: morsel
mortal: mortal,mortals
mortality: mortality
mortally: mortally
mortar: mortar
mortification: mortification
moss: moss
mother: mother,mothers
motherly: motherly
motion: motion,motioned,motioning,motions
motionless: motionless
motive: motive,motives
mould: mould
moulder: mouldering
mound: mounds
mount: mounted,mounting
mountebank: mountebank
mourner: mourner,mourners
mournful: mournful
mournfully: mournfully
mourning: mourning
mouse: mice,mouse
mouth: mouth
movable: movables
moveable: moveables
moved: moved
movement: movement
mower: mowers
mud: mud
muddle: muddle,muddled
muddy: muddy
muffin: muffin,muffins
muffle: muffled,muffling
multifarious: multifarious
multitude: multitude
mumble: mumbled
mumbling: mumbling
murder: murder,murdered,murdering,murders
murderer: murderer,murderers
murdering: murdering
murderous: murderous
murky: murky
murmur: murmur,murmured,murmurs
murrain: murrain
mus: mus
muscle: muscle
muscular: muscular
muse: musing
music: music
musical: musical
muslin: muslin
mussulman: mussulman
mustachio: mustachios
muster: muster
musty: musty
mute: mute,mutes
mutely: mutely
mutter: mutter,muttered,muttering
muttering: muttering
mutton: mutton
mutual: mutual
myrmidon: myrmidons
mysterious: mysterious
mysteriously: mysteriously
mystery: mysteries,mystery
mystification: mystification
nab: nab,nabbed
nail: nail,nailed,nails
naked: naked
nameless: nameless
nance: nance
nancy: nancy
nankeen: nankeen
nap: nap,naps
napkin: napkin
narrate: narrated
narration: narration
narrative: narrative
narrow: narrow,narrower,narrowest
narrowly: narrowly
nasty: nastier,nasty
native: native
natural: natural
naturally: naturally
nature: nature,natures
naughty: naughty
naval: naval
nearer: nearer
neat: neat
neatly: neatly
necessaries: necessaries
necessity: necessity
neck: neck,necks
neckcloth: neckcloth
necked: necked
neckerchief: neckerchief
ned: ned
needful: needful
needle: needle
needless: needless
negative: negative
neglect: neglect,neglected
negligently: negligently
neighbour: neighbour,neighbouring,neighbours
neighbourhood: neighbourhood
nephew: nephews
neptune: neptune
nerve: nerve,nerves
nervous: nervous
nervously: nervously
nether: nether
nettle: nettled,nettles
newgate: newgate
news: news
newspaper: newspaper,newspapers
nice: nice
nicely: nicely
nicety: niceties,nicety
niece: niece,nieces
nigger: niggers
nigh: nigh
night: night,nights
nightcap: nightcap
nightfall: nightfall
nightly: nightly
nimble: nimble
nimbly: nimbly
ninepence: ninepence
nineteen: nineteen
ninth: ninth
noah: noah
nob: nobs
noble: noble
nobleman: nobleman
nocturnal: nocturnal
nod: nod,nodded,nodding,nods
noise: noise,noises
noiseless: noiseless
noisily: noisily
noisome: noisome
noisy: noisy
nonce: nonce
nonsense: nonsense
nook: nook,nooks
noon: noon
noose: noose
north: north
nose: nose,noses
nosed: nosed
nosegay: nosegay,nosegays
nosey: nosey
nostril: nostrils
notable: notable
note: note,notes,noting
notice: notice,noticed,noticing
notion: notion,notions
notorious: notorious
nourishment: nourishment
novelty: novelty
nozzle: nozzle
nudge: nudged
nudging: nudging
numerous: numerous
nurse: nurse,nursed,nurses
nursing: nursing
nutmeg: nutmeg
nutshell: nutshell
oak: oak
oaken: oaken
oakum: oakum
oar: oar
oath: oath,oaths
oatmeal: oatmeal
obdurate: obdurate
obedience: obedience
obedient: obedient
obeisance: obeisance
obey: obey,obeyed
object: object,objected,objects
objection: objection
oblige: obliged,obliging
obliterate: obliterated
obscure: obscure,obscured
obscurity: obscurity
observable: observable
observance: observance
observant: observant
observation: observation,observations
observatory: observatory
observe: observe,observed,observing
observer: observer
obstacle: obstacle,obstacles
obstinacy: obstinacy
obstinate: obstinate
obstinately: obstinately
obvious: obvious
occasion: occasion,occasioned,occasioning,occasions
occasionally: occasionally
occupation: occupation,occupations
occupier: occupier
occupy: occupied,occupy,occupying
occur: occur,occurred,occurring
occurrence: occurrence,occurrences
od: od
odd: odd
oddity: oddity
odds: odds
odour: odour,odours
offal: offal
offence: offence
offend: offended
offender: offender,offenders
offensive: offensive
offer: offer,offered,offering,offers
offering: offering
offhand: offhand
office: office,offices
officer: officer,officers
official: official
officiate: officiating
officiously: officiously
offspring: offspring
oftener: oftener
oho: oho
oliver: oliver
onion: onion,onions
onset: onset
onward: onward
openly: openly
openness: openness
opera: opera
operation: operation,operations
opinion: opinion,opinions
opium: opium
opportunely: opportunely
opportunity: opportunities,opportunity
oppose: oppose,opposing
opposition: opposition
oppress: oppress,oppressed
oppressive: oppressive
opprobrious: opprobrious
orange: orange
oratorical: oratorical
orderly: orderly
ordinarily: ordinarily
ordinary: ordinary
original: original
originally: originally
originate: originate,originated,originating
originator: originators
ornament: ornament,ornamented
ornamental: ornamental
orphan: orphan,orphans
ostentatiously: ostentatiously
ostler: ostler
ough: ough
ounce: ounce,ounces
outbreak: outbreak
outcast: outcast,outcasts
outcry: outcry
outer: outer
outhouse: outhouse
outline: outline
outpouring: outpouring
outrageous: outrageous
outright: outright
outset: outset
outskirts: outskirts
outstanding: outstanding
outstretched: outstretched
outward: outward
overborne: overborne
overcast: overcast
overcharge: overcharged
overcome: overcome
overdo: overdo
overflow: overflowing
overgrown: overgrown
overhang: overhung
overhead: overhead
overhear: overheard
overjoy: overjoyed
overload: overload
overlook: overlooked
overmuch: overmuch
overpower: overpowered
overpowering: overpowering
overrate: overrated
overseer: overseer,overseers
overspread: overspread
overstrained: overstrained
overtake: overtake,overtaken,overtook
overthrow: overthrew,overthrow
overturn: overturned
overwhelm: overwhelmed
overwhelming: overwhelming
owe: owe,owed
owner: owner,owners
oxen: oxen
oyster: oyster,oysters
pace: pace,paced,paces
paced: paced
pacification: pacification
pacing: pacing
pack: packed
package: package,packages
packet: packet
pad: pad
paddock: paddock
padlocked: padlocked
pail: pail,pails
pain: pain,pains
painful: painful
paint: paint,painted
painter: painters
painting: painting
pair: pair,pairs
pal: pal,pals
palace: palace,palaces
pale: pale
paleness: paleness
palest: palest
paling: palings
pallid: pallid
palm: palm,palmed,palms
palpable: palpable
palpitating: palpitating
palsied: palsied
palsy: palsy
palter: palter
paltry: paltry
pan: pan
panacea: panacea
pane: pane,panes
panegyric: panegyric
panel: panel,panelled,panels
pang: pang
panic: panic
panting: panting
pantomime: pantomime
pantomimic: pantomimic
paper: paper,papers
paragraph: paragraph
parallel: parallel
paralysed: paralysed
parapet: parapet
parcel: parcel,parcels
parchment: parchment
pardon: pardon,pardoned
parent: parent,parents
parentage: parentage
parental: parental
paris: paris
parish: parish
parishioner: parishioners
park: park
parley: parley
parliament: parliament
parliamentary: parliamentary
parlour: parlour,parlours
parochial: parochial
paroxysm: paroxysm
parrot: parrot
parry: parrying
parson: parson
parsonage: parsonage
parti: parti
partial: partial
partially: partially
participate: participating
participation: participation
particulars: particulars
partition: partition
partly: partly
partner: partner,partners
party: parties,party
pass: pass,passed,passes,passing
passage: passage,passages
passenger: passengers
passer: passer
passing: passing
passion: passion,passions
passionate: passionate
passionately: passionately
passive: passive
paste: paste,pasted
pastime: pastimes
pastor: pastor
pasty: pasty
pat: pat,patted,patting
patch: patch,patched,patching
patchwork: patchwork
patent: patent
path: path
pathetically: pathetically
pathway: pathways
patience: patience
patient: patient
patiently: patiently
patriotic: patriotic
patron: patron,patrons
patronage: patronage
patronising: patronising
patter: pattered
pattering: pattering
pattern: pattern,patterns
paul: paul
pauper: pauper,paupers
pause: pause,paused,pausing
pave: paved,paving
paved: paved
pavement: pavement,pavements
paviour: paviour
pawn: pawned
pawnbroker: pawnbroker
pay: paid,pay,paying
payment: payment
peace: peace
peaceful: peaceful
peacefully: peacefully
peach: peach,peached
peaching: peaching
peal: peal
peasantry: peasantry
peculiar: peculiar
peculiarity: peculiarities
peculiarly: peculiarly
pedlar: pedlar
peel: peel
peep: peep,peeped,peeping
peeping: peeping
peer: peered,peering
peevish: peevish
peg: peg,pegs
pell: pell
pen: pen,pens,pent
penalty: penalty
pence: pence
pencil: pencil
pend: pending
penetrate: penetrate,penetrated
penitence: penitence
penitent: penitent
penny: penny
pension: pension,pensioned
pensively: pensively
pepper: pepper
peppermint: peppermint
perceive: perceive,perceived,perceiving
perceptible: perceptible
perception: perception,perceptions
peremptorily: peremptorily
peremptory: peremptory
perfect: perfect
perfection: perfection
perfectly: perfectly
perform: perform,performed,performing
performance: performance
perfume: perfume,perfumes
perfumed: perfumed
perfumery: perfumery
peril: peril
period: period
periodical: periodical
periodically: periodically
perish: perished
permission: permission
permit: permit,permitted
perpetually: perpetually
perplexity: perplexity
persecute: persecuted
perseveringly: perseveringly
persist: persist,persisted
person: people,person,persons
personage: personage,personages
personal: personal
perspective: perspective
perspiration: perspiration
persuade: persuaded
persuader: persuaders
persuasion: persuasion
persuasively: persuasively
perusal: perusal
peruse: perused,perusing
pervade: pervade,pervaded
perverse: perverse
perversely: perversely
perversion: perversion
perversity: perversity
pestilence: pestilence
pet: pet
pettishly: pettishly
petty: petty
pewter: pewter
phantom: phantom
pharisee: pharisee
phenomenon: phenomena,phenomenon
phil: phil
philanthropy: philanthropy
philosopher: philosopher,philosophers
philosophical: philosophical
philosophically: philosophically
philosophy: philosophy
phrase: phrase
physic: physic
physical: physical
piano: piano
pick: pick,picked,picking
pickaxe: pickaxe
pickpocket: pickpocket
picture: picture,pictures,picturing
pie: pie
piece: piece,pieces
pier: piers
pierce: piercing
piercer: piercer
pig: pig,pigs
pilaster: pilaster
pile: pile,piled,piles
pilfer: pilfering
pilgrimage: pilgrimages
pillar: pillars
pillow: pillow,pillows
pilot: pilot
pin: pin,pinned,pins
pinch: pinch,pinches
pinched: pinched
pincher: pincher
pinion: pinioned,pinioning
pint: pint
piously: piously
pipe: pipe,pipes
pistol: pistol,pistols
pit: pits
pitch: pitch,pitched
pitcher: pitcher
pitchfork: pitchfork
piteous: piteous
piteously: piteously
pity: pitied,pity,pitying
pivot: pivot
placid: placid
placidly: placidly
plain: plain
plainly: plainly
plaited: plaited
plan: plan,planned,plans
plant: plant,planted,planting,plants
planting: planting
plashing: plashing
plate: plate,plated,plates
plateful: plateful
platform: platform
play: play,played,playing
playful: playful
playfully: playfully
playing: playing
playmate: playmate
pleasant: pleasant
pleasantly: pleasantly
pleasantry: pleasantry
pleased: pleased
pleasing: pleasing
pleasurable: pleasurable
pleasure: pleasure,pleasures
pledge: pledge,pledged
plentifully: plentifully
plenty: plenty
plod: plodding
plot: plot,plots,plotting
pluck: pluck,plucked,plucking
plumage: plumage
plummy: plummy
plunder: plunder,plundering
plunge: plunge,plunged,plunges
plunging: plunging
plush: plush
ply: plied,ply
poach: poached
pock: pock
pocket: pocket,pocketed,pocketing,pockets
poise: poised,poising
poison: poison,poisoned
poke: poke,poked,poking
poker: poker
pole: poles
police: police
policeman: policeman,policemen
policy: policy
polish: polish,polished
polite: polite
politeness: politeness
political: political
pomp: pomp
pomposity: pomposity
pompously: pompously
pond: pond
ponder: pondered
ponderous: ponderous
pony: pony
pooh: pooh
pool: pool,pools
poor: poor,poorer,poorest
pop: pop,popped
poplar: poplar
populace: populace
populated: populated
population: population
porch: porch
pore: pore,pored,poring
porringer: porringer
port: port
portal: portal
portentous: portentous
porter: porter
portico: portico
portion: portion,portions
portionless: portionless
portly: portly
portrait: portrait
position: position,positions
positive: positive
positively: positively
possess: possess,possessed,possessing
possession: possession
possessor: possessors
possibility: possibilities,possibility
post: post,posts
postboy: postboy
postillion: postillion
postpone: postpone,postponed,postponing
posture: posture
pot: pot,pots
potato: potatoes
pounce: pouncing
pound: pound,pounds
pour: pour,poured,pouring
poverty: poverty
powder: powder,powdered,powdering
powdered: powdered
power: power,powers
powerful: powerful
powerless: powerless
practical: practical
practice: practice
practitioner: practitioner
prad: prad
prattle: prattle
pray: pray,prayed
prayer: prayer,prayers
preach: preached,preaching
precaution: precaution,precautions
precede: preceded,preceding
precedent: precedents
precept: precepts
preceptor: preceptor
precious: precious
preciously: preciously
precipitation: precipitation
precise: precise
precisely: precisely
precision: precision
precursor: precursor
predicament: predicament
prediction: prediction,predictions
preface: preface
prefer: prefer,preferred,preferring
prefix: prefixed
preliminary: preliminaries,preliminary
prelude: prelude
premature: premature
premise: premises
premium: premium
prentice: prentice
preparation: preparation,preparations
preparatory: preparatory
prepare: prepare,prepared,preparing
prepared: prepared
prepossessing: prepossessing
preposterous: preposterous
prerogative: prerogative
presage: presage
prescribe: prescribed
presence: presence
presentiment: presentiment
presently: presently
preservation: preservation
preserve: preserve,preserved,preserving
preserver: preserver
preside: presided,presiding
president: president
press: press,pressed,pressing
pressing: pressing
pressure: pressure
presume: presume,presuming
pretence: pretence,pretences
pretend: pretended,pretending
pretext: pretext
pretty: prettier,pretty
prevail: prevailed,prevailing
prevalent: prevalent
prevent: prevent,prevented,preventing
previous: previous
prey: prey
price: price,prices
priceless: priceless
prick: pricking
pride: pride
prig: prig
prime: prime
principal: principal
principle: principle
print: print,printed
prior: prior
prison: prison
prisoner: prisoner,prisoners
private: private
privation: privation
privilege: privileges
privily: privily
probability: probabilities,probability
probable: probable
proceed: proceed,proceeded,proceeding
proceeding: proceeding
proceedings: proceedings
proceeds: proceeds
process: process
procession: processions
proclaim: proclaim,proclaimed,proclaiming
procure: procure,procured,procuring
prodigiously: prodigiously
produce: produce,produced,produces,producing
production: production
productive: productive
profane: profane
profession: profession
professional: professional
professionally: professionally
proffer: proffered,proffering
proficiency: proficiency
profile: profile
profit: profit,profited,profits
profitable: profitable
profligacy: profligacy
profound: profound
profoundly: profoundly
profuse: profuse
progress: progress
project: project,projecting,projects
prolific: prolific
prolong: prolong
prolonged: prolonged
prominently: prominently
promise: promise,promised,promises,promising
promising: promising
promote: promoted
promotion: promotion,promotions
prompt: prompt,prompting
promptitude: promptitude
promptness: promptness
prone: prone
pronoun: pronoun
pronounce: pronounce,pronounced
proof: proof,proofs
prop: propped
propensity: propensity
proper: proper
properly: properly
property: properties,property
prophecy: prophecy
prophetic: prophetic
propitiate: propitiate
proportion: proportion
proportionate: proportionate
proportionately: proportionately
proposal: proposal
propose: propose,proposed
proposition: proposition
propound: propound,propounded
propriety: propriety
prosecute: prosecute,prosecuting
prosecution: prosecution
prosecutor: prosecutor
prospect: prospect
prospective: prospective
prospects: prospects
prosper: prosper,prospered
prostrate: prostrate
prostration: prostration
protect: protected,protecting
protection: protection
protectress: protectress
protest: protested,protesting
protestant: protestant
protestation: protestations
protract: protracted
protrude: protruded
prouder: prouder
proudly: proudly
prove: prove,proved,proving
provide: provide,providing
providence: providence
provision: provisions
provoke: provoke,provoking
prudence: prudence
prudent: prudent
prudently: prudently
prying: prying
psalm: psalm
public: public
publican: publicans
publicity: publicity
publicly: publicly
publish: published
pule: puling
pull: pull,pulled,pulling
pulley: pulley
pulse: pulse
pump: pump,pumps
punch: punch
punctual: punctual
punctually: punctually
punish: punish,punished
punishable: punishable
punishment: punishment
pupil: pupil,pupils
purchase: purchase,purchased,purchases
pure: pure,purest
purify: purify
purport: purport
purpose: purpose,purposed,purposes
purposely: purposely
purse: purse,pursed
pursuance: pursuance
pursue: pursue,pursued,pursuing
pursuer: pursuers
pursuit: pursuit,pursuits
push: push,pushed,pushing
putrefy: putrefying
quack: quack
quail: quail
quaint: quaint
quake: quaked
qualification: qualifications
qualified: qualified
qualify: qualify
quality: qualities,quality
quantity: quantities,quantity
quarrel: quarrel,quarrelling
quart: quart
quarter: quarter,quartered,quarters
quartern: quartern
quartette: quartette
quarto: quartos
queer: queer
queerest: queerest
quell: quell,quelled
quest: quest
question: question,questioned,questions
questioner: questioner
questioning: questioning
quick: quick,quicker,quickest
quicken: quickened,quickening
quiet: quiet
quietly: quietly
quietude: quietude
quill: quill
quit: quit,quitted,quitting
quiver: quivered,quivering
quixotic: quixotic
rabbit: rabbit
race: race
racking: racking
radiant: radiant
raff: raff
rag: rag,rags
rage: rage,raging
ragged: ragged
rail: rail,railed,rails
railing: railing,railings
rain: rain,rained,raining
rainy: rainy
raise: raise,raised,raising
rakishly: rakishly
rally: rally
ramble: ramble,rambled,rambling
rampacious: rampacious
range: range,ranged,ranging
rank: rank
rap: rap,rapped,raps
rapacity: rapacity
rapid: rapid
rapidity: rapidity
rapidly: rapidly
rapture: rapture
rapturously: rapturously
rare: rare
rarity: rarity
rascal: rascal,rascals
rascally: rascally
rash: rash
rat: rat,rats
rate: rate,rates
ratify: ratified
rational: rational
rattle: rattled,rattling
rattling: rattling
rave: raved,raving
raving: raving
raw: raw
ray: ray,rays
razor: razors
reach: reach,reached,reaching
read: read,reading
reader: reader,readers
readiness: readiness
reading: reading
ready: ready
real: real
realise: realised,realises
reality: reality
reappear: reappeared
rear: rear,reared
reason: reason,reasoned,reasons
reasonable: reasonable
reasoning: reasoning
reassure: reassured
reassured: reassured
rebel: rebel,rebels
rebellious: rebellious
rebelliously: rebelliously
rec: rec
recall: recall,recalled,recalling
recapture: recapture
recede: recede,receding
receipt: receipt
receive: receive,received,receiving
reception: reception
recess: recess,recesses
reciprocate: reciprocated,reciprocating
recital: recital
reckless: reckless
recklessness: recklessness
reckon: reckon
reckoning: reckoning
reclaim: reclaimed
recline: reclined,reclining
recognise: recognise,recognised,recognising
recognition: recognition
recoil: recoil,recoiled,recoiling
recollect: recollect,recollected,recollecting
recollection: recollection,recollections
recommence: recommenced
recommend: recommend,recommended
recommendation: recommendation
recompense: recompense
reconsider: reconsidered
record: record,recorded,recording
recount: recounted,recounting
recover: recover,recovered,recovering
recovery: recovery
recreation: recreations
recruit: recruit,recruiting
recur: recurring
red: red,redder
redden: reddening
reddish: reddish
redeem: redeem,redeemed
redemption: redemption
redness: redness
redouble: redoubled
redress: redress
reduce: reduced,reducing
reduction: reduction
reek: reeking
refer: referred,referring
reference: reference
refine: refined
reflect: reflect,reflected,reflecting,reflects
reflection: reflection,reflections
reflective: reflective
reflectively: reflectively
refractory: refractory
refrain: refrain
refresh: refreshed
refreshing: refreshing
refreshment: refreshment
refuge: refuge
refusal: refusal
refuse: refuse,refused,refusing
regain: regain,regained,regaining
regale: regale,regaled,regales
regard: regard,regarded
regimental: regimentals
region: region
register: register
regret: regret,regrets
regular: regular
regularity: regularity
regularly: regularly
regulate: regulating
regulation: regulation,regulations
reign: reigned
rejoicing: rejoicing
rejoin: rejoined
rejoinder: rejoinder
relapse: relapsed,relapsing
relapsing: relapsing
relate: relate,relates
relation: relation,relations
relationship: relationship
relative: relative,relatives
relax: relaxed,relaxing
relaxed: relaxed
release: release,released,releasing
relent: relented,relenting
relict: relict
relief: relief
relieve: relieve,relieved,relieving
religious: religious
relinquish: relinquished
relish: relish
reluctance: reluctance
rely: relied,rely
remain: remain,remained,remaining,remains
remainder: remainder
remains: remains
remand: remanded
remark: remark,remarked,remarking,remarks
remarkable: remarkable
remarkably: remarkably
remedy: remedy
remember: remember,remembered,remembering
remembrance: remembrance,remembrances
remind: remind,reminded,reminds
reminder: reminder
remonstrance: remonstrance,remonstrances
remonstrate: remonstrate,remonstrated,remonstrating
remonstratory: remonstratory
remorse: remorse
remote: remote,remoter,remotest
removal: removal
remove: remove,removed,removing
render: render,rendered,rendering
renew: renew,renewed
renewal: renewal,renewals
renounce: renounced
renowned: renowned
rent: rent
repair: repair,repaired
repay: repaid
repeat: repeat,repeated,repeating
repent: repent
repentance: repentance
repetition: repetition
replace: replace,replaced,replacing
replenish: replenished
reply: replied,replies,reply,replying
report: report,reported
repose: repose,reposed,reposing
represent: represent,represented
representation: representation,representations
repress: repress,repressed,repressing
reprieve: reprieve
reproach: reproach,reproaches,reproaching
reproachfully: reproachfully
reprove: reproving
reptile: reptile
repugnance: repugnance
repulse: repulsed
repulsive: repulsive
repulsiveness: repulsiveness
reputable: reputable
reputation: reputation
request: request,requested,requesting
require: require,required
required: required
rescue: rescue,rescued,rescuing
reseat: reseated
resemblance: resemblance
resemble: resembled
reserve: reserve,reserving
reside: reside,resided,residing
residence: residence
resign: resign,resigned
resignation: resignation
resist: resist,resisted,resisting
resistance: resistance
resolute: resolute
resolution: resolution
resolve: resolve,resolved,resolving
resort: resort,resorted,resorting
resound: resounded
resource: resource
respect: respect
respectable: respectable
respected: respected
respectful: respectful
respectfully: respectfully
respects: respects
respiration: respiration
respond: responded,responding
responsibility: responsibility
responsible: responsible
rest: rest,rested,resting
restitution: restitution
restless: restless
restlessly: restlessly
restorative: restoratives
restore: restore,restored
restrain: restrain,restrained
restraint: restraint
result: result
resume: resumed,resuming
retain: retain,retained,retaining
reticule: reticule
retire: retire,retired,retiring
retirement: retirement
retort: retorted,retorts
retrace: retracing
retreat: retreat,retreated,retreating
retrieve: retrieve,retrieving
retrospective: retrospective
return: return,returned,returning,returns
reveal: reveal
revenge: revenge
reverberate: reverberated
reverence: reverence
reverend: reverend
reverently: reverently
reverie: reverie
reverse: reverse
reversion: reversion
revert: revert,reverts
revive: revive
revolution: revolution
revulsion: revulsion
reward: reward,rewarded,rewards
riband: riband
ribbon: ribbon
rich: rich,richest
riches: riches
richly: richly
richness: richness
rick: rick
rid: rid
riddle: riddle
ride: ride
ridicule: ridicules
ridiculous: ridiculous
rifle: rifled
rightly: rightly
rigid: rigid
rigidly: rigidly
riot: riot
ripple: rippling
rise: rise,risen,rising,rose
risk: risk
river: river
rivet: rivets
road: road,roads
roam: roam,roaming
roar: roar,roared,roaring,roars
roast: roasting
roasted: roasted
rob: rob,robbed
robber: robber,robbers
robbery: robberies,robbery
robe: robes
robust: robust
rock: rocked,rocking
rogue: rogue
roll: roll,rolled,rolling,rolls
rolling: rolling
roman: roman
romance: romance
rome: rome
roof: roof,roofed,roofs
roofless: roofless
rook: rook
root: root,rooted
rope: rope
rose: rose,roses
rot: rot,rotted,rotting
rotten: rotten
rottenness: rottenness
rough: rough,roughest
roughly: roughly
roughness: roughness
rounder: rounder
rouse: rouse,roused,rousing
roused: roused
rouses: rouses
rousing: rousing
route: route
row: row
roystering: roystering
rub: rub,rubbed,rubbing
rubber: rubber
rude: rude
rudely: rudely
rueful: rueful
ruefully: ruefully
ruefulness: ruefulness
ruffian: ruffian,ruffians
ruffle: ruffled
rug: rug
ruin: ruin,ruined,ruins
ruinous: ruinous
rule: rule,rules
rum: rum
ruminate: ruminate,ruminating
rummage: rummage
rumour: rumour
runaway: runaway
runner: runners
running: running
rush: rush,rushed,rushes,rushing
rushlight: rushlight
rust: rust,rusted
rustic: rustic
rustle: rustle,rustled
rustling: rustling
rusty: rusty
ruthless: ruthless
ruthlessly: ruthlessly
sack: sack,sacks
sacred: sacred
sacrifice: sacrifice,sacrificed
sad: sad,saddest
saddle: saddle,saddled
sadly: sadly
sadness: sadness
safe: safe,safer
safeguard: safeguard
safely: safely
safety: safety
saffron: saffron
sage: sage,sages
saint: saint
sake: sake
sale: sale
salesman: salesman
sallow: sallow
sally: sallied,sallies,sally,sallying
salt: salted
salutary: salutary
salutation: salutation,salutations
salute: saluted,saluting
samaritan: samaritan
sanction: sanction,sanctioned
sanguinary: sanguinary
sanguine: sanguine
sarcasm: sarcasm
sash: sash,sashes
satin: satin
satisfaction: satisfaction
satisfactorily: satisfactorily
satisfactory: satisfactory
satisfied: satisfied
satisfy: satisfied,satisfy,satisfying
saturate: saturated
saturday: saturday
saturnine: saturnine
sauce: sauce
saucepan: saucepan,saucepans
saucer: saucer
saunter: saunter,sauntered
sauntering: sauntering
sausages: sausages
savage: savage
savagely: savagely
save: save,saved,saving
saveloy: saveloy
saving: saving
savings: savings
saviour: saviour
savour: savouring
sawyer: sawyer
scaffold: scaffold
scald: scald,scalded
scamper: scamper
scandal: scandal
scanty: scanty
scar: scar
scarce: scarce
scarcely: scarcely
scarcity: scarcity
scare: scared
scared: scared
scatter: scattered
scattered: scattered
scene: scene,scenes
scent: scent
scheme: scheme,schemes,scheming
school: school
science: science
scientific: scientific
scold: scolding
scorch: scorched
score: score,scores
scorn: scorn
scornful: scornful
scornfully: scornfully
scot: scot
scoundrel: scoundrel,scoundrels
scour: scoured
scouring: scourings
scout: scouting,scouts
scowl: scowl,scowled,scowling
scrag: scragged
scragging: scragging
scrap: scrap
scrape: scrape,scraped
scratch: scratch,scratched,scratching
scream: scream,screamed,screaming
screech: screech,screeched,screeching
screen: screened
screw: screwed,screwing
scrub: scrubbed
scruple: scruple
scrupulous: scrupulous
scrupulously: scrupulously
scrutinise: scrutinised
scrutiny: scrutiny
scud: scudded,scudding
scuffle: scuffle
scullery: scullery
scum: scum
sea: sea
seal: seal,sealed,seals
seam: seams
sear: seared
search: search,searched,searches,searching
season: season,seasoned
seat: seat,seated,seating,seats
seated: seated
seating: seating
secluded: secluded
secrecy: secrecy
secret: secret,secrets
secretary: secretary
secretly: secretly
secure: secure,secured
securely: securely
security: security
sediment: sediment
seed: seed,seeds
seek: seek,seeking,sought
seemly: seemly
seer: seers
seize: seized,seizing
seldom: seldom
select: select,selected,selecting
selfish: selfish
selfishness: selfishness
sell: sell,sold
seller: seller
semblance: semblance
send: send,sending,sends
seneschal: seneschal
senior: senior
sensation: sensation
sense: sense
sensitive: sensitive
sentence: sentence
sentiment: sentiment,sentiments
sentimental: sentimental
separate: separate,separated
separation: separation
sepulchral: sepulchral
sequel: sequel
serene: serene
serenity: serenity
series: series
sermon: sermon
servant: servant,servants
serve: serve,served,serves,serving
service: service,services
session: sessions
sessions: sessions
set: set,sets,setting
setting: setting
settle: settle,settled
settled: settled
settlement: settlement
sevenpence: sevenpence
seventeen: seventeen
seventh: seventh
severally: severally
severe: severe
severely: severely
severity: severity
sex: sex
sha: sha
shabby: shabby
shade: shade,shading
shades: shades
shadow: shadow,shadowed,shadows
shadows: shadows
shadowy: shadowy
shady: shady
shaggy: shaggy
shake: shake,shaken,shaking,shook
shallow: shallow
sham: sham,shamming
shamble: shambling
shame: shame
shameful: shameful
shape: shape,shaped,shapes
shapen: shapen
shaping: shaping
share: share,shared
sharp: sharp,sharper,sharpest
sharpen: sharpened
sharply: sharply
sharpness: sharpness
shatter: shattered
shave: shaved
shaver: shaver
shawl: shawl,shawls
sheep: sheep
sheer: sheer
sheet: sheet,sheets
shelf: shelf,shelves
shelter: shelter,sheltering
shelving: shelving
sheriff: sheriffs
shield: shielding
shift: shift,shifted
shilling: shilling,shillings
shine: shining,shone
shiner: shiners
shiny: shiny
ship: ship
shipping: shipping
shipwrecked: shipwrecked
shirt: shirt
shiver: shiver,shivered,shivering
shock: shock,shocked
shoe: shoe,shoes
shoeless: shoeless
shoot: shoot,shooting,shoots,shot
shop: shop,shopped,shops
shopkeeper: shopkeepers
shore: shore
short: short,shorter,shortest
shorten: shorten,shortened
shortly: shortly
shorts: shorts
shot: shot
shoulder: shoulder,shouldered,shoulders
shout: shout,shouted,shouting,shouts
shouting: shouting
shove: shoving
shovel: shovel,shovelled
shower: shower,showered,showers
shred: shreds
shrewd: shrewd
shriek: shriek,shrieked,shrieks
shrill: shrill
shrillness: shrillness
shrink: shrank,shrink,shrinking,shrunk,shrunken
shrivel: shrivelled
shroud: shroud,shrouded,shrouds
shrug: shrugged,shrugging
shrunken: shrunken
shudder: shudder,shuddered,shuddering
shuffle: shuffled
shuffling: shuffling
shun: shunned
shut: shut,shutting
shutter: shutter,shutters
shutting: shutting
sick: sick
sicken: sicken,sickened
sickening: sickening
sickly: sickly
sickness: sickness
sideboard: sideboard
sidelong: sidelong
sideways: sideways
sigh: sigh,sighed
sight: sight,sights
sign: sign,signed,signing,signs
signal: signal,signals
signature: signature,signatures
sike: sike
sikes: sikes
silence: silence
silent: silent
silk: silk
silly: silly
silver: silver
simile: simile
simple: simple
simply: simply
simultaneous: simultaneous
simultaneously: simultaneously
sin: sin,sins
sincerely: sincerely
sincerity: sincerity
sinecure: sinecure
sing: sang,sing,singing,sings
singe: singeing
singer: singers
singing: singing
single: single
singular: singular
singularly: singularly
sinister: sinister
sink: sank,sink,sinking,sinks,sunk,sunken
sinking: sinking
sip: sipping
sir: sir
sister: sister,sisters
sit: sat,sit,sits,sitting
sitch: sitch
situate: situated
situation: situation,situations
sixpence: sixpence,sixpences
size: size,sizes
sized: sized
skeleton: skeleton
skelter: skelter
sketch: sketching
skilful: skilful
skilfully: skilfully
skill: skill
skin: skin
skinny: skinny
skipper: skipper
skirt: skirt,skirted,skirting,skirts
skulk: skulk,skulked,skulking
skull: skull
sky: sky
slab: slab
slacken: slackened,slackening
slam: slam
slap: slap,slapped,slapping,slaps
slatternly: slatternly
sledge: sledge
sleep: sleep,sleeping,slept
sleeper: sleeper,sleepers
sleepily: sleepily
sleepless: sleepless
sleepy: sleepy
sleeve: sleeve,sleeves
slice: slice,slices
slight: slight,slightest
slim: slim
slime: slime
slimy: slimy
sling: slinging,slung
slink: slunk
slip: slip,slipped,slipping
slipshod: slipshod
slop: slops
slow: slow
slowly: slowly
slug: slug
sluggish: sluggish
sluggishly: sluggishly
sluice: sluices
slumber: slumber,slumbered,slumbers
slunk: slunk
sly: sly
slyly: slyly
smack: smacked,smacking
smalls: smalls
smart: smart
smartly: smartly
smash: smash
smear: smeared
smell: smell,smelling,smells,smelt
smile: smile,smiled,smiles,smiling
smilingly: smilingly
smirk: smirk
smite: smiting
smithfield: smithfield
smock: smock
smoke: smoke,smoked,smoking
smoking: smoking
smoky: smoky
smooth: smoothed,smoothing
smoothly: smoothly
smother: smothered
smoulder: smoulder
snail: snail
snap: snap,snapping
snappish: snappish
snappishly: snappishly
snare: snared,snares
snarl: snarling
snatch: snatched,snatches,snatching
sneak: sneak,sneaking
sneer: sneer,sneered,sneers
sneeze: sneeze,sneezed
sniff: sniffs
snivel: snivelling
snivelling: snivelling
snooze: snooze,snoozing
snore: snore,snoring
snow: snow
snub: snub,snubbed
snuff: snuff,snuffed,snuffing
snuffbox: snuffbox
snug: snug
soap: soap
sob: sob,sobbed,sobbing,sobs
sober: sober
sobriquet: sobriquet
sociably: sociably
society: society
socket: socket
sofa: sofa
soft: soft
soften: soften,softened,softening,softens
softened: softened
softly: softly
softness: softness
soil: soil,soiled,soils
soiled: soiled
sojourn: sojourning
solace: solace
soldier: soldier
sole: sole,soles
solemn: solemn
solemnity: solemnity
solemnly: solemnly
solicit: solicited
solicitude: solicitude
solitary: solitary
solitude: solitude
solution: solution
solve: solve
sombre: sombre
son: son
song: song,songs
sooner: sooner
soot: soot
soothe: soothe,soothed,soothing
soothed: soothed
soothing: soothing
soothingly: soothingly
sordid: sordid
sordidly: sordidly
sore: sore
sorrow: sorrow,sorrows
sorrowful: sorrowful
sorrowfully: sorrowfully
sort: sort,sorts
soul: soul,souls
sound: sound,sounded,sounding,sounds
sounding: sounding
soundly: soundly
source: source
sovereign: sovereigns
space: space
spade: spade
spaniel: spaniel
spare: spare,spared
sparingly: sparingly
spark: spark,sparks
sparkle: sparkle,sparkling
spasm: spasms
spatter: spatter
speak: speak,speaking,speaks,spoke,spoken
speaker: speaker
special: special
specially: specially
species: species
specimen: specimen
speck: speck
speckled: speckled
spectacle: spectacle
spectacles: spectacles
spectator: spectator,spectators
speculation: speculation,speculations
speech: speech
speechless: speechless
speed: sped,speed,speeds
speedily: speedily
speedy: speedy
spell: spell,spelt
spend: spend,spending,spent
sphere: sphere
spice: spice
spick: spick
spider: spiders
spike: spikes
spill: spill
spire: spire,spires
spirit: spirit,spirits
spirited: spirited
spirting: spirting
spit: spat,spit
spite: spite
splash: splash,splashes,splashing
splendid: splendid
splendour: splendour
splintered: splintered
split: split,splitting
spoil: spoil
spoke: spoke
spoon: spoon,spoons
spoonful: spoonful
sport: sport,sports
spot: spot,spots
spouse: spouse
spout: spout
spread: spread,spreading
spree: spree
sprightly: sprightly
spring: sprang,spring,springing,springs,sprung
sprinkle: sprinkling
sprite: sprite
spruce: spruce
spur: spurs
spurn: spurning
spy: spies,spy
squabble: squabbling
squalid: squalid
squalor: squalor
squander: squandered
square: square,squares
squeak: squeaking
squeeze: squeezed,squeezing
squire: squire
stable: stable,stables
stack: stack,stacks
staff: staff
stage: stage,stages
stagger: stagger,staggered,staggering
staggering: staggering
stagnant: stagnant
stain: stain,stained,stains
stair: stair,stairs
staircase: staircase
stake: stake,stakes
stale: stale
stalk: stalk
stall: stall,stalls
stammer: stammered
stamp: stamp,stamped,stamping
stand: stand,standing,stands,stood
stander: standers
standing: standing
star: stars
stare: stare,stared,stares,staring
stark: stark
start: start,started,starting,starts
startle: startled,startling
startled: startled
startling: startling
starvation: starvation
starve: starve,starved,starving
stateliness: stateliness
stately: stately
statement: statement
station: station,stationed,stations
stationary: stationary
stature: stature
staunch: staunch,stauncher
stay: stay,staying
steadily: steadily
steady: steadier,steady
steak: steaks
steal: steal,stealing,steals,stole,stolen
stealing: stealing
stealthily: stealthily
steam: steam,steaming
steed: steeds
steel: steel
steep: steep,steeped
stem: stem
stentorian: stentorian
step: step,stepped,stepping,steps
stern: stern,sterner,sternest
sterner: sterner
sternly: sternly
sternness: sternness
stew: stews
steward: steward
stick: stick,sticking,stuck
stiff: stiff
stiffen: stiffening
stiffly: stiffly
stifle: stifle,stifled
stile: stile
stillness: stillness
stimulate: stimulated
stipend: stipend
stipendiary: stipendiary
stipulate: stipulate,stipulated
stipulation: stipulation
stir: stir,stirred,stirring
stirring: stirring
stock: stock
stocking: stockings
stoke: stoke
stomach: stomach
stone: stone,stones
stoof: stoof
stool: stool
stoop: stooped,stooping
store: store,stores
storehouse: storehouses
storm: storm
stormy: stormy
story: stories,story
stout: stout,stouter
stoutly: stoutly
stove: stove,stoves
stow: stow,stowing
straggle: straggling
straggler: stragglers
straight: straight
straightforward: straightforward
straightway: straightway
strain: strain,straining,strains
strained: strained
strait: strait
strand: strand
strange: strange,strangest
strangely: strangely
stranger: stranger,strangers
strangle: strangle
strap: strap,strapped
stratagem: stratagem
straw: straw
stray: stray,strayed,straying
streaky: streaky
stream: stream,streamed
streaming: streaming
street: street,streets
strength: strength
strengthen: strengthen,strengthened
stress: stress
stretch: stretched,stretching
strew: strew,strewn
stricken: stricken
strict: strict
strictly: strictly
stride: strides,strode
strike: strike,strikes,striking,struck
striking: striking
string: string,strung
strip: strip
striped: striped
strive: striving,strove
stroke: stroke,strokes
strong: strong,stronger,strongest
strop: strops
struggle: struggle,struggled,struggles,struggling
studiously: studiously
study: studied,study,studying
stuff: stuff,stuffing
stumble: stumbled,stumbling
stump: stump
stun: stun
stunned: stunned
stunning: stunning
stupefaction: stupefaction
stupefied: stupefied
stupefy: stupefied
stupid: stupid
stupidity: stupidity
stupidly: stupidly
stupor: stupor
sturdy: sturdy
style: style
subdued: subdued
subject: subject,subjected,subjects
submissively: submissively
submit: submit,submitted
subscription: subscriptions
subsequent: subsequent
subside: subside,subsided
subsist: subsisted
subsistence: subsistence
substance: substance
substantial: substantial
substitute: substituted,substituting
subtle: subtle
suburb: suburb,suburbs
succeed: succeed,succeeded,succeeding
success: success
successful: successful
succession: succession
successive: successive
succour: succoured
suck: sucking
sudden: sudden
suddenly: suddenly
suddenness: suddenness
suds: suds
sue: sue
suet: suet
suffer: suffer,suffered,suffering
suffering: suffering,sufferings
suffice: suffice,sufficed
sufficiency: sufficiency
sufficient: sufficient
suffocation: suffocation
suffuse: suffused
sugar: sugar
suggestion: suggestion
suit: suit,suited,suiting,suits
suited: suited
sulky: sulky
sullen: sullen
sullenly: sullenly
sullenness: sullenness
sully: sullying
sultry: sultry
sum: sum
summarily: summarily
summary: summary
summer: summer
summit: summit
summon: summon,summoned,summoning
summons: summons
sun: sun
sunday: sunday
sundays: sundays
sundry: sundries,sundry
sunlight: sunlight
sunny: sunny
sunshine: sunshine
sunshiny: sunshiny
superb: superb
superfine: superfine
superintendence: superintendence
superior: superior,superiors
superiority: superiority
superlative: superlative
supper: supper
supperless: supperless
supplication: supplication
supply: supplied,supplies,supply
support: support,supported,supporting
suppose: suppose,supposed,supposes,supposing
supposition: supposition
suppress: suppress,suppressed,suppressing
suppression: suppression
supreme: supreme
surely: surely
surface: surface
surgeon: surgeon
surly: surly
surmise: surmises
surmount: surmount,surmounting
surname: surname
surplice: surplice
surprise: surprise,surprised
surprised: surprised
surprising: surprising
surprisingly: surprisingly
surrey: surrey
surround: surrounded,surrounding
survey: survey,surveyed,surveying
survive: survive,survived
survivor: survivors
susan: susan
susceptible: susceptible
suspect: suspect,suspected,suspecting
suspend: suspended
suspense: suspense
suspicion: suspicion,suspicions
suspicious: suspicious
suspiciously: suspiciously
sustain: sustained
sustainable: sustainable
swag: swag
swagger: swagger,swaggered,swaggering
swallow: swallow,swallowed,swallowing
swamp: swamp
swear: swear,swore,sworn
sweat: sweat
sweep: sweep,sweeping,swept
sweeper: sweeper
sweepstakes: sweepstakes
sweet: sweet,sweeter,sweetest
sweetness: sweetness
swell: swell,swelled,swelling,swollen
swift: swift,swiftest
swiftly: swiftly
swim: swam
swing: swing,swung
swinging: swinging
swipe: swipes
swoon: swoon,swooned
syllable: syllable
sympathise: sympathising
sympathy: sympathy
symptom: symptoms
systematic: systematic
table: table
tablet: tablet
tacit: tacit
tack: tack
tail: tail,tailed,tails
taint: taint
tainted: tainted
taker: taker
tale: tale,tales
talent: talents
talk: talk,talked,talking
tall: tall
tallow: tallow
tame: tamed
tangible: tangible
tantalising: tantalising
tap: tap,tapped,tapping
tape: tape
tardily: tardily
tardiness: tardiness
tartly: tartly
task: task
taste: taste,tasted,tasting
tattered: tattered
taunt: taunt,taunts
tavern: tavern
tea: tea
teach: taught,teach,teaches
teacher: teachers
teacupful: teacupful
teapot: teapot
tear: tear,tearing,tears,tore,torn
tearful: tearful
teaspoon: teaspoon,teaspoons
tedious: tedious
teel: teel
telescope: telescope
telling: telling
temerity: temerity
temper: temper,tempered
temperament: temperament
temperate: temperate
temple: temple,temples
temporary: temporary
tempt: tempted
temptation: temptation
tempting: tempting
tenacity: tenacity
tenant: tenanted
tend: tend,tended
tendency: tendency
tender: tender,tendered,tenderest
tenderer: tenderer
tenderly: tenderly
tenderness: tenderness
tenement: tenement,tenements
tenterhooks: tenterhooks
term: term,terms
terminate: terminated,terminates
termination: termination
terrible: terrible
terrific: terrific
terrified: terrified
terrify: terrified
terror: terror,terrors
testify: testify
testily: testily
testimony: testimony
texture: texture
thames: thames
thankful: thankful
thankfulness: thankfulness
thanksgiving: thanksgiving
theatre: theatre
theft: theft
theme: theme
thenceforth: thenceforth
theoretically: theoretically
theory: theories,theory
thereabout: thereabouts
thereat: thereat
therefrom: therefrom
thereon: thereon
theretofore: theretofore
thereunto: thereunto
thicken: thickened
thickly: thickly
thief: thief,thieves
thieve: thieved
thingummy: thingummy
thinking: thinking
thirsty: thirsty
thirteen: thirteen
thither: thither
thoroughfare: thoroughfare
thoughtful: thoughtful
thoughtfully: thoughtfully
thoughtless: thoughtless
thousandfold: thousandfold
thrash: thrashed,thrashing
thread: thread,threaded
threadbare: threadbare
threat: threat,threats
threaten: threatened,threatening
threatening: threatening
thrice: thrice
thrill: thrill
thrive: thrived,throve
thriving: thriving
throat: throat,throats
throb: throbbing
throng: throng,thronged
throttle: throttle,throttled
throw: threw,throw,throwing,thrown,throws
thrust: thrust,thrusting
thumb: thumb,thumbed,thumbs
thunder: thunder,thundered,thundering
thundering: thundering
thursday: thursday
ti: ti
tick: ticking
ticker: tickers
ticket: ticketed,tickets
tickle: tickled
tide: tide
tiding: tidings
tidy: tidy
tie: tie,tied,tying
tier: tiers
tight: tight,tighter
tighten: tightening
tightly: tightly
tile: tiles
timber: timber
time: time,timed,times
timely: timely
timid: timid
timidity: timidity
timidly: timidly
timorously: timorously
tin: tin
tincture: tinctured
tinge: tinge
tingle: tingling
tinker: tinker
tinkler: tinkler
tint: tints
tipsy: tipsy
tiptoe: tiptoe,tiptoes
tirade: tirade
tire: tire
tired: tired
titter: tittered,tittering
toast: toast,toasted,toasting
tobacco: tobacco
toby: toby
toe: toes
tog: togs
toil: toil,toiled,toiling,toils
toilet: toilet
token: token,tokens
tol: tol
tolerable: tolerable
tolerably: tolerably
toll: tolled
tolling: tolling
tom: tom
tomb: tomb,tombs
tombstone: tombstones
tommy: tommy
tomorrow: tomorrow
tone: tone,tones
tong: tongs
tongue: tongue
tonight: tonight
tool: tools
tooth: teeth
toothache: toothache
toothless: toothless
toothpick: toothpick
topic: topics
torch: torch,torches
torment: tormented
tormentor: tormentor,tormentors
torn: torn
torrent: torrent
tortoise: tortoise
torture: torture,tortured,tortures
toss: toss,tossed,tossing
total: total
totally: totally
totter: totter,tottered,tottering
touch: touch,touched,touches,touching
tour: tour
tower: tower,towering
town: town,towns
trace: trace,traced,traces,tracing
track: track,tracked,tracks
trade: trade
trader: trader,traders
tradesman: tradesman
trading: trading
traffic: traffic
tragic: tragic
train: train,trained
training: training
trait: traits
tramp: tramp
tramper: tramper
trample: trampled
trampling: trampling
trance: trance
tranquil: tranquil
tranquillity: tranquillity
transact: transact
transfer: transferred
transfix: transfixed
transition: transitions
translate: translate,translating
transport: transport,transported,transporting,transports
transportation: transportation
trap: trap,trapped,traps
trash: trash
travel: travel,travelled,travelling
traveller: traveller,travellers
travelling: travelling
travels: travels
traverse: traversed,traversing
tray: tray
treacherous: treacherous
treachery: treachery
tread: tread,treading,trod
treadmill: treadmill
treasure: treasures
treat: treat,treated,treating,treats
treatment: treatment
treaty: treaty
treble: treble
tree: tree,trees
tremble: tremble,trembled,trembling
tremendous: tremendous
tremulous: tremulous
trespass: trespass
tressel: tressels
trial: trial,trials
tribute: tribute
trick: trick,tricks
trickle: trickling
trifle: trifle,trifles
trifling: trifling
trim: trim
trinity: trinity
trinket: trinket,trinkets
trip: trip,tripped
triumph: triumph
triumphant: triumphant
triumphantly: triumphantly
trivet: trivet
trivial: trivial
trod: trod
trodden: trodden
trot: trot,trotted
trotter: trotter
trouble: trouble,troubled,troubles,troubling
troubled: troubled
troublesome: troublesome
trousers: trousers
trudge: trudged,trudging
true: true,truest
trumpet: trumpet
trunk: trunks
trust: trust,trusted,trusting
trustworthy: trustworthy
truth: truth
tub: tub
tuck: tucked
tuesday: tuesday
tuition: tuition
tumble: tumbled,tumbling
tumbler: tumbler
tumbling: tumblings
tumult: tumult
tumultuously: tumultuously
tune: tune
turbid: turbid
turbulence: turbulence
turbulent: turbulent
turf: turf
turk: turk
turmoil: turmoil,turmoils
turnkey: turnkey,turnkeys
turnpike: turnpike
tush: tush
twelvemonth: twelvemonth
twilight: twilight
twin: twins
twine: twined,twining
twinkle: twinkling
twinkling: twinkling
twist: twist,twisted,twisting
twitch: twitch,twitched
twofold: twofold
twopence: twopence
twopenny: twopenny
ud: ud,uds
ugh: ugh
ugliness: ugliness
ugly: ugly
ultimate: ultimate
ultimately: ultimately
umph: umph
unable: unable
unaccountable: unaccountable
unaccustomed: unaccustomed
unadorned: unadorned
unanimity: unanimity
unanimously: unanimously
unavailing: unavailing
unavailingly: unavailingly
unavoidable: unavoidable
unbar: unbarred
unbecoming: unbecoming
unbeknown: unbeknown
unbidden: unbidden
unbroken: unbroken
unbutton: unbuttoned
unbuttoned: unbuttoned
unceasingly: unceasingly
unceremoniously: unceremoniously
uncertain: uncertain
uncertainty: uncertainty
unchanged: unchanged
unchecked: unchecked
uncle: uncle
unclosed: unclosed
uncomfortable: uncomfortable
uncommon: uncommon
uncommonly: uncommonly
unconcerned: unconcerned
unconditionally: unconditionally
unconscious: unconscious
unconsciously: unconsciously
unconsciousness: unconsciousness
unconstitutional: unconstitutional
uncontradicted: uncontradicted
uncontrollable: uncontrollable
uncork: uncorked
uncouth: uncouth
uncover: uncovered
undaunted: undaunted
undecided: undecided
undefined: undefined
undergo: undergo,undergoing,undergone,underwent
undergrown: undergrown
undermine: undermine
understand: understand,understanding,understands,understood
understanding: understanding
undertake: undertake,undertaken,undertook
undertaker: undertaker
undertaking: undertaking
undertone: undertone
undiminished: undiminished
undisguised: undisguised
undismayed: undismayed
undo: undid,undo,undoes
undoubted: undoubted
undraw: undraw,undrawing
undrew: undrew
undue: undue
unearthly: unearthly
uneasily: uneasily
uneasy: uneasy
unemployed: unemployed
unequal: unequal
unequally: unequally
uneven: uneven
unexampled: unexampled
unexpected: unexpected
unexpectedly: unexpectedly
unfair: unfair
unfasten: unfasten
unfastened: unfastened
unfavourable: unfavourable
unfeignedly: unfeignedly
unfinished: unfinished
unfit: unfit
unfold: unfolded
unfortunate: unfortunate
ungainly: ungainly
ungovernable: ungovernable
ungrateful: ungrateful
unguarded: unguarded
unhand: unhand
unhappiness: unhappiness
unhappy: unhappy
unhealthy: unhealthy
unicorn: unicorn
uniform: uniform
unimpaired: unimpaired
unimportant: unimportant
uninhabited: uninhabited
unintelligible: unintelligible
unintentionally: unintentionally
uninterrupted: uninterrupted
union: union
unite: unite
united: united
universal: universal
universally: universally
unjust: unjust
unkind: unkind
unknown: unknown
unlawful: unlawful
unlimited: unlimited
unlock: unlocked,unlocking
unlooked: unlooked
unloose: unloose
unloosen: unloosened
unmindful: unmindful
unmingled: unmingled
unmitigated: unmitigated
unmixed: unmixed
unmoved: unmoved
unmusical: unmusical
unnatural: unnatural
unnaturally: unnaturally
unnecessary: unnecessary
unnoticed: unnoticed
unobserved: unobserved
unoccupied: unoccupied
unoffending: unoffending
unpack: unpack
unperceived: unperceived
unpleasant: unpleasant
unpolite: unpolite
unpoliteness: unpoliteness
unprecedented: unprecedented
unprofitable: unprofitable
unpropitious: unpropitious
unprotected: unprotected
unprovoked: unprovoked
unquenchable: unquenchable
unquestionably: unquestionably
unreasonable: unreasonable
unrelenting: unrelenting
unrelished: unrelished
unreservedly: unreservedly
unsafe: unsafe
unsatisfactory: unsatisfactory
unseasonable: unseasonable
unseen: unseen
unsentimental: unsentimental
unshaven: unshaven
unshorn: unshorn
unsightly: unsightly
unspeakable: unspeakable
unstateable: unstateable
unsteady: unsteady
unsuccessful: unsuccessful
unsupported: unsupported
untasted: untasted
untenanted: untenanted
untidy: untidy
untie: untied,untying
untiring: untiring
unusual: unusual
unusually: unusually
unwashed: unwashed
unwelcome: unwelcome
unwholesome: unwholesome
unwilling: unwilling
unwillingly: unwillingly
unwonted: unwonted
unworthiness: unworthiness
unworthy: unworthy
upper: upper
uppermost: uppermost
upraised: upraised
upright: upright
uproariously: uproariously
uprose: uprose
upset: upset
upstairs: upstairs
upturned: upturned
upward: upward
urge: urge,urged,urging
usage: usage
useless: useless
usher: ushered,ushering
usual: usual
utensil: utensils
utmost: utmost
utter: utter,uttered,uttering
utterance: utterance
uttered: uttered
utterly: utterly
vacant: vacant
vacantly: vacantly
vagabond: vagabond,vagabonds
vagrant: vagrant
vague: vague
vain: vain
vale: vale
valiantly: valiantly
valuable: valuable
vamper: vamper
vampire: vampire
vanish: vanish,vanished
vapour: vapour
variety: variety
vary: varied,varying
vase: vase
vassal: vassals
vast: vast
vault: vault,vaults
vaunt: vaunt
vegetable: vegetables
vehemence: vehemence
vehement: vehement
vehemently: vehemently
vehicle: vehicle,vehicles
veil: veil
vein: veins
velvet: velvet
velveteen: velveteen
vend: vend
vendor: vendor
venerable: venerable
vengeance: vengeance
vent: vent,vented
ventriloquial: ventriloquial
venture: venture,ventured,venturing
ver: ver
verdict: verdict
verge: verge
verify: verified
verse: verses
vessel: vessel,vessels
vestige: vestige
vestry: vestry
vex: vex,vexed
vexation: vexation
viand: viands
vibrate: vibrate,vibrated
vice: vice,vices
vicinity: vicinity
vicious: vicious
victim: victim,victims
victuals: victuals
view: view,viewed
vigorous: vigorous
vigorously: vigorously
vigour: vigour
vii: vii
viii: viii
vile: vile
village: village,villages
villager: villagers
villain: villain
villainous: villainous
villainy: villainy
vindicate: vindicated
vindictive: vindictive
violence: violence
violent: violent
violently: violently
virtue: virtue,virtues
virtuous: virtuous
visage: visaged
visible: visible
visibly: visibly
vision: vision,visions
visionary: visionary
visit: visit,visited,visiting,visits
visitation: visitation
visitor: visitor,visitors
visitors: visitors
vivacious: vivacious
vivaciously: vivaciously
vivid: vivid
vixenish: vixenish
vocular: vocular
voice: voice,voices
volley: volley
volubility: volubility
volume: volume,volumes
voluntarily: voluntarily
voluntary: voluntary
volunteer: volunteered
voracious: voracious
vote: vote
voyage: voyage
vulgar: vulgar
vulnerable: vulnerable
wag: wagged,wagging
wages: wages
waggish: waggish
waggishness: waggishness
waggon: waggon,waggons
waggoner: waggoner
wail: wail
wainscot: wainscot
waist: waist
waistcoat: waistcoat,waistcoats
waistcoated: waistcoated
wait: wait,waited,waiting,waits
waiter: waiter
waiting: waiting
wake: wake,wakes,waking,woke
wakeful: wakeful
waken: waken,wakened
wales: wales
walk: walk,walked,walking,walks
walking: walking
wall: wall,walls
wallow: wallowing
wander: wander,wandered,wandering
wanderings: wanderings
wane: wane
war: war
ward: ward
warden: warden,wardens
warder: warders
wardrobe: wardrobe
warehouse: warehouse,warehouses
wares: wares
warlike: warlike
warm: warm,warmed,warmer,warmest,warming
warmly: warmly
warmth: warmth
warn: warn,warned,warning
warning: warning,warnings
warrant: warrant
wary: wary
wash: wash,washed,washes,washing
washable: washable
washerwoman: washerwoman
washing: washing
waste: waste,wasted,wastes,wasting
watch: watch,watched,watches,watching
watcher: watchers
watchman: watchman
watchword: watchword
water: water,watering
waterproof: waterproof
waterside: waterside
wave: wave,waved,waving
waver: wavered,wavering
waxwork: waxwork
wayfarer: wayfarer
wayside: wayside
weak: weak,weakest
weaken: weakened
weakly: weakly
weakness: weakness,weaknesses
wealthy: wealthy
weapon: weapon
wear: wear,wearing,wears,wore,worn
wearer: wearer
wearied: wearied
wearily: wearily
weariness: weariness
weary: wearied,weary
weather: weather
weave: weave
wedding: wedding
wedge: wedges
weed: weeding,weeds
week: week,weeks
weekly: weekly
weep: weep,weeping,wept
weigh: weighed
weight: weight
weighty: weightier
wend: wended
west: west
wet: wet
wharf: wharfs
whatsoever: whatsoever
wheel: wheel,wheeled,wheels
whereabout: whereabout
wherefore: wherefore
whereof: whereof
whereunto: whereunto
wherewith: wherewith
whew: whew
whiff: whiff
whimper: whimpered,whimpering
whine: whining
whining: whining
whip: whip
whipper: whippers
whirl: whirl,whirled,whirling
whisk: whisked
whisker: whisker,whiskers
whisper: whisper,whispered,whispering,whispers
whispering: whispering
whist: whist
whistle: whistle,whistled,whistling
whit: whit
white: white
whitechapel: whitechapel
whiteness: whiteness
wholesale: wholesale
wholesome: wholesome
wholesomely: wholesomely
wholly: wholly
whoop: whooping
whop: whop
whopping: whopping
wice: wice
wick: wick
wicked: wicked
wickedness: wickedness
wicket: wicket
wide: wide,wider
widen: widen
widow: widow,widows
wife: wife,wives
wig: wig,wigs
wild: wild
wildest: wildest
wildly: wildly
wildness: wildness
wile: wile
wiles: wiles
wilfully: wilfully
willed: willed
william: william
willingly: willingly
wily: wily
win: win
wind: wind,winding,winds,wound
winder: winder
window: window,windows
windpipe: windpipe
windy: windy
wine: wine
wing: winged
wink: wink,winked,winking
winnings: winnings
winter: winter,winters
wipe: wipe,wiped,wipes,wiping
wisdom: wisdom
wise: wise,wiser
wisely: wisely
wistful: wistful
wistfully: wistfully
wit: wit
withal: withal
withdraw: withdraw,withdrawing,withdrawn,withdrew
wither: withered,withering
withered: withered
withhold: withheld
witness: witness,witnessed,witnesses
witted: witted
witticism: witticism,witticisms
woe: woe
wolf: wolf,wolves
woman: woman,women
womanhood: womanhood
womanly: womanly
wonderful: wonderful
wonderment: wonderment
wood: wood,woods
wooden: wooden
woollen: woollen
word: word
workhouse: workhouse
workman: workman,workmen
workmanship: workmanship
workshop: workshop
worldliness: worldliness
worldly: worldly
worm: worm,worms
worn: worn
worried: worried
worrit: worrit
worry: worried,worry
worship: worship
worsted: worsted
worth: worth
worthy: worthier,worthies,worthy
wot: wot
wound: wound,wounded,wounds
wounded: wounded
wrangle: wrangling
wrap: wrapped,wrapping
wrapper: wrapper
wrapt: wrapt
wrath: wrath
wreak: wreaked
wreck: wreck
wrench: wrench,wrenched,wrenching
wrest: wrested
wrestle: wrestling
wretch: wretch,wretches
wretched: wretched
wretchedness: wretchedness
wring: wrings,wrung
wringing: wringing
wrinkle: wrinkled
wrist: wrist,wrists
write: write,writing,written,wrote
writer: writer
writhe: writhed,writhing
writing: writing
wrong: wrong,wrongs
wry: wry
wud: wud
xi: xi
xii: xii
xiii: xiii
xiv: xiv
xix: xix
xvi: xvi
xvii: xvii
xviii: xviii
xx: xx
xxi: xxi
xxii: xxii
xxiii: xxiii
xxiv: xxiv
xxv: xxv
xxx: xxx
yard: yard,yards
yawn: yawn,yawned
yearn: yearn
yell: yell,yelled,yelling,yells
yellow: yellow
yer: yer
yesterday: yesterday
yew: yew
yield: yield,yielded,yielding
yoke: yoke
yokel: yokel
yonder: yonder
youngster: youngster
younker: younker
youth: youth,youths
youthful: youthful
zealous: zealous
zenith: zenith
