aback: aback
abandon: abandoned
abase: abased
abashed: abashed
abbey: abbey
abear: abear
abel: abel
aberdeen: aberdeen
aberration: aberration
abet: abet
abeyance: abeyance
abhor: abhorring
abhorrence: abhorrence
abhorrent: abhorrent
abide: abide,abided
ability: abilities,ability
abject: abject
ablutions: ablutions
aboard: aboard
abode: abode
abominate: abominate
abraham: abraham
abreast: abreast
abrupt: abrupt
abruptness: abruptness
absence: absence
absent: absent
absolute: absolute
absolutely: absolutely
absolve: absolve
absorb: absorbed
abstinence: abstinence
abstract: abstracts
abstraction: abstraction
absurd: absurd
absurdest: absurdest
absurdly: absurdly
abundance: abundance
abundantly: abundantly
abyss: abyss
accept: accept,accepted
acceptable: acceptable
acceptance: acceptance
access: access
accessory: accessories,accessory
accident: accident,accidents
accidental: accidental
accidentally: accidentally
accommodate: accommodated
accommodation: accommodation
accompany: accompanied,accompany,accompanying
accompanying: accompanying
accomplish: accomplished
accord: accord
accost: accosted
accoucheur: accoucheur
account: account,accounted,accounting,accounts
accountant: accountant
accredit: accredited
accumulate: accumulated,accumulating
accumulative: accumulative
accuracy: accuracy
accurate: accurate
accurately: accurately
accusatory: accusatory
accuse: accuse,accused,accuses,accusing
accustom: accustomed
accustomed: accustomed
ache: ache,aching
achieve: achieved
achievement: achievement
acid: acid
acknowledge: acknowledge,acknowledged,acknowledging
acknowledgment: acknowledgment
acquaint: acquainted
acquaintance: acquaintance,acquaintances
acquiesce: acquiesced
acquiescence: acquiescence
acquire: acquire,acquired
acquirement: acquirements
acquisition: acquisition
acquit: acquit,acquitted
acquittal: acquittal
action: action,actions
active: active
actively: actively
actor: actor
actual: actual
acute: acute
acuteness: acuteness
adamantine: adamantine
adapt: adapt,adapted
add: add
addition: addition
additional: additional
addle: addle
address: address,addressed,addressing
adept: adepts
adequately: adequately
adhere: adhered
adjacent: adjacent
adjective: adjective
adjoin: adjoined
adjoining: adjoining
adjourn: adjourned
adjunct: adjuncts
adjuration: adjuration
adjure: adjured
administer: administered,administering
administration: administration
administrative: administrative
admirable: admirable
admiralty: admiralty
admiration: admiration
admire: admire,admired,admires,admiring
admirer: admirer,admirers
admission: admission,admissions
admit: admit,admitted,admitting
admonish: admonished
adopt: adopt
adoption: adoption
adoration: adoration
adore: adore,adored,adoring
adrift: adrift
advance: advance,advanced,advancing
advanced: advanced
advancement: advancement
advantage: advantage,advantages
adventure: adventure,adventures
adventurer: adventurers
adversary: adversary
advert: adverted
advertise: advertise
advice: advice
advisable: advisable
advise: advise,advised
advisedly: advisedly
adviser: adviser,advisers
afar: afar
affability: affability
affable: affable
affair: affair,affairs
affection: affection
affectionate: affectionate
affectionately: affectionately
affianced: affianced
affinity: affinity
affirmative: affirmative
afflict: afflicted
affliction: affliction
affluent: affluent
afford: afford,afforded
affront: affront
afire: afire
afoot: afoot
afore: afore
aforehand: aforehand
aforesaid: aforesaid
afraid: afraid
afresh: afresh
african: african
afternoon: afternoon,afternoons
age: age,aged
aged: aged
agen: agen
agency: agency
agent: agent
aggravate: aggravated
aggravated: aggravated
aggravating: aggravating
aggravation: aggravation
aghast: aghast
agitate: agitated
agitation: agitation
agonizing: agonizing
agony: agonies,agony
agree: agree,agreed,agreeing
agreeable: agreeable
agreeably: agreeably
agreement: agreement
ague: ague
aguish: aguish
aha: aha
ahoy: ahoy
aid: aid,aided,aids
aim: aim,aiming
air: air,airing
airing: airing
airless: airless
airy: airiest,airy
ajar: ajar
akimbo: akimbo
alarm: alarm,alarmed
alarmed: alarmed
alarming: alarming
alarmingly: alarmingly
alder: alder
ale: ale
alehouse: alehouses
alexander: alexander
alick: alick
alienate: alienate
alight: alight,alighted
alighting: alighting
alive: alive
alleviate: alleviated
alley: alley
allot: allotted
allowance: allowance
alloy: alloy
allude: alluded,alluding
allusion: allusion
ally: allied,allies,ally
almanac: almanac
almighty: almighty
aloud: aloud
alphabet: alphabet
altar: altar
alter: altered,altering
alteration: alteration,alterations
altercation: altercation
altered: altered
alternate: alternate
alternately: alternately
altogether: altogether
amalgamation: amalgamation
amateur: amateur
amaze: amazed
amazed: amazed
amazement: amazement
amazing: amazing
amble: ambled
ambush: ambush
amelia: amelia
amen: amen
amenity: amenities
amens: amens
america: america
amiable: amiable
amiably: amiably
amiss: amiss
amphibious: amphibious
ample: ample
amply: amply
amuse: amused
amused: amused
amusement: amusement
analysis: analysis
anatomy: anatomy
ancestor: ancestor
ancestral: ancestral
anchor: anchor,anchors
anchovy: anchovy
ancient: ancient
anew: anew
angel: angel
anger: anger
angle: angle
angrily: angrily
angry: angry
animal: animal,animals
animate: animate,animated
animated: animated
animosity: animosity
ankle: ankle,ankles
anne: anne
announcement: announcement
annoyance: annoyances
annoyed: annoyed
annual: annual,annuals
annum: annum
anonymous: anonymous
answer: answer,answered,answering,answers
answering: answering
antecedent: antecedents
antechamber: antechamber
anticipate: anticipate,anticipated
anticipation: anticipation,anticipations
antipode: antipodes
antony: antony
antwerp: antwerp
anvil: anvil
anxiety: anxieties,anxiety
anxious: anxious
anxiously: anxiously
anywise: anywise
apartment: apartment,apartments
apiece: apiece
apologetic: apologetic
apologetically: apologetically
apologise: apologised
apology: apology
apoplectic: apoplectic
apostrophe: apostrophe
apostrophise: apostrophising
apothecary: apothecary
appal: appalled
appalling: appalling
apparent: apparent
apparition: apparition
appeal: appeal,appealing,appeals
appearance: appearance,appearances
appease: appeased
appendage: appendages
appertain: appertaining
appetite: appetite
applaud: applaud
apple: apples
appliance: appliances
application: application
apply: applied,applies,apply,applying
appoint: appointed
appointed: appointed
appointment: appointment
apportion: apportioned
appraise: appraised
appreciative: appreciative
apprehend: apprehend
apprehension: apprehension
apprentice: apprentice,apprenticed
apprenticeship: apprenticeship
apprise: apprised
approach: approach,approached,approaches,approaching
approbation: approbation
approval: approval
approve: approve,approved,approving
april: april
apron: apron,aprons
arabian: arabian
arbitrary: arbitrary
arbour: arbour
arch: arch,arches
archbishop: archbishop
architect: architect
architecture: architecture
archly: archly
archway: archway
arena: arena
argue: argue,argued,arguing
argument: argument,arguments
argumentation: argumentation
argumentative: argumentative
argus: argus
arid: arid
aristocratic: aristocratic
arithmetic: arithmetic
ark: ark
arm: arm,arms
arouse: aroused
arrange: arrange,arranged,arranging
arrangement: arrangement,arrangements
array: array,arraying
arrest: arrest,arrested
arrival: arrival
arrive: arrive,arrived,arriving
arrogance: arrogance
arrow: arrow
art: art,arter,arts
arter: arter
artful: artful
artfully: artfully
arthur: arthur
article: article,articled,articles
artifice: artifices
artificer: artificer
artificial: artificial
artlessness: artlessness
ascend: ascend,ascended
ascent: ascent
ascertain: ascertain,ascertained,ascertaining
ash: ashes
ashamed: ashamed
ashore: ashore
ashy: ashy
aslant: aslant
asleep: asleep
asmear: asmear
aspect: aspect
aspiration: aspiration,aspirations
aspire: aspiring
ass: ass,asses
assail: assailed
assailant: assailant
assemble: assembled
assembly: assembly
assent: assent,assented,assenting
assert: asserting
asseverate: asseverates
assiduity: assiduity
assign: assign,assigned
assist: assist,assisted,assisting
assistance: assistance
assistant: assistant
associate: associate,associates
association: association,associations
assort: assort
assume: assume,assumed,assuming
assumption: assumption
assurance: assurance
assure: assure,assured
assured: assured
assuredly: assuredly
astern: astern
astir: astir
astonish: astonished
astonished: astonished
astonishing: astonishing
astonishment: astonishment
astounded: astounded
astride: astride
asunder: asunder
athens: athens
athletic: athletic
athwart: athwart
atmosphere: atmosphere
atop: atop
attach: attached,attaching
attachment: attachment
attack: attack,attacked
attempt: attempt,attempted,attempting,attempts
attend: attend,attended,attending,attends
attendance: attendance
attendant: attendant,attendants
attention: attention,attentions
attentive: attentive
attentively: attentively
attest: attested
attic: attic
attire: attire,attired
attitude: attitude
attract: attract,attracted,attracting
attraction: attractions
attractive: attractive
attribute: attributed,attributes
auction: auction
auctioneer: auctioneer
audacious: audacious
audible: audible
audibly: audibly
audience: audience
augment: augmented
augur: augur
aunt: aunt
auspicious: auspicious
australia: australia
authority: authorities,authority
avail: avail
avarice: avarice
avaricious: avaricious
avenge: avenge,avenging
avenger: avenger
avenue: avenue
average: average
averse: averse
aversion: aversion
avert: averted
avoid: avoid,avoided,avoiding,avoids
avoidable: avoidable
avoidance: avoidance
avowal: avowal
await: awaited,awaiting,awaits
awake: awake,awoke
awaken: awaken,awakened
aware: aware
awe: awe
awful: awful
awkward: awkward
awkwardly: awkwardly
axe: axe
ay: ay
baby: babies,baby
babyhood: babyhood
bachelor: bachelor
backer: backer
background: background
bacon: bacon
bad: bad,worse,worst
badge: badge
badger: badger,badgered,badgering
badly: badly
baffle: baffle,baffled
bag: bag,bags
bagatelle: bagatelle
bailey: bailey
bait: baited,baiting
baize: baize
bake: bake,baking
baker: baker
balance: balance
bald: bald
ball: ball,balls
ballast: ballast
balloon: balloon
balls: balls
band: band
bandage: bandage,bandaged,bandages
bandaged: bandaged
bandbox: bandboxes
bang: bang,banging
banish: banish
bank: bank,banked,banks
banker: banker
banking: banking
banner: banners
banns: banns
banquet: banquet
bar: bar,barred,bars
barbarously: barbarously
barbed: barbed
bard: bard
bare: bare,baring
barefoot: barefoot
barely: barely
bargain: bargain
barge: barge,barges
bargemen: bargemen
barley: barley
barn: barn,barns
barnard: barnard
baronet: baronet
baronetcy: baronetcies,baronetcy
barrack: barrack
barrel: barrel
barricade: barricaded
barrier: barrier
barrow: barrow,barrows
bartholomew: bartholomew
base: base,based,basest
basely: basely
basement: basement
bashful: bashful
basin: basin
basket: basket,baskets
bass: bass
bathe: bathe
battered: battered
battery: battery
battle: battle
battlements: battlements
bawl: bawling
bay: bay
bazaar: bazaar
beach: beach
beacon: beacon
beadle: beadle
beam: beam,beamed,beaming
bean: beans
bear: bear,bearing,bears,bore,born,borne
beard: beard
bearer: bearer,bearers
bearing: bearing,bearings
beast: beast,beasts
beastly: beastly
beat: beat,beaten,beating,beats
beating: beating
beautiful: beautiful
beautifully: beautifully
beauty: beauties,beauty
beaver: beaver
beckon: beckoned
bed: bed,beds
bedchamber: bedchamber
bedded: bedded
bedding: bedding
bedevil: bedevilled
bedridden: bedridden
bedroom: bedroom,bedrooms
bedside: bedside
bedstead: bedstead
bedtime: bedtime
bee: bee
beef: beef
beer: beer
beetle: beetles
befall: befall,befallen
beg: beg,begged,begging
beggar: beggar,beggared
beguile: beguile,beguiled
behalf: behalf
behave: behave
behaviour: behaviour
behead: beheaded
behold: beheld,behold
beholden: beholden
behoof: behoof
beknown: beknown
belief: belief
belinda: belinda
bell: bell,bells
bellow: bellowed,bellows
belong: belong,belonged,belonging,belongs
belongings: belongings
belt: belt
bemoan: bemoan
bench: bench
bend: bend,bending,bent
beneath: beneath
benefactor: benefactor
benefactress: benefactress
beneficent: beneficent
beneficial: beneficial
benefit: benefits
benevolent: benevolent
bent: bent
bereaved: bereaved
bereavement: bereavements
bereft: bereft
beseech: beseeching,besought
beseem: beseem
beset: beset
besetting: besetting
besiege: besieged
bestir: bestirring
bestow: bestow,bestowed,bestowing
bet: bet,betted
betake: betook
bethink: bethinking,bethought
betime: betimes
betray: betray,betrayed
betroth: betrothed
betsy: betsy
betters: betters
betwixt: betwixt
bewilder: bewildered
bib: bib
bible: bibles
bid: bidding
biddy: biddy
bide: bide
bijou: bijou
bile: bile
bilious: bilious
billet: billeted
billingsgate: billingsgate
bind: binding,bound
binding: binding
biography: biography
birch: birch
bird: bird,birds
birth: birth
birthday: birthday
biscuit: biscuit,biscuits
bit: bit,bits
bite: bit,bite,bites,biting
bitter: bitter
bitterly: bitterly
black: black,blackest,blacking,blacks
blacken: blackened
blackfriars: blackfriars
blacksmith: blacksmith
blade: blade,blades
blame: blame
blandly: blandly
blank: blank
blanket: blankets
blankness: blankness
blast: blast,blasts
blatant: blatant
blaze: blaze,blazes,blazing
blazes: blazes
bleak: bleak
bleed: bleeding
bleeding: bleeding
bless: bless,blessed
blessed: blessed
blessedly: blessedly
blessing: blessing
blight: blight,blighted
blind: blind,blinded,blinding
blindly: blindly
blindness: blindness
bliss: bliss
blistered: blistered
blithe: blithe
bloated: bloated
block: block,blocked
blockhead: blockhead
blood: blood
bloodhound: bloodhound
bloodshot: bloodshot
bloodstained: bloodstained
bloodthirsty: bloodthirsty
bloody: bloody
bloom: bloom
blot: blot
blotch: blotches
blotchy: blotchy
blotting: blotting
blow: blew,blow,blowing,blown,blows
blowing: blowing
blubber: blubbered
bludgeon: bludgeon
blue: blue
blunder: blundered,blundering
blunt: blunt,blunter
blur: blur,blurred
blush: blushed,blushes,blushing
bluster: blustered
blusterous: blusterous
boar: boar
board: board,boarded,boards
boarder: boarder
boarding: boarding
boast: boast
boastfulness: boastfulness
boasting: boasting
boat: boat,boating,boats
boatman: boatmen
boatswain: boatswain
bob: bobbing
bobbish: bobbish
bobtail: bobtail
bodily: bodily
body: bodies,body
boil: boil,boiled,boiling
bold: bold,bolder,boldest
boldly: boldly
boldness: boldness
bolt: bolt,bolted,bolting
bolter: bolters
bolting: bolting
bondage: bondage
bondsman: bondsman
bone: bone,boned,bones
bonnet: bonnet
bony: bony
booby: booby
book: book,books
bookcase: bookcase
bookshelf: bookshelves
bookshop: bookshop
boom: boom
boor: boor
boorish: boorish
boot: boot,booted,boots
booth: booth
bootjack: bootjack
bootmaker: bootmaker
border: border,bordered
bore: bore
borrow: borrow,borrowed
bosom: bosom
botany: botany
bother: bother,bothering
bottle: bottle,bottles
bounce: bounce,bounced,bouncing
bounceable: bounceable
bound: bound,bounds
boundless: boundless
bow: bow,bows
bower: bower
bowl: bowl,bowls
bowsprit: bowsprit
box: box,boxed,boxes
boxer: boxer
boy: boy,boys
boyhood: boyhood
boyish: boyish
brace: brace,braces
brag: brag
brain: brain,brains
bramble: bramble,brambles
branch: branch,branches
brand: branded
brandy: brandy
brass: brass
brave: brave
bravery: bravery
brazen: brazen
breach: breach
bread: bread
breadth: breadth
break: break,breaking,broke,broken
breaker: breaker,breakers
breakfast: breakfast,breakfasted
breaking: breaking,breakings
breast: breast,breasts
breasted: breasted
breath: breath,breaths
breathe: breathe,breathed,breathing
breathing: breathing
breathless: breathless
breeches: breeches
breed: bred,breed
breeder: breeder
breeding: breeding
brew: brew,brewed
brewer: brewer
brewery: brewery
brewing: brewing
briar: briars
bribe: bribed
brick: brick
bridal: bridal
bride: bride
bridegroom: bridegroom
bridge: bridge,bridges
bright: bright,brighter
brighten: brightened
brightly: brightly
brightness: brightness
brilliant: brilliant
brilliantly: brilliantly
brim: brim,brimmed
bring: bring,bringing,brings,brought
brink: brink
brisk: brisk,brisker
briskly: briskly
briskness: briskness
bristle: bristling
britain: britain
britannia: britannia
british: british
briton: briton
britons: britons
broach: broached
broad: broad,broader
broken: broken
broker: broker
brooch: brooch,brooches
brood: brood,brooded,brooding
brooding: brooding
broom: broom
broomstick: broomstick
broth: broth
brother: brother,brothers
brow: brow,brows
brown: brown,browned
bruise: bruise,bruised
brush: brush,brushes,brushing
brutal: brutal
brutality: brutality
brute: brute
bucket: bucket
buckle: buckle
budge: budging
buffalo: buffaloes
buffet: buffets
bug: bug
build: build,built
builder: builders
building: building,buildings
bulb: bulbs
bulging: bulging
bull: bull
bullock: bullock
bully: bullied,bully,bullying
bullying: bullying
bulrush: bulrushes
bulwark: bulwarks
bump: bumped,bumping
bundle: bundle,bundles
buoy: buoys
burden: burden
burly: burly
burn: burn,burned,burning,burnt
burning: burning
burst: burst,bursting
bury: buried,burying
bush: bush,bushes
bushel: bushel
bushy: bushy
busily: busily
business: business
bust: bust,busting
busted: busted
buster: buster
bustle: bustle
busy: busy
butcher: butcher,butchers
butt: butts
butter: butter,buttered
button: button,buttons
buttons: buttons
buxom: buxom
buzzingly: buzzingly
bye: bye
bystander: bystander,bystanders
cab: cab
cabbage: cabbage
cabin: cabin
cable: cables
caesar: caesar
cag: cag
cage: cage,caged,cages
cain: cain
cairo: cairo
cake: cake
calculate: calculate,calculated,calculates,calculating
caldron: caldron
calendar: calendar
calf: calves
calling: calling,callings
callous: callous
calm: calm
calmly: calmly
cambridge: cambridge
camel: camels
camels: camels
camilla: camilla
campbell: campbell
canary: canary
cancel: cancel,cancelled
candid: candid
candle: candle,candles
candlelight: candlelight
candlestick: candlestick,candlesticks
candour: candour
cane: cane
cannon: cannon
canterbury: canterbury
canvas: canvas
cap: cap,caped
capable: capable
capacious: capacious
capacity: capacities,capacity
caparison: caparisoned
cape: capes
capital: capital
capitalist: capitalist
capitally: capitally
capricious: capricious
capsize: capsized
capstan: capstans
captain: captain
captive: captive
captor: captor
caravan: caravan
card: card,cards
care: care,cared,caring
career: career
careful: careful
carefully: carefully
careless: careless
carelessly: carelessly
carelessness: carelessness
carols: carols
carpenter: carpenter
carpet: carpet
carriage: carriage,carriages
carry: carried,carry,carrying
cart: cart,carted
carter: carter
carve: carved
carver: carvers
carving: carving
cash: cash
cashier: cashier
cask: cask,casks
casket: casket
cast: cast,casting,casts
casting: casting
castle: castle,castles
castor: castors
casually: casually
cat: cat,cats
catalogue: catalogue
catch: catch,catched,catches,catching,caught
catcher: catcher
catechism: catechism
cathedral: cathedral,cathedrals
cattle: cattle
causeway: causeway
caution: caution,cautioned
cautious: cautious
cautiously: cautiously
cease: cease,ceased,ceasing
ceaseless: ceaseless
ceiling: ceiling
celebrate: celebrated
celebrated: celebrated
cell: cell
cellar: cellar,cellars
census: census
cent: cent
centre: centre
ceremonious: ceremonious
ceremoniously: ceremoniously
ceremony: ceremonies,ceremony
certainty: certainty
certificate: certificate
cestus: cestus
ceylon: ceylon
chafe: chafe,chafed
chaff: chaff
chaffinch: chaffinch
chain: chain,chained,chains
chair: chair,chairs
chaise: chaise
chalk: chalk
challenge: challenged
chamber: chamber,chambers
chamberlain: chamberlain
chambermaid: chambermaid
chance: chance,chanced,chances
chancellor: chancellor
chandelier: chandeliers
chandler: chandler
change: change,changed
chap: chap
chapter: chapter
character: character
characteristic: characteristic,characteristics
charge: charge,charged,charges,charging
chariot: chariot
charity: charity
charles: charles
charlotte: charlotte
charm: charm,charms
charmed: charmed
charming: charming
charmingly: charmingly
chart: charts
charter: chartering
chary: chary
chase: chase,chased
chasm: chasm
chaste: chaste
chat: chat
chatter: chattered
chaw: chawed
cheap: cheap
cheapside: cheapside
cheat: cheat,cheated
check: check,checked,checking
cheek: cheek,cheeks
cheeky: cheeky
cheer: cheer,cheered,cheering
cheerful: cheerful,cheerfullest
cheerfully: cheerfully
cheerfulness: cheerfulness
cheerily: cheerily
cheering: cheering
cheery: cheery
cheese: cheese
chemical: chemical
chemist: chemist
chemistry: chemistry
cherish: cherished
cherry: cherry
chest: chest
chestnut: chestnut
chew: chewing
chicken: chicken
chief: chief
chiefly: chiefly
child: child,children
childhood: childhood
childish: childish
chill: chill
chilled: chilled
chime: chimes
chimney: chimney,chimneys
chin: chin
china: china
chink: chinks
chinks: chinks
chip: chipped,chips
chirp: chirping
chisel: chisel
chivalry: chivalry
choice: choice
choicer: choicer
choke: choke,choked,choking
choleric: choleric
chook: chook
choose: choose,chooses,choosing,chose,chosen
chop: chop,chopping,chops
chopper: chopper
chorus: chorus
christen: christened
christian: christian
christmas: christmas
chronic: chronic
chronically: chronically
chuck: chucked
chum: chum
chump: chump
church: church,churches
churchyard: churchyard
cigar: cigar,cigars
cipher: cipher
circle: circle,circles
circuit: circuit
circuitously: circuitously
circular: circular
circularly: circularly
circulate: circulate
circulation: circulation
circumjacent: circumjacent
circumstance: circumstance,circumstanced,circumstances
circumstantial: circumstantial
cistern: cistern
city: city
civic: civic
civilized: civilized
civilly: civilly
claim: claim,claimed,claiming
clammy: clammy
clap: clap,clapped
clapping: clapping
clara: clara
clash: clash,clashing
clasp: clasping
clasped: clasped
clasping: clasping
class: class,classes
classic: classic
claudius: claudius
clause: clause
claw: claw
clean: clean,cleaned,cleaning
cleaning: cleaning
cleanliness: cleanliness
cleave: cleaving
clem: clem
clemency: clemency
clench: clench,clenching
clenched: clenched
cleopatra: cleopatra
clergyman: clergyman
clerical: clerical
clerk: clerk,clerks
clever: clever,cleverer,cleverest
cleverly: cleverly
client: client,clients
cliental: cliental
cling: clinging,clung
clink: clink
clinking: clinking
clip: clipped
cloak: cloak
clock: clock,clocks
close: close,closed,closer,closest,closing
closed: closed
closely: closely
closet: closet
cloth: cloth
clothe: clothed
clothes: clothes
cloud: cloud,clouds
clouded: clouded
clover: clover
club: club,clubs
clue: clue
clumsy: clumsy
cluster: clustered,clustering
clutch: clutched
coach: coach,coaches
coaching: coaching
coachmaker: coachmaker
coachman: coachman
coal: coal,coals
coarse: coarse,coarser,coarsest
coast: coast,coasting
coat: coat,coated,coats
coattail: coattails
coax: coaxed
cobb: cobbs
cobwebs: cobwebs
cock: cock,cocking
cocked: cocked
codfish: codfish
coercion: coercion
coffee: coffee
coffer: coffers
coffin: coffin
cogent: cogent
cogitation: cogitation
coherent: coherent
coiler: coiler
coin: coin
coincidence: coincidence
coiner: coiner
cold: cold,colder
coldly: coldly
collapse: collapse,collapsed,collapsing
collar: collar,collars
collation: collation
collect: collect,collected
collectedly: collectedly
collection: collection
collier: colliers
collins: collins
collision: collision
colly: collier
colonel: colonel
colonist: colonist,colonists
colour: colour,coloured,colours
column: column,columns
coma: coma
comb: comb
combat: combat,combats
combination: combination,combinations
combine: combine,combined
comfort: comfort,comforted,comforting,comforts
comfortable: comfortable
comfortably: comfortably
comforting: comforting
comic: comic
comical: comical
coming: coming,comings
command: command,commanded
commandment: commandments
commence: commence
commend: commended
commendable: commendable
comment: comment,comments
commercial: commercial,commercials
commiserate: commiserating
commiseration: commiseration
commission: commission
commit: commit,committed
committal: committal
commodious: commodious
common: common,commonest
commoner: commoner
commonly: commonly
commotion: commotion
commune: commune
communicate: communicate,communicated,communicating
communication: communication,communications
communicative: communicative
communing: communing
community: community
compact: compact
compactly: compactly
companion: companion,companions
companionship: companionship
company: companies,company
comparative: comparative
comparatively: comparatively
compare: compare,compared,comparing
comparison: comparison
compass: compass
compassion: compassion
compassionate: compassionate,compassionating
compel: compels
compelled: compelled
compelling: compelling
compensation: compensation
compete: competed
competency: competency
competent: competent
competition: competition
competitive: competitive
compilation: compilation
compiler: compiler
complacency: complacency
complacent: complacent
complacently: complacently
complain: complain,complained
complaint: complaint,complaints
complete: complete,completed,completing
completely: completely
completeness: completeness
complexion: complexion
complexioned: complexioned
complicate: complicated
complicated: complicated
complication: complications
compliment: compliment,complimented,complimenting,compliments
complimentary: complimentary
comply: complied,comply
compose: compose,composed
composed: composed
composedly: composedly
composition: composition
composure: composure
compound: compound
comprehend: comprehend,comprehended,comprehending
comprehension: comprehension
comprehensive: comprehensive
compress: compress,compressed
comprise: comprised,comprising
compromise: compromise,compromised
compromising: compromising
computation: computation
comrade: comrade
conceal: conceal,concealed
concealment: concealment
concede: conceded,conceding
conceited: conceited
conceitedly: conceitedly
conceive: conceive,conceived
concentrate: concentrated,concentrating
concentration: concentration
conception: conception
concern: concern,concerned,concerns
concerned: concerned
concert: concert,concerts
concession: concession
conciliate: conciliate
conciliatory: conciliatory
conclude: conclude,concluded,concluding
conclusion: conclusion,conclusions
conclusive: conclusive
conclusively: conclusively
concourse: concourse
concrete: concrete
concur: concurred
concussion: concussion
condemn: condemned
condemnation: condemnation
condescend: condescend
condescending: condescending
condescension: condescension
condition: condition,conditions
conduce: conduced
conduct: conduct,conducted,conducting
conductor: conductor
conductress: conductress
confectioner: confectioner
conference: conference
confess: confess,confessed
confession: confession,confessions
confide: confide,confided,confides,confiding
confidence: confidence,confidences
confident: confident
confidential: confidential
confidentially: confidentially
confine: confined
confinement: confinement
confirm: confirmed
confirmatory: confirmatory
conflagration: conflagration
conflict: conflict
confound: confound,confounded,confounding
confront: confront,confronted,confronting
confuse: confused,confuses
confused: confused
confusedly: confusedly
confusion: confusion
confute: confute
congelation: congelation
congratulate: congratulate,congratulated,congratulating
congratulation: congratulations
congregation: congregation
conjecture: conjectures
conjugate: conjugate
conjunction: conjunction
connect: connect,connected
connection: connection
connubial: connubial
conquer: conquered
conquest: conquest
conscience: conscience
conscientious: conscientious
conscious: conscious
consciously: consciously
consciousness: consciousness
consent: consent,consented
consequence: consequence,consequences
consequent: consequent
conservatory: conservatory
considerable: considerable
considerably: considerably
considerate: considerate
consideration: consideration,considerations
consign: consigned
consist: consisted,consisting
consistent: consistent
consolation: consolation
consolatory: consolatory
consort: consorted
conspiracy: conspiracy
constable: constable
constables: constables
constancy: constancy
constant: constant
constantly: constantly
consternation: consternation
constitute: constituted
constitution: constitution
constitutional: constitutional
constitutionally: constitutionally
constrainedly: constrainedly
constraint: constraint
construct: constructed
construction: construction
construe: construe
consult: consult,consulted
consultation: consultation
consume: consume,consumed,consuming
contaminate: contaminated
contemplate: contemplate,contemplated,contemplating
contemplation: contemplation
contempt: contempt
contemptible: contemptible
contemptuous: contemptuous
contemptuously: contemptuously
contend: contended,contending
content: content
contented: contented
contention: contention
contents: contents
contest: contest
contiguous: contiguous
contingent: contingent
continue: continue,continued,continuing
contract: contract,contracted
contraction: contraction
contradict: contradicted
contradiction: contradiction
contradictory: contradictory
contrary: contrary
contrast: contrast,contrasted,contrasting
contribute: contributed
contrite: contrite
contrition: contrition
contrivance: contrivance
contrive: contriving
contrived: contrived
contriver: contriver
control: control
contumaciously: contumaciously
convenience: convenience
convenient: convenient
conveniently: conveniently
conventional: conventional
conventionally: conventionally
conversation: conversation,conversations
conversational: conversational
converse: conversed,conversing
convert: converting
convey: convey,conveyed,conveying
convict: convict,convicted,convicts
conviction: conviction
convince: convince,convinced
convinced: convinced
convincing: convincing
convulsive: convulsive
coo: cooing
cook: cook,cooked
cool: cool,cooling
cooling: cooling
coolly: coolly
coolness: coolness
coopering: coopering
copious: copious
copper: copper
coppersmith: coppersmith
cordial: cordial
cordiality: cordiality
cordially: cordially
corduroy: corduroys
coriolanus: coriolanus
cork: cork
corn: corn
corner: corner,cornered,corners
coroner: coroner
coronet: coronets
corpse: corpse
correct: correct,correcting
correction: correction
correspond: corresponded
correspondence: correspondence
correspondent: correspondent
corroborate: corroborated
corrugated: corrugated
corrupt: corrupted
cosey: cosey
cost: cost,costs
cot: cot
cottage: cottage
cotton: cotton
cough: cough,coughed,coughing,coughs
council: council,councils
counsel: counsel,counsels
counsellor: counsellor
count: count,counted,counting
countenance: countenance,countenances
counter: counter
counteraction: counteraction
counterpart: counterpart
counterweight: counterweights
counting: counting
country: country
countryside: countryside
county: county
couple: couple
couplet: couplet
coupling: coupling
courage: courage
courser: coursers
court: court,courting,courts
courtier: courtier
courtyard: courtyard
cousin: cousin
cove: cove
covent: covent
cover: cover,covered,covering,covers
covered: covered
coverlet: coverlet
coward: coward
cowardice: cowardice
cowardly: cowardly
cower: cowering
crack: crack,cracked,cracking,cracks
cracker: crackers
cracksman: cracksmen
cradle: cradle
craft: craft
cram: crammed,cramming
cravat: cravat
crawl: crawling
crazy: crazy
creak: creak,creaking
creamy: creamy
creation: creation
creature: creature,creatures
credence: credence
credentials: credentials
credit: credit
creditor: creditor,creditors
creek: creek
creep: creep,creeping,crept
crestfallen: crestfallen
crevice: crevice
crew: crew
crib: crib,cribbed
crier: criers
crime: crime,crimes
criminal: criminal
criminality: criminality
cringe: cringe,cringes
crippled: crippled
crisis: crisis
crisp: crisp
critical: critical
crock: crock
crockery: crockery
crook: crook
crooked: crooked
croon: crooning
crop: cropping
cross: cross,crossed,crossing
crouch: crouching
crow: crow,crowing,crows
crowd: crowd,crowded,crowding
crowded: crowded
crown: crown,crowned
crowning: crowning
cruel: cruel
cruelty: cruelty
cruet: cruet
crumb: crumb,crumbs
crumble: crumble
crumple: crumpled
crumpled: crumpled
crunch: crunching
crusaders: crusaders
crush: crush,crushed,crushing
crust: crust
crutch: crutch,crutched,crutches
crying: crying
cucumber: cucumber,cucumbers
cuff: cuff,cuffs
culminate: culminated
culprit: culprit,culprits
cultivate: cultivated
cumber: cumbered
cunning: cunning
cup: cup,cups
cupboard: cupboard
cupid: cupid
cupidity: cupidity
curator: curator
curiosity: curiosities,curiosity
curious: curious
curiously: curiously
curl: curls
curly: curly
currant: currant
current: current
curse: curse,cursed,curses
curtain: curtain,curtains
curtly: curtly
cushion: cushion,cushioned,cushions
custody: custody
custom: custom,customs
customary: customary
cut: cut,cutting
cutlet: cutlets
cutting: cutting
dab: dab
daily: daily
daintily: daintily
dale: dale
damage: damage,damaged,damaging
damn: damn
damnatory: damnatory
damp: damp
damsel: damsel
dance: dance,danced,dances,dancing
dancing: dancing
dandle: dandling
danger: danger,dangers
dangerous: dangerous
dangle: dangling
dangling: dangling
danish: danish
daring: daring
dark: dark,darker,darkest
darken: darkened,darkening
darkening: darkening
darkly: darkly
darkness: darkness
darling: darling
darn: darn
dart: darted
dash: dash,dashed,dashes
daughter: daughter
dawn: dawn,dawned,dawning
day: day,days
daylight: daylight
daze: dazed
dazed: dazed
dead: dead
deaden: deaden,deadened
deadly: deadly
deaf: deaf
deal: deal,dealt
dean: dean
dearly: dearly
death: death
debate: debate,debated,debates,debating
debilitate: debilitating
debt: debt,debts
debtor: debtors
decant: decanted
decanter: decanter,decanters
decay: decay
decayed: decayed
decease: decease
deceased: deceased
deceive: deceive,deceiving
december: december
decent: decent
decide: decide,decided
decidedly: decidedly
decisive: decisive
decisively: decisively
deck: deck
declamation: declamation
declaration: declaration
declare: declare,declared,declaring
decline: decline,declined,declining
decorate: decorated,decorating
deduce: deduced
deed: deed,deeds
deem: deem,deemed,deeming
deep: deep,deeper,deepest
deepening: deepening
deeply: deeply
deer: deer
deface: defaced
defeat: defeat,defeated
defence: defence,defences
defenceless: defenceless
defend: defend,defended
defer: deferred
deferential: deferential
defiance: defiance
defiant: defiant
deficiency: deficiencies,deficiency
deficient: deficient
define: define
definite: definite
definition: definition
defy: defy
degradation: degradation
degraded: degraded
degrading: degrading
degree: degree,degrees
dejected: dejected
dejectedly: dejectedly
dejection: dejection
delay: delay
delegate: delegated
deliberate: deliberate,deliberated
deliberately: deliberately
deliberation: deliberation,deliberations
delicacy: delicacy
delicate: delicate
delicately: delicately
delicious: delicious
delight: delight,delights
delighted: delighted
delightedly: delightedly
delightful: delightful
delightfully: delightfully
delirious: delirious
deliver: deliver,delivered,delivering
deliverance: deliverance
delusion: delusion
demand: demanded
demeanour: demeanour
demonstrate: demonstrated
demonstration: demonstration
denmark: denmark
denote: denoted
denounce: denounce,denounced,denouncing
denouncer: denouncer
dense: dense
dentist: dentist
denude: denuded
denunciation: denunciations
deny: denied,deny
depart: depart,departed,departing
department: department
departure: departure
depend: depend,depended,depends
dependence: dependence
dependent: dependent
depose: depose,deposed
deposit: deposit,deposited
depreciation: depreciation
depreciatory: depreciatory
depress: depressed,depressing
depressed: depressed
depressing: depressing
depression: depression
depth: depth
deputy: deputy
derision: derision
derisively: derisively
derive: derive,derived
descend: descended
description: description
descry: descried,descry,descrying
desert: desert,deserted,deserting
deserted: deserted
deserve: deserve,deserved,deserving
deserved: deserved
deservedly: deservedly
design: design,designed,designing,designs
designation: designation
desirable: desirable
desire: desire,desired,desiring
desirous: desirous
desisted: desisted
desk: desk
desolate: desolate
desolation: desolation
despair: despair
despairing: despairing
despairingly: despairingly
despatch: despatch,despatched
desperate: desperate
desperately: desperately
desperation: desperation
despicable: despicable
despise: despise,despised,despising
despondency: despondency
despondent: despondent
desponding: desponding
despotic: despotic
dessert: dessert
destination: destination
destine: destined
destiny: destiny
destroy: destroy,destroyed
destroyer: destroyer
destruction: destruction
destructive: destructive
detach: detach,detached
detain: detaining
detect: detect,detected
deter: deterred
deteriorated: deteriorated
determination: determination
determine: determine,determined,determining
determined: determined
detest: detested
detestable: detestable
detestation: detestation
detrimental: detrimental
deuce: deuce
devastating: devastating
develop: develop,developed,developing
development: development
deviate: deviate
device: device,devices
devil: devil
devilish: devilish
devise: devise,devised
devolve: devolved
devote: devote,devoted,devoting
devoted: devoted
devotedly: devotedly
devotion: devotion
devour: devouring
devoutly: devoutly
dexterity: dexterity
dexterous: dexterous
dexterously: dexterously
diabolical: diabolical
diadem: diadem
dialogue: dialogue,dialogues
diamond: diamond
dickens: dickens
dictate: dictates
dictatorial: dictatorial
die: die,died,dying
diet: diet
difference: difference,differences
difficult: difficult
difficulty: difficulties,difficulty
diffidence: diffidence
diffident: diffident
dig: dug
digestion: digestion
digger: digger
dignified: dignified
dignitary: dignitary
dignity: dignities,dignity
dike: dike,dikes
dilapidated: dilapidated
dilate: dilated
dilute: diluting
dim: dim,dimmed
diminish: diminishing
dimly: dimly
dimple: dimples
dimpled: dimpled
din: din
dine: dine,dined,dines,dining
diner: diner
dingy: dingiest
dining: dining
dinner: dinner,dinners
dint: dint,dints
dip: dip,dipped,dipping
dire: dire
direct: direct,directed,directing
direction: direction,directions
director: director
dirt: dirt
dirty: dirty
disable: disable
disabled: disabled
disadvantage: disadvantage
disaffection: disaffection
disagree: disagreed
disagreeable: disagreeable
disagreeably: disagreeably
disappear: disappear,disappeared,disappearing
disappoint: disappointed
disappointed: disappointed
disappointment: disappointment,disappointments
disarrangement: disarrangement
disaster: disaster
disastrous: disastrous
discern: discern
discernible: discernible
discharge: discharge,discharged,discharges
disclose: disclose,disclosed,discloses
disclosure: disclosure
discomfited: discomfited
discomfiture: discomfiture
discompose: discomposed
discomposure: discomposure
disconcerted: disconcerted
disconsolately: disconsolately
discontent: discontent
discontented: discontented
discourage: discourage
discouragement: discouragement
discouraging: discouraging
discourse: discourse,discoursed
discover: discover,discovered,discovering
discovery: discoveries,discovery
discreet: discreet
discrepancy: discrepancy
discretion: discretion
discrimination: discrimination
discursive: discursive
discuss: discuss,discussed,discussing
discussion: discussion,discussions
disdain: disdain
disdainful: disdainful
disdainfully: disdainfully
disease: disease
diseased: diseased
disembodied: disembodied
disengage: disengaged,disengaging
disfigured: disfigured
disgorge: disgorged
disgrace: disgrace,disgraces
disgraced: disgraced
disgraceful: disgraceful
disguise: disguise,disguised,disguising
disgust: disgust
disgusted: disgusted
dish: dish,dishes
disheartening: disheartening
disinherit: disinherited
disinterested: disinterested
disinterestedness: disinterestedness
dislike: dislike
dislocate: dislocate
dismal: dismal
dismally: dismally
dismay: dismay
dismayed: dismayed
dismiss: dismiss,dismissed,dismissing
disorder: disorder,disordered,disordering
disordered: disordered
disorderly: disorderly
disparagement: disparagement
disparity: disparity
dispel: dispelled
dispense: dispense
disperse: dispersed
dispirited: dispirited
displace: displace,displaced
display: display,displayed,displaying
displease: displease
displeasure: displeasure
disposal: disposal
dispose: dispose,disposed
disposed: disposed
disposition: disposition,dispositions
disputatious: disputatious
dispute: dispute,disputed,disputing
disquiet: disquiet
disregard: disregarded,disregarding
disrespectful: disrespectful
dissatisfied: dissatisfied
dissatisfy: dissatisfied
dissimilar: dissimilar
dissipate: dissipated
dissociate: dissociate
dissolve: dissolve,dissolved
dissuade: dissuading
distance: distance
distant: distant
distinct: distinct
distinctly: distinctly
distinctness: distinctness
distinguish: distinguish,distinguished,distinguishing
distinguishable: distinguishable
distinguished: distinguished
distinguishing: distinguishing
distort: distorted
distortion: distortions
distract: distracted
distracted: distracted
distractedly: distractedly
distraction: distraction
distraught: distraught
distress: distress
distressed: distressed
distribute: distributed
district: district
distrust: distrust,distrusts
distrustful: distrustful
distrustfully: distrustfully
disturb: disturbed,disturbing
disturbance: disturbance
disturbed: disturbed
disused: disused
ditch: ditch,ditches
ditty: ditty
dive: dive,dived
diver: divers
diverge: diverged
divergence: divergence
diversion: diversion
divert: divert,diverted,diverts
divest: divest,divested,divesting
divide: divided,dividing
divine: divined
divinely: divinely
diving: diving
division: division
divorce: divorced
divulge: divulged
dock: dock,docks
docket: docketed
doctor: doctor
documentary: documentary
dodge: dodged,dodging
dog: dog,dogs
dogged: dogged
doggedly: doggedly
doings: doings
doleful: doleful
dolefully: dolefully
doll: doll
dolt: dolt
dome: dome
domestic: domestic
dominant: dominant
dominion: dominions
donkey: donkey
donor: donor
doo: doo
doom: doomed
door: door,doors
doorstep: doorstep,doorsteps
doorway: doorway
dormouse: dormouse
dose: dosed
dot: dots
double: double,doubled,doubling
doubly: doubly
doubt: doubt,doubted,doubting,doubts
doubtless: doubtless
dove: dove
dover: dover
dower: dower
downcast: downcast
downfall: downfall
downhill: downhill
downright: downright
downstairs: downstairs
downstroke: downstroke
doze: doze,dozed,dozing
dozen: dozen
draft: drafted
drag: drag,dragged,dragging
draggled: draggled
dram: dram
drama: drama
dramatic: dramatic
drape: draped
drat: drat
draw: draw,drawing,drawn,drew
drawback: drawback
drawbridge: drawbridge
drawer: drawer,drawers
drawl: drawling
dread: dread,dreaded,dreads
dreaded: dreaded
dreadful: dreadful
dreadfully: dreadfully
dream: dream,dreamed,dreaming,dreams
dreamy: dreamy
drearily: drearily
dreary: dreary
dregs: dregs
dress: dress,dressed,dresses,dressing
dressed: dressed
dresser: dresser
dressing: dressing
drift: drift,drifted,drifting
drily: drily
drink: drank,drink,drinking,drinks,drunk
drinking: drinking
drip: dripped
dripping: dripping
drive: drive,driven,driving,drove
drivelling: drivelling
driving: driving
drizzle: drizzle
drizzly: drizzly
droll: droll
droop: drooped
drop: drop,dropped,dropping,drops
dropping: dropping
drown: drown,drowned
drownd: drownded
drowned: drowned
drowsily: drowsily
drudge: drudge,drudging
drug: drugs
drum: drum
drumstick: drumsticks
drunk: drunk
drunkard: drunkard
dry: dried,drier,dry,drying
dryer: dryer
dryly: dryly
dubiously: dubiously
duchess: duchess
dull: dull
dulness: dulness
duly: duly
dumb: dumb
dunder: dunder
dunghill: dunghill
dunstable: dunstable
duration: duration
durst: durst
dusk: dusk
dust: dust,dusting
dustman: dustman
dustpan: dustpan
dusty: dusty
dutch: dutch
dutchman: dutchmen
dutifully: dutifully
duty: duties,duty
dwell: dwelling,dwelt
dwelling: dwelling,dwellings
dwindle: dwindled
dye: dyes
dying: dying
eager: eager
eagerly: eagerly
eagerness: eagerness
eagle: eagle
ear: ear,ears
earn: earn,earned
earnest: earnest
earnestly: earnestly
earnestness: earnestness
earnings: earnings
earth: earth
earthenware: earthenware
earthwork: earthwork
earthy: earthy
earwig: earwigs
ease: ease,easing
easily: easily
east: east
eastern: eastern
eastward: eastward
easy: easier,easy
eat: ate,eat,eaten,eating,eats
eating: eating
ebb: ebb
eccentric: eccentric
eccentrically: eccentrically
ecclesiastical: ecclesiastical
echo: echo,echoed,echoing
ecod: ecod
economy: economy
ecstasy: ecstasy
ecstatic: ecstatic
eddy: eddies,eddy
edge: edge,edged,edges,edging
edged: edged
edifying: edifying
edition: edition
educate: educated,educating
education: education
educational: educational
eel: eel
effects: effects
effectually: effectually
efficient: efficient
effort: effort,efforts
egg: egg,eggs
egress: egress
eighteen: eighteen
eject: ejected
elaborate: elaborate,elaborated
elapse: elapsed
elated: elated
elbow: elbow,elbows
eld: eldest
elder: elder,elders
elderly: elderly
elect: elect
election: election
elegance: elegance
elegant: elegant
element: elements
elephant: elephant,elephants
elevate: elevated
elevation: elevation
elicit: eliciting
elixir: elixir
elocution: elocution
elongated: elongated
elongation: elongation
eloquence: eloquence
elude: eluded,eluding
emancipation: emancipation
embankment: embankment
embark: embarked
embellishment: embellishment
embodiment: embodiment
embrace: embrace,embraced,embraces,embracing
embroider: embroidered
emerge: emerge,emerged
emergence: emergence
emergency: emergency
emigrant: emigrant
eminently: eminently
emotion: emotion,emotions
emotional: emotional
emphasis: emphasis
emphasise: emphasised
emphatic: emphatic
emphatically: emphatically
employ: employ,employing
employer: employer
employment: employment
empower: empowered
enable: enabled
enchanter: enchanter
enchantment: enchantment
encircle: encircled
enclose: enclosed,enclosing
encompass: encompassed
encounter: encounter,encountered
encourage: encourage,encouraged
encouragement: encouragement
encouraging: encouraging
encroach: encroached,encroaching
encrusting: encrusting
encumber: encumber,encumbered
endanger: endanger,endangered
endearing: endearing
endeavour: endeavour,endeavoured,endeavouring
endow: endowed
endurance: endurance
endure: endure,endured,enduring
enemy: enemies,enemy
energetic: energetic
energetically: energetically
energy: energies,energy
engage: engage,engaged
engagement: engagement,engagements
engaging: engaging
engender: engender,engendered,engendering
engine: engine,engines
engineer: engineer
england: england
english: english
englishman: englishman
engraving: engravings
engross: engrossed
enhance: enhanced
enjoy: enjoy,enjoyed,enjoying
enjoyable: enjoyable
enjoyment: enjoyment
enlarge: enlarged,enlarging
enlighten: enlighten,enlightened
enlightenment: enlightenment
enlist: enlist,enlisted
enormous: enormous
enrich: enrich,enriching
ensue: ensued,ensuing
ensure: ensure
entangle: entangled
enter: enter,entered,entering
enterprising: enterprising
entertain: entertain,entertained
entertainer: entertainer
entertaining: entertaining
entertainment: entertainment
enthralling: enthralling
enthusiastic: enthusiastic
entire: entire
entitle: entitled
entrance: entrance
entrap: entrap
entrapped: entrapped
entreat: entreat,entreated,entreating
entreatingly: entreatingly
entry: entries,entry
envious: envious
envy: envied,envy,envying
epergne: epergne
episode: episode
epistle: epistle
epitaph: epitaph
epsom: epsom
equal: equal,equalled,equals
equality: equality
equally: equally
equipage: equipage
err: err
errand: errand
errant: errant
error: errors
erudition: erudition
escape: escape,escaped
escort: escort,escorted,escorting
especial: especial
esquire: esquire
essex: essex
est: est
establish: establish,established
established: established
establishment: establishment
estate: estate
esteem: esteem
estella: estella
estimable: estimable
estimate: estimate
eternal: eternal
eternity: eternity
europe: europe
evade: evade,evading
evaporate: evaporated
evasion: evasion
evasively: evasively
eve: eve
evening: evening,evenings
event: event,events
eventful: eventful
eventually: eventually
evidence: evidence
evident: evident
evidently: evidently
evil: evil
evince: evincing
evoke: evoked
exact: exact,exacted
exacting: exacting
exaggerate: exaggerate
exaggerated: exaggerated
exaggeration: exaggeration
exalt: exalted
exaltation: exaltation
examination: examination,examinations
examine: examine,examined,examining
exasperate: exasperated
exasperated: exasperated
exasperating: exasperating
excavation: excavation
exceed: exceeded,exceeding
exceedingly: exceedingly
excellence: excellence
excellent: excellent
exception: exception
exceptional: exceptional
exceptionally: exceptionally
excess: excess
excessive: excessive
exchange: exchange,exchanged,exchanging
excitable: excitable
excite: excited
excited: excited
excitement: excitement
exclaim: exclaimed,exclaiming
exclamation: exclamation,exclamations
exclude: excluded
exclusion: exclusion
excommunicate: excommunicated
excrescence: excrescence
excusable: excusable
excusably: excusably
excuse: excuse,excuses
execrate: execrated
execrating: execrating
execute: execute,executed
execution: execution
executioner: executioner
exemplary: exemplary
exemplify: exemplified
exercise: exercise,exercises
exertion: exertions
exhale: exhaled
exhaust: exhausted
exhausted: exhausted
exhausting: exhausting
exhaustion: exhaustion
exhibit: exhibit,exhibited,exhibiting
exhibition: exhibition
exhibitor: exhibitor
exhort: exhorted
exile: exile
exist: exist,existing
existence: existence,existences
exonerate: exonerated
exordium: exordium
expand: expand,expanded
expanse: expanse
expansion: expansion
expatriate: expatriated
expect: expect,expected,expecting
expectancy: expectancy
expectant: expectant
expectation: expectation,expectations
expectorate: expectorating
expedition: expedition,expeditions
expend: expending
expenditure: expenditure
expense: expense,expenses
expensive: expensive
expensively: expensively
experience: experience,experienced,experiences
experimental: experimental
explain: explain,explained,explaining
explainer: explainer
explanation: explanation,explanations
explanatory: explanatory
explicit: explicit
explode: exploding
explore: explore,explored
expose: expose,exposed
exposition: exposition
expostulatory: expostulatory
exposure: exposure
expound: expounded
express: express,expressed,expresses,expressing
expression: expression
expressive: expressive
expressly: expressly
exquisite: exquisite
extend: extend,extended,extending
extension: extension
extensive: extensive
extensively: extensively
extent: extent
extenuate: extenuated
extenuating: extenuating
externally: externally
extinct: extinct
extinguish: extinguished
extort: extort,extorted
extra: extra
extract: extract,extracted
extraordinarily: extraordinarily
extraordinary: extraordinary
extravagant: extravagant
extravagantly: extravagantly
extreme: extreme
extremely: extremely
extremity: extremities,extremity
extricate: extricate
exuberant: exuberant
exult: exult
exultant: exultant
exultingly: exultingly
eye: eye,eyeing,eyes
eyebrow: eyebrow,eyebrows
eyed: eyed
eyelid: eyelids
eyesight: eyesight
fabulous: fabulous
facetious: facetious
fade: faded,fading
fail: fail,failed,failing
failing: failings
failure: failure,failures
fain: fain
faint: faint,faintest
fainting: fainting
faintly: faintly
fair: fair
fairy: fairy
faith: faith
faithful: faithful
faithfully: faithfully
fall: fall,fallen,falling,falls,fell
falling: falling
falls: falls
false: false
falser: falser
falter: faltered,faltering
familiar: familiar
familiarity: familiarity
family: family
famous: famous
famously: famously
fancied: fancied
fanciful: fanciful
fancy: fancied,fancier,fancies,fancy,fancying
fang: fangs
fanny: fanny
fantastic: fantastic
fare: faring
farewell: farewell
farinaceous: farinaceous
farm: farm
farmer: farmer,farmers
farthing: farthing
farthingale: farthingale
fascinate: fascinated
fashion: fashion,fashions
fashionable: fashionable
fashioned: fashioned
fast: fast,faster,fasts
fasten: fastened
fastening: fastenings
fat: fat
fatal: fatal
fate: fate
father: father,fathers
fatigue: fatigues
fatigued: fatigued
fatten: fatten
fatty: fatty
fault: fault,faults
favour: favour,favoured,favouring,favours
favourable: favourable
favoured: favoured
favourite: favourite
fawn: fawned,fawning
fawner: fawners
fealty: fealty
fear: fear,feared,fearing,fears
fearful: fearful,fearfullest
fearfully: fearfully
feasible: feasible
feast: feast
feat: feats
feather: feather,feathers
feature: feature,features
february: february
fee: fees
feeble: feeble,feebler
feebleness: feebleness
feebly: feebly
feed: fed,feed,feeding
feel: feel,feeling
feeling: feeling,feelings
feelingly: feelingly
feign: feign,feigned
feint: feint
felicitous: felicitous
fell: fell,felled
fellow: fellow,fellows
felon: felon,felons
felonious: felonious
felony: felony
female: female
feminine: feminine
fence: fence,fenced
fencing: fencing
fend: fend
fender: fender,fenders
ferment: fermenting
ferocious: ferocious
ferocity: ferocity
fervent: fervent
fervently: fervently
fervor: fervor
festival: festival
festive: festive
festivity: festivities
festoon: festoon,festooned
fetch: fetch,fetched
fetter: fetter,fetters
fever: fever
feverish: feverish
fiction: fiction
fidelity: fidelity
fidgety: fidgety
field: field,fields
fiend: fiend
fiendishly: fiendishly
fierce: fierce
fiercely: fiercely
fiery: fiery
fight: fight,fighting,fights,fought
fighting: fighting
figure: figure,figures
file: file,filed,filing
film: film
filth: filth
fin: fin
final: final
finally: finally
finch: finch,finches
fine: fine,finer,finest
finely: finely
finger: finger,fingers
finish: finish,finished,finishing
finished: finished
finishing: finishing
firelight: firelight
fireplace: fireplace
fireside: fireside
firework: firework
firing: firing
firm: firm
firmly: firmly
firstly: firstly
fish: fish,fished,fishing
fishily: fishily
fishing: fishing
fishy: fishy
fist: fist
fit: fit,fits,fitted,fitting
fitful: fitful
fitfully: fitfully
fixed: fixed
fixture: fixture
flabby: flabby
flaccid: flaccid
flag: flag,flags
flagstaff: flagstaff
flake: flakes
flame: flame,flames,flaming
flannel: flannel
flap: flap,flapped,flapping
flare: flare,flared,flaring
flash: flash,flashed,flashes,flashing
flask: flask
flat: flat,flats,flatter
flatly: flatly
flatter: flattered
flattering: flattering
flavour: flavour
flaw: flawed
flaxen: flaxen
flay: flay
fledged: fledged
fledgling: fledgling
fleet: fleet,fleeter
flicker: flickering
flight: flight
flighty: flighty
fling: fling,flinging,flung
flint: flint,flints
flip: flip
flit: flit
float: floating
floating: floating
flock: flock
floor: floor,floors
floorcloth: floorcloth
flounce: flounce
flounder: flounder,floundering
flour: flour
flourish: flourish,flourishing
flow: flow,flowing
flower: flower,flowered,flowering,flowers
fluey: fluey
fluid: fluid
flush: flush,flushed,flushes
flute: flute
flutter: flutter,fluttering
fly: flew,flies,flown,fly,flying
foam: foam
focus: focus
foe: foe
fog: fog
foggy: foggy
fold: fold,folded,folding
folding: folding
folk: folks
foller: foller
follow: follow
follower: followers
folly: folly
fond: fond,fonder
fondness: fondness
font: font
food: food
fool: fool
foolish: foolish
foolishly: foolishly
foot: feet,foot
footed: footed
footing: footing
footman: footmen
footprint: footprints
footsore: footsore
footstep: footstep,footsteps
footstool: footstool
forasmuch: forasmuch
forbear: forbore
forbearance: forbearance
forbid: forbid,forbidden,forbidding
forbidden: forbidden
force: force,forced,forcing
forcible: forcible
forcibly: forcibly
fore: fore
forecastle: forecastle
forefather: forefathers
forefinger: forefinger,forefingers
forefoot: forefoot
foregone: foregone
foreground: foreground
forehead: forehead
foreign: foreign
forelock: forelock
foremost: foremost
foresee: foresaw,foreseeing
foreshadow: foreshadowed
foresight: foresight
forest: forest
forewarn: forewarned
forfeit: forfeited
forfeiture: forfeiture
forge: forge,forged,forging
forgery: forgery
forget: forget,forgetting,forgot,forgotten
forgetful: forgetful
forgetfulness: forgetfulness
forgive: forgive,forgiven,forgiving
forgiveness: forgiveness
fork: fork,forks
forlorn: forlorn
form: form,formed,forming,forms
formal: formal
formality: formalities,formality
formally: formally
formation: formation
forsake: forsook
forsworn: forsworn
forte: forte
fortification: fortifications
fortify: fortified
fortitude: fortitude
fortnight: fortnight
fortress: fortress
fortuitously: fortuitously
fortunate: fortunate
fortunately: fortunately
fortune: fortune,fortunes
forwards: forwards
foster: fostered
foul: foul
founder: founder
fountain: fountain
fourpence: fourpence
fourteen: fourteen
fourth: fourth
fowl: fowl,fowls
fox: fox
fragment: fragments
fragrance: fragrance
frame: frame,frames
france: france
frank: frank
frantic: frantic
frantically: frantically
fraud: fraud
fraught: fraught
fray: frayed
freak: freak
freckled: freckled
freedom: freedom
freehold: freehold
freely: freely
freemasonry: freemasonry
freeze: froze
freezing: freezing
french: french
frenzy: frenzy
frequent: frequent
frequently: frequently
fresh: fresh,fresher
freshen: freshened
freshness: freshness
fret: fret
fretful: fretful
fretfulness: fretfulness
friction: friction
friday: friday
friend: friend,friends
friendly: friendly
friendship: friendship
fright: fright
frighten: frighten,frightened
frightened: frightened
frightful: frightful
frill: frill
frilling: frillings
fringe: fringe
frivolity: frivolity
fro: fro
frock: frock,frocks
frog: frog
frost: frost
frosty: frosty
frown: frown,frowned,frowning
frowning: frowning
frowningly: frowningly
frowzy: frowzy
frugally: frugally
fruit: fruit,fruits
fuel: fuel
fugitive: fugitive,fugitives
fulfil: fulfilling
fulfilment: fulfilment
function: functions
funeral: funeral
funereal: funereal
fungus: fungus
fur: fur
furious: furious
furlong: furlongs
furnace: furnace
furnish: furnished
furnished: furnished
furniture: furniture
furred: furred
furrow: furrowed
fury: fury
futile: futile
future: future
gain: gain,gained,gaining,gains
gainsaying: gainsaying
gait: gait
gaiter: gaiters
gallant: gallant
gallery: gallery
galley: galley
gallon: gallon
gallows: gallows
game: game,gamed,games
gaming: gaming
gang: gang,gangs
gangway: gangway
gaoler: gaoler
gap: gap
gape: gaping
garden: garden,gardens
gardener: gardener
gardening: gardening
gardens: gardens
gargle: gargling
garland: garlanded,garlands
garment: garment,garments
garret: garret
garter: garter
gas: gas
gasp: gasp,gasped,gasping
gate: gate,gates
gateway: gateway
gather: gathered,gathering
gathering: gathering
gay: gay
gayly: gayly
gaze: gaze,gazed,gazing
gen: gen
generalise: generalising
generate: generated
generation: generations
generosity: generosity
generous: generous
generously: generously
genial: genial
genius: genius
genteel: genteel
genteelly: genteelly
gentility: gentility
gentle: gentle
gentlefolk: gentlefolks
gentleman: gentleman,gentlemen
gentlemanly: gentlemanly
gentleness: gentleness
gentler: gentler
gently: gently
gentry: gentry
genuine: genuine
geographical: geographical
george: george
georgiana: georgiana
gesture: gestures
gewgaw: gewgaws
ghastly: ghastly
ghost: ghost
ghostly: ghostly
giant: giant,giants
gibbet: gibbet
giddy: giddy
gift: gift,gifts
gifted: gifted
gigantic: gigantic
gilded: gilded
gin: gin
ginger: ginger
gird: gird
girdle: girdle
girl: girl,girls
giveth: giveth
glad: glad
gladiator: gladiator
gladly: gladly
glance: glance,glanced,glances,glancing
glare: glare,glared,glaring
glaring: glaring
glasgow: glasgow
glass: glass,glasses
glasses: glasses
glastonbury: glastonbury
gleam: gleam,gleaming
glide: glided,gliding
glimpse: glimpse
glistening: glistening
glitter: glitter,glittering
gloat: gloated,gloating
globe: globe
gloom: gloom
gloomily: gloomily
gloomy: gloomy
glory: glory
gloss: gloss
gloucester: gloucester
glove: glove,gloves
glow: glow,glowing
gluttony: gluttony
gnaw: gnawed
goad: goad,goaded,goads
gobble: gobbling
goblin: goblin
god: god
godliness: godliness
godmother: godmother
godsend: godsend
gold: gold
goldsmith: goldsmith
goo: goo
goodly: goodly
goodness: goodness
goose: geese
gore: gore
gorgeous: gorgeous
gorging: gorging
gormandize: gormandizing
gothic: gothic
gouging: gouging
gout: gout
government: government
governor: governor
gown: gown
grab: grab
grace: grace,graced,graces
graceful: graceful
gracefully: gracefully
gracious: gracious
graciously: graciously
gradual: gradual
gradually: gradually
grain: grain,grains
grammar: grammar
grand: grand
granddaughter: granddaughter
grandpapa: grandpapa
grant: grant
grape: grape,grapes
grasp: grasp,grasped,grasping
grass: grass
grate: grate,grated
grateful: grateful
gratefully: gratefully
grater: grater
gratification: gratification
gratified: gratified
gratify: gratified,gratify,gratifying
gratitude: gratitude
grave: grave,graves,gravest
gravedigger: gravedigger
gravel: gravel
gravely: gravely
gravity: gravity
gravy: gravy
graze: grazed,grazing
grease: grease
greasy: greasy
greatly: greatly
greatness: greatness
greedily: greedily
greedy: greedy
greek: greek
green: green,greener,greens
greenhouse: greenhouse
greenwich: greenwich
greet: greeted
grey: grey,greyer
gridiron: gridiron
grief: grief
grieve: grieve,grieved
grievous: grievous
grim: grim
grime: grimed
grimly: grimly
grimy: grimiest,grimy
grin: grin,grinning
grind: grinding,ground
grinder: grinder
grindstone: grindstone
grip: grip
grit: grit
grizzled: grizzled
groan: groan,groaning
groaning: groaning
grocer: grocer
grog: grog
grope: groped,groping
gross: gross
grossly: grossly
ground: ground
grounds: grounds
grove: grove
grovel: grovelling
grow: grew,grow,growed,growing,grown
growl: growl,growled,growling,growls
growth: growth
grub: grubs
grubber: grubber
grudge: grudge
grudging: grudging
gruff: gruff
gruffly: gruffly
grunt: grunt
guard: guard,guarded
guardian: guardian
guards: guards
guess: guess,guessing
guest: guest,guests
guidance: guidance
guide: guide,guided,guiding
guiding: guiding
guileless: guileless
guillotine: guillotine
guilt: guilt
guiltily: guiltily
guilty: guilty
guinea: guinea,guineas
guitar: guitar
gul: gul
gulf: gulf
gull: gull
gulp: gulped,gulps
gun: gun,guns
gunwale: gunwale
gush: gush,gushed
gust: gusts
gypsy: gypsies,gypsy
ha: ha
habit: habit,habits
habitual: habitual
habitually: habitually
habituate: habituated
hackney: hackney
haggard: haggard
hah: hah
hail: hail,hailed,hailing
hair: hair
hale: hale,haled
halfpence: halfpence
halfway: halfway
hall: hall
halloa: halloa
halo: halo
halt: halt,halting
hamburg: hamburg
hamlet: hamlet
hammer: hammer,hammered,hammering,hammers
hammercloth: hammercloth
hammersmith: hammersmith
hand: hand,handed,handing,hands
handcuff: handcuffed
handcuffs: handcuffs
handed: handed
handel: handel
handful: handful
handkercher: handkercher
handkerchief: handkerchief,handkerchiefs
handle: handle,handled,handles
handsome: handsome
handsomely: handsomely
handwriting: handwriting
handy: handy
hang: hang,hanged,hanging,hung
hangman: hangman
hankering: hankerings
happen: happen,happened,happening
happily: happily
happiness: happiness
happy: happier,happy
harass: harassed
harbour: harboured
hard: hard,harder,hardest
hardbake: hardbake
harden: hardened,hardens
hardihood: hardihood
hardy: hardy
hare: hare
hark: hark
harm: harm,harming
harmonious: harmonious
harmoniously: harmoniously
harness: harnessing
harp: harp,harping
harrow: harrow,harrowed
harshly: harshly
hart: hart,harts
haste: haste
hastily: hastily
hasty: hasty
hat: hat,hats
hatband: hatband
hatch: hatched
hate: hate,hated
hatred: hatred
hatter: hatter
haughty: haughty
haul: hauled,hauling
haunt: haunted,haunting
haunted: haunted
haunting: haunting
hawker: hawker
hawser: hawsers
hay: hay
haymaker: haymaker
haymaking: haymaking
hazard: hazard,hazarded
haze: haze
head: head,headed,heads
header: headers
headforemost: headforemost
heading: heading
heal: heal
healing: healing
health: health
healthy: healthy
heap: heap,heaped,heaping,heaps
hear: hear,heard,hearing,hears
hearing: hearing
heart: heart,hearts
hearted: hearted
hearth: hearth,hearths
hearthstone: hearthstone
heartily: heartily
heartless: heartless
heartlessly: heartlessly
hearty: hearty
heat: heat
heated: heated
heath: heath
heating: heating
heave: heave
heaven: heaven,heavens
heavily: heavily
heaving: heaving
heavy: heavier,heaviest,heavy
hebrew: hebrew
hedge: hedge,hedges
heed: heed,heeding
heedful: heedful
heel: heel,heels
height: height
heighten: heightened,heightening
heir: heir
heiress: heiress
helpful: helpful
helpless: helpless
helplessly: helplessly
helplessness: helplessness
hem: hem,hemmed
hempen: hempen
henceforth: henceforth
herb: herb,herbs
herbert: herbert
hercules: hercules
hereabouts: hereabouts
hermitage: hermitage
hero: hero
hesitate: hesitate,hesitated,hesitating
hesitatingly: hesitatingly
hesitation: hesitation
hew: hewed
hey: hey
hide: hidden,hide,hiding
hideous: hideous
hiding: hiding
highly: highly
highway: highway
hill: hill,hills
hillside: hillside
hilly: hilly
hilted: hilted
hind: hind
hindrance: hindrance
hinge: hinge,hinges
hint: hint,hinted,hints
hire: hired,hiring
hiss: hissing
historically: historically
history: history
hit: hit,hitting
hitch: hitch
hoard: hoarded
hoarse: hoarse
hoarsely: hoarsely
hob: hob
hoist: hoist,hoisted
hold: held,hold,holding,holds
holden: holden
holdfast: holdfast
hole: hole,holes
holiday: holiday,holidays
hollow: hollow,hollower
holy: holy
homage: homage
homely: homely
homeward: homeward
homily: homily
honest: honest
honestly: honestly
honour: honour,honoured
honourable: honourable
honoured: honoured
hoof: hoofs
hook: hook
hooked: hooked
hoop: hoops
hoot: hoot,hooted
hope: hope,hoped,hopes,hoping
hopeful: hopeful
hopeless: hopeless
hopelessly: hopelessly
hopelessness: hopelessness
horizon: horizon
horizontal: horizontal
horizontally: horizontally
horn: horn
hornpipe: hornpipe
horrible: horrible
horribly: horribly
horror: horror,horrors
horse: horse,horses
horsehair: horsehair
horseshoe: horseshoe
hosier: hosier
hospitality: hospitality
host: host
hostility: hostility
hot: hot
hotel: hotel
hound: hound
hour: hour,hours
house: house,housed,houses
household: household
housekeeper: housekeeper
housekeeping: housekeeping
housemaid: housemaid
housewife: housewives
housing: housing
hout: hout
hover: hover,hovered,hovering
howl: howled,howling
howsomever: howsomever
hubble: hubble
hue: hue
hug: hug,hugged,hugging
hugging: hugging
hulk: hulk,hulks
hulks: hulks
hull: hulls
hum: hum
human: human
humanity: humanity
humble: humble,humbled
humbly: humbly
humbug: humbug,humbugs
humiliate: humiliated
humiliation: humiliation
humour: humour,humouring
hump: humps
hunch: hunch
hundredth: hundredth
hunger: hunger
hungry: hungry
hunk: hunk
hunt: hunt,hunted
hunter: hunter
hup: hup
hurried: hurried
hurriedly: hurriedly
hurry: hurried,hurry,hurrying
hurt: hurt,hurting,hurts
husband: husband
hush: hush,hushed
hushing: hushing
huskily: huskily
husky: husky
hut: hut
hyde: hyde
hymen: hymen
hypocrite: hypocrite
hypothesis: hypothesis
hypothetical: hypothetical
ice: ice
idea: idea,ideas
identical: identical
identification: identification
identify: identified,identify
identity: identity
idiot: idiot
idle: idle
idolize: idolized
ignominiously: ignominiously
ignorance: ignorance
ignorant: ignorant
iii: iii
illegibly: illegibly
illness: illness,illnesses
illuminate: illuminated
illusion: illusion
illustrate: illustrate
image: images
imaginary: imaginary
imagination: imagination
imagine: imagine,imagined,imagining
imbecility: imbecility
imbrue: imbrued,imbruing
imbue: imbued
imitate: imitated
imitation: imitation
immeasurably: immeasurably
immense: immense
immensely: immensely
immensity: immensity
immortal: immortal
immovable: immovable
imp: imp
impair: impair,impaired
impart: impart,imparted,imparting
impartiality: impartiality
impatience: impatience
impatient: impatient
impatiently: impatiently
impede: impede
impel: impel,impelled
impend: impended
impending: impending
impenetrably: impenetrably
imperative: imperative
imperceptible: imperceptible
imperceptibly: imperceptibly
imperfect: imperfect
imperfectly: imperfectly
imperil: imperilled
imperiously: imperiously
impertinent: impertinent
impetuosity: impetuosity
impiously: impiously
implement: implements
implicate: implicate
implication: implication
implore: implored
imploringly: imploringly
imply: implies,imply,implying
import: importing
impose: imposed,imposing
impossibility: impossibilities,impossibility
impossible: impossible
impostor: impostor
impracticable: impracticable
imprecation: imprecations
impregnable: impregnable
impress: impress,impressed,impressing
impressed: impressed
impressibility: impressibility
impression: impression,impressions
impressionable: impressionable
impressive: impressive
imprison: imprisoned
imprisonment: imprisonment,imprisonments
improbability: improbabilities
improbable: improbable
improve: improve,improved,improves,improving
improved: improved
impudence: impudence
impulse: impulse
inability: inability
inaccessibility: inaccessibility
inaction: inaction
inappropriate: inappropriate
inaptitude: inaptitude
incapable: incapable
incapacity: incapacity
incensed: incensed
inch: inch,inches
incident: incident,incidents
incidental: incidental
incidentally: incidentally
incipient: incipient
inclination: inclination,inclinations
incline: inclined,inclining
inclined: inclined
include: included,includes,including
inclusive: inclusive
incoherent: incoherent
incoherently: incoherently
income: income
incommode: incommoded
incompatibility: incompatibility
incompatible: incompatible
incompetence: incompetence
incomplete: incomplete
incomprehensible: incomprehensible
inconceivable: inconceivable
incongruity: incongruity
incongruous: incongruous
inconsistency: inconsistency
inconsistent: inconsistent
inconvenience: inconvenience
inconveniently: inconveniently
increase: increased,increasing
incredible: incredible
incredulous: incredulous
incubate: incubated
incur: incurred
incursion: incursion
indebted: indebted
indecision: indecision
indefinably: indefinably
indefinite: indefinite
indelible: indelible
indenture: indentures
independence: independence
independent: independent
independently: independently
indescribable: indescribable
india: india
indicative: indicative
indies: indies
indifference: indifference
indifferent: indifferent
indigestive: indigestive
indignant: indignant
indignantly: indignantly
indignation: indignation
indirectly: indirectly
indiscriminate: indiscriminate
indispensable: indispensable
indisputable: indisputable
indistinct: indistinct
indite: indite
individual: individual
induce: induce,induced
induced: induced
induct: inducted
indulge: indulged,indulging
indulgence: indulgence
industrious: industrious
industriously: industriously
industry: industry
ineffectually: ineffectually
inefficacy: inefficacy
inevitable: inevitable
inevitably: inevitably
inexcusably: inexcusably
inexpertly: inexpertly
inexplicable: inexplicable
inexpressible: inexpressible
inexpressibly: inexpressibly
inf: inf
infallible: infallible
infamous: infamous
infancy: infancy
infant: infant,infants
infectious: infectious
infer: infer,inferred
inference: inference
infernal: infernal
infinite: infinite
infinitely: infinitely
infirmary: infirmary
infirmity: infirmity
inflamed: inflamed
inflammatory: inflammatory
inflexible: inflexible
influence: influence,influenced,influences
influential: influential
inform: inform,informed,informing
informed: informed
informer: informer
infuse: infused
ingenious: ingenious
ingenuity: ingenuity
ingrate: ingrate
ingratitude: ingratitude
inhabitant: inhabitants
inherit: inherit
inheritance: inheritance
inhospitable: inhospitable
inhospitably: inhospitably
initial: initial
injudicious: injudicious
injunction: injunction
injure: injure,injured
injured: injured
injurious: injurious
injuriously: injuriously
injury: injuries,injury
injustice: injustice
ink: ink
inkling: inkling
inkstand: inkstand
inky: inky
inn: inn
innermost: innermost
innocence: innocence
innocent: innocent
innocently: innocently
innumerable: innumerable
inquest: inquest
inquire: inquire,inquired
inquiringly: inquiringly
inquiry: inquiries,inquiry
inquisitive: inquisitive
inquisitively: inquisitively
insane: insane
inscribe: inscribed
inscription: inscription,inscriptions
inscrutably: inscrutably
insect: insect,insects
insensible: insensible
insensibly: insensibly
inseparable: inseparable
insinuation: insinuations
insist: insist,insisted,insisting
insolent: insolent
insolently: insolently
insoluble: insoluble
insomuch: insomuch
inspect: inspected,inspecting
inspection: inspection
inspiration: inspiration
inspire: inspire,inspired
installation: installation
instance: instance,instances
instant: instant
instantly: instantly
instinctively: instinctively
institution: institution
instruct: instructed
instruction: instruction,instructions
instrument: instrument,instruments
insufficient: insufficient
insult: insulting
insulting: insulting
insupportable: insupportable
insure: insured,insuring
insurer: insurer,insurers
insurmountable: insurmountable
intellect: intellect,intellects
intellectual: intellectual
intelligence: intelligence
intelligent: intelligent
intelligible: intelligible
intend: intend,intended,intending
intensely: intensely
intensify: intensified
intensity: intensity
intent: intent
intention: intention,intentions
intentional: intentional
intently: intently
intercept: intercept
interchange: interchange,interchanged
intercourse: intercourse
interfere: interfere,interfered,interfering
interference: interference
interior: interior
interlocutor: interlocutor
intermediate: intermediate
interment: interment
interminable: interminable
intermix: intermixed
interpose: interposed,interposing
interposition: interposition
interpretation: interpretation
interrogative: interrogative
interrupt: interrupt,interrupted,interrupting
interrupted: interrupted
interruption: interruption,interruptions
intersect: intersected
interval: interval,intervals
intervene: intervened,intervening
intervention: intervention
interview: interview,interviews
intimacy: intimacy
intimate: intimate,intimated
intimation: intimation
intolerable: intolerable
intoxicating: intoxicating
intoxication: intoxication
intricacy: intricacies
intriguing: intriguing
introduce: introduce,introduced,introducing
introduction: introduction
introductory: introductory
intrude: intrude
invalid: invalid
invariably: invariably
inveigle: inveigled
invent: invent,invented
invest: invest,invested,investing
investigation: investigation,investigations
investment: investment
inveterate: inveterate
invisible: invisible
invitation: invitation
invite: invite,invited
invitingly: invitingly
involuntarily: involuntarily
involuntary: involuntary
involve: involved
involved: involved
invulnerable: invulnerable
inwardly: inwardly
irate: irate
irish: irish
iron: iron,ironed,irons
irreconcilability: irreconcilability
irregular: irregular
irrelevant: irrelevant
irrepressible: irrepressible
irresistible: irresistible
irresistibly: irresistibly
irresolute: irresolute
irrespective: irrespective
irresponsible: irresponsible
irrevocable: irrevocable
irritably: irritably
irritating: irritating
island: island
issue: issue,issued
item: item
iv: iv
ivory: ivory
ivy: ivy
ix: ix
jack: jack,jacks
jacket: jacket
jackknife: jackknife
jacks: jacks
jaggers: jaggers
jail: jail,jails
jam: jam,jammed
jane: jane
jar: jar
jargon: jargon
jaw: jaw,jaws
jealous: jealous
jealousy: jealousy
jerk: jerk,jerked,jerks
jerking: jerkings
jew: jew
jewel: jewel,jewels
jeweller: jeweller
jewelry: jewelry
jewish: jewish
jig: jig
jigger: jiggered
jingle: jingling
job: job
jocose: jocose
joe: joe
joes: joes
john: john
johns: johns
joint: joint,joints
joke: joke
jolly: jolly
jolt: jolting
jorge: jorge
jorum: jorum
joseph: joseph
jostle: jostled
journey: journey,journeys
journeyman: journeyman
joviality: joviality
jowled: jowled
joy: joy
judge: judge,judged,judging
judges: judges
judgment: judgment
judicial: judicial
judicious: judicious
jug: jug
juicy: juicy
jump: jumped
junction: junction
june: june
junior: junior
jury: jury
juryman: juryman
justice: justice,justices
justices: justices
justification: justification
justify: justified,justifying
justly: justly
juvenile: juvenile
keel: keel
keen: keen,keenest
keenly: keenly
keeper: keeper,keepers
keeping: keeping
kent: kent
kep: kep
kettle: kettle
key: key
keyhole: keyhole,keyholes
kick: kick,kicked,kicking
kid: kid
kill: kill,killed
kiln: kiln
kindle: kindled
kindly: kindly
kindness: kindness
king: king,kings
kingdom: kingdom
kingston: kingston
kiss: kiss,kissed,kissing
kit: kit
kitchen: kitchen
kite: kite
kittle: kittle
knave: knaves
knaves: knaves
knead: kneaded
knee: knee,knees
kneel: kneeling
knife: knife,knives
knight: knight,knighted
knit: knit,knitted,knitting
knitting: knitting
knob: knob
knobbed: knobbed
knobby: knobby
knock: knock,knocked,knocking
knot: knot
knotted: knotted
knoweth: knoweth
knowingly: knowingly
knowledge: knowledge
knuckle: knuckles
label: label
labour: labour,labouring,labours
labourer: labourer
labyrinth: labyrinth
lace: lace
lacerate: lacerated
lack: lacked
lad: lad
ladder: ladder,ladders
laden: laden
lady: ladies,lady
laertes: laertes
lag: lagging
lair: lair
lake: lake
lamb: lamb
lame: lame,lamed,lamer
lameness: lameness
lament: lament
lamentation: lamentation
lamp: lamp,lamps
land: land,landed,lands
landing: landing
landlord: landlord
landmark: landmarks
lane: lane,lanes
language: language,languages
languidly: languidly
languor: languor
lantern: lantern
lap: lap
lapse: lapse,lapsed,lapsing
larcenous: larcenous
larceny: larceny
lark: lark,larks
lash: lashing
lasting: lasting
lastly: lastly
latch: latch
late: late
latent: latent
latin: latin
latitude: latitude
lattice: lattice
laud: lauded
laugh: laugh,laughed,laughing
laughter: laughter
launch: launch
laundress: laundress
lave: laving
lavish: lavish,lavished
law: law,laws
lawfully: lawfully
lawyer: lawyer
lay: laid,lay,laying,lays
layer: layer
lazy: lazy
lead: lead,leading,leads,led
leaden: leaden
leaf: leaf,leaves
league: leagues
leaky: leaky
lean: lean,leaned,leaning
leap: leap,leaps
learn: learn,learned,learning,learnt
learning: learning
leastwise: leastwise
leather: leather
leave: leave,leaves,leaving,left
lecture: lecturing
lecturer: lecturer
lee: lee
leer: leer
left: left
leg: leg,legs
legacy: legacies
legal: legal
legally: legally
legged: legged
legible: legible
legitimate: legitimate
leisure: leisure
leisurely: leisurely
leith: leith
lemon: lemon
lend: lend,lending,lent
leniently: leniently
lesson: lesson,lessons
lethargic: lethargic
letter: letter,letters
level: level,levelled,levels
liable: liable
liar: liar
liberal: liberal
liberality: liberality
liberally: liberally
liberty: liberties,liberty
lick: licked,licking
lid: lid
lie: lain,lie,lies,lying
lieu: lieu
life: life,lives
lifeless: lifeless
lifer: lifer
lift: lift,lifted,lifting
lifting: lifting
light: light,lighted,lighter,lightest,lighting,lights
lighted: lighted
lighten: lightened
lighter: lighters
lighterman: lightermen
lighthouse: lighthouse
lighting: lighting
lightly: lightly
lightning: lightning
likeness: likeness,likenesses
liking: liking
limb: limb,limbs
limbed: limbed
lime: lime,limes
limehouse: limehouse
limekiln: limekiln
limit: limits
limitation: limitation
limited: limited
limp: limp,limped,limping
limping: limping
linchpin: linchpin
linen: linen
linger: linger,lingering
link: link,linked,linking
lip: lip,lips
liquid: liquid
liquidation: liquidation
liquor: liquor,liquors
liquorice: liquorice
lisp: lisped
list: list
listen: listen,listened,listening
listener: listener
listening: listening
listless: listless
literary: literary
literature: literature
lithe: lithe
litter: litter
liv: liv
live: live,lived,lives,living
lived: lived
lively: lively
liver: liver
liverpool: liverpool
livery: livery
livid: livid
living: living
lloyd: lloyd
load: load,loaded,loading
loading: loading
loaf: loaf
loathing: loathing
lobster: lobster
local: local
locality: localities
lock: lock,locked,locks
locked: locked
locking: locking
locomotively: locomotively
lodge: lodge,lodged
lodger: lodger,lodgers
lodging: lodging
lodgings: lodgings
loft: loft
lofty: loftier,lofty
logical: logical
loin: loin
loiter: loiter,loitered
loitering: loitering
loll: loll,lolled
london: london
lone: lone
loneliness: loneliness
lonely: loneliest,lonely
lonesome: lonesome
loo: loo
lookee: lookee
looker: lookers
lookout: lookout
loom: looming
loop: loop,loops
loophole: loophole
loose: loose
loosely: loosely
loosen: loosen,loosening
lor: lor
lord: lord,lords
lords: lords
lose: lose,losing,lost
loss: loss
lost: lost
lot: lot,lots
lotion: lotion
loud: loud,louder
loudly: loudly
lounge: lounging
lounger: lounger,loungers
love: love,loved,loves,loving
loveliness: loveliness
lovely: lovely
lover: lover,lovers
loving: loving
lowness: lowness
lozenge: lozenges
lucid: lucid
luck: luck
lucky: lucky
ludicrous: ludicrous
lug: lug
luggage: luggage
lull: lull
luminous: luminous
lumpish: lumpish
lunar: lunar
lunatic: lunatic
lunch: lunch,lunched,lunching
lung: lungs
lure: lured
lurker: lurker
lustily: lustily
lustre: lustre
lustrous: lustrous
luxurious: luxurious
luxury: luxury
lying: lying
lyrical: lyrical
macbeth: macbeth
machinery: machinery
mad: mad
madden: maddened
madman: madman
madness: madness
magic: magic
magisterial: magisterial
magisterially: magisterially
magistrate: magistrate,magistrates
magnanimous: magnanimous
magnate: magnates
magnificence: magnificence
magnificent: magnificent
magnificently: magnificently
magnify: magnified
magnifying: magnifying
maid: maid,maids
mail: mail
main: main
maintain: maintained,maintaining
maintenance: maintenance
majestic: majestic
majesty: majesty
majority: majority
maker: maker,makers
makeshift: makeshift
male: male
malefactor: malefactors
malevolent: malevolent
malice: malice
malicious: malicious
malignant: malignant
malignity: malignity
malt: malt
mamma: mamma
manacle: manacle,manacled
manacled: manacled
manage: manage,managed
management: management
manager: manager
mane: mane
mangle: mangle
mangy: mangy
manhood: manhood
mania: mania
manifest: manifest,manifested
mankind: mankind
manly: manly
manner: manner
manners: manners
manor: manor
mansion: mansions
manslaughter: manslaughter
mantel: mantel
manufacture: manufacture
manuscript: manuscript
map: maps
march: march
mare: mare
margin: margin,margins
marine: marine
mark: mark,marked,marks
marked: marked
market: market,markets
marriage: marriage,marriages
married: married
marrow: marrow
marry: married,marry,marrying
marseilles: marseilles
marsh: marsh,marshes
marvel: marvels
mary: mary
mask: mask
massive: massive
mast: mast
master: master,mastered,mastering,masters
mastery: mastery
mat: mat,mats
match: match
material: material,materials
matrimonially: matrimonially
matronly: matronly
matter: matter,matters
matthew: matthew
mattress: mattress
maudlin: maudlin
maul: mauled
mayor: mayor
maze: mazes
meal: meal
meaning: meaning
meanness: meanness,meannesses
meant: meant
measles: measles
measure: measure,measured,measures
meat: meat
mechanical: mechanical
mechanically: mechanically
medical: medical
medicine: medicine
meditate: meditating
meditation: meditation,meditations
meditative: meditative
meditatively: meditatively
medium: medium
meek: meek
meekly: meekly
meet: meet,meeting,met
meeting: meeting,meetings
melancholy: melancholy
melia: melia
meller: meller
melodious: melodious
melon: melon
melt: melt,melted,melting
memorable: memorable
memorandum: memorandum
memorialise: memorialise
memory: memory
menace: menace
mend: mend,mended,mending
mending: mending
mental: mental
mentally: mentally
mention: mention,mentioned,mentioning
mentor: mentor
mercenary: mercenaries,mercenary
merchant: merchant,merchants
merciful: merciful
mercilessly: mercilessly
mercy: mercy
mere: mere
merit: merit,merited,merits
meritorious: meritorious
mesh: meshes
message: message,messages
messenger: messenger,messengers
metal: metal
metaphysics: metaphysics
method: method
methodical: methodical
metropolis: metropolis
metropolitan: metropolitan
mi: mi
midday: midday
middle: middle
midnight: midnight
midst: midst
midsummer: midsummer
midway: midway
mightily: mightily
mighty: mighty
mike: mike
mild: mild,mildest
mildew: mildewed
mile: mile,miles
military: military
milk: milk
miller: millers
millers: millers
mince: mince
mincemeat: mincemeat
mind: mind,minding,minds
minded: minded
mindful: mindful
mingle: mingled
miniature: miniature
mining: mining
minister: minister
minor: minor
mint: mints
minute: minute,minutes
minutely: minutely
miracle: miracle
mire: mire
mirror: mirror
mischief: mischief
mischievous: mischievous
mischievously: mischievously
miscreant: miscreant
misdeal: misdealt
misdeed: misdeed
misdemeanor: misdemeanor
miserable: miserable
miserably: miserably
miserly: miserly
misery: miseries,misery
misfortune: misfortunes
misgiving: misgiving
misjudge: misjudge
mislay: mislaid
mislead: misled
misplace: misplaced
misremember: misremembered
misrepresent: misrepresent
misrepresentation: misrepresentations
misshapen: misshapen
missile: missile
missionary: missionary
missis: missis
mist: mist,mists
mistake: mistake,mistaken,mistakes,mistaking
mistaken: mistaken
mistress: mistress
mistrust: mistrust,mistrusted
misty: misty
mite: mite
mitre: mitre
mix: mix,mixed,mixing
mixed: mixed
mixture: mixture
moan: moaned,moaning
moat: moat
model: model
moderate: moderate
moderately: moderately
moderation: moderation
modest: modest
modestly: modestly
modify: modified
moist: moist
moisten: moistened
molestation: molestation
mollify: mollified
molly: molly
moment: moment,moments
momentary: momentary
momentous: momentous
monday: monday
money: money
monk: monks
monkey: monkey
monomania: monomania
monopoly: monopoly
monosyllable: monosyllable
monotonous: monotonous
monster: monster,monsters
monstrosity: monstrosity
monstrous: monstrous
month: month,months
monumental: monumental
mood: mood,moods
moodily: moodily
moody: moody
moon: moon,mooning
moonlight: moonlight
moor: moored
mooring: moorings
mop: mop
moral: moral
morality: morality
moralize: moralizing
morally: morally
morbidly: morbidly
morning: morning
morose: morose
morrow: morrow
morsel: morsel
mortal: mortal
mortality: mortality
mortally: mortally
mortar: mortar
mortification: mortification
mortified: mortified
mortifying: mortifying
moses: moses
moth: moth,moths
mother: mother
motherly: motherly
motion: motion,motioned,motioning
motionless: motionless
motive: motives
mottled: mottled
mould: mould,moulding
mouldering: mouldering
mound: mound,mounds
mount: mount,mounted,mounting
mountain: mountain,mountains
mountainous: mountainous
mourner: mourner
mournful: mournful
mournfully: mournfully
mournfulness: mournfulness
mourning: mourning
mouse: mice,mouse
mouth: mouth,mouths
mouthful: mouthful
movement: movement,movements
mud: mud
mudbank: mudbank
muddy: muddy
muffin: muffin,muffins
multiply: multiplied
multitude: multitude
mum: mum
mumbling: mumbling
mummery: mummery
munch: munching
murder: murder,murdered,murdering
murderer: murderer,murderers
murderous: murderous
murky: murky
murmur: murmur,murmured,murmuring
murmuring: murmuring
muscle: muscles
muscular: muscular
muse: mused
museum: museum
music: music
musical: musical
musing: musing
musket: musket,muskets
muslin: muslin
muster: mustered
musty: musty
mute: mute
mutiny: mutiny
mutter: mutter,muttered,muttering
mutton: mutton
mutual: mutual
muzzle: muzzle,muzzled
myrmidon: myrmidons
mysterious: mysterious
mystery: mysteries,mystery
nail: nail,nails
nameless: nameless
nap: nap
nape: nape
napkin: napkin
narrate: narrate
narrative: narrative
narrow: narrow
nastiness: nastiness
nasty: nasty
nation: nation
national: national
native: native
natural: natural
naturally: naturally
nature: nature
natured: natured
naught: naught
naughty: naughty
navigation: navigation
nearer: nearer
neat: neat
neatly: neatly
neatness: neatness
necessaries: necessaries
necessitate: necessitate
necessity: necessity
neck: neck
neckcloth: neckcloth
neckerchief: neckerchief
necromantic: necromantic
needle: needle,needles
needless: needless
needlework: needlework
negative: negative,negativing
neglect: neglected
negotiation: negotiation
negress: negress
negro: negro
neighbour: neighbour,neighbouring,neighbours
neighbourhood: neighbourhood
nephew: nephews
nerve: nerves
nervous: nervous
nervously: nervously
nest: nest,nesting
nettle: nettles
newgate: newgate
newly: newly
news: news
newspaper: newspaper,newspapers
nice: nice,nicest
nicety: nicety
nick: nick
niece: niece
niggardly: niggardly
nigh: nigh
nigher: nigher
night: night,nights
nightcap: nightcap
nightly: nightly
nightmare: nightmare
nights: nights
nile: nile
nimble: nimble
noah: noah
nob: nob
nobility: nobility
noble: noble,nobler,nobles
nocturnal: nocturnal
nod: nod,nodded,nodding
noise: noise,noises
noisily: noisily
noisy: noisy
nominal: nominal
nonsense: nonsense
nonsensical: nonsensical
noodle: noodle,noodles
nook: nook,nooks
noon: noon
noose: noose
nore: nore
normal: normal
north: north
nose: nose,noses
nosegay: nosegays
nostril: nostril,nostrils
note: note,notes
notice: notice,noticed,notices,noticing
noticeable: noticeable
noticeably: noticeably
notify: notify
notion: notion,notions
notoriously: notoriously
nourishment: nourishment
novelty: novelty
november: november
nowt: nowt
numb: numbed
numerous: numerous
nurse: nurse,nursed,nurses,nursing
nurture: nurture
nut: nut,nuts
nutmeg: nutmeg
nutshell: nutshells
oar: oar,oared,oars
oarsman: oarsmen
oath: oath,oaths
obdurate: obdurate
obedience: obedience
obey: obey
object: object,objected,objecting,objects
objection: objection,objections
objectionable: objectionable
obligate: obligated
obligation: obligation,obligations
oblige: oblige,obliged,obliging
obliged: obliged
obnoxious: obnoxious
obscure: obscure
obscurely: obscurely
obsequious: obsequious
observance: observance,observances
observant: observant
observation: observation
observatory: observatory
observe: observe,observed,observing
obstacle: obstacles
obstinacy: obstinacy
obstinate: obstinate
obstinately: obstinately
obstruction: obstruction,obstructions
obtrude: obtruded
obtruded: obtruded
obtrusive: obtrusive
obtuseness: obtuseness
obvious: obvious
occasion: occasion,occasioned,occasions
occasional: occasional
occasionally: occasionally
occupant: occupants
occupation: occupation
occupy: occupied,occupy,occupying
occur: occurred,occurs
occurrence: occurrence
octagonal: octagonal
odd: odd
oddly: oddly
odds: odds
ode: ode
odious: odious
offence: offence,offences
offend: offended
offended: offended
offender: offender
offensive: offensive
offer: offer,offered,offering
office: office,offices
officer: officer,officers
official: official
officiating: officiating
offshoot: offshoot
oftener: oftener
ogre: ogre
oil: oiled
olive: olive
ominously: ominously
omit: omit,omitting
omnipotent: omnipotent
ooze: ooze
ope: ope
opener: opener
openly: openly
opera: operas
operate: operate
ophelia: ophelia
ophthalmic: ophthalmic
opinion: opinion,opinions
opportune: opportune
opportunity: opportunities,opportunity
oppose: opposed
opposed: opposed
opposition: opposition
oppress: oppressed
oppressed: oppressed
oppressive: oppressive
oracle: oracle
orange: orange,oranges
oration: oration
orchard: orchard
orchestra: orchestra
orderly: orderly
ordinary: ordinary
ordnance: ordnance
organ: organ
original: original
originally: originally
originate: originate,originated,originating
ornament: ornamented,ornaments
ornamental: ornamental
orphan: orphan,orphans
orthographical: orthographical
os: os
ostentatious: ostentatious
ostentatiously: ostentatiously
ostler: ostler
ostrich: ostriches
ounce: ounce,ounces
outbreak: outbreak
outburst: outburst
outdo: outdone
outer: outer
outfit: outfit
outlaw: outlaw
outline: outline
outlive: outlived
outrage: outrage
outraged: outraged
outrageous: outrageous
outright: outright
outrun: outrunning
outshine: outshone
outspread: outspread
outward: outward
outwatch: outwatched
overboard: overboard
overcome: overcame,overcome,overcoming
overdo: overdo,overdoing
overflow: overflowed,overflowing
overgrown: overgrown
overhang: overhanging,overhung
overhead: overhead
overhear: overhear,overheard,overhearing
overjoyed: overjoyed
overlie: overlying
overlook: overlook,overlooking
overmatch: overmatched
overmuch: overmuch
overnight: overnight
overpower: overpowered
overrate: overrated
overshadow: overshadowing
overshoot: overshooting
overspread: overspreading
overstate: overstate
overtake: overtaken,overtaking,overtook
owe: owe,owed
owner: owner
ox: ox
oyster: oyster,oysters
pace: pace,paces
pacific: pacific
pacing: pacing
pack: pack,packed,packing
package: packages
packet: packet,packets
packing: packing
paddle: paddles
pageant: pageant
pail: pail
pain: pain,pains
pained: pained
painful: painful
painfully: painfully
paint: painted,painting
painting: painting
pair: pair
pal: pals
pale: pale
paleness: paleness
pall: pall
pallor: pallor
palm: palm
pamper: pampered
pan: pan
pane: pane
panel: panels
panelled: panelled
pannikin: pannikins
pant: panted
panting: panting
pantomime: pantomime
pantry: pantry
papa: papa
paper: paper,papers
parade: paraded
paragraph: paragraph
paralytic: paralytic
parcel: parcel
pardner: pardner,pardners
pardon: pardon
parent: parent,parents
parentage: parentage
parental: parental
parenthesis: parenthesis
parenthetical: parenthetical
paris: paris
parish: parish
park: park
parks: parks
parley: parley
parliament: parliament
parliamentary: parliamentary
parlour: parlour
paroxysm: paroxysm
parrot: parrots
parsley: parsley
partake: partake,partaken,partook
partial: partial
partially: partially
participate: participate
participation: participation
particle: particle
particulars: particulars
partly: partly
partner: partner,partners
partnership: partnership
partook: partook
party: parties,party
pass: pass,passed,passing
passage: passage,passages
passenger: passenger,passengers
passing: passing
passion: passion,passions
passionate: passionate
passionately: passionately
passions: passions
passive: passive
passport: passports
pastry: pastry
pastureless: pastureless
pat: pat,patted
patch: patches
patchwork: patchwork
patent: patented
path: path,paths
pathetic: pathetic
pathetically: pathetically
pathway: pathway
patience: patience
patient: patient
patriotic: patriotic
patron: patron
patronage: patronage
patroness: patroness
patronise: patronise,patronised
patronizing: patronizing
patten: pattens
pattern: pattern
paul: paul
pauper: paupers
pause: pause,paused,pausing
paved: paved
pavement: pavement
pay: paid,pay,paying,pays
payment: payments
pea: pea,peas
peace: peace
peaceable: peaceable
peaceful: peaceful
peach: peach
peal: peal,peals
pebble: pebbles
peck: peck
peculiar: peculiar
peculiarity: peculiarity
peculiarly: peculiarly
peddle: peddles
peel: peel
peep: peep,peeped,peeping
peer: peer,peering
peerless: peerless
peg: peg,pegging,pegs
pelt: pelted
pen: pen,penned,pens
penalty: penalties,penalty
penance: penance
pence: pence
pencil: pencil
penitence: penitence
penitent: penitent
penitential: penitential,penitentials
penitentially: penitentially
penitently: penitently
penknife: penknife
penny: pence,penny
pepper: pepper
peppercorny: peppercorny
perceive: perceive,perceived,perceives,perceiving
perceptibly: perceptibly
perception: perception
perch: perch
perfect: perfect,perfected
perfection: perfection
perfectly: perfectly
perforated: perforated
perform: perform,performed,performing
performance: performance,performances
perfumer: perfumer
peril: peril
period: period
periodical: periodical
perish: perished,perishing
perishing: perishing
permission: permission
pernicious: pernicious
perpendicular: perpendicular
perpetual: perpetual
perpetually: perpetually
perplex: perplex
perplexed: perplexed
perplexing: perplexing
perplexity: perplexities,perplexity
perseverance: perseverance
persevere: persevered
persist: persisted,persists
persistent: persistent
person: people,person,persons
personage: personage
personal: personal
personally: personally
perspective: perspective
perspicuity: perspicuity
perspiration: perspiration
persuade: persuade,persuaded
persuasive: persuasive
persuasively: persuasively
perusal: perusal
peruse: perused
pervade: pervade,pervaded,pervading
perversion: perversion
pester: pester
petition: petition,petitions
pettishly: pettishly
pew: pew,pews
phantom: phantom
phase: phases
phenomenon: phenomenon
philip: philip
philosophical: philosophical
philosophy: philosophy
phosphoric: phosphoric
photograph: photographs
phrase: phrase
physic: physic
physical: physical
physically: physically
physiognomy: physiognomy
pi: pi
piano: piano
pick: pick,picked,picking
pickle: pickled,pickles
picnic: picnics
picture: picture,pictures
picturesque: picturesque
pie: pie
piece: piece,pieced,pieces,piecing
pieman: pieman
pig: pig,pigs
pigeon: pigeon,pigeons
pigtail: pigtail
pile: pile,piled,piles
pilfer: pilfering
pilgrim: pilgrim
pilgrimage: pilgrimage
pill: pill,pills
pillar: pillar
pillow: pillow
pilot: pilot
pimple: pimples
pin: pin,pins
pinch: pinch,pinching
pincushion: pincushions
pink: pink
pint: pint
pious: pious
pip: pip
pipe: pipe,piped,pipes
pips: pips
pirate: pirate
pistol: pistol,pistols
pit: pit
pitch: pitch,pitched,pitching
pitcher: pitcher
pitchy: pitchy
pitfall: pitfall
pity: pitied,pity,pitying
pitying: pitying
placable: placable
placid: placid
placidly: placidly
plain: plain,plainer
plainly: plainly
plaintively: plaintively
plait: plaited
plaited: plaited
plan: plan,planned,planning,plans
plank: plank
plant: plant,planted,plants
plaster: plaster
plate: plate,plates
play: play,played,playing,plays
playacting: playacting
player: player
playfellow: playfellow
playful: playful
playfully: playfully
plea: plea
plead: pleaded
pleasant: pleasant,pleasanter
pleasantly: pleasantly
pleasantry: pleasantry
pleased: pleased
pleasure: pleasure,pleasures
plebeian: plebeian
pledge: pledge,pledged
plenipotentiary: plenipotentiary
plenty: plenty
plight: plight
plot: plots
plotter: plotters
pluck: plucked,plucking
plum: plum
plumber: plumber
plumed: plumed
plummet: plummet
plump: plump
plunge: plunge,plunged,plunging
ply: plied,plying
poacher: poacher
pocket: pocket,pockets
poet: poet
poetic: poetic
poetry: poetry
pointedly: pointedly
poise: poising
poison: poison
poisonous: poisonous
poke: poke,poked,poking
poker: poker
pole: pole
police: police
policeman: policeman
policy: policy
polish: polished
polished: polished
polite: polite
politely: politely
politeness: politeness
political: political
pollard: pollards
pompously: pompously
pon: pon
pond: pond
ponder: pondered,pondering
ponderous: ponderous
poodle: poodles
pooh: pooh
pool: pool,pools
poor: poor,poorer
populace: populace
popular: popular
popularity: popularity
popularly: popularly
population: population
porcelain: porcelain
porch: porch
pore: poring
pork: pork
port: port
portable: portable
portal: portal
portentous: portentous
porter: porter
portly: portly
portmanteau: portmanteau
portrait: portraits
position: position,positions
positive: positive
positively: positively
possess: possess,possessed,possessing
possessed: possessed
possession: possession,possessions
possessor: possessor
possibility: possibility
post: post,posted,posting,posts
postboy: postboy
postern: postern
posting: posting
postponement: postponement
posture: posturing
pot: pot
potato: potatoes
potent: potent
potman: potman
pottle: pottle
pouch: pouch
poultice: poultice
poultry: poultry
pounce: pounce,pounced
pound: pound,pounded,pounding,pounds
pour: poured,pouring
poverty: poverty
powder: powder
powdered: powdered
power: power,powers
powerful: powerful
powerfully: powerfully
powerless: powerless
practicable: practicable
practical: practical
practically: practically
practice: practice
practise: practise,practised
practised: practised
practitioner: practitioner
praise: praise,praised,praises,praising
prance: prancing
pray: pray,prayed,prays
prayer: prayer,prayers
precaution: precaution,precautions
precede: preceded,preceding
precedence: precedence
precious: precious
precise: precise
precisely: precisely
precision: precision
predatory: predatory
predecessor: predecessors
prediction: prediction
predominant: predominant
preface: preface
prefer: prefer,preferred,preferring
preference: preference
preferment: preferment
prejudice: prejudice
preliminary: preliminaries,preliminary
premature: premature
prematurely: prematurely
premise: premises
premium: premium
prentice: prentice,prentices
preoccupied: preoccupied
preparation: preparation,preparations
preparatory: preparatory
prepare: prepare,prepared,preparing
prepared: prepared
prepossession: prepossessions
preposterous: preposterous
prescribe: prescribing
presence: presence
presentable: presentable
presentiment: presentiment
presently: presently
preservation: preservation
preserve: preserved,preserving
preside: presided,presiding
press: press,pressed,pressing
pressing: pressing
pressure: pressure,pressures
presume: presumed,presuming
pretence: pretence,pretences
pretend: pretend,pretended,pretending
pretender: pretender
pretext: pretext
prettily: prettily
pretty: prettier,pretty
prevail: prevailing
prevent: prevent,prevented
previous: previous
prey: prey,preyed
price: price,prices
pride: pride
prime: prime
primeval: primeval
prince: prince
princely: princely
princess: princess
principal: principal,principals
principally: principally
principle: principle
print: print,printed
priory: priory
prison: prison,prisons
prisoner: prisoner,prisoners
private: private
privately: privately
privilege: privilege
prize: prize
probable: probable
probe: probe
proceed: proceed,proceeded,proceeding
proceeding: proceeding
proceedings: proceedings
process: process
procession: procession
procrastinate: procrastinating
prodigal: prodigal
prodigious: prodigious
prodigiously: prodigiously
produce: produce,produced,producing
producible: producible
production: production
profess: professed
profession: profession
professional: professional
professionally: professionally
proffer: proffered
proficiency: proficiency
profile: profile
profit: profit,profited,profiting,profits
profitable: profitable
profound: profound
progress: progress,progressing
prohibit: prohibited
prohibition: prohibition
project: project,projects
prolix: prolix
prolong: prolonged,prolonging
prolonged: prolonged
prominent: prominent
promise: promise,promised
promising: promising
promote: promoted
promotion: promotion
prompt: prompt
prone: prone
pronounce: pronounced
proof: proof
prop: propped
propensity: propensities
proper: proper
property: property
prophesy: prophesy
propitiate: propitiate
propitiation: propitiation
proportion: proportion,proportioned,proportions
proposal: proposal,proposals
propose: propose,proposed,proposing
proposition: proposition
propound: propound
proprietor: proprietor
proprietorship: proprietorship
propriety: proprieties
proscribe: proscribed
prose: prose
prosecute: prosecuted
prosecution: prosecution
prospect: prospect
prospects: prospects
prosper: prospered,prospering
prosperity: prosperity
prosperous: prosperous
prosperously: prosperously
prostrate: prostrated
protect: protected,protecting
protection: protection
protest: protest,protested,protesting
prove: prove,proved,proving
proverb: proverb
provide: providing
providence: providence
providentially: providentially
province: provinces
provincial: provincial
provision: provisions
provoke: provoked
provoking: provoking
prowl: prowl,prowling
prudent: prudent
pry: pry
psalm: psalm
psychological: psychological
public: public
publican: publican
publicly: publicly
pudding: pudding
puff: puffed
puffy: puffy
pugilistic: pugilistic
pull: pull,pulled,pulling,pulls
pummel: pummel
pump: pump,pumps
punch: punch
punctual: punctual
punctuality: punctuality
pungent: pungent
punish: punished
punishment: punishment,punishments
pupil: pupil,pupils
puppet: puppets
puppy: puppy
purblind: purblind
purchase: purchase,purchased,purchases,purchasing
pure: pure
purify: purified
purple: purple
purpose: purpose,purposes,purposing
purposely: purposely
purposing: purposing
purse: purse
purser: purser
pursuance: pursuance
pursuant: pursuant
pursue: pursue,pursued,pursuing
pursuer: pursuers
pursuit: pursuit,pursuits
push: pushed,pushing
puzzle: puzzled
puzzled: puzzled
quail: quailed
qualified: qualified
quality: qualities,quality
quantity: quantity
quantum: quantum
quarrel: quarrel,quarrelled
quarry: quarries,quarry
quarter: quarter
quarterly: quarterly
queen: queen
queens: queens
queer: queer
queerest: queerest
quell: quell
querulous: querulous
quest: quest
question: question,questioned,questioning,questions
questionable: questionable
questioner: questioner
quick: quick,quicker
quicken: quickened
quickness: quickness
quiet: quiet,quieted,quieter
quietly: quietly
quietness: quietness
quintin: quintin
quit: quit,quitted
quiver: quivering
rabbit: rabbits
race: race,races
radiant: radiant
rafter: rafters
rag: rag,rags
rage: rage,rages
ragged: ragged
rail: rail,rails
rain: rain,rains
rainy: rainy
raise: raise,raised,raising
raising: raising
rake: raked,rakes,raking
rakish: rakish
rally: rallied,rallying
ram: ram
rampage: rampage,rampages
range: range,ranged,ranges
rank: rank
rankle: rankled
rantipole: rantipole
rap: rap
rapid: rapid
rapidity: rapidity
rapture: rapture
rapturously: rapturously
rare: rare
rarely: rarely
rascal: rascal
rash: rash
rasp: rasped,rasping
rat: rat
rate: rate
rater: rater
rattle: rattle,rattled,rattling
ravage: ravaging
rave: raved
ravel: ravel
ravenous: ravenous
ravenously: ravenously
raw: raw
rawness: rawness
ray: rays
raymond: raymond
razor: razor
reach: reach,reached,reaches,reaching
reaction: reaction
read: read,reading
reader: reader,readers
readier: readier
readiness: readiness
reading: reading
ready: readiest,ready
real: real
realisation: realisation
realise: realise,realised
reality: realities,reality
reap: reaping
reappear: reappear,reappeared,reappearing
reappearance: reappearance
rear: rear,reared
reargue: reargued
reason: reason,reasoned,reasons
reasonable: reasonable
reasoning: reasoning
reassurance: reassurance
reassure: reassuring
reassuring: reassuring
reawaken: reawakening
rebel: rebel
rebellious: rebellious
rebuff: rebuff
recall: recall,recalled,recalling
receipt: receipt
receive: receive,received,receiving
reception: reception
recess: recess
reciprocate: reciprocated
recital: recital,recitals
recite: recited
reckless: reckless
reckon: reckon,reckoning
recline: reclined
recluse: recluses
recognisable: recognisable
recognise: recognise,recognised,recognising
recognition: recognition
recoil: recoiled,recoiling
recollect: recollect,recollecting
recollection: recollection
recommend: recommend,recommended,recommending
recommendation: recommendation
recompense: recompense
reconcilable: reconcilable
reconnoitre: reconnoitre
reconsider: reconsider,reconsidered
record: record,recorded,records
recorder: recorder,recorders
recount: recount,recounted,recounting
recover: recover,recovered
recovery: recovery
recruit: recruiting
recur: recurring
red: red
redden: reddened
redeem: redeem
redeeming: redeeming
redness: redness
reduce: reduced
reed: reeds
reek: reek
reel: reeled
refectory: refectories
refer: refer,referred,referring
referable: referable
reference: reference,references
refined: refined
reflect: reflect,reflected,reflecting
reflection: reflection,reflections
reflectively: reflectively
reformatory: reformatory
refractory: refractory
refrain: refrain,refrained,refraining
refresh: refresh,refreshed
refreshment: refreshment,refreshments
refurbish: refurbished
refuse: refuse,refused,refusing
regale: regaled
regard: regard,regarded
region: region
regret: regret,regrets,regretted
regular: regular
regularly: regularly
regulate: regulated
rehearsal: rehearsal
reign: reign
reiterate: reiterate,reiterated
reject: rejecting
rejoice: rejoiced
rejoin: rejoined
rekindle: rekindling
relapse: relapsed
relate: relate
relation: relation,relations
relationship: relationships
relative: relative,relatives
relax: relax
release: release,released,releasing
reliable: reliable
reliance: reliance
relic: relics
relief: relief
relieve: relieve,relieved
relieved: relieved
religion: religion
religious: religious
religiously: religiously
relinquish: relinquish,relinquished,relinquishing
relish: relish,relishing
reluctance: reluctance
reluctant: reluctant
reluctantly: reluctantly
rely: relied,rely
remain: remain,remained,remaining,remains
remains: remains
remark: remark,remarked,remarking,remarks
remarkable: remarkable
remarkably: remarkably
remarking: remarking
remedy: remedy
remember: remember,remembered,remembering
remembered: remembered
remembrance: remembrance,remembrances
remind: remind,reminded,reminding,reminds
remissness: remissness
remonstrance: remonstrance,remonstrances
remonstrate: remonstrate,remonstrated
remorse: remorse
remorseful: remorseful
remote: remote,remoter
remotely: remotely
remove: remove,removed,removing
remunerate: remunerate
remunerative: remunerative
render: render,rendered,rendering,renders
rendering: rendering
renew: renew,renewed
renounce: renounce
renown: renown
renowned: renowned
rent: rent,rented
reopen: reopened
repair: repair,repaired,repairing
reparation: reparation
repass: repassed
repay: repaid,repay,repaying
repeat: repeat,repeated,repeating
repeatedly: repeatedly
repeater: repeater
repel: repelled
repent: repent,repented
repentance: repentance
repentant: repentant
repetition: repetition
replace: replace,replaced
replenish: replenish
reply: replied,reply,replying
report: report,reported,reports
repose: repose,reposed,reposing
represent: represent,represented,representing
representation: representation,representations
representative: representative
repress: repress,repressed,repressing
reproach: reproach,reproached,reproaches
reproachful: reproachful
reproachfully: reproachfully
republic: republic
repudiate: repudiate,repudiated
repugnance: repugnance
repulse: repulse,repulsed
repulsion: repulsion
repulsive: repulsive
reputably: reputably
reputation: reputation
repute: reputed
request: request,requested,requesting
require: required,requires,requiring
requirement: requirement,requirements
requisite: requisite
requited: requited
rescue: rescue,rescued,rescues
resemblance: resemblance
resent: resent,resented,resenting
resentful: resentful
resentment: resentment
reservation: reservation,reservations
reserve: reserve
reside: residing
residence: residence,residences
resign: resigned
resignation: resignation
resist: resisted
resistance: resistance
resolute: resolute
resolution: resolution,resolutions
resolve: resolve,resolved
resort: resort,resorting
resound: resounded
resource: resource,resources
respect: respect,respected,respecting
respectable: respectable
respected: respected
respectful: respectful
respectfully: respectfully
respects: respects
respond: respond,responded,responding
respondent: respondent
response: response
responsibility: responsibilities,responsibility
responsible: responsible
responsive: responsive
rest: rest,rested,resting
resting: resting
restless: restless
restlessly: restlessly
restlessness: restlessness
restorative: restorative
restore: restore,restored,restoring
restrain: restrain,restrained,restraining
restraining: restraining
restraint: restraint
result: result
resume: resume,resumed,resuming
retain: retain,retained
retake: retaken
retaliation: retaliations
reticence: reticence
reticent: reticent
retire: retired,retiring
retirement: retirement
retort: retort,retorted
retrace: retrace
retreat: retreat
retributive: retributive
retrospectively: retrospectively
return: return,returned,returning,returns
reveal: reveal
revelation: revelation
revenge: revenge
revengeful: revengeful
revengefully: revengefully
reverberate: reverberating
reverence: reverence
reverse: reverse,reversed
revert: revert,reverted,reverting
review: reviewed,reviewing
revisit: revisit
revival: revival
revive: revive,revived,reviving
revolve: revolving
reward: reward,rewarded
rhapsody: rhapsody
rheumatic: rheumatic
rib: ribs
ribbon: ribbon
rich: rich
richard: richard
richly: richly
richmond: richmond
rick: rick,ricks
rid: rid
riddance: riddance
riddle: riddles
ride: ride,rode
ridgy: ridgy
ridiculous: ridiculous
rifle: rifle
rigging: rigging
righteous: righteous
rigidity: rigidity
rigidly: rigidly
rim: rim,rims
rimy: rimy
rind: rind
rinse: rinse
riotous: riotous
ripple: ripple,rippling
rise: rise,risen,rising,rose
risk: risk,risked
river: river
rivet: riveted
road: road
roadway: roadway
roam: roam
roar: roar,roared,roaring,roars
roaring: roaring
roast: roast,roasting
roasted: roasted
rob: rob,robbed
robber: robber,robbers
robbery: robbery
robe: robe,robes
robin: robin
rock: rock,rocked
rocking: rocking
rod: rod
roger: roger
rogue: rogue,rogues
roll: roll,rolled,rolling,rolls
roller: roller
roman: roman,romans
romance: romance
romantic: romantic
roof: roof,roofs
roofless: roofless
rook: rooks
root: root,rooted
rope: rope
roscian: roscian
rose: rose
rot: rot,rots,rotted,rotting
rotatory: rotatory
rotten: rotten
rottenness: rottenness
rotterdam: rotterdam
rouge: rouge
rough: rough
roughen: roughened
roughly: roughly
roundabout: roundabout
rounded: rounded
rouse: rouse,roused
routine: routine
rove: rove
row: row,rowed,rows
rower: rowers
rowing: rowing
royal: royal
rub: rub,rubbed,rubbing
rubbish: rubbish
rubicund: rubicund
ruby: rubies
rudder: rudder
rude: rude
rudiment: rudiments
rueful: rueful
ruffle: ruffled,ruffles
rug: rug
ruin: ruin,ruined
rule: rule,rules
ruler: ruler
rum: rum
rumination: rumination
rumple: rumple
rumpled: rumpled
rums: rums
runaway: runaway,runaways
running: running
rush: rush,rushed,rushes,rushing
rushlight: rushlight
rustic: rustic
rustily: rustily
rustle: rustle,rustled
rusty: rusty
sable: sable,sables
sack: sack
sackcloth: sackcloth
sacred: sacred
sacrifice: sacrifice
sad: sad,sadder
sadden: saddened
saddle: saddle
saddler: saddler
sadly: sadly
sadness: sadness
safe: safe,safer,safest
safely: safely
safety: safety
sagacious: sagacious
sagaciously: sagaciously
sage: sage
sail: sail,sailed,sailing,sails
sailing: sailing
sailor: sailor,sailors
saint: saint
sake: sake
sal: sal
salad: salad
salary: salary
sale: sale
sally: sally
saloon: saloon
salt: salt
saltcellar: saltcellar
salutation: salutation
salute: salute,saluted
sample: sample
sanctify: sanctified
sand: sand
sandwich: sandwich,sandwiches
sandy: sandy
sanguinary: sanguinary
sanguine: sanguine
sap: sap
sarah: sarah
sarcastic: sarcastic
sarcastically: sarcastically
satin: satins
satis: satis
satisfaction: satisfaction
satisfied: satisfied
satisfy: satisfied,satisfy
saturday: saturday
saturdays: saturdays
sauce: sauce,sauces
saucepan: saucepan
saucer: saucers
saunter: sauntered
sausage: sausage
savage: savage
savagely: savagely
save: save,saved,saving
savings: savings
savory: savory
sawdust: sawdust
sawdusty: sawdusty
sawpit: sawpit
scabbard: scabbard
scaffold: scaffold
scale: scale
scaly: scaly
scandalise: scandalised
scant: scant
scar: scarred
scarcely: scarcely
scare: scared
scarecrow: scarecrow
scared: scared
scarf: scarf
scarlet: scarlet
scarred: scarred
scatter: scatter,scattered,scattering
scattered: scattered
scene: scene,scenes
scent: scent,scented,scents
scented: scented
scheme: scheme
scheming: scheming
scholar: scholar,scholars
school: school,schools
schoolboy: schoolboy
schoolfellow: schoolfellows
schoolhouse: schoolhouse
schooling: schooling
scold: scold
sconce: sconces
scoop: scooped
scorch: scorched
score: score,scores
scorn: scorning
scornful: scornful
scornfully: scornfully
scoundrel: scoundrel,scoundrels
scourge: scourge
scowl: scowling
scramble: scrambled
scrap: scrap
scrape: scrape,scraped
scratch: scratched,scratches,scratching
scream: scream,screamed,screams
screen: screen,screened
screw: screw,screwed,screwing,screws
scrubbing: scrubbing
scrutiny: scrutiny
scuffle: scuffle
sculler: scullers
scum: scum
scuttle: scuttle
sea: sea
seafaring: seafaring
seal: seal,sealed,seals
seaman: seaman
seaport: seaport
sear: seared
search: search,searched,searching
season: season,seasons
seat: seat,seated,seats
seated: seated
sech: sech
secluded: secluded
seclusion: seclusion
secrecy: secrecy
secret: secret,secrets
secretary: secretary
secretly: secretly
secure: secure,secured,securing
security: security
sedan: sedan
sedative: sedative
seed: seed,seeds
seedsman: seedsman
seek: seek,seeking,sought
seize: seize,seized,seizing
seldom: seldom
select: select,selected,selecting
selection: selection
sell: sell,sold
send: send,sending,sends
sensation: sensation
sense: sense
sensibly: sensibly
sensitive: sensitive
sensitiveness: sensitiveness
sentence: sentence,sentenced,sentences
sententious: sententious
sentiment: sentiment,sentiments
separate: separate,separated,separating
separately: separately
separation: separation
sequence: sequence
serene: serene
sergeant: sergeant
series: series
sermon: sermon
serpent: serpent
serpentine: serpentine
servant: servant,servants
serve: serve,served,serves,serving
service: service,services
serviceable: serviceable
servile: servile
sessions: sessions
set: set,sets,setting
settee: settee
setting: setting
settle: settle,settled,settles,settling
settled: settled
settlement: settlement
seventh: seventh
sever: sever
severe: severe,severest
severely: severely
severity: severity
sew: sewed
sewing: sewing
sex: sex
sha: sha
shabby: shabby
shackle: shackled
shade: shade,shaded,shading
shadow: shadow,shadows
shadowy: shadowy
shaft: shaft
shake: shake,shaken,shaking,shook
shaker: shaker
shallow: shallow
shallows: shallows
sham: sham
shame: shame
shameful: shameful
shape: shape,shaped,shapes,shaping
share: share,shared,shares,sharing
shark: shark
sharp: sharp,sharper,sharpest
sharpen: sharpened
sharply: sharply
sharpness: sharpness
shattered: shattered
shaver: shaver
shaving: shaving,shavings
shawl: shawl,shawls
shay: shay
sheep: sheep
sheer: sheer
sheet: sheet,sheets
shelf: shelf,shelves
shelter: shelter,sheltered,sheltering
sheltered: sheltered
shepherd: shepherd
sheriff: sheriff,sheriffs
sherry: sherry
shield: shield
shift: shifts
shifty: shifty
shilling: shilling,shillings
shin: shins
shine: shine,shines,shining,shone
ship: ship,shipped,ships
shipping: shipping
shipwreck: shipwreck
shirt: shirt
shiver: shivered,shivering,shivers
shoal: shoal
shock: shock,shocks
shoe: shod,shoe,shoes
shoeing: shoeing
shoot: shoot,shooting,shot
shooting: shooting
shop: shop,shops
shoplifting: shoplifting
shopman: shopman
shore: shore
shorl: shorl
short: short,shorter
shortcoming: shortcomings
shorten: shortened
shortly: shortly
shorts: shorts
shot: shot
shoulder: shoulder,shouldered,shouldering,shoulders
shout: shout,shouted,shouts
shouting: shouting
shove: shoved
shovelful: shovelful
shower: shower
showy: showy
shred: shreds
shrew: shrew
shrewdly: shrewdly
shriek: shriek,shrieked,shrieking,shrieks
shrill: shrill
shrink: shrank,shrink,shrinking,shrunk
shropshire: shropshire
shroud: shroud,shrouded
shrug: shrugged
shudder: shudder,shuddered,shuddering
shuddering: shuddering
shuffle: shuffled
shuffling: shuffling
shut: shut,shutting
shutter: shutter,shutters
shy: shy
shyness: shyness
sick: sick
sicken: sickened
sickening: sickening
sickly: sickly
sideways: sideways
sidle: sidling
sigh: sigh,sighed,sighing
sight: sight,sights
sighted: sighted
sign: sign,signed,signs
signal: signal
signature: signature
signify: signified,signify,signifying
silence: silence
silent: silent
silently: silently
silk: silk,silks
silly: silly
silver: silver
silvery: silvery
similarity: similarity
simmer: simmered
simple: simple,simplest
simplicity: simplicity
simply: simply
sincerely: sincerely
sincerity: sincerity
sinew: sinews
sinewy: sinewy
sing: sang,sing,singing,sung
singe: singed
singing: singing
single: single,singling
singleness: singleness
singly: singly
singular: singular
singularity: singularity
sink: sank,sink,sinking,sinks
sinner: sinner
sir: sir,sirs
sister: sister
sit: sat,sit,sitting
sitch: sitch
sitter: sitter,sitters
sitting: sitting
situate: situate,situated
situation: situation
sixpence: sixpence
sixteen: sixteen
size: size
skeleton: skeleton
sketch: sketch,sketched
skiff: skiffs
skilful: skilful
skilfully: skilfully
skill: skill
skilled: skilled
skin: skin
skip: skipped,skipping
skirt: skirts
skull: skull
sky: skies,sky
skylight: skylight
slab: slab
slack: slack
slacken: slacken,slackened
slant: slanted
slap: slapped,slapping
slate: slate
slave: slave,slaving
slavery: slavery
sledgehammer: sledgehammer
sleeker: sleeker
sleep: sleep,sleeping,slept
sleeplessness: sleeplessness
sleepy: sleepy
sleet: sleet
sleeve: sleeve,sleeves
sleight: sleight
slender: slender
slice: slice,sliced,slices
slight: slight,slighter,slightest
slightingly: slightingly
slime: slime
slimy: slimy
sling: sling,slung
slink: slinking
slip: slip,slipped,slipping,slips
slipperiness: slipperiness
slippery: slippery
slit: slit
slop: slop
slope: sloping
slouch: slouch,slouched,slouching
slouching: slouching
slovenly: slovenly
slow: slow,slower
slowly: slowly
slue: slued
sluggish: sluggish
sluice: sluice,sluices
sluicing: sluicing
slumber: slumber
slumbering: slumbering
slumberous: slumberous
slumberously: slumberously
slushy: slushy
sly: sly
smack: smacked
smart: smart,smarting,smarts
smartingly: smartingly
smartly: smartly
smash: smash,smashed,smashing
smear: smear,smeared
smeary: smeary
smell: smell,smelling,smells,smelt
smelter: smelter
smile: smile,smiled,smiles,smiling
smirk: smirked
smite: smote
smiter: smiter
smith: smith,smiths
smithfield: smithfield
smithy: smithies
smock: smock
smoke: smoke,smoked,smoking
smoking: smoking
smoky: smoky
smooth: smooth,smoothed,smoother,smoothing
smoothly: smoothly
smother: smothered
smoulder: smouldering
smuggle: smuggling
snake: snake
snaky: snaky
snap: snap,snapped,snapping
snappish: snappish
snappishly: snappishly
snare: snares
snarl: snarling
sneak: sneaking
sneer: sneer,sneered
sneeze: sneeze
snivel: snivelling
snort: snorting
snow: snow
snuff: snuff
snuffer: snuffers
snuffing: snuffing
snugly: snugly
soak: soaked,soaking
soap: soap,soaped
soapsud: soapsuds
soar: soaring
sob: sob,sobbing
sober: sober
sociable: sociable
social: social
society: societies,society
sofa: sofa
soft: soft,softer
soften: soften,softened,softening
softly: softly
softness: softness
soho: soho
soil: soiling
solar: solar
soldier: soldier,soldiering,soldiers
soldiering: soldiering
sole: sole
solely: solely
solemn: solemn
solemnity: solemnity
solemnly: solemnly
solicit: solicited
solicitor: solicitor
solid: solid
solitaire: solitaire
solitary: solitary
solitude: solitude
solution: solution
solve: solve,solved
solvency: solvency
son: son
song: song
sooner: sooner
soot: soot
soothe: soothe,soothed
soothing: soothing
sooty: sooty
sophia: sophia
sore: sore
sorrow: sorrow
sorrowful: sorrowful
sort: sort,sorts
sot: sot
soul: soul
sound: sound,sounded,sounds
soundly: soundly
soup: soup
sour: sour
source: source,sources
south: south
sovereign: sovereign
sow: sowed
space: space,spaces
spacious: spacious
span: spanned,spanning
spanish: spanish
spare: spare,spared
sparely: sparely
spark: sparks
sparkle: sparkled,sparkles,sparkling
sparrer: sparrer
sparrow: sparrows
spasmodic: spasmodic
spawn: spawn
speak: speak,speaking,speaks,spoke,spoken
speaker: speaker
speaking: speaking
special: special
speciality: speciality
species: species
specific: specific
specimen: specimens
speck: speck,specks
speckle: speckle
speckled: speckled
spectacle: spectacle
spectacles: spectacles
spectator: spectator,spectators
spectral: spectral
spectre: spectre
speculate: speculate,speculated
speculation: speculation,speculations
speech: speech,speeches
speechless: speechless
speed: sped,speed
speedily: speedily
spell: spell
speller: speller
spelling: spelling
spend: spend,spending,spent
sphere: sphere
spice: spices
spider: spider,spiders
spike: spiked,spikes
spin: spinning
spine: spine
spire: spires
spirit: spirit,spirits
spirited: spirited
spirting: spirting
spit: spat,spit,spits,spitting
spite: spite
spiteful: spiteful
splash: splash,splashed,splashes,splashing
splendid: splendid
splendour: splendour
split: split
splutter: spluttering
spoil: spoilt
spoilt: spoilt
sponge: sponge,sponging
spontaneous: spontaneous
spontaneously: spontaneously
spoon: spoon,spooned,spoons
spooney: spooney
sport: sported
sporting: sporting
sportive: sportive
spot: spot,spots
sprat: sprat
sprawly: sprawly
spread: spread
sprightly: sprightly
spring: sprang,spring,springing
springing: springing
sprinkle: sprinkled
spurious: spurious
spurn: spurned
spy: spy
squally: squally
square: square,squared,squaring
squat: squat
squeaker: squeaker
squeeze: squeezed,squeezing
squint: squint
squire: squires
squires: squires
stab: stabbed,stabbing,stabs
stable: stable,stables
stack: stack,stacks
stage: stage,stages
stagger: staggered,staggering
stagnant: stagnant
stagnation: stagnation
staid: staid
stain: stain,stained
stair: stair,stairs
staircase: staircase
stake: staked,stakes
stalk: stalking,stalks
stammer: stammer,stammered
stamp: stamping
stand: stand,standing,stands,stood
standing: standing
star: star,stars
stare: stare,stared,staring
staringly: staringly
starlight: starlight
starling: starlings
start: start,started,starting,starts
starting: starting
startle: startle,startled
startled: startled
starve: starve,starved
stately: stately
statement: statement
station: station,stationed,stations
stationery: stationery
statue: statue
stature: stature
stave: staved,staving
stay: stay,stayed
staylace: staylace
steadfastly: steadfastly
steadily: steadily
steady: steadiest,steady
steak: steak,steaks
steal: stealing,stole,stolen
stealth: stealth
steam: steam,steaming
steamer: steamer,steamers
steel: steel
steep: steeped
steeple: steeple
steer: steer,steered
steerer: steerer
steering: steering
steersman: steersman
step: step,stepped,stepping,steps
sterling: sterling
stern: stern
sternly: sternly
sternness: sternness
stew: stewed
steward: steward
stick: stick,sticking,sticks,stuck
sticking: sticking
stiff: stiff,stiffest
stiffen: stiffened
stiffly: stiffly
stifle: stifled
stifling: stifling
stile: stile
stillness: stillness
stilt: stilts
stimulate: stimulated,stimulating
sting: sting,stung
stinger: stinger
stipulate: stipulate,stipulated,stipulating
stipulation: stipulations
stir: stir,stirred,stirring
stirring: stirring
stitch: stitches
stock: stock,stocking,stocks
stocking: stocking,stockings
stolidity: stolidity
stomach: stomach
stone: stone,stones
stonily: stonily
stool: stool
stoop: stoop,stooped,stooping
stopper: stoppers
stopping: stopping
store: store,stores
storehouse: storehouse
storm: storm,storming
stormy: stormy
story: stories,story
stout: stout,stouter
stow: stowed
straddle: straddling
straggle: straggle
straggler: stragglers
straight: straight
straighten: straightening
straightway: straightway
strain: strain,strained,straining
strait: strait
strand: stranded
strange: strange,strangest
stranger: stranger,strangers
strangle: strangled
strap: strapping
stratagem: stratagem
straw: straw,straws
strawberry: strawberries
stray: stray,strayed,straying
streak: streaks
stream: stream,streaming
streaming: streaming
street: street,streets
strength: strength
strengthen: strengthened,strengthening
strenuous: strenuous
stress: stress
stretch: stretch,stretched,stretching
strew: strewed,strewing,strewn
stricken: stricken
strict: strict,strictest
strictly: strictly
stride: strides
strike: strike,strikes,striking,struck
striking: striking
string: string,strings,strung
strip: strip,stripped,strips
strive: strive
stroke: stroke,strokes
stroll: stroll,strolled,strolling
strong: strong,stronger,strongest
stronghold: stronghold
structure: structure
struggle: struggle,struggled,struggling
strut: strutting
stuck: stuck
stud: studded
student: student,students
studious: studious
study: studied,studies,study,studying
stuff: stuff,stuffed,stuffing,stuffs
stumble: stumble,stumbling
stumbling: stumbling
stump: stump
stunned: stunned
stunning: stunning
stupefy: stupefied
stupendous: stupendous
stupid: stupid
sty: sty
style: style
subdue: subdued
subdued: subdued
subject: subject,subjects
subjection: subjection
sublime: sublime
submission: submission
submissive: submissive
submissively: submissively
submit: submit,submitted
subordinate: subordinate
suborn: suborned
subsequent: subsequent
subside: subside,subsided,subsiding
subsist: subsisted
substance: substance,substances
substitute: substitute,substituting
substitution: substitution
subterfuge: subterfuge
subtle: subtle
subtlety: subtlety
succeed: succeed,succeeded
success: success
successful: successful
succession: succession
successive: successive
successor: successor
sudden: sudden
suddenly: suddenly
suddenness: suddenness
suffer: suffer,suffered,suffering
sufferer: sufferer,sufferers
suffering: suffering,sufferings
sufficient: sufficient
suffocate: suffocating
sugar: sugar
suggestion: suggestion,suggestions
suggestive: suggestive
suicide: suicide
suit: suit,suited,suits
suitable: suitable
suited: suited
suitor: suitor
sulk: sulks
sulkily: sulkily
sulky: sulky
sullen: sullen
sultan: sultan
sum: sum,summed,summing,sums
summary: summary
summer: summer
summon: summon,summoned,summoning
sun: sun
sunday: sunday
sundays: sundays
sunder: sunders
sundry: sundry
sunken: sunken
sunlight: sunlight
sunny: sunny
sunset: sunset
sunshine: sunshine
super: super
superannuated: superannuated
superb: superb
superciliously: superciliously
superfluous: superfluous
superior: superior
superiority: superiority
superscription: superscription
supersede: superseded
superstition: superstition
supervise: supervising
supper: supper
supplementary: supplementary
suppliant: suppliants
supplicant: supplicant
supply: supplied,supply
support: support,supported
supporter: supporter
suppose: suppose,supposed,supposes,supposing
supposititious: supposititious
suppress: suppressed
suppression: suppression
supremacy: supremacy
supreme: supreme
surely: surely
surface: surface
surge: surge
surgeon: surgeon
surly: surly
surmise: surmising
surname: surname
surpass: surpassed
surpassingly: surpassingly
surplus: surplus
surprise: surprise,surprised
surprised: surprised
surprising: surprising
surrender: surrender
surrey: surrey
surround: surrounded,surrounding
surroundings: surroundings
survey: survey,surveyed,surveying
surveyor: surveyor
susceptibility: susceptibility
suspect: suspect,suspected,suspecting
suspend: suspended
suspense: suspense
suspension: suspension
suspicion: suspicion,suspicions
suspicious: suspicious
sustain: sustained
sustained: sustained
swab: swab,swabs
swabs: swabs
swallow: swallow,swallowed,swallowing
swamp: swamp,swamps
swarthy: swarthy
sway: swaying
swear: swear,swearing,swore,sworn
sweat: sweat
sweep: sweep,sweeping,swept
sweet: sweet
sweeten: sweetened
swell: swell,swelled,swollen
swelter: sweltering
swift: swift
swiftly: swiftly
swim: swim,swimming,swum
swimming: swimming
swindle: swindling
swindler: swindlers
swindling: swindling
swine: swine
swing: swing,swung
swinging: swinging
swollen: swollen
swoop: swoop
sword: sword,swords
syllable: syllable
symmetrical: symmetrical
symmetrically: symmetrically
sympathetic: sympathetic
sympathetically: sympathetically
sympathise: sympathise
sympathy: sympathy
symptom: symptoms
synopsis: synopsis
systematic: systematic
table: table,tables
tablecloth: tablecloth,tablecloths
tablet: tablets
tacit: tacit
tack: tacked
tact: tact
tag: tag
tai: tai
tail: tail,tails
tailor: tailor
taint: taint
taker: takers
tal: tal
talk: talk,talked,talking
talkative: talkative
talking: talking
tall: tall,taller
tambourine: tambourine
tame: tame,tamed,taming
tangle: tangle,tangles
tangled: tangled
tap: tap,tapped,tapping,taps
tar: tar
tarnished: tarnished
tarpaulin: tarpaulin
tartar: tartar
task: task
taskmaster: taskmaster
taste: taste,tasted
tatters: tatters
tattoo: tattooed
taunt: taunting
tavern: tavern
tax: taxed,taxes
tea: tea
teaboard: teaboard
teach: taught,teach
teacher: teacher
teaching: teaching,teachings
teacup: teacup,teacups
teapot: teapot
tear: tear,tearing,tears,tore,torn
tearful: tearful
tease: tease
teel: teel
teem: teemed,teems
telemachus: telemachus
telescope: telescope
teller: teller
temper: temper,tempered
temperament: temperament
temperate: temperate
temperature: temperature
tempered: tempered
temple: temple
temporary: temporary
temporize: temporized
tempt: tempt,tempted,tempting
temptation: temptation
tenancy: tenancy
tenant: tenant
tend: tended,tending
tendency: tendency
tender: tender
tenderer: tenderer
tenderly: tenderly
tenderness: tenderness
tendon: tendons
tenement: tenement
tense: tense
tenure: tenure
ter: ter
term: term,terms
terminate: terminate,terminated
terrace: terrace
terrible: terrible
terribly: terribly
terrier: terrier
terrific: terrific
terrifically: terrifically
terrified: terrified
terrify: terrified,terrify
terror: terror,terrors
tersely: tersely
testament: testament
testator: testators
tester: tester
testify: testified,testify
testily: testily
testimony: testimonies,testimony
thames: thames
thankee: thankee
thankful: thankful
thankfulness: thankfulness
thankless: thankless
thanklessness: thanklessness
thanksgiving: thanksgiving
theatre: theatre
theatrical: theatrical
theme: theme,themes
thenceforth: thenceforth
theological: theological
theology: theology
theoretically: theoretically
theory: theories,theory
thereabout: thereabouts
thief: thief,thieves
thieve: thieving
thieving: thieving
thimble: thimble
thinking: thinking
thirdly: thirdly
thither: thither
tho: tho
thorn: thorns
thoroughfare: thoroughfares
thoughtful: thoughtful
thoughtfully: thoughtfully
thread: thread
threat: threat
threaten: threatened,threatening
threatened: threatened
threatening: threatening
threshold: threshold
thrice: thrice
thrive: thrive,thriven,thriving
thriving: thriving
throat: throat,throats
throb: throbbed
throbbing: throbbing
throne: throne
throttle: throttled
throw: threw,throw,throwing,thrown,throws
thrush: thrush
thumb: thumb,thumbs
thump: thump,thumped,thumping
thunder: thunder
thunderbolt: thunderbolts
thursday: thursday
thwart: thwarted
tick: ticked,ticks
tickled: tickled
tickler: tickler
tide: tide,tides,tiding
tidemark: tidemarks
tiding: tidings
tidy: tidied
tie: tie,tied,ties
tier: tiers
tiger: tiger
tight: tight,tighter,tightest
tighten: tightened,tightening
tile: tiled,tiles
tilt: tilt,tilted,tilting
tilting: tilting
timber: timber
time: time,times
times: times
timid: timid
timidly: timidly
timon: timon
tin: tin
tinder: tinder
tinge: tinge
tingle: tingling
tinker: tinker
tiptoe: tiptoe
tire: tire
tired: tired
tiresome: tiresome
tiring: tiring
tissue: tissue
tithe: tithe
title: title,titles
toady: toadies,toady
toast: toast,toasted,toasting
tobacco: tobacco
tobias: tobias
toe: toes
toil: toil,toiling
token: token,tokens
tolerable: tolerable
tolerably: tolerably
tolerate: tolerate
toleration: toleration
tom: tom
tomb: tomb,tombs
tombstone: tombstone,tombstones
ton: ton,tons
tone: tone,toned,tones
tong: tongs
tongue: tongue,tongued,tongues
tonic: tonic
tonight: tonight
tool: tool,tools
tooth: teeth
toothache: toothache
toothpick: toothpick
topic: topic
topple: toppling
torch: torch,torches
torchlight: torchlight
torment: torment,tormented
torn: torn
torrent: torrent
torture: torture,tortured,tortures
toss: toss,tossed,tossing
total: total
totally: totally
totter: totter
touch: touch,touched,touches,touching
touching: touching
tough: tough
tour: tour
tow: towing
towel: towel,towelled,towelling,towels
tower: tower,towering,towers
town: town
townsman: townsman
trace: trace,traced,traces,tracing
track: track,tracked,tracks
tract: tract,tracts
trade: trade,traded,trades
trader: traders
trades: trades
tradesman: tradesman,tradesmen
tradespeople: tradespeople
trading: trading
traffic: traffic
tragedy: tragedy
tragic: tragic
tragically: tragically
trail: trailed
training: training
traitor: traitor
tramp: tramp,tramping,tramps
tranquil: tranquil
tranquillity: tranquillity
transact: transact,transacted
transaction: transaction,transactions
transfer: transfer
transfix: transfixed
transformation: transformations
transpire: transpired
transport: transport,transported
transportation: transportation
trap: trap,trapped,traps
travel: travel,travelling
traveller: traveller
travelling: travelling
traverse: traversed
tray: tray
treacherous: treacherous
tread: tread,trod
treasonable: treasonable
treasonably: treasonably
treasure: treasure,treasured
treasury: treasury
treat: treat,treated,treating
treatise: treatises
treatment: treatment
tree: tree,trees
tremble: tremble,trembled,trembling
tremendous: tremendous
tremendously: tremendously
tremulous: tremulous
trenchant: trenchant
trepidation: trepidation
trial: trial,trials
triangular: triangular
tribe: tribe
trick: tricks
trifle: trifle,trifled,trifles
trifling: trifling
trimming: trimming,trimmings
trinket: trinkets
trip: trip,tripped,trips
triumph: triumph
triumphant: triumphant
triumphantly: triumphantly
trodden: trodden
troop: trooping
trooper: troopers
troops: troops
trot: trot
trouble: trouble,troubled,troubles,troubling
troubled: troubled
troublesome: troublesome
trousers: trousers
trowel: trowel
truckle: truckle
truculent: truculent
true: true,truer
trump: trumps
trumpet: trumpet
truncheon: truncheon
trunk: trunks
truss: trussed
trust: trust
trustful: trustful
truth: truth
tub: tub
tuck: tuck,tucked,tucking
tuesday: tuesday
tuft: tuft
tuition: tuition
tumble: tumble,tumbled,tumbling
tumbler: tumbler,tumblers
tumblers: tumblers
tumult: tumult
tune: tune
tuner: tuner
tunnel: tunnel
tureen: tureen
turnip: turnips
turnkey: turnkey,turnkeys
turnpike: turnpike
turret: turret
tusk: tusks
tutor: tutor
twelvemonth: twelvemonth
twentieth: twentieth
twig: twig,twigs
twilight: twilight
twin: twin
twine: twined
twinge: twinge
twinkle: twinkle,twinkled
twist: twist,twisted,twisting,twists
twisted: twisted
twitch: twitched
twitchy: twitchy
twopence: twopence
typify: typified
ud: ud
ugly: ugly
ull: ull
ulterior: ulterior
ultimately: ultimately
umbrella: umbrella
unable: unable
unacceptable: unacceptable
unaccountable: unaccountable
unacquainted: unacquainted
unaffected: unaffected
unanimously: unanimously
unartistic: unartistic
unassertive: unassertive
unassisted: unassisted
unassuming: unassuming
unavoidable: unavoidable
unbeknown: unbeknown
unbend: unbend
unbind: unbind
unbolt: unbolted
unborn: unborn
unbound: unbound
unbounded: unbounded
unbutton: unbuttoning
unceremoniously: unceremoniously
uncertain: uncertain
uncertainty: uncertainty
unchanged: unchanged
unchanging: unchanging
uncle: uncle,uncles
unclench: unclenched
uncoil: uncoil
uncolonial: uncolonial
uncomfortable: uncomfortable
uncomfortably: uncomfortably
uncommon: uncommon
uncommonly: uncommonly
uncongenial: uncongenial
unconnected: unconnected
unconscionable: unconscionable
unconscious: unconscious
unconsciously: unconsciously
unconsciousness: unconsciousness
uncouth: uncouth
uncover: uncovered
undecided: undecided
undefined: undefined
undeniable: undeniable
undergo: undergo,undergoing,underwent
underlet: underlet
undermine: undermining
underpaid: underpaid
undersized: undersized
understand: understand,understanding,understood
understanding: understanding
undertake: undertake,undertaking,undertook
undertaker: undertaker
undertaking: undertaking
undesignedly: undesignedly
undesigning: undesigning
undesirable: undesirable
undeterred: undeterred
undistinguishable: undistinguishable
undisturbed: undisturbed
undivided: undivided
undo: undo,undone
undoubtedly: undoubtedly
undutiful: undutiful
unearthly: unearthly
uneasily: uneasily
uneasiness: uneasiness
uneasy: uneasy
unemployed: unemployed
unequal: unequal
unexpected: unexpected
unexpectedly: unexpectedly
unexplained: unexplained
unfair: unfair
unfaithful: unfaithful
unfamiliar: unfamiliar
unfavourable: unfavourable
unfeeling: unfeeling
unfit: unfit,unfitted
unfitness: unfitness
unfixed: unfixed
unfold: unfold,unfolding
unfortunate: unfortunate
unfrequented: unfrequented
ungainly: ungainly
ungenerous: ungenerous
ungracious: ungracious
ungrateful: ungrateful
unhappiness: unhappiness
unhappy: unhappy
unhealthy: unhealthy
unheard: unheard
unhindered: unhindered
unholy: unholy
unhooped: unhooped
uniformly: uniformly
uninformed: uninformed
unintelligible: unintelligible
unintentional: unintentional
unintentionally: unintentionally
union: union
unique: unique
unite: unite,united
united: united
universal: universal
universally: universally
unjust: unjust
unkind: unkind
unkindness: unkindness
unknown: unknown
unlimited: unlimited
unload: unloading
unlock: unlocked,unlocking
unlucky: unlucky
unmanageable: unmanageable
unmanned: unmanned
unmindful: unmindful
unmoved: unmoved
unnatural: unnatural
unnaturally: unnaturally
unnecessary: unnecessary
unoffending: unoffending
unopened: unopened
unparalleled: unparalleled
unpleasant: unpleasant
unpossessed: unpossessed
unprofessional: unprofessional
unpromoted: unpromoted
unprotected: unprotected
unpunctual: unpunctual
unqualified: unqualified
unquestionably: unquestionably
unquestioning: unquestioning
unquiet: unquiet
unreason: unreason
unreasonable: unreasonable
unreasonably: unreasonably
unrefreshed: unrefreshed
unremunerative: unremunerative
unreservedly: unreservedly
unrestricted: unrestricted
unsatisfactory: unsatisfactory
unsay: unsay
unscrewed: unscrewed
unscrupulous: unscrupulous
unseen: unseen
unsettled: unsettled
unskilfully: unskilfully
unspeakable: unspeakable
unsteadily: unsteadily
unsteady: unsteady
unsuccessful: unsuccessful
unsuited: unsuited
unsympathetically: unsympathetically
untasted: untasted
untaught: untaught
untenable: untenable
unthankful: unthankful
untiring: untiring
untouched: untouched
untoward: untoward
untried: untried
untrue: untrue
untruthfulness: untruthfulness
unusual: unusual
unusually: unusually
unutterable: unutterable
unwelcome: unwelcome
unwilling: unwilling
unwind: unwound
unwittingly: unwittingly
unwonted: unwonted
unworthiness: unworthiness
unworthy: unworthy
unwound: unwound
unwrap: unwrapping
uphill: uphill
upholsterer: upholsterer
upholstery: upholstery
uplift: uplifted
uplong: uplong
upper: upper
upright: upright
uproar: uproars
uprose: uprose
upshot: upshot
upside: upside
upstairs: upstairs
upstroke: upstroke
uptown: uptown
upward: upward
urge: urged
urgency: urgency
urgent: urgent
urn: urn
usage: usage
useless: useless
usher: ushered,ushers
usual: usual
utensil: utensils
utmost: utmost
utter: utter,uttered,uttering
utterance: utterance
utterly: utterly
vacant: vacant
vacantly: vacantly
vacate: vacated
vacillate: vacillating
vagabond: vagabond
vagary: vagaries
vagrancy: vagrancy
vagrant: vagrants
vague: vague
vaguely: vaguely
vain: vain
vainglorious: vainglorious
vainly: vainly
valedictory: valedictory
valuable: valuable
vanish: vanished
vanity: vanities,vanity
vanquish: vanquished
vantage: vantage
vapour: vapour
varied: varied
variety: variety
varnish: varnish
vary: varied,vary
vast: vast
vastly: vastly
vastness: vastness
vat: vat
vault: vault
vauxhall: vauxhall
veal: veal
vehemence: vehemence
vehicle: vehicles
veil: veil,veiled
veinous: veinous
vellum: vellum
velvet: velvet
velveteen: velveteen
venerable: venerable
venerate: venerated
vengeance: vengeance
ventriloquist: ventriloquist
venture: venture,ventured
verb: verb
verbal: verbal
verdict: verdict
verge: verge
verification: verification
verify: verified,verify
verily: verily
veritably: veritably
vermin: vermin
verse: verse
verses: verses
version: version
vessel: vessel,vessels
vestige: vestige
vestry: vestry
vex: vex
vexation: vexation
vibrate: vibrated
vicariously: vicariously
vicious: vicious
victim: victim
victory: victory
victualling: victualling
view: view,viewing,views
vigil: vigils
vigilance: vigilance
vigor: vigor
vigorous: vigorous
vigorously: vigorously
vii: vii
viii: viii
vile: vile
village: village,villages
villain: villain,villains
villainous: villainous
vine: vine
vinegar: vinegar
vintage: vintage
violence: violence
violent: violent
violently: violently
violoncello: violoncello
virtue: virtue,virtues
virtues: virtues
virtuous: virtuous
virtuously: virtuously
visage: visage
visible: visible
vision: vision,visions
visionary: visionary
visit: visit,visited,visiting,visits
visitor: visitor,visitors
vista: vista
vitally: vitally
vivaciously: vivaciously
vivacity: vivacity
vivid: vivid
vividly: vividly
vividness: vividness
vogue: vogue
voice: voice,voices
volatile: volatile
volume: volume
volunteer: volunteered
vote: voted
voucher: vouchers
voyager: voyager
vulgar: vulgar
wafer: wafer,wafers
wager: wager,wagers
wages: wages
wagoner: wagoner
wail: wailing
wain: wain
waist: waist
waistcoat: waistcoat
waistcoated: waistcoated
wait: wait,waited,waiting,waits
waiter: waiter,waiters
waiting: waiting
waive: waive,waiving
wake: wake,wakes,waking,woke
wales: wales
walk: walk,walked,walking,walks
walking: walking
wall: wall,walls
walled: walled
walnut: walnut
wan: wan
wander: wander,wandering,wanders
wanderer: wanderer
wandering: wandering
wanderings: wanderings
war: war
ward: ward,warded
warder: warder,warders
ware: ware
warehousing: warehousing
warily: warily
warm: warm,warmed,warmest,warming
warmly: warmly
warmth: warmth
warn: warn,warned
warning: warning,warnings
warrant: warrant
wash: wash,washed,washing
washerwoman: washerwoman
washing: washing
waste: waste,wasted,wasting
watch: watch,watched,watching
watchful: watchful
watchfully: watchfully
watching: watching
watchmaker: watchmaker
watchman: watchman
water: water,watered,waters
watercress: watercress,watercresses
waterloo: waterloo
waterman: waterman,watermen
watery: watery
wave: wave,waved,waves,waving
waver: wavered,wavering
wax: wax,waxed
waxwork: waxwork
waywardness: waywardness
weak: weak,weaker,weakest
weaken: weakening
weakly: weakly
weakness: weakness,weaknesses
weal: weal
wealth: wealth
weapon: weapon
wear: wear,wearing,wore,worn
wearer: wearer
weariness: weariness
wearisomeness: wearisomeness
weary: wearied,weary
weather: weather
weathercock: weathercock
weazen: weazen
wedding: wedding
wedge: wedge
wednesday: wednesday
weed: weed,weeds
weedy: weedy
week: week,weeks
weekly: weekly
weep: weeping,wept
weigh: weigh,weighed,weighing
weight: weight
weighty: weighty
weir: weirs
weird: weird
weld: welded
wellington: wellington
welter: weltering
wen: wen
west: west
western: western
westminster: westminster
westward: westward
wet: wet
wharf: wharf
whatsoever: whatsoever
wheel: wheel,wheeling,wheels
wheeled: wheeled
wheelwright: wheelwright
wherefore: wherefore
whereof: whereof
whereon: whereon
wherry: wherries,wherry
whimper: whimpered,whimpering
whip: whipped
whipper: whippers
whirl: whirl,whirling
whisk: whisked
whisker: whisker,whiskers
whisper: whisper,whispered,whispering
whist: whist
whistle: whistled,whistling
white: white
whites: whites
whitesmith: whitesmith
whitewash: whitewash
whitewashed: whitewashed
whitlow: whitlow
wholesale: wholesale
wholesome: wholesome
wholesomely: wholesomely
wholesomer: wholesomer
wholly: wholly
whomsoever: whomsoever
whooping: whooping
whosoever: whosoever
wi: wi
wick: wick
wicked: wicked
wicket: wicket
wide: wide,wider
widen: widen,widened
widow: widow
wield: wield
wife: wife
wig: wig,wigs
wild: wild
wilderness: wilderness
wildest: wildest
wildly: wildly
wildness: wildness
wilful: wilful
wilfully: wilfully
william: william
willingly: willingly
willow: willow
win: win,winning
wind: wind,winding,winds,wound
winder: winder
windfall: windfall
windmill: windmill,windmills
window: window,windows
windsor: windsor
windy: windy
wine: wine,wines
wineglass: wineglasses
wing: wing,winged,wings
wink: winked,winking
winner: winner
winnings: winnings
winter: winter
wintertime: wintertime
wintry: wintry
wipe: wipe,wiped,wiping
wire: wire
wisdom: wisdom
wise: wise,wiser,wisest
wisher: wisher
wishful: wishful
wit: wit,wits
witch: witch
witches: witches
withdraw: withdrawing,withdrawn,withdrew
wither: withered,withering
withered: withered
withhold: withheld,withhold
witness: witness,witnesses
wo: wos
wolf: wolf
woman: woman,women
womanly: womanly
wonderful: wonderful
wonderfully: wonderfully
wood: wood,woods
woodcut: woodcut
wooden: wooden
wool: wool
woolsack: woolsack
word: word
workingman: workingman
workman: workman,workmen
worldly: worldly
worm: worm
worn: worn
worried: worried
worrit: worrit
worry: worried,worry
worship: worshipping
worsted: worsted
worth: worth
worthless: worthless
worthy: worthier,worthy
wot: wot
wound: wound,wounded,wounding,wounds
wounded: wounded
wrap: wrapped
wrath: wrath
wreak: wreak,wreaked
wreath: wreaths
wreck: wreck,wrecked,wrecks
wrecked: wrecked
wrench: wrenched,wrenching
wrestle: wrestles,wrestling
wretch: wretch,wretches
wretched: wretched
wretchedness: wretchedness
wriggle: wriggling
wring: wrung
wrinkle: wrinkles
wrist: wrist,wrists
write: write,writes,writing,written,wrote
writer: writer
writing: writing
written: written
wrong: wrong,wrongs
wrongdoing: wrongdoing
xi: xi
xii: xii
xiii: xiii
xiv: xiv
xix: xix
xvi: xvi
xvii: xvii
xviii: xviii
xx: xx
xxi: xxi
xxii: xxii
xxiii: xxiii
xxiv: xxiv
xxv: xxv
xxx: xxx
yah: yah
yard: yard,yards
yarmouth: yarmouth
yarn: yarn
yawn: yawn,yawned
yearly: yearly
yell: yell
yellow: yellow,yellower
yelp: yelping
yesterday: yesterday
yield: yield,yielded,yielding
yonder: yonder
yore: yore
yorkshire: yorkshire
yourn: yourn
youth: youth
youthful: youthful
youthfulness: youthfulness
zeal: zeal
zealous: zealous
zest: zest
