abandon: abandon,abandoned
abasement: abasement
abash: abash
abashed: abashed
abet: abet
abide: abide
ability: ability
abjure: abjures
abnegation: abnegation
abode: abode,abodes
abrupt: abrupt
absent: absent
absolute: absolute
absolutely: absolutely
absoluteness: absoluteness
absolve: absolved
absorb: absorbed
abstain: abstain
abstruse: abstruse
absurd: absurd
abundance: abundance
abuse: abuse,abused
abusive: abusive
abut: abut
abysmal: abysmal
abyss: abyss,abysses
academic: academic
accept: accept,accepted,accepting
access: access,accessed
accessible: accessible
accident: accident,accidents
accommodate: accommodate
accompany: accompanied,accompany
accomplish: accomplish
accord: accord
account: account
accredit: accredit
accumulate: accumulate,accumulated
accuracy: accuracy
accusation: accusation,accusations
accuse: accuse,accuses,accusing
accuser: accuser,accusers
achieve: achieve
acknowledge: acknowledge,acknowledged
acorn: acorns
acquaint: acquainted
acquaintance: acquaintances
acquire: acquire,acquired,acquires,acquiring
acquisition: acquisition
action: action,actions
active: active
activity: activity
actor: actor,actors
actual: actual
actuate: actuated
acumen: acumen
acute: acutest
adapt: adapt,adapted
adaptation: adaptation
adder: adder
addition: addition,additions
additional: additional
address: address,addresses
adequate: adequate
adjustment: adjustment
admirably: admirably
admiration: admiration
admire: admire,admiring
admit: admits
admonish: admonished,admonishing
ado: ado
adopt: adopting,adopts
adoration: adoration
adore: adore,adoring
adored: adored
adorer: adorers
adorn: adorn
adornment: adornment
adown: adown
adult: adult
adulterate: adulterated
adultery: adultery
advance: advance,advanced,advances
advanced: advanced
advantage: advantage
advent: advent
adventure: adventure,adventures
adventurer: adventurers
adversary: adversary
adverse: adverse
advice: advice
advise: advise
advocacy: advocacy
advocate: advocate,advocates
afar: afar
affair: affair,affairs
affect: affect
affection: affection
affirmative: affirmative
afflict: afflicted
affliction: affliction,afflictions
afford: afford
afraid: afraid
afresh: afresh
afric: afric
afterglow: afterglows
afternoon: afternoon
afterward: afterward
agape: agape
age: age,ages
aged: aged
agency: agency
agent: agent
ages: ages
agitation: agitation
agitator: agitators
agnosticism: agnosticism
agree: agree,agreed
agreeable: agreeable
agreement: agreement
aha: aha
aim: aim,aims
aimlessness: aimlessness
air: air,aired
alarm: alarm,alarmed
alarmed: alarmed
alarming: alarming
alas: alas
alien: alien
alight: alight
alike: alike
alive: alive
allay: allayed
allegorical: allegorical
allegory: allegories
alleviate: alleviates
alleviation: alleviation
allot: allotted
allure: allure,allured
alluringly: alluringly
allusion: allusion
almighty: almighty
alms: alms
almshouse: almshouse
aloft: aloft
aloneness: aloneness
aloud: aloud
alpha: alpha
altar: altars
alter: alter,altered,altering
alteration: alteration
alternate: alternate
alternately: alternately
altogether: altogether
altruism: altruism
amazedly: amazedly
amazement: amazement
amazing: amazing
ambition: ambition,ambitions
ambitious: ambitious
ambusher: ambusher
amen: amen
amend: amended,amends
amends: amends
amiable: amiable
amiss: amissing
amorous: amorous
amuse: amuse,amusing
amusement: amusement
analysis: analysis
anarchist: anarchist,anarchists
anarchy: anarchy
ancestor: ancestors
anchor: anchor,anchored
anchorite: anchorite,anchorites
ancient: ancient
anew: anew
angel: angel,angels
anger: anger
angle: angle
angora: angora
angrily: angrily
angry: angry
anguish: anguish
animal: animal,animals
animosity: animosity
ankle: ankles
annihilate: annihilated,annihilating
annihilation: annihilation
announcement: announcement
announcer: announcer
annoy: annoy
annoyance: annoyance,annoyances
anoint: anointed
anon: anon
answer: answer,answered,answering,answers
ant: ant
antagonism: antagonism
antagonistic: antagonistic
antelope: antelope
anthony: anthony
antichrist: antichrist
anticipate: anticipate,anticipated
antipathy: antipathy
antiquity: antiquity
antithesis: antitheses,antithesis
antithetical: antithetical
anvil: anvil
anxiety: anxiety
anxiously: anxiously
ape: ape,apes
aphorism: aphorism
apologia: apologia
apologise: apologise
apologists: apologists
apostate: apostates
apostates: apostates
apparent: apparent
apparition: apparition
appeal: appeal,appealed,appealing,appeals
appearance: appearance
appendix: appendix
appertain: appertain
appetite: appetite,appetites
applaud: applaud,applauded
apple: apple,apples
applicable: applicable
apply: applied,applies,apply,applying
appoint: appointed
appointable: appointable
apportion: apportioned
approach: approach,approached,approaching
approbation: approbation
appropriation: appropriation
appropriator: appropriator
approval: approval
approve: approve,approving
april: april
apt: apt
aquila: aquila
arbitrariness: arbitrariness
arch: arch,arches
archaic: archaic
arched: arched
archive: archive
archives: archives
ardent: ardent
ardently: ardently
ardour: ardour
argonauts: argonauts
argue: argued
argument: argument,arguments
aria: aria
arid: arid
aright: aright
aristocracy: aristocracy
aristocratic: aristocratic
aristotelian: aristotelian
ark: ark
arm: arm,arms
arouse: aroused
arrange: arrange,arranged,arranging
arrangement: arrangement
arranging: arranging
array: array,arrayed
arrear: arrear
arrival: arrival
arrive: arrive,arrived
arrogancy: arrogancy
arrogant: arrogant
arrow: arrow,arrows
art: art,arts
artful: artful
artfulness: artfulness
article: article
artifice: artifice,artifices
artist: artist
artistic: artistic
ascend: ascend,ascended,ascending
ascendancy: ascendancy
ascent: ascent
ascertain: ascertained
ascii: ascii
ascribe: ascribe
ash: ashes
ashamed: ashamed
ashore: ashore
ashy: ashy
asleep: asleep
aspect: aspect
aspiration: aspiration,aspirations
ass: ass,asses
assail: assail,assailed
assault: assaults
assemble: assembled
assess: assesses
assign: assign
assist: assists
assistance: assistance
assistant: assistants
associate: associate
association: association
assuagement: assuagement
assume: assume,assumes,assuming
assumption: assumption
assurance: assurance
assure: assure,assured
assuredly: assuredly
astonished: astonished
astonishing: astonishing
astonishment: astonishment
astral: astral
astray: astray
astrologer: astrologers
astute: astute
asunder: asunder
atheism: atheism
atheist: atheist
atmosphere: atmosphere
atone: atone
attach: attached
attack: attack,attacked
attain: attain,attained,attaining,attains
attainable: attainable
attempt: attempt,attempted,attempting,attempts
attend: attend
attendant: attendant
attention: attention
attentively: attentively
attire: attired
attitude: attitude,attitudes
attribute: attributes
audible: audible
audibly: audibly
audient: audient
aught: aught
august: august
auspices: auspices
author: author
authoritative: authoritative
authority: authority
autobiographical: autobiographical
autobiography: autobiography
autumn: autumn
avail: avails
avenger: avenger
average: average
averse: averse
aversion: aversion
avert: averted
avesta: avesta
avian: avian
avidity: avidity
avoid: avoid,avoided,avoids
avowal: avowal
await: await,awaited,awaiting
awake: awake,awoke
awaken: awaken,awakened
awakening: awakening
aware: aware
awe: awe
aweary: aweary
awful: awful
awfulness: awfulness
awhile: awhile
awkward: awkward
awkwardly: awkwardly
axe: axe
ay: ay
aye: aye
azure: azure
babbler: babbler
babbling: babbling
backbite: backbite
backbone: backbone
background: background
backside: backside
bad: bad,badder,baddest,worse,worst
badly: badly
bailiff: bailiffs
bait: bait
bake: baked
balance: balance
bale: bale
ball: ball
balsam: balsam
ban: ban,banned
banish: banish
bank: banks
banquet: banquet
baptize: baptized
bar: bar,bars
barbarism: barbarism
barefoot: barefooted
bargain: bargain
bargaining: bargaining
bark: bark
baroness: baroness
barrel: barrel
base: base,based
baseness: baseness
baser: baser
bashful: bashful
bashfulness: bashfulness
basis: basis
bat: bat,bats
bath: bath
batter: batter
battle: battle
battlefield: battlefield
bawler: bawlers
bay: bay
beak: beaks
beam: beam,beaming
bear: bear,bearing,bears,bore,born,borne
beard: beard,bearded
bearer: bearer,bearers
bearing: bearing,bearings
beast: beast,beasts
beat: beat
beating: beating
beauteous: beauteous
beautiful: beautiful
beauty: beauties,beauty
beckon: beckoning
becometh: becometh
bed: bed
bedeck: bedecked
bedevil: bedevilled
bedwarfing: bedwarfing
bee: bee,bees
beehive: beehives
beetle: beetles
befall: befall,befallen
befool: befooled
beg: beg
beget: beget
beggar: beggar,beggars
beginner: beginner
begirt: begirt
begloom: begloom
begotten: begotten
behave: behaved
behold: beheld,behold,beholding
beholder: beholders
belaud: belauded
belie: belie
belief: belief,beliefs
believer: believer,believers
believeth: believeth
belittle: belittling
bell: bell,bells
bellied: bellied
bellow: bellows
bellows: bellows
belly: bellies,belly
belong: belong,belongs
beloved: beloved
bend: bend,bending
beneath: beneath
benediction: benedictions
benefactor: benefactor
beneficence: beneficence
beneficent: beneficent
benevolence: benevolence
bent: bent
benumbed: benumbed
bereft: bereft
beribbon: beribboned
berry: berries
beseech: beseech
beset: beset
besmirch: besmirch
besom: besom
bestow: bestow,bestowing
bestower: bestower
bestowing: bestowing
bethink: bethink
bethought: bethought
betime: betimes
betray: betray,betrayed
betrayer: betrayer
betwixt: betwixt
beware: beware
bewitch: bewitched
bid: bade,bid,bids
bidding: bidding
bile: bile
bilious: bilious
bin: bin
binary: binary
bind: bind,bound
biography: biography
biological: biological
biology: biology
bird: bird,birds
birth: birth
bit: bit
bite: bit,bite,bites,biting,bitten
biting: biting
bitter: bitter,bitterest
bitterly: bitterly
bitterness: bitterness
black: black,blackest
blackness: blackness
blamable: blamable
blame: blame,blaming
blameless: blameless
blaspheme: blaspheme
blasphemer: blasphemers
blasphemy: blasphemies,blasphemy
blast: blasts
bleat: bleats
bleed: bleed
bleeding: bleeding
bless: bless,blessed
blessed: blessed
blessedly: blessedly
blessedness: blessedness
blesser: blesser
blessing: blessing,blessings
blind: blind
blindingly: blindingly
blindly: blindly
blindness: blindness
blink: blink,blinking
bliss: bliss
blissful: blissful
blissfully: blissfully
bloated: bloated
block: block
blond: blond
blood: blood
bloodless: bloodless
bloodthirsty: bloodthirsty
bloody: bloody
bloom: blooming
blossom: blossomed
blotch: blotches
blow: blew,blow,blows
blowfly: blowflies
blue: blue
blunder: blundered,blundering
blunt: blunt
bluntly: bluntly
blush: blush,blushes,blushing
bluster: blustering
blusterer: blusterer,blusterers
boar: boar
board: board
boat: boat
bob: bob
bodily: bodily
body: bodies,body
boil: boil,boiled
boisterousness: boisterousness
bold: bold,bolder,boldest
bon: bon
bondage: bondage
bone: bone,boned,bones
book: book,books
booming: booming
boot: boots
booty: booty
borrow: borrow,borrowed
bosom: bosom,bosoms
botch: botch,botched
bottle: bottles
boulder: boulders
bound: bound,bounding,bounds
boundary: boundaries,boundary
boundless: boundless
bow: bow,bowed,bowing
bowels: bowels
bowl: bowl
box: box
boy: boy,boys
braggart: braggarts
brain: brain
branch: branched,branches
brass: brass
brave: brave,bravest
bravery: bravery
brawling: brawling
bray: brayed
brazen: brazen
breach: breach
bread: bread
breadth: breadth
break: break,breaking,breaks,broke,broken
breaker: breaker
breaking: breaking
breast: breast,breasts
breath: breath,breaths
breathe: breathe
breathing: breathing
breathless: breathless
breed: bred
breeder: breeder
breeding: breeding
breeze: breeze,breezes
brethren: brethren
bridge: bridge,bridged,bridges
bright: bright,brighter
brighten: brightened
brightly: brightly
brightness: brightness
brilliant: brilliant
bring: bring,bringing,brings,brought
bringer: bringer
bringeth: bringeth
briskly: briskly
bristle: bristled,bristling
brittle: brittle
broad: broad,broadest
broil: broil
broken: broken
brood: brood,brooding
brook: brook,brooks
brother: brother
brotherly: brotherly
brown: brown
browsing: browsing
brush: brushed
brutal: brutal
brute: brute
bubble: bubble,bubbles
bucket: buckets
buckle: buckle
buckler: buckler
bud: bud
buddha: buddha
buddhism: buddhism
buddhist: buddhist
buddhistic: buddhistic
buffalo: buffalo,buffaloes
buffoon: buffoon,buffoons
bug: bugs
build: build,built
bulgy: bulgy
bull: bull
bullock: bullock
bulrush: bulrushes
bulwark: bulwark
buoyant: buoyant
burden: burden,burdened,burdens
burdensome: burdensome
burn: burn,burning,burnt
burner: burners
burrow: burrow,burrowing
burst: burst,bursts
bury: buried,bury
bush: bushes
business: business
butcher: butcher
butter: butter
butterfly: butterflies,butterfly
buyer: buyers
buzz: buzz,buzzing
buzzing: buzzing
bye: bye
bygone: bygone
cabinet: cabinets
cackle: cackle
caesar: caesar
calamity: calamity
calculable: calculable
calculate: calculate,calculated
calf: calves
calling: calling
callous: callous
calm: calm,calmer,calmest
calmly: calmly
calumniate: calumniated
camel: camel
camp: camp
campaign: campaigns
candidly: candidly
canker: cankers
canopy: canopy
canst: canst
cap: caps
capable: capable
capacity: capacity
cape: cape
capo: capo
capsule: capsule
captain: captain
captive: captives
capture: capture,captured
card: card
care: care,caring
careful: careful
carefully: carefully
caress: caress,caressed,caresses,caressing
caressingly: caressingly
careworn: careworn
caricature: caricatures
carp: carps
carpet: carpets
carrion: carrion
carry: carried,carry,carrying
cart: carts
cascade: cascade
cask: cask,casks
casket: casket
cast: cast,casting,casts
caste: castes
caster: casters
casteth: casteth
casualty: casualties
cat: cat,cats
catch: catch,caught
catcher: catchers
cattish: cattish
causality: causality
caution: cautions
cautiously: cautiously
cave: cave,caved,caves
cavern: cavern,caverns
cease: cease,ceased
ceiling: ceiling
celebrate: celebrate,celebrated
celestial: celestial
cellar: cellar,cellars
censed: censed
century: centuries,century
ceremony: ceremony
certainty: certainty
cessation: cessation
cetera: cetera
chain: chain,chains
chair: chair,chairs
chalk: chalk
challenge: challenges
chamber: chamber,chambers
chamois: chamois
chance: chance,chanced,chances
change: change,changed
changeable: changeable
channel: channels
chaos: chaos
chapter: chapter,chapters
character: character,characters
characteristic: characteristics
characterize: characterized
charcoal: charcoal
charge: charge,charged,charges
chariot: chariot
charitable: charitable
charity: charities,charity
charming: charming
charmingly: charmingly
charnel: charnel
chase: chased
chasm: chasm
chaste: chaste
chasten: chasten
chastity: chastity
chatter: chatter,chattering
check: check,checked,checks
cheek: cheek,cheeks
cheer: cheer,cheered
cheerful: cheerful
cheerfully: cheerfully
cheerfulness: cheerfulness
cherish: cherish
chew: chew
chilblain: chilblains
child: child,children
childhood: childhood
childish: childish
childishness: childishness
chill: chill
chilled: chilled
chimney: chimney
chip: chip
chloral: chloral
choice: choice,choicest
choicely: choicely
choke: choke,choked,chokes,choking
choose: choose,choosing,chose,chosen
christ: christ
christen: christen,christened
christian: christian,christians
christianity: christianity
church: church,churches
cigar: cigars
circle: circle,circles
circuit: circuit,circuits
circumnavigate: circumnavigate
circumscribe: circumscribed
circumstance: circumstances
cistern: cistern
city: cities,city
claim: claim,claimed
clamber: clamber,clambering
clambering: clambering
class: class,classes
classical: classical
clatter: clatter,clattering
claw: claws
clean: clean
cleanly: cleanly
cleansing: cleansing
clearness: clearness
clench: clench
clever: clever,cleverer
cliff: cliffs
climate: climate
climb: climb,climbed,climbing
climber: climber,climbers
climbing: climbing
cling: cling,clinging,clings
clinking: clinking
cloak: cloak
clock: clock,clocks
clockwork: clockworks
close: close,closed,closer,closest
closed: closed
closely: closely
closet: closets
clothe: clothed
clothes: clothes
clothing: clothing
cloud: cloud,clouds
cloudlet: cloudlet
cloudy: cloudy
club: club
clumsily: clumsily
clumsy: clumsy
cluster: cluster,clusters
clutch: clutch
coarse: coarse
coarsely: coarsely
coast: coast,coasts
cobweb: cobweb
cock: cock
cockcrow: cockcrow
code: codes
coerce: coerce
coercive: coercive
coffin: coffin,coffins
coil: coil,coiled
coiling: coiling
coinage: coinages
coiner: coiner,coiners
cold: cold,colder,coldest
coldly: coldly
coldness: coldness
collapse: collapse
collapsing: collapsing
colleague: colleagues
collect: collect
collection: collection
colour: colour,coloured,colours
coloured: coloured
column: columns
comb: comb
combat: combat
combine: combined
cometh: cometh
comfort: comfort,comforted,comforting
comfortable: comfortable
comfortableness: comfortableness
comforter: comforter,comforters
comforting: comforting
command: command,commanded,commanding
commander: commander
commanding: commanding
commandment: commandment
commence: commence,commenced,commences
commend: commended
comment: comment
commentary: commentary
commercial: commercial
commiserate: commiserate
commiseration: commiseration
commit: commit,committed,committing
common: common
commune: communed
communication: communication
community: communities,community
companion: companion,companions
company: company
comparatively: comparatively
compare: compare,compared,compares
comparison: comparison
compassion: compassion
compatible: compatible
compel: compel,compelled
compelled: compelled
compendium: compendium
compilation: compilation
complacency: complacency
complain: complain,complained,complaining
complementary: complementary
complete: complete
completely: completely
compliance: compliance
compliant: compliant
complimentary: complimentary
comply: comply,complying
compose: compose,composed,composing
composer: composer
composition: composition
composure: composure
comprehensible: comprehensible
comprehensive: comprehensive
compress: compressed
compressed: compressed
comprise: comprised
compromise: compromise
comrade: comrade
comradeship: comradeship
conceal: conceal,concealed
conceit: conceit
conceivable: conceivable
conceive: conceive,conceived
concept: concept,concepts
conception: conception,conceptions
concern: concern
concerned: concerned
concert: concert
concise: concise
conclude: conclude,concludes
conclusion: conclusion,conclusions
concomitant: concomitant
condemn: condemn,condemned,condemns
condescension: condescension
condition: condition,conditioned,conditions
conduce: conduce,conduced
conduct: conduct
cone: cones
confection: confection
confectioner: confectioners
confess: confess,confessed,confesses
confide: confiding
confidence: confidence
confident: confident
confidently: confidently
confined: confined
confinement: confinement
confirm: confirmed,confirms
confirmation: confirmation
conflict: conflict,conflicting
conflicting: conflicting
confound: confound,confounded,confounding
confront: confronted,confronting
confused: confused
confusedly: confusedly
confusion: confusion
congeal: congealed
conjecture: conjecture,conjecturing
conjecturing: conjecturing
conjunction: conjunction
conjure: conjure
connection: connection
conquer: conquer
conqueror: conqueror,conquerors
conquest: conquest
conscience: conscience,consciences
conscientious: conscientious
conscientiousness: conscientiousness
conscious: conscious
consciousness: consciousness
consecrate: consecrate,consecrated
consequence: consequence
consequential: consequential
conserve: conserved
considerable: considerable
considerably: considerably
considerate: considerate
considerateness: considerateness
consideration: consideration
consist: consist
consistently: consistently
consolation: consolation,consolations
console: console
constant: constant
constantly: constantly
constitute: constituted,constitutes,constituting
constitution: constitutions
constitutional: constitutional
constrain: constrain,constrained
constraint: constraint
consume: consumed
consummate: consummating
consummation: consummation
consumptive: consumptive
contact: contact
contagious: contagious
contemplate: contemplate,contemplated
contemplation: contemplation
contemplative: contemplative
contemporary: contemporaries,contemporary
contempt: contempt
contemptible: contemptible
contemptuously: contemptuously
contend: contends
content: content
contention: contention
contents: contents
context: context
continent: continent
continual: continual
continually: continually
continue: continue,continued
continuous: continuous
contorted: contorted
contra: contra
contract: contract
contradict: contradict,contradicted,contradicting
contradiction: contradiction
contrary: contrary
contrast: contrast,contrasted
contribute: contribute
contribution: contributions
contrive: contrive
contrived: contrived
control: control
convalescence: convalescence
convalescent: convalescent,convalescents
convenance: convenance
convenience: convenience
convention: conventions
conversation: conversation
convert: convert,converted
converted: converted
convey: convey
convince: convince
convinced: convinced
convulse: convulsed
convulsion: convulsion,convulsions
cook: cook,cooked
cooking: cooking
cookshop: cookshops
cool: cool,cooling
coolly: coolly
coolness: coolness
copiously: copiously
copying: copying
copyright: copyright
cord: cord
cordial: cordial
cordially: cordially
cork: cork
corn: corn
corner: corner,corners
cornfield: cornfields
corporation: corporation
corpse: corpse,corpses
correct: correct
correctest: correctest
correctly: correctly
corridor: corridors
corrupt: corrupt
cosmogony: cosmogony
cost: cost,costs
cot: cot
couch: couch,couches
cough: cough,coughing
couldst: couldst
counsel: counsel,counselled
counsellor: counsellors
count: counted
countenance: countenance,countenances
counter: counter
counterpart: counterpart
country: countries,country
courage: courage
courageous: courageous
court: court,courts
courteous: courteous
courteously: courteously
courtier: courtiers
courtly: courtly
cove: cove
cover: covered
covet: covet
covetous: covetous
cow: cow,cows
coward: coward,cowards
cowardice: cowardice
cowardly: cowardly
cowed: cowed
cower: cowered
cozener: cozeners
crab: crab,crabs
crack: crack,cracked,cracking
cracker: cracker,crackers
cradle: cradle,cradled,cradles
craft: craft
craftily: craftily
crafty: craftiest,crafty
crave: crave,craved
craving: craving,cravings
crawl: crawl,crawled
creak: creaking
creakingly: creakingly
create: create,created,creates,creating
creation: creation,creations
creative: creative
creator: creator,creators
creature: creature,creatures
credit: credit
credulous: credulous
creed: creeds
creep: creep,creeping,crept
creeper: creeper
crew: crew
crier: crier
crime: crime
criminal: criminal,criminals
cringe: cringing
cripple: cripple,crippled,cripples
crippled: crippled
crisp: crisp
criterion: criteria
critic: critic,critics
critical: critical
criticism: criticism
croak: croak,croaked,croaking
crocodile: crocodiles
crooked: crooked,crookedest
cross: cross,crossed,crosses,crossing
crossing: crossing
crossroad: crossroad
crow: crow,crowing,crows
crowd: crowd,crowded,crowding
crown: crown,crowns
crowning: crowning
crucifixion: crucifixion,crucifixions
crucify: crucify
cruel: cruel,cruellest
cruellest: cruellest
cruelly: cruelly
cruelty: cruelty
crumble: crumble
crunch: crunch,crunched
crusade: crusade
crush: crush
crutch: crutch
crying: crying
cudgel: cudgel
culprit: culprits
cultivate: cultivated
cultivator: cultivators
culture: culture,cultured
cunning: cunning
cunningly: cunningly
cup: cup
cupid: cupid
cupping: cupping
cure: cure
curer: curers
curiosity: curiosity
curious: curious
curiously: curiously
curl: curled,curling
curly: curly
current: current
curse: curse,cursed,curses
cursed: cursed
curtain: curtain
curtained: curtained
curve: curve
curved: curved
custom: custom,customs
cut: cut
cutting: cutting
cyclone: cyclone
cypress: cypresses
da: da,das
daily: daily
dainty: dainties,dainty
dale: dale
damage: damage,damaging
damaged: damaged
damages: damages
damp: damp
damsel: damsels
dance: dance,danced,dances,dancing
dancer: dancer,dancers
dancing: dancing
danger: danger,dangers
dangerous: dangerous
dangerously: dangerously
dangle: dangled
daring: daring
daringly: daringly
dark: dark,darker,darkest
darken: darkened
darkening: darkening
darkness: darkness
darwin: darwin
darwinian: darwinian
das: das
datum: data
daughter: daughters
david: david
dawn: dawn,dawned,dawning,dawns
day: day,days
daylight: daylight
dead: dead
deadly: deadly
deaf: deaf
deafen: deafen,deafened
deal: deal,dealing
dearest: dearest
dearly: dearly
death: death
debility: debility
decadent: decadent,decadents
decamp: decamping
decay: decay,decayed,decaying
deceit: deceit
deceitful: deceitful
deceive: deceive,deceived,deceiving
deceiver: deceiver,deceivers
december: december
deceptive: deceptive
decide: decide,decided
decisive: decisive
deck: decked
declare: declare,declared,declares,declaring
decline: decline,declining
declivity: declivity
decoy: decoy,decoyed
decrepit: decrepit
deductible: deductible
deed: deed,deeds
deep: deep,deeper,deepest
deepen: deepen
deeply: deeply
defame: defame
defect: defect,defects
defective: defective
defend: defend,defended,defending
defensive: defensive
defiance: defiance
defiant: defiant
define: define,defines,defining
definite: definite
definiteness: definiteness
definition: definition
defy: defies
degenerate: degenerate,degenerates,degenerating
degeneration: degeneration
degree: degree
dehumanise: dehumanised
deified: deified
deity: deities,deity
dejection: dejection
del: del
delay: delay
delectation: delectation
deletion: deletions
deliberately: deliberately
delicacy: delicacy
delicate: delicate
delight: delight
delighted: delighted
delightful: delightful
delightfully: delightfully
deliver: deliver,delivered
deliverance: deliverance
deliverer: deliverer
delusion: delusion,delusions
demagogue: demagogues
demand: demand,demanded
demi: demi
democrat: democrats
democratic: democratic
demolisher: demolisher
demoniacal: demoniacal
demonstrate: demonstrate
demonstration: demonstration
den: den
denounce: denounced
dense: dense
deny: denied,denying
depart: depart,departed,departing,departs
department: department
departure: departure
depend: depends
dependent: dependent
deplore: deplored
deposit: deposit
depressed: depressed
depressing: depressing
deprive: depriving
depth: depth
depths: depths
der: der
deride: derided
derision: derision
derisively: derisively
derivative: derivative,derivatives
derive: derive,derived
des: des
descend: descend,descending
descent: descent
description: description
desert: desert,deserted,deserts
deserve: deserve
desideratum: desideratum
designate: designate,designated,designates,designating
desirability: desirability
desirable: desirable
desire: desire,desired,desires,desiring
desirous: desirous
desistance: desistance
despair: despair,despaired
despaired: despaired
despairing: despairing
desperate: desperate
desperation: desperation
despicable: despicable
despise: despise,despised,despises,despising
despiser: despiser,despisers
despising: despising
despond: despond
dessert: dessert
destine: destined
destiny: destiny
destitute: destitute
destroy: destroy,destroyed,destroying
destroyer: destroyer,destroyers
destruction: destruction
detach: detach
detailed: detailed
detect: detected
deteriorate: deteriorated
determination: determination
determine: determine,determined
detest: detest,detested
detestation: detestation
detriment: detriment
develop: develop,developed,develops
development: development,developments
devil: devil,devils
devise: devise,devised
deviser: devisers
devoid: devoid
devote: devote,devoted
devotee: devotee,devotees
devotion: devotion
devour: devour,devoured
dew: dew,dews
dexterous: dexterous
diable: diable
dialogue: dialogue
diamond: diamond
dice: dice
dictate: dictated
diction: diction
dictum: dictum,dictums
didst: didst
die: die,died,dying
diener: diener
difference: difference,differences
differentiate: differentiated
differentiation: differentiation
difficult: difficult
difficulty: difficulties,difficulty
diffuse: diffused
dig: dig
digest: digest
digger: digger,diggers
dignity: dignities,dignity
diligence: diligence
dim: dim
dimness: dimness
din: din
dingy: dingy
dinner: dinner
dionysian: dionysian
dire: direst
direct: direct,directed
direction: direction,directions
dirt: dirt
dirty: dirtiest,dirty
disagree: disagreed,disagrees
disappear: disappear,disappeared
disappointment: disappointment,disappointments
disapproval: disapproval
disassociate: disassociates
disavow: disavow,disavowed
discern: discern,discerning
discerner: discerner,discerners
discerning: discerning
discernment: discernment
discharge: discharge
disciple: disciple,disciples
discipline: discipline
disclaim: disclaim,disclaims
disclaimer: disclaimer,disclaimers
disclose: disclose,disclosed,discloses
disconcerted: disconcerted
discontinue: discontinue
discord: discord
discount: discounted
discourage: discouraged
discouraging: discouraging
discourse: discourse,discoursed,discourses
discourses: discourses
discourteous: discourteous
discover: discover,discovered,discovering
discoverer: discoverer
discovery: discovery
discreet: discreet
discuss: discuss,discussed
disdain: disdain
disdainfully: disdainfully
disease: disease,diseases
diseased: diseased
disenchant: disenchanted
disfigure: disfigure
disfigured: disfigured
disguise: disguise,disguised
disgust: disgust,disgusted
disgusted: disgusted
disharmony: disharmony
disheartening: disheartening
dishevelled: dishevelled
dishonest: dishonest
dishonestly: dishonestly
disk: disk
dislike: dislike,disliked
dislocation: dislocation
dismay: dismay,dismayed
dismiss: dismiss
disorder: disorder,disorders
disown: disown
disparage: disparaged
dispatch: dispatch
dispense: dispensed,dispensing
disperse: dispersed
display: display,displayed,displaying
disposal: disposal
dispose: dispose
disposed: disposed
dispute: dispute
disquiet: disquiet,disquieted
dissatisfied: dissatisfied
dissemble: dissemble,dissembling
dissembler: dissemblers
dissembling: dissembling
dissentingly: dissentingly
dissimilar: dissimilar
dissipate: dissipating
dissuade: dissuaded
distance: distance,distances
distant: distant
distilled: distilled
distinct: distinct
distinction: distinction
distinctly: distinctly
distinguish: distinguish,distinguished,distinguishes
distinguished: distinguished
distort: distorted
distorted: distorted
distress: distress
distressed: distressed
distribute: distribute,distributed,distributing
distribution: distribution
distributor: distributor
distrust: distrust
distrustful: distrustful
distrustfully: distrustfully
disturb: disturb,disturbed
dithyrambic: dithyrambic
diver: divers
diversion: diversion
divest: divest
divinable: divinable
divine: divine,divined,divining
divinely: divinely
diviner: diviner
divining: divining
divinity: divinity
division: divisions
divorce: divorce
dizzy: dizzy
doctrine: doctrine,doctrines
doer: doer
doest: doest
doeth: doeth
dog: dog,dogs
doggish: doggish
dogma: dogma,dogmas
doll: dolls
dolt: dolt
doltish: doltish
domain: domain,domains
domestic: domestic
domination: domination
dominion: dominion
donate: donate
donation: donation,donations
donkey: donkey
donkeyism: donkeyism
donor: donors
doom: doom
door: door,doors
doorway: doorways
dost: dost
doth: doth
double: double
doubt: doubt,doubted,doubting,doubts
doubter: doubter
doubtfully: doubtfully
doubting: doubting
doubtless: doubtless
dough: dough
dove: dove,doves
dovecote: dovecote
downhill: downhill
download: downloading
downpour: downpour
downward: downward
dowry: dowry
drag: drag,dragged
dragon: dragon,dragons
drama: drama
drape: draped
draught: draught,draughts
draw: draw,drawing,drawn,drew
drawer: drawer
drawing: drawing
dread: dreading
dreadful: dreadful
dream: dream,dreamed,dreams,dreamt
dreamer: dreamer
dreamily: dreamily
dreams: dreams
dreary: dreariest,dreary
dregs: dregs
drench: drenched
dress: dressed
drift: drift,drifting
drink: drink,drunk
drinker: drinker,drinkers
drinking: drinking
drip: drip,dripped
dripping: dripping
drive: drive,driven,drove
driver: drivers
droll: droll
drop: drop,dropped,drops
dropping: droppings
dropt: dropt
drown: drown,drowned,drowning
drowsily: drowsily
drowsy: drowsy
drug: drug
drum: drum,drums
drummer: drummer
drunk: drunk
drunkard: drunkard
drunken: drunken
drunkenness: drunkenness
dry: dried,dry
dull: dull,dulled
dumb: dumb
dupe: dupe
dusky: dusky
dust: dust
dusty: dusty
duty: duty
dwarf: dwarf,dwarfs
dwell: dwell,dwelt
dweller: dweller,dwellers
dying: dying
dynasty: dynasty
dyspeptic: dyspeptic
eager: eager,eagerer
eagerly: eagerly
eagerness: eagerness
eagle: eagle,eagles
eaglelike: eaglelike
ear: ear,ears
eared: eared
earn: earned,earning
earnest: earnest
earnestly: earnestly
earnestness: earnestness
earth: earth
earthly: earthliest,earthly
earthquake: earthquake
earthward: earthward
ease: ease
easily: easily
easy: easier,easy
eat: ate,eat,eating
eater: eater,eaters
eating: eating
ebb: ebb
ecce: ecce
eccentric: eccentric
echo: echo,echoed,echoing
economist: economists
economy: economy
ecstasy: ecstasy
ecstatic: ecstatic
eddy: eddy
edge: edge
edify: edified
edition: edition,editions
editor: editor
educational: educational
educator: educator
efface: effaced
effeminate: effeminate
efficient: efficient
effort: effort,efforts
egg: egg,eggs
ego: ego
egregious: egregious
elaborate: elaborate
elderly: elderly
elect: elect
electronic: electronic
electronically: electronically
elegant: elegant
element: element
elephant: elephant
elevate: elevate,elevated,elevates,elevating
elevated: elevated
elevation: elevation,elevations
elizabeth: elizabeth
eloquence: eloquence
eloquent: eloquent
eloquently: eloquently
elucidate: elucidate,elucidated
elude: elude
email: email
emanate: emanate
emancipate: emancipated
emancipation: emancipation
emancipator: emancipator
emasculate: emasculated
embark: embark,embarked
embarrassment: embarrassment
embittered: embittered
embodiment: embodiment
embody: embodied
embrace: embrace,embraces,embracing
emerald: emerald
emerge: emerge
eminence: eminence
emotion: emotions
emotional: emotional
emotionalism: emotionalism
emperor: emperor
emphasis: emphasis
emphatically: emphatically
empire: empire,empires
employee: employee,employees
en: en
enable: enabled,enables
enamour: enamoured
encage: encaged
enchain: enchained
enchanted: enchanted
enchanter: enchanter
encircle: encircled,encircling
encode: encoding
encourage: encourage,encouraged
endless: endless
endorse: endorsed
endow: endow,endowing
endurable: endurable
endure: endure,endured,enduring
endurer: endurer
enemy: enemies,enemy
energy: energies,energy
engage: engaged
england: england
english: english
engross: engrossed
enhance: enhance
enigma: enigma,enigmas
enjoin: enjoin,enjoined
enjoy: enjoy,enjoyed,enjoying
enjoyer: enjoyer,enjoyers
enjoyment: enjoyment
enlace: enlaced
enlighten: enlighten
enlightened: enlightened
enlink: enlinked
enmity: enmity
enormous: enormous
enraged: enraged
enrapture: enraptured
enraptured: enraptured
ensure: ensuring
enter: enter,entered
entertain: entertain
entertainment: entertainment,entertainments
enthusiasm: enthusiasm
enthusiastic: enthusiastic
entice: entice,enticed
entire: entire
entitle: entitled
entity: entity
entrails: entrails
entrance: entrance
entreatingly: entreatingly
enunciate: enunciated
envier: enviers
envious: envious
enviously: enviously
environ: environed
environment: environment
envy: envied,envy,envying
epitome: epitome
equal: equal,equals
equality: equality
equally: equally
equanimity: equanimity
equipment: equipment
equivocal: equivocal
equivocalness: equivocalness
era: eras
ere: ere
err: erred,erring
errand: errand
erratically: erratically
error: error,errors
escape: escape,escaped
esoteric: esoteric
essay: essay
essential: essential
essentially: essentially
establish: establish,established
estate: estate
esteem: esteem,esteeming
esteeming: esteeming
estimable: estimable
estimate: estimate,estimated,estimates
eternal: eternal
eternally: eternally
eternity: eternities,eternity
ether: ether
ethic: ethics
eulogy: eulogies
euphemism: euphemism
europe: europe
european: european
evade: evaded,evades
eve: eve
evening: evening,evenings
event: event,events
eventide: eventide
evergreen: evergreen
everlasting: everlasting
everyday: everyday
evidence: evidence
evidently: evidently
evil: evil,evilest,evils
eviler: eviler
evilly: evilly
evolution: evolution,evolutions
evolutionist: evolutionist,evolutionists
evolve: evolved,evolving
exact: exacted
exaggerate: exaggerates
exalt: exalt,exalted
exaltation: exaltation
examine: examined,examining
exasperated: exasperated
excavate: excavated
exceed: exceed
exceedingly: exceedingly
excellence: excellence
excellency: excellencies
excellent: excellent
exception: exception
exceptional: exceptional
exceptionally: exceptionally
excessive: excessive
excite: excite,excited
excited: excited
exclaim: exclaimed
exclusion: exclusion
exclusive: exclusive
excuse: excuse
execrable: execrable
execute: execute
executioner: executioner
exempt: exempt
exercise: exercise,exercising
exert: exert,exerted
exhale: exhale
exhausted: exhausted
exhaustive: exhaustive
exhaustively: exhaustively
exhibit: exhibit
exhilarate: exhilarating
exhort: exhorts
exhortation: exhortation
exile: exiled,exiles
exist: exist,existed,existing,exists
existence: existence
exit: exit
expand: expand
expect: expected,expects
expectation: expectation,expectations
expedient: expedient,expedients
expend: expend
expense: expense,expenses
experience: experience,experienced,experiences,experiencing
experienced: experienced
experiment: experiment
experimental: experimental
expert: expert
explain: explained,explains
explanation: explanation
exploit: exploit,exploited,exploiting
exploitation: exploitation
explore: exploring
export: exporting
expose: exposed
exposition: exposition
expound: expounded
express: express,expressed
expression: expression
expressive: expressive
extend: extended
extensive: extensive
extent: extent
exterior: exterior
external: external
extinguish: extinguishing
extol: extol,extolled
extra: extra
extract: extract
extraneous: extraneous
extraordinary: extraordinary
extreme: extreme,extremes
extremely: extremely
exuberance: exuberance
exuberant: exuberant
exult: exulted,exulting
eye: eye,eyes
eyed: eyed
fabricate: fabricate,fabricated
fabulous: fabulous
faced: faced
facet: facets
facility: facility
factor: factor,factors
faculty: faculties,faculty
fade: faded
fagot: fagot
fail: fail,failed,failing,fails
failure: failure,failures
fain: fain
faint: faint,fainting
fair: fair,fairer,fairest
fait: fait
faith: faith
faithful: faithful
faithfulness: faithfulness
faithlessness: faithlessness
falcon: falcon
fall: fall,fallen,falling,falls,fell
fallen: fallen
falls: falls
false: false,falsest
falsehood: falsehood,falsehoods
falseness: falseness
falsify: falsified
falter: faltered
fame: fame
famed: famed
familiar: familiar
familiarity: familiarity
familiarly: familiarly
family: family
famished: famished
famous: famous
fan: fan
fanatical: fanatical
fanciful: fanciful
fancy: fancied,fancies,fancy
fare: fare
farewell: farewell
farm: farm
fashion: fashion
fast: fast,faster,fastest
faster: faster
fastidious: fastidious
fat: fat,fatter
fatal: fatal
fatally: fatally
fate: fate,fates
fateful: fateful
father: father,fathers
fatherland: fatherland,fatherlands
fathom: fathom
fathomless: fathomless
fatigue: fatigue
fatigued: fatigued
fatten: fatten
fatuous: fatuous
fault: fault,faults
favour: favour
favourable: favourable
favourably: favourably
favourite: favourite
fawningly: fawningly
fear: fear,feared,fears
fearful: fearful
fearfully: fearfully
fearless: fearless
feast: feast,feasted
feather: feather
feature: feature,features
february: february
federal: federal
fee: fee,fees
feeble: feeble
feebleness: feebleness
feed: feed
feel: feel,feeling,feels
feeling: feeling,feelings
feign: feign
felicity: felicities
felix: felix
feller: fellers
fellow: fellow,fellows
fellowman: fellowmen
female: female,females
feminine: feminine
feminise: feminise
fen: fens
fertile: fertile
fervent: fervent
fervid: fervid
fervour: fervour
festa: festa
festival: festival,festivals
fetch: fetch,fetched
fetter: fetter,fetters
feud: feuds
fever: fever,fevers
feverish: feverish
fickly: fickly
fiction: fiction
fidelity: fidelity
fidget: fidgeting
fie: fie
field: field,fields
fiend: fiend
fierce: fierce
fifteenth: fifteenth
fig: fig,figs
fight: fight,fighting,fights,fought
fighter: fighter,fighters
figure: figure,figures
filch: filched
file: file,files
film: film
filth: filth
filthy: filthier,filthy
final: final
finally: finally
financial: financial
fine: fine,finer,finest
finger: finger,fingers
finish: finished
finite: finite
fino: fino
fireside: fireside
firework: fireworks
firm: firm
firmament: firmament
firmly: firmly
firmness: firmness
firstling: firstling,firstlings
firstly: firstly
fish: fish,fishes
fisher: fisher,fishers
fisherman: fisherman,fishermen
fishing: fishing
fishlike: fishlike
fist: fists
fit: fit
fitness: fitness
fitting: fitting
fixed: fixed
fixedly: fixedly
flame: flame,flames,flaming
flamingo: flamingo,flamingoes
flap: flap
flapping: flapping
flash: flash,flashed,flashes,flashing
flat: flat,flatter
flatter: flattered
flattered: flattered
flatterer: flatterer,flatterers
flattering: flattering
flatteringly: flatteringly
flattery: flatteries,flattery
flatulent: flatulent
flavour: flavour
flaxen: flaxen
flea: flea
flee: fled,flee,fleeing,flees
fleeing: fleeing
fleet: fleetest
fleeting: fleeting
flesh: flesh
fleshly: fleshly
flexible: flexible
flicker: flicker,flickering
flies: flies
flight: flight,flights
flippant: flippant
flit: flit
float: floated
flock: flock,flocked,flocks
flood: flood,flooded
floor: floor
flour: flour
flow: flow,flowed,flowing,flows
flower: flowers
fluid: fluid
flute: flute,flutes
flutter: flutter,fluttered,fluttering
flux: flux
fly: flew,flies,flown,fly,flying
flying: flying
foam: foam,foaming
fodder: foddered
foe: foe,foes
foil: foiled
fold: fold,folded,folds
follow: follow
follower: follower,followers
followeth: followeth
folly: follies,folly
fond: fond,fondest
font: font
food: food
fool: fool,fools
foolish: foolish,foolishest
foolisher: foolisher
foolishest: foolishest
foolishly: foolishly
foolishness: foolishness
foot: feet,foot
footed: footed
footing: footing
footpath: footpath,footpaths
footstep: footstep,footsteps
forage: foraged
forbear: forbearing
forbearing: forbearing
forbid: forbid,forbidden
force: force,forced,forces
foreboding: foreboding
forefather: forefather,forefathers
forego: forego
foreground: foreground
foreign: foreign
forelock: forelock
foremost: foremost
forenoon: forenoon
forerunner: forerunner,forerunners
foreseeing: foreseeing
foresight: foresight
forest: forest,forests
foretaste: foretaste
foretell: foretell,foretold
forget: forget,forgetting,forgot,forgotten
forgetful: forgetful
forgetfulness: forgetfulness
forgive: forgive,forgiven
forgiveness: forgiveness
forgotten: forgotten
form: form,formed,forms
format: format,formats
formative: formative
formidable: formidable
formula: formula,formulae
forsake: forsake,forsaken
forsaken: forsaken
forsakenness: forsakenness
forsooth: forsooth
forthwith: forthwith
fortress: fortress
fortunate: fortunate
fortunately: fortunately
fortune: fortune
foster: foster,fostered
foul: foul
foundation: foundation
founder: foundering
fountain: fountain,fountains
fourteenth: fourteenth
fourth: fourth
fox: foxes
fragile: fragile
fragment: fragment,fragments
fragrance: fragrance
frame: frame,framed
france: france
frantic: frantic
frantically: frantically
frau: frau
fray: fray
frederick: frederick
freed: freed
freedman: freedman
freedom: freedom
freely: freely
freeze: freeze,freezing,frozen
french: french
frenzy: frenzy
frequent: frequent
frequently: frequently
fresh: fresh
fret: fretted,fretting
fretful: fretful
friend: friend,friends
friendly: friendly
friendship: friendship,friendships
fright: fright
frighten: frighten,frightened
frightened: frightened
frightening: frightening
frightful: frightful
frightfully: frightfully
frisk: frisk
frivolous: frivolous
fro: fro
frog: frog,frogs
frost: frost
frothily: frothily
frothy: frothy
frown: frowning
frozen: frozen
fruit: fruit,fruits
fuel: fuel
fugitive: fugitive,fugitives
fulfil: fulfilled
fulfill: fulfiller
fulness: fulness
fulsome: fulsome
fume: fume,fumes
fun: fun
function: function,functions
functionary: functionaries
fundamental: fundamental
fundamentally: fundamentally
furbish: furbished
furious: furious
furnace: furnace
furtively: furtively
fury: fury
future: future,futures
gadfly: gadfly
gaily: gaily
gain: gain
gainst: gainst
game: game,games
gangway: gangways
gap: gap
gape: gape
garb: garb
garble: garble
garden: garden,gardens
gargling: gargling
garland: garland
garment: garment
gast: gast
gate: gate,gates
gateway: gateway
gather: gathered
gatherer: gatherers
gaudily: gaudily
gaudy: gaudy
gay: gay
gaze: gaze,gazed,gazing
gear: gear
genealogy: genealogy
genera: genera
generation: generation,generations
generous: generous
genesis: genesis
genius: genius
genoa: genoa
gentle: gentle,gentler,gentlest
gentleman: gentleman
gently: gently
genuine: genuine
george: george
germ: germ
german: german,germans
germany: germany
gesture: gestures
ghastly: ghastly
ghost: ghost,ghosts
giant: giant,giants
giddiness: giddiness
giddy: giddy
gift: gift,gifted,gifts
gild: gild
gilded: gilded
gird: girded
girdle: girdle,girdles
girl: girl,girls
giver: giver
giveth: giveth
glacial: glacial
glad: glad
gladiator: gladiators
gladly: gladly
gladness: gladness
glance: glance,glances
glass: glass,glasses
gleam: gleam,gleams
glitter: glitter,glittering
globe: globe
gloom: gloom
gloomily: gloomily
gloomy: gloomiest,gloomy
glorification: glorification
glorify: glorify,glorifying
glorious: glorious
glory: glories,glory
gloss: glossed
glove: gloves
glow: glow,glowed,glowing,glows
glue: glued
glutton: glutton
gnarled: gnarled
gnash: gnashing
gnashing: gnashing
gnat: gnat,gnats
gnaw: gnawed,gnawing
goad: goad
goal: goal,goals
goat: goat,goats
goatherd: goatherds
goblet: goblet,goblets
goblin: goblins
god: god,gods
godless: godless
godlessness: godlessness
godlike: godlike
godly: godly
gods: gods
goer: goer,goers
gold: gold
golden: golden
goldlike: goldlike
goodly: goodly
goodness: goodness
goose: geese,goose
gorge: gorges
gospel: gospel
gospels: gospels
govern: govern
government: government
grace: grace
graceful: graceful
gracefulness: gracefulness
gracious: gracious
graciousness: graciousness
gradation: gradations
grade: grades
gradually: gradually
graffiti: graffiti
grain: grain,grains
grand: grand,grandest
grandfather: grandfather
grandmother: grandmother,grandmothers
grant: granted,granting
grape: grape,grapes
grasp: grasp,grasped,grasping
grass: grass
grate: grate
grateful: grateful
gratefully: gratefully
gratify: gratify
gratitude: gratitude
gratuitously: gratuitously
grave: grave,graves
gravity: gravity
greatly: greatly
greatness: greatness
greed: greed
greedily: greedily
greek: greek,greeks
green: green,greenest
greet: greet,greeting
greeting: greeting
gregariousness: gregariousness
grey: grey
grief: grief
grieve: grieved
grievous: grievous
grim: grim
grimace: grimace
grin: grinning
grind: grind
grip: grip,grips
grope: grope,groped,groping
gross: gross
ground: ground
groundling: groundlings
grounds: grounds
grove: groves
grovel: grovelling
grow: grew,grow,growing,grown
growl: growl,growled,growling
growth: growth,growths
grub: grub,grubbed
grudge: grudge
gruesomeness: gruesomeness
grumble: grumble
grumblingly: grumblingly
grunt: grunt,grunting
grunting: grunting
guard: guard
guardian: guardian,guardians
guess: guess,guessed
guest: guest,guests
guide: guide,guides
guile: guile
guileful: guileful
guilt: guilt
guilty: guilty
guise: guises
gulf: gulf
gurgle: gurgle,gurgling
gush: gush,gushing
ha: ha
habit: habit,habits
habitually: habitually
hadst: hadst
haggard: haggard
hail: hail,hailing
hailstorm: hailstorm
hair: hair
halcyon: halcyon
hale: hale
hallowed: hallowed
halt: halt,halted,halting
hammer: hammer
hammock: hammocks
hand: hand,handed,hands
handbreadth: handbreadth
handful: handful
handle: handle
handler: handlers
handmaid: handmaid
handsome: handsome
hang: hang,hanging,hangs,hung
hangman: hangman
happen: happen,happened
happily: happily
happiness: happiness
happy: happier,happiest,happy
harbinger: harbinger
harbour: harbour
hard: hard,harder,hardest
harden: harden
hardiness: hardiness
hardness: hardness
hardy: hardy
hark: hark
harlot: harlot,harlots
harm: harm
harmless: harmless
harmonise: harmonise
harmony: harmony
harness: harness,harnessed
harnessed: harnessed
harp: harp,harps
harsh: harsh,harshest
harshly: harshly
hart: hart
harvest: harvest,harvested
hast: hast
haste: haste
hasten: hasten
hastily: hastily
hasty: hasty
hatch: hatch
hate: hate,hated
hateful: hateful
hath: hath
hatred: hatred
haughty: haughty
haunch: haunches
haunchless: haunchless
haunt: haunt,haunts
haunter: haunter
hazard: hazard
hazy: hazy
head: head,headed,heads
heading: headings
headlong: headlong
heal: heal,healed
healing: healing
health: health
healthiness: healthiness
healthy: healthier,healthy
hear: hear,heard,hearing,hears
hearing: hearing
hearken: hearken,hearkened
hearkening: hearkening
hearst: hearst
heart: heart,hearts
hearted: hearted
heartening: heartening
heartily: heartily
heartless: heartless
heartrending: heartrending
hearty: heartier,hearty
heat: heat
heated: heated
heave: heave,heaved
heaven: heaven,heavens
heavenly: heavenly
heavily: heavily
heaviness: heaviness
heavy: heavier,heaviest,heavy
hebrew: hebrew
hebrews: hebrews
hedge: hedges
hedgehog: hedgehogs
heed: heed,heeded
heel: heel,heels
height: height,heights
heir: heir,heirs
hellish: hellish
helm: helm
helmsman: helmsman
hen: hen,hens
henceforth: henceforth
herald: herald,heralds
herb: herb,herbs
herbage: herbage
herbert: herbert
herd: herd,herds
herdsman: herdsman,herdsmen
herdsmen: herdsmen
heredity: heredity
heresy: heresy
heretic: heretic
heretofore: heretofore
heritage: heritage
hero: hero,heroes
heroes: heroes
heroism: heroism
heron: heron
hesitate: hesitating
hesitatingly: hesitatingly
heterodox: heterodox
hew: hewing
hidden: hidden
hide: hidden,hide
hideous: hideous
hiding: hiding
hie: hie
hierolatry: hierolatry
highly: highly
highway: highway
hilarious: hilarious
hill: hill,hills
hind: hind
hindmost: hindmost
hindrance: hindrance
hint: hint,hinted,hints
hire: hire
historical: historical
history: history
histrionic: histrionic
hit: hit
hitherto: hitherto
hoarse: hoarse
hoarseness: hoarseness
hoary: hoary
hobbling: hobbling
hodgepodge: hodgepodge
hohenstaufen: hohenstaufen
hold: held,hold,holding
holder: holder
holiday: holiday
holiness: holiness
hollow: hollow,hollowed,hollowest
holy: holier,holiest,holy
homage: homage
homelike: homelike
homely: homelier
homewards: homewards
homo: homo
honest: honest
honestest: honestest
honestly: honestly
honesty: honesty
honey: honey
honour: honour,honoured,honouring,honours
honourable: honourable
honourableness: honourableness
honourably: honourably
honoured: honoured
hook: hook,hooks
hoot: hooted
hop: hopping
hope: hope,hoped,hopes,hoping
hopeful: hopeful
horizon: horizon
horn: horn,horns
horror: horror
horse: horse,horses
horseback: horseback
hose: hose
hospitable: hospitable
hospital: hospital
host: host,hosts
hostile: hostile
hostility: hostilities,hostility
hosts: hosts
hot: hot
hotchpotch: hotchpotch
hound: hound
hour: hour,hours
hourly: hourly
house: house,houses
hover: hovered,hovering
howl: howl,howled,howling
hubbub: hubbub
hued: hued
hug: hug
huge: huge
hullabaloo: hullabaloo
human: human
humane: humaner
humanity: humanity
humanly: humanly
humble: humble,humbled
humiliate: humiliate
humiliating: humiliating
humiliation: humiliation
humility: humility
humour: humour,humours
hump: hump
hunchback: hunchback,hunchbacks
hunchbacked: hunchbacked
hunger: hunger
hungrily: hungrily
hungry: hungrier,hungry
hunt: hunt,hunted
hunter: hunter
hunting: hunting
huntsman: huntsman,huntsmen
hurl: hurl
hurricane: hurricane
hurry: hurry
hurt: hurt,hurting
husband: husband
hush: hush
huzza: huzza
hybrid: hybrid
hydrate: hydrate
hymn: hymn,hymns
hypocrisy: hypocrisy
hypothesis: hypothesis
hypothetical: hypothetical
ice: ice
ich: ich
iciness: iciness
iconoclast: iconoclast,iconoclasts
icy: icy
idea: idea,ideas
ideal: ideal,ideals
idealise: idealised
idealist: idealist,idealists
identical: identical
identification: identification
identify: identify,identifying
identity: identity
idiosyncracy: idiosyncracy
idle: idle,idling
idleness: idleness
idler: idlers
idol: idol,idols
idolater: idolaters
idolatry: idolatry
ignominy: ignominy
ignorance: ignorance
ignorant: ignorant
iii: iii
illness: illness
illumine: illumine,illumined
illusion: illusion
illustrious: illustrious
image: image
imagination: imagination
imagine: imagine,imagined
imbibe: imbibe
imitate: imitate
immaculate: immaculate
immature: immature
immaturely: immaturely
immemorially: immemorially
immense: immense
immodest: immodest
immodestly: immodestly
immoral: immoral
immoralist: immoralist
immortality: immortality
impart: impart
impatient: impatient
impatiently: impatiently
impel: impel,impelled
imperfect: imperfect
imperfectly: imperfectly
imperiously: imperiously
imperishable: imperishable
impersonal: impersonal
implore: imploring
imploringly: imploringly
imply: implied,implies,imply
impose: impose,imposed,imposes
impossibility: impossibility
impossible: impossible
imposture: imposture
impotence: impotence
impotent: impotent
impression: impression
imprison: imprisoned
improve: improve
improvise: improvised
impudence: impudence
impudent: impudent
impulse: impulse,impulses
impure: impure
impurity: impurities
inability: inability
inaccurate: inaccurate
inadequate: inadequate
inadequately: inadequately
inadvisable: inadvisable
inaudibly: inaudibly
inaugurate: inaugurate
incarnation: incarnation
incendiary: incendiary
incense: incense
incident: incident
incidental: incidental
incisory: incisory
inclination: inclination
incline: incline,inclined
inclined: inclined
include: include,included,includes,including
including: including
inclusive: inclusive
incomparable: incomparable
incomplete: incomplete
inconceivable: inconceivable
incorporation: incorporation
increase: increase,increased,increases,increasing
incurable: incurable
incurably: incurably
indefinitely: indefinitely
indemnify: indemnify
indemnity: indemnity
indented: indented
independence: independence
independent: independent
indescribable: indescribable
indictment: indictment
indifference: indifference
indifferent: indifferent
indignant: indignant
indignantly: indignantly
indirect: indirect
indirectly: indirectly
indiscernible: indiscernible
indiscretion: indiscretion
indispensability: indispensability
indispensable: indispensable
indistinct: indistinct
individual: individual,individuals
individualist: individualist
individuality: individuality
individuals: individuals
indolent: indolent
induce: induced
indulge: indulged,indulging
indulgence: indulgence
indulgently: indulgently
industry: industry
ineffable: ineffable
ineptly: ineptly
inequality: inequality
ineradicable: ineradicable
inevitable: inevitable
inexhaustible: inexhaustible
inexorable: inexorable
inexperienced: inexperienced
infallibility: infallibility
infatuate: infatuated
infatuated: infatuated
infatuation: infatuation
infected: infected
infection: infection
infer: infer
infinite: infinite
infirm: infirm
infirmity: infirmity
inflame: inflame,inflamed
inflate: inflate,inflated
inflated: inflated
inflexible: inflexible
influence: influence
influenza: influenza
infringement: infringement
ingenious: ingenious
ingenuousness: ingenuousness
ingratitude: ingratitude
inhale: inhale,inhaled
inheritor: inheritor
inhuman: inhuman
injunction: injunction
injure: injure,injuring
injured: injured
injurer: injurers
injury: injury
injustice: injustice
ink: ink
inmost: inmost
inn: inn
innermost: innermost
innocence: innocence
innocent: innocent
innocently: innocently
innuendo: innuendos
innumerable: innumerable
inoculate: inoculated
inordinate: inordinate
inordinately: inordinately
inquire: inquire,inquired
inquiringly: inquiringly
insane: insane
insanity: insanity
insatiable: insatiable
insatiably: insatiably
inscribe: inscribe,inscribed
insect: insects
insecurity: insecurity
insensible: insensible
insidious: insidious
insight: insight
insinuate: insinuated
insist: insist,insisted
insistence: insistence
insolent: insolent
inspiration: inspiration
inspire: inspired,inspiring
inspiring: inspiring
instance: instance
instant: instant
instinct: instinct,instincts
instinctively: instinctively
institution: institution
instrument: instrument,instruments
instruments: instruments
insult: insult
insurrection: insurrection
intangible: intangible
integrate: integrated
intellect: intellect
intellectual: intellectual
intellectually: intellectually
intelligence: intelligence
intelligently: intelligently
intend: intended,intending
intensely: intensely
intent: intent
intention: intention
intentionally: intentionally
intercourse: intercourse
interlocutor: interlocutors
interloper: interloper
internal: internal
internally: internally
international: international
interpose: interposing
interpret: interpret,interpreted
interpretation: interpretation,interpretations
interpreter: interpreter
interrogative: interrogative
interrupt: interrupt,interrupted,interrupts
interruption: interruptions
intertwine: intertwined
interval: interval
interview: interview
intimate: intimate
intoxicate: intoxicated
intoxicated: intoxicated
intoxicating: intoxicating
introduce: introduce,introduced,introduces
introduction: introduction
introspective: introspective
invade: invading
invalid: invalid,invalids
invalidity: invalidity
invective: invectives
inveigh: inveighed
invent: invent,invented
inventor: inventors
investigate: investigated,investigating
investigation: investigation,investigations
investigator: investigator
invisible: invisible
invisibly: invisibly
invite: invite,invited,invites
involuntarily: involuntarily
involuntariness: involuntariness
involuntary: involuntary
involved: involved
invulnerable: invulnerable
inwardly: inwardly
iron: iron
irrational: irrational
irreplaceable: irreplaceable
irrepressible: irrepressible
irresolute: irresolute
irrespective: irrespective
irresponsible: irresponsible
irretrievable: irretrievable
irreverence: irreverence
irritate: irritate
irritation: irritation
irs: irs
isabelle: isabelle
isaiah: isaiah
ischia: ischia
island: island,islands
isle: isle,isles
isles: isles
isolate: isolated
isolation: isolation
israel: israel
issue: issue,issues
italics: italics
italy: italy
itch: itch
iv: iv
ivy: ivy
ix: ix
jagged: jagged
jailer: jailer
jangle: jangling
january: january
jaw: jaws
jealous: jealous
jealousy: jealousy
jeopardise: jeopardise
jeremiah: jeremiah
jerk: jerk
jest: jests
jestingly: jestingly
jesus: jesus
jew: jew
jewel: jewel,jewels
jewish: jewish
jews: jews
jingle: jingle,jingling
john: john
joke: joke
jokingly: jokingly
journey: journey,journeys
jovial: jovial
joy: joy,joys
joyful: joyful
joyfully: joyfully
joyous: joyous
joyousness: joyousness
joys: joys
jubilation: jubilation
judaic: judaic
judaism: judaism
judge: judge,judged,judges
judgment: judgment
juice: juice
july: july
jump: jump,jumped
june: june
jurisdiction: jurisdiction
justice: justice
justification: justification
justified: justified
justifier: justifiers
justify: justified,justify
keel: keel
keen: keen
keenly: keenly
ken: ken
kettle: kettle
kettledrum: kettledrums
key: key
keyhole: keyhole
kick: kick
kill: kill,killed
kin: kin
kindle: kindle
kindliness: kindliness
kindly: kindly
kindness: kindness
kine: kine
king: king,kings
kingdom: kingdom,kingdoms
kiss: kiss,kissed,kissing
kitten: kittens
knack: knack
knave: knaves
knee: knee,knees
kneel: kneeling
knife: knife
knight: knights
knitting: knitting
knock: knocked
knot: knot
knower: knower
knoweth: knoweth
knowing: knowing
knowledge: knowledge
label: labels
labour: labour,labouring
labourer: labourer
labyrinthine: labyrinthine
lace: lace
lacerate: lacerated
laceration: laceration
lack: lack,lacking
lacking: lacking
ladder: ladder,ladders
laden: laden
lag: lag
lair: lair
lake: lake
lamb: lamb,lambs
lambkin: lambkins
lambkins: lambkins
lame: lame
lamely: lamely
lament: lament
lamentation: lamentations
land: land,landed,lands
landmark: landmarks
landscape: landscape,landscapes
lane: lane,lanes
language: language,languages
languid: languid
languish: languish,languishing
larcenous: larcenous
lascivious: lascivious
lasciviously: lasciviously
lash: lash
lassitude: lassitude
late: late
laud: laud
laudable: laudable
lauding: lauding
laugh: laugh,laughed,laughing
laughable: laughable
laugher: laugher
laughingly: laughingly
laughter: laughter,laughters
launch: launch
lavish: lavish
law: law,laws
lay: laid,lay,laying,lays
lazy: lazy
le: le
lead: lead,leading,leads,led
leader: leader
leadeth: leadeth
leading: leading
leaf: leaf,leaves
lean: lean,leaner,leaning
leap: leap,leaping,leaps
learn: learn,learned,learning,learnt
learner: learners
learning: learning
leave: leave,leaves,leaving,left
leaven: leaven,leavened
leben: leben
lecture: lectures
leech: leech,leeches
lees: lees
left: left
leg: leg,legs
legal: legal
legalise: legalised
legally: legally
legislator: legislator
leisure: leisure
lend: lend,lends
lengthen: lengthen,lengthened
leonine: leonine
lesson: lessons
letter: letter
level: level,levelled,levels
lever: lever
levity: levity
lewd: lewd
liability: liability
liable: liable
liar: liar,liars
libertine: libertine
liberty: liberty
library: library
lice: lice
license: license
licensed: licensed
licet: licet
lick: lick,licked
licking: licking
lie: lain,lie,lied,lies,lying
liest: liest
lieu: lieu
life: life
lift: lift,lifted
light: light,lighted,lighter,lightest,lights
lighten: lightened
lighthouse: lighthouse
lightly: lightly
lightning: lightning,lightnings
liken: likens
likeness: likeness
lily: lilies
limb: limbs
limit: limit,limited
limitation: limitation
limited: limited
limp: limp,limped
limpid: limpid
lineage: lineage
linger: lingering
link: linked,links
lion: lion,lions
lioness: lioness,lionesses
lip: lip,lips
listen: listen,listened,listening
litany: litany
literally: literally
literary: literary
literature: literature
littler: littler
liv: liv,livest
live: live,lived,living
lively: lively
livest: livest
liveth: liveth
living: living
lizard: lizard
lo: lo
load: load
loadstone: loadstone
loathe: loathe,loathes
loathing: loathing
loathsome: loathsome
locate: located
location: locations
lock: locked,locks
lodging: lodging
loftier: loftier
loftiest: loftiest
loftiness: loftiness
lofty: loftiest,lofty
logical: logical
loin: loins
loitering: loitering
london: london
lone: lone
loneliness: loneliness
lonely: loneliest,lonely
lonesome: lonesome
lonesomeness: lonesomeness
longing: longing,longings
longingly: longingly
loose: loose,loosed
loosen: loosen,loosened
lopping: lopping
lord: lord,lords
lordship: lordship
lose: lose,loses,losing,lost
loss: loss
lost: lost
lot: lot
loud: loud,louder
loudly: loudly
lounger: loungers
lovable: lovable
love: love,loved,loving
loved: loved
loveless: loveless
lovely: lovelier,loveliest,lovely
lover: lover,lovers
loving: loving
lovingly: lovingly
lowing: lowing
lowlander: lowlanders
lowliness: lowliness
loyally: loyally
luck: luck
lucky: lucky
ludicrous: ludicrous
lukewarm: lukewarm
luminous: luminous
lunar: lunar
lure: lure,lured,lures,luring
lurement: lurement
lurk: lurking
lust: lust,lusting,lusts
lustful: lustful
lustfulness: lustfulness
lusting: lusting
lustre: lustre
lustrous: lustrous
lx: lx
lxx: lxx
lying: lying
lyre: lyre,lyres
machine: machine
mad: mad
madcap: madcaps
maddened: maddened
madhouse: madhouse
madman: madman,madmen
madness: madness
maestro: maestro
magazine: magazine
maggot: maggots
magic: magic
magician: magician,magicians
magnanimous: magnanimous
magnificent: magnificent
magnum: magnum
maiden: maiden,maidens
maidlike: maidlike
maidservant: maidservant
maim: maimed
main: main
maintain: maintain,maintained,maintaining
maintainment: maintainment
maitre: maitre
majestic: majestic
majority: majority
maker: maker,makers
makeshift: makeshift
malady: malady
male: male
maleficence: maleficence
malevolence: malevolence
malice: malice,malices
malicious: malicious
maliciously: maliciously
malign: malign
malignant: malignant
maligner: maligner,maligners
malthus: malthus
manage: managed
manager: manager
mane: mane
manhood: manhood
maniac: maniac
manifest: manifest,manifested,manifests
manifestation: manifestations
manifold: manifold
mankind: mankind
manly: manly
manner: manner
mannerism: mannerisms
manners: manners
manoir: manoir
manslaughter: manslaughter
mantle: mantle
manuscript: manuscript
mar: marred
march: marching
maria: maria
mark: mark,marked
market: market,markets
marriage: marriage,marriages
married: married
marsh: marsh
marshal: marshalled
marvel: marvel,marvelled,marvels
marvelling: marvelling
marvellous: marvellous
mask: mask,masked,masks
mass: mass
mast: masts
master: master,mastered,mastering,masters
mastiff: mastiffs
match: matched
mate: mate
maternity: maternity
matter: matter,matters
mature: mature
maturity: maturity
maw: maws
mawkish: mawkish
maxim: maxim,maxims
maximum: maximum
mayest: mayest
mayst: mayst
meadow: meadow,meadows
meagre: meagre
meaning: meaning
meant: meant
measurable: measurable
measure: measure,measures
meat: meat
mediator: mediators
medicine: medicine
mediocre: mediocre
mediocrity: mediocrity
meditate: meditated
meditation: meditation
mediterranean: mediterranean
medium: medium
meekness: meekness
meet: meet,meeting,meets,met
meeting: meeting
melancholic: melancholic
melancholy: melancholy
mellow: mellow
melody: melody
melt: melt,melting
melting: melting
memento: memento
memorial: memorials
memory: memory
mendacious: mendacious
mendicant: mendicant
mental: mental
mention: mention,mentioned
merchant: merchants
merchantability: merchantability
merciful: merciful
mere: mere
merit: merit,merited
merrily: merrily
merriment: merriment
merry: merrier,merry
messmate: messmate
metamorphoses: metamorphoses
metamorphosis: metamorphoses,metamorphosis
metaphysical: metaphysical
method: method,methods
michael: michael
midday: midday
middle: middle
midnight: midnight
midriff: midriff
midst: midst
midway: midway
mien: mien
mightier: mightier
mighty: mightiest,mighty
mild: mildest
mile: miles
military: military
milk: milk
millennium: millenniums
millstone: millstone,millstones
mind: mind,minds
minded: minded
mingle: mingled
minor: minor
minority: minority
minstrel: minstrel
miracle: miracle
mire: mire
mirror: mirror,mirrors
mirth: mirth
mis: mis
misanthropic: misanthropic
miscalculate: miscalculated
miscarry: miscarried
mischief: mischief
mischievous: mischievous
mischievously: mischievously
mise: mise
miserable: miserable
misery: miseries,misery
misfortune: misfortune
misheard: misheard
mishmash: mishmash
misinterpretation: misinterpretations
misjudge: misjudge,misjudged
mislead: mislead,misled
misshapen: misshapen
mission: mission
mississippi: mississippi
mist: mist
mistake: mistake,mistaken,mistakes
mistaken: mistaken
mistress: mistress
misunderstand: misunderstand,misunderstood
misunderstanding: misunderstanding,misunderstandings
mitigate: mitigate
mix: mix,mixed
mixed: mixed
mixer: mixers
mob: mob
mobile: mobile
mock: mock,mocked,mocking
mocker: mocker
mockery: mockery
mockingly: mockingly
mode: mode,modes
moderate: moderate
moderation: moderation
modern: modern
modest: modest
modestly: modestly
modesty: modesty
modicum: modicum
modification: modification
modify: modified,modify,modifying
modulation: modulation
moist: moist
mole: mole,moles
mollusc: molluscs
mollycoddle: mollycoddles
molten: molten
moment: moment,moments
momentary: momentary
monastery: monasteries
money: money
mong: mong
monition: monition
monk: monk
monkey: monkey
monster: monster,monsters
monstrous: monstrous
month: month,months
monument: monuments
mood: mood
moon: moon,moons
moonlight: moonlight
moorish: moorish
moory: moory
moral: moral,morals
moralist: moralist,moralists
morality: moralities,morality
morally: morally
morals: morals
morbid: morbid
morn: morn
morning: morning
morosely: morosely
morrow: morrow
mortal: mortal,mortals
mortally: mortally
mortify: mortify
moss: moss
moth: moth
mother: mother,mothers
motherland: motherlands
motion: motion
motionless: motionless
motive: motive,motives
motley: motley
motleyest: motleyest
mottled: mottled
mould: mould
moulded: moulded
moulder: mouldering
mouldered: mouldered
mount: mount,mounted
mountain: mountain,mountains
mountebank: mountebanks
mourn: mourn
mournful: mournful
mouse: mouse
mouth: mouth,mouths
mouthful: mouthful
mouthpiece: mouthpiece
movement: movement,movements
mucilage: mucilage
mucus: mucus
mud: mud
muddle: muddle
muddy: muddy
mule: mules
multiplicity: multiplicity
multitude: multitude
mumble: mumble
mumbler: mumblers
mumbling: mumbling
mummer: mummers
mummery: mummery
mummy: mummies,mummy
munificence: munificence
murder: murder,murdered
murderer: murderer
murderous: murderous
murmur: murmured
murmuring: murmuring
muscle: muscles
muscular: muscular
muse: muse
music: music
musical: musical
musician: musician
mustily: mustily
musty: musty
mute: mute
mutely: mutely
muteness: muteness
mutter: mutter
muzzle: muzzle
mysterious: mysterious
mysteriously: mysteriously
mystery: mysteries,mystery
mystifier: mystifiers
nag: nagged
nail: nailed,nailing
naively: naively
naked: naked
nakedness: nakedness
nameless: nameless
narrate: narrate,narrated
narrative: narrative
narrator: narrators
narrow: narrow,narrowest
nastiness: nastiness
nation: nation
natural: natural
naturalist: naturalist,naturalists
naturally: naturally
nature: nature
natured: natured
naught: naught
naughty: naughty
nausea: nausea
navel: navel
naysayer: naysayer
nazarene: nazarene
nearness: nearness
neath: neath
nebulous: nebulous
necessity: necessity
neck: neck,necks
necked: necked
necromancer: necromancer
needful: needful
needfulness: needfulness
needless: needless
negation: negation
negligence: negligence
neigh: neigh
neighbour: neighbour,neighbouring,neighbours
neighbourhood: neighbourhood
neighbourliness: neighbourliness
nest: nest
nether: nether
network: network
newsletter: newsletter
newspaper: newspaper,newspapers
nibble: nibbled
nice: nice
nicely: nicely
nickname: nickname
nietzsche: nietzsche
nietzschean: nietzschean
niggard: niggard
nigh: nigh
nigher: nigher
nighest: nighest
nighness: nighness
night: night,nights
nightly: nightly
nightward: nightwards
nihilism: nihilism
nimble: nimble,nimblest
nimbly: nimbly
nineteenth: nineteenth
ninth: ninth
noah: noah
nobility: nobility
noble: noble,nobler,noblest
nocturnal: nocturnal
nod: nod,nodded
noise: noise,noises
noisiest: noisiest
noisy: noisy
nondescript: nondescript
nonproprietary: nonproprietary
nonsense: nonsense
noon: noon
noonday: noonday
noontide: noontide,noontides
normal: normal
north: north
nose: nose,noses
nostril: nostrils
note: note,notes
nothingness: nothingness
notice: notice
noticeable: noticeable
notify: notifies
notion: notion,notions
nourish: nourish,nourished
nourished: nourished
nourishment: nourishment
november: november
nowadays: nowadays
numerous: numerous
nursery: nursery
nut: nut,nuts
nuts: nuts
oak: oak
oar: oars
oasis: oases,oasis
oath: oaths
obdurately: obdurately
obedience: obedience
obedient: obedient
obediently: obediently
obey: obey,obeying
obeyer: obeyers
object: object,objected
objection: objection,objections
objectivity: objectivity
obligation: obligation,obligations
oblige: obliged,obliging
obscure: obscure
obscurity: obscurities,obscurity
obsequent: obsequent
obsequious: obsequious
observance: observance
observation: observations
observe: observe
observer: observer
obsess: obsessed
obsolete: obsolete
obstacle: obstacle,obstacles
obstinacy: obstinacy
obstinate: obstinate
obstinately: obstinately
obtrusion: obtrusion
obtrusive: obtrusive
obtrusiveness: obtrusiveness
obvious: obvious
occasion: occasion
occasional: occasional
occident: occident
occidental: occidental
occidentals: occidentals
occupy: occupied
occur: occur,occurred,occurring,occurs
octavius: octavius
odious: odious
odour: odour,odours
odoured: odoured
offensive: offensive
offer: offer,offered,offering,offers
offering: offerings
office: office
official: official
oft: oft
ofttime: ofttimes
ofttimes: ofttimes
ogle: ogled,ogling
olive: olive
omega: omega
omen: omen
omission: omissions
omit: omit
omniscient: omniscient
oneself: oneself
online: online
onward: onward
onwards: onwards
openly: openly
operate: operate
operation: operation
operative: operative
opinion: opinion,opinions
opportunity: opportunities,opportunity
oppose: opposed
opposed: opposed
oppress: oppressed
oppressed: oppressed
oppressing: oppressing
oppressive: oppressive
optimism: optimism
optimistically: optimistically
opus: opus
orb: orb
orbit: orbit
ordinary: ordinary
ore: ore
organ: organ,organs
organic: organic
organise: organised
organised: organised
organism: organism,organisms
organize: organized
orient: orient
oriental: oriental
origin: origin,origins
original: original
originally: originally
originate: originate,originated
originator: originator
orthodox: orthodox
orthodoxy: orthodoxy
ostrich: ostrich
outburst: outburst,outbursts
outcast: outcast
outcry: outcry
outdated: outdated
outlook: outlook,outlooks
outrage: outrage,outrages
outstretched: outstretched
outward: outward
outwardly: outwardly
outwit: outwit
overcome: overcame,overcome,overcoming
overdrunk: overdrunk
overflow: overflow,overflowing
overfull: overfull
overhead: overhead
overheated: overheated
overleap: overleap
overleapt: overleapt
overlook: overlook,overlooked
overmuch: overmuch
overpersuade: overpersuade
overpower: overpowering
overreach: overreaching
oversleep: overslept
overspread: overspread
overswinging: overswinging
overtake: overtake,overtaken
overthrow: overthrow
overwhelming: overwhelming
owe: owe,owed
owl: owl,owls
owner: owner
ox: ox
oyster: oyster
pace: paces
padded: padded
paean: paean
pagan: pagan
pail: pail
pain: pain,pains
painful: painful
painfullest: painfullest
paint: paint,painted,paints
pair: pair,paired,pairs
palate: palates
palazzo: palazzo
pale: pale
pallid: pallid
palm: palm,palms
pamphlet: pamphlet
pane: panes
pang: pangs
panther: panther
pantherlike: pantherlike
panting: panting
paper: paper
paperwork: paperwork
par: par,pars
parable: parable,parables
parade: parade
paradisal: paradisal
paradise: paradises
paragon: paragon
paragraph: paragraph,paragraphs
paralyse: paralysing
paralysed: paralysed
paralysing: paralysing
paramount: paramount
parasite: parasite,parasites
pardon: pardon,pardons
parent: parents
parody: parody
parqueted: parqueted
parsifal: parsifal
partake: partake
partaker: partakers
partially: partially
participate: participate
particle: particle
partly: partly
party: party
pass: pass,passed,passing
passage: passage,passages
passer: passers
passion: passion,passions
passionate: passionate
passionately: passionately
passions: passions
passive: passive
pastime: pastime
pasture: pasture
patch: patches
path: path,paths
pathos: pathos
pathway: pathways
patience: patience
patient: patient
patientest: patientest
patiently: patiently
patter: patter
paul: paul
pause: pause,paused
paw: paw,paws
pay: paid,pay,paying,pays
paymaster: paymaster
payment: payments
peace: peace
peaceable: peaceable
peaceful: peaceful
peacefully: peacefully
peacock: peacock,peacocks
peak: peak,peaks
peal: peal,peals
pearl: pearls
peasant: peasant
pebble: pebbles
peck: peck
peculiar: peculiar
peer: peer
peevish: peevish
pen: pen
penalty: penalties,penalty
penance: penance
pencil: pencilled,pencils
penetrate: penetrate,penetrated,penetrating
penitence: penitence
penitent: penitent,penitents
penitential: penitential
penny: pennies
penultimate: penultimate
people: peoples
peoples: peoples
perambulate: perambulating
perceive: perceive,perceived
perception: perception,perceptions
perch: perched
perchance: perchance
perfect: perfect
perfection: perfection
perfectly: perfectly
perforce: perforce
perform: perform,performed,performing
performance: performance,performances
perfume: perfume
perilous: perilous
period: period,periods
periodic: periodic
perish: perish,perished,perishing
perishable: perishable
perishableness: perishableness
perishing: perishing
perjurer: perjurers
permanent: permanent
permission: permission
permit: permitted
pernicious: pernicious
perplexity: perplexity
persecute: persecute,persecuted
persecution: persecution
persian: persian,persians
persist: persist
persistent: persistent
persistently: persistently
person: people,person,persons
personal: personal
personality: personality
personally: personally
perspiration: perspiration
perspire: perspired
persuade: persuade,persuaded,persuading
persuasive: persuasive
pertain: pertain
pessimism: pessimism
pessimist: pessimist,pessimists
pessimistic: pessimistic
pestle: pestles
peter: peter
pettily: pettily
pettiness: pettiness
petty: petty
phantasy: phantasies,phantasy
phantom: phantom,phantoms
pharisees: pharisees
phenomena: phenomena
philanthropist: philanthropist
philanthropy: philanthropy
philologist: philologists
philosopher: philosopher,philosophers
philosophical: philosophical
philosophy: philosophy
phoenix: phoenix
phrase: phrase,phrases
physical: physical
physician: physician,physicians
physiological: physiological
piano: piano
piazza: piazza
pick: pick,picked
picker: pickers
pickpocket: pickpockets
picture: picture,pictured,pictures
pie: pied
piece: piece,pieces
pied: pied
pier: piers
pierce: pierce,pierced,piercing
piety: piety
pig: pig
pillar: pillar,pillars
pillow: pillows
pin: pin
pinchbeck: pinchbeck
pine: pine,pines
pinion: pinion,pinions
pioneer: pioneers
pious: pious
piously: piously
pipe: pipe,pipes
piper: piper
piping: piping
pit: pit,pits,pitted
pitch: pitch
pitiable: pitiable
pitiably: pitiably
pitiful: pitiful
pity: pity,pitying
plagiarise: plagiarised
plague: plague
plain: plain,plainest,plains
plainly: plainly
plaint: plaint,plaints
plan: plan
plank: planks
plant: plant,plants
plantation: plantation
plash: plashing
plastic: plastic
plat: plat
platter: platters
play: play,played,playing,plays
player: player,players
playfully: playfully
playfulness: playfulness
playmate: playmates
plaything: plaything,playthings
plea: plea
plead: plead
pleading: pleading
pleasant: pleasant,pleasanter
pleasantly: pleasantly
pleasantry: pleasantry
pleased: pleased
pleasing: pleasing
pleasingly: pleasingly
pleasure: pleasure,pleasures
pledge: pledge,pledged,pledging
plenteously: plenteously
plenum: plenum
plexus: plexus
pliant: pliant
plough: ploughing
ploughshare: ploughshare
pluck: pluck
plume: plume,plumes
plump: plump
plunder: plundering
plunge: plunge,plunged
plurality: plurality
poem: poem
poet: poet,poets
poetaster: poetasters
poetess: poetess
poetic: poetic
poetical: poetical
poetry: poetry
poise: poised
poison: poison,poisoned,poisons
poisoner: poisoners
poisonous: poisonous
poke: poking
pole: pole
polemical: polemical
policeman: policemen
policy: policy
politeness: politeness
political: political
politics: politics
polluted: polluted
pollution: pollution
pomp: pomp
pond: ponds
ponder: pondering
pontiff: pontiff
pool: pools
poor: poor,poorer,poorest
pope: pope
poppy: poppies,poppy
populace: populace
popular: popular
portal: portals
portent: portent
portentous: portentous
portion: portion,portions
porto: porto
portrait: portrait
position: position,positions
possess: possess,possessed,possesses,possessing
possessedness: possessedness
possession: possession
possessor: possessor
possibility: possibility
post: post,posted
posterity: posterity
posthumously: posthumously
posts: posts
postscript: postscript
posturing: posturing
pot: pot,pots
potent: potent
potentate: potentate
potter: potter
pouncing: pouncing
pour: pour
poverty: poverty
power: power,powers
powerful: powerful
practically: practically
practice: practice
practise: practise,practised,practises,practising
prairie: prairie
praise: praise,praised,praises,praising
praiser: praiser
prate: prate
pray: pray,prayed,praying
prayer: prayers
preach: preach,preached
preacher: preacher,preachers
preachers: preachers
preaching: preaching
precaution: precaution
precede: precede,preceded
precept: precept,precepts
preceptor: preceptors
precinct: precincts
precious: precious
precipice: precipice
precipitous: precipitous
precisely: precisely
precision: precision
precursor: precursors
predestine: predestined
predilection: predilection
preface: preface
prefer: prefer
preferably: preferably
pregnancy: pregnancy
pregnant: pregnant
prejudice: prejudice
prelude: prelude
premature: premature
premonition: premonitions
preparation: preparation
prepare: prepare,prepared
prepared: prepared
prerequisite: prerequisites
presage: presage,presaged,presaging
presence: presence
presently: presently
preservation: preservation
preserve: preserve,preserved,preserves
preside: presided
press: press,pressed,pressing
pressure: pressure
presume: presume
presumption: presumption
presumptuousness: presumptuousness
pretend: pretend
pretty: pretty
prevalence: prevalence
prevent: prevent,prevented
previous: previous
prey: prey,preying
price: price
prick: prick
prickly: prickly
pride: pride
priest: priest,priests
primary: primary
primate: primates
primitive: primitive
prince: prince,princes
principle: principle,principles
print: print,printed
prison: prison,prisons
prisoner: prisoner,prisoners
private: private
privately: privately
privation: privations
privilege: privilege
probability: probability
proceed: proceed,proceeded,proceeding,proceeds
proceeds: proceeds
process: process,processes
processing: processing
procession: procession
proclaim: proclaimed
proclaimer: proclaimer
procreate: procreating
procreation: procreation
procreator: procreators
prodigious: prodigious
prodigy: prodigy
produce: produce,produced,producing
product: product
production: production
profess: profess
professional: professional
professor: professor
profit: profit,profits
profound: profound,profoundest
profoundly: profoundly
profoundness: profoundness
prognostic: prognostic
prognosticator: prognosticator
progress: progress
prohibition: prohibition
project: project,projected
prologue: prologue
prolonged: prolonged
prominent: prominent
prominently: prominently
promiscuous: promiscuous
promise: promise,promised,promising
promiser: promiser
promontory: promontory
promote: promote,promoted,promotes,promoting
promotion: promotion
prompter: prompter
prompting: promptings
promulgate: promulgated
prone: prone
pronounced: pronounced
pronouncement: pronouncements
proof: proof,proofs
proofread: proofread
propagate: propagate
proper: proper
properly: properly
property: property
prophet: prophet,prophets
prophetic: prophetic
proportion: proportion
proposal: proposal
proprietary: proprietary
prospective: prospective
prostitution: prostitution
prostrate: prostrate,prostrated
protect: protect,protected,protecting
protection: protection
protest: protest
proudly: proudly
prove: prove,proved,proves,proving
proverb: proverb,proverbs
proverbs: proverbs
provide: provide,providing
providence: providence
province: province
provision: provision,provisions
provoke: provoke
prowl: prowl,prowled
proximity: proximity
prudence: prudence
prudent: prudent
prudently: prudently
pry: prying
prying: prying
psalm: psalm
psalmodic: psalmodic
psychological: psychological
psychology: psychology
public: public
publication: publication,publications
publish: published
publisher: publisher,publishers
puff: puffed
pull: pull,pulled,pulling,pulls
punctuation: punctuation
punish: punish,punishing
punishment: punishment
punitive: punitive
puny: puny
pupil: pupils
puppet: puppet,puppets
purblind: purblind
purchase: purchase,purchased
purchaser: purchaser
pure: pure,purest
purely: purely
purge: purged
purify: purify
puritans: puritans
purity: purity
purlieus: purlieus
purple: purple
purpose: purpose
purposer: purposer
purr: purr
pursue: pursue,pursued,pursues
pursuit: pursuit
push: push,pushed,pushing
pusillanimous: pusillanimous
putridly: putridly
puzzle: puzzle,puzzles
pyramidal: pyramidal
pyre: pyres
quaff: quaffed
quail: quail
quake: quaked
quality: qualities,quality
quarrel: quarrel
quarter: quarter
quench: quench
quest: quest
question: question,questioning,questions
questionable: questionable
questioning: questioning,questionings
questioningly: questioningly
quick: quick
quiet: quiet
quietly: quietly
quiver: quivering
quod: quod
quotation: quotations
rabbit: rabbits
rabble: rabble
race: race,races
races: races
racing: racing
rack: racked
radically: radically
rag: rag,rags
rage: rage,raged,raging
rail: rail
railing: railing,railings
raillery: raillery
raiment: raiment
rain: rain
rainbow: rainbow,rainbows
rainy: rainy
raise: raise,raised,raises,raising
rally: rally
rambler: rambler
range: range
rank: rank
ransom: ransom
rapacity: rapacity
rapallo: rapallo
rapid: rapid
rapidly: rapidly
rapture: rapture,raptures
rapturous: rapturous
rare: rare,rarer,rarest
rarely: rarely
rashly: rashly
rate: rate
rationality: rationality
rattle: rattle,rattling
raving: raving
ray: ray
reach: reach,reached,reaches,reaching
read: read,reading,reads
readable: readable
reader: reader,readers
reading: reading
ready: readiest,ready
real: real,realer
realise: realise,realised,realises
reality: realities,reality
realm: realm
reap: reaped
reaper: reapers
rear: rear,reared,rearing
rearing: rearing
reason: reason,reasons
reasonable: reasonable
reawaken: reawakened
rebel: rebel
rebellious: rebellious
rebuke: rebukes
recall: recalls
recede: receded
receipt: receipt
receive: receive,received,receives,receiving
receiver: receiver
reception: reception
rechristen: rechristening
reckon: reckoned
reckoning: reckoning
recline: recline
recluse: recluse
recognise: recognise,recognised,recognising
recognition: recognition
recoil: recoil,recoils
recollection: recollection,recollections
recommend: recommending
recompense: recompense
reconcile: reconcile,reconciled
reconciler: reconcilers
reconciliation: reconciliation,reconciliations
recondite: recondite
reconnoitre: reconnoitre
reconsider: reconsider
record: record
recourse: recourse
recover: recover,recovered,recovering
recovery: recovery
recreation: recreation
rectangular: rectangular
recuperate: recuperate
recur: recurring
recurrence: recurrence
red: red
redeem: redeem,redeemed
redeemer: redeemer
redeeming: redeeming
redemption: redemption
redistribute: redistribute,redistributing
redistributing: redistributing
redistribution: redistribution
reel: reel,reeling
reeve: rove
refer: refer,referred,referring,refers
reference: reference,references
refine: refined
refined: refined
reflect: reflecting
reflection: reflection
reform: reforming,reforms
reformer: reformer
refractory: refractory
refrain: refrain,refraining
refresh: refresh,refreshing
refreshing: refreshing
refreshment: refreshment
refrigerate: refrigerated
refuge: refuge
refund: refund
refuse: refuses
refutation: refutation,refutations
refute: refute,refuted
regain: regained
regard: regard,regarded
region: regions
register: registered
regret: regret
regulate: regulating
reign: reigning
rein: reins
reinstate: reinstate
rejoice: rejoice,rejoiced,rejoicing
rejoicer: rejoicers
rejoicing: rejoicing
rejuvenated: rejuvenated
relapse: relapse
relate: relate,relating
relation: relation,relations
relationship: relationship
relative: relative,relatives
relativist: relativist
relativity: relativity
relax: relax,relaxed
relaxation: relaxation
relaxed: relaxed
release: release
relief: relief
relieve: relieve
relieved: relieved
religion: religion
religious: religious
remain: remain,remained,remaining,remains
remark: remark,remarks
remarkable: remarkable
remedy: remedies
remember: remember,remembered
remembrance: remembrance,remembrances
remind: reminded
reminiscent: reminiscent
remnant: remnant
remote: remote,remoter,remotest
remotely: remotely
remoteness: remoteness
remoter: remoter
remove: remove,removed
renaissance: renaissance
rename: renamed
rend: rend,rending
render: render,rendered
renounce: renounce,renounced,renounces
renowned: renowned
renunciation: renunciation
repast: repast,repasts
repay: repay
repeat: repeated
repel: repelled,repelling
repetition: repetitions
replace: replace
replacement: replacement
reply: replied,replies,reply
report: reported,reports
repose: repose
represent: represent,represented,representing,represents
representation: representations
reproach: reproach,reproaches
reprobate: reprobate
reprove: reproving
reptile: reptile
repugnant: repugnant
repulsive: repulsive
reputation: reputation
repute: repute
request: request,requests
require: require,required,requires
requirement: requirements
requisite: requisite
requital: requital
requite: requite
resemble: resemble
resent: resented,resenting
resentful: resentful
resentment: resentment
reservation: reservation
reserve: reserve
reside: reside
resignation: resignation
resist: resist,resisted,resists
resistance: resistance
resolution: resolution
resolve: resolved,resolving
resort: resort
resound: resound,resounded
respect: respect,respected,respecting
respectable: respectable
respects: respects
respond: respond
response: response
responsibility: responsibility
responsible: responsible
rest: rest,rested,resting
restate: restate
resting: resting
restless: restless
restore: restored
restrain: restrain,restrained
restrict: restricted
restricted: restricted
restrictedly: restrictedly
restriction: restrictions
result: result
resurrect: resurrected
resurrection: resurrections
retain: retain
retaliate: retaliates
retire: retire,retired,retiring
retreat: retreat,retreated
retribution: retribution
retrieve: retrieve
return: return,returned,returning,returns
reveal: reveal,revealed,reveals
revelation: revelation
reveller: reveller
revenge: revenge,revenged
revengeful: revengeful
revengefulness: revengefulness
revenue: revenue
revere: revered,reveres
reverence: reverence
reverent: reverent
reverential: reverential
reverentially: reverentially
reverently: reverently
reverer: reverers
reverse: reverse,reversed
reversed: reversed
revile: revile,reviled
revise: revised
revisit: revisiting
revive: revived
revolution: revolution,revolutions
revolutionist: revolutionists
revolve: revolve,revolved
revulsion: revulsion
reward: reward,rewarded
rhyme: rhyme,rhymed,rhymes
rhythm: rhythm
rhythmic: rhythmic
rib: ribs
rich: rich,richest
richard: richard
riches: riches
richter: richter
rid: rid
riddle: riddle,riddles
ride: ride
rider: rider
ridge: ridge,ridges
rife: rife
righteous: righteous
righteousness: righteousness
rightly: rightly
rigorous: rigorous
rigorously: rigorously
rip: ripped
ripe: ripe
ripen: ripened
rise: rise,risen,rises,rising,rose
risk: risk,risked
rival: rival
river: river
road: road,roads
roadstead: roadstead
roar: roar,roared,roaring
roaring: roaring
roast: roast
rob: rob,robbed,robbing
robber: robber,robbers
robbing: robbing
robust: robust
rock: rock,rocks
rod: rod,rods
rogue: rogue
roguish: roguish
roguishness: roguishness
role: role
roll: roll,rolled,rolling
rolling: rolling
roman: roman
rome: rome
romp: romp
roof: roof,roofs
root: root,roots
rope: rope,ropes
rose: rose,roses
rosy: rosy
rot: rot
rotten: rotten
rottenness: rottenness
rough: rough
rounded: rounded
roundelay: roundelay
route: route
rove: rove,roved,roving
rover: rover
roving: roving
row: row
royalty: royalties,royalty
rub: rub
rubbish: rubbish
ruffle: ruffled
rugged: rugged
ruin: ruin,ruined,ruins
rule: rule,ruled,rules,ruling
ruler: ruler,rulers
ruling: ruling
rumble: rumbling
ruminate: ruminate,ruminating
ruminating: ruminating
rumour: rumour,rumoured
runner: runners
runneth: runneth
rupture: ruptured
ruse: ruse
rush: rush,rushed
rustiest: rustiest
rustling: rustling
ruthlessly: ruthlessly
sack: sack,sacks
sacred: sacred
sacrifice: sacrifice,sacrificed,sacrifices,sacrificing
sacrificer: sacrificers
sacrificial: sacrificial
sad: sad
saddle: saddles
sadly: sadly
sadness: sadness
sagacious: sagacious
sagacity: sagacities,sagacity
sage: sage,sages
sagely: sagely
sail: sail,sails
sailor: sailor,sailors
saint: saint,saints
saintship: saintship
saith: saith
sake: sake
sallow: sallow
salt: salt
salubrity: salubrities
salvation: salvation
sanctify: sanctified,sanctify
sanctuary: sanctuary
sand: sand,sands
santa: santa
sap: sapped
satiety: satiety
satire: satire
satisfaction: satisfaction
satisfied: satisfied
satisfiedness: satisfiedness
satisfy: satisfy
satyr: satyrs
savage: savages
save: save,saved,saving
savior: savior
saviour: saviour,saviours
saviours: saviours
savour: savour
savoury: savoury
sayer: sayer
sayest: sayest
scab: scab
scabby: scabby
scale: scale,scales
scanty: scanty
scarcely: scarcely
scare: scare
scarecrow: scarecrow
scared: scared
scarer: scarers
scathing: scathing
scatter: scattered
scene: scene,scenes
scent: scented
scented: scented
scepticism: scepticism
scholar: scholar,scholars
school: school
schoolboy: schoolboys
schooling: schooling
schopenhauerian: schopenhauerian
science: science
scientific: scientific
scientist: scientists
scoffer: scoffer
scope: scope
scorch: scorch,scorched
score: scoring
scorn: scorn
scorner: scorner
scornful: scornful
scornfully: scornfully
scorpion: scorpion
scourge: scourge
scrap: scraps
scrape: scrape
scratch: scratch
scrawling: scrawling
scream: scream,screamed
scribble: scribbling
scribe: scribe
scrupulously: scrupulously
scrutinise: scrutinised,scrutinising
scuffle: scuffle
sculptor: sculptor
scum: scum
scurry: scurry
sea: sea,seas
seafarer: seafarer
seal: seal,seals
sealike: sealike
seals: seals
seaman: seaman
search: search
searcher: searcher
searching: searching
season: season
seat: seat,seated,seats
secede: seceding
secondary: secondary
secrecy: secrecy
secret: secret,secrets
secretest: secretest
secretly: secretly
sectarians: sectarians
secure: secure
security: securities,security
seditious: seditious
seduce: seduce,seduced,seducing
seed: seed
seek: seek,seeking,sought
seeker: seeker
seeking: seeking
seer: seer
seethe: seethed
seize: seize,seized,seizing
selah: selah
seldom: seldom
seldomer: seldomer
select: select
selection: selection
selfish: selfish
selfishness: selfishness
selfless: selfless
selfsame: selfsame
sell: sold
semblance: semblance
send: send,sending,sends
senior: senior
sensation: sensation,sensations
sensational: sensational
sense: sense
sensitive: sensitive
sensual: sensual
sensualist: sensualists
sensuality: sensuality
sentence: sentence
sentiment: sentiment,sentiments
sentimental: sentimental
separate: separate,separated
separation: separation
september: september
sequester: sequestered
serene: serene
serenity: serenity
series: series
seriousness: seriousness
sermon: sermon
serpent: serpent,serpents
servant: servant,servants
serve: serve,served,serving
service: service,services
servile: servile
servitude: servitude
set: set
settle: settled
seventh: seventh
sever: severed
severe: severe,severest
severely: severely
severity: severity
sex: sex,sexes
shackle: shackles
shade: shade
shades: shades
shadow: shadow,shadows
shadowy: shadowy
shady: shady
shaft: shaft
shaggily: shaggily
shaggy: shaggy
shake: shake,shaken,shaking,shook
shallow: shallow
shalt: shalt
shambles: shambles
shame: shame
shamefast: shamefast
shameless: shameless
shamelessly: shamelessly
shape: shape,shaped
share: share,shared,sharing
shared: shared
sharp: sharp,sharper,sharpest
sharpen: sharpened
shatter: shatter,shattered
shattered: shattered
sheep: sheep
sheepish: sheepish
sheeplike: sheeplike
sheet: sheet
shelter: shelter
shelve: shelved
shepherd: shepherd,shepherds
shift: shifted,shifting
shine: shine,shining,shone
ship: ship,ships
shipwrecked: shipwrecked
shiver: shiver,shivering
shoe: shoe,shoes
shoot: shoot,shot
shopkeeper: shopkeepers
shopman: shopman,shopmen
shore: shore,shores
short: short,shortest
shortly: shortly
shot: shot
shoulder: shoulder,shoulders
shouldest: shouldest
shouldst: shouldst
shout: shout,shouted,shouting,shouts
shouting: shouting
shower: showered,showers
shred: shreds
shrewd: shrewd,shrewder
shriek: shrieked
shrill: shrill
shrink: shrank
shrivel: shrivelled
shroud: shroud,shrouded
shrub: shrub
shrug: shrugged
shudder: shudder,shuddered
shun: shun,shunning
shut: shut
shy: shy
shyly: shyly
sick: sick
sickening: sickening
sickle: sickle,sickles
sickly: sickliest,sickly
sickness: sickness
sidelong: sidelong
sigh: sigh,sighed,sighing
sighing: sighing
sight: sight,sights
sighted: sighted
sign: sign,signs
significance: significance
signification: signification
signify: signify,signifying
silence: silence,silenced
silent: silent
silently: silently
silk: silk
silly: silly
silver: silver
silvery: silvery
simile: simile,similes
simple: simple,simplest
simpleton: simpletons
simplicity: simplicity
simply: simply
simultaneously: simultaneously
sin: sin,sinning
sincerely: sincerely
sincerity: sincerity
sinful: sinful
sing: sang,sing,singing,sings,sung
singe: singed
singer: singer,singers
singing: singing
single: single
singly: singly
singular: singular
sinister: sinister
sink: sank,sink,sinking,sunk,sunken
sinking: sinking
sinner: sinner,sinners
sinuous: sinuous
sip: sipped
sister: sister
sit: sat,sit,sitting
sitting: sitting
situation: situation
sixth: sixth
sized: sized
skeleton: skeleton
sketch: sketch,sketched,sketching
skilful: skilful
skin: skin,skins
skirt: skirting
skulk: skulking
skulker: skulkers
sky: sky
slam: slammed
slander: slander
slate: slate
slaughter: slaughter,slaughtered
slave: slave,slaves
slavery: slavery
slay: slain,slay,slew
slayer: slayer,slayers
slaying: slaying
sleek: sleek
sleep: sleep,sleeping,slept
sleeper: sleeper,sleepers
sleepless: sleepless
sleepy: sleepy
slender: slender
sleuth: sleuth
slide: slide
slight: slight
slim: slim
slime: slime
sling: sling
slink: slink
slip: slip,slipped
slippery: slippery
slope: slopes
sloth: sloths
slothfulness: slothfulness
slow: slow
slowly: slowly
sluggard: sluggard,sluggards
slum: slum
slumber: slumber
slumbering: slumbering
slur: slur
sly: sly
smack: smacked,smacking
smallness: smallness
smart: smarting
smell: smell,smelling,smells,smelt
smile: smile,smiled,smiling
smirking: smirking
smite: smite
smith: smith
smitten: smitten
smoke: smoke,smoked
smoking: smoking
smooth: smooth
smother: smother
smug: smug
snake: snake,snakes
snaky: snaky
snap: snap
snare: snare,snares
snatch: snatched
sneak: sneaking
sneeringly: sneeringly
sneeze: sneeze
sniff: sniffed,sniffing
sniffle: sniffled
sniffling: sniffling
snort: snort,snorted,snorting
snorter: snorter
snout: snout
snow: snow,snows
snowflake: snowflakes
snub: snubs
snuffling: snuffling
snug: snugger
soap: soap
soar: soar,soaring,soars
sob: sobs
soberly: soberly
social: social
socialists: socialists
society: society
sociologist: sociologist
sociology: sociology
soft: soft,softer
softly: softly
soil: soil
sojourn: sojourn,sojourned
solar: solar
soldier: soldiers
sole: sole,soles
solemn: solemn
solemnity: solemnities
solemnly: solemnly
solicit: solicit
solicitation: solicitation
solicitous: solicitous
solitary: solitary
solitude: solitude
solution: solution
solve: solve,solved,solving
sombre: sombre
somnolence: somnolence
somnolent: somnolent
son: son
song: song,songs
songstress: songstresses
sooth: sooth
soothing: soothing
soothsayer: soothsayer,soothsayers
sorcerer: sorcerer
sordidly: sordidly
sordidness: sordidness
sore: sore,sorer,sorest
sorely: sorely
sorrow: sorrow,sorrows
sorrowful: sorrowful
sorrowfully: sorrowfully
sorrowfulness: sorrowfulness
sort: sort
soul: soul,souls
sound: sound,sounded,sounding,sounds
soundly: soundly
sour: sour
source: source
south: south,souths
southerly: southerly
southern: southern
sovereign: sovereign
sower: sower,sowers
space: space
spacious: spacious
spake: spake
span: span
spare: spare,spared,sparing
sparingness: sparingness
spark: sparks
sparkle: sparkle,sparkled,sparkling
sparkling: sparkling
speak: spake,speak,speaking,speaks,spoken
speaker: speaker
speaking: speaking
spear: spear
special: special
specialist: specialist
species: species
speckled: speckled
spectacle: spectacle
spectator: spectator,spectators
speech: speech
speedily: speedily
speedy: speedy
spelling: spelling
spencer: spencer
spencerian: spencerian
spend: spent
spew: spewing
sphere: sphere
spice: spice,spices
spicily: spicily
spicing: spicing
spider: spider,spiders
spin: spin
spine: spines
spinning: spinning
spirit: spirit,spirits
spirited: spirited
spiritual: spiritual
spiritually: spiritually
spit: spat,spit,spits
spite: spite
spiteful: spiteful
spitting: spitting
spittle: spittle
splash: splash,splashing
spleen: spleen
splendid: splendid
splendour: splendour
spoil: spoil,spoilt
spoiler: spoiler
spoken: spoken
sponge: sponge
spongy: spongy
spontaneous: spontaneous
spontaneously: spontaneously
sport: sport,sported
sporting: sporting
spot: spot,spots
spotted: spotted
spout: spouted,spouting
spread: spread
sprightly: sprightly
spring: sprang,spring,springing,springs,sprung
springing: springing
sprite: sprite,sprites
spur: spur
spurious: spurious
spurn: spurns
spurt: spurted
spy: spied
squander: squander
squanderer: squanderer
square: square
squarely: squarely
squat: squat,squatted
squattest: squattest
squint: squint,squinting
stab: stab
stable: stable
staff: staff
stage: stage
staggered: staggered
stair: stair,stairs
stake: stake
stalk: stalk
stammer: stammer
stammerer: stammerer
stammering: stammering
stamp: stamp,stamped
stand: stand,standing,stands,stood
standeth: standeth
standing: standing
star: star,stars
starless: starless
starlet: starlets
starred: starred
starry: starry
start: start,started,starts
startle: startle,startled
startled: startled
startling: startling
starve: starved
stately: stately
statement: statement,statements
station: station
statue: statue,statues
status: status
stay: stay,stayed,staying
steadfast: steadfast
steadily: steadily
steady: steady
steal: steal,stealing,stole,stolen
stealing: stealing
stealthy: stealthy
steam: steam,steaming
steamy: steamy
steel: steel
steep: steep
stench: stench
step: step,stepped,steps
sterile: sterile
sterility: sterility
stern: stern
sternly: sternly
stew: stew,stewed
stick: stick
sticky: sticky
stiff: stiff
stiffen: stiffened
stifle: stifle,stifling
stiller: stiller
stillest: stillest
stillness: stillness
stilt: stilts
stimulus: stimulus
sting: sting,stings,stung
stink: stink,stinking
stir: stir,stirred
stock: stock
stomach: stomach,stomachs
stone: stone,stones
stoning: stoning
stony: stony
stool: stool
stoop: stoop
store: store,stored
storm: storm,storms
stormy: stormier,stormy
story: story
stout: stout
straight: straight
straightforwardness: straightforwardness
straightway: straightway
strain: strain,strained,strains
strange: strange,strangest
strangely: strangely
stranger: stranger,strangers
strangle: strangle,strangled,strangling
strangler: strangler
strauss: strauss
straw: straw
stray: stray,strayed
streak: streak
stream: stream,streams
streaming: streaming
streamlet: streamlets
street: street,streets
strength: strength
strengthen: strengthened
strengthening: strengthening
stress: stress
stretch: stretch,stretched,stretching
stricken: stricken
strict: strict,strictest
strictly: strictly
stride: stride
strike: strike,strikes,struck
string: string
strip: strip
stripe: stripes
strive: strive,strives,striving,strove
striver: striver
stroke: stroke,stroked
stroll: strolling
strong: strong,stronger,strongest
structure: structure,structures
struggle: struggle,struggled,struggles,struggling
student: student,students
study: studied,study,studying
stuff: stuffed
stultifying: stultifying
stumble: stumble
stumbling: stumbling
stunned: stunned
stupid: stupid,stupidest
stupidity: stupidity
style: style
subdued: subdued
subject: subject
subjugator: subjugator
sublime: sublime
sublimeness: sublimeness
sublimity: sublimity
submerge: submerged
submission: submission,submissions
submissive: submissive
submit: submit,submits,submitting
subordinate: subordinate
subscribe: subscribe
subsequent: subsequent
subsequently: subsequently
subside: subsided
substance: substance
subterranean: subterranean
subtle: subtle,subtlest
subtlely: subtlely
subtler: subtler
subtlest: subtlest
subtlety: subtlety
subversive: subversive
subverter: subverters
succeed: succeed,succeeded,succeeds
success: success,successes
successful: successful
successive: successive
succumb: succumb,succumbed,succumbing
suck: suck,sucked
sudden: sudden
suddenly: suddenly
sue: sue
suffer: suffer,suffered,suffering
sufferer: sufferer,sufferers
suffering: suffering
suffice: suffice,sufficed
sufficient: sufficient
sufficing: sufficing
suffocate: suffocate,suffocated,suffocating
suggestion: suggestion,suggestions
suggestive: suggestive
suicide: suicide,suicides
suit: suit,suited
sulker: sulker
sulky: sulky
sullen: sullen
sullenly: sullenly
sultry: sultry
summer: summer
summit: summit,summits
summon: summon,summoned
sumpter: sumpter
sun: sun,suns
sunbeam: sunbeam
sunk: sunk
sunny: sunny
sunrise: sunrise
sunset: sunset
sunshine: sunshine
superabundance: superabundance
superearthly: superearthly
superficial: superficial
superficiality: superficiality
superfluous: superfluous
superhero: superhero
superhuman: superhuman
superior: superior
superman: superman
supermen: supermen
superstition: superstition,superstitions
superstitious: superstitious
supervene: supervened
supper: supper
supple: supple,supplest
supplement: supplement,supplemented
supplementary: supplementary
suppliant: suppliants
support: support,supported,supporting
suppose: suppose,supposed
suppress: suppressed
suppression: suppression
suppurate: suppurating
supremacy: supremacy
supreme: supreme
supremely: supremely
supremest: supremest
surely: surely
surface: surface
surge: surging
surmount: surmount,surmounted,surmounting,surmounts
surmounter: surmounter
surname: surnamed
surpass: surpass,surpassed,surpassing
surpassing: surpassing
surprise: surprise
surprised: surprised
surrender: surrender,surrendered
surround: surround,surrounded,surrounding
survival: survival
survive: survive,surviving
susceptible: susceptible
suspect: suspect,suspected
suspend: suspended
suspicion: suspicion,suspicions
suspicious: suspicious
sustaining: sustaining
swaddle: swaddle,swaddling
swallow: swallow,swallowed
swamp: swamp,swamps
sward: sward
swarm: swarm,swarming
swarthy: swarthy
swathe: swathed
sweat: sweat
sweep: sweep,swept
sweet: sweet,sweetest
sweeten: sweeten
sweetly: sweetly
sweetmeat: sweetmeats
sweetness: sweetness
sweetwood: sweetwood
swell: swelled,swelling
swift: swift
swill: swill
swim: swim,swum
swimming: swimming
swindler: swindler
swine: swine
swing: swing
swinish: swinish
switzerland: switzerland
swollen: swollen
sword: sword,swords
swordsman: swordsman
swordsmanship: swordsmanship
sybil: sybil
syllable: syllable
symbol: symbol
symbolic: symbolic
symbolically: symbolically
sympathetic: sympathetic
sympathetically: sympathetically
sympathise: sympathise
sympathy: sympathy
synonymous: synonymous
tabernacle: tabernacle,tabernacles
table: table,tables
tactic: tactics
tail: tail
taint: tainted
tainted: tainted
taker: taker
taketh: taketh
tale: tale,tales
talk: talk,talked,talking
tall: tall
talon: talons
tame: tame,tamer
tameness: tameness
tamer: tamers
tangle: tangled
taper: taper
tarantula: tarantula,tarantulas
tarantulas: tarantulas
tardy: tardy
tare: tares
tarry: tarried,tarry
task: task
taste: taste,tasted,tastes,tasting
taster: tasters
tatter: tatter
taunt: taunted
tautological: tautological
tax: tax,taxes
teach: taught,teach,teaches,teaching
teacher: teacher,teachers
teaching: teaching
tear: tear,tears,torn
teardrop: teardrops
tedium: tedium
teem: teeming
teens: teens
teeth: teeth
tellingly: tellingly
temperament: temperament
tempered: tempered
tempest: tempest
tempestuous: tempestuous
temple: temple,temples
temporary: temporary
tempt: tempt,tempted
temptation: temptation
tempter: tempter
tempting: tempting
temptingly: temptingly
temptress: temptress
tend: tend
tendency: tendencies,tendency
tender: tender,tenderest
tenderly: tenderly
tenderness: tenderness
tension: tension
tepidly: tepidly
term: term,terms
terrestrial: terrestrial
terrible: terrible
terribly: terribly
terrific: terrific
terrified: terrified
terrify: terrified,terrifies
territory: territory
terror: terror
testify: testified,testify
testimony: testimony
testing: testing
thankful: thankful
thaw: thaw
thawing: thawing
thee: thee
theft: theft
theory: theory
thereabout: thereabouts
thereat: thereat
therefrom: therefrom
thereon: thereon
therethrough: therethrough
theretofore: theretofore
thereunder: thereunder
therewith: therewith
thicket: thicket,thickets
thief: thief,thieves
thine: thine
thinkable: thinkable
thinkableness: thinkableness
thinker: thinker,thinkers
thinking: thinking
thirdly: thirdly
thirst: thirst,thirsted
thirstily: thirstily
thirsty: thirstier,thirsty
thirteenth: thirteenth
thirtieth: thirtieth
thistle: thistle,thistles
thither: thither
thitherwards: thitherwards
thomas: thomas
thorn: thorns
thoughtful: thoughtful
thoughtfully: thoughtfully
thousandfold: thousandfold
thrash: thrash,thrashing
thread: thread,threads
threading: threading
threaten: threaten,threatening
thrice: thrice
thrill: thrill,thrills
thrilling: thrilling
throat: throat
throb: throbbed
throe: throes
throne: throne,thrones
throng: throng,thronged,thronging
throw: threw,throw,thrown
thrust: thrust
thunder: thunder,thunders
thwart: thwarted
thy: thy
thyself: thyself
tick: tick,ticking
tickle: tickle
tickled: tickled
ticktack: ticktack
tide: tide
tiding: tidings
tie: tied
tiger: tiger,tigers
tight: tighter
time: time,times
timepiece: timepiece
timid: timid
timidly: timidly
timorousness: timorousness
tinkle: tinkle
tinted: tinted
tire: tire
tired: tired
title: title,titles
toad: toad,toads
toe: toe,toes
toil: toils
toilsomely: toilsomely
token: token
tolerate: tolerate,tolerated
toleration: toleration
toll: toll
tom: tom
tomb: tomb
tomboy: tomboy
tone: tone,tones
tongue: tongue,tongues
tongued: tongued
toot: tooted
tooth: teeth,tooth,tooths
toothed: toothed
toothless: toothless
torch: torch
torment: torment,tormented
torrent: torrent
tortuously: tortuously
torture: torture,tortured,tortures,torturing
torturer: torturer
toss: toss,tossed
totally: totally
totter: tottering
touch: touch,touched,touching
tough: tougher
tower: tower,towered,towers
towering: towering
town: town
toy: toy
trace: traces,tracing
trademark: trademark
trader: trader,traders
tradition: tradition,traditions
traditional: traditional
traffic: traffic
trafficking: trafficking
tragedy: tragedies,tragedy
tragic: tragic
train: trained
trainer: trainer
training: training
trample: trample,trampling
tranquil: tranquil
transcendental: transcendental
transcribe: transcribe
transcription: transcription
transfigure: transfigured,transfiguring
transform: transform,transformed,transforms
transformation: transformation
transgressor: transgressor
transient: transient
translate: translate,translated
translation: translation
translator: translator
transparent: transparent
transport: transport,transported
transvaluation: transvaluation
transvalue: transvalued
trap: traps
trappings: trappings
travel: travel,travelling
traveller: traveller,travellers
travelling: travelling
traverse: traverse
treacherous: treacherous
tread: tread,treading,trod
treader: treaders
treasure: treasure,treasures
treat: treat,treated
treatment: treatment
tree: tree,trees
tremble: tremble,trembled,trembles,trembling
tress: tresses
triangle: triangle
tribulation: tribulation
tribute: tribute
trick: trick,tricks
trickle: trickle
trier: trier
trifling: trifling
trim: trim
trip: trip
triumph: triumph,triumphed,triumphing,triumphs
triumphant: triumphant
triumphantly: triumphantly
trivial: trivial
trodden: trodden
trophy: trophies
trot: trot
trouble: trouble,troubled,troubling
troubled: troubled
troublesome: troublesome
true: true,truest
trueness: trueness
trumpery: trumpery
trumpet: trumpet
trumpeter: trumpeters
trust: trust,trusting
truth: truth,truths
truthful: truthful
truthfulness: truthfulness
tub: tub
tuft: tuft
tug: tug
tumble: tumble,tumbled
tumult: tumult
turbid: turbid
twain: twain
twig: twig
twilight: twilight
twine: twine
twined: twined
twinkle: twinkle,twinkling
twinkling: twinkling
twist: twist
twixt: twixt
type: type,types
tyrant: tyrant
ubiquitous: ubiquitous
udder: udder,udders
ugliest: ugliest
ugliness: ugliness
ugly: ugliest,ugly
ulceration: ulcerations
ultimate: ultimate
ultimately: ultimately
unabated: unabated
unafflicted: unafflicted
unappeasable: unappeasable
unappeased: unappeased
unappreciative: unappreciative
unattainable: unattainable
unattempted: unattempted
unavoidable: unavoidable
unaware: unaware
unawares: unawares
unbearable: unbearable
unbearded: unbearded
unbelief: unbelief
unbelievable: unbelievable
unbind: unbind
unbosom: unbosom
unbounded: unbounded
unbridled: unbridled
unburiable: unburiable
unceasingly: unceasingly
uncertain: uncertain
uncertainty: uncertainty
unchanged: unchanged
unclean: unclean
uncleanliness: uncleanliness
uncleanly: uncleanly
unclouded: unclouded
uncloudedly: uncloudedly
uncomely: uncomely
uncommon: uncommon
unconcerned: unconcerned
unconquerable: unconquerable
unconquered: unconquered
unconscious: unconscious
uncreated: uncreated
uncritical: uncritical
undermine: undermined
understand: understand,understanding,understood
understanding: understanding
undertake: undertake,undertaken
undignified: undignified
undiscovered: undiscovered
undo: undone
undoubted: undoubted
undoubtedly: undoubtedly
unduly: unduly
uneasiness: uneasiness
unemancipated: unemancipated
unembarrassed: unembarrassed
unenforceability: unenforceability
unequivocal: unequivocal
unexhausted: unexhausted
unexpected: unexpected
unexplored: unexplored
unfair: unfair
unfamiliar: unfamiliar
unfathomable: unfathomable
unfathomably: unfathomably
unfavourable: unfavourable
unfettered: unfettered
unfitted: unfitted
unforgettable: unforgettable
unforgotten: unforgotten
unfortunate: unfortunate
unfrequented: unfrequented
unfriendly: unfriendly
unfruitful: unfruitful
ungodliest: ungodliest
ungodliness: ungodliness
ungodly: ungodlier,ungodly
ungracious: ungracious
ungraciously: ungraciously
ungrateful: ungrateful
unhandy: unhandy
unhappiness: unhappiness
unhappy: unhappy
unharness: unharnessed
unharnessed: unharnessed
unhealthy: unhealthy
unheard: unheard
unhesitatingly: unhesitatingly
unholy: unholy
unhomelike: unhomelike
uniform: uniform
uninitiated: uninitiated
unique: unique
united: united
unity: unity
universally: universally
university: university
unjoyously: unjoyously
unjustly: unjustly
unkind: unkind
unknowable: unknowable
unknown: unknown
unlearn: unlearn
unlearned: unlearned
unlearnt: unlearnt
unlink: unlink
unloosed: unloosed
unmoved: unmoved
unnamable: unnamable
unobserved: unobserved
unpardonable: unpardonable
unpityingly: unpityingly
unpleasantly: unpleasantly
unplumed: unplumed
unprepared: unprepared
unproductive: unproductive
unprofiting: unprofiting
unprotected: unprotected
unquestionable: unquestionable
unquestionably: unquestionably
unrealised: unrealised
unreconciled: unreconciled
unrighteousness: unrighteousness
unroll: unrolled
unrollable: unrollable
unruly: unruly
unsatisfactory: unsatisfactory
unselfish: unselfish
unselfishness: unselfishness
unsettle: unsettled
unsettled: unsettled
unslept: unslept
unsolicited: unsolicited
unsoundness: unsoundness
unspeakable: unspeakable
unspeakably: unspeakably
unspoken: unspoken
unstable: unstable
unsteady: unsteady
unsuccessful: unsuccessful
unsuited: unsuited
unsummoned: unsummoned
untried: untried
untrustful: untrustful
untrustworthy: untrustworthy
unusual: unusual
unusually: unusually
unutterable: unutterable
unwary: unwary
unweariedly: unweariedly
unwilling: unwilling
unwillingly: unwillingly
unwillingness: unwillingness
unwittingly: unwittingly
unworthy: unworthy
upbraid: upbraid,upbraided
upbringing: upbringing
update: updated
uphill: uphill
uphold: upheld
upraise: upraised
upright: upright
uprightly: uprightly
uprightness: uprightness
uproot: uprooting
upset: upset,upsets
upside: upside
upward: upward
urgent: urgent
usage: usages
useless: useless
user: user
ut: ut
utmost: utmost
utter: utter,uttered
utterance: utterance
utterly: utterly
vague: vague
vain: vain,vainest
vainly: vainly
valiant: valiant
valley: valley,valleys
valorous: valorous
valour: valour
valuable: valuable
valuation: valuation,valuations
valuator: valuator
valuer: valuer
vanilla: vanilla
vanish: vanish,vanished,vanishes,vanishing
vanity: vanity
vanquish: vanquished
vapour: vapour
vapours: vapours
variability: variability
variance: variance
variation: variations
variegate: variegated
variegated: variegated
variety: varieties,variety
vast: vast
vault: vault,vaults
vaunt: vaunt
vegetable: vegetable,vegetables
vehemence: vehemence
vehemently: vehemently
veil: veil,veiled,veils
vein: vein,veins
veins: veins
velvety: velvety
venerable: venerable
venerate: venerate,venerating
veneration: veneration
venery: venery
vengeance: vengeance
venice: venice
ventriloquist: ventriloquist
venture: venture,ventured
venturer: venturers
verbal: verbal
verdant: verdant
verily: verily
vermin: vermin
versa: versa
verse: verse,versed,verses
verses: verses
version: version
vertiginous: vertiginous
vertigo: vertigo
vesper: vesper
vessel: vessel
vestige: vestige
vex: vexed
vexation: vexation
vibrate: vibrated
vice: vice,vices
vicinity: vicinity
vicious: vicious
victim: victim,victims
victor: victor
victorious: victorious
victoriously: victoriously
victory: victories,victory
view: view,viewed,viewing,views
vigorously: vigorously
vigour: vigour
vii: vii
viii: viii
village: village
villain: villain
vindictive: vindictive
vine: vine
vintage: vintage
vintager: vintager
vintner: vintner
violate: violated,violates
violator: violators
violence: violence
violent: violent
violently: violently
violet: violet
virgin: virgin
virginity: virginity
virile: virile
virtue: virtue,virtues
virtuous: virtuous
virulent: virulent
virus: virus
visible: visible
vision: vision,visions
visionary: visionaries,visionary
visit: visit
visitor: visitors
vituperation: vituperations
vivacious: vivacious
vivant: vivant
vividly: vividly
vocal: vocal
voice: voice,voices
void: void
volcano: volcano
voluntarily: voluntarily
voluntary: voluntary
volunteer: volunteer,volunteers
voluptuous: voluptuous
voluptuousness: voluptuousness
vomit: vomit,vomiting
von: von
vow: vow
voyage: voyages
vulgar: vulgar
vulnerable: vulnerable
vulture: vultures
wade: wade
wag: wags
wage: wage
wager: wager
waggish: waggish
waggle: waggle
wagner: wagner
wail: wailing
wailer: wailer
wait: wait,waited,waiting
waiting: waiting
waive: waive
wake: wake,woke
wakeful: wakeful
walk: walk,walked,walking,walks
walker: walker
walking: walking
wall: wall,walls
wander: wander,wandered,wandering
wanderer: wanderer
wanderings: wanderings
wanton: wanton
wantoning: wantoning
wantonly: wantonly
wantonness: wantonness
war: war,wars
warfare: warfare
warily: warily
warlike: warlike
warm: warm,warmed,warmer,warmest
warmer: warmers
warmly: warmly
warmth: warmth
warn: warn,warned,warns
warning: warning
warranty: warranties,warranty
warrior: warrior,warriors
warriors: warriors
wash: wash,washed
wast: wast
waste: waste,wasted
watch: watches
watcher: watchers
watchman: watchman
watchmen: watchmen
water: water,waters
wave: wave,waved,waves
waver: wavering
wax: wax
wayfaring: wayfaring
waylay: waylaid
wayside: wayside
wayward: wayward
weak: weak,weaker
weakling: weakling,weaklings
weakly: weakly
weakness: weakness,weaknesses
wealth: wealth
weapon: weapon,weapons
wear: wear,wears,wore
wearied: wearied
wearily: wearily
weariness: weariness
wearisome: wearisome
weary: wearied,wearier,weary
weather: weather
weaving: weaving
weed: weeds
week: weeks
weep: weep,weeping,wept
weigh: weigh,weighed,weighing
weighable: weighable
weigher: weigher
weight: weight,weighted
weightily: weightily
weighty: weighty
weird: weird
welfare: welfare
weltanschauung: weltanschauung
welter: weltering
wert: wert
west: west
wet: wet
whale: whale
whatsoever: whatsoever
wheat: wheat
wheel: wheel
wheeze: wheeze
wheezy: wheezy
wherefore: wherefore
whereof: whereof
whereon: whereon
wherewith: wherewith
whet: whet
whiff: whiff
whimper: whimper
whine: whining
whip: whip
whirl: whirl,whirled,whirling
whirlwind: whirlwind
whirr: whirr
whisk: whisk,whisked
whisking: whisking
whisper: whisper,whispered,whispering
whispering: whispering
whistle: whistling
white: white
whited: whited
whitehead: whitehead
whitewash: whitewash
whitewashed: whitewashed
whiz: whizzing
whizz: whizz
whizzing: whizzing
wholeness: wholeness
wholesome: wholesome
wholly: wholly
whosoever: whosoever
wicked: wicked,wickedest
wickedly: wickedly
wickedness: wickedness
wide: wide,widest
widespread: widespread
wife: wife,wives
wild: wild
wilderness: wilderness,wildernesses
wildest: wildest
wildly: wildly
wilfully: wilfully
willed: willed
willer: willer,willers
willingly: willingly
wilt: wilt
wind: wind,winds,wound
winding: windings
window: window,windows
wine: wine,wines
wing: wing,wings
wink: winked
winter: winter,winters
wipe: wipe,wiped
wire: wires
wisdom: wisdom
wise: wise,wiser,wisest
wiseacre: wiseacres
wisely: wisely
wit: wit,wits
witch: witch
withal: withal
withdraw: withdraw,withdrawing,withdrawn,withdrew
wither: withered
withered: withered
withstand: withstand,withstood
witness: witness,witnesses
witted: witted
wittingly: wittingly
witty: wittiest
wizard: wizard
woe: woe
woeful: woeful
wolf: wolf,wolves
woman: woman,women
womanly: womanly
women: women
wonderful: wonderful
wonderfully: wonderfully
wood: wood,woods
wooer: wooer
wooled: wooled
woolly: woolly
word: word
worker: worker
worldling: worldlings
worldly: worldly
worm: worm,worms
wormy: wormy
worn: worn
worry: worry
worsen: worsen
worship: worship,worshipped,worshipping
worshipper: worshippers
worth: worth,worths
worthless: worthless
worthy: worthier,worthiest,worthy
wouldst: wouldst
wound: wound,wounded,wounds
wounding: wounding
wow: wow
wrangling: wrangling
wrapper: wrappers
wrath: wrath
wrathful: wrathful
wrathfully: wrathfully
wreath: wreath,wreaths
wreck: wrecked
wreckage: wreckage
wretch: wretch
wretched: wretched
wriggle: wriggled
write: write,writes,writing,written,wrote
writer: writer,writers
writhe: writhe,writhing
writing: writing
writings: writings
wrong: wrong
wroth: wroth
xi: xi
xii: xii
xiii: xiii
xiv: xiv
xix: xix
xvi: xvi
xvii: xvii
xviii: xviii
xx: xx
xxi: xxi
xxii: xxii
xxiii: xxiii
xxiv: xxiv
xxv: xxv
xxx: xxx
yard: yard
yawn: yawn,yawned,yawning
yawning: yawning
yea: yea
yearningly: yearningly
yell: yell
yellow: yellow
yellower: yellower
yelp: yelp
yester: yester
yesterday: yesterday,yesterdays
yield: yield,yielding
yoke: yoke
yonder: yonder
youth: youth,youths
youthful: youthful
zeal: zeal
zend: zend
zenith: zenith
zurich: zurich
