abandon: abandon,abandoned,abandoning
abandonment: abandonment
abate: abate,abated
abatis: abatis
abbreviate: abbreviated
abeyance: abeyance
abhorrent: abhorrent
abide: abide,abiding
ability: abilities,ability
ablest: ablest
ably: ably
aboard: aboard
abolish: abolished,abolishing
abolition: abolition
abolitionist: abolitionists
abortive: abortive
abound: abound,abounded,abounding
abraham: abraham
abreast: abreast
abrupt: abrupt
abruptly: abruptly
absence: absence
absent: absent
absolute: absolute
absolutely: absolutely
absorb: absorb,absorbing
absorbing: absorbing
abstain: abstain,abstained,abstaining
absurd: absurd
abundance: abundance
abundant: abundant
abundantly: abundantly
abuse: abuse,abused
academic: academic
academy: academy
acapulco: acapulco
accede: accede,acceded
accelerate: accelerated
accept: accept,accepted,accepting
acceptable: acceptable
acceptance: acceptance
accepting: accepting
access: access,accessed
accessibility: accessibility
accessible: accessible
accession: accessions
accident: accident,accidents
acclimate: acclimated
accommodate: accommodate
accommodation: accommodation,accommodations
accompany: accompanied,accompany,accompanying
accomplish: accomplish,accomplished,accomplishing
accomplished: accomplished
accomplishment: accomplishment
accord: accord
account: account,accounted,accounts
accountable: accountable
accountant: accountant
accoutrements: accoutrements
accumulate: accumulate,accumulated
accumulation: accumulation
accuracy: accuracy
accurate: accurate
accurately: accurately
accuse: accused
accuser: accuser
accustom: accustomed
accustomed: accustomed
ache: aching
achieve: achieve,achieved
achievement: achievement,achievements
acknowledge: acknowledge,acknowledged,acknowledging
acquaint: acquaint,acquainted
acquaintance: acquaintance,acquaintances
acquiesce: acquiesced
acquire: acquire,acquired,acquiring
acquirement: acquirements
acquisition: acquisition,acquisitions
acre: acre,acres
acrimonious: acrimonious
acrimony: acrimony
action: action,actions
active: active
actively: actively
activity: activity
actual: actual
actuate: actuated
acute: acute
adams: adams
adapt: adapted
add: add,adding,adds
addition: addition,additions
additional: additional
address: address,addressed,addresses,addressing
adduce: adduced
adelbert: adelbert
adequate: adequate
adhere: adhered
adieu: adieu
adjacent: adjacent
adjective: adjectives
adjoin: adjoining
adjoining: adjoining
adjourn: adjourned
adjournment: adjournment
adjt: adjt
adjudge: adjudged
adjust: adjusted
adjutant: adjutant
administer: administer
administration: administration
administrative: administrative
admirable: admirable
admiral: admiral
admire: admired
admirer: admirer,admirers
admission: admission,admissions
admit: admit,admitted
admittance: admittance
admonish: admonishing
adopt: adopt,adopting
adoption: adoption
adore: adored
adrift: adrift
adult: adults
advance: advance,advanced,advances,advancing
advanced: advanced
advantage: advantage,advantages
advantageous: advantageous
advantageously: advantageously
advent: advent
adventurer: adventurers
adversary: adversary
advertise: advertised
advice: advice
advisable: advisable
advise: advise,advised,advises,advising
advisedly: advisedly
adviser: advisers
advocate: advocate,advocated
afar: afar
affair: affair,affairs
affect: affect
afford: afford,afforded,affording,affords
afoot: afoot
afraid: afraid
afresh: afresh
afternoon: afternoon,afternoons
afterward: afterward
age: age,ages
aged: aged
agency: agency
agent: agent
aggrandizement: aggrandizement
aggravating: aggravating
aggregate: aggregate
aggression: aggressions
aggressive: aggressive
aggressiveness: aggressiveness
aggressor: aggressors
aggrieved: aggrieved
aglow: aglow
agony: agony
agree: agree,agreed,agreeing
agreeable: agreeable
agreeably: agreeably
agreement: agreement
agricultural: agricultural
agriculture: agriculture
aground: aground
ague: ague
aid: aid,aided,aiding
aide: aide,aides
ailment: ailments
aim: aim,aimed,aiming
air: air
akin: akin
alabama: alabama
alacrity: alacrity
alameda: alameda
alamo: alamo
alarm: alarm,alarmed
alarmed: alarmed
alarming: alarming
albert: albert
alcoholic: alcoholic
alert: alert
alertness: alertness
alex: alex
alexander: alexander
alexandria: alexandria
alfred: alfred
algebra: algebra
alien: alien,aliens
alike: alike
alive: alive
allegiance: allegiance
alleviate: alleviate,alleviating
alley: alleys
allot: allot,allotted
allowance: allowance
allude: allude,alluded,alluding
alluvial: alluvial
ally: allies,ally
aloof: aloof
aloud: aloud
alps: alps
alter: altered
alteration: alteration
alternate: alternate
alternately: alternately
alternative: alternative
alto: alto
altogether: altogether
amazed: amazed
amazingly: amazingly
ambition: ambition,ambitions
ambitious: ambitious
ambulance: ambulance,ambulances
ambush: ambushed
ame: ame
amelia: amelia
amendment: amendment,amendments
america: america
american: american,americans
ammunition: ammunition
ample: ample
amplify: amplified
amply: amply
amputate: amputated
amputation: amputation
amused: amused
amusement: amusement
amusing: amusing
ancestor: ancestors
ancestry: ancestry
anchor: anchor,anchored,anchoring
ancient: ancient
anderson: anderson
andrew: andrew
anecdote: anecdote,anecdotes
anecdotes: anecdotes
angle: angle,angles
angry: angry
anguish: anguish
animal: animal,animals
animated: animated
ankle: ankle
anna: anna
annals: annals
annapolis: annapolis
annas: annas
annexation: annexation
annihilate: annihilate,annihilated,annihilating
annihilation: annihilation
anniversary: anniversaries,anniversary
announcement: announcement
annoy: annoy,annoyed
annoyance: annoyance,annoyances
annoyed: annoyed
annoying: annoying
annual: annual
annul: annulled
answer: answer,answered,answering,answers
antagonist: antagonist,antagonists
antedate: antedate
antelope: antelope
anticipate: anticipated,anticipating
anticipation: anticipation,anticipations
antietam: antietam
anton: anton
antonio: antonio
anxiety: anxieties,anxiety
anxious: anxious
ap: ap
apologetic: apologetic
apologetically: apologetically
apologize: apologize,apologized
apology: apologies,apology
apparent: apparent
appeal: appeal,appealed,appealing,appeals
appearance: appearance,appearances
appease: appease
appendix: appendix
appetite: appetite
applaud: applaud
apple: apple
applicable: applicable
applicant: applicant
application: application,applications
apply: applied,apply
appoint: appoint,appointed,appointing
appointed: appointed
appointment: appointment,appointments
appomattox: appomattox
appreciation: appreciation
apprehend: apprehend,apprehended
apprehension: apprehension,apprehensions
apprehensive: apprehensive
apprise: apprised
approach: approach,approached,approaches,approaching
approaches: approaches
appropriately: appropriately
approval: approval
approve: approve,approved
approximate: approximate
april: april
apt: apt
aqueduct: aqueduct,aqueducts
arc: arcs
arch: arch,arches
archer: archer
architectural: architectural
archive: archive,archives
ardor: ardor
arduous: arduous
arena: arena
argument: argument,arguments
arithmetic: arithmetic
arkansas: arkansas
arm: arm,armed,arms
armada: armada
armament: armament,armaments
armed: armed
armies: armies
armistice: armistice,armistices
armory: armory
army: armies,army
arouse: aroused
arrange: arrange,arranged,arranging
arrangement: arrangement,arrangements
array: array
arrest: arrest,arrested,arrests
arrival: arrival,arrivals
arrive: arrive,arrived,arrives,arriving
arsenal: arsenal,arsenals
art: arts
article: article,articles
artificial: artificial
artillerist: artillerists
artillery: artillery
ascend: ascend,ascended,ascending,ascends
ascent: ascent
ascertain: ascertain,ascertained,ascertaining
ascertainment: ascertainment
ascii: ascii
ashore: ashore
asleep: asleep
aspen: aspen
aspirant: aspirants
aspiration: aspirations
ass: ass
assail: assailed
assailant: assailants
assassin: assassin
assassinate: assassinated
assassination: assassination,assassinations
assault: assault,assaulted,assaulting,assaults
assaulting: assaulting
assemblage: assemblage
assemble: assemble,assembled,assembling
assembling: assembling
assembly: assembly
assert: assert,asserted
assessment: assessments
assign: assign,assigned,assigning
assignment: assignment
assist: assist,assisted
assistance: assistance
assistant: assistant,assistants
associate: associates
associations: associations
assume: assume,assumed,assumes,assuming
assuming: assuming
assurance: assurance,assurances
assure: assure,assured,assuring
astonishing: astonishing
astray: astray
athens: athens
atlanta: atlanta
atlantic: atlantic
atlee: atlee
atone: atone
atonement: atonement
attach: attach,attached,attaching
attack: attack,attacked,attacking,attacks
attain: attain,attained,attaining
attempt: attempt,attempted,attempting,attempts
attend: attend,attended,attending
attendance: attendance
attendant: attendants
attention: attention
attentive: attentive
attorney: attorney
attract: attract,attracted,attracting
attribute: attributed
attrition: attrition
auburn: auburn
auction: auction
audience: audience
augur: augur
august: august
augusta: augusta
augustin: augustin
augustine: augustine
austere: austere
austin: austin
austrian: austrian
authenticity: authenticity
author: author
authority: authorities,authority
authorization: authorization
authorize: authorize,authorized,authorizing
authorship: authorship
autocrat: autocrat
auxiliary: auxiliary
avail: avail,availed,availing
avarice: avarice
avenge: avenge
avenue: avenues
average: average,averaged
averaging: averaging
averse: averse
aversion: aversion
avert: averted
avidity: avidity
avocation: avocations
avoid: avoid,avoided,avoiding
await: await,awaited,awaiting
awake: awake,awakes
award: awarded
aware: aware
awe: awe
awful: awful
awkward: awkward
ax: ax
axe: axe
axemen: axemen
axiom: axiom
axis: axes
axle: axle
babcock: babcock
background: background
bacon: bacon
bad: bad,worse,worst
badge: badge
badly: badly,worse
bag: bags
baggage: baggage
bagger: bagger
bailey: bailey
bake: bake,baking
baker: baker,bakers
bakery: bakery
balance: balance,balanced
baldwin: baldwin
bale: bales
balky: balky
ball: ball,balls
ballot: ballot
balloting: balloting
baltimore: baltimore
banana: banana
band: band,bands
bandanna: bandanna
bank: bank,banks
banker: bankers
banks: banks
banner: banners
bar: bar,barred
barbarous: barbarous
barbed: barbed
bare: bare
barefooted: barefooted
bareheaded: bareheaded
barely: barely
barge: barges
barley: barley
barlow: barlow
barnard: barnard
barracks: barracks
barren: barren
barrett: barrett
barrier: barrier,barriers
barringer: barringer
bartlett: bartlett
barton: barton
base: base,based
basis: bases,basis
bastion: bastion
bath: bath
bathing: bathing
baton: baton
battalion: battalion,battalions
battery: batteries,battery
battle: battle,battles,battling
battlefield: battlefield
baxter: baxter
bay: bay
bayonet: bayonets
bayou: bayou
bayous: bayous
beach: beach
bean: bean,beans
bear: bear,bearing,bears,bore,born,borne
bearer: bearer
bearing: bearing
beast: beast,beasts
beat: beat,beaten,beating
beaufort: beaufort
beautiful: beautiful
beauty: beauty
beaver: beaver
bed: bed,beds
bedding: bedding
beech: beech
beef: beef
beet: beets
befall: befallen
beg: beg,begged
begot: begot
behalf: behalf
behave: behaved
behold: beheld
beleaguered: beleaguered
belfry: belfry
belgian: belgian
belief: belief
believer: believer
belittle: belittled,belittling
belknap: belknap
bell: bell
belle: belle
belligerent: belligerent,belligerents
belong: belong,belonged,belonging,belongs
belt: belt
bend: bend,bends
beneath: beneath
benefactor: benefactors
beneficial: beneficial
benefit: benefit,benefited
benj: benj
benjamin: benjamin
bent: bent
benton: benton
berate: berating
bereavement: bereavement
bereft: bereft
bermuda: bermuda
bern: bern
berne: berne
beset: beset
besiege: besiege,besieged,besieging
besiegement: besiegement
besieger: besiegers
bestow: bestow,bestowed
bet: bet
betake: betaking
bethel: bethel
bethesda: bethesda
betray: betray,betrayed,betraying
beverage: beverage
beverly: beverly
bible: bible
bickering: bickering
bid: bade,bidding
binary: binary
bind: binding,bound
binding: bindings
biographer: biographer
bird: bird,birds
birth: birth
birthplace: birthplace
bishop: bishop
bit: bit
bitter: bitter
bitterly: bitterly
bitterness: bitterness
bivouac: bivouac,bivouacked,bivouacking
black: black,blacks
blacksmith: blacksmith,blacksmiths
blackwater: blackwater
blade: blade,blades
blair: blair
blame: blame
blank: blank,blanks
blanket: blanket,blankets
blast: blast,blasted
blaze: blaze,blazing
bleed: bled
bless: bless
blind: blind
blindfold: blindfolded
blindness: blindness
bliss: bliss
block: block,blocked
blockade: blockade,blockaded,blockading
blockading: blockading
blood: blood
blooded: blooded
bloodhound: bloodhound,bloodhounds
bloodless: bloodless
bloodshed: bloodshed
bloody: bloodiest,bloody
blouse: blouse
blow: blew,blow,blowing,blown
blue: blue
bluff: bluff,bluffs
bluffs: bluffs
blunder: blunder,blunders
board: board,boarded,boards
boarding: boarding
boast: boast,boasted
boat: boat,boats
boatman: boatmen
bobby: bobby
bodied: bodied
bodily: bodily
body: bodies,body
boiler: boiler,boilers
bold: bold
boldly: boldly
boldness: boldness
bolivar: bolivar
bolt: bolt
bomb: bomb
bombard: bombarded
bombardment: bombardment
bone: bones
bonfire: bonfires
book: book,books
boom: boom
booming: booming
boone: boone
boot: boot,boots
booth: booth,booths
border: border,bordered,bordering,borders
bore: boring
borrow: borrow,borrowed
bottle: bottle
boundary: boundaries,boundary
bountiful: bountiful
bourbon: bourbon
bout: bout
bow: bow,bowed,bowing
bowels: bowels
bowers: bowers
bowles: bowles
bowling: bowling
box: boxes
boy: boy,boys
boyd: boyd
boyhood: boyhood
brace: brace,bracing
brackish: brackish
brain: brain,brains
bran: bran
branch: branch,branches,branching
brand: branding
brandon: brandon
brandy: brandy
brass: brass
brave: brave,braver
bravely: bravely
bravery: bravery
brazenness: brazenness
breach: breach
bread: bread
break: break,breaking,breaks,broke,broken
breaker: breakers
breakfast: breakfast
breaking: breaking
breast: breast,breasts
breastwork: breastworks
breathe: breathe,breathed
breeching: breeching
breeze: breeze
brethren: brethren
brevet: brevet
brewster: brewster
brick: brick
bridge: bridge,bridged,bridges,bridging
bridgeport: bridgeport
bridle: bridle,bridles
brigade: brigade,brigades
brigades: brigades
brigadier: brigadier,brigadiers
brigadiers: brigadiers
bright: bright
brighten: brightened
brightly: brightly
brilliant: brilliant
bring: bring,bringing,brought
brink: brink
brisk: brisk
briskly: briskly
british: british
broad: broad
brock: brock
broken: broken
broker: broker,brokers
brooke: brooke
brooks: brooks
brother: brother,brothers
brough: brough
brow: brow
brown: brown
bruise: bruise
brunt: brunt
brush: brush,brushed
bryan: bryan
buchanan: buchanan
buck: buck
bucket: bucket
buckland: buckland
buffalo: buffalo
buggy: buggy
bugle: bugles
bugler: bugler,buglers
build: build,building,built
builder: builder,builders
building: building,buildings
bulk: bulk
bull: bull,bulls
bullet: bullet,bullets
bully: bully
bulwark: bulwarks
bummer: bummers
bundle: bundle,bundles
bunker: bunker
burden: burden,burdened
burdensome: burdensome
bureau: bureau
burgess: burgess
burial: burial
burke: burke
burlington: burlington
burn: burn,burned,burning,burnt
burning: burning
burnside: burnside
burst: burst,bursting
bursting: bursting
burton: burton
bury: buried,bury,burying
bush: bushes
bushes: bushes
bushwhack: bushwhacked
busily: busily
business: business
busy: busy
butcher: butchered
butler: butler
buzzard: buzzard
cabbage: cabbage
cabin: cabin,cabins
cabinet: cabinet
cable: cable
cadet: cadet,cadets
cadetship: cadetship
cairo: cairo
caisson: caissons
calculate: calculate,calculated
calculation: calculations
caliber: caliber,calibers
calibre: calibre
calico: calicoes
california: california
calling: calling
calm: calm
calmly: calmly
camden: camden
camp: camp,camped,camping,camps
campaign: campaign,campaigning,campaigns
campaigning: campaigning
campbell: campbell
canada: canada
canal: canal
candidate: candidate,candidates
candle: candles
candor: candor
cane: cane
canebrake: canebrakes
cannon: cannon
cannonade: cannonade
canoe: canoe
canteen: canteens
cantle: cantle
canton: canton
canvass: canvass,canvassed
capable: capable
capacious: capacious
capacity: capacities,capacity
cape: cape
capital: capital,capitals
capitol: capitol
capitulate: capitulated
capitulation: capitulation
capron: capron
captain: captain,captains
captaincy: captaincies,captaincy
captains: captains
captive: captives
capture: capture,captured,captures,capturing
capturing: capturing
car: car,cars
carbine: carbines
carcass: carcasses
card: card,cards
care: care,cared,cares,caring
career: career
careful: careful
carefully: carefully
carelessly: carelessly
cargo: cargo,cargoes
carlin: carlin
carlos: carlos
carnage: carnage
carolina: carolina
carolinas: carolinas
carolinian: carolinian
carpenter: carpenters
carpet: carpet,carpeted,carpets
carr: carr
carriage: carriage,carriages
carroll: carroll
carry: carried,carries,carry,carrying
cart: cart
cartel: cartel
carter: carter
cartridge: cartridge,cartridges
carve: carved,carving
cascades: cascades
casey: casey
cash: cash
cass: cass
cast: cast,casting
casting: casting
castle: castle
casualty: casualties,casualty
catastrophe: catastrophe
catch: catch,catching,caught
catcher: catchers
catharpin: catharpin
catholic: catholic
cattle: cattle
causeway: causeway,causeways
caution: caution,cautioned,cautioning
cautious: cautious
cautiously: cautiously
cavalry: cavalry
cavalryman: cavalrymen
cave: cave,caves
cavity: cavities,cavity
cease: cease,ceased
ceaseless: ceaseless
cedar: cedar
cede: ceded
ceiling: ceiling
celebrate: celebrate,celebrated
celebrated: celebrated
cen: cen
cent: cent,cents
central: central
centre: centre,centres
century: centuries,century
cereal: cereals
ceremony: ceremony
certainty: certainty
certificate: certificate
cessation: cessation
chafe: chafe
challenge: challenge
chamber: chambers
chamberlain: chamberlain
champion: champion
chance: chance,chances
chandler: chandler
change: change,changed,changing
changed: changed
channel: channel,channels
chaotic: chaotic
chaparral: chaparral
chaplain: chaplain,chaplains
chapman: chapman
chapter: chapter
character: character,characters
characteristic: characteristic,characteristics
characteristics: characteristics
characterize: characterized
charge: charge,charged,charges,charging
charitable: charitable
charity: charities,charity
charles: charles
charleston: charleston
charlotte: charlotte
charlottesville: charlottesville
charm: charm,charms
charter: chartered
charts: charts
chase: chase
chasm: chasm,chasms
chattanooga: chattanooga
chattel: chattels
cheap: cheap
check: check,checked,checks
cheer: cheer,cheered,cheering,cheers
cheerfully: cheerfully
cheerfulness: cheerfulness
cheering: cheering
cheerless: cheerless
chesapeake: chesapeake
chest: chest,chests
chesterfield: chesterfield
chew: chew,chewing
chicago: chicago
chickahominy: chickahominy
chickamauga: chickamauga
chickasaw: chickasaw
chicken: chicken,chickens
chicot: chicot
chief: chief,chiefs
chiefly: chiefly
child: child,children
chilicothe: chilicothe
chin: chin
chock: chocking
choice: choice
choke: choked
cholera: cholera
choose: choose,chose,chosen
choosing: choosing
chop: chopping
chopper: choppers
christ: christ
christian: christian
christmas: christmas
chum: chum
church: church,churches
cigarette: cigarette,cigarettes
cincinnati: cincinnati
cipher: cipher,ciphers
circle: circle,circles
circuitous: circuitous
circulate: circulated
circulation: circulation
circumstance: circumstance,circumstances
citadel: citadel
citizen: citizen,citizens
citizens: citizens
citizenship: citizenship
city: cities,city
civil: civil
civilian: civilian,civilians
civilization: civilization
civilized: civilized
civilly: civilly
clad: clads
claiborne: claiborne
claim: claim,claimed,claiming,claims
claimant: claimants
clamor: clamor,clamored
clamoring: clamoring
clarke: clarke
clarksville: clarksville
class: class,classes
classify: classified
classmate: classmate
clay: clay
clean: cleaned
clearing: clearing,clearings
clearness: clearness
clergyman: clergyman
clerk: clerk
clerkship: clerkship
cleveland: cleveland
climate: climate
climb: climb,climbed,climbing
climbing: climbing
clinch: clinch
clinton: clinton
clockwork: clockwork
close: close,closed,closes,closest,closing
closely: closely
closet: closeted
cloth: cloth,cloths
clothe: clad,clothe,clothed
clothes: clothes
clothing: clothing
cloud: cloud,clouds
cloudy: cloudy
club: clubs
cluster: cluster,clusters
coal: coal
coalfield: coalfield
coarse: coarse
coast: coast,coasts
coat: coat,coats
cobb: cobb
cocked: cocked
code: codes
coerce: coerce,coerced
coercion: coercion
coffee: coffee
coil: coil
coin: coin
col: col
cold: cold,colder
coldness: coldness
cole: cole
collapse: collapse
collar: collar,collars
collateral: collateral
collect: collect,collected,collecting,collects
collecting: collecting
collection: collection
collector: collector
college: college
collision: collision
colonel: colonel,colonels
colonelcy: colonelcy
colonels: colonels
colonist: colonists
colonize: colonize,colonized
colony: colonies,colony
color: color,colored,colors
colorado: colorado
colored: colored
colossal: colossal
colt: colt
columbia: columbia
columbus: columbus
column: column,columns
combat: combat,combats
combine: combined
combined: combined
comfort: comfort,comforted,comforts
comfortable: comfortable
comfortably: comfortably
comfortless: comfortless
coming: coming
command: command,commanded,commanding,commands
commandant: commandant
commander: commander,commanders
commanders: commanders
commanding: commanding
commence: commence,commenced,commences,commencing
commencement: commencement
commendable: commendable
commendation: commendation,commendations
comment: commenting,comments
commerce: commerce
commercial: commercial
commingling: commingling
commissary: commissaries,commissary
commission: commission,commissioned,commissions
commissioned: commissioned
commissioner: commissioner,commissioners
commit: commit,committed
commodious: commodious
common: common
commonwealth: commonwealth
commotion: commotion
communicate: communicate,communicated,communicating
communication: communication,communications
communicative: communicative
community: communities,community
compact: compact
companion: companion,companions
company: companies,company
comparative: comparative
comparatively: comparatively
compare: compare,compared,comparing
comparison: comparison
compass: compass
compel: compel,compelled,compels
compelling: compelling
compensate: compensate,compensated
compensation: compensation
compete: compete
competence: competence
competency: competency
competent: competent
competitor: competitor
compilation: compilation
compile: compiled
compiled: compiled
complacent: complacent
complain: complained,complaining
complainant: complainant
complaint: complaint,complaints
complaints: complaints
complement: complement
complete: complete,completed,completing
completely: completely
completion: completion
compliance: compliance
complicate: complicated
complication: complication
compliment: compliment
complimentary: complimentary
comply: complied,comply,complying
compose: composed,composing
composure: composure
compress: compressed
comprise: comprising
compromise: compromise
compulsion: compulsion
compulsory: compulsory
computation: computation
compute: computed
comrade: comrades
comstock: comstock
concave: concave
conceal: conceal,concealed,concealing
concealment: concealment
concede: concede
conceit: conceit,conceited
conceive: conceive,conceived
conceived: conceived
concentrate: concentrate,concentrated,concentrating
concentration: concentration
concentric: concentric
concept: concept
conception: conception
concern: concerned
concerned: concerned
concert: concert
concession: concessions
concisely: concisely
conclude: conclude,concluded
conclusion: conclusion
conclusive: conclusive
concord: concord
concurrence: concurrence
condemn: condemning
condition: condition,conditions
conditional: conditional
conditionally: conditionally
conducive: conducive
conduct: conduct,conducted,conducting
conestoga: conestoga
confederacy: confederacy
confederate: confederate,confederates
confederates: confederates
confederation: confederation
confer: confer,conferred,conferring
conference: conference
confess: confess
confession: confession
confide: confided
confidence: confidence
confident: confident
confidential: confidential
confidentially: confidentially
confine: confine,confined
confirm: confirm,confirmed
confirmation: confirmation
confiscate: confiscated,confiscating
conflagration: conflagration
conflict: conflict,conflicts
conform: conform
conformity: conformity
confront: confront,confronted,confronting
confuse: confuse
confused: confused
confusion: confusion
congenial: congenial
congratulate: congratulate,congratulated,congratulating
congratulation: congratulations
congratulatory: congratulatory
congregate: congregated
congregation: congregation
congress: congress
congressional: congressional
congressman: congressmen
conjunction: conjunction
connect: connect,connected,connecting,connects
connecticut: connecticut
connection: connection,connections
conquer: conquered,conquering
conqueror: conqueror
conquest: conquest,conquests
conscience: conscience
conscientious: conscientious
conscientiously: conscientiously
consciousness: consciousness
conscript: conscripting,conscripts
conscription: conscription,conscriptions
consent: consent,consented
consequence: consequence,consequences
consequent: consequent
consequential: consequential
considerable: considerable
considerably: considerably
consideration: consideration,considerations
consist: consist,consisted,consisting
consistent: consistent
console: consoled
consolidate: consolidate,consolidated
consolidation: consolidation
conspicuous: conspicuous
conspicuously: conspicuously
conspiracy: conspiracy
conspire: conspiring
constant: constant
constantly: constantly
consternation: consternation
constituent: constituents
constitute: constitute,constituted,constituting
constituting: constituting
constitution: constitution
constitutional: constitutional
constitutionality: constitutionality
construct: construct,constructed,constructing
construction: construction
constructively: constructively
construe: construed
consult: consult,consulted,consulting
consultation: consultation
consume: consume,consumed,consuming
consumer: consumer
consummate: consummate,consummated
consummation: consummation
consumption: consumption
contact: contact
contemplate: contemplate,contemplated
contemplation: contemplation
contemporary: contemporaries
contempt: contempt
contend: contend,contending
contented: contented
contents: contents
contest: contest,contested,contests
contestant: contestants
contested: contested
continent: continent
continental: continental
contingency: contingencies,contingency
continually: continually
continuance: continuance
continue: continue,continued,continues,continuing
continuity: continuity
continuous: continuous
continuously: continuously
contraband: contraband
contract: contract,contracted,contracts
contractor: contractor
contradiction: contradiction
contradictory: contradictory
contrary: contrary
contrast: contrast,contrasted
contribute: contribute,contributed,contributing
contribution: contributions
contributor: contributor
control: control,controlled,controlling
controversy: controversy
convalescent: convalescent,convalescents
convene: convened,convening
convenience: conveniences
convenient: convenient
conveniently: conveniently
convening: convening
convention: convention
converge: converge,converging
conversation: conversation,conversations
conversationalist: conversationalist
converse: converse,conversed,conversing
convert: convert,converted,converting
convey: convey,conveyed
conveyance: conveyance
convict: convicts
conviction: conviction
convince: convince,convinced,convincing
convinced: convinced
convoy: convoy,convoyed,convoying
cook: cook,cooked,cooking,cooks
cooking: cooking
cool: cool
coolness: coolness
cooper: cooper
cooperate: cooperate
cooperation: cooperation
cooperative: cooperative
cope: cope
copper: copper
copperhead: copperhead
copying: copying
copyright: copyright
cord: cord,cords
cordiality: cordiality
cordially: cordially
corduroy: corduroy,corduroyed
corinth: corinth
cork: cork,corked
corn: corn
corner: corner,corners
corners: corners
cornfield: cornfield
cornmeal: cornmeal
corporal: corporal,corporals
corporation: corporation
corps: corps
corpse: corpse
corpus: corpus
corral: corral,corralled
correct: correct
correctly: correctly
correctness: correctness
correspond: correspond
correspondence: correspondence
correspondent: correspondent,correspondents
correspondingly: correspondingly
corrupt: corrupt
corse: corse
cortez: cortez
cost: cost,costs
costly: costly
cottage: cottage
cotton: cotton
cough: cough
council: council
count: count,counted,counting
countenances: countenances
counter: counter
counterbalance: counterbalanced
countermand: countermanded,countermanding
countermarch: countermarch
countermine: countermine,countermined
countermining: countermining
countersign: countersign
country: countries,country
countryman: countrymen
county: county
coupee: coupee
couple: couple,coupled
courage: courage
courier: courier,couriers
court: court,courts
courteously: courteously
courtesy: courtesy
courtney: courtney
cousin: cousin
cover: cover,covered,covering,covers
covered: covered
covet: coveted
coveted: coveted
cow: cow
coward: cowards
cowardice: cowardice
cox: cox
cracker: cracker
cradle: cradle
craft: craft
craig: craig
crash: crash
crater: crater
crawl: crawl
create: create,created,creating
creation: creation
credentials: credentials
credibility: credibility
credit: credit,credited,crediting
creditable: creditable
creed: creed
creek: creek,creeks
creep: creeping
crest: crest
crestfallen: crestfallen
crevasse: crevasse
crew: crew,crews
crime: crime
criminal: criminal,criminals
crimination: crimination
cripple: cripple,crippled
crippled: crippled
crippling: crippling
crisis: crisis
critic: critics
critical: critical
criticise: criticise,criticised
criticism: criticism,criticisms
criticisms: criticisms
croak: croaking
crocker: crocker
crook: crook
crop: crop,crops
cross: cross,crossed,crosses,crossing
crossing: crossing,crossings
crosswise: crosswise
crouch: crouched
crowbar: crowbars
crowd: crowd,crowded,crowding,crowds
crown: crown
cruces: cruces
cruel: cruel
cruelty: cruelty
crumble: crumble,crumbling
crump: crump
crush: crush,crushed,crushing
crutch: crutches
culminate: culminated
culpable: culpable
cultivate: cultivate,cultivated
cultivation: cultivation
culvert: culverts
cumberland: cumberland
cure: cured
curiosity: curiosities,curiosity
current: current,currents
curtis: curtis
curvature: curvature
cushing: cushing
custom: custom,customs
customer: customers
cut: cut,cuts,cutting
cutler: cutler
cutting: cutting
cypher: cypher
cypress: cypress
cyrus: cyrus
daguerreotype: daguerreotype
daily: daily
dallas: dallas
dally: dallying
dalton: dalton
dam: dam,dammed,dams
damage: damage,damaged
damaged: damaged
damages: damages
damaging: damaging
damn: damn
dampen: dampen
dana: dana
danger: danger,dangers
dangerous: dangerous
dangerously: dangerously
daniel: daniel
darby: darby
daring: daring
dark: dark
darkness: darkness
darling: darling
darning: darning
dash: dash,dashed,dashing
dated: dated
datum: data
daughter: daughter,daughters
david: david
davies: davies
davis: davis
dawn: dawn,dawning
day: day,days
daylight: daylight
deacon: deacon
dead: dead
deadly: deadly
deal: deal,dealing
dealer: dealers
dealings: dealings
dearly: dearly
death: death
debar: debarred
debark: debark,debarked,debarking
debarkation: debarkation
debate: debate,debates
debater: debater
debating: debating
debouch: debouches
debris: debris
debt: debt,debts
decamp: decamped
deceive: deceive,deceived
december: december
deception: deception
decide: decide,decided,decides,deciding
decidedly: decidedly
decimate: decimated
decimation: decimation
decision: decision
decisive: decisive
deck: deck,decks
declaim: declaimed
declaration: declaration
declare: declare,declared,declares,declaring
decline: decline,declined,declining
declivity: declivity
decree: decree
dedication: dedication
deduct: deducting
deductible: deductible
deed: deeds
deem: deem,deemed,deeming,deems
deep: deep,deeper,deepest
deepen: deepen,deepening
deer: deer
defeat: defeat,defeated,defeating,defeats
defect: defect,defects
defective: defective
defence: defence,defences
defenceless: defenceless
defences: defences
defend: defend,defended,defending
defender: defenders
defense: defense
defensible: defensible
defensive: defensive
defensively: defensively
defer: defer,deferred,deferring
deference: deference
defiant: defiant
deficiency: deficiencies,deficiency
deficient: deficient
defile: defile,defiled,defiles
define: defined
definite: definite
deflection: deflection
defunct: defunct
defy: defying
degradation: degradation
degrade: degraded
degraded: degraded
degree: degree
dejection: dejection
del: del
delaware: delaware
delay: delay,delayed,delaying,delays
delegation: delegation
deletion: deletions
deliberate: deliberate
deliberately: deliberately
delicate: delicate
delight: delight
delighted: delighted
delightful: delightful
deliver: deliver,delivered,delivering
delivery: delivery
demagogue: demagogues
demand: demand,demanded,demanding,demands
demerit: demerits
democracy: democracy
democrat: democrat
democratic: democratic
demonstrate: demonstrate,demonstrated,demonstrates
demonstration: demonstration,demonstrations
demoralization: demoralization
demoralize: demoralized,demoralizing
demoralized: demoralized
demoralizing: demoralizing
dennis: dennis
denominate: denominated
denomination: denomination,denominations
denote: denote
denounce: denounce,denounced,denouncing
dense: dense
densely: densely
density: density
dent: dent
denunciation: denunciation,denunciations
deny: denied,denies,deny
depart: depart,departed
department: department,departments
departments: departments
departure: departure
depend: depend,depended,depending,depends
dependency: dependencies
dependent: dependent
depict: depicted
deplete: depleted,depleting
depletion: depletion,depletions
deplorable: deplorable
deploy: deploy,deployed
deposit: deposit,deposited
depot: depot,depots
depressed: depressed
depressing: depressing
depression: depression
deprive: deprive,deprived,depriving
depth: depth
derivative: derivative
derive: derive,derived
descend: descended,descending,descends
descendant: descendant,descendants
descent: descent
description: description
desert: desert,deserted
deserted: deserted
deserter: deserter,deserters
desertion: desertion,desertions
deserve: deserve,deserved,deserves
deservedly: deservedly
deserving: deserving
design: design,designed,designs
designate: designate,designated,designating
designation: designation
designedly: designedly
desirable: desirable
desire: desire,desired,desiring
desirous: desirous
desist: desist
desk: desk
despair: despair
despaired: despaired
despatch: despatch,despatches
desperate: desperate
desperately: desperately
desperation: desperation
despise: despised
despondency: despondency
despondent: despondent
despotism: despotism
destination: destination,destinations
destine: destined
destiny: destiny
destitute: destitute
destroy: destroy,destroyed,destroying,destroys
destruction: destruction
detach: detach,detached,detaches,detaching
detached: detached
detachment: detachment,detachments
detailed: detailed
detain: detain,detained,detaining
detect: detect,detected
detection: detection
detention: detention
deter: deterred
determination: determination
determine: determine,determined,determining
determined: determined
detest: detested
detour: detour
detract: detracting
detroit: detroit
devastation: devastation
develop: developed,developing
device: device
devil: devil
devise: devise,devised
devolve: devolved,devolves,devolving
devote: devote,devoted
devoted: devoted
devotion: devotion
devour: devour
diagonally: diagonally
diameter: diameter
diamond: diamond
diana: diana
diary: diary
dick: dick
dictate: dictate,dictated
dictation: dictation
die: die,died,dying
difference: difference,differences
difficult: difficult
difficulty: difficulties,difficulty
dig: dig,digging
digest: digesting
digging: digging
dignity: dignity
digression: digression
dilapidated: dilapidated
dilatoriness: dilatoriness
dilatory: dilatory
dilemma: dilemma
diligently: diligently
dimension: dimensions
diminish: diminish
diminished: diminished
dine: dine
dinner: dinner
dint: dint
dire: dire
direct: direct,directed,directing
direction: direction,directions
director: director
dirt: dirt
dirty: dirty
disability: disabilities,disability
disable: disable
disabled: disabled
disabused: disabused
disadvantage: disadvantages
disagreeable: disagreeable
disagreement: disagreements
disappear: disappeared,disappears
disappoint: disappoint,disappointed
disappointed: disappointed
disappointment: disappointment,disappointments
disapproval: disapproval
disapprove: disapprove,disapproved
disapproving: disapproving
disarrange: disarrange
disaster: disaster,disasters
disastrous: disastrous
disband: disband,disbanded
disbanding: disbanding
disbandment: disbandment
discharge: discharge,discharged,discharges
disciplinarian: disciplinarian
discipline: discipline,disciplined
disciplined: disciplined
disclaim: disclaim
disclaimer: disclaimer,disclaimers
disclose: disclosed,disclosing
discomfiture: discomfiture
discomfort: discomfort
disconnect: disconnected
discontent: discontent
discontinue: discontinue
discourage: discourage,discouraged,discouraging
discouraged: discouraged
discouraging: discouraging
discourtesy: discourtesy
discover: discover,discovered,discovering
discovery: discovery
discreet: discreet
discretion: discretion
discriminating: discriminating
discuss: discuss,discussed,discussing
discussion: discussion,discussions
disease: disease,diseases
disembarkation: disembarkation
disgrace: disgrace
disgraceful: disgraceful
disgracefully: disgracefully
disguise: disguise
disgust: disgust
disgusted: disgusted
dishearten: dishearten,disheartened
disheartened: disheartened
dishonorable: dishonorable
disinclination: disinclination
disinclined: disinclined
disintegration: disintegration
disk: disk
dislodge: dislodge,dislodged,dislodging
disloyal: disloyal
disloyalty: disloyalty
dismal: dismal
dismiss: dismissed
dismount: dismount,dismounted,dismounting
dismounted: dismounted
disobedience: disobedience
disorder: disorder
disorganized: disorganized
disparity: disparity
dispatch: dispatch,dispatched,dispatches
dispel: dispelled
dispense: dispensed
dispersal: dispersal
disperse: disperse,dispersed,dispersing
display: display,displayed,displaying
disposal: disposal
dispose: dispose,disposed,disposes
disposed: disposed
disposition: disposition,dispositions
dispossess: dispossess,dispossessing
disprove: disprove
disputatious: disputatious
dispute: dispute,disputed,disputing
disqualification: disqualification
disqualify: disqualified
disregard: disregard,disregarding
disreputable: disreputable
disrespect: disrespect
disrespectful: disrespectful
dissatisfaction: dissatisfaction
dissatisfied: dissatisfied
disseminate: disseminate
dissipate: dissipated
distance: distance,distances
distant: distant
distaste: distaste
distasteful: distasteful
distinct: distinct
distinction: distinction,distinctions
distinctly: distinctly
distinguish: distinguish,distinguished
distinguished: distinguished
distress: distress,distressed
distressing: distressing
distribute: distribute,distributed,distributing
distribution: distribution
distributor: distributor
district: district,districts
distrust: distrust
distrustful: distrustful
disturb: disturbed
disturbance: disturbance
disturbed: disturbed
disuse: disuse
ditch: ditch,ditches
div: div
diverge: diverge
diversion: diversion
divert: divert,diverted
divide: divide,divided,divides,dividing
divine: divine,divined
divinity: divinity
division: division,divisions
divulge: divulge,divulged
dix: dix
doctor: doctor,doctors
document: document,documents
dodge: dodge
dog: dog
dole: dole
doles: doles
dollar: dollar,dollars
domain: domain
domestic: domestic
donate: donate
donation: donation,donations
donor: donors
doom: doom,doomed
door: door,doors
dorado: dorado
dorn: dorn
double: double,doubled
doubloon: doubloons
doubt: doubt,doubted,doubting,doubts
doubtless: doubtless
douglas: douglas
douse: doused
dover: dover
downfall: downfall
download: downloading
dozen: dozen
draft: draft
drag: dragged
dragoon: dragoons
drain: drains
draper: draper
draw: draw,drawing,drawn,draws,drew
drawback: drawbacks
dray: drays
drayman: drayman
dread: dread,dreaded
dream: dream,dreamed,dreaming,dreams
drearily: drearily
dreary: dreary
dredge: dredges
drenching: drenching
dress: dress,dressed
dressing: dressing
drill: drill,drilled
drink: drink,drinking,drinks
drinking: drinking
drive: drive,driven,driving,drove
driver: drivers
drizzling: drizzling
drop: drop,dropped,dropping,drops
dropping: dropping
drover: drover,drovers
drown: drowned
drury: drury
dry: dried,dry
dublin: dublin
duck: duck,ducks
dude: dude
duel: duel,duelling,duels
duly: duly
dun: dun
duncan: duncan
duplicate: duplicate,duplicates
duplicity: duplicity
duration: duration
duress: duress
dusk: dusk
dust: dust
dusty: dusty
dutch: dutch
duty: duties,duty
dwarf: dwarfed
dwell: dwelling
dwelling: dwelling
dye: dyed
eagerly: eagerly
eagle: eagle
ear: ear,ears
earnest: earnest
earnestly: earnestly
earnestness: earnestness
earnings: earnings
earth: earth
earthly: earthly
ease: ease,eased
easily: easily
east: east
easterly: easterly
eastern: eastern
eastward: eastward
easy: easier,easiest,easy
eat: ate,eat,eating
eaves: eaves
ebenezer: ebenezer
eddy: eddy
edge: edge
edition: edition,editions
editor: editor
educate: educated,educating
education: education,educations
educational: educational
edward: edward
effective: effective
effectual: effectual
effectually: effectually
efficiency: efficiency
efficient: efficient
efficiently: efficiently
effort: effort,efforts
effusion: effusion
egotist: egotist
egress: egress
egypt: egypt
eighteen: eighteen
eighth: eighth
eightieth: eightieth
eke: eked
el: el
elaboration: elaboration
elapse: elapsed
elated: elated
elbow: elbows
eld: eldest
elder: elder
elderly: elderly
elect: elect,elected,electing
election: election,elections
electioneer: electioneer
elector: elector
electricity: electricity
electrify: electrified
electronic: electronic
electronically: electronically
element: element,elements
elevated: elevated
elevation: elevation,elevations
eleventh: eleventh
elicit: elicit,elicited
eligible: eligible
eliminate: eliminated
elisha: elisha
elk: elk
eloquence: eloquence
elude: elude,eluded,eluding
email: email
emancipation: emancipation
embankment: embankment,embankments
embark: embark,embarked,embarking
embarkation: embarkation
embarrass: embarrass,embarrassing
embarrassed: embarrassed
embarrassing: embarrassing
embarrassment: embarrassment,embarrassments
embody: embodying
embolden: emboldened
embrace: embrace,embraced,embracing
embrasure: embrasure
emerge: emerged,emerging
emergency: emergencies,emergency
emigrate: emigrate,emigrated
eminent: eminent
eminently: eminently
emolument: emolument
emory: emory
emphasis: emphasis
emphatically: emphatically
empire: empire
employ: employ,employed,employing
employee: employee,employees
employing: employing
employment: employment
empower: empower
en: en
enable: enable,enabled,enabling
enact: enact,enacted,enacting
encamp: encamp,encamped
encampment: encampment
enclose: enclosed,enclosing
enclosure: enclosure
encode: encoding
encounter: encounter,encountered,encountering,encounters
encourage: encourage,encouraged,encouraging
encouraged: encouraged
encouragement: encouragement
encouraging: encouraging
encroach: encroach
encroachment: encroachments
encumber: encumbered
encumbrance: encumbrance
endanger: endanger,endangered,endangering
endeavor: endeavor,endeavored,endeavoring
endorse: endorsed
endorsement: endorsement
endurable: endurable
endurance: endurance
endure: endure,endured
enduring: enduring
enemy: enemies,enemy
energetic: energetic
energy: energies,energy
enervate: enervated
enfilade: enfiladed
enforce: enforce,enforced
enfranchise: enfranchise
enfranchisement: enfranchisement
engage: engage,engaged,engaging
engagement: engagement,engagements
engender: engender,engendered
engine: engine,engines
engineer: engineer,engineers
engineering: engineering
engineers: engineers
england: england
english: english
engrave: engraved
engraved: engraved
engross: engrossed
enjoin: enjoin,enjoined
enjoy: enjoy,enjoyed,enjoying
enjoyable: enjoyable
enjoyment: enjoyments
enlighten: enlightened
enlist: enlist,enlisted,enlisting
enlisted: enlisted
enlistment: enlistment,enlistments
enliven: enlivened
enmity: enmity
enormous: enormous
enormously: enormously
enrage: enrage
enrol: enrolled
ensue: ensue,ensued,ensuing
ensure: ensuring
entail: entailed
enter: enter,entered,entering,enters
enterprise: enterprise
entertain: entertain,entertained,entertaining,entertains
enthusiasm: enthusiasm
enthusiastic: enthusiastic
enthusiastically: enthusiastically
entire: entire
entitle: entitle,entitled
entity: entity
entrance: entrance
entry: entry
enumerate: enumerated
enumeration: enumeration
envelop: envelop,enveloped
enviable: enviable
envy: envied,envy
equal: equal,equalled
equality: equality
equally: equally
equip: equip,equipped
equipage: equipage
equipment: equipment
equipped: equipped
equivalent: equivalent
era: era
erasure: erasures
erect: erect,erected,erecting
err: err
erroneously: erroneously
error: error,errors
eruption: eruption
escape: escape,escaped,escaping
escaping: escaping
escort: escort,escorted,escorting,escorts
especial: especial
espouse: espoused
essential: essential
essex: essex
establish: establish,established,establishing
establishment: establishment
estate: estate,estates
esteem: esteem,esteemed
estimable: estimable
estimate: estimate,estimated,estimates,estimating
estimated: estimated
estimation: estimation
estop: estopped
estrange: estranged
estrangement: estrangement
etch: etched
etching: etching
eulogy: eulogy
europe: europe
european: european
evacuate: evacuate,evacuated,evacuating
evacuation: evacuation
evan: evan
evaporation: evaporation
evasive: evasive
eve: eve
evening: evening,evenings
event: event,events
eventual: eventual
evidence: evidence,evidences
evident: evident
evidently: evidently
evil: evil,evils
evince: evince
evolution: evolutions
ewing: ewing
exact: exact
exaggerate: exaggerated
exaggeration: exaggeration
exalt: exalted
examination: examination,examinations
examine: examine,examined,examining
exasperate: exasperated,exasperating
excavation: excavation
exceed: exceed,exceeded
exceedingly: exceedingly
excel: excelled
excellent: excellent
exception: exception
excessive: excessive
exchange: exchange,exchanged
excitable: excitable
excited: excited
excitement: excitement
exciting: exciting
exclaim: exclaimed
exclude: excluded,excludes,excluding
exclusion: exclusion
exclusive: exclusive
exclusively: exclusively
excruciating: excruciating
excursion: excursion
excuse: excuse,excused
execute: execute,executed,executing
execution: execution
executive: executive
executor: executor
exemplary: exemplary
exempt: exempt
exercise: exercise,exercised,exercises,exercising
exertion: exertion,exertions
exhaust: exhaust,exhausted,exhausting
exhausted: exhausted
exhausting: exhausting
exhaustion: exhaustion
exhibit: exhibited
exhibition: exhibition
exist: exist,existed,existing,exists
existence: existence
exonerate: exonerating
exorbitant: exorbitant
expand: expand
expatriated: expatriated
expect: expect,expected,expecting
expectation: expectation,expectations
expedient: expedient,expedients
expedite: expedite,expedited,expediting
expedition: expedition,expeditions
expeditious: expeditious
expel: expel,expelled,expelling
expend: expend,expended
expenditure: expenditure
expense: expense,expenses
expensive: expensive
experience: experience,experienced,experiences
experienced: experienced
experiment: experiment,experiments
expert: experts
expiration: expiration
expire: expire,expired
explain: explain,explained,explaining
explanation: explanation
expletive: expletive
explicit: explicit
explode: explode,exploded
exploit: exploit,exploits
exploration: explorations
explore: explore,explored
explorer: explorers
explosion: explosion,explosions
explosive: explosive,explosives
export: exporting
expose: expose,exposed,exposing
exposure: exposure,exposures
express: express,expressed,expressing
expression: expression,expressions
expressive: expressive
expressly: expressly
expulsion: expulsion
expunge: expunge
extend: extend,extended,extending,extends
extended: extended
extension: extension
extensive: extensive
extent: extent
extenuate: extenuated
exterminate: exterminated
extermination: extermination
extinction: extinction
extinguish: extinguish,extinguishing
extol: extolled
extort: extorted
extra: extra
extreme: extreme
extremely: extremely
extremist: extremist
extremity: extremity
extricate: extricated
exult: exult
eye: eye,eyes
fac: fac
facetiousness: facetiousness
facilitate: facilitate
facility: facilities,facility
facto: facto
factor: factor
factory: factories,factory
fade: fade
fag: fagged
fail: fail,failed,failing
failure: failure,failures
faint: faint,fainted,faintest
fair: fair
faith: faith
faithful: faithful
faithfully: faithfully
fall: fall,fallen,falling,falls,fell
fallacy: fallacy
fame: fame
familiar: familiar
familiarize: familiarize,familiarized
family: families,family
famine: famine
famish: famishing
famishing: famishing
famous: famous
fanatic: fanatic
fancy: fancy
fare: fare,faring
farm: farm,farmed,farming,farms
farmer: farmers
farmhouse: farmhouse
farming: farming
faro: faro
farth: farthest
fast: fast,faster
fasten: fastened,fastening
fastening: fastenings
fasting: fasting
fatal: fatal
fatally: fatally
fate: fate
father: father,fathers
fatigue: fatigue,fatigues
fatigued: fatigued
fault: fault
faultless: faultless
favor: favor,favored,favoring,favors
favorable: favorable
favorably: favorably
favorite: favorite
fear: fear,feared,fearing,fears
fearful: fearful
fearfully: fearfully
feasibility: feasibility
feasible: feasible
feast: feast
feat: feat
feature: feature
february: february
fed: fed
federal: federal
federals: federals
fee: fee,fees
feeble: feeble
feebly: feebly
feed: fed,feed,feeding
feeding: feeding
feel: feel,feeling
feeling: feeling,feelings
feint: feint
fell: felled,felling
fellow: fellow,fellows
female: female
fence: fence,fences
ferocious: ferocious
ferry: ferried,ferries,ferry,ferrying
fertile: fertile
fever: fever,fevers
fiction: fiction,fictions
field: field,fields
fierce: fiercer,fiercest
fifteenth: fifteenth
fight: fight,fighting,fights,fought
fighting: fighting
figure: figure,figured,figures
file: file,filed,files,filing
filibustering: filibustering
filling: filling
filter: filtered
final: final
finally: finally
financial: financial
finding: finding
fine: fine,finest
finish: finish,finished
firing: firing
firm: firm
firmly: firmly
firmness: firmness
fish: fish
fisher: fisher
fishing: fishing
fit: fit,fitted,fitter,fittest,fitting
fitness: fitness
fitz: fitz
fixed: fixed
flag: flag,flags
flagrant: flagrant
flagship: flagship
flame: flames
flamingo: flamingo
flank: flank,flanked,flanking,flanks
flash: flashes
flat: flat,flats
flatten: flattens
flatter: flatters
flaunt: flaunted
fledged: fledged
flee: fled,flee,fleeing
fleet: fleet,fleets
flight: flight
flinch: flinching
flint: flint
float: float,floated,floating
flock: flock
flood: flood,floods
floor: floor
florence: florence
florida: florida
flounder: floundering
flour: flour
flourish: flourishing
flow: flow,flowing,flows
floyd: floyd
flurry: flurry
flush: flush
flutter: flutter
fly: flew,fly,flying
flying: flying
foe: foe
fog: fog
foggy: foggy
foil: foil
fold: folded
follow: follow
folly: folly
fond: fond
food: food
fool: fool
foolhardiness: foolhardiness
foot: feet,foot
footed: footed
foothold: foothold,footholds
footing: footing
footnote: footnote
forage: forage,foraged
forager: foragers
forbid: forbade,forbid,forbidden
force: force,forced,forces,forcing
forces: forces
forcible: forcible
forcibly: forcibly
ford: ford,forded,fording,fords
fordable: fordable
fore: fore
forego: forego,foregoing
foregone: foregone
foreign: foreign
foreigner: foreigners
forelock: forelock
foremost: foremost
forenoon: forenoon
foresee: foresee,foreseen
foresight: foresight
forest: forest,forests
forestall: forestalling
foretell: foretell
forget: forget,forgetting,forgot,forgotten
forgive: forgive
fork: fork,forked,forks
forks: forks
forlorn: forlorn
form: form,formed,forming,forms
formal: formal
formality: formalities
format: format,formats
formation: formation
formidable: formidable
formidably: formidably
fort: fort,forts
fortification: fortification,fortifications
fortifications: fortifications
fortified: fortified
fortify: fortified,fortifies,fortify,fortifying
fortitude: fortitude
fortress: fortress
fortunate: fortunate
fortunately: fortunately
fortune: fortune,fortunes
forwarding: forwarding
foster: foster
foundation: foundation
founder: founder,founders
foundry: foundries,foundry
fourteen: fourteen
fourteenth: fourteenth
fourth: fourth
fox: fox
fragment: fragments
frame: framed
framer: framers
framing: framing
france: france
francis: francis
francisco: francisco
franco: franco
frank: frank
franklin: franklin
frantic: frantic
fraternize: fraternize,fraternized
fray: fray
fred: fred
frederick: frederick
freedman: freedman,freedmen
freedmen: freedmen
freedom: freedom
freely: freely
freeze: freezing,frozen
freight: freight
french: french
frenzy: frenzy
frequency: frequency
frequent: frequent
frequently: frequently
fresh: fresh
friday: friday
friend: friend,friends
friendly: friendly
friendship: friendship
fright: fright
frighten: frightened
frightened: frightened
frightful: frightful
fringe: fringed
fritter: frittering
fro: fro
frontier: frontier,frontiers
frontiersman: frontiersmen
frontispiece: frontispiece
frontpiece: frontpiece
fruit: fruits
fruitful: fruitful
frustrate: frustrated
fuel: fuel
fugitive: fugitive,fugitives
fulfil: fulfilled
fulfilment: fulfilment
fuller: fuller
fulsome: fulsome
function: functions
fund: fund,funds
furious: furious
furiously: furiously
furlough: furlough
furnace: furnace
furnish: furnish,furnished
furnishing: furnishing
furniture: furniture
furrowing: furrowing
fury: fury
fuse: fuses
fusillade: fusillade
future: future
gain: gain,gained,gaining
galena: galena
gallant: gallant
gallantly: gallantly
gallantry: gallantry
gallery: gallery
gallop: gallop,galloped
gallows: gallows
galt: galt
gamble: gambling
gambling: gambling
game: game
gang: gang
gap: gap,gaps
garb: garb
garden: garden,gardens
garland: garland
garment: garments
garrison: garrison,garrisoned,garrisons
gate: gate,gates
gates: gates
gather: gather,gathered,gathering
gathering: gathering
gauge: gauge
gauntlet: gauntlet
gen: gen
genealogy: genealogy
generalcy: generalcy
generals: generals
generalship: generalship
generation: generation,generations
generosity: generosity
generous: generous
genial: genial
genius: genius
gentle: gentle
gentleman: gentleman,gentlemen
gentlemanly: gentlemanly
gently: gently
geo: geo
geographical: geographical
geography: geography
george: george
georgia: georgia
german: germans
germania: germania
gershom: gershom
gettysburg: gettysburg
gibbon: gibbon
gibe: gibes
gibson: gibson
gift: gift
giles: giles
gin: gin,gins
ginning: ginning
girl: girl,girls
glad: glad,gladder
glance: glance
glass: glass,glasses
glean: gleaned
glimpse: glimpse
glisten: glistened
glorious: glorious
glory: glory
glove: gloves
goal: goals
god: god
godspeed: godspeed
gold: gold
goliad: goliad
goodness: goodness
gordon: gordon
gore: gore
gorge: gorge
govern: govern,governed,governing,governs
government: government,governments
governor: governor,governors
gown: gown
graciously: graciously
grade: grade,graded,grades
gradual: gradual
gradually: gradually
graduate: graduate,graduated,graduates,graduating
graduation: graduation
grain: grain
grand: grand
grande: grande
grandeur: grandeur
grandfather: grandfather
grandmother: grandmother
grandparent: grandparents
grange: grange
granger: granger
granny: granny
grant: grant,granted,granting
grape: grape
graphic: graphic
graphically: graphically
grasp: grasp
grass: grass
grateful: grateful
gratefully: gratefully
gratification: gratification
gratified: gratified
gratify: gratify
gratifying: gratifying
gratitude: gratitude
grave: grave,graves
gravelly: gravelly
gravity: gravity
gray: gray
graze: grazing
grazing: grazing
greatly: greatly
greek: greek
green: green
greenwood: greenwood
greet: greet,greeted
gregg: gregg
grenada: grenada
grenade: grenades
grief: grief
grievance: grievance,grievances
griffin: griffin
grimes: grimes
grind: grind
grindstone: grindstone
grip: grip
grocery: groceries
gross: gross
ground: ground,grounded,grounding
grounds: grounds
grove: grove
grow: grew,grow,growing,grown
growth: growth,growths
guarantee: guarantees
guard: guard,guarded,guarding,guards
guardian: guardian
guerilla: guerilla,guerillas
guess: guess,guessing
guest: guest,guests
guidance: guidance
guide: guide,guided,guides
guilty: guilty
gulf: gulf
gully: gullies,gully
gun: gun,gunning,guns
gunboat: gunboat,gunboats
gunner: gunners
gunshot: gunshot
gutter: gutter
gyrate: gyrating
habit: habit,habits
habitation: habitation
habitually: habitually
hacienda: hacienda
hail: hailed,hailing
haired: haired
halls: halls
halt: halt,halted,halting
halted: halted
halter: halters
hamburg: hamburg
hamilton: hamilton
hamlet: hamlet,hamlets
hammer: hammer
hand: hand,handed,handing,hands
handing: handing
handkerchief: handkerchief
handle: handle,handled,handling
handsome: handsome
handsomely: handsomely
handwriting: handwriting
handy: handy
hang: hang,hung
hannibal: hannibal
hanover: hanover
happen: happen,happened,happening
happiness: happiness
happy: happy
harass: harass
harbor: harbor,harbors
hard: hard,hardest
hardness: hardness
hardship: hardship,hardships
hardy: hardy
harm: harm
harmless: harmless
harmlessly: harmlessly
harmonious: harmonious
harmoniously: harmoniously
harmony: harmony
harness: harness,harnessed
harper: harper
harris: harris
harrison: harrison
harry: harry
harsh: harsh
hart: hart
hartford: hartford
harvest: harvest,harvested
haste: haste
hasten: hasten,hastened,hastening
hastening: hastening
hastily: hastily
hasty: hasty
hat: hat
hatch: hatch
hatcher: hatcher
haul: hauled,hauling
hauling: hauling
haunch: haunches
haversack: haversacks
havoc: havoc
hawkins: hawkins
hay: hay
hayes: hayes
hays: hays
hazard: hazard,hazards
hazardous: hazardous
hazen: hazen
hazy: hazy
head: head,headed,heading,heads
headache: headache
headed: headed
headlong: headlong
headquarters: headquarters
headway: headway
heal: healed
health: health
healthy: healthy
heap: heaps
hear: hear,heard,hearing
hearer: hearers
hearing: hearing
heart: heart
hearted: hearted
heartily: heartily
hearty: hearty
heat: heat,heated,heating
heavily: heavily
heavy: heavier,heaviest,heavy
heed: heeded
heel: heels
height: height,heights
heir: heir
helena: helena
helpless: helpless
helplessly: helplessly
hem: hemmed
henry: henry
herculean: herculean
herd: herd
heretofore: heretofore
herewith: herewith
hermetically: hermetically
heroically: heroically
heroism: heroism
hesitate: hesitate,hesitated
hesitation: hesitation
heth: heth
hicks: hicks
hidalgo: hidalgo
hide: hide,hiding
highland: highlands
highly: highly
highway: highway
hill: hill,hills
hilled: hilled
hills: hills
hillside: hillside
hilt: hilt
hind: hind
hinderance: hinderance
hint: hint
hire: hire,hired,hiring
historian: historian
historical: historical
history: history
hit: hit,hitting
hitch: hitched,hitching
hoe: hoe
hoist: hoisted
hoisting: hoisting
hoke: hoke
hold: held,hold,holding,holds
holder: holder,holders
holding: holding
hole: hole,holed,holes
holiday: holiday,holidays
hollow: hollow
holly: holly
holmes: holmes
holt: holt
holy: holy
homestead: homestead
hon: hon
honest: honest
honesty: honesty
honey: honey
honor: honor,honors
honorable: honorable
honorably: honorably
hood: hood
hoof: hoof
hook: hook
hooker: hooker
hope: hope,hoped,hopes,hoping
hopeless: hopeless
hopelessness: hopelessness
horace: horace
horde: hordes
horn: horn,horns
horrible: horrible
horse: horse,horses
horseback: horseback
horseman: horseman,horsemen
hospital: hospital,hospitals
host: host
hostile: hostile
hostilities: hostilities
hostility: hostilities,hostility
hot: hot
hotel: hotel,hotels
hotly: hotly
hour: hour,hours
hourly: hourly
house: house,housed,houses
houseless: houseless
hover: hovered,hovering
howard: howard
howitzer: howitzer,howitzers
howitzers: howitzers
howl: howling
huddle: huddled
hudson: hudson
hug: hugged
huge: huge,huger
huger: huger
hugh: hugh
hulk: hulk
hull: hulls
human: human
humane: humane
humanity: humanity
humiliating: humiliating
humiliation: humiliation
humor: humor
hunt: hunt
hunter: hunter
huntley: huntley
hurl: hurl
hurried: hurried
hurriedly: hurriedly
hurry: hurry
hurt: hurt,hurting
husband: husband,husbanded,husbands
husk: husks
hut: hut,huts
ice: ice
idea: idea,ideas
identical: identical
identification: identification
identify: identify
identity: identity
idiom: idioms
idle: idle
idleness: idleness
ifs: ifs
ignorance: ignorance
ignorant: ignorant
ignore: ignore,ignoring
iii: iii
illinois: illinois
illness: illness
illogical: illogical
illustrate: illustrates
illustrating: illustrating
illustrations: illustrations
imaginable: imaginable
imaginary: imaginary
imagine: imagine,imagining
imbue: imbued
imitate: imitate
imitation: imitation
imitator: imitator
immaterial: immaterial
immense: immense
immigrant: immigrant
immigrate: immigrated
imminent: imminent
immoderately: immoderately
immunity: immunity
impart: impart,imparted
impassable: impassable
impassible: impassible
impatience: impatience
impatient: impatient
impecunious: impecunious
impede: impede,impeded
impediment: impediment
impel: impelled
impenetrable: impenetrable
imperative: imperative
imperfectly: imperfectly
implication: implication
imply: implied,implies,imply
import: import,imported,importing,imports
impose: imposed
impossibility: impossibility
impossible: impossible
impost: imposts
impracticable: impracticable
impregnable: impregnable
impress: impress,impressed
impressed: impressed
impression: impression,impressions
imprison: imprison
improbable: improbable
improve: improve,improved
improved: improved
improvidence: improvidence
improvise: improvised
imprudence: imprudence
impudence: impudence
impunity: impunity
inability: inability
inaccessible: inaccessible
inaccurate: inaccurate
inactive: inactive
inactivity: inactivity
inadequate: inadequate
inaugurate: inaugurated
inauguration: inauguration
incalculable: incalculable
incapable: incapable
incapacitate: incapacitated
incensed: incensed
inception: inception
incessant: incessant
incessantly: incessantly
inch: inch,inches
incident: incident,incidents
incidental: incidental
incivility: incivility
inclemency: inclemency
incline: inclined
inclined: inclined
inclose: inclosed,inclosing
include: include,included,includes,including
including: including
income: income
incompetency: incompetency
incompetent: incompetent
incomplete: incomplete
inconsistent: inconsistent
inconvenience: inconvenience
inconvenient: inconvenient
inconveniently: inconveniently
incorporate: incorporated
incorrect: incorrect
increase: increase,increased,increasing
incredibly: incredibly
incumbent: incumbent
incur: incur,incurred
incursion: incursions
indebt: indebted
indebted: indebted
indecision: indecision
indecisive: indecisive
indefinite: indefinite
indemnify: indemnify
indemnity: indemnity
independence: independence
independent: independent
independently: independently
indian: indian,indians
indiana: indiana
indianapolis: indianapolis
indication: indication,indications
indies: indies
indifferent: indifferent
indifferently: indifferently
indigenous: indigenous
indignant: indignant
indignantly: indignantly
indignation: indignation
indirect: indirect
indirectly: indirectly
indiscriminate: indiscriminate
indispensably: indispensably
indisputable: indisputable
individual: individual,individuals
individuality: individuality
individually: individually
indorsement: indorsement
induce: induce,induced,induces
inducement: inducement
indulge: indulged
industry: industry
inefficiency: inefficiency
inefficient: inefficient
ineligible: ineligible
inestimable: inestimable
inevitable: inevitable
inevitably: inevitably
inexhaustible: inexhaustible
inexperience: inexperience
inexperienced: inexperienced
infallibility: infallibility
infant: infant
infantry: infantry
infected: infected
infection: infection
infer: inferred
inferior: inferior
infest: infested
infinitely: infinitely
infirmity: infirmity
inflict: inflict,inflicted,inflicting
influence: influence,influences
inform: inform,informed,informing
informed: informed
infrequent: infrequent
infringe: infringing
infringement: infringement
ingenuity: ingenuity
inglorious: inglorious
ingloriously: ingloriously
ingratitude: ingratitude
ingress: ingress
inhabit: inhabited
inhabitant: inhabitant,inhabitants
inherent: inherent
inherit: inherited
inhuman: inhuman
initial: initials
initiate: initiate,initiated
initiative: initiative
injunction: injunctions
injure: injure,injured
injurious: injurious
injury: injury
injustice: injustice
inland: inland
inlet: inlet
innocent: innocent
innumerable: innumerable
inquire: inquire,inquired,inquiring
inquiry: inquiries,inquiry
insane: insane
insensible: insensible
insert: insert,inserted
insidious: insidious
insignificant: insignificant
insinuate: insinuating
insist: insist,insisted,insisting
insolent: insolent
inspect: inspect,inspected
inspection: inspection
inspector: inspectors
inspire: inspire,inspired
inst: inst
instance: instance,instanced,instances
instant: instant
instantaneous: instantaneous
instantaneously: instantaneously
instantly: instantly
instinct: instinct,instincts
institution: institution,institutions
instruct: instruct,instructed
instruction: instruction,instructions
instructor: instructor
instrument: instrument,instruments
instrumental: instrumental
instrumentality: instrumentality
insubordinate: insubordinate
insubordination: insubordination
insufficient: insufficient
insulate: insulated
insult: insult,insulting
insuperable: insuperable
insure: insure,insured,insuring
intact: intact
integral: integral
integrity: integrity
intellectual: intellectual
intelligence: intelligence
intelligent: intelligent
intelligently: intelligently
intend: intend,intended,intending
intended: intended
intense: intense
intensely: intensely
intent: intent
intention: intention,intentions
intentionally: intentionally
intercept: intercept,intercepted,intercepts
intercepting: intercepting
intercourse: intercourse
interfere: interfere,interfered,interfering
interference: interference
interior: interior
interlace: interlace,interlacing
interlineation: interlineations
intermarriage: intermarriage
intermediate: intermediate
intermingle: intermingling
intermission: intermission
internal: internal
international: international
internecine: internecine
interpose: interpose,interposed
interposition: interposition
interpret: interpreted
interrupt: interrupted
interruption: interruption
intersect: intersect,intersected,intersects
intersection: intersection
interval: interval,intervals
intervene: intervened,intervenes,intervening
intervention: intervention
interview: interview,interviews
intimacy: intimacy
intimate: intimate
intimately: intimately
intimation: intimation
intimidate: intimidating
intolerable: intolerable
intolerant: intolerant
intrench: intrench,intrenched,intrenching
intrenched: intrenched
intrenching: intrenching
intrenchment: intrenchment
intrepid: intrepid
intricate: intricate
intrigue: intrigue
introduce: introduce,introduced
introduction: introduction
intrusion: intrusion
intrust: intrust,intrusted,intrusting
inure: inured
inured: inured
invade: invade,invaded,invading
invader: invader,invaders
invalid: invalid
invalidity: invalidity
invariably: invariably
invasion: invasion
invent: invented
invest: invest,invested,investing
investigate: investigate
investigation: investigation
investment: investment
invitation: invitation
invite: invite,invited,inviting
involuntary: involuntary
involve: involved
inwardly: inwardly
iowa: iowa
irascible: irascible
irishman: irishman
iron: iron,irons
ironclad: ironclads
irreconcilable: irreconcilable
irregular: irregular
irregularity: irregularities
irregularly: irregularly
irreparable: irreparable
irretrievable: irretrievable
irrevocable: irrevocable
irs: irs
irvin: irvin
irving: irving
irwin: irwin
isaac: isaac
isabel: isabel
island: island,islands
islands: islands
isolate: isolate,isolated,isolating
issue: issue,issued,issues,issuing
isthmus: isthmus
iv: iv
ix: ix
jackson: jackson
jacksonville: jacksonville
jacob: jacob
jade: jaded
jalapa: jalapa
jam: jammed
james: james
january: january
jasper: jasper
jaw: jaw
jealous: jealous
jealousy: jealousies,jealousy
jeff: jeff
jefferson: jefferson
jeopardy: jeopardy
jericho: jericho
jerk: jerked
jersey: jersey
jerusalem: jerusalem
jesse: jesse
jew: jew
job: job
joe: joe
john: john
johnnies: johnnies
johnny: johnny
johnson: johnson
joint: joint
joke: joke
jones: jones
joseph: joseph
joshua: joshua
journal: journal
journey: journey
joy: joy
juan: juan
jubilant: jubilant
judah: judah
judge: judge,judged
judgment: judgment
judicial: judicial
judiciary: judiciary
judiciously: judiciously
julia: julia
july: july
jump: jump
junction: junction
juncture: juncture
june: june
junior: junior,juniors
jurisdiction: jurisdiction,jurisdictions
jurist: jurist
justice: justice
justifiable: justifiable
justification: justification
justified: justified
justify: justified,justify,justifying
justly: justly
kanawha: kanawha
kansas: kansas
keenly: keenly
kelly: kelly
kentucky: kentucky
ketch: ketch
kettle: kettles
key: key
khedive: khedive
kick: kick,kicked,kicking
kill: kill,killed,killing
killing: killing
kin: kin
kindhearted: kindhearted
kindly: kindly
kindness: kindness
kindred: kindred
king: king
kingston: kingston
kirby: kirby
kitching: kitching
knapsack: knapsacks
knee: knee
knife: knife,knives
knob: knob,knobs
knock: knock,knocked
knot: knot,knots
knowledge: knowledge
knoxville: knoxville
labor: labor,labored,laboring,labors
laborer: laborer,laborers
lace: lace
lack: lack,lacking
lad: lad
ladder: ladder
lady: ladies,lady
lafayette: lafayette
lake: lake,lakes
lame: lame
lameness: lameness
lance: lances
land: land,landed,landing,lands
landing: landing,landings
lane: lane
language: language
languid: languid
lapse: lapse,lapsed
lash: lashed
lasso: lasso,lassoed,lassos
late: late
lateness: lateness
lateral: lateral
latitude: latitude
laugh: laughed
lava: lava
law: law,laws
lawlessness: lawlessness
lawn: lawn
lawrence: lawrence
lawson: lawson
lawyer: lawyer,lawyers
lay: laid,lay,laying
layman: layman
lead: lead,leading,leads,led
leader: leader,leaders
leadership: leadership
leading: leading
leaf: leaf,leaves
league: league
leak: leaked
lean: leaning
leap: leap
learn: learn,learned,learning
learning: learning
leather: leather
leave: leave,leaves,leaving,left
leaven: leavened
leaving: leaving
lee: lee
left: left
leg: leg,legs
legal: legal
legally: legally
legislate: legislate
legislation: legislation
legislative: legislative
legislator: legislators
legislature: legislature,legislatures
leisurely: leisurely
lend: lent
lengthen: lengthened
leonard: leonard
lesson: lesson,lessons
letter: letter,lettered,letters
levee: levee,levees
level: level,levelling
lever: lever
levy: levies,levy
lew: lew
lewis: lewis
liability: liability
liable: liable
liberal: liberal
liberate: liberated
liberated: liberated
liberation: liberation
liberty: liberty
library: libraries,library
license: license
licensed: licensed
lick: lick
lie: lain,lie,lies,lying
lieu: lieu
lieutenant: lieutenant,lieutenants
lieutenants: lieutenants
life: life,lives
lift: lift,lifted
light: light,lighted,lighter,lightest,lit
lighten: lighten,lightening
lighter: lighters
lightly: lightly
lightning: lightning
limb: limb,limbs
limit: limit,limited,limiting,limits
limitation: limitation
limited: limited
lincoln: lincoln
link: linked,links
liquor: liquor
list: list
listen: listen,listened,listening
literally: literally
literary: literary
litter: litter,litters
liv: liv
live: live,lived,lives,living
lively: lively
living: living
lloyd: lloyd
load: load,loaded,loading,loads
loaded: loaded
loading: loading
loaf: loaf
loan: loaned,loans
loath: loath
local: local
locality: localities,locality
localize: localized
locate: locate,located,locating
location: location,locations
loche: loche
lock: lock,locked,locks
locomotive: locomotive,locomotives
lodge: lodge,lodged
lodgment: lodgment
log: log,logs
logan: logan
longevity: longevity
lookout: lookout
loom: looms
loop: loop
loose: loose
loosen: loosened
loring: loring
lose: lose,losing,lost
loss: loss,losses
lot: lot,lots
loud: loud
louis: louis
louisa: louisa
louisiana: louisiana
louisville: louisville
lounge: lounging
love: love
loyal: loyal
loyalty: loyalty
luck: luck
luckily: luckily
lucky: lucky
lumber: lumber
lunch: lunches
lunge: lunge
lurk: lurking
lustily: lustily
lusty: lusty
luther: luther
luxury: luxury
lx: lx
lxx: lxx
lying: lying
lyon: lyon
lysander: lysander
machine: machine,machines
machinery: machinery
macon: macon
mad: mad
madam: madam
madeira: madeira
madison: madison
madre: madre
madrid: madrid
magazine: magazine,magazines
magnificent: magnificent
magnify: magnified,magnifying
magnitude: magnitude
mahone: mahone
maiden: maiden
mail: mail,mails
main: main
maine: maine
maintain: maintain,maintained,maintaining
maintenance: maintenance
major: major
majority: majority
majors: majors
malarial: malarial
male: male
malicious: malicious
manage: manage,managed,managing
management: management
manager: manager
manchester: manchester
mane: manes
mangled: mangled
manhood: manhood
manifest: manifested
manifestly: manifestly
manifold: manifold
manitou: manitou
manly: manly
manned: manned
manner: manner
manners: manners
manoeuvre: manoeuvre,manoeuvred
manoeuvring: manoeuvring
mansion: mansion
manual: manual
manufactory: manufactories,manufactory
manufacture: manufacture,manufactures,manufacturing
map: map,mapped,maps
maps: maps
march: march,marched,marches,marching
marching: marching
margin: margin
marine: marine,marines
marion: marion
mark: mark,marked,marks
marked: marked
market: market
markland: markland
marksmanship: marksmanship
marriage: marriage
married: married
marry: married
marsh: marsh
marshal: marshal,marshals
marshall: marshall
marshy: marshy
martin: martin
marvellous: marvellous
mary: mary
maryland: maryland
masked: masked
mason: mason,masons
mass: mass,massed
massa: massa
massachusetts: massachusetts
massacre: massacre,massacred
massing: massing
master: master,masters
mat: mat
mate: mate,mates
material: material,materials
materially: materially
mathematical: mathematical
mathematics: mathematics
mattapony: mattapony
matter: matter,matters
mature: mature,matured
maturer: maturer
maxim: maxim
maximum: maximum
mayor: mayor
meadow: meadow
meagre: meagre
meal: meal,meals
meander: meanders
meandering: meandering
meaning: meaning
meant: meant
measles: measles
measure: measure,measures
measurement: measurement
meat: meat
mechanic: mechanic,mechanics
mechanical: mechanical
medal: medal
medical: medical
medicine: medicine
medicines: medicines
medium: medium
meet: meet,meeting,meets,met
meeting: meeting
melee: melee
melting: melting
membership: membership
memoirs: memoirs
memorable: memorable
memorandum: memorandum
memory: memory
memphis: memphis
menace: menace
menaced: menaced
menacing: menacing
mention: mention,mentioned,mentioning
merchant: merchants
merchantability: merchantability
merciless: merciless
mercy: mercy
mere: mere,merest
merge: merged
meridian: meridian
merit: merit,merits
meritorious: meritorious
mess: mess
message: message,messages
messenger: messenger,messengers
metal: metal
method: method,methods
mexican: mexican,mexicans
mexico: mexico
miami: miami
michael: michael
michigan: michigan
middle: middle
midnight: midnight
midst: midst
midway: midway
midwinter: midwinter
mighty: mighty
migraine: migraine
mild: mild,mildest
mile: mile,miles
miles: miles
military: military
militia: militia
miller: millers
mills: mills
mind: mind,minds
mindful: mindful
miner: miner,miners
mineral: mineral
mingle: mingled
minimum: minimum
mining: mining
minister: minister,ministers
minnesota: minnesota
minor: minor
minority: minority
minute: minute,minutes
minuteness: minuteness
misapprehension: misapprehensions
misappropriate: misappropriating
misbehavior: misbehavior
mischief: mischief
miserable: miserable
misery: misery
misfortune: misfortune,misfortunes
mishap: mishap
mislead: misled
missile: missiles
missing: missing
mission: mission
missionary: missionary
mississippi: mississippi
missouri: missouri
mist: mist
mistake: mistake,mistaken,mistakes,mistaking
mistaken: mistaken
mistress: mistress
misunderstand: misunderstood
misunderstanding: misunderstanding
mitchell: mitchell
mixed: mixed
mob: mob
mobile: mobile
mode: mode,modes
model: modelled
moderate: moderate
modern: modern
modest: modest
modification: modification
modify: modified,modifies,modify
modoc: modoc
molasses: molasses
molest: molest,molested
molestation: molestation
moment: moment,moments
momentary: momentary
monarchical: monarchical
monarchy: monarchies,monarchy
monday: monday
money: money,moneys
monitor: monitors
monopolize: monopolized
monopoly: monopoly
monroe: monroe
monster: monster
monte: monte
monterey: monterey
montgomery: montgomery
month: month,months
monument: monuments
mood: mood
moody: moody
moon: moon
moral: moral
morale: morale
morales: morales
morass: morass
morgan: morgan
mormonism: mormonism
morning: morning
morris: morris
morrow: morrow
mortal: mortal
mortally: mortally
mortar: mortar,mortars
mortgage: mortgage
mortify: mortified
mortifying: mortifying
morton: morton
moscow: moscow
moses: moses
mosquito: mosquitoes
mother: mother
motion: motion
motive: motive,motives
motley: motley
mott: mott
moulder: mouldering
mound: mound
mount: mount,mounted,mounting
mountain: mountain,mountains
mountainous: mountainous
mountains: mountains
mourn: mourn
mourning: mourning
mouth: mouth,mouths
mouthful: mouthful
movable: movable
movement: movement,movements
moving: moving
mow: mowed
mower: mower
mud: mud
muddy: muddy
muffle: muffled
mule: mule,mules
mulligan: mulligan
multitude: multitudes
municipal: municipal
munitions: munitions
murder: murder
murderer: murderers
murmur: murmured
murphy: murphy
muscle: muscle
museum: museums
music: music
musician: musician,musicians
musket: musket,muskets
musketry: musketry
mustang: mustang
mustard: mustard
muster: muster,mustered,mustering
mustering: mustering
mutineer: mutineers
mutiny: mutinied,mutiny
mutter: muttered
mutton: mutton
mutual: mutual
myriad: myriads
mysterious: mysterious
mysteriously: mysteriously
nankeen: nankeen
napoleon: napoleon
narrate: narrated
narrative: narrative
narrow: narrow,narrowed,narrowing
narrowness: narrowness
nashville: nashville
natchez: natchez
natchitoches: natchitoches
nation: nation,nations
national: national
nationality: nationalities,nationality
nationalize: nationalized
native: native,natives
natural: natural
naturally: naturally
nature: nature
naught: naught
naval: naval
navigable: navigable
navigate: navigated,navigating
navigation: navigation
navy: navy
nearer: nearer
nebraska: nebraska
necessitate: necessitated
necessity: necessity
neck: neck,necks
needle: needle,needles
negative: negative
negatively: negatively
neglect: neglect,neglected
negligence: negligence
negotiate: negotiate
negotiation: negotiations
negotiations: negotiations
negro: negro,negroes
neighbor: neighbor,neighbors
neighborhood: neighborhood
neighboring: neighboring
nelson: nelson
nephew: nephew
nerve: nerve
nervous: nervous
nettle: nettled
network: network
neutral: neutral
neutrality: neutrality
neutralize: neutralize
newcastle: newcastle
newly: newly
news: news
newsletter: newsletter
newspaper: newspaper,newspapers
newton: newton
nicholas: nicholas
night: night,nights
nightfall: nightfall
nineteen: nineteen
ninth: ninth
noah: noah
nobility: nobility
noble: noble
noise: noise
noiselessly: noiselessly
noisy: noisy
nominal: nominal
nominally: nominally
nominate: nominated,nominating
nomination: nomination
nondescript: nondescript
nonproprietary: nonproprietary
nonsense: nonsense
noon: noon
noose: noose
norfolk: norfolk
norman: norman
north: north
northeast: northeast
northern: northern
northerners: northerners
northernmost: northernmost
northward: northward
northwest: northwest
notably: notably
note: note,notes,noting
nothings: nothings
notice: notice,noticed,notices,noticing
notification: notification
notify: notified,notifies,notify,notifying
notion: notion,notions
notorious: notorious
nottoway: nottoway
noun: noun
novelist: novelist
november: november
nucleus: nucleus
nugatory: nugatory
numbering: numbering
numerical: numerical
numerically: numerically
numerous: numerous
nurse: nurse
nut: nut
ny: ny
oak: oak
oath: oath
obedience: obedience
obedient: obedient
obey: obey,obeyed,obeying
object: object,objected,objecting,objects
objection: objection,objections
objective: objective
obligation: obligation
oblige: obliged
oblivion: oblivion
obnoxious: obnoxious
obscure: obscured
observance: observance
observation: observation
observe: observe,observed
observer: observer,observers
obsolete: obsolete
obstacle: obstacle,obstacles
obstinacy: obstinacy
obstinate: obstinate
obstruct: obstruct,obstructed,obstructing,obstructs
obstruction: obstruction,obstructions
obstructionist: obstructionist
obviate: obviate,obviated
obvious: obvious
occasion: occasion,occasioned,occasions
occasional: occasional
occasionally: occasionally
occupancy: occupancy
occupant: occupant,occupants
occupation: occupation
occupied: occupied
occupy: occupied,occupies,occupy,occupying
occur: occur,occurred,occurring
occurrence: occurrence
ocean: ocean,oceans
october: october
ocular: ocular
odd: odd
odds: odds
odious: odious
offence: offence
offensive: offensive
offensively: offensively
offer: offer,offered,offers
office: office,offices
officer: officer,officered,officers
official: official,officials
officially: officially
offset: offset
oftener: oftener
ohio: ohio
olive: olive
oliver: oliver
omission: omission
omit: omit
onion: onions
online: online
onset: onset
onward: onward
openly: openly
operate: operate,operated,operates,operating
operating: operating
operation: operation,operations
operations: operations
operative: operatives
operator: operator,operators
opinion: opinion
opponent: opponent
opportune: opportune
opportunity: opportunities,opportunity
oppose: oppose,opposed,opposing
opposition: opposition
oppress: oppressed
oppressed: oppressed
oppression: oppression
option: option
opulent: opulent
orange: orange
orchard: orchard
ordain: ordained
ordeal: ordeal
orderly: orderly
ordinance: ordinance,ordinances
ordinarily: ordinarily
ordinary: ordinary
ordnance: ordnance
oregon: oregon
organization: organization,organizations
organize: organize,organized,organizing
organized: organized
origin: origin
original: original
originally: originally
originator: originator
orlando: orlando
orleans: orleans
ornament: ornament,ornamented
ostensibly: ostensibly
ounce: ounces
outbreak: outbreak
outcast: outcasts
outdated: outdated
outdo: outdone
outer: outer
outfit: outfit
outgrowth: outgrowth
outlay: outlay
outlet: outlet
outline: outlining
outnumber: outnumbered,outnumbering,outnumbers
outpost: outpost,outposts
outrage: outrage,outrages
outraged: outraged
outskirts: outskirts
outwards: outwards
outwork: outworks
oven: oven,ovens
overboard: overboard
overcoat: overcoat,overcoats
overcome: overcame,overcome
overcrowded: overcrowded
overflow: overflow,overflowed,overflowing
overhang: overhanging
overhaul: overhauling
overhead: overhead
overland: overland
overlook: overlooked,overlooking
overpower: overpowered
overrule: overruled
oversight: oversight
overtake: overtake,overtaken,overtook
overthrow: overthrow,overthrowing
overture: overture,overtures
overwhelming: overwhelming
overwhelmingly: overwhelmingly
owe: owed
owen: owen
owl: owl
owner: owner,owners
ownership: ownership
ox: ox
oxen: oxen
oxford: oxford
pace: paces
pacific: pacific
pacify: pacified
pacing: pacing
pack: pack,packed,packing
package: package,packages
packet: packets
paddle: paddled,paddles
paging: paging
pain: pain
painful: painful
painfully: painfully
pair: pair
palace: palace
pale: pale
palisade: palisade,palisades
palma: palma
palmer: palmer
palmetto: palmetto
palmyra: palmyra
palpably: palpably
pamunkey: pamunkey
panama: panama
panic: panic
pantaloons: pantaloons
panting: panting
pants: pants
papa: papa
paper: paper,papers
papers: papers
paperwork: paperwork
parade: parade,parading
paragraph: paragraph,paragraphs
parallel: parallel
paralyzed: paralyzed
paramount: paramount
parapet: parapet,parapets
parched: parched
parent: parents
paris: paris
park: park,parked
parker: parker
parley: parley
parlor: parlor
parole: parole,paroled,paroles,paroling
paroling: paroling
partake: partaking
partial: partial
partiality: partiality
partially: partially
participate: participate,participated
particle: particle
particulars: particulars
partisan: partisan
partly: partly
partner: partner,partners
partnership: partnership
party: parties,party
pass: pass,passed,passes,passing
passable: passable
passage: passage
passageway: passageways
passenger: passenger,passengers
passing: passing
passion: passions
pastime: pastime
pasturage: pasturage
pat: pat
patent: patent
path: path
patience: patience
patient: patient
patiently: patiently
patricio: patricio
patrick: patrick
patriotic: patriotic
patriotism: patriotism
patrol: patrolled
patronize: patronized
pattern: patterned
paul: paul
pave: paved,paving
pay: paid,pay,paying
paymaster: paymaster,paymasters
payment: payment,payments
peace: peace
peaceable: peaceable
peaceful: peaceful
peacefully: peacefully
peach: peach
pearl: pearl
pecan: pecan
peculiarity: peculiarity
peculiarly: peculiarly
pecuniary: pecuniary
pedee: pedee
pedregal: pedregal
peep: peeped
pelt: pelts
pen: pen,penned
pencil: pencil
pend: pending
pendency: pendency
penetrable: penetrable
penetrate: penetrate,penetrated,penetrating
peninsula: peninsula
pennsylvania: pennsylvania
penny: pennies
pensacola: pensacola
peon: peons
perceive: perceived
percentage: percentage
perceptible: perceptible
perception: perception,perceptions
percolate: percolates
percussion: percussion
peremptorily: peremptorily
peremptory: peremptory
perfect: perfect,perfected
perfection: perfection
perfectly: perfectly
perform: perform,performed,performing
performance: performance,performances
peril: peril
perilous: perilous
period: period,periods
periodic: periodic
permanency: permanency
permanent: permanent
permanently: permanently
permission: permission
permit: permit,permits,permitted,permitting
perpendicular: perpendicular
perpendicularly: perpendicularly
perpetrate: perpetrated
perpetual: perpetual
perpetuation: perpetuation
perpetuity: perpetuity
perseverance: perseverance
persist: persisted
persistency: persistency
persistent: persistent
persistently: persistently
person: people,person,persons
personage: personage
personal: personal
personally: personally
personnel: personnel
persuade: persuade
pertain: pertaining
perusal: perusal
pestilence: pestilence
pet: pet
peter: peter
petersburg: petersburg
phil: phil
philadelphia: philadelphia
philip: philip
phrase: phrase
phraseology: phraseology
physical: physical
physically: physically
physician: physicians
physique: physique
piazza: piazza
pick: pick,picked,picking,picks
picket: picket,picketed,pickets
picking: picking
picture: picture,pictured
piece: piece,pieces
piedmont: piedmont
pierce: pierce
pierre: pierre
pike: pike
pile: pile,piled,piles,piling
pillaging: pillaging
pillar: pillar
pillow: pillow
pilot: pilot,pilots
pin: pin
pine: pine
piney: piney
pioneer: pioneers
pit: pit,pits,pitted
pitch: pitch,pitched
piteous: piteous
pity: pity
placer: placer
plain: plain,plainer,plains
plainly: plainly
plains: plains
plan: plan,planned,plans
plank: plank,planks
plant: planted,planting,plants
plantation: plantation,plantations
planter: planters
plaster: plastered,plasters
platoon: platoon
plaudit: plaudits
plausible: plausible
play: play,played,playing
player: players
playing: playing
plaza: plaza
pleasant: pleasant,pleasanter,pleasantest
pleasantly: pleasantly
pleased: pleased
pleasure: pleasure
pledge: pledge,pledged,pledges,pledging
plenty: plenty
plough: plough,ploughed,ploughing
pluck: pluck
plunder: plunder,plundering
plunge: plunged,plunging
ply: plied,plying
plymouth: plymouth
po: po
pocket: pocket
poison: poison
pole: pole,poles
police: police
policy: policies,policy
polite: polite
politely: politely
political: political
politically: politically
politician: politician,politicians
politics: politics
polk: polk
poltroon: poltroons
polygamy: polygamy
pommel: pommels
pond: pond,ponds
pontoon: pontoon,pontoons
poodle: poodle
pool: pool,pools
poor: poor
pope: pope
poplar: poplar
popular: popular
popularity: popularity
popularize: popularizes
populated: populated
population: population
populous: populous
porch: porch
pork: pork
port: port,ports
portage: portage
porter: porter
portion: portion,portions
portland: portland
position: position,positions
positive: positive
positively: positively
possess: possess,possessed,possessing
possession: possession,possessions
possibility: possibility
post: post,posted,posting,posts
poster: posters
posthumous: posthumous
postmaster: postmaster
postpone: postpone,postponed,postponing
postponement: postponement
potato: potatoes
potomac: potomac
potter: potter
pouch: pouch
poultry: poultry
pound: pound,pounds
pounder: pounder,pounders
pour: pour,pouring
powder: powder,powdered
power: power,powers
powerful: powerful
powhatan: powhatan
pox: pox
practicability: practicability
practicable: practicable
practical: practical
practically: practically
practice: practice
prairie: prairie,prairies
praise: praise,praised
prayer: prayer
preach: preached
precarious: precarious
precaution: precaution,precautions
precede: preceded,preceding
precious: precious
precipice: precipice
precipitate: precipitate,precipitated,precipitating
precipitately: precipitately
precipitous: precipitous
precise: precise
precisely: precisely
precision: precision
preclude: precluded
preconceived: preconceived
precursor: precursor
predict: predicted
prediction: prediction,predictions
preface: preface
prefer: prefer,preferred,preferring
preferred: preferred
prejudice: prejudice,prejudices
prejudicial: prejudicial
preliminary: preliminary
premature: premature
premeditation: premeditation
preparation: preparation,preparations
preparations: preparations
preparatory: preparatory
prepare: prepare,prepared,preparing
prepared: prepared
preposterous: preposterous
prerogative: prerogatives
prescribe: prescribed
prescribed: prescribed
presence: presence
presentation: presentations
presentiment: presentiment
preservation: preservation
preserve: preserve,preserved
preside: preside,presides,presiding
presidency: presidency
president: president
presidential: presidential
press: press,pressed,pressing
pressure: pressure
prestige: prestige
presumable: presumable
presume: presume
presumption: presumption
pretence: pretence
pretend: pretend,pretending
pretension: pretensions
pretext: pretext,pretexts
pretty: pretty
prevail: prevailed,prevailing
prevent: prevent,prevented,preventing
prevention: prevention
previous: previous
price: price,prices
prick: prick
pricking: pricking
pride: pride,prided
priest: priest
prime: prime
prince: prince
principal: principal
principally: principally
principle: principle,principles
print: print,printed
prior: prior
prison: prisons
prisoner: prisoner,prisoners
private: private,privates
privation: privations
privilege: privilege,privileges
privileged: privileged
prize: prize,prizes
probability: probabilities,probability
probable: probable
probation: probation
proceed: proceed,proceeded,proceeding
proceeds: proceeds
process: process
processing: processing
procession: processions
proclaim: proclaim,proclaimed,proclaiming
proclamation: proclamation,proclamations
proclivity: proclivities
procrastination: procrastination
procure: procure,procured,procuring
produce: produce,produced,producing
product: product,products
production: production,productions
productive: productive
profane: profane
profess: profess,professed
profession: profession,professions
professional: professional
professionally: professionally
professor: professor,professors
professorship: professorship
profit: profit,profited,profits
profitable: profitable
profound: profound,profoundest
programme: programme
progress: progress,progressed,progressing
prohibit: prohibited,prohibiting
prohibition: prohibition
project: project,projected
prolong: prolong,prolonged
prolongation: prolongation
prominence: prominence
prominent: prominent
prominently: prominently
promiscuous: promiscuous
promiscuously: promiscuously
promise: promise,promised,promises,promising
promising: promising
promontory: promontory
promote: promote,promoted,promoting
promotion: promotion,promotions
prompt: prompt,prompted,prompting
promptitude: promptitude
promptness: promptness
promulgate: promulgated
pronounce: pronounced
pronunciation: pronunciation
proof: proof,proofs
proofread: proofread
propel: propel,propelled
propeller: propeller
proper: proper
properly: properly
property: property
prophecy: prophecy
proportion: proportion,proportions
proportionate: proportionate
proposal: proposal,proposals
propose: propose,proposed,proposes,proposing
proposition: proposition
proprietary: proprietary
proprietor: proprietor
propriety: propriety
prosecute: prosecute,prosecuted
prosecution: prosecution
prospect: prospect
prospective: prospective
prospects: prospects
prosperity: prosperity
prosperous: prosperous
prostrate: prostrate
protect: protect,protected,protecting
protection: protection
protest: protest,protested,protests
protestant: protestant
protract: protract,protracted
protrude: protruding
prove: prove,proved,proven,proves
provide: provide,providing
providence: providence
provision: provision,provisioned,provisions
provisional: provisional
provoke: provoke,provoked
provost: provost,provosts
prowess: prowess
proximity: proximity
prudence: prudence
prudent: prudent
prussia: prussia
prussian: prussian
pry: prying
public: public
publication: publication,publications
publicity: publicity
publish: publish,published
publisher: publishers
pull: pull,pulled,pulling
pulley: pulley
pulpit: pulpit
punish: punish,punished,punishing
punishment: punishment
punitive: punitive
purchase: purchase,purchased,purchases
purchaser: purchaser,purchasers
purchasing: purchasing
purdy: purdy
pure: pure,purest
purely: purely
purity: purity
purport: purported
purpose: purpose,purposed,purposes
pursuance: pursuance
pursuant: pursuant
pursue: pursue,pursued,pursuing
pursuer: pursuers
pursuing: pursuing
pursuit: pursuit,pursuits
push: push,pushed,pushing
quaint: quaint
quaker: quaker
qualification: qualifications
qualified: qualified
quality: qualities,quality
quantity: quantities,quantity
quarles: quarles
quarrel: quarrel,quarrelled,quarrelling
quarter: quarter,quarters
quartermaster: quartermaster,quartermasters
queen: queen
question: question,questioned,questions
quick: quick
quicksand: quicksands
quiet: quiet
quietly: quietly
quincy: quincy
quit: quit,quitted
quota: quota
quotation: quotation
quote: quote
rabbit: rabbit
raccoon: raccoon
race: race,races
rack: rack,racks
racket: racket
radical: radical
radically: radically
raft: raft,rafting,rafts
rage: rage,raged,raging
ragged: ragged
raid: raid,raided,raiding,raids
raider: raiders
rail: rail,rails
railing: railing
railroad: railroad,railroads
railway: railway
rain: rain,rained,raining,rains
rainfall: rainfall
rainy: rainy
raise: raise,raised,raising
raising: raising
rally: rallied,rally
ram: ram
rampant: rampant
rand: rand
range: range,ranged,ranging
rank: rank,ranked,ranks
ransom: ransom
rapid: rapid,rapids
rapidity: rapidity
rapidly: rapidly
rare: rare
rarely: rarely
rascality: rascality
rash: rash
rate: rate
ratification: ratification
ratify: ratified
ration: ration,rationed,rations
rational: rational
rattling: rattling
ravine: ravine,ravines
raw: raw
ray: rays
raymond: raymond
reach: reach,reached,reaches,reaching
read: read,reading
readable: readable
reader: reader
readiness: readiness
reading: reading
readjust: readjusted
ready: ready
real: real
reality: reality
realization: realization
realize: realize,realized
reams: reams
reap: reap
reappoint: reappointed
rear: rear
reason: reason,reasoned,reasons
reasonable: reasonable
reassert: reassert
reassume: reassumed
rebel: rebel,rebelled,rebels
rebellion: rebellion
rebellious: rebellious
rebuff: rebuff
rebuild: rebuild,rebuilding,rebuilt
rebuilding: rebuilding
rebuke: rebuke,rebuked
recall: recalled,recalling
recapture: recapture,recaptured,recaptures
recede: recede,receded,recedes,receding
receipt: receipt,receipts
receive: receive,received,receiving
reception: reception,receptions
recipient: recipient
reciprocate: reciprocate
recital: recital
recklessness: recklessness
reckon: reckoned
reclothe: reclothed
recognition: recognition
recognize: recognize,recognized,recognizing
recollect: recollect,recollected
recollection: recollection,recollections
recommence: recommenced
recommend: recommend,recommended,recommending
recommendation: recommendation,recommendations
recompense: recompense
reconcile: reconcile,reconciled
reconciliation: reconciliation
reconnaissance: reconnaissance
reconnoissance: reconnoissance
reconnoiter: reconnoitering
reconnoitre: reconnoitre
reconnoitring: reconnoitring
reconstruct: reconstructed
reconstruction: reconstruction
record: record,recorded,records
recorded: recorded
recover: recover,recovered
recovery: recovery
recrimination: recrimination
recross: recross,recrossed,recrossing
recruit: recruited,recruiting,recruits
recruiting: recruiting
rectify: rectified,rectify
recuperate: recuperate,recuperated
recurrence: recurrence
red: red
redan: redan,redans
redeem: redeem
redistribute: redistribute,redistributing
redistributing: redistributing
redistribution: redistribution
redound: redound
reduce: reduce,reduced,reduces,reducing
reduction: reduction
reel: reel,reels
refer: refer,referred
reference: reference,references
refit: refit
refitting: refitting
reflect: reflect,reflecting
reflection: reflection,reflections
reform: reform,reformed,reforming
refuge: refuge
refugee: refugees
refund: refund
refusal: refusal
refuse: refuse,refused,refusing
refute: refuted
regain: regain,regained
regale: regaled
regard: regard,regarded
regime: regime
regiment: regiment,regiments
regimental: regimental
region: region,regions
register: register,registered
regret: regret,regretted,regretting
regular: regular,regulars
regularity: regularity
regularly: regularly
regulate: regulated,regulating
regulation: regulation,regulations
reign: reign,reigned
reinforce: reinforce,reinforced,reinforcing
reinforcement: reinforcement,reinforcements
reiterate: reiterated
reject: rejected
rejoice: rejoice,rejoiced,rejoicing
rejoicing: rejoicing
rejoin: rejoined
relate: relate,relates,relating
relation: relation,relations
relative: relative,relatives
relay: relaid
release: release,released,releasing
reliable: reliable
reliance: reliance
relief: relief
relieve: relieve,relieved,relieving
relieved: relieved
religious: religious
relinquish: relinquish,relinquished
reluctant: reluctant
reluctantly: reluctantly
rely: relied,rely,relying
remain: remain,remained,remaining,remains
remainder: remainder
remains: remains
remark: remark,remarked,remarking,remarks
remarkable: remarkable
remarkably: remarkably
remarks: remarks
remedy: remedied,remedies,remedy
remember: remember,remembered
remind: reminded,reminding
remnant: remnant,remnants
remonstrate: remonstrated
remote: remote
remount: remount,remounted
removal: removal
remove: remove,removed,removing
rename: renamed
render: render,rendered,rendering
rendezvous: rendezvous,rendezvoused
renew: renew,renewed
renewal: renewal
rent: rented
reopen: reopened
reorganize: reorganize,reorganized
repair: repair,repaired,repairing,repairs
repay: repay
repeal: repeal,repealed
repeat: repeat,repeated,repeating
repeated: repeated
repeatedly: repeatedly
repel: repel,repelled
repent: repent
repetition: repetition
repine: repining
replace: replace,replaced
replacement: replacement
replenish: replenish
reply: replied,replies,reply
report: report,reported,reporting,reports
reporter: reporters
repose: repose
reprehensible: reprehensible
represent: represented,representing
representation: representations
representative: representative,representatives
reprimand: reprimand,reprimanded
republic: republic
republican: republican,republicans
republish: republished
repulse: repulse,repulsed,repulsing
reputation: reputation
repute: reputed
request: request,requested,requesting,requests
requests: requests
require: require,required,requiring
requirement: requirements
requisite: requisite
requisition: requisition,requisitions
resaca: resaca
rescind: rescinded
rescue: rescue,rescued
resell: resold
resemble: resemble
resentment: resentment
reservation: reservation
reserve: reserve,reserves
reserves: reserves
reside: reside,resided,resides,residing
residence: residence
resident: resident,residents
resign: resign,resigned
resignation: resignation
resist: resist,resisted
resistance: resistance
resolution: resolutions
resolve: resolved
resort: resort,resorted,resorting
resound: resound,resounded
resource: resources
respect: respect,respected,respecting
respectability: respectability
respectable: respectable
respected: respected
respectfully: respectfully
respective: respective
respects: respects
respond: responded
response: response
responsibility: responsibilities,responsibility
responsible: responsible
rest: rest,rested,resting,rests
restaurant: restaurant,restaurants
resting: resting
restive: restive
restless: restless
restlessness: restlessness
restoration: restoration
restore: restore,restored,restoring
restrain: restrained,restraining
restraint: restraint
restrict: restrict,restricted
restriction: restriction,restrictions
result: result
resume: resume,resumed,resumes,resuming
retain: retain,retained,retaining
retake: retake,retaken,retaking
retaliate: retaliate,retaliating
retard: retard,retarding
retarded: retarded
retention: retention
retinue: retinue
retire: retire,retired,retiring
retort: retort
retrace: retracing
retreat: retreat,retreated,retreating,retreats
retrograde: retrograde
retrospect: retrospect
retrospective: retrospective
return: return,returned,returning,returns
reveal: revealed
revelation: revelation
revenge: revenge
revengeful: revengeful
revenue: revenue,revenues
reverence: reverence
reverse: reverse
revert: reverted
review: review,reviewed,reviewing
revise: revised
revisit: revisited
revive: revive
revoke: revoked
revolution: revolution,revolutions
revolutionary: revolutionary
revolve: revolve
reward: reward,rewarded
rhetoric: rhetoric
rice: rice
rich: rich
richard: richard
richardson: richardson
richly: richly
richmond: richmond
ricochet: ricochetted
rid: rid
riddle: riddled
ride: ridden,ride,riding,rode
rider: rider,riders
ridge: ridge,ridges
ridicule: ridicule
riding: riding
rifle: rifle,rifles
rifled: rifled
rightful: rightful
rightfully: rightfully
rightly: rightly
rigid: rigid
rigidly: rigidly
riley: riley
rio: rio
ripe: ripe
rise: rise,risen,rises,rising,rose
risk: risk,risked,risking,risks
rival: rival
rivalry: rivalry
river: river,rivers
rivers: rivers
road: road,roads
roads: roads
roadstead: roadstead
roadway: roadway,roadways
roam: roam,roamed,roaming
roanoke: roanoke
roar: roar,roaring
rob: robbing
robert: robert
robinson: robinson
robust: robust
rock: rock,rocks
rocket: rockets
rocky: rocky
rod: rod,rods
rode: rode
rodney: rodney
role: role
roll: roll,rolled,rolling,rolls
roller: roller
rolling: rolling
rolls: rolls
romance: romance
rome: rome
roof: roof,roofed,roofs
roost: roost
root: root,roots
rope: rope,ropes
ross: ross
rosser: rosser
rot: rot
rouge: rouge
rough: rough
roughly: roughly
rousseau: rousseau
rout: rout
route: route,routed,routes,routing
routine: routine
row: rows
rowan: rowan
rowing: rowing
rowley: rowley
roy: roy
royal: royal
royalty: royalties,royalty
rude: rude
rudely: rudely
rufus: rufus
rugged: rugged
ruin: ruin,ruined,ruins
rule: rule,ruled,rules
ruler: ruler
rummage: rummaging
rumor: rumor,rumored,rumors
runaway: runaway
runner: runner,runners
running: running
ruse: ruse,ruses
rush: rush,rushed,rushes
russell: russell
russia: russia
rust: rust
saber: saber
sabine: sabine
sabre: sabre
sack: sacks
sacramento: sacramento
sacrifice: sacrifice,sacrificed,sacrifices,sacrificing
sad: sad
saddle: saddle,saddled,saddles
sadness: sadness
safe: safe,safest
safely: safely
safety: safety
sail: sail,sailed,sailing,sails
sailing: sailing
sailor: sailor,sailors
sake: sake
salary: salary
sale: sale,sales
salem: salem
salient: salient
saline: saline
salisbury: salisbury
sally: sallied
salt: salt
saltwork: saltworks
salubrity: salubrity
salute: salute,salutes
samuel: samuel
san: san
sanction: sanction,sanctioned
sand: sand
sandbag: sandbags
sanders: sanders
sandy: sandy
sanguinary: sanguinary
sanguine: sanguine
sanitary: sanitary
santa: santa
santiago: santiago
santo: santo
sap: sap
sapling: sapling
satisfactorily: satisfactorily
satisfactory: satisfactory
satisfied: satisfied
satisfy: satisfied,satisfies,satisfy,satisfying
saturday: saturday
savage: savages
savannah: savannah
save: save,saved,saves,saving
saving: saving
sawbuck: sawbuck
scabbard: scabbard
scale: scale
scalp: scalped
scanty: scanty
scarce: scarce
scarcely: scarcely
scarcity: scarcity
scatter: scatter,scattered,scattering
scattered: scattered
scene: scene,scenes
scenery: scenery
scheme: scheme
scholar: scholar,scholars
school: school,schools
schooling: schooling
scientific: scientific
scold: scolding
scolding: scolding
scoop: scooped
scott: scott
scout: scout,scouts
scow: scow,scows
scramble: scrambling
scratch: scratch
scroll: scroll
scrupulous: scrupulous
sea: sea
seaboard: seaboard
seal: seal,sealed
seam: seams
search: search,searching
season: season,seasons
seat: seat,seated,seats
secede: secede,seceded,seceding
secession: secession
secessionist: secessionists
secluded: secluded
secondary: secondary
secrecy: secrecy
secret: secret
secretary: secretary
secretly: secretly
sect: sect
sectional: sectional
secure: secure,secured,secures,securing
securely: securely
security: securities,security
seek: seek,seeking,sought
seeker: seekers
seemingly: seemingly
seize: seize,seized,seizing
seizure: seizure
seldom: seldom
select: select,selected,selecting
selected: selected
selection: selection,selections
selfish: selfish
sell: sell,selling,sold
semicircle: semicircle
senate: senate
senator: senator,senators
send: send,sending,sends
senior: senior
sensation: sensations
sense: sense
sensitive: sensitive
sentence: sentence,sentences
sentiment: sentiment,sentiments
sentinel: sentinel,sentinels
sentry: sentry
separate: separate,separated,separating
separated: separated
separately: separately
separation: separation
september: september
sequence: sequence
serenely: serenely
sergeant: sergeants
series: series
servant: servant,servants
serve: serve,served,serves,serving
service: service,services
services: services
session: session,sessions
set: set,sets,setting
seth: seth
settle: settle,settled,settling
settled: settled
settlement: settlement,settlements
seventeen: seventeen
seventeenth: seventeenth
seventh: seventh
sever: sever,severed
severally: severally
severe: severe,severest
severely: severely
severest: severest
severity: severity
sew: sewed
sex: sex,sexes
seymour: seymour
shade: shade
shades: shades
shady: shady
shaft: shafts
shake: shaking
shaky: shaky
shallow: shallow
shame: shame
shanty: shanty
shape: shape
share: share,shared,sharing
sharp: sharp
sharpshooter: sharpshooters
shattered: shattered
sheep: sheep
sheer: sheer
sheet: sheet
sheeting: sheeting
shelter: shelter,sheltered
sherman: sherman
shields: shields
shift: shift,shifted,shifting
shiloh: shiloh
shine: shining
ship: ship,shipping,ships
shipboard: shipboard
shipping: shipping
shirk: shirk
shirt: shirt
shoal: shoal,shoals
shock: shock,shocks
shod: shod
shoe: shoes
shoot: shoot,shot
shooter: shooters
shop: shop,shops
shore: shore,shores
short: short,shorter,shortest
shorten: shortened,shortening
shortly: shortly
shot: shot,shots
shoulder: shoulder,shoulders
shove: shoved
shovel: shovel
showy: showy
shreveport: shreveport
shrewdness: shrewdness
shuck: shuck
shun: shunned
shut: shut,shutting
shy: shying
sick: sick
sicken: sickening
sickening: sickening
sickness: sickness
sidney: sidney
siege: siege
sierra: sierra
sieve: sieve
sight: sight,sights
sign: sign,signed,signing,signs
signal: signal,signalled,signals
signature: signature
significance: significance
signing: signing
silence: silence,silenced,silencing
sill: sills
silver: silver
silverware: silverware
simile: simile
simmons: simmons
simon: simon
simple: simple
simply: simply
simpson: simpson
simultaneous: simultaneous
simultaneously: simultaneously
sincerely: sincerely
sincerity: sincerity
single: single
singly: singly
singularly: singularly
sink: sink,sinking,sunk
sir: sir
sister: sister,sisters
sit: sat,sit,sitting
situate: situated
situation: situation
sixteen: sixteen
sixth: sixth
size: size,sizes
sized: sized
skate: skating
skeleton: skeleton,skeletons
sketch: sketch
skiff: skiff
skilful: skilful
skilfully: skilfully
skill: skill
skilled: skilled
skin: skin,skins
skip: skipped
skirmish: skirmish,skirmished,skirmishes
skirmisher: skirmishers
skirmishers: skirmishers
skirmishing: skirmishing
sky: sky
slacken: slackened
slander: slander
slap: slapping
slash: slashed
slaughter: slaughter,slaughtered
slave: slave,slaves
slaveholder: slaveholder
slavery: slavery
sleep: sleep,sleeping,slept
sleeve: sleeves
sleigh: sleigh
slender: slender
slide: slid
slight: slight,slightest
slip: slip,slipped
slipnoose: slipnoose
slope: slope,slopes,sloping
slough: slough,sloughs
slow: slow,slower
slowly: slowly
slug: slugs
sluggish: sluggish
sluggishness: sluggishness
slumbering: slumbering
smash: smashing
smell: smell
smile: smiled,smiles
smith: smith,smiths
smithfield: smithfield
smoke: smoke,smoked
smoker: smokers
smokestack: smokestacks
smuggle: smuggled
smuggler: smugglers
smuggling: smuggling
smyth: smyth
snake: snake
snappishly: snappishly
snatch: snatched
sneak: sneaking
snicker: snicker
snow: snow
social: social
society: societies,society
soda: soda
sofa: sofa
soft: soft
softness: softness
soil: soil
sojourn: sojourn
soldier: soldier,soldiering,soldiers
soldierly: soldierly
soldiery: soldiery
sole: sole
solely: solely
solemn: solemn
solemnity: solemnity
solicit: solicit
solicitation: solicitation
solicitude: solicitude
solid: solid
solomon: solomon
solution: solution
solve: solve
son: son,sons
sophomore: sophomore
sorrow: sorrow
sort: sort,sorts
sortie: sortie
soul: soul,souls
sound: sound,sounded,sounding,sounds
source: source,sources
south: south
southeast: southeast
southerly: southerly
southern: southern
southerners: southerners
southernmost: southernmost
southward: southward
southwest: southwest
southwesterly: southwesterly
sovereignty: sovereignty
space: space,spaces
spade: spade,spades
spain: spain
span: spanning,spans
spanish: spanish
spare: spare,spared
sparring: sparring
sparse: sparse
sparsely: sparsely
sparta: sparta
speak: speak,speaking,spoke,spoken
speaker: speakers
speaking: speaking
spear: spear,spears
spearhead: spearheads
special: special
specially: specially
species: species
specific: specific
specimen: specimen
spectacle: spectacle
spectator: spectator,spectators
speculation: speculations
speech: speech,speeches
speeches: speeches
speed: speed,speeding
speedily: speedily
speedy: speediest,speedy
spend: spend,spending,spent
spike: spike,spiked
spill: spilled
spinal: spinal
spirit: spirit,spirits
spirited: spirited
spit: spat,spit
spite: spite
splash: splashing
splendid: splendid
splinter: splinters
spontaneous: spontaneous
sport: sport,sports
sportsman: sportsman
spot: spot,spots
spread: spread,spreading
spring: spring,springing,springs,sprung
springfield: springfield
springs: springs
spur: spur,spurs
spy: spies
squad: squads
squadron: squadron
squander: squandered
square: square
squarely: squarely
stab: stab
stable: stable,stables
stack: stack,stacked,stacking
staff: staff,staffs
stafford: stafford
stage: stage,stages
stager: stager
staid: staid
stairway: stairway
stake: stake,staked,staking
stalactite: stalactites
stalagmite: stalagmites
stampede: stampede,stampeded
stand: stand,standing,stands,stood
standard: standard
standing: standing
standpoint: standpoint
stanley: stanley
star: stars
stars: stars
start: start,started,starting,starts
starting: starting
starve: starve,starved,starving
statement: statement,statements
statesman: statesman,statesmen
station: station,stationed,stations
stations: stations
stature: stature
status: status
statute: statute
stay: stay,stayed,staying
steadily: steadily
steady: steady
steal: stealing,stolen
steam: steam
steamboat: steamboat,steamboats
steamer: steamer,steamers
steamship: steamship
stedman: stedman
steel: steel
steele: steele
steep: steep
steeple: steeple
stem: stem
step: step,stepped,stepping,steps
stephen: stephen
sterling: sterling
stern: stern
steven: steven
stewart: stewart
stick: stick,stuck
stiff: stiff
stimulate: stimulated
stipulate: stipulated
stipulation: stipulations
stirrup: stirrups
stock: stock,stocks
stockade: stockade
stockton: stockton
stone: stone,stones
stoneman: stoneman
stonewall: stonewall
stony: stony
stoppage: stoppage
store: store,stored,stores,storing
storehouse: storehouse,storehouses
storm: storm,storming,storms
story: stories,story
stout: stout
stove: stoves
straggle: straggling
straggler: stragglers
straggling: straggling
straight: straight
strain: strain
strange: strange
strangely: strangely
strangeness: strangeness
stranger: stranger,strangers
strap: straps
strasburg: strasburg
strategic: strategic
strategical: strategical
strategy: strategy
straw: straw
strawberry: strawberry
stream: stream,streams
street: street,streets
streets: streets
strength: strength
strengthen: strengthen,strengthened,strengthening,strengthens
strenuous: strenuous
strenuously: strenuously
stretch: stretched,stretches
strew: strewn
stricken: stricken
strict: strict,strictest
strictly: strictly
strife: strife
strike: strike,strikes,striking,struck
striking: striking
stringent: stringent
strip: strip,stripping
stripe: stripes
stripes: stripes
strive: striving
strong: strong,stronger,strongest
stronghold: stronghold,strongholds
structure: structure,structures
struggle: struggle,struggled,struggles
stuart: stuart
stubborn: stubborn
student: student
studious: studious
study: studied,studies,study,studying
stump: stump,stumps
stunt: stunted
stupendous: stupendous
style: style
subdivide: subdivided
subdue: subdue,subdued,subduing
subdued: subdued
subject: subject,subjected,subjects
sublime: sublime
submission: submission
submissive: submissive
submissively: submissively
submit: submit,submitted,submitting
subordinate: subordinate,subordinates
subordination: subordination
subscribe: subscribe,subscribed
subscription: subscription
subsequent: subsequent
subsequently: subsequently
subside: subside,subsided
subsist: subsist,subsisted
subsistence: subsistence
substance: substance
substantial: substantial
substitute: substitute,substituted,substituting
suburb: suburbs
suburban: suburban
succeed: succeed,succeeded,succeeding,succeeds
success: success,successes
successful: successful
succession: succession
successive: successive
successively: successively
successor: successor
succumb: succumbed
sudden: sudden
suddenly: suddenly
suffer: suffer,suffered,suffering
suffering: suffering,sufferings
suffice: suffice,sufficed
sufficient: sufficient
suffocate: suffocated
suffolk: suffolk
suffrage: suffrage
sugar: sugar
suggestion: suggestion,suggestions
suicidal: suicidal
suit: suit,suited,suits
suitable: suitable
suited: suited
sulphur: sulphur
sum: sum,summed,sums
summarily: summarily
summary: summary
summer: summer
summit: summit
summon: summoned
sumner: sumner
sun: sun
sunday: sunday
sundown: sundown
sunflower: sunflower
sunlight: sunlight
sunrise: sunrise
sunset: sunset
sunshine: sunshine
superb: superb
superhuman: superhuman
superintend: superintend,superintended,superintending
superintendence: superintendence
superintendent: superintendent
superior: superior,superiors
superiority: superiority
supersede: supersede,superseded
superstition: superstition,superstitions
supervision: supervision
supper: supper
supplement: supplement,supplements
supplies: supplies
supply: supplied,supplies,supply,supplying
supplying: supplying
support: support,supported,supporting,supports
supporter: supporter,supporters
suppose: suppose,supposed,supposing
supposition: supposition
suppress: suppress,suppressed,suppressing
suppression: suppression
supremacy: supremacy
supreme: supreme
surely: surely
surf: surf
surface: surface
surgeon: surgeons
surpass: surpassed
surplus: surplus
surprise: surprise,surprised,surprises
surprised: surprised
surprising: surprising
surrender: surrender,surrendered,surrendering
surround: surround,surrounded,surrounding
surroundings: surroundings
survey: survey,surveyed
surveyor: surveyor
survive: survive
susceptible: susceptible
suspect: suspect,suspected,suspecting
suspend: suspend,suspended,suspending
suspenders: suspenders
suspense: suspense
suspension: suspension
suspicion: suspicion,suspicions
susquehanna: susquehanna
sustain: sustain,sustained,sustaining
sustained: sustained
sutler: sutlers
swamp: swamp,swamps
swampy: swampy
swarm: swarm,swarmed
swear: sworn
sweep: sweep,sweeping,swept
sweet: sweet
swell: swell,swelled,swollen
swelling: swelling
swiftly: swiftly
swim: swam,swim,swimming
swimmer: swimmer
swing: swing,swung
switch: switch,switches
swollen: swollen
sword: sword,swords
sympathize: sympathized
sympathizer: sympathizers
sympathy: sympathy
symptom: symptoms
synonymous: synonymous
synopsis: synopsis
ta: ta
table: table,tables
tack: tack
tactic: tactics
tactical: tactical
tail: tails
tailor: tailor,tailors
talent: talent
talk: talk,talked,talking
tall: tall
tanner: tanner
tannery: tannery
tardiness: tardiness
tarry: tarry
task: task,tasks
taste: taste
tavern: tavern
tax: tax,taxed,taxes
taylor: taylor
tea: tea
teach: taught,teach,teaching
teacher: teacher,teachers
team: team,teams
teamster: teamster,teamsters
tear: tear,tearing,tears,torn
tedious: tedious
telegram: telegram,telegrams
telegraph: telegraph,telegraphed,telegraphing
telegraphic: telegraphic
telegraphs: telegraphs
temper: temper
temperate: temperate
temporarily: temporarily
temporary: temporary
tempt: tempted
tenable: tenable
tenacity: tenacity
tend: tend,tended,tending
tendency: tendency
tender: tender,tendered,tendering
tennessee: tennessee
tenor: tenor
tensas: tensas
tent: tent,tents
tenth: tenth
term: term,termed,terms
terminate: terminate,terminated,terminating
termination: termination
terminus: terminus
terms: terms
terrible: terrible
terribly: terribly
terrific: terrific
territorial: territorial
territory: territories,territory
terry: terry
testimony: testimony
tete: tete
tether: tether
texan: texan,texans
texas: texas
thankful: thankful
thawing: thawing
theatre: theatre
theme: theme
theodore: theodore
thereabout: thereabouts
therefrom: therefrom
thereon: thereon
thermometer: thermometer
thesis: theses
thicket: thicket,thickets
thickly: thickly
thigh: thigh
thirst: thirst
thirteen: thirteen
thirteenth: thirteenth
thither: thither
thomas: thomas
thompson: thompson
thoroughfare: thoroughfares
thos: thos
threat: threat,threats
threaten: threaten,threatened,threatening
threatened: threatened
threatening: threatening
threateningly: threateningly
threefold: threefold
thrifty: thrifty
throat: throat
throne: throne
throw: threw,throw,throwing,thrown
ticket: ticket
tide: tide
tie: tie,tied,ties
tight: tight
tighten: tighten
tightly: tightly
tiller: tiller
timber: timber,timbered
timbered: timbered
time: time,times
timely: timely
times: times
timid: timid
tin: tin
tired: tired
tissue: tissue
title: title
tobacco: tobacco
tod: tod
todd: todd
toil: toil
toledo: toledo
tolerably: tolerably
tolerate: tolerate
tomb: tomb
tomorrow: tomorrow
ton: ton,tons
tone: tone,tones
tong: tongs
tongue: tongue
tonight: tonight
tool: tools
topography: topography
torch: torch,torches
torment: torment
tormentor: tormentor
torpedo: torpedoes
torrent: torrent,torrents
tortuous: tortuous
torture: torture
total: total
totally: totally
totter: totter
touch: touched,touching
tough: toughest
tow: tow,towed
tower: tower
towing: towing
town: town,towns
towson: towson
trace: trace
track: track
tractable: tractable
trade: trade,trading
trademark: trademark
trader: traders
trading: trading
traditional: traditional
traffic: traffic
tragedy: tragedy
trail: trail,trails
train: train,trained,trains
training: training
traitor: traitor
trammel: trammel
trans: trans
transact: transacted
transaction: transaction
transcribe: transcribe,transcribed
transcription: transcription
transfer: transfer,transferred
transgression: transgressions
transit: transit
translate: translated
translation: translation,translations
transmission: transmission
transmit: transmit,transmitted,transmitting
transparent: transparent
transpire: transpired
transport: transport,transported,transporting,transports
transportation: transportation
trap: trap
trapping: trapping
trash: trash
trashy: trashy
travel: travel,travelled,travelling
traveling: traveling
traveller: traveller,travellers
travels: travels
traverse: traverse,traversed,traverses
treachery: treachery
tread: tread,trod
treason: treason
treasure: treasure
treasury: treasury
treat: treat,treated,treats
treatment: treatment
treaty: treaty
tree: tree,trees
treeless: treeless
tremble: trembled
tremendous: tremendous
trench: trench,trenches
trend: trends
trenton: trenton
trepidation: trepidation
trestle: trestle
trial: trial
triangle: triangle
triangular: triangular
tribe: tribes
tributary: tributaries
trick: trick
trim: trimmed
trip: trip,trips
triplicate: triplicate
trist: trist
trite: trite
triumph: triumph
triumphant: triumphant
triumphantly: triumphantly
trivial: trivial
trooper: troopers
troops: troops
trophy: trophies
tropical: tropical
tropics: tropics
trot: trotted
trouble: trouble,troubled,troubles
trough: trough
trousers: trousers
truce: truce
true: true
trump: trumped
trust: trust,trusted,trusts
trusty: trusty
truth: truth
truthful: truthful
tub: tub
tuesday: tuesday
tug: tug
tuition: tuition
tunnel: tunnel,tunnels
tupelo: tupelo
turkey: turkeys
turnip: turnips
turnpike: turnpike
twelfth: twelfth
twist: twist,twisted
twofold: twofold
tyler: tyler
type: types
ultimate: ultimate
ultimately: ultimately
ultimatum: ultimatum
ulysses: ulysses
unabated: unabated
unable: unable
unaccountable: unaccountable
unaccustomed: unaccustomed
unanimous: unanimous
unanimously: unanimously
unanticipated: unanticipated
unapplied: unapplied
unarmed: unarmed
unattached: unattached
unattained: unattained
unattended: unattended
unavailing: unavailing
unavoidable: unavoidable
unawares: unawares
unbearable: unbearable
unbeknownst: unbeknownst
unbiased: unbiased
unbounded: unbounded
unbridged: unbridged
unbroken: unbroken
unceasingly: unceasingly
unceremoniously: unceremoniously
uncertain: uncertain
uncertainty: uncertainty
unchangeable: unchangeable
unchivalrous: unchivalrous
uncivil: uncivil
uncle: uncle
uncleared: uncleared
uncoil: uncoil
uncomfortable: uncomfortable
uncomfortably: uncomfortably
uncommon: uncommon
uncommunicative: uncommunicative
unconcealed: unconcealed
unconditional: unconditional
unconditionally: unconditionally
unconscious: unconscious
unconstitutional: unconstitutional
uncontrollable: uncontrollable
uncover: uncovered
undecided: undecided
underbrush: underbrush
underclothing: underclothing
underestimate: underestimate
undergo: undergo
underground: underground
undergrowth: undergrowth
undermine: undermined
understand: understand,understanding,understood
understanding: understanding
understate: understated
undertake: undertake,undertaken,undertook
undertaking: undertaking
undisciplined: undisciplined
undisputed: undisputed
undoubted: undoubted
undoubtedly: undoubtedly
undue: undue
undulate: undulating
undying: undying
unearth: unearthed
unearthly: unearthly
uneasiness: uneasiness
unendurable: unendurable
unenforceability: unenforceability
uneventful: uneventful
uneventfully: uneventfully
unexpected: unexpected
unfair: unfair
unfavorable: unfavorable
unfavorably: unfavorably
unfinished: unfinished
unfit: unfit
unfitted: unfitted
unforeseen: unforeseen
unfortunate: unfortunate
ungenerous: ungenerous
unholy: unholy
uniform: uniform,uniforms
uniformed: uniformed
uniformly: uniformly
unimportance: unimportance
unimportant: unimportant
uninjured: uninjured
uninteresting: uninteresting
uninterrupted: uninterrupted
union: union
unit: unit,units
unite: unite,united,uniting
united: united
unity: unity
universal: universal
universally: universally
unjust: unjust
unknown: unknown
unlimited: unlimited
unlink: unlink
unload: unload
unloading: unloading
unmarried: unmarried
unmeasured: unmeasured
unmilitary: unmilitary
unmistakable: unmistakable
unmistakably: unmistakably
unmixed: unmixed
unmolested: unmolested
unmoved: unmoved
unnecessarily: unnecessarily
unnecessary: unnecessary
unobserved: unobserved
unoccupied: unoccupied
unofficial: unofficial
unopposed: unopposed
unpleasant: unpleasant
unpleasantly: unpleasantly
unprecedented: unprecedented
unprepared: unprepared
unprotected: unprotected
unquestionably: unquestionably
unquestioned: unquestioned
unquestioning: unquestioning
unreasonable: unreasonable
unruly: unruly
unsafe: unsafe
unsatisfactory: unsatisfactory
unseen: unseen
unsolicited: unsolicited
unsubdued: unsubdued
unsuccessful: unsuccessful
unsupported: unsupported
unsurpassed: unsurpassed
untenable: untenable
untimely: untimely
untiring: untiring
untouched: untouched
untrammeled: untrammeled
untrammelled: untrammelled
untrue: untrue
unusual: unusual
unwarrantable: unwarrantable
unwarranted: unwarranted
unwilling: unwilling
unwillingness: unwillingness
update: updated
uphold: uphold
upholster: upholstering
upper: upper
uppermost: uppermost
upright: upright
uproar: uproar
upward: upward
urchin: urchin
urge: urge,urged,urging
useless: useless
user: user
usual: usual
ut: ut
utensil: utensils
utilize: utilizing
utmost: utmost
utter: utter,uttered,uttering
utterance: utterance
utterly: utterly
vacancy: vacancies,vacancy
vacant: vacant
vacate: vacate,vacated
vacation: vacation
vacillate: vacillating
vacillation: vacillation
vain: vain
valiant: valiant
valiantly: valiantly
valley: valley,valleys
valor: valor
valuable: valuable
van: van
vancouver: vancouver
vanilla: vanilla
vanish: vanished
vanity: vanity
vanquish: vanquish
vantage: vantage
vara: vara
varied: varied
variety: variety
varioloid: varioloid
vary: varied,vary,varying
vast: vast
vastly: vastly
vaughn: vaughn
vegetable: vegetables
vegetation: vegetation
vehemence: vehemence
vehemently: vehemently
vehicle: vehicle,vehicles
veil: veiled
velocity: velocity
venerate: venerated
venison: venison
venture: ventured
vera: vera
veracity: veracity
verbal: verbal
verbally: verbally
verbatim: verbatim
verify: verified,verify
verona: verona
version: version
vessel: vessel,vessels
vestige: vestige
veteran: veteran,veterans
vexatious: vexatious
vice: vice,vices
vicinity: vicinity
vicious: vicious
viciousness: viciousness
victim: victims
victor: victors
victorious: victorious
victory: victories,victory
view: view,viewed,viewing,views
vigilant: vigilant
vigilantly: vigilantly
vigor: vigor
vigorous: vigorous
vigorously: vigorously
vii: vii
viii: viii
village: village,villages
villager: villagers
vindication: vindication
vine: vines
violate: violated,violates,violating
violation: violation
violence: violence
violent: violent
violently: violently
virginia: virginia
virginian: virginian
virtually: virtually
virtue: virtue,virtues
virulence: virulence
virus: virus
visible: visible
visibly: visibly
vision: vision,visions
visit: visit,visited,visiting,visits
visiting: visiting
visitor: visitor,visitors
vista: vista
vital: vital
vitals: vitals
vividly: vividly
voice: voice
void: void
volcanic: volcanic
volcano: volcano
volley: volley
volume: volume,volumes
voluntarily: voluntarily
voluntary: voluntary
volunteer: volunteer,volunteered,volunteers
volunteering: volunteering
volunteers: volunteers
vomito: vomito
voracity: voracity
vote: vote,voted,votes
voter: voter,voters
voting: voting
voucher: vouchers
voyage: voyage
vulnerable: vulnerable
wade: wade,waded,wading
wage: waged
wagon: wagon,wagons
wainwright: wainwright
waist: waists
wait: wait,waited,waiting
waive: waive,waiving
wake: wake,waking
walk: walk,walked,walking,walks
walker: walker
wall: wall,walls
walled: walled
walling: walling
walnut: walnut
wander: wandering
wane: wane,waning
wanton: wanton
war: war,wars
ward: ward
warfare: warfare
warm: warm
warn: warned
warning: warning
warrant: warrant,warranted
warranty: warranties,warranty
warren: warren
wary: wary
wash: wash,washed,washes
washing: washing
washington: washington
washita: washita
waste: waste,wasted,wasting
watch: watch,watched,watching
watchmen: watchmen
water: water,waters
waterline: waterline
waterloo: waterloo
waterway: waterway,waterways
watery: watery
watson: watson
watts: watts
wave: wave,waves,waving
wayne: wayne
weak: weak,weaker
weaken: weaken,weakened,weakening,weakens
weakening: weakening
weakly: weakly
weakness: weakness
wealth: wealth
wealthy: wealthy
weapon: weapons
wear: wear,wearing,wore,worn
wearisome: wearisome
weary: weary
weather: weather
weave: woven
weber: weber
webster: webster
wednesday: wednesday
weed: weed
week: week,weeks
weigh: weighing,weighs
weight: weight
wesley: wesley
west: west
westerly: westerly
western: western
westward: westward
wet: wet
wharf: wharf,wharves
whatsoever: whatsoever
wheat: wheat
wheel: wheel,wheels
wheeled: wheeled
wheeler: wheeler
wheeling: wheeling
whereabouts: whereabouts
whig: whig
whigs: whigs
whip: whip,whipped
whirl: whirled
whiskey: whiskey
whisper: whispered
whistle: whistle,whistled,whistling
white: white
whites: whites
whiteside: whiteside
whiting: whiting
whitworth: whitworth
wholesale: wholesale
wholesome: wholesome
wholly: wholly
wickedness: wickedness
wide: wide,wider,widest
widen: widened,widening,widens
widespread: widespread
widow: widow,widows
widower: widower
wife: wife,wives
wild: wild
wilderness: wilderness
william: william
williams: williams
willingness: willingness
willow: willow
wilson: wilson
win: win
winchester: winchester
wind: wind,winding,winds,wound
window: window,windows
windsor: windsor
wing: wing,wings
winona: winona
winslow: winslow
winter: winter,winters
wire: wire,wires
wiry: wiry
wisconsin: wisconsin
wisdom: wisdom
wise: wise,wisest
wisely: wisely
wit: wit,wits
witchcraft: witchcraft
withdraw: withdraw,withdrawing,withdrawn,withdrew
withdrawal: withdrawal
withhold: withheld
withholding: withholding
witness: witness,witnessed,witnesses,witnessing
wm: wm
wolf: wolf,wolves
woman: woman,women
wonderful: wonderful
wood: wood,wooded,woods
wooded: wooded
wooden: wooden
woollen: woollen
word: word,worded
wording: wording
workman: workmen
workshop: workshops
worldly: worldly
worn: worn
worship: worship
worshipper: worshippers
worth: worth
worthily: worthily
worthless: worthless
worthy: worthy
wound: wound,wounded,wounding,wounds
wounded: wounded
wrangling: wrangling
wrap: wrapped
wrapper: wrappers
wreck: wreck,wrecks
wrench: wrenched
wrest: wrested
wright: wright
wrist: wrists
write: write,writing,written,wrote
writer: writer,writers
writing: writing
writings: writings
written: written
wrong: wrong
xi: xi
xii: xii
xiii: xiii
xiv: xiv
xix: xix
xvi: xvi
xvii: xvii
xviii: xviii
xx: xx
xxi: xxi
xxii: xxii
xxiii: xxiii
xxiv: xxiv
xxv: xxv
xxx: xxx
yank: yank
yankee: yankee
yankees: yankees
yanks: yanks
yard: yard,yards
yawl: yawls
yawning: yawning
yazoo: yazoo
yellow: yellow
yesterday: yesterday
yield: yield,yielded,yielding
yoke: yoke
york: york
youth: youth
youthful: youthful
zachariah: zachariah
zeal: zeal
zigzag: zigzagging,zigzags
