aback: aback
abandonment: abandonment
abide: abide,abiding
ability: ability
abjectly: abjectly
abreast: abreast
absent: absent
abundance: abundance
accent: accents
accept: accepted,accepting
accident: accident
accommodate: accommodated
accompany: accompanied
accomplish: accomplished
account: account,accounted
accumulate: accumulated
ache: ached
achieve: achieve,achieved
acknowledge: acknowledged
acquaintance: acquaintance
acting: acting
action: action,actions
active: active
acuteness: acuteness
adaptability: adaptability
add: adding
addition: addition
additional: additional
address: addressed
adjust: adjust,adjusting
adjustment: adjustment
administer: administered,administering
administration: administration
admiration: admiration
adoration: adoration
adore: adore
advance: advance,advanced,advances
advanced: advanced
advantage: advantage
advent: advent
adventure: adventure,adventures
adversary: adversary
advertise: advertised
advertising: advertising
advice: advice
affair: affair
affection: affection
affirm: affirmed
affirmative: affirmative
afford: afford
afoot: afoot
afraid: afraid
afternoon: afternoon
afterward: afterward
age: ages
aged: aged
agent: agent
agility: agility
aglow: aglow
agonizing: agonizing
agony: agony
aid: aid
aimlessly: aimlessly
air: air
aisle: aisles
akin: akin
alaska: alaska
alaskan: alaskan
alert: alert
alertness: alertness
alice: alice
alive: alive
aloud: aloud
alpine: alpine
alter: alter
amazingly: amazingly
ambition: ambition
ambitious: ambitious
ambuscade: ambuscade
amenity: amenities
ammunition: ammunition
ancestor: ancestor,ancestors
anchor: anchor
ancient: ancient
anger: anger
angle: angle
angry: angry
animal: animal,animals
animate: animated
ankle: ankle
annoyed: annoyed
answer: answer,answered,answering,answers
antagonist: antagonist,antagonists
antler: antlers
anxious: anxious
apex: apex
appal: appalled
apparel: apparel
apparent: apparent
appeal: appealed
appealingly: appealingly
appearance: appearance
appeasement: appeasement
appeasingly: appeasingly
appetite: appetites
appoint: appointed
apprehension: apprehension,apprehensions
apprehensively: apprehensively
approach: approached
apt: apt
arbor: arbors
arctic: arctic
arduous: arduous
aristocrat: aristocrat
arm: arm,armed,arms
arouse: arouse,aroused
arrange: arranged
arrangement: arrangement
array: array
arrest: arrested
arrive: arrive,arrived
arrow: arrow,arrows
art: art
artesian: artesian
article: article,articles
articulate: articulate
artist: artist
ascend: ascended
ashamed: ashamed
ashore: ashore
asleep: asleep
aspect: aspect
aspen: aspens
aspire: aspired
assail: assailed
assailant: assailants
association: association
assortment: assortment
astonished: astonished
astonishment: astonishment
asunder: asunder
athletic: athletic
atmosphere: atmosphere
attach: attached
attack: attack,attacked,attacking
attempt: attempt,attempted,attempting
attend: attended
attention: attention
attitude: attitude
attract: attracted
aurora: aurora
authority: authority
avail: avail
aver: averred
average: averaged
avoid: avoided
awake: awoke
awakening: awakening,awakenings
aware: aware
awe: awe
awed: awed
awkward: awkward
axe: axe
babel: babel
backbone: backbone
bacon: bacon
bad: bad,worse,worst
badly: badly,worse
bag: bag,bags
baggage: baggage
baggageman: baggageman
ball: ball
band: band,bands
bank: bank,banked
bar: bar,barred,bars
barbarous: barbarous
bare: bare
barely: barely
barge: barge
bark: bark,barked,barking
barracks: barracks
barrelled: barrelled
barrens: barrens
basis: basis
batch: batches
bath: bathed
batter: battered
battering: battering
battle: battle,battles
bay: bay
beach: beach,beaches
bear: bear,bearing,bore,born,borne
beardless: beardless
beast: beast,beasts
beat: beaten
beating: beating
beautiful: beautiful
beaver: beaver
beckon: beckon
bed: bed,beds
bedlam: bedlam
beg: begged
belie: belie
belief: belief
bell: bells
belligerent: belligerent
belly: belly,bellying
belong: belong,belonged,belongs
belongings: belongings
belt: belt
bench: bench
benches: benches
bend: bend,bending,bends,bent
beneath: beneath
bernard: bernard
berry: berry
beset: beset,besetting
bespeak: bespeak
bet: bet
betray: betrayed
bewilder: bewildered
bicker: bickered
bickering: bickering
bid: bid
bide: bide
bind: bound
birch: birch
bird: bird,birds
bit: bit
bite: bit,bite,bites,biting,bitten
bitter: bitter
bitterness: bitterness
black: black
blade: blade
blank: blanked
blanket: blankets
blaze: blaze,blazed,blazing
bleak: bleak
bleeding: bleeding
blind: blind,blinded,blinding
blink: blinking
blizzard: blizzards
block: blocked,blocking
blood: blood
bloodhound: bloodhound
bloody: bloody
blow: blew,blow,blowing,blows
blowing: blowing
blue: blue
bluff: bluff
blunder: blundered,blundering
blunderer: blunderer
boast: boast
boastful: boastful
boat: boat,boats
bode: boded
bodily: bodily
body: bodies,body
bold: boldest
boldly: boldly
bologna: bologna
bolt: bolted
bombard: bombarded
bonanza: bonanza
bone: bone,bones
bony: bony
book: book
boom: boomed,booming
borealis: borealis
bored: bored
boss: boss
bough: bough,boughs
bound: bound,bounded
boundless: boundless
box: box,boxes
boy: boy,boys
brace: braced
brag: bragged
brain: brain
branch: branching
brass: brass
brave: bravest
bravely: bravely
bravery: bravery
bread: bread
break: break,breaking,breaks,broke,broken
breakable: breakable
breakfast: breakfast
breaking: breaking
breast: breast
breasted: breasted
breath: breath,breaths
breathe: breathe,breathed
breathing: breathing
breathless: breathless
breed: bred,breed
breeze: breeze,breezes
brewing: brewing
bribe: bribe
bridge: bridges
bright: bright
bring: bring,bringing,brought
bristle: bristled,bristling
broad: broad,broader
broke: broke
broken: broken
brood: brooded
brooding: brooding
broom: brooms
brother: brother,brothers
brown: brown
browse: browse
bruise: bruise,bruised,bruises
brumal: brumal
brutal: brutal
brutality: brutality
brute: brutes
bubble: bubbled,bubbling
buck: buck,bucked
buckle: buckled,buckles
bud: buds
budge: budge
build: build,building,built
building: building
bulge: bulging
bulk: bulk,bulked
bull: bull,bulls
bully: bully
bunch: bunched
bundle: bundle,bundled,bundles
burn: burned,burning
burst: burst,bursting
bursting: bursting
burton: burton
bury: buried
business: business
businesslike: businesslike
buster: busters
busy: busy
butt: butt
butter: butter
cabin: cabin
cadence: cadences
cagelike: cagelike
cajole: cajole
calamity: calamity
calculate: calculated,calculating
calf: calf,calves
callous: callous
callowness: callowness
calm: calm
calmly: calmly
camp: camp,camped,camps
camping: camping
canada: canada
canadian: canadian
candle: candle
canvas: canvas
cap: cap
capable: capable
capacity: capacity
capital: capital
capsize: capsized
captain: captain
car: car
carcass: carcass,carcasses
card: card
care: care,cared
careful: careful
carefully: carefully
caress: caress,caressing
carnivorous: carnivorous
carry: carried,carry,carrying
cart: carted
cartridge: cartridges
cash: cash
cast: cast
cat: cat
catch: catching,caught
catlike: catlike
cattlemen: cattlemen
caution: caution
cautious: cautious
cautiously: cautiously
cave: cave
cayuse: cayuses
cease: ceased
celerity: celerity
cell: cell
cement: cement
centre: centre,centring
century: centuries
certainty: certainty
certitude: certitude
cessation: cessation
chafe: chafing
chaff: chaff
chaffering: chaffering
chain: chain
challenge: challenging
champion: champion
chance: chance,chanced,chances
change: change,changed,changing
channel: channel
chant: chant
chaotic: chaotic
chapter: chapter
characterize: characterized
charge: charge,charged
charles: charles
charlotte: charlotte
chase: chase
chasm: chasm
chatter: chattered,chattering
cheap: cheaper
check: check,checked
cheek: cheek,cheeks
cheer: cheer
cheerful: cheerful
cheering: cheering
cheery: cheery
chemically: chemically
cherish: cherished
chest: chest,chests
chew: chew,chewed
chief: chief
child: child,children
chill: chill
chinese: chinese
chink: chinked
chipmunk: chipmunks
chivalrous: chivalrous
chivalrously: chivalrously
choke: choke,choked
choking: choking
chook: chook
choose: chosen
chop: chop,chopping,chops
chorus: chorus
chronic: chronic
chuckle: chuckling
chunk: chunk,chunks
churn: churned,churning
circle: circle,circled,circles
circling: circling
citizen: citizens
city: cities,city
civilization: civilization
civilized: civilized
civilizing: civilizing
claim: claims
clamor: clamor
clannish: clannish
clara: clara
clash: clash,clashed
clasped: clasped
claw: claws
clean: clean,cleaned
cleanly: cleanly
cleanse: cleansed
clearing: clearing
clench: clenching
clerk: clerks
clever: clever
cliff: cliff
climb: climbed
clime: climes
clinch: clinching
cling: cling,clinging,clung
clip: clip,clipped,clipping
close: close,closed,closer,closing
closely: closely
clothe: clad
clothes: clothes
cloud: cloud
club: club,clubbed,clubs
clubbing: clubbing
clutch: clutched,clutching
coal: coals
coat: coat,coated,coats
cock: cock
code: code
coil: coils
cold: cold,colder
coldly: coldly
collar: collar
collect: collected
college: college
colored: colored
colt: colt
comb: comb
combatant: combatants
combine: combined
comfortable: comfortable
comfortably: comfortably
command: command,commanded
commence: commence
comment: commented
commingle: commingled
common: common
communicate: communicated
communion: communion
compact: compact
compactly: compactly
companion: companion
company: companies,company
comparatively: comparatively
compare: compared
compass: compass
compel: compel,compelled
compelled: compelled
compellingly: compellingly
complain: complained
complete: complete
completely: completely
completeness: completeness
comply: complied
comprehend: comprehend
comprehension: comprehension
comprehensively: comprehensively
compress: compressed
computation: computation
comrade: comrade,comrades
comradely: comradely
comradeship: comradeship
conceal: concealed
concealment: concealment
concern: concerned
conciliate: conciliate,conciliated
conclusively: conclusively
concrete: concrete
condition: condition,conditions
conduct: conduct
confess: confessed
confidence: confidence
confidently: confidently
confine: confined
confines: confines
confuse: confused
confusion: confusion
congested: congested
conjuration: conjuration
conscious: conscious
consideration: consideration
consignment: consignment
conspicuous: conspicuous
constant: constant
constantly: constantly
consternation: consternation
consultation: consultation
contact: contact
contagion: contagion
contemplate: contemplate
contemplation: contemplation
contend: contend,contended
content: content
contents: contents
continent: continent
continual: continual
continually: continually
continue: continued
continuous: continuous
contract: contracted
contraption: contraption
contribution: contribution
control: control
convalescence: convalescence
conversation: conversation
conveyance: conveyance
convulse: convulsed
convulsive: convulsive
cook: cook,cooking,cooks
cool: cool
coolly: coolly
copious: copious
corner: corner
cornered: cornered
cottage: cottages
count: count,counted
counter: countered
countless: countless
country: country
couple: couple
courier: courier
cousin: cousins
cover: cover,covered
covering: coverings
covert: covert
coveted: coveted
cow: cows
coy: coy
crack: crack,cracked
crackle: crackled,crackling
crackling: crackling
craftily: craftily
crash: crashed
crashing: crashing
crate: crate,crates
crater: craters
crawl: crawl,crawled,crawling
craze: crazed
creature: creature,creatures
credit: credit
creek: creek
creep: creep,creeping,crept
crest: crest
cricket: crickets
crippled: crippled
crisp: crisp
cross: cross,crossed,crosses
crossing: crossing
crouch: crouch,crouched,crouching
crouching: crouching
crow: crowed
crowd: crowd,crowded
cruelly: cruelly
crumb: crumb
crumple: crumpled
crunch: crunch,crunched
crush: crushing
crushingly: crushingly
cue: cue
culprit: culprit,culprits
cunning: cunning
cunningly: cunningly
cure: cure
curiously: curiously
curl: curled
curly: curly
current: current
curse: curse,cursed,curses,cursing
cursing: cursing
curved: curved
curving: curving
custom: custom
customary: customary
cut: cut,cuts,cutting
dainty: dainty
dam: dam,dams
damnation: damnation
dance: dance,dancing
danger: danger
dangerous: dangerous
dark: dark
darkness: darkness
dart: darted
dash: dash,dashed
dat: dat
daughter: daughters
daunt: daunted
dave: dave
dawn: dawn
dawson: dawson
day: day,days
daybreak: daybreak
daze: dazed
dazed: dazed
dead: dead
deaf: deaf
deal: deal,dealt
dealer: dealers
death: death
deathless: deathless
debt: debts
decay: decay
deceit: deceit
december: december
decide: decided
decidedly: decidedly
decivilization: decivilization
deck: deck,decks
deed: deeds
deep: deep,deeper,deeps
deer: deer
deerhound: deerhound
defence: defence
defend: defend,defended,defending
defiance: defiance
defiantly: defiantly
definite: definite
deft: deft
defy: defied,defying
dejected: dejected
delay: delay,delayed
deliberately: deliberately
deliberateness: deliberateness
delight: delight,delights
deliver: deliver
deluge: deluged
demand: demand,demanded,demanding
demesne: demesne
demon: demon
demonstrative: demonstrative
den: den
deny: denied
depart: depart,departed,departs
departure: departure
depend: depending
deposit: deposited,deposits
depot: depot
depths: depths
descend: descend,descended
descent: descent
description: description
desert: deserted
deserve: deserved
desire: desire,desired,desires
desolated: desolated
despatch: despatches
desperate: desperate
desperately: desperately
desperation: desperation
despise: despise
destine: destined
destroy: destroy,destroyed,destroying
destruction: destruction
detection: detection
determine: determined,determining
detestable: detestable
develop: developed
development: development
devil: devil,devils
devotion: devotion
devour: devoured
diabolically: diabolically
dictate: dictate,dictating
die: die,died,dying
diego: diego
diet: diet
difficult: difficult
dig: dig,digging,dug
dignified: dignified
dignity: dignity
dim: dim,dimmed
diminish: diminished
dimly: dimly
din: din
dinner: dinner
direct: directing
direction: direction,directions
directness: directness
dirt: dirt
dirty: dirty
dis: dis
disappear: disappear,disappeared,disappearing
disaster: disaster
disburden: disburdened
discard: discarded
discharge: discharged,discharging
discipline: discipline,disciplining
disclose: disclosed
discolor: discolored
discomfited: discomfited
discomfiture: discomfiture
disconsolate: disconsolate
discover: discover,discovered
discovery: discovery
disgust: disgust
dish: dishes
dismay: dismay
disorder: disorder
displace: displaced
displeasure: displeasure
dispute: dispute
disrupt: disrupted
distance: distance
distant: distant
distinct: distinct
distribute: distributed
diver: divers
divide: divide,divides
divine: divined
docilely: docilely
doctor: doctor
dodge: dodge,dodged
dog: dog,dogs
dogged: dogged
dollar: dollars
dolly: dolly
domesticated: domesticated
dominant: dominant
dominion: dominion
doom: doom
door: door,doors
dose: dose
dot: dot
double: doubled,doubling
doubt: doubt
downhill: downhill
downward: downward
doze: dozing
dozen: dozen
drag: drag,dragged,dragging
draggle: draggled
draggled: draggled
drainage: drainage
drape: draped
draught: draught
draw: draw,drawing,drawn,drew
dream: dream,dreamed,dreaming,dreams
dreamily: dreamily
dreary: dreary
drift: drift,drifted,drifting
driftwood: driftwood
drink: drank,drink
drip: dripping
drive: drive,driven,drives,driving,drove
driver: driver,drivers
driveway: driveways
droop: drooped,drooping
drop: drop,dropped,dropping
drown: drowned
drum: drumming
druther: druther
dry: dried,dry
dub: dub
dubiously: dubiously
dull: dull
dump: dumped
duplicate: duplicated
dust: dust
duty: duties,duty
dwell: dwelling
dweller: dweller
dwindle: dwindled
dynasty: dynasty
eager: eager
eagerly: eagerly
eagerness: eagerness
ear: ear,ears
eared: eared
earn: earned
earnest: earnest
earth: earth
ease: ease
easily: easily
east: east
easy: easier,easy
eat: ate,eat,eaten,eating
eatable: eatable
eater: eater
ebb: ebb,ebbed
economy: economy
ecstasy: ecstasy
eddy: eddies,eddy
edge: edge
eerie: eerie
effectually: effectually
effort: effort,efforts
egotistical: egotistical
eighteen: eighteen
elbow: elbows
eldorado: eldorado
electric: electric
elimination: elimination
eloquent: eloquent
eloquently: eloquently
embrace: embrace,embracing
emptiness: emptiness
enable: enable,enabled
encounter: encountered
encourage: encourage,encouraged,encouraging
encouragement: encouragement
endless: endless
endure: endured
enemy: enemy
enforce: enforce,enforcing
english: english
enormous: enormous
enormousness: enormousness
enter: enter,entered
enthusiastically: enthusiastically
entice: enticed
entreat: entreated
envelop: enveloped,enveloping
environment: environment
equal: equal
equally: equally
equilibrium: equilibrium
ere: ere
erect: erect
errand: errands
error: error
escape: escape,escaped
escort: escorted
especial: especial
essential: essential
estimation: estimation
eternal: eternal
eternity: eternity
evening: evening
event: events
evidence: evidenced
evident: evident
evil: evil
evince: evinced
examine: examined,examining
excel: excelled
excellent: excellent
exception: exception
excess: excess
excessive: excessive
exchange: exchanged
excited: excited
excitedly: excitedly
excitement: excitement
exclaim: exclaim
exclamation: exclamations
excrescence: excrescence
exertion: exertion
exhausted: exhausted
exhausting: exhausting
exist: exist
existence: existence
expect: expected,expecting
expectant: expectant
expediency: expediency
experience: experience,experienced
experienced: experienced
experiment: experiment
exploit: exploit
express: express,expressed,expressing
expression: expression
exquisite: exquisite
external: external
extinct: extinct
extract: extracted
extreme: extreme
extremity: extremity
exultantly: exultantly
eye: eye,eyes
eyed: eyed
fabled: fabled
faced: faced
fade: fading
fail: fail,failed,failing,fails
faint: faint,fainter,faintest
faintly: faintly
fair: fair
faith: faith
faithful: faithful
faithfully: faithfully
faithfulness: faithfulness
fall: fall,fallen,falling,fell
fallen: fallen
fame: fame
familiar: familiar
familiarity: familiarity
family: family
famine: famine
famished: famished
fan: fanned
fang: fang,fangs
fanged: fanged
fare: fare,fared
farth: farthest
fashion: fashion,fashions
fast: fast,faster
fasten: fastened
fastidiousness: fastidiousness
fat: fat
fatal: fatal
fateful: fateful
father: father,fathered,fathers
fatigue: fatigue
fault: fault
favor: favor,favored,favors
favorite: favorite
fawn: fawned
fear: fear,feared
fearful: fearful
fearfully: fearfully
fearlessly: fearlessly
feast: feasted
feat: feat
feather: feathered,feathers
feathered: feathered
feature: feature
feebly: feebly
feed: fed
feel: feel,feeling
feeling: feeling,feelings
feign: feigned
fellow: fellow,fellows
fellowship: fellowship
ferine: ferine
ferocious: ferocious
ferocity: ferocity
ferry: ferry
fervently: fervently
fetch: fetching
fever: fever
feverish: feverish
fibre: fibre
field: field
fiend: fiend
fierce: fierce,fiercer,fiercest
fiercely: fiercely
fierceness: fierceness
fight: fight,fighting,fights,fought
fighter: fighter,fighters
fighting: fighting
figure: figure
file: file,filing
final: final
finally: finally
fine: fine
finely: finely
fingers: fingers
finish: finish,finished,finishing
firewood: firewood
fish: fish,fished
fishing: fishing
fissure: fissures
fit: fit,fits
fivescore: fivescore
flag: flag,flagged
flame: flame,flames,flaming
flank: flank,flanks
flap: flap,flapped
flash: flash,flashed,flashing
flat: flat
flatten: flattened
fleck: flecked
flee: fled,flee,fleeing
fleeting: fleeting
flesh: flesh
flicker: flickered
flight: flight
fling: fling,flung
flint: flint
flirt: flirted
flit: flitted,flitting
flood: flood,flooded
floor: floor
flounder: flounder,floundered
flour: flour
flow: flowing,flows
flower: flower,flowers
flung: flung
flush: flush
flutter: fluttered
fly: flew,flies,flying
foam: foaming
foe: foe
fold: folds
follow: follow
folly: folly
food: food
fool: fool,fooled,fools
foot: feet,foot
footed: footed
footing: footing
footsore: footsore
footstep: footsteps
forbear: forbear
forbiddingly: forbiddingly
forbore: forbore
force: force,forced
fore: fore
forebear: forebears
forecast: forecast
forego: forego,forewent
foremost: foremost
forest: forest
forge: forged
forget: forgot,forgotten
forgetfulness: forgetfulness
forlorn: forlorn
form: form,formed,forming,forms
formidable: formidable
fortune: fortune,fortunes
foul: foul
fountain: fountain,fountains
fourteen: fourteen
fourth: fourth
fowl: fowl
fox: fox
frame: frame
francisco: francisco
frankly: frankly
frantically: frantically
fraught: fraught
freeze: freezing,froze,frozen
freight: freight,freighted
french: french
frenzy: frenzy
frequently: frequently
fresh: fresh,fresher
friction: friction
friend: friends
friendliness: friendliness
friendly: friendly
friendship: friendship
frighten: frighten
frightened: frightened
frightful: frightful
frightfully: frightfully
fringe: fringed
frisco: frisco
frost: frost
frosty: frosty
froth: frothing
frown: frowning
frozen: frozen
frustrate: frustrated
fund: fund
fundamental: fundamental
fungus: fungus
fur: fur,furred
furiously: furiously
furnish: furnished
furred: furred
furry: furry
fury: fury
fuss: fuss
futile: futile
futilely: futilely
future: future
gad: gad
gain: gain,gained,gaining
galvanized: galvanized
gambler: gamblers
gambling: gambling
game: game,games
gamekeeper: gamekeepers
gape: gaping
gar: gar
garb: garbs
gardener: gardener
garment: garments
gas: gas
gash: gashing
gasp: gasp,gasped,gasping
gather: gathered
gaunt: gaunt
gayety: gayety
gaze: gaze
gear: gear
gee: gee
generation: generation,generations
generous: generous
generously: generously
genial: genial
gentleman: gentlemen
gentler: gentler
genuine: genuine
geological: geological
ghost: ghost
ghostly: ghostly
giant: giant,giants
gif: gif
gigantic: gigantic
gingerly: gingerly
glacier: glaciers
glad: glad
gladden: gladdened
gladness: gladness
glamour: glamour
glance: glance,glanced
glazed: glazed
gleam: gleaming
gleefully: gleefully
glide: gliding
glimmer: glimmering
glimpse: glimpses
glitter: glitter
gloomy: gloomy
glorious: glorious
gloriously: gloriously
gloss: gloss
glow: glowed
gnat: gnats
goad: goaded
god: god
gold: gold
goose: goose
gorge: gorge
government: government
grade: grade,grades
grandson: grandsons
grape: grape
grapple: grappled,grappling
grasp: grasp
grass: grass,grasses
grate: grating
gratify: gratifying
gravel: gravel
gravelled: gravelled
gravely: gravely
graven: graven
gray: gray
greatly: greatly
greatness: greatness
green: green
greet: greeting
grief: grief
grievance: grievance
grievously: grievously
grimly: grimly
grin: grin,grinned,grinning
grind: ground
grip: grip,gripped
grit: grit
grittily: grittily
groan: groaned
groom: grooms
groove: grooves
grope: grope,groping
ground: ground
grow: grew,grow,growing,grown,grows
grower: growers
growl: growl,growled,growling,growls
grown: grown
growth: growth
grub: grub
gruffly: gruffly
grumble: grumbled,grumbling
grunt: grunted,grunting
guard: guard,guarded,guards
guardianship: guardianship
guide: guided,guiding
guilty: guilty
gulp: gulped
gun: gun
gust: gust
habit: habits
hail: hailed
hair: hair
haired: haired
hairless: hairless
hairy: hairy
hal: hal
halfway: halfway
halt: halt,halted
hammer: hammered
hand: hand,hands
handed: handed
handful: handful
handicap: handicap
handkerchief: handkerchief
handle: handle
hang: hang,hanging,hung
hankering: hankering
hans: hans
happen: happened,happening
happiness: happiness
hard: hard,harder,hardest
harden: hardened
hark: harked,harking
harm: harm
harness: harness,harnessed,harnesses,harnessing
harry: harrying
harsh: harsh
haste: haste
hasten: hastened
hat: hats
hatchet: hatchet
hate: hated
hatred: hatred
haul: hauled,hauling
hauling: hauling
haunch: haunches
haunt: haunted
haw: haw
head: head,headed,heading,heads
heal: healed
health: health
heap: heaped
hear: hear,heard,hearing
hearing: hearing
heart: heart,hearts
heartbreaking: heartbreaking
hearted: hearted
heartedly: heartedly
heat: heat
heaven: heaven
heavily: heavily
heavy: heavier,heavy
hedge: hedged
heed: heed
heel: heels
height: height
helper: helper,helpers
helpless: helpless
helplessly: helplessly
helplessness: helplessness
herald: heralded
herd: herd
heredity: heredity
heroic: heroic
hesitate: hesitate
hey: hey
hidden: hidden
hide: hidden,hide,hides,hiding
hiding: hiding
highly: highly
hike: hike
hill: hill
hind: hind
hinder: hinder
hint: hint
hip: hip,hips
history: history
hit: hitting
hitch: hitch,hitching
ho: ho
hoarse: hoarse
hoist: hoisted
hold: held,hold,holding,holds
hole: hole,holes
homesick: homesick
honestly: honestly
honk: honked
honor: honored
hoof: hoofs
hope: hope,hoped
hopeless: hopeless
horn: horns
horrible: horrible
horribly: horribly
horror: horror
horse: horse,horses
hostile: hostile
hot: hot
hotel: hotel
hour: hour,hours
house: house
housemaid: housemaids
howl: howl,howled,howling
hudson: hudson
huge: huge
hum: hum
human: humans
humor: humor
hundredweight: hundredweight
hunger: hunger
hungry: hungry
hunt: hunted,hunting,hunts
hunter: hunter,hunters
hunting: hunting
hurl: hurled,hurling
hurricane: hurricane
hurriedly: hurriedly
hurry: hurried,hurry
hurt: hurt,hurting
husband: husband
husky: huskies,husky
hydrophoby: hydrophoby
hysteria: hysteria
ice: ice
idea: idea
ideal: ideal
idle: idle
idol: idols
ignominiously: ignominiously
iii: iii
illumine: illumined
imagination: imagination
imagine: imagined
impact: impact
impartial: impartial
impatience: impatience
impeachment: impeachment
impede: impede
impel: impelled
impend: impending
impending: impending
imperative: imperative
imperiously: imperiously
imploringly: imploringly
importune: importuned
impossible: impossible
impress: impress
imprison: imprisoned
impulse: impulse,impulses
inability: inability
inarticulate: inarticulate
incarnate: incarnate
incarnation: incarnation
inch: inch,inches
incident: incident
incidentally: incidentally
incline: inclined
include: included,including
incoherent: incoherent
incompetence: incompetence
incomprehensible: incomprehensible
inconceivably: inconceivably
increase: increase,increased
incurious: incurious
indefinite: indefinite
indeterminate: indeterminate
indian: indian,indians
indigestible: indigestible
indiscreet: indiscreet
indiscretion: indiscretion
indispensable: indispensable
inevitable: inevitable
inevitably: inevitably
inexorable: inexorable
infinitely: infinitely
infinitesimal: infinitesimal
inflammation: inflammation
influence: influence
infrequent: infrequent
inherit: inherited
injure: injured
inkling: inkling
innocuously: innocuously
innutritious: innutritious
inoffensive: inoffensive
insensible: insensible
inseparable: inseparable
insides: insides
insidious: insidious
insist: insist,insisted
instance: instance,instances
instant: instant
instantaneous: instantaneous
instinct: instinct,instincts
instinctively: instinctively
instruction: instruction
insubordination: insubordination
insular: insular
intelligence: intelligence
intend: intended
intense: intense
intensely: intensely
intent: intent
intention: intention,intentions
intentness: intentness
interfere: interfere,interfered
interlace: interlacing
internal: internal
interrupt: interrupt
interval: interval,intervals
intimacy: intimacy
intimate: intimate,intimated
intolerable: intolerable
introduction: introduction
introspective: introspective
invade: invaded
invader: invaders
invest: invested
investigate: investigate
invitation: invitations
involuntarily: involuntarily
irish: irish
iron: iron
irresistible: irresistible
irresolutely: irresolutely
irritability: irritability
irritable: irritable
irritate: irritating
irritating: irritating
island: island
issue: issued
iv: iv
jack: jack
jaded: jaded
jagged: jagged
jam: jam
jangle: jangling
japanese: japanese
jar: jarring
jaw: jaw,jaws
jealousy: jealousy
jerk: jerk,jerked,jerks
jim: jim
jingle: jingling
jingo: jingo
job: job
joe: joe
john: john
joint: joint
jolt: jolted
journey: journey
journeyer: journeyers
joy: joy
joyful: joyful
joyfully: joyfully
jubilant: jubilant
judge: judge
judgment: judgment
jugular: jugular
juice: juices
jump: jump
justice: justice
jut: jutted
keel: keel
keen: keen,keenest
keenly: keenly
keeper: keeper
kennel: kennel,kennels
key: key,keyed
kick: kick
kidnap: kidnapped
kidnapper: kidnapper
kill: kill,killed,killing
killer: killer
kin: kin
kindliness: kindliness
kindly: kindly
kindred: kindred
king: king
kiss: kissed
kitten: kittens
klondike: klondike
knee: knee,knees
kneel: knelt
knife: knife
knit: knitted
knock: knock,knocked,knocking
knotting: knotting
knotty: knotty
knowledge: knowledge
knuckle: knuckles
knuckled: knuckled
lacerate: lacerated
lack: lack
lak: lak
lake: lake,lakes
land: land,landed
landing: landing
lap: lap,lapping
lapse: lapsed
largeness: largeness
las: las
lash: lash
lashing: lashing,lashings
late: late
latent: latent
laugh: laugh,laughed,laughing
launch: launched
law: law
lawgiver: lawgiver
lawn: lawns
lay: laid,lay,lays
lazily: lazily
lazy: lazy
le: le
lead: lead,leading,led
leaden: leaden
leader: leader,leaders
leadership: leadership
leaf: leaf,leaves
lean: lean
leap: leap,leaped,leaping
learn: learn,learned,learning
leash: leashed
leather: leather
leathery: leathery
leave: leave,leaving,left
ledge: ledge
leeward: leeward
left: left
leg: leg,legs
legged: legged
legion: legion
lek: leks
leks: leks
lend: lend
lesson: lesson,lessoned
letter: letter,letters
level: level,levels
library: library
lick: lick,licked,licking
lie: lie,lying
life: life,lives
lifeless: lifeless
lifetime: lifetime
lift: lift,lifted,lifting
light: light,lighter,lighting,lights,lit
lighten: lightened
lightish: lightish
lightly: lightly
lightning: lightning
limb: limb
limitless: limitless
limp: limp,limped,limping
limping: limping
limply: limply
linger: linger,lingered,lingering
link: linked
lionlike: lionlike
lip: lip,lips
listen: listen,listened,listening
listening: listening
literally: literally
live: live,lived,living
lively: lively
living: living
load: load,loaded
loaf: loaf
loafing: loafing
loath: loath
loathsome: loathsome
locate: locate
lock: lock
locomotive: locomotive,locomotives
lodge: lodge
log: log,logs
logs: logs
loll: lolling
lolling: lolling
london: london
lonely: lonely
longing: longing,longings
loom: loom
loose: loose,loosed
loosely: loosely
loosen: loosen
loot: looted
lope: lope,loped
lord: lord
lose: lost
loser: loser
loss: loss,losses
lot: lot
lottery: lottery
loud: louder
loudly: loudly
love: love,loved
lovingly: lovingly
luck: luck
lug: lugged
lugubriously: lugubriously
lunge: lunge
lurch: lurched
lure: lures,luring
luringly: luringly
lurk: lurking
lust: lust
lusty: lusty
machine: machine
mad: mad
madly: madly
madness: madness
magnetic: magnetic
magnetism: magnetism
magnificent: magnificent
mail: mail
main: main
maintain: maintaining
majority: majority
malicious: malicious
malignant: malignant
malinger: malinger
malingerer: malingerer
manage: manage,managed
mandate: mandate
mane: mane
mangled: mangled
manhood: manhood
manifest: manifested
manifestly: manifestly
manila: manila
mankind: mankind
manner: manner
manuel: manuel
marauder: marauders
march: march,marched,marching
mark: marked,marks
marsh: marsh
marvellous: marvellous
mass: mass
massive: massive
master: master,mastered,masters
masterful: masterful
mastership: mastership
mastery: mastery
mastodon: mastodon
mat: matted
match: match,matching
mate: mates
matted: matted
matter: matter,matters
mayo: mayo
meal: meal
meaning: meaning
measure: measured
meat: meat
meditate: meditated
meekly: meekly
meet: meet,met
meeting: meeting
melancholy: melancholy
mell: mell
memorable: memorable
memory: memories,memory
menace: menace
menacing: menacing
menacingly: menacingly
mend: mend,mending
mentally: mentally
mercedes: mercedes
merciless: merciless
mercilessly: mercilessly
mercy: mercy
mere: mere
merrily: merrily
mess: mess
message: message
messenger: messengers
metal: metal
metallic: metallic
metamorphose: metamorphosed
method: method
mew: mewed
mexican: mexican
mid: mid
middle: middle
midmost: midmost
midnight: midnight,midnights
midst: midst
midway: midway
mightily: mightily
mighty: mighty
migrate: migrating
mile: mile,miles
miller: miller
mind: mind
miner: miners
mining: mining
ministration: ministrations
minor: minor
minute: minutes
miracle: miracle
miscalculate: miscalculated
misdeed: misdeed
misdemeanor: misdemeanors
miserable: miserable
misery: misery
mistake: mistake
mistaken: mistaken
misunderstand: misunderstood
misunderstanding: misunderstandings
mite: mite
mitten: mittened,mittens
mittened: mittened
moan: moaned
moccasin: moccasins
mode: mode
moisture: moisture
mollie: mollie
moment: moment,moments
momentum: momentum
money: money
mongrel: mongrels
monosyllabic: monosyllabic
monotonous: monotonous
month: months
mood: mood,moods
moon: moon
moonlight: moonlight
moose: moose
mop: mops
moral: moral
morning: morning
morose: morose
mortal: mortal
mosquito: mosquitoes
moss: moss
mother: mother,mothers
motion: motion
motionless: motionless
mould: mould
mountain: mountain,mountains
mountainous: mountainous
mournful: mournful
mournfully: mournfully
mourning: mourning
mouth: mouth
movement: movement,movements
muck: muck
mud: mud
muddy: muddy
multiply: multiplied
multitudinous: multitudinous
murmur: murmur,murmured,murmurs
muscle: muscle,muscles
muse: muses,musing
mush: mush
musher: mushers
mushy: mushy
music: music
mustache: mustache
mutiny: mutiny
muzzle: muzzle
mysterious: mysterious
mysteriously: mysteriously
mystery: mystery
nag: nagging
naked: naked
nameless: nameless
narrow: narrow
narwhal: narwhal
native: native
nature: nature
natured: natured
naturedly: naturedly
necessaries: necessaries
neck: neck
needle: needle
neighboring: neighboring
nerve: nerve
nervous: nervous
nest: nest,nests
newborn: newborn
newcomer: newcomers
newfoundland: newfoundland
news: news
newspaper: newspapers
nice: nice
nig: nig
night: night,nights
nightmare: nightmare
nineteen: nineteen
nip: nip,nipped
noble: noblest
nocturnal: nocturnal
nod: nodded,nodding
noise: noise,noises
noiselessly: noiselessly
nomadic: nomadic
north: north
northland: northland
northwest: northwest
nose: nose,noses,nosing
nostril: nostrils
notch: notches
note: note
notice: notice,noticing
nudge: nudge
nugget: nuggets
numb: numb
numerous: numerous
nurse: nursed,nursing
nutriment: nutriment
oath: oath,oaths
obdurate: obdurate
obedience: obedience
obediently: obediently
obey: obey,obeyed
obliterate: obliterated
obscurely: obscurely
obscureness: obscureness
observe: observed
occasion: occasion,occasions
occasional: occasional
occupant: occupants
occupy: occupied
odd: odd
odds: odds
offence: offence
offend: offending
offensive: offensive
offer: offer,offered,offering
office: office
official: official
oftener: oftener
onlooker: onlookers
onlooking: onlooking
onset: onset
openly: openly
operate: operating
opinion: opinions
opportunity: opportunity
oppose: opposing
oppress: oppressed
orchard: orchard,orchards
ordain: ordained
orderly: orderly
ordinary: ordinary
organize: organizing
original: original
orthodox: orthodox
ounce: ounce
outcome: outcome
outdistance: outdistanced
outdoor: outdoor
outer: outer
outfit: outfit
outhouse: outhouses
outline: outlined,outlines
outlook: outlook
outrage: outrage
outreach: outreached
outsides: outsides
overfeed: overfeeding
overhang: overhanging
overhaul: overhauled
overhead: overhead
overloaded: overloaded
overlook: overlooked
overpower: overpowering
overrun: overrunning
overspill: overspilling
overtake: overtake,overtaken
overthrow: overthrow,overthrowing,overthrown
overture: overture
overturn: overturning
owner: owners
pace: pace
pack: pack,packed,packing,packs
packed: packed
pad: pads
paddock: paddocks
pain: pain,pains
painful: painful
painfully: painfully
painstakingly: painstakingly
pair: pair
pale: pale,paled
pall: pall
palmated: palmated
palpitant: palpitant
pampered: pampered
pan: pan,pans
pandemonium: pandemonium
pang: pangs
panic: panic
panther: panther
panting: panting
paradox: paradox
parallel: parallel
parcel: parcels
parched: parched
park: park
paroxysm: paroxysms
particle: particle
partly: partly
partner: partners
partnership: partnership
partridge: partridges
party: party
pass: pass,passed,passes,passing
passage: passage
passing: passing
passion: passion
passionate: passionate
passive: passive
passiveness: passiveness
pasture: pastures
pat: patted
patch: patches
path: path
patience: patience
pause: pause,paused
paw: paws
pay: paid,pay
peace: peace
peak: peaks
peculiar: peculiar
peculiarity: peculiarity
peculiarly: peculiarly
peer: peer,peered
pell: pell
pellet: pellets
pen: pent
pencil: pencil
penetrate: penetrate,penetrated
pepper: pepper
perambulate: perambulating
perceive: perceived,perceiving
perceptibly: perceptibly
perch: perches
peremptorily: peremptorily
perfect: perfect
perform: performed
performance: performance
peril: peril
period: periods
permanent: permanent
permit: permitted,permitting
perpendicular: perpendicular
perpetual: perpetual
perplex: perplexed
persist: persisted
persistent: persistent
person: people
personal: personal
pertinacity: pertinacity
pervade: pervaded
pet: pet,petted
pete: pete
petty: petty
phrase: phrase
physical: physical
pick: pick,picked,picking
piece: piece,pieces
pike: pike
pile: pile,piled
pine: pine,pines
pipe: pipe,pipes
pistol: pistol
pitch: pitch,pitched
pivot: pivoting
pivoting: pivoting
placer: placer
plain: plain
plainly: plainly
plaint: plaint
plant: plant
play: play,played,playing,plays
playfully: playfully
plead: pleaded
pleading: pleading
plenty: plenty
plethoric: plethoric
plight: plight
plough: ploughed
pluck: pluck
plum: plum
plunge: plunge,plunged,plunging
pointedly: pointedly
pointer: pointers
poise: poise,poised
poke: poked
pole: pole,poled
police: police
poling: poling
politeness: politeness
political: political
pompous: pompous
pooh: pooh
pool: pool,pools
poor: poor,poorer
poplar: poplars
populous: populous
porcupine: porcupine
position: position
positive: positive
possess: possess,possessed
possession: possession
possibility: possibility
potent: potent
pouch: pouch
pound: pound,pounded,pounding,pounds
pour: pour,poured
powdery: powdery
power: power
powerfully: powerfully
practically: practically
practise: practised
praise: praise
pray: prayed
preach: preaching
precious: precious
precipitate: precipitate
preeminently: preeminently
prefer: preferred
pregnant: pregnant
prejudice: prejudices
preliminary: preliminary
prepare: prepared,preparing
prerogative: prerogative
presence: presence
presently: presently
preserver: preserver
press: pressed,pressing
pretty: pretty
prevent: prevent,prevented
previous: previous
prey: prey,preyed,preying
price: price
prick: pricked
pride: pride,prided
primeval: primeval
primitive: primitive
primordial: primordial
principally: principally
print: prints
private: private
privilege: privilege
proceed: proceeded,proceeding
proceeds: proceeds
proclaim: proclaimed,proclaiming
prod: prodded
profit: profit
progeny: progeny
progress: progress
project: project,projected
prolonged: prolonged
promise: promise,promises
prompt: prompt,prompting
prone: prone
propel: propelled
propeller: propeller
proper: proper
property: property
proportion: proportion,proportions
prosper: prosper,prospered
prostrate: prostrate
protect: protect,protected
protection: protection
protest: protest,protested
protrude: protruded,protruding
proudly: proudly
prove: proved
provocation: provocation
prowess: prowess
prowl: prowled
pry: pry
ptarmigan: ptarmigan
public: public
pug: pug
puget: puget
pull: pull,pulled,pulling
pullman: pullman
pulse: pulse
pumping: pumping
punish: punish,punished
punishment: punishment
puppet: puppet
puppyhood: puppyhood
purpose: purposed
purposely: purposely
pursue: pursued
pursuit: pursuit
push: pushed
puzzle: puzzled
quality: quality
quarrel: quarrel,quarrelled,quarrelling
quarrelling: quarrelling
quarry: quarry
quarter: quarter,quarters
quaver: quaver
queen: queen
quest: quest
quibble: quibble
quick: quick
quicken: quickened
quickness: quickness
quiet: quiet
quietly: quietly
quiver: quivered,quivering
quote: quoting
quoth: quoth
rabbit: rabbit
race: race,raced,races
raft: raft,rafted
rage: rage,raged,raging
ragged: ragged
rail: rail
railway: railway
rain: rain
raise: raised
raisin: raisin
rake: rake
ram: ram
ramble: rambles
rampant: rampant
ramshackle: ramshackle
range: range,ranged,ranging
rap: rapped
rapid: rapid,rapids
rapidity: rapidity
rapids: rapids
rarely: rarely
rashness: rashness
ration: ration
rattle: rattled
ravenous: ravenous
raw: raw
reach: reach,reached,reaches,reaching
read: read,reading
ready: ready
real: real
reality: realities,reality
realize: realized
realm: realm
rear: rear,reared,rearing
rearrange: rearranging
reason: reason,reasoned
reassure: reassured
rebel: rebel,rebels
rebound: rebound
recall: recalled
recede: receding
receive: receive,received,receiving
recess: recesses
recital: recital
recognize: recognize,recognized
recollection: recollections
record: record
recover: recover,recovered
recovery: recovery
recuperate: recuperated
recuperation: recuperation
recurrent: recurrent
red: red
reel: reeled
refresh: refreshed
refuse: refused,refusing
regain: regained
register: registering
regular: regular
regularity: regularity
regularly: regularly
reign: reign
rejoin: rejoin
rejoinder: rejoinder
relation: relations
relax: relax
relaxed: relaxed
release: released,releasing
relevant: relevant
relief: relief
reluctantly: reluctantly
remain: remain,remained
remainder: remainder
remark: remarked
remarkable: remarkable
remarkably: remarkably
remedy: remedy
remember: remember,remembered
remnant: remnant,remnants
remonstrance: remonstrance
remote: remoter,remotest
remotely: remotely
remove: removed
rend: rend,rending
rent: rent
repeat: repeated
repeatedly: repeatedly
replace: replaced
reply: replied,replies,reply
repose: repose
reproof: reproof
repugnance: repugnance
reputation: reputation
require: required,requires
rescue: rescue,rescued
resent: resent,resented
reserve: reserve
reside: resided
resiliency: resiliency
resist: resist
resolutely: resolutely
resolve: resolved
resounding: resounding
respect: respect
respectful: respectful
respond: responded,responding
response: response
rest: rest,rested,resting
restlessly: restlessly
restlessness: restlessness
result: result
resume: resumed
retain: retained
retaliate: retaliate,retaliated
retard: retarding
retarded: retarded
retrace: retraced
retreat: retreated
retrogression: retrogression
return: return,returned,returning
revelation: revelation
reverently: reverently
revolt: revolt
revolver: revolver
reward: rewarded
rhythm: rhythm
rib: rib,ribs
ribbon: ribbons
rid: rid
riddle: riddled
ride: ride,riding,rode
ridiculous: ridiculous
riding: riding
rifle: rifle
rift: rift
rigorous: rigorous
rim: rim
rink: rink
riotously: riotously
rip: ripped,ripping,rips
ripe: ripe
ripple: rippling
rise: rise,rising,rose
risk: risk,risks
rival: rival
river: river,rivers
road: road
roam: roamed
roar: roar,roared,roaring
roaring: roaring
rob: rob,robbed,robbing
robe: robe,robes
rock: rock,rocking,rocks
roll: rolled,rolling,rolls
romance: romance
romp: romped
roof: roof
roost: roosted
rope: rope,ropes
rot: rotted
rotten: rotten
rough: rough
roughly: roughly
rounded: rounded
roundly: roundly
rouse: rouse,roused
route: routed
rove: rove,roved
row: rows
royal: royal
rub: rubbed
ruction: ruction
rule: rule,ruled
runner: runners
running: running
rush: rush,rushed,rushes,rushing
rustle: rustled
rut: rut
ruthless: ruthless
sack: sack,sacked,sacks
sacrifice: sacrificed
sad: sad
safe: safe
safety: safety
sag: sagged
sake: sakes
salient: salient
salmon: salmon
saloon: saloon
salt: salt
san: san
santa: santa
sap: sap,sapped
sate: sated
satisfaction: satisfaction
satisfied: satisfied
sausage: sausage
savage: savage,savages
savagely: savagely
savageness: savageness
savagery: savagery
save: save,saved
savor: savor
scale: scale,scaled
scales: scales
scar: scarred,scarring
scarlet: scarlet
scatter: scatter,scattered,scattering
scene: scene
scent: scent,scented,scenting
scheme: scheme
scholar: scholar
school: schools
scorch: scorched
score: score,scored
scotch: scotch
scramble: scrambling
scrape: scraped
scratch: scratched
scream: scream,screamed,screaming
scruff: scruff
scum: scum
sea: sea
search: search,searched
season: seasons
seattle: seattle
secrecy: secrecy
secret: secret
secretly: secretly
secure: secure,secured
securely: securely
seed: seed
seek: seek,seeking,sought
seize: seize,seized
select: select,selected
sell: sold
sensation: sensation,sensations
sense: sense,sensed
senseless: senseless
sensitive: sensitive
separate: separate,separated
sequential: sequential
servant: servants
serve: served
set: set,setting
setter: setter
settle: settles
severe: severe
severely: severely
sex: sex
shade: shade
shades: shades
shadow: shadow,shadows
shaggy: shaggy
shake: shake,shaken,shaking,shook
shallow: shallow
shamble: shambled,shambling
shame: shame
shape: shape
share: share
sharp: sharp
sharply: sharply
shear: shorn
sheen: sheen
sheep: sheep
sheepishly: sheepishly
sheer: sheer
sheet: sheet
shellfish: shellfish
shelter: shelter,sheltered,sheltering
sheltered: sheltered
shepherd: shepherd
shift: shifted,shifting
shine: shining,shone
ship: ship
shipping: shipping
shirk: shirked,shirks
shiver: shivered,shivering
shock: shock
shoe: shoes
shoot: shoots,shot
shore: shore,shores
shoreward: shoreward
short: short,shorter
shortly: shortly
shot: shot
shoulder: shoulder,shoulders
shout: shout,shouted,shouting
shove: shove
shred: shreds
shrewd: shrewd
shrewdly: shrewdly
shriek: shriek,shrieked,shrieking
shrill: shrill
shroud: shrouded
shrub: shrubs
shrug: shrugged
shun: shunned
shut: shutting
sick: sick
sickly: sickly
sigh: sighing
sight: sight,sights
sign: sign,signed,signs
silence: silence
silent: silent
silk: silk
silky: silky
silly: silly
silvery: silvery
simple: simple
simply: simply
simulated: simulated
simultaneous: simultaneous
sin: sin
sinew: sinew
sing: sang,sing,singing,sings
singe: singed
singing: singing
single: single
sink: sank,sink,sinking,sinks
sir: sir
sister: sister
sit: sat,sit,sitting
situation: situation
sixteen: sixteen
size: size
skeet: skeet
skeleton: skeletons
skin: skin,skins
skirt: skirted
skookum: skookum
skulk: skulking
sky: sky
skyward: skyward
slack: slack,slacked
slake: slake
slam: slammed
slant: slanted
slap: slapping
slash: slash,slashed,slashing
slaver: slaver,slavered
slaying: slaying
sled: sled,sledded,sleds
sleek: sleek
sleep: sleep,sleeping,slept
sleeping: sleeping
sleepy: sleepy
slender: slender
slice: slice
slide: slid
slight: slight
slim: slim
slip: slipped,slipping
slippery: slippery
slipshod: slipshod
slope: slope,sloped
slouch: slouch
slovenly: slovenly
slow: slow,slower
slowly: slowly
sluice: sluice
slyly: slyly
smart: smart
smash: smashed,smashing
smell: smell,smelled,smelling,smells
smile: smiled,smiling
smother: smothered
snag: snags
snake: snake
snap: snap,snapped,snapping,snaps
snarl: snarl,snarled,snarling
sneer: sneered
sneering: sneering
sniff: sniffed,sniffing,sniffs
snort: snort
snow: snow,snowed,snows
snowdrift: snowdrifts
snowfall: snowfall
snowshoe: snowshoe
snub: snub,snubbed,snubbing
snug: snug
soar: soars
sob: sobbed,sobbing,sobs
society: society
soft: soft,softer
soften: softened
softly: softly
soil: soil
sol: sol
soldier: soldier
solidarity: solidarity
solidly: solidly
soliloquize: soliloquized
solitary: solitary
sombre: sombre
son: sons
song: song,songs
sore: sore
sorely: sorely
sorrow: sorrow
sort: sort,sorts
sou: sou
sound: sound,sounded,sounding,sounds
sounding: sounding
soundly: soundly
sour: sour,sourer
south: south
southland: southland
space: space,spaces
spacious: spacious
spark: spark,sparks
spasmodically: spasmodically
speak: speak,spoke
spear: spear,spears
special: special
speech: speech
speed: sped,speed
speedily: speedily
spend: spent
spider: spider
spik: spik
spill: spilling
spinning: spinning
spirit: spirit
spit: spat,spit
spite: spite
spitz: spitz
splash: splash,splashes
splay: splay
splendid: splendid
splintering: splintering
split: split
splutter: spluttered
spoil: spoil
spoiled: spoiled
spot: spot
spout: spouted
spray: spray,sprayed
spread: spread,spreading
spring: sprang,spring,springs,sprung
springiness: springiness
springtime: springtime
spruce: spruce
spur: spurred
spy: spy
squabbling: squabbling
squarehead: squarehead
squarely: squarely
squat: squatted
squaw: squaw
squirm: squirmed
squirrel: squirrels
squirrels: squirrels
stable: stable,stables
stage: stage
stagger: stagger,staggered,staggering
stake: staked
stalk: stalk,stalked
stamp: stamped
stand: stand,standing,stands,stood
standing: standing
standstill: standstill
star: star,stars
start: start,started,starting,starts
starvation: starvation
starve: starved,starves,starving
stately: stately
station: station
statue: statue
stay: stay,staying
stead: stead
steadily: steadily
steal: steal,stealing,stole
stealthily: stealthily
steamer: steamer
steamship: steamship
steel: steel
steep: steep,steeped
steeply: steeply
step: step,stepped,steps
stern: stern
stewart: stewart
stick: stick,sticks
stiff: stiff
stiffen: stiffened
stiffness: stiffness
stinging: stinging
stir: stir,stirred,stirring
stirring: stirring,stirrings
stomach: stomach
stone: stone
stoop: stooped
stopover: stopover
stoppage: stoppage,stoppages
store: store
storm: stormed
story: story
stout: stout,stoutest
stoutly: stoutly
straight: straight
strain: strain,strained,straining
strange: strange
strangely: strangely
stranger: stranger,strangers
strangle: strangle,strangling
strap: strapped,straps
straw: straw
strawberry: strawberries
stray: stray
stream: stream,streamed,streaming,streams
streamlet: streamlet
street: street
strength: strength
stretch: stretch,stretched,stretches
stricken: stricken
strife: strife
strike: strike,striking,struck
string: strings,strung
stringy: stringy
strip: stripped,strips
strive: striving,strove
stroke: strokes
stroll: stroll
strong: strong,stronger
struggle: struggle,struggled,struggling
strut: strutting
study: studying
stuff: stuff
stumble: stumbled
stun: stunned
stutter: stuttered
style: style
subdued: subdued
submerge: submerged
substitute: substitute
subtle: subtle
subtler: subtler
succeed: succeed,succeeded
successful: successful
succession: succession
suck: suck
sudden: sudden
suddenly: suddenly
suffer: suffer,suffered,suffering
suffering: suffering
sufficient: sufficient
suffocate: suffocating
sullen: sullen
sullenly: sullenly
sum: sum
summer: summer,summers
summit: summit
sun: sun
sundays: sundays
sunland: sunland
sunshine: sunshine
superfluous: superfluous
superior: superior
supper: supper
supply: supply
suppose: suppose
suppress: suppress,suppressed
suppressedly: suppressedly
supremacy: supremacy
supreme: supreme
surcharge: surcharged
surely: surely
surface: surface
surge: surge,surged,surging
surgeon: surgeon
surprise: surprise,surprised
surprised: surprised
surprising: surprising
surround: surrounded
survey: survey,surveyed
survive: survive,survived,surviving
survivor: survivors
suspicious: suspicious
swagger: swaggering
swarm: swarming
swart: swart
swarthy: swarthy
sway: swayed
swear: swearing,swore,sworn
sweat: sweating
sweater: sweater
sweep: sweep,sweeping,swept
sweet: sweet
sweetheart: sweethearts
swell: swelled,swelling
swift: swift
swiftly: swiftly
swim: swam
swimmer: swimmer
swimming: swimming
swing: swing,swung
swinging: swinging
swirl: swirl
swollen: swollen
sympathetically: sympathetically
table: tables
tagish: tagish
tail: tail,tails
taker: takers
takin: takin
tale: tale
talk: talk,talked,talking
talking: talking
tall: tall
tallow: tallow
tam: tam
tame: tamed
tangible: tangible
tangle: tangle,tangled
tangled: tangled
tank: tank
target: target
task: task
taste: taste,tasting
taunt: taunted
taut: taut
teach: taught,teach
teacher: teachers
teaching: teaching
team: team,teams
tear: tearing,tears,tore,torn
tease: teasing
temper: temper,tempers
temperature: temperature
tempered: tempered
tend: tend
tenderfoot: tenderfoot
tendon: tendons
tense: tense
tent: tent,tents
term: terms
terrible: terrible
terribly: terribly
terrier: terriers
terrific: terrific
terrify: terrified
terrifying: terrifying
terror: terror
terse: terse
testimony: testimony
thaw: thawed,thawing
theft: theft
thenceforward: thenceforward
theory: theory
thermometer: thermometer
thicket: thicket
thief: thief
thigh: thighs
thinking: thinking
thirst: thirst,thirsting
thirsty: thirsty
thong: thong
thoroughfare: thoroughfare
thoughtless: thoughtless
thrash: thrash,thrashing
thread: threading
threaten: threatened,threatening
threateningly: threateningly
thrice: thrice
thrill: thrill
thrilling: thrilling
throat: throat,throats
throb: throbbed,throbbing
throttle: throttled
throw: threw,throw,throwing,thrown
thrust: thrust,thrusting
thump: thumping
tidal: tidal
tide: tide,tides
tie: tie
tight: tight
tighten: tightened,tightening
tightly: tightly
timber: timber
time: time,times
timid: timid
tin: tin
tinkle: tinkled
tire: tire
tired: tired
tiredness: tiredness
tireless: tireless
tissue: tissue,tissues
toe: toes
toil: toil,toiled
token: token,tokens
tolerate: tolerated
toll: toll
tom: tom
ton: ton
tone: tone
tongue: tongue,tongues
tonic: tonic
tool: tools
tooth: teeth
toothless: toothless
toots: toots
topic: topic
torment: torment
tormentor: tormentor,tormentors
tornado: tornado
toss: tossed
total: total
tote: tote
totem: totem
totter: tottered
touch: touch,touched,touches
tough: toughest
tow: towed
town: town
trace: trace,traces
track: track
trade: trade,traded
tradition: tradition
tragedy: tragedy
tragic: tragic
trail: trail,trails
train: train,trained
trait: trait,traits
tramp: tramping
trample: trampled
transform: transformed,transforming
transformation: transformation
transient: transient
transportation: transportation
trap: trap,traps
travail: travail
travel: travel,travelled,travelling
traveller: travellers
treacherous: treacherous
treacherously: treacherously
treachery: treachery
treasure: treasure
treat: treated
treatment: treatment
tree: tree,trees
treetop: treetops
tremble: trembled,trembling
tremendous: tremendous
trespasser: trespasser
tribesman: tribesmen
trice: trice
trick: trick,tricked,tricks
trickle: trickle,trickling
trifle: trifle
trim: trim
trip: trip,tripped
triumph: triumph
triumphantly: triumphantly
trot: trot,trotted
trouble: trouble
trouncing: trouncing
trouser: trouser
truce: truce
truck: truck,trucked
true: true
trunk: trunk,trunks
trust: trust
tubbing: tubbing
tucker: tuckered
tuition: tuition
tumble: tumbled
tween: tween
twilight: twilight
twist: twist,twisted
twitching: twitching
type: type
ultimately: ultimately
unable: unable
unaffected: unaffected
unafraid: unafraid
unaltered: unaltered
unapproachable: unapproachable
unaware: unaware
unbreakable: unbreakable
unbridled: unbridled
unbroken: unbroken
unbuilt: unbuilt
uncanny: uncanny
uncharted: uncharted
uncle: uncles
uncoil: uncoiled
unconcern: unconcern
unconscious: unconscious
unconsciously: unconsciously
uncontent: uncontent
uncouth: uncouth
uncowed: uncowed
underbrush: underbrush
underfeed: underfeeding
underfeeding: underfeeding
underfoot: underfoot
undergrowth: undergrowth
underhand: underhand
understand: understand,understood
understanding: understanding
undervalue: undervalued
undesirable: undesirable
undo: undid
undreamed: undreamed
unduly: unduly
unearth: unearthed
uneasily: uneasily
unending: unending
unendurable: unendurable
unexpected: unexpected
unfair: unfair
unfasten: unfastened
unfastened: unfastened
unfed: unfed
unfinished: unfinished
unheeded: unheeded
unhesitatingly: unhesitatingly
unhitch: unhitched
universal: universal
unjust: unjust
unkempt: unkempt
unknown: unknown
unload: unloaded
unlucky: unlucky
unmistakable: unmistakable
unmolested: unmolested
unnumbered: unnumbered
unpacked: unpacked
unpleasantly: unpleasantly
unpursued: unpursued
unresisting: unresisting
unrest: unrest
unrested: unrested
unruly: unruly
unseen: unseen
unsuspected: unsuspected
unswerving: unswerving
untold: untold
untouched: untouched
untreated: untreated
unusually: unusually
unutterable: unutterable
unuttered: unuttered
unwashed: unwashed
unwieldy: unwieldy
unwilling: unwilling
unwillingly: unwillingly
unwittingly: unwittingly
unwonted: unwonted
uppermost: uppermost
upright: upright
uproar: uproar
uproariously: uproariously
upstanding: upstanding
upward: upward
urgent: urgent
usual: usual
usurp: usurp
utensil: utensils
utter: uttered,uttering
utterly: utterly
vague: vague
vaguely: vaguely
vain: vain
vainly: vainly
vair: vair
valley: valley,valleys
valor: valor
vanish: vanish
vary: varying
vast: vast
vastness: vastness
vaunt: vaunt
veer: veered
vegetable: vegetable
vein: veins
venom: venom
venture: ventured
veranda: veranda
vexation: vexation
vibrant: vibrant
vicarious: vicarious
vicious: vicious
victim: victim
view: view,views
vigil: vigil,vigils
vigilant: vigilant
vigor: vigor
vigorously: vigorously
vii: vii
vilely: vilely
village: village
vine: vine,vines
violently: violently
virgin: virgin
virility: virility
virtue: virtue
visible: visible
vision: vision,visions
visitor: visitor
vital: vital
vitality: vitality
voice: voice,voiced,voices
void: void
volcano: volcanoes
voracious: voracious
wag: wagged
wager: wager
wages: wages
wagon: wagon
wail: wailing
wait: waited,waiting
wake: wake,waking
waken: wakens
walk: walk,walked
wall: wall,walls
walled: walled
wan: wan
wander: wandered,wandering
wantonness: wantonness
war: war
warily: warily
warm: warm,warmed,warmer
warmly: warmly
warning: warning
wary: wary
wash: wash,washed,washes
washing: washing
waste: waste,wasted
watch: watch,watched,watching
watchful: watchful
water: water,watering,waters
watercourse: watercourses
watershed: watershed
watery: watery
wave: wave,waves,waving
wax: waxed
wayfarer: wayfarers
weak: weak,weaker
weakly: weakly
weakness: weakness
wear: wearing,wore,worn
weary: weary,wearying
weather: weather
weazen: weazened
weazened: weazened
wedge: wedges
week: week,weeks
weep: weeping,wept
weigh: weighed
weight: weight
weird: weird
welfare: welfare
western: western
wet: wet
whale: whale
whaling: whaling
wheedlingly: wheedlingly
wheel: wheel
wheeler: wheeler
whereat: whereat
wherefore: wherefore
whiff: whiff
whimper: whimpered,whimpering
whine: whine,whined,whining
whip: whip,whipped,whips
whipping: whipping
whipsaw: whipsawed
whirl: whirl,whirled
whirlwind: whirlwind
whisper: whisper,whispered
whistle: whistling
white: white
whiteness: whiteness
whittle: whittled,whittling
whoa: whoa
whoop: whoop
whoso: whoso
wide: wide
wield: wielded
wife: wife,wives
wild: wild
wilder: wilder
wilderness: wilderness
wildfowl: wildfowl
wildly: wildly
wildness: wildness
wiliness: wiliness
willow: willow,willows
win: win
wind: wind,winds,wound
winded: winded
window: windows
wink: winking
winter: winter,winters
wintry: wintry
wipe: wiped,wiping
wisdom: wisdom
wise: wise
wistfully: wistfully
withhold: withheld
withstand: withstanding
witness: witness,witnessed
woe: woe
wolf: wolf,wolves
wolfish: wolfish
wolflike: wolflike
woman: woman,women
womanhood: womanhood
womb: womb
wonderful: wonderful
wonted: wonted
wood: wood,woods
wooded: wooded
woodpecker: woodpeckers
woody: woody
word: word
worker: worker
worm: wormed
worn: worn
worried: worried
worry: worry,worrying
worshipful: worshipful
worth: worth
worthily: worthily
worthless: worthless
wot: wot
wound: wound,wounded,wounds
wounded: wounded
wraith: wraith
wrangle: wrangled
wrap: wrap,wrapped
wrapping: wrappings
wrath: wrath
wreckage: wreckage
wrench: wrenched,wrenching
wrestle: wrestled,wrestling
wretched: wretched
wriggle: wriggled
wrinkle: wrinkled
write: written,wrote
writhe: writhed,writhing
wrong: wrong
yard: yard,yards
yawn: yawn,yawned
yawning: yawning
yearning: yearning,yearnings
yellow: yellow
yelp: yelp,yelped,yelping,yelps
yep: yep
youngster: youngster
youth: youth
yukon: yukon
zeal: zeal
