aaron: aaron
abate: abated
abdiel: abdiel
abel: abel
abhor: abhor,abhorred
abib: abib
abide: abide,abiding
abiezer: abiezer
abigail: abigail
ability: ability
abner: abner
abode: abode
abominable: abominable
abominably: abominably
abomination: abomination,abominations
abraham: abraham
abram: abram
absalom: absalom
absent: absent
abundance: abundance
abundant: abundant
abundantly: abundantly
abuse: abuse,abused
accept: accept,accepted
acceptable: acceptable
accompany: accompanying
accomplish: accomplish,accomplished
accord: accord
account: account,accounted
accurse: accursed
accursed: accursed
accusation: accusation
achar: achar
achmetha: achmetha
achor: achor
acknowledge: acknowledge,acknowledged
acquaintance: acquaintance
acre: acre
action: actions
activity: activity
acts: acts
adam: adam
adar: adar
add: add
adder: adder
addition: addition,additions
adiel: adiel
adin: adin
adjure: adjure,adjured
adlai: adlai
adoniram: adoniram
adrammelech: adrammelech
adullam: adullam
adullamite: adullamite
adulterer: adulterer
adulteress: adulteress
adultery: adultery
advance: advanced
adventure: adventure,adventured
adversary: adversaries,adversary
adversity: adversities,adversity
advertise: advertise
advice: advice
advise: advise
advisement: advisement
afar: afar
affair: affairs
affection: affection
affinity: affinity
afflict: afflict,afflicted
affliction: affliction
affright: affright,affrighted
afore: afore
aforetime: aforetime
afraid: afraid
afternoon: afternoon
afterward: afterward
agag: agag
agate: agate
age: age
aged: aged
agee: agee
agone: agone
agreement: agreement
ague: ague
ahab: ahab
ahi: ahi
aid: aided
ain: ain
air: air
akan: akan
alamoth: alamoth
alarm: alarm
alas: alas
algum: algum
alien: alien
alike: alike
alive: alive
allowance: allowance
ally: allied
almighty: almighty
almon: almon
almond: almonds
almug: almug
aloe: aloes
aloud: aloud
altar: altar,altars
alter: alter
altogether: altogether
alvah: alvah
alvan: alvan
alway: alway
amal: amal
amalekite: amalekite
amazed: amazed
ambassador: ambassadors
ambush: ambush
ambushment: ambushment
amen: amen
amend: amend,amends
amerce: amerce
amethyst: amethyst
ami: ami
amiss: amiss
ammonite: ammonite
ammonites: ammonites
ammonitess: ammonitess
amok: amok
amorite: amorite
amos: amos
anan: anan
ancestor: ancestors
ancient: ancient,ancients
angel: angel,angels
anger: anger
angry: angry
anguish: anguish
anim: anim
anoint: anoint,anointed,anointing
anointing: anointing
answer: answer,answered
answerable: answerable
apace: apace
ape: apes
apiece: apiece
apostle: apostle
apostles: apostles
apothecary: apothecaries,apothecary
apparel: apparel,apparelled
appearance: appearance
appease: appease
appertain: appertain,appertained
apple: apple
appoint: appoint,appointed
appointment: appointment
approach: approach,approached
apron: aprons
apt: apt
ara: ara
arab: arab
arabia: arabia
arabian: arabian,arabians
arad: arad
aramitess: aramitess
arba: arba
archer: archer,archers
ariel: ariel
ark: ark
arkite: arkite
arm: arm,armed,arms
armed: armed
armenia: armenia
armour: armour
armourbearer: armourbearer
armoury: armoury
army: armies,army
array: array,arrayed
arrogancy: arrogancy
arrow: arrow,arrows
art: art
artificer: artificer,artificers
artillery: artillery
asa: asa
asahel: asahel
asaph: asaph
ascend: ascend,ascended,ascending
ascent: ascent
ascribe: ascribe,ascribed
ash: ashes
ashamed: ashamed
asher: asher
asherites: asherites
ashtoreth: ashtoreth
ashur: ashur
asleep: asleep
asp: asps
ass: ass,asses
assay: assayed
assemble: assemble,assembled,assembling
assembly: assembly
assent: assent
assign: assigned
assurance: assurance
assure: assured
assuredly: assuredly
asswage: asswaged
assyria: assyria
assyrians: assyrians
astonish: astonished
astonished: astonished
astonishment: astonishment
astony: astonied
astray: astray
asunder: asunder
athirst: athirst
atonement: atonement,atonements
attain: attained
attendance: attendance
attent: attent
attentive: attentive
attire: attired
audience: audience
augment: augment
aul: aul
aunt: aunt
ava: ava
avenge: avenge,avenged,avenging
avenger: avenger
avenging: avenging
avoid: avoided
avouch: avouched
awake: awake,awaked,awoke
axe: axe
axis: axes
axletree: axletrees
baal: baal
baalath: baalath
baalim: baalim
babe: babe
babel: babel
babylon: babylon
babylonians: babylonians
babylonish: babylonish
backbone: backbone
backside: backside
bad: bad,worse
bade: bade
badger: badgers
badness: badness
bag: bag,bags
bake: bake,baked
bakemeat: bakemeats
baken: baken
baker: baker,bakers
balaam: balaam
balak: balak
balance: balances
bald: bald
baldness: baldness
balm: balm
bamoth: bamoth
band: band,bands
bani: bani
banish: banished
banishment: banishment
bank: bank,banks
bar: bar,bars
bare: bare,barest
barefoot: barefoot
barley: barley
barrel: barrel,barrels
barren: barren
baruch: baruch
base: base
basis: bases
basket: basket,baskets
bason: bason
bastard: bastard
bat: bat
bath: baths
bathe: bathe
batter: battered
battle: battle,battles
battlement: battlement
bay: bay
bdellium: bdellium
beam: beam,beams
bean: beans
bear: bear,bearing,bears,bore,born,borne
beard: beard,beards
bearer: bearers
bearing: bearing
beast: beast,beasts
beat: beat,beaten,beating
beautiful: beautiful
beautify: beautify
beauty: beauty
becher: becher
bed: bed,beds
bedad: bedad
bedchamber: bedchamber
bedstead: bedstead
bee: bees
beef: beeves
beer: beer
beerothite: beerothite
beetle: beetle
befall: befall,befallen,befell
beforetime: beforetime
beget: begat,beget,begotten
beggar: beggar
begotten: begotten
beguile: beguiled
behalf: behalf
behave: behave,behaved
behaviour: behaviour
behead: beheaded
beheld: beheld
behold: beheld,behold
bekah: bekah
bela: bela
belah: belah
belaites: belaites
belial: belial
bell: bell,bells
belly: belly
belong: belong,belonged,belonging
beloved: beloved
ben: ben
beneath: beneath
benefit: benefit
benjamin: benjamin
benjamite: benjamite
beno: beno
bereave: bereaved
beri: beri
berith: berith
beryl: beryl
beseech: beseech,besought
beset: beset
besiege: besiege,besieged
bestir: bestir
bestow: bestow,bestowed
bethel: bethel
bethink: bethink
bethlehem: bethlehem
bethlehemite: bethlehemite
bethuel: bethuel
betime: betimes
betray: betray
betroth: betroth,betrothed
betwixt: betwixt
bewail: bewail,bewailed
beware: beware
bezaleel: bezaleel
bible: bible
bid: bade,bid,bidden
bidding: bidding
bier: bier
bind: bind,binding,bound
binding: binding
bird: bird,birds
birth: birth
birthday: birthday
birthright: birthright
bite: bit,bitten
bitter: bitter
bitterly: bitterly
bitterness: bitterness
black: black
blade: blade
blain: blains
blame: blame
blameless: blameless
blaspheme: blaspheme,blasphemed
blasphemy: blasphemy
blast: blast,blasted,blasting
blasting: blasting
bleat: bleating
blemish: blemish,blemishes
bless: bless,blessed
blessed: blessed
blessing: blessing,blessings
blind: blind
blindness: blindness
blood: blood
bloody: bloody
bloom: bloomed
blossom: blossom,blossoms
blot: blot,blotted
blow: blew,blow,blowing
blue: blue
blush: blush
board: board,boards
boast: boast
boat: boat
body: bodies,body
boil: boil,boiled,boils
boldly: boldly
boll: bolled
bolster: bolster
bolt: bolt,bolted
bond: bond,bonds
bondage: bondage
bondmaid: bondmaid,bondmaids
bondman: bondman,bondmen
bondmen: bondmen
bondservant: bondservant
bondwoman: bondwoman,bondwomen
bone: bone,bones
bonnet: bonnets
book: book
booth: booths
booty: booty
border: border,borders
bore: bored
borrow: borrow,borrowed
bosom: bosom
botch: botch
bottle: bottle,bottles
bough: bough,boughs
bound: bounds
bounty: bounty
bow: bow,bowed,bowing,bows
bowels: bowels
bowl: bowl,bowls
box: box
boy: boys
bracelet: bracelet,bracelets
brake: brake
bramble: bramble
branch: branch,branches
brand: brands
brasen: brasen
brass: brass
breach: breach,breaches
bread: bread
breadth: breadth
break: break,breaking,broken
breaking: breaking
breast: breast,breasts
breastplate: breastplate
breath: breath
breathe: breathe,breathed
breeches: breeches
breed: bred,breed
brethren: brethren
bribe: bribe,bribes
brick: brick,bricks
bridle: bridle
brier: briers
bright: bright
brightness: brightness
brim: brim
brimstone: brimstone
bring: bring,bringing,brought
bringer: bringers
bringeth: bringeth
brink: brink
broad: broad
broider: broidered
brook: brook,brooks
broth: broth
brother: brother,brothers
brown: brown
bruise: bruise,bruised
bucket: buckets
buckler: buckler,bucklers
bud: budded,buds
build: build,builded,building,built
builded: builded
builder: builders
building: building
bul: bul
bull: bulls
bullock: bullock,bullocks
bulrush: bulrushes
bulwark: bulwarks
bunch: bunch,bunches
bundle: bundle,bundles
burden: burden,burdens
burial: burial
burn: burn,burned,burning,burnt
burning: burning
bury: buried,bury,burying
bush: bush
business: business
busy: busied,busy
butler: butler,butlers
butlership: butlership
butter: butter
buttock: buttocks
buz: buz
byway: byways
byword: byword
cab: cab
cain: cain
cake: cake,cakes
calamity: calamity
calamus: calamus
caldron: caldron,caldrons
caleb: caleb
calf: calf,calves
calling: calling
camel: camel,camels
camp: camp,camped,camps
canaan: canaan
canaanite: canaanite
canaanites: canaanites
canaanitess: canaanitess
canaanitish: canaanitish
candlestick: candlestick,candlesticks
canst: canst
caphtor: caphtor
caphtorim: caphtorim
captain: captain,captains
captive: captive,captives
captivity: captivity
carbuncle: carbuncle
carcase: carcase,carcases
care: care,caring
careful: careful
carefully: carefully
careless: careless
carmel: carmel
carmelite: carmelite
carmelitess: carmelitess
carnally: carnally
carpenter: carpenters
carriage: carriage
carry: carried,carry,carrying
cart: cart
carve: carved
carving: carving,carvings
cassia: cassia
cast: cast,casting
casting: casting
castle: castle,castles
catch: catch,caught
cattle: cattle
caul: caul
causeless: causeless
causeway: causeway
cave: cave,caves
cease: cease,ceased,ceasing
cedar: cedar,cedars
ceiling: ceiling
celebrate: celebrate
cellar: cellars
censer: censer,censers
ceremony: ceremonies
certainty: certainty
certify: certified,certify
chafe: chafed
chain: chain,chains
chaldean: chaldean
chamber: chamber,chambers
chamberlain: chamberlain
chameleon: chameleon
chamoix: chamois
champaign: champaign
champion: champion
chance: chance
chancellor: chancellor
change: change,changed,changing
channel: channels
chapiter: chapiter,chapiters
chapman: chapmen
charge: charge,charged,charges
chargeable: chargeable
charger: charger,chargers
chariot: chariot,chariots
charmer: charmer
chase: chase,chased,chasing
chasten: chasten,chastened
chastise: chastise,chastised
chastisement: chastisement
checker: checker
cheek: cheek,cheeks
cheer: cheer
cheese: cheese,cheeses
cherish: cherish,cherished
cherub: cherub
chesil: chesil
chest: chest
chestnut: chestnut
chew: chew,chewed
chide: chide
chiding: chiding
chief: chief,chiefest
child: child,children
childhood: childhood
childless: childless
chilion: chilion
choice: choice
choose: choose,chose,chosen
chronicle: chronicles
chun: chun
churlish: churlish
cinnamon: cinnamon
circuit: circuit
circumcise: circumcise,circumcised,circumcising
circumcision: circumcision
circumspect: circumspect
cistern: cistern
city: cities,city
clap: clapped
clave: clave
claw: claws
clay: clay
clean: clean
cleanness: cleanness
cleanse: cleanse,cleansed
cleansing: cleansing
clearness: clearness
cleave: clave,cleave,cleaved
cleft: cleft
cliff: cliff
clift: clift
climb: climbed
close: close,closed
cloth: cloth,cloths
clothe: clad,clothe,clothed
clothes: clothes
cloud: cloud,clouds
cloudy: cloudy
clout: clouted
cloven: cloven
cluster: cluster,clusters
coal: coal,coals
coast: coast,coasts
coat: coat,coats
coffer: coffer
coffin: coffin
cold: cold
collar: collars
collection: collection
college: college
colossians: colossians
colour: colour,colours
colt: colt,colts
comely: comely
cometh: cometh
comfort: comfort,comforted
comfortable: comfortable
comfortably: comfortably
comforter: comforters
command: command,commanded,commanding
commandment: commandment,commandments
commend: commended
commission: commissions
commit: commit,committed
committed: committed
common: common
commonly: commonly
commune: commune,communed,communing
communication: communication
companion: companion,companions
company: companies,company
comparison: comparison
compass: compass,compassed,compassing
compassion: compassion
compel: compel,compelled
compelled: compelled
complain: complain,complained
complaint: complaint
complete: complete
composition: composition
compound: compound
conceal: conceal
conceive: conceive,conceived
conception: conception
concubine: concubine,concubines
condemn: condemn,condemned,condemning
condition: condition
conduct: conduct,conducted
conduit: conduit
coney: coney
confection: confection
confectionary: confectionaries
confederate: confederate
confer: conferred
confess: confess,confessed
confession: confession
confidence: confidence
confirm: confirm,confirmed
confiscation: confiscation
confound: confound,confounded
confusion: confusion
congeal: congealed
congratulate: congratulate
congregation: congregation
consecrate: consecrate,consecrated
consecrated: consecrated
consecration: consecration,consecrations
consent: consent,consented
conspiracy: conspiracy
conspirator: conspirators
conspire: conspired
constant: constant
constrain: constrained
consult: consulted
consulter: consulter
consume: consume,consumed,consuming
consumption: consumption
contend: contend,contended
content: content
continual: continual
continually: continually
continuance: continuance
continue: continue,continued
contrary: contrary
controversy: controversies,controversy
conversant: conversant
convey: convey
convocation: convocation,convocations
cook: cook,cooks
cool: cool
cope: coping
copper: copper
copulation: copulation
cord: cord,cords
coriander: coriander
corinthian: corinthians
cormorant: cormorant
corn: corn
corner: corner,corners
cornet: cornet,cornets
corpse: corpses
corrupt: corrupt,corrupted
corruption: corruption
corruptly: corruptly
cost: cost
costly: costly
cote: cotes
couch: couch,couched,couching
coulter: coulter,coulters
counsel: counsel,counselled
counsellor: counsellor,counsellors
count: count,counted
countenance: countenance
country: countries,country
couple: couple,coupled
coupling: coupling,couplings
courage: courage
courageous: courageous
courageously: courageously
court: court,courts
covenant: covenant,covenanted
cover: cover,covered,covering,covers
covering: covering
covert: covert
covet: covet,coveted
covetousness: covetousness
cow: cow
coz: coz
cracknel: cracknels
craftsman: craftsman,craftsmen
create: created
creature: creature
creditor: creditor
creep: creep,creeping
crimson: crimson
crooked: crooked
crop: crop
crouch: crouch
crown: crown
cruel: cruel
cruelty: cruelty
cruse: cruse
crush: crushed
crying: crying
cubit: cubit,cubits
cucumber: cucumbers
cud: cud
cumbrance: cumbrance
cunning: cunning
cup: cup,cups
cupbearer: cupbearer,cupbearers
curious: curious
current: current
curse: curse,cursed,curses,cursing
cursed: cursed
cursing: cursing
curtain: curtain,curtains
cush: cush
custody: custody
custom: custom,customs
cut: cut
cutting: cutting,cuttings
cymbal: cymbals
cyrus: cyrus
dagger: dagger
dagon: dagon
daily: daily
dainty: dainties
dale: dale
dam: dam
damage: damage
damascus: damascus
damsel: damsel,damsels
dan: dan
dance: dance,danced,dances,dancing
dancing: dancing
daniel: daniel
darius: darius
dark: dark
darken: darkened
darkish: darkish
darkness: darkness
darts: darts
dash: dash,dashed
daub: daubed
daughter: daughter,daughters
david: david
dawn: dawning
day: day,days
dead: dead
deadly: deadly
deaf: deaf
deal: deal,deals,dealt
dealings: dealings
dearth: dearth
death: death
deborah: deborah
debt: debt
decay: decay,decayed
deceitfully: deceitfully
deceive: deceive,deceived
deceiver: deceiver
decide: decided
declare: declare,declared
decline: decline,declined
decrease: decreased
decree: decree
dedan: dedan
dedicate: dedicate,dedicated,dedicating
dedicated: dedicated
dedication: dedication
deed: deed,deeds
deep: deep,deeper,deeps
deer: deer
defeat: defeat
defence: defence
defend: defend,defended
defer: deferred
defile: defile,defiled
defraud: defraud,defrauded
defy: defied,defy
degree: degree,degrees
delay: delay,delayed
delicate: delicate
delicately: delicately
delicateness: delicateness
delight: delight,delighted,delights
delighted: delighted
delilah: delilah
deliver: deliver,delivered
deliverance: deliverance
deliverer: deliverer
demand: demanded
den: dens
denounce: denounce
deny: denied,deny
depart: depart,departed,departing
deprive: deprived
depths: depths
depute: deputed
deputy: deputy
descend: descend,descended,descending
description: description
descry: descry
desert: desert
deserve: deserve
deserving: deserving
desire: desire,desired
desolate: desolate
desolation: desolation,desolations
despair: despair
despise: despise,despised
destitute: destitute
destroy: destroy,destroyed,destroying
destroyer: destroyer
destruction: destruction
detain: detain,detained
determine: determine,determined
detest: detest
deuteronomy: deuteronomy
device: device
devil: devils
devise: devise,devised
devote: devote,devoted
devoted: devoted
devour: devour,devoured,devouring
dew: dew
dial: dial
diamond: diamond
didst: didst
die: die,died,dying
difference: difference
dig: dig,digged
dignity: dignity
diligent: diligent
diligently: diligently
dim: dim
diminish: diminish,diminished
dinah: dinah
dine: dine
dip: dip,dipped
direct: direct
direction: direction
dirt: dirt
disallow: disallow,disallowed
discern: discern,discerned
discharge: discharged
discomfited: discomfited
discomfiture: discomfiture
discontented: discontented
discourage: discourage,discouraged
discover: discover,discovered
discreet: discreet
disdain: disdained
disease: disease,diseases
diseased: diseased
disguise: disguise,disguised
dish: dish,dishes
dishonour: dishonour
disinherit: disinherit
dismay: dismayed
dismayed: dismayed
dismiss: dismissed
disobedient: disobedient
disobey: disobeyed
disperse: disperse,dispersed
displease: displease,displeased
displeased: displeased
displeasure: displeasure
dispossess: dispossess,dispossessed
dispossessed: dispossessed
disquiet: disquieted
dissemble: dissembled
distant: distant
distil: distil
distinctly: distinctly
distress: distress,distressed
distressed: distressed
distribute: distribute,distributed
ditch: ditches
diver: divers
diverse: diverse
divide: divide,divided,dividing
divination: divination
divine: divine
diviner: diviners
division: division,divisions
divorce: divorced
divorced: divorced
divorcement: divorcement
doctrine: doctrine
dodo: dodo
doeg: doeg
doer: doer,doers
doest: doest
doeth: doeth
dog: dog,dogs
doings: doings
dominion: dominion
door: door,doors
dor: dor
dost: dost
doth: doth
double: double,doubled
doubt: doubt
doubtless: doubtless
dough: dough
dove: dove
downward: downward
dowry: dowry
dragon: dragon,dragons
dram: drams
draught: draught
drave: drave
draw: draw,drawing,drawn,drew
drawer: drawer,drawers
dread: dread
dreadful: dreadful
dream: dream,dreamed,dreams
dreamer: dreamer
dress: dress,dressed
dressed: dressed
dresser: dressers
drink: drank,drink,drinking
drinking: drinking
drive: drive,driven,driving,drove
driver: driver
driving: driving
dromedary: dromedaries
drop: drop,dropped
drought: drought
drove: droves
drown: drowned
drunk: drunk
drunkard: drunkard
drunken: drunken
drunkenness: drunkenness
dry: dried,dry
duke: duke,dukes
dumb: dumb
dung: dung
dungeon: dungeon
dunghill: dunghill
dust: dust
duty: duty
dwarf: dwarf
dwell: dwell,dwelled,dwelling,dwelt
dwelling: dwelling,dwellings
dwelt: dwelt
dye: dyed
eagle: eagle,eagles
ear: ear,ears
eared: eared
earing: earing
earnestly: earnestly
earring: earring,earrings
earth: earth
earthen: earthen
earthquake: earthquake
ease: ease
east: east
eastward: eastward
easy: easier
eat: eat,eaten,eating
eater: eater
eating: eating
ebenezer: ebenezer
ecclesiastes: ecclesiastes
eden: eden
edge: edge,edges
edomite: edomite
egg: eggs
egypt: egypt
egyptian: egyptian,egyptians
eighteen: eighteen
eighteenth: eighteenth
eighth: eighth
eightieth: eightieth
eker: eker
ekron: ekron
eld: eldest
elder: elder,elders
eleazar: eleazar
eleventh: eleventh
eli: eli
elihu: elihu
elijah: elijah
eliphalet: eliphalet
elisha: elisha
elishah: elishah
elkanah: elkanah
ellasar: ellasar
elon: elon
eloquent: eloquent
elul: elul
embalm: embalm,embalmed
embrace: embrace,embraced
embroider: embroider
embroiderer: embroiderer
emerald: emerald
emerod: emerods
employ: employ,employed
enam: enam
encamp: encamp,encamped,encamping
enchanter: enchanter
enchantment: enchantment,enchantments
encourage: encourage,encouraged
endamage: endamage
endow: endow
endue: endued
endure: endure
enemy: enemies,enemy
engine: engines
engrave: engrave
engraver: engraver
engraving: engravings
enjoy: enjoy,enjoyed
enlarge: enlarge,enlarged
enlighten: enlightened
enmity: enmity
enoch: enoch
enos: enos
enquire: enquire,enquired
enrich: enrich
ensign: ensign
entangle: entangled
enter: enter,entered,entering
entering: entering
entice: entice
entrance: entrance
entreat: entreated
entry: entry
environ: environ
envy: envied
ephah: ephah
ephesians: ephesians
ephod: ephod
ephraim: ephraim
ephraimite: ephraimite
ephrathite: ephrathite
epistle: epistle
equally: equally
ere: ere
erect: erected
err: err,erred
errand: errand
error: error
esau: esau
escape: escape,escaped,escaping
espouse: espoused
espy: espied,espy
establish: establish,established
establishment: establishment
estate: estate
esteem: esteemed
esther: esther
estimate: estimate
estimation: estimation,estimations
eternal: eternal
ethan: ethan
ethanim: ethanim
ether: ether
ethiopia: ethiopia
ethiopian: ethiopian,ethiopians
eunuch: eunuchs
euphrates: euphrates
eve: eve
evening: evening
eventide: eventide
everlasting: everlasting
evil: evil,evils
ewe: ewe,ewes
exact: exact,exacted
exaction: exaction
exalt: exalt,exalted
examine: examine
exceed: exceed,exceeded,exceeding
exceedingly: exceedingly
excel: excel,excelled
excellency: excellency
exchange: exchange
execute: execute,executed,executing
exempt: exempted
exile: exile
exodus: exodus
expel: expel,expelled
expense: expenses
experience: experience
expert: expert
expire: expired
expound: expound,expounded
express: expressed
expressly: expressly
extend: extended
extreme: extreme
eye: eye,eyes
eyebrow: eyebrows
eyed: eyed
ezekiel: ezekiel
ezra: ezra
fade: fade
fail: fail,failed,failing
faint: faint,fainted
fainthearted: fainthearted
faintness: faintness
fair: fair,fairer
faith: faith
faithful: faithful
faithfully: faithfully
faithfulness: faithfulness
fall: fall,fallen,falling,fell
fallow: fallow
false: false
falsehood: falsehood
falsely: falsely
fame: fame
familiar: familiar
family: families,family
famine: famine
famished: famished
famous: famous
fare: fare
fashion: fashion,fashioned
fast: fast,fasted
fasten: fasten,fastened
fasting: fasting
fat: fat,fatted
father: father,fathers
fatherless: fatherless
fatling: fatlings
fatness: fatness
fault: fault,faults
faulty: faulty
favour: favour,favoured
favourable: favourable
favoured: favoured
fear: fear,feared,fearing
fearful: fearful
feast: feast,feasts
feather: feathers
feeble: feeble,feebler
feed: fed,feed,feeding
feel: feel
feign: feign,feigned
fell: felled,felling
fellest: fellest
felloe: felloes
fellow: fellow,fellows
fellowship: fellowship
female: female
fence: fenced
ferret: ferret
ferry: ferry
fetch: fetch,fetched
fetter: fetters
fever: fever
fewness: fewness
field: field,fields
fierce: fierce,fiercer
fierceness: fierceness
fiery: fiery
fifteenth: fifteenth
fiftieth: fiftieth
fig: fig,figs
fight: fight,fighting,fought
figure: figure,figures
file: file
fillet: filleted,fillets
filthiness: filthiness
fin: fins
fine: fine
finger: finger,fingers
finish: finish,finished
fir: fir
firebrand: firebrand,firebrands
firepan: firepans
firm: firm
firmament: firmament
firstborn: firstborn
firstling: firstling,firstlings
fish: fish,fishes
fist: fist
fit: fit,fitted
flag: flags
flagon: flagon
flame: flame
flaming: flaming
flank: flanks
flat: flat
flax: flax
flay: flay,flayed
flea: flea
flee: fled,flee,fleeing
fleece: fleece
flesh: flesh
fleshhook: fleshhook
flight: flight
flint: flint
flinty: flinty
float: floats
flock: flock,flocks
flood: flood,floods
floor: floor,floors
flour: flour
flow: flowed,flowing
flower: flower,flowers
fly: flew,flies,fly,flying
foal: foal,foals
foe: foes
fold: folds
folding: folding
folk: folk
follow: follow
followeth: followeth
folly: folly
food: food
fool: fool,fools
foolish: foolish
foolishly: foolishly
foolishness: foolishness
foot: feet,foot
footman: footmen
footstool: footstool
forasmuch: forasmuch
forbare: forbare
forbear: forbear
forbid: forbad,forbid,forbidden
forbidden: forbidden
force: force,forced,forces,forcing
ford: ford,fords
forefront: forefront
forehead: forehead
foreigner: foreigner
foremost: foremost
forepart: forepart
foreskin: foreskin,foreskins
forest: forest,forests
forfeit: forfeited
forgat: forgat
forget: forget,forgot,forgotten
forgive: forgive,forgiven,forgiving
fork: forks
form: form,formed
fornication: fornication
forsake: forsake,forsaken,forsook
fort: fort,forts
forthwith: forthwith
fortieth: fortieth
fortify: fortified,fortify
fortress: fortress
foundation: foundation,foundations
founder: founder
fountain: fountain,fountains
fourfold: fourfold
fourscore: fourscore
foursquare: foursquare
fourteen: fourteen
fourteenth: fourteenth
fourth: fourth
fowl: fowl,fowls
fox: fox,foxes
frame: frame
frankincense: frankincense
fray: fray
freckled: freckled
freedom: freedom
freely: freely
freewill: freewill
fresh: fresh
fret: fret,fretting
friend: friend,friends
friendly: friendly
fringe: fringe,fringes
fro: fro
frog: frogs
frontlet: frontlets
frost: frost
froward: froward
fruit: fruit,fruits
fruitful: fruitful
frustrate: frustrate
fry: fried
fugitive: fugitive,fugitives
fulfil: fulfil,fulfilled
fulness: fulness
furiously: furiously
furnace: furnace,furnaces
furnish: furnish,furnished
furniture: furniture
fury: fury
gabbai: gabbai
gad: gad
gaddi: gaddi
gadi: gadi
gadite: gadite
gain: gain
galatians: galatians
galbanum: galbanum
galilee: galilee
gall: gall
gamaliel: gamaliel
garden: garden,gardens
garment: garment,garments
garnish: garnished
garrison: garrison,garrisons
gat: gat
gate: gate,gates
gather: gather,gathered,gathering
gathering: gathering
gaze: gaze
gazer: gazer
gederathite: gederathite
gederite: gederite
gender: gender
genealogy: genealogies,genealogy
generation: generation,generations
genesis: genesis
gentiles: gentiles
gentleness: gentleness
gently: gently
gerah: gerahs
gershom: gershom
gershon: gershon
gershonite: gershonite
geshurites: geshurites
gether: gether
ghost: ghost
giant: giant,giants
gibbar: gibbar
gibeonite: gibeonite
gideon: gideon
gift: gift,gifts
gileadite: gileadite
gird: gird,girded
girdle: girdle,girdles
girgashite: girgashite
girgasite: girgasite
girt: girt
gittite: gittite
giveth: giveth
glad: glad
gladness: gladness
glean: glean,gleaned
gleaning: gleaning
gleanings: gleanings
glede: glede
glister: glistering
glitter: glittering
glorify: glorified
glorious: glorious
gloriously: gloriously
glory: glory
glutton: glutton
goad: goad,goads
goat: goat,goats
gob: gob
god: god,gods
goddess: goddess
gods: gods
gog: gog
gold: gold
golden: golden
goldsmith: goldsmith,goldsmiths
goliath: goliath
gomer: gomer
gomorrah: gomorrah
goodliest: goodliest
goodly: goodlier,goodliest,goodly
goodness: goodness
gopher: gopher
gore: gore,gored
goshen: goshen
gospel: gospel
gourd: gourds
govern: govern
governor: governor,governors
grace: grace
gracious: gracious
graciously: graciously
grant: grant,granted
grape: grape,grapes
grass: grass
grasshopper: grasshopper,grasshoppers
grate: grate
grave: grave,graved,graves
graven: graven
graving: graving
gray: gray
greatly: greatly
greatness: greatness
greave: greaves
green: green
greenish: greenish
greet: greet
grief: grief
grieve: grieve,grieved
grievous: grievous
grind: grind,ground
groaning: groaning
grope: grope
ground: ground
grove: grove,groves
grow: grew,grow,grown
grudge: grudge
guard: guard
guest: guests
guide: guided,guiding
guile: guile
guilt: guilt
guiltiness: guiltiness
guiltless: guiltless
guilty: guilty
gur: gur
gush: gushed
gutter: gutter,gutters
habakkuk: habakkuk
habergeon: habergeon
habitation: habitation,habitations
hadst: hadst
haft: haft
hagar: hagar
haggai: haggai
hail: hail
hailstone: hailstones
hair: hair,hairs
hairy: hairy
hallow: hallow
hallowed: hallowed
halt: halt,halted
ham: ham
hamathite: hamathite
hammer: hammer
hamulites: hamulites
hand: hand,hands
handbreadth: handbreadth
handed: handed
handful: handful,handfuls
handle: handle
handmaid: handmaid,handmaids
handmaiden: handmaidens
hang: hang,hanged,hanging
hanging: hanging,hangings
hap: hap
haply: haply
happen: happen,happened
happy: happy
hard: hard
harden: harden,hardened
hare: hare
harim: harim
harlot: harlot,harlots
harm: harm
harness: harness,harnessed
harp: harp,harps
harrow: harrows
hart: hart,harts
harvest: harvest
hast: hast,hasted
haste: haste
hasted: hasted
hasten: hasten,hastened
hastily: hastily
hate: hate,hated,hating
hath: hath
hatred: hatred
haughty: haughty
haunt: haunt
hawk: hawk
hazel: hazel
head: head,heads
heal: heal,healed
health: health
heap: heap,heaps
hear: hear,heard,hearing
hearing: hearing
hearken: hearken,hearkened
heart: heart,hearts
hearted: hearted
hearth: hearth
heat: heat
heathen: heathen
heave: heave,heaved
heaven: heaven,heavens
heavens: heavens
heavily: heavily
heaviness: heaviness
heavy: heavy
hebrew: hebrew
hebrews: hebrews
hedge: hedges
heed: heed
heel: heel,heels
heifer: heifer
height: height
heir: heir
helmet: helmet,helmets
helper: helper,helpers
helve: helve
hem: hem,hems
heman: heman
henceforth: henceforth
henceforward: henceforward
herb: herb,herbs
herd: herd,herds
herdman: herdmen
herdmen: herdmen
heretofore: heretofore
heritage: heritage
heron: heron
heth: heth
hew: hew,hewed,hewn
hewer: hewer,hewers
hezekiah: hezekiah
hezron: hezron
hezronites: hezronites
hide: hidden,hide
highway: highway,highways
hill: hill,hills
hillel: hillel
hin: hin
hind: hind,hinds
hinder: hinder,hindered
hindermost: hindermost
hindmost: hindmost
hinge: hinges
hip: hip
hiram: hiram
hire: hire,hired
hiss: hiss
hissing: hissing
hit: hit
hitherto: hitherto
hittite: hittite
hivite: hivite
ho: ho
hoar: hoar
hoary: hoary
hod: hod
hold: held,hold,holds
holden: holden
hole: hole,holes
holiness: holiness
hollow: hollow
holy: holy
homam: homam
homeborn: homeborn
homer: homer,homers
honey: honey
honeycomb: honeycomb
honor: honor
honour: honour,honoured
honourable: honourable
hoof: hoof
hook: hook,hooks
hope: hope
hor: hor
horn: horn,horns
hornet: hornet,hornets
horonite: horonite
horror: horror
horse: horse,horses
horseback: horseback
horseman: horseman,horsemen
hosea: hosea
host: host,hosts
hostage: hostages
hot: hot,hottest
hotly: hotly
hough: hough
house: house,houses
household: household,households
howl: howling
howsoever: howsoever
huge: huge
huldah: huldah
humble: humble,humbled
humbly: humbly
hundredfold: hundredfold
hundredth: hundredth
hunger: hunger
hungry: hungry
hunt: hunt
hunter: hunter
hunting: hunting
huppah: huppah
hurl: hurl,hurling
hurt: hurt,hurting
hurtful: hurtful
husband: husband,husbands
husbandman: husbandman,husbandmen
husbandry: husbandry
husk: husk
hyssop: hyssop
idle: idle
idol: idol,idols
idolatrous: idolatrous
idolatry: idolatry
ignorance: ignorance
ignorantly: ignorantly
image: image,images
imagination: imagination,imaginations
imagine: imagined
impose: impose
impoverished: impoverished
imprisonment: imprisonment
impute: impute
imputed: imputed
incense: incense
incline: incline,inclined
inclose: inclosed
increase: increase,increased
incurable: incurable
indignation: indignation
industrious: industrious
infant: infant
infirmity: infirmity
inflammation: inflammation
inform: inform
ingather: ingathering
inhabit: inhabit,inhabited
inhabitant: inhabitants
inherit: inherit,inherited
inheritance: inheritance,inheritances
iniquity: iniquities,iniquity
inn: inn
innocency: innocency
innocent: innocent
inquisition: inquisition
instruct: instruct,instructed
instructer: instructer
instrument: instrument,instruments
insurrection: insurrection
integrity: integrity
intend: intend
intent: intent
interpret: interpret,interpreted
interpretation: interpretation,interpretations
interpreter: interpreter
intreat: intreat,intreated
invade: invade,invaded
invasion: invasion
invent: invented
invite: invited
inwards: inwards
ira: ira
iron: iron
isaac: isaac
isaiah: isaiah
ishmael: ishmael
ishmaelite: ishmaelite
isle: isles
israel: israel
israelite: israelite
israelites: israelites
israelitish: israelitish
issachar: issachar
issue: issue,issued
itch: itch
ithiel: ithiel
ivory: ivory
jacob: jacob
james: james
japheth: japheth
jared: jared
jasper: jasper
javan: javan
javelin: javelin
jaw: jaw
jawbone: jawbone
jealous: jealous
jealousy: jealousies,jealousy
jebus: jebus
jebusi: jebusi
jebusite: jebusite
jehoshaphat: jehoshaphat
jehovah: jehovah
jehu: jehu
jeopard: jeoparded
jeopardy: jeopardy
jerahmeel: jerahmeel
jerahmeelites: jerahmeelites
jeremiah: jeremiah
jericho: jericho
jeroboam: jeroboam
jerusalem: jerusalem
jesse: jesse
jethro: jethro
jewel: jewels
jews: jews
jezebel: jezebel
jeziah: jeziah
jezreelite: jezreelite
job: job
joel: joel
john: john
joined: joined
joining: joinings
joint: joint,joints
jonah: jonah
jonathan: jonathan
joram: joram
jordan: jordan
joseph: joseph
joshua: joshua
josiah: josiah
journey: journey,journeyed,journeying,journeys
journeying: journeyings
joy: joy
joyful: joyful
joyfulness: joyfulness
jubile: jubile
judah: judah
jude: jude
judge: judge,judged,judges,judging
judges: judges
judgment: judgment,judgments
judith: judith
juniper: juniper
justice: justice
justify: justify,justifying
kedar: kedar
keeper: keeper,keepers
kernel: kernels
keros: keros
kettle: kettle
key: key
kick: kick,kicked
kid: kid,kids
kidney: kidneys
kill: kill,killed
killing: killing
kiln: kiln
kin: kin
kinah: kinah
kindle: kindle,kindled
kindly: kindly
kindness: kindness
kindred: kindred,kindreds
kine: kine
king: king,kings
kingdom: kingdom,kingdoms
kinsman: kinsman,kinsmen
kinswoman: kinswoman
kinswomen: kinswomen
kish: kish
kishon: kishon
kiss: kiss,kissed
kite: kite
knead: knead,kneaded
knee: knee,knees
kneel: kneel,kneeled,kneeling
knife: knife,knives
knit: knit
knop: knop,knops
knoweth: knoweth
knowledge: knowledge
korah: korah
korahite: korahite
kore: kore
laban: laban
labour: labour,laboured,labours
lace: lace
lack: lack,lacked,lacking
lad: lad,lads
ladder: ladder
lade: lade,laded
laden: laden
lading: lading
lady: ladies
lamb: lamb,lambs
lame: lame
lament: lament,lamented
lamentation: lamentation,lamentations
lamentations: lamentations
lamp: lamp,lamps
lancet: lancets
land: land,lands
landmark: landmark
language: language
lap: lap,lapped
lapwing: lapwing
largeness: largeness
lattice: lattice
laugh: laugh,laughed
laver: laver,lavers
law: law,laws
lawful: lawful
lawgiver: lawgiver
lay: laid,lay,laying
lead: lead,led
leader: leader,leaders
leadeth: leadeth
leaf: leaf,leaves
league: league
leah: leah
lean: lean,leaned
leap: leap,leaped,leaping
learn: learn,learned
leather: leather
leave: leave,left
leaven: leaven,leavened
leavened: leavened
lebanon: lebanon
ledge: ledges
leek: leeks
left: left,leftest
leg: legs
lehi: lehi
lend: lend,lent
lengthen: lengthen,lengthened
leper: leper,lepers
leprosy: leprosy
leprous: leprous
letter: letter,letters
levi: levi
levite: levite
leviticus: leviticus
levy: levy
lewdness: lewdness
liar: liars
liberally: liberally
liberty: liberty
lice: lice
lick: lick,licked
lid: lid
lie: lain,lie,lied,lies,lying
lien: lien
lier: liers
liest: liest
lieutenant: lieutenants
life: life,lives
lifetime: lifetime
lift: lift,lifted,lifting
light: light,lighted,lighter,lightest,lights
lighten: lighten
lightly: lightly
lightning: lightning,lightnings
ligure: ligure
likeness: likeness
lily: lilies,lily
linen: linen
linger: lingered
lintel: lintel
lion: lion,lions
lionlike: lionlike
lip: lip,lips
liquor: liquor,liquors
liv: livest
live: live,lived,living
lively: lively
liver: liver
liveth: liveth
living: living
lizard: lizard
lo: lo
loaf: loaf,loaves
loan: loan
loathsome: loathsome
lock: locked,locks
locust: locust,locusts
lod: lod
lodge: lodge,lodged
lodging: lodging
lodgings: lodgings
loft: loft
log: log
loin: loins
longing: longing
longsuffering: longsuffering
loop: loops
loose: loose,loosed
lord: lord,lords
lordly: lordly
lose: lose,lost
loss: loss
lost: lost
lot: lot,lots
lotan: lotan
loud: loud,louder
love: love,loved
lovely: lovely
lover: lover
lowing: lowing
lucre: lucre
lud: lud
luke: luke
lump: lump
lurk: lurking
lust: lust,lusted,lusting
lusty: lusty
machi: machi
mad: mad
madness: madness
magician: magicians
magistrate: magistrate,magistrates
magnifical: magnifical
magnify: magnified,magnify
magog: magog
maid: maid,maids
maiden: maiden,maidens
maidservant: maidservant,maidservants
mail: mail
maim: maimed
maintain: maintain
maintenance: maintenance
majesty: majesty
malachi: malachi
male: male,males
manasseh: manasseh
mandrake: mandrakes
manifold: manifold
mankind: mankind
manna: manna
manner: manner
manners: manners
manservant: manservant,menservants
manslayer: manslayer
mantle: mantle
mar: mar
mara: mara
marah: marah
marble: marble
march: marched
mark: mark,marked,marks
marriage: marriage,marriages
married: married
marry: married,marry,marrying
marvel: marvelled,marvels
marvellous: marvellous
marvellously: marvellously
mash: mash
mashal: mashal
mason: masons
massa: massa
master: master
mastery: mastery
matrix: matrix
matter: matter,matters
matthew: matthew
mattock: mattock,mattocks
maw: maw
mayest: mayest
meadow: meadow,meadows
meal: meal
mealtime: mealtime
measure: measure,measured,measures
meat: meat
meddle: meddle,meddling
meditate: meditate
meek: meek
meet: meet,met
meeting: meeting
melchizedek: melchizedek
melon: melons
melt: melt,melted
memorial: memorial
mend: mend
mention: mention,mentioned
merchandise: merchandise
merchant: merchant,merchants
merchantman: merchantmen
merciful: merciful
mercy: mercies,mercy
mered: mered
merry: merry
meshech: meshech
mesopotamia: mesopotamia
mess: mess,messes
message: message
messenger: messenger,messengers
mete: mete
meteyard: meteyard
methuselah: methuselah
micah: micah
michael: michael
midday: midday
middle: middle
midianite: midianite
midianitish: midianitish
midnight: midnight
midst: midst
midwife: midwife,midwives
mightier: mightier
mightily: mightily
mighty: mightier,mightiest,mighty
milch: milch
mildew: mildew
milk: milk
millstone: millstone
mind: mind,minds
minded: minded
mindful: mindful
mingle: mingled
minish: minish
minister: minister,ministered,ministering,ministers
ministry: ministry
minstrel: minstrel
miracle: miracle,miracles
mire: mire
miriam: miriam
mirth: mirth
mischief: mischief,mischiefs
misery: misery
mist: mist
mistress: mistress
misuse: misused
mitre: mitre
mixed: mixed
mixt: mixt
mizpah: mizpah
mizraim: mizraim
moabite: moabite
moabitess: moabitess
moabitish: moabitish
mock: mock,mocked,mocking
moist: moist
mole: mole
molten: molten
moment: moment
money: money
month: month,months
moon: moon,moons
mordecai: mordecai
morning: morning
morrow: morrow
morsel: morsel
mortally: mortally
mortar: mortar
mortgage: mortgaged
moses: moses
mother: mother
mouldy: mouldy
mount: mount
mountain: mountain,mountains
mourn: mourn,mourned,mourning
mourner: mourner
mourning: mourning
mouse: mice,mouse
mouth: mouth,mouths
mulberry: mulberry
mule: mule,mules
multiply: multiplied,multiply,multiplying
multitude: multitude
murderer: murderer,murderers
murmur: murmur,murmured
murrain: murrain
musical: musical
muster: mustered
muzzle: muzzle
myrrh: myrrh
myrtle: myrtle
naam: naam
naaman: naaman
nabal: nabal
naboth: naboth
nahor: nahor
nahum: nahum
nail: nail,nails
naked: naked
nakedness: nakedness
naomi: naomi
naphtali: naphtali
narrow: narrow,narrowed
nathan: nathan
nation: nation,nations
nativity: nativity
natural: natural
naught: naught
naughtiness: naughtiness
nave: naves
navy: navy
nazarite: nazarite
nearer: nearer
nebaioth: nebaioth
nebuchadnezzar: nebuchadnezzar
neck: neck,necks
necromancer: necromancer
needful: needful
needlework: needlework
needy: needy
negligent: negligent
nehemiah: nehemiah
neighbour: neighbour,neighbours
nephew: nephews
nest: nest
neth: nether
nether: nether
nethermost: nethermost
network: network,networks
newly: newly
nigh: nigh
night: night,nights
nimrod: nimrod
nimshi: nimshi
nineteen: nineteen
nineteenth: nineteenth
ninth: ninth
nisan: nisan
noah: noah
nob: nob
noble: noble,nobles
nod: nod
noise: noise
noised: noised
noon: noon
noonday: noonday
north: north
northward: northward
nose: nose
nostril: nostrils
notice: notice
nought: nought
nourish: nourish,nourished
nourisher: nourisher
numbering: numbering
nun: nun
nurse: nurse,nursed
nursing: nursing
nut: nuts
oak: oak
oath: oath
obadiah: obadiah
obedient: obedient
obeisance: obeisance
obey: obey,obeyed,obeying
oblation: oblation,oblations
observe: observe,observed
observer: observer,observers
obstinate: obstinate
occasion: occasion,occasioned,occasions
occupation: occupation
occupy: occupied
occurrent: occurrent
odd: odd
odious: odious
odour: odours
offence: offence
offend: offended
offender: offenders
offer: offer,offered,offering
offering: offering,offerings
office: office,offices
officer: officer,officers
oft: oft
og: og
oil: oil,oiled
ointment: ointment
olive: olive,olives
olivet: olivet
omar: omar
omer: omer,omers
onan: onan
onion: onions
ono: ono
onward: onward
onycha: onycha
onyx: onyx
openly: openly
ophir: ophir
opinion: opinions
oppress: oppress,oppressed
oppressed: oppressed
oppression: oppression
oracle: oracle
ordain: ordain,ordained
ordinance: ordinance,ordinances
organ: organ
ornament: ornaments
oshea: oshea
ossifrage: ossifrage
ouch: ouches
outgoing: outgoings
outlandish: outlandish
outlive: outlived
outmost: outmost
outstretched: outstretched
outward: outward
oven: oven,ovens
overcome: overcome
overdrive: overdrive
overflow: overflow
overfly: overflown
overlay: overlaid,overlay
overlaying: overlaying
overlive: overlived
overplus: overplus
overrun: overran
oversee: oversee
overseer: overseer,overseers
oversight: oversight
overspread: overspread
overtake: overtake,overtook
overthrow: overthrew,overthrow,overthrown
overturn: overturned
owl: owl
owner: owner
ox: ox
oxen: oxen
pace: paces
paddle: paddle
pain: pains
paint: painted
palace: palace,palaces
pallu: pallu
palluites: palluites
palm: palm,palms
pan: pan,pans
parable: parable
parcel: parcel
parched: parched
pardon: pardon,pardoned
pare: pare
parlour: parlour,parlours
partition: partition
partridge: partridge
party: parties
pass: pass,passed,passing
passage: passage,passages
passover: passover,passovers
pasture: pasture,pastures
path: path
pathrusim: pathrusim
patrimony: patrimony
pattern: pattern
pau: pau
paul: paul
paved: paved
pavement: pavement
pavilion: pavilions
paw: paw,paws
pay: paid,pay
peace: peace
peaceable: peaceable
peaceably: peaceably
peacock: peacocks
peculiar: peculiar
pedigree: pedigrees
pelican: pelican
pen: pen
peradventure: peradventure
perceive: perceive,perceived
perfect: perfect,perfected
perform: perform,performed,performing
perfume: perfume
perish: perish,perished
perpetual: perpetual
perpetually: perpetually
persecute: persecuted
persecutor: persecutors
persia: persia
persian: persian
person: people,person,persons
persuade: persuade,persuaded
pertain: pertain,pertained,pertaining
perverse: perverse
perversely: perversely
perverseness: perverseness
pervert: pervert
perverted: perverted
pestilence: pestilence
peter: peter
petition: petition
pharaoh: pharaoh
philemon: philemon
philippians: philippians
philistine: philistine
philistines: philistines
phut: phut
physician: physicians
picture: pictures
piece: piece,pieces
pierce: pierce,pierced
pigeon: pigeon,pigeons
pilgrimage: pilgrimage
pill: pilled
pillar: pillar,pillars
pillow: pillow,pillows
pin: pin,pins
pine: pine
pinon: pinon
pipe: pipe,piped,pipes
pisgah: pisgah
piss: piss
pit: pit,pits
pitch: pitch,pitched
pitcher: pitcher,pitchers
pity: pity
plague: plague,plagued,plagues
plain: plain,plains
plainly: plainly
plaister: plaister,plaistered
planet: planets
plank: planks
plant: plant,planted,plants
plat: plat
plate: plate,plates
play: play,played,playing
player: player
playing: playing
plea: plea
plead: plead,pleaded
pleasant: pleasant
pleased: pleased
pleasure: pleasure
pledge: pledge,pledges
plenteous: plenteous
plenteousness: plenteousness
plenty: plenty
plow: plow,plowed,plowing
pluck: pluck,plucked
plummet: plummet
poison: poison
pole: pole
poll: poll,polled,polls
pollute: pollute,polluted
polluted: polluted
pomegranate: pomegranate,pomegranates
pommel: pommels
pond: ponds
pool: pool,pools
poor: poor,poorer,poorest
poplar: poplar
populous: populous
porch: porch
port: port
porter: porter,porters
portion: portion,portions
possess: possess,possessed
possession: possession,possessions
possessor: possessor
post: post,posts
posterity: posterity
pot: pot,pots
pottage: pottage
potter: potters
pound: pound
pour: pour,poured
poverty: poverty
powder: powder
power: power
practise: practised
praise: praise,praised,praises,praising
pray: pray,prayed,praying
prayer: prayer
preach: preach
precept: precepts
precious: precious
preparation: preparation
prepare: prepare,prepared,preparing
prepared: prepared
prescribe: prescribing
presence: presence
presently: presently
preserve: preserve,preserved
press: pressed,presses
presume: presume,presumed
presumptuously: presumptuously
prevail: prevail,prevailed
prevent: prevented
prey: prey
price: price
prick: pricks
pride: pride
priest: priest,priests
priesthood: priesthood
prince: prince,princes
princess: princesses
principal: principal
print: print
prison: prison
prisoner: prisoners
privily: privily
privy: privy
proceed: proceed,proceeded
process: process
proclaim: proclaim,proclaimed
proclamation: proclamation
profane: profane,profaned,profaning
profess: profess
profit: profit
progenitor: progenitors
project: project
prolong: prolong,prolonged
promise: promise,promised
promote: promote,promoted
pronounce: pronounce,pronounced,pronouncing
proper: proper
prophecy: prophecy
prophesy: prophesied,prophesy,prophesying
prophet: prophet,prophets
prophetess: prophetess
proportion: proportion
prosper: prosper,prospered
prosperity: prosperity
prosperous: prosperous
prosperously: prosperously
prostitute: prostitute
protection: protection
protest: protest,protested
proudly: proudly
prove: prove,proved
provender: provender
proverb: proverb,proverbs
proverbs: proverbs
provide: provide
province: province,provinces
provision: provision
provocation: provocation,provocations
provoke: provoke,provoked,provoking
prudence: prudence
prudent: prudent
prune: prune
psalm: psalm,psalms
psalmist: psalmist
psalms: psalms
psaltery: psalteries,psaltery
pua: pua
publish: publish
pul: pul
pull: pull,pulled
pulpit: pulpit
pulse: pulse
punish: punish,punished
punishment: punishment
purchase: purchase,purchased
pure: pure
purge: purge,purged
purification: purification
purify: purified,purify,purifying
purifying: purifying
purple: purple
purpose: purpose,purposed,purposing
pursue: pursue,pursued,pursuing
pursuer: pursuers
purtenance: purtenance
push: push
pygarg: pygarg
quail: quails
quake: quaked
quarrel: quarrel
quarry: quarries
quarter: quarter,quarters
queen: queen
quench: quench,quenched
question: questioned,questions
quick: quick
quiet: quiet
quietly: quietly
quietness: quietness
quit: quit
quiver: quiver
rachel: rachel
rage: rage
rail: rail,railed
raiment: raiment
rain: rain,rained
raise: raise,raised
raisin: raisins
ram: ram,rams
rameses: rameses
range: ranges
rank: rank,ranks
ransom: ransom
rate: rate
raven: raven,ravens
ravin: ravin
raw: raw
razor: razor
reach: reach,reached,reaching
read: read
reading: reading
ready: ready
realm: realm
reap: reap,reaping
reaper: reapers
rear: rear,reared
reason: reason
rebekah: rebekah
rebel: rebel,rebelled,rebels
rebellion: rebellion
rebellious: rebellious
rebuke: rebuke,rebuked,rebuking
receive: receive,received,receiving
reckon: reckon,reckoned
reckoning: reckoning
recompence: recompence
recompense: recompense,recompensed,recompensing
reconcile: reconcile,reconciling
reconciliation: reconciliation
record: record,recorded,records
recorder: recorder
recover: recover,recovered
red: red
reddish: reddish
redeem: redeem,redeemed
redeeming: redeeming
redemption: redemption
reed: reed
refine: refined
reform: reformed
refrain: refrain,refrained
refresh: refresh,refreshed
refuge: refuge
refuse: refuse,refused
regard: regard,regarded
region: region
register: register
rehearse: rehearse,rehearsed
rehoboam: rehoboam
rehoboth: rehoboth
rei: rei
reign: reign,reigned,reigning
reject: rejected
rejoice: rejoice,rejoiced,rejoicing
rejoicing: rejoicing
release: release
relieve: relieve
rely: relied,rely
remain: remain,remained,remaining
remainder: remainder
remedy: remedy
remember: remember,remembered
remembrance: remembrance
remnant: remnant
remove: remove,removed,removing
rend: rend
render: render,rendered
renew: renew,renewed
renown: renown
renowned: renowned
rent: rent
repair: repair,repaired,repairing
repay: repay
repent: repent,repented
rephael: rephael
replenish: replenish
report: report,reported
reproach: reproach,reproached
reprove: reprove,reproved
request: request,requested
require: require,required
requite: requite,requited,requiting
rereward: rereward
rescue: rescue,rescued
resemble: resembled
residue: residue
resort: resort,resorted
respect: respect
respite: respite
rest: rest,rested,rests
resting: resting
restitution: restitution
restore: restore,restored
restorer: restorer
restrain: restrained
restraint: restraint
retain: retained
retire: retire,retired
return: return,returned
reuben: reuben
reubenites: reubenites
reuel: reuel
reveal: revealed
revelation: revelation
revenge: revenges
revenger: revenger,revengers
revenue: revenue
reverence: reverence
reverse: reverse
revile: revile
revive: revive,revived,reviving
revolt: revolt,revolted
reward: reward,rewarded,rewards
rib: rib,ribs
ribband: ribband
rich: rich
riches: riches
rid: rid
riddance: riddance
ridden: ridden
riddle: riddle
ride: ride,riding,rode
rider: rider,riders
rie: rie
righteous: righteous
righteously: righteously
righteousness: righteousness
rightly: rightly
rigour: rigour
ringstraked: ringstraked
rinse: rinsed
rip: rip,ripped
ripe: ripe
rise: rise,risen,rising,rose
rite: rites
river: river,rivers
road: road
roar: roar,roared
roast: roast
roasted: roasted
rob: rob,robbed
robe: robe,robes
rock: rock,rocks
rod: rod,rods
roe: roe,roes
roebuck: roebuck,roebucks
roll: roll,rolled,rolls
roman: romans
roof: roof
root: root,rooted,roots
rope: ropes
rot: rot
rough: rough
roughly: roughly
rouse: rouse
rover: rovers
row: row,rows
royal: royal
rubbish: rubbish
ruddy: ruddy
ruin: ruin
ruinous: ruinous
rule: rule,ruled,ruling
ruler: ruler,rulers
rumour: rumour
rump: rump
runneth: runneth
running: running
rush: rushed
ruth: ruth
sabbath: sabbath,sabbaths
sack: sack,sacks
sackcloth: sackcloth
sacrifice: sacrifice,sacrificed,sacrifices,sacrificing
sad: sad
saddle: saddle,saddled
sadly: sadly
safe: safe
safeguard: safeguard
safely: safely
safety: safety
saint: saint,saints
saith: saith
sake: sake,sakes
sale: sale
salem: salem
salma: salma
salmon: salmon
salt: salt
salute: salute,saluted
salvation: salvation
samaria: samaria
samaritan: samaritans
samson: samson
samuel: samuel
sanballat: sanballat
sanctify: sanctified,sanctify
sanctuary: sanctuaries,sanctuary
sand: sand
sapphire: sapphire
sarah: sarah
sardius: sardius
satan: satan
satisfaction: satisfaction
satisfied: satisfied
saul: saul
save: save,saved,saving
saviour: saviour,saviours
savour: savour,savours
savoury: savoury
scab: scab,scabbed
scaffold: scaffold
scale: scales
scall: scall
scapegoat: scapegoat
scarce: scarce
scarceness: scarceness
scarlet: scarlet
scatter: scatter,scattered
sceptre: sceptre
scholar: scholar
scorn: scorn
scorpion: scorpions
scour: scoured
scourge: scourged,scourges
scrabble: scrabbled
scrape: scrape,scraped
scribe: scribe,scribes
scrip: scrip
scurvy: scurvy
sea: sea,seas
seal: seal,sealed
search: search,searched,searching
searching: searchings
seas: seas
season: season,seasons
seat: seat,seated
seba: seba
secret: secret,secrets
secretly: secretly
secure: secure
sedition: sedition
seduce: seduced
seed: seed,seeds
seedtime: seedtime
seek: seek,sought
seer: seer,seers
seethe: seethe,seething
seize: seize
selah: selah
selfsame: selfsame
sell: sell,sold
seller: sellers
selvedge: selvedge
senaah: senaah
send: send,sending
sense: sense
sentence: sentence
separate: separate,separated
separation: separation
sepharvites: sepharvites
sepulchre: sepulchre
sered: sered
serpent: serpent,serpents
servant: servant,servants
serve: serve,served,serving
service: service
servile: servile
servitor: servitor
servitude: servitude
set: set
seth: seth
setting: settings
settle: settle,settled
settled: settled
sevenfold: sevenfold
seventeen: seventeen
seventeenth: seventeenth
seventh: seventh
sever: sever,severed
sew: sewed
shadow: shadow
shaft: shaft
shake: shake,shaken,shook
shalt: shalt
shama: shama
shame: shame,shamed
shamelessly: shamelessly
shamer: shamer
shamir: shamir
share: share
sharezer: sharezer
sharon: sharon
sharp: sharp
sharpen: sharpen
sharply: sharply
shaul: shaul
shave: shave,shaved
shaven: shaven
sheaf: sheaf,sheaves
sheal: sheal
shear: shear,shearing
shearer: shearers
sheath: sheath
shechem: shechem
shechemites: shechemites
sheep: sheep
sheepcote: sheepcote
sheepfold: sheepfolds
sheepmaster: sheepmaster
sheet: sheets
shekel: shekel,shekels
shelah: shelah
shem: shem
shema: shema
sheminith: sheminith
shen: shen
shepherd: shepherd,shepherds
sheth: sheth
sheva: sheva
shew: shew,shewed,shewing
shewbread: shewbread
shewed: shewed
shibboleth: shibboleth
shield: shield,shields
shiloh: shiloh
shimei: shimei
shine: shine,shined,shining,shone
ship: ships
shipman: shipmen
shittim: shittim
shock: shocks
shoe: shod,shoe,shoes
shoot: shoot,shooting,shot
shooter: shooters
shore: shore
short: short
shortly: shortly
shot: shot
shoulder: shoulder,shoulders
shouldest: shouldest
shout: shout,shouted,shouting
shouting: shouting
shovel: shovels
shower: showers
shred: shred
shrink: shrank
shrub: shrubs
shunammite: shunammite
shut: shut
shutting: shutting
sia: sia
sibboleth: sibboleth
sick: sick
sickle: sickle
sickness: sickness,sicknesses
siege: siege
sigh: sighed
sight: sight
sign: sign,signs
signet: signet,signets
silence: silence
silent: silent
silver: silver
simeon: simeon
similitude: similitude
simplicity: simplicity
sin: sin,sinned,sinning,sins
sincerely: sincerely
sincerity: sincerity
sinew: sinew
sinful: sinful
sing: sang,sing,singing
singer: singer,singers
singing: singing
singular: singular
sinite: sinite
sink: sank,sunk
sinner: sinners
sion: sion
sir: sir
sister: sister,sisters
sit: sat,sit,sitting
sitting: sitting
situate: situate
situation: situation
sixscore: sixscore
sixteen: sixteen
sixteenth: sixteenth
sixth: sixth
size: size
skilful: skilful
skill: skill
skin: skin,skins
skirt: skirt
skull: skull
sky: skies,sky
slack: slack
slander: slander,slandered
slang: slang
slaughter: slaughter
slay: slain,slay
slayer: slayer
slaying: slaying
sleep: sleep,sleeping,slept
slew: slew
slide: slide
slime: slime
sling: sling,slings
slinger: slingers
slip: slip,slipped
slothful: slothful
slow: slow
smell: smell,smelled
smite: smite,smiting,smitten,smote
smith: smith,smiths
smitten: smitten
smoke: smoke
smoking: smoking
smooth: smooth
smote: smote
snail: snail
snare: snare,snared,snares
sneeze: sneezed
snow: snow
snowy: snowy
snuffer: snuffers
socket: socket,sockets
sod: sod
sodden: sodden
sodom: sodom
sodomite: sodomite,sodomites
soever: soever
softly: softly
sojourn: sojourn,sojourned,sojourning
sojourner: sojourner,sojourners
sojourning: sojourning
soldier: soldiers
sole: sole,soles
solemn: solemn
solemnity: solemnity
solemnly: solemnly
solomon: solomon
son: son,sons
song: song,songs
soothsayer: soothsayer
sorcerer: sorcerers
sore: sore
sorely: sorely
sorrow: sorrow,sorrows
sorrowful: sorrowful
sort: sort,sorts
soul: soul,souls
sound: sound,sounded,sounding
south: south
southward: southward
sow: sow,sowed,sown
sowing: sowing
space: space
spake: spake
span: span
spare: spare,spared
speak: spake,speak,speaking,spoken
spear: spear,spears
special: special
specially: specially
speckled: speckled
speech: speech,speeches
speed: sped,speed
speedily: speedily
spend: spend,spent
spice: spice,spices
spicery: spicery
spill: spilled
spilt: spilt
spin: spin,spun
spirit: spirit,spirits
spit: spit
spittle: spittle
spoil: spoil,spoiled,spoils
spoiled: spoiled
spoiler: spoilers
spoke: spokes
spokesman: spokesman
spoon: spoon,spoons
sport: sport,sporting
spot: spot,spots,spotted
spotted: spotted
spread: spread,spreading
spring: spring,springing,springs,sprung
sprinkle: sprinkle,sprinkled
spue: spue,spued
spy: spied,spies,spy
square: square
stable: stable
stablish: stablish,stablished
stack: stacks
stacte: stacte
staff: staff
stair: stairs
stalk: stalk,stalks
stall: stalls
stamp: stamp,stamped
stand: stand,standing,stood
standard: standard,standards
standeth: standeth
standing: standing
stank: stank
star: star,stars
start: start
stature: stature
statute: statute,statutes
stave: staves
stay: stay,stayed,stays
stead: stead,steads
steady: steady
steal: steal,stealing,stole,stolen
stealth: stealth
stedfastly: stedfastly
steel: steel
step: step,steps
steward: steward,stewards
stick: stick,sticks,stuck
stiff: stiff
stiffen: stiffened
stink: stank,stink
stir: stir,stirred
stock: stock
stone: stone,stoned,stones,stoning
stool: stool,stools
stoop: stooped
store: store
storehouse: storehouses
stork: stork
story: stories,story
straight: straight
straightway: straightway
strait: strait
straitly: straitly
straitness: straitness
strake: strakes
strange: strange
strangely: strangely
stranger: stranger,strangers
straw: straw,strawed
stream: stream,streams
street: street,streets
strength: strength
strengthen: strengthen,strengthened
stretch: stretch,stretched
stricken: stricken
strife: strife
strike: strike,struck
strip: strip,stripped
stripe: stripe,stripes
stripling: stripling
stript: stript
strive: strive,strove
striving: strivings
stroke: stroke
strong: strong,stronger
strow: strowed
struggle: struggled
stubble: stubble
stubborn: stubborn
stubbornness: stubbornness
stuff: stuff
stumble: stumbled
stump: stump
subdue: subdue,subdued
submit: submit,submitted
substance: substance
subtilly: subtilly
subtilty: subtilty
suburb: suburbs
succeed: succeed,succeeded
success: success
succoth: succoth
succour: succour,succoured
suck: suck,sucking
suckling: suckling,sucklings
suddenly: suddenly
suffer: suffer,suffered
suffice: suffice,sufficed
sufficient: sufficient
suit: suit
sum: sum
summer: summer
sun: sun
sunrising: sunrising
superfluous: superfluous
supplant: supplanted
supplication: supplication,supplications
suppose: suppose
sur: sur
surely: surely
surety: surety
susi: susi
sustain: sustain,sustained
sustenance: sustenance
swallow: swallow,swallowed
swan: swan
sware: sware
swarm: swarm,swarms
swear: swear,sworn
swearing: swearing
sweat: sweat
sweep: swept
sweet: sweet,sweeter
sweetness: sweetness
swell: swell,swelled
swift: swift,swifter
swim: swim
swine: swine
sword: sword,swords
sycomore: sycomore
syria: syria
syrian: syrian,syrians
tabernacle: tabernacle,tabernacles
table: table,tables
tablet: tablets
tabor: tabor
tabret: tabret
tach: taches
tail: tail,tails
taketh: taketh
tale: tale
talebearer: talebearer
talent: talent,talents
talk: talk,talked,talking
tall: tall,taller
tanach: tanach
tare: tare
tarea: tarea
target: target,targets
tarry: tarried,tarry
tartan: tartan
task: task,tasks
taskmaster: taskmasters
taste: taste,tasted
tax: taxed
taxation: taxation
teach: taught,teach
teacher: teacher
teaching: teaching
tear: tear,tears,torn
telling: telling
tema: tema
teman: teman
temper: tempered
temple: temple,temples
tempt: tempt,tempted
temptation: temptations
tender: tender
tenderhearted: tenderhearted
tenderness: tenderness
tenon: tenons
tenor: tenor
tent: tent,tents
tenth: tenth
teraphim: teraphim
terrace: terraces
terrible: terrible
terribleness: terribleness
terrified: terrified
terror: terror,terrors
testament: testament
testify: testified,testify
testimony: testimonies,testimony
thanksgiving: thanksgiving,thanksgivings
thee: thee
theft: theft
thenceforth: thenceforth
thereat: thereat
therefrom: therefrom
thereon: thereon
thereout: thereout
thereunto: thereunto
therewith: therewith
thessalonians: thessalonians
thicket: thicket,thickets
thickness: thickness
thief: thief
thigh: thigh,thighs
thine: thine
thinking: thinking
thirst: thirst,thirsted
thirsty: thirsty
thirteen: thirteen
thirteenth: thirteenth
thirtieth: thirtieth
thistle: thistle,thistles
thither: thither
thitherward: thitherward
thorn: thorns
thread: thread
threescore: threescore
thresh: threshed
threshing: threshing
threshold: threshold,thresholds
thrice: thrice
throne: throne
throw: threw,throw,throwing,thrown
thrust: thrust
thumb: thumb,thumbs
thunder: thunder,thundered,thunders
thy: thy
thyself: thyself
tidal: tidal
tiding: tidings
tie: tie,tied
tillage: tillage
tiller: tiller
timber: timber
timbrel: timbrel,timbrels
time: time,times
timothy: timothy
tin: tin
tingle: tingle
tired: tired
tirshatha: tirshatha
tithe: tithe,tithes,tithing
tithing: tithing
title: title
titus: titus
tob: tob
tobiah: tobiah
toe: toe,toes
toi: toi
toil: toil
token: token,tokens
tola: tola
toll: toll
tomorrow: tomorrow
tong: tongs
tongue: tongue,tongues
tool: tool
tooth: teeth,tooth
topaz: topaz
tortoise: tortoise
tou: tou
touch: touch,touched,touching
tow: tow
tower: tower,towers
town: town,towns
trade: trade
traffick: traffick
train: train,trained
trance: trance
transgress: transgress,transgressed,transgressing
transgression: transgression,transgressions
translate: translate
trap: traps
travail: travail,travailed
traveller: traveller,travellers
treacherously: treacherously
treachery: treachery
tread: tread,treading
treason: treason
treasure: treasure,treasures
treasurer: treasurer,treasurers
treasury: treasuries,treasury
tree: tree,trees
tremble: tremble,trembled,trembling
trench: trench
trespass: trespass,trespassed,trespasses
trespassing: trespassing
tribe: tribe,tribes
tribulation: tribulation,tribulations
tributary: tributaries
tribute: tribute
trim: trimmed
triumph: triumph,triumphed
trodden: trodden
trode: trode
troop: troop
trouble: trouble,troubled,troubles
troubled: troubled
troubler: troubler
trough: trough,troughs
true: true
trumpet: trumpet,trumpets
trumpeter: trumpeters
trust: trust,trusted
truth: truth
tubal: tubal
tumble: tumbled
tumult: tumult
turtle: turtles
turtledove: turtledove,turtledoves
twain: twain
twelfth: twelfth
twentieth: twentieth
twilight: twilight
twin: twins
twined: twined
tyre: tyre
ulla: ulla
unawares: unawares
uncircumcised: uncircumcised
uncle: uncle
unclean: unclean
uncleanness: uncleanness
uncover: uncover,uncovered
understand: understand,understood
understanding: understanding
undo: undone
undressed: undressed
ungird: ungirded
ungodly: ungodly
unholy: unholy
unicorn: unicorn,unicorns
unite: united
unleavened: unleavened
unmindful: unmindful
unoccupied: unoccupied
unrighteous: unrighteous
unrighteously: unrighteously
unrighteousness: unrighteousness
unsavoury: unsavoury
unstable: unstable
unwalled: unwalled
unweighed: unweighed
unwise: unwise
unwittingly: unwittingly
upbraid: upbraid
upper: upper
uppermost: uppermost
upright: upright
uprightness: uprightness
uproar: uproar
upside: upside
upward: upward
ur: ur
urge: urged
urgent: urgent
uri: uri
uriah: uriah
uriel: uriel
urim: urim
usurer: usurer
usury: usury
utmost: utmost
utter: utter,uttered
utterly: utterly
uttermost: uttermost
vagabond: vagabond
vail: vail
vain: vain
vale: vale
valiant: valiant
valiantly: valiantly
valley: valley,valleys
valour: valour
vanity: vanities,vanity
vaunt: vaunt
vengeance: vengeance
venison: venison
venom: venom
venture: venture
verify: verified
verily: verily
version: version
vessel: vessel,vessels
vestment: vestments
vestry: vestry
vesture: vesture,vestures
vex: vex,vexed
vexation: vexation,vexations
vial: vial
victory: victory
victual: victual
victuals: victuals
view: view,viewed
vile: vile
vilely: vilely
village: villages
vine: vine,vines
vinegar: vinegar
vineyard: vineyard,vineyards
vintage: vintage
violence: violence
violent: violent
violently: violently
virgin: virgin,virgins
virginity: virginity
virtuous: virtuous
vision: vision,visions
visit: visit,visited,visiting
visitation: visitation
voice: voice,voices
void: void
voluntary: voluntary
vow: vow,vowed,vows
vows: vows
vulture: vulture
wafer: wafer,wafers
wages: wages
wagon: wagon,wagons
wait: wait,waited,waiting
walk: walk,walked,walking
wall: wall,walls
walled: walled
wallow: wallowed
wander: wander,wandered,wandering
war: war,warred,warring,wars
ward: ward,wards
wardrobe: wardrobe
ware: ware
warfare: warfare
warm: warm
warn: warn,warned
warp: warp
warrior: warriors
wash: wash,washed,washing
washing: washing
wast: wast
waste: waste,wasted
watch: watch,watches,watching
watchman: watchman
watchmen: watchmen
water: water,watered,waters
watercourse: watercourse
watering: watering
wave: wave,waved,waves
wax: wax,waxed
waxen: waxen
wayfaring: wayfaring
wayside: wayside
weak: weak,weaker
weaken: weakened
wealth: wealth
wean: weaned
weapon: weapon,weapons
wear: wear,wearing
weary: wearied,weary
weasel: weasel
weave: wove,woven
weaver: weaver
wedge: wedge
week: week,weeks
weep: weep,weeping,wept
weigh: weigh,weighed,weighing
weight: weight,weights
welfare: welfare
wen: wen
wench: wench
west: west
western: western
westward: westward
whale: whales
whatsoever: whatsoever
wheat: wheat
wheaten: wheaten
wheel: wheel,wheels
whelp: whelp,whelps
whensoever: whensoever
whereabout: whereabout
wherefore: wherefore
whereinto: whereinto
whereof: whereof
whereon: whereon
wheresoever: wheresoever
whereunto: whereunto
wherewith: wherewith
whet: whet
whip: whips
whirlwind: whirlwind
whisper: whispered
whit: whit
white: white
whithersoever: whithersoever
wholly: wholly
whomsoever: whomsoever
whore: whore
whoredom: whoredom,whoredoms
whoring: whoring
whoso: whoso
whosoever: whosoever
wicked: wicked
wickedly: wickedly
wickedness: wickedness
wide: wide
widow: widow,widows
widowhood: widowhood
wife: wife,wives
wild: wild
wilderness: wilderness
wiles: wiles
wilily: wilily
willingly: willingly
willow: willows
wilt: wilt
win: win
wind: wind,winding,wound
window: window,windows
wine: wine
winepress: winepress
wing: wing,winged,wings
winged: winged
winter: winter
wipe: wipe,wiping
wire: wires
wisdom: wisdom
wise: wise,wiser
wisely: wisely
wist: wist
wit: wit
witch: witch
witchcraft: witchcraft
withal: withal
withdraw: withdraw,withdrawn,withdrew
wither: withered
withhold: withheld,withhold
withholden: withholden
withstand: withstand,withstood
witness: witness,witnessed,witnesses
wittingly: wittingly
wizard: wizard,wizards
woe: woe
wolf: wolf
woman: woman,women
womankind: womankind
womb: womb,wombs
wonderful: wonderful
wonderfully: wonderfully
wondrous: wondrous
wood: wood
woof: woof
wool: wool
woollen: woollen
word: word
worker: worker,workers
workman: workman,workmen
workmanship: workmanship
worm: worm,worms
wormwood: wormwood
worship: worship,worshipped,worshipping
worshipper: worshippers
worth: worth
worthily: worthily
worthy: worthy
wot: wot
wotteth: wotteth
wouldest: wouldest
wound: wound,wounded,wounds
wounding: wounding
wrap: wrapped
wrath: wrath
wreath: wreath,wreaths
wreathen: wreathen
wrest: wrest
wrestle: wrestled
wrestling: wrestlings
wretchedness: wretchedness
wring: wring,wrung
write: write,writing,written,wrote
writer: writer
writing: writing
wrong: wrong
wroth: wroth
yarn: yarn
yea: yea
yearly: yearly
yearn: yearn,yearned
yellow: yellow
yesterday: yesterday
yesternight: yesternight
yield: yield,yielded,yielding
yoke: yoke
yonder: yonder
youth: youth
zachariah: zachariah
zeal: zeal
zealous: zealous
zebulun: zebulun
zechariah: zechariah
zephaniah: zephaniah
zer: zer
zillah: zillah
zilpah: zilpah
zion: zion
