abandon: abandon,abandoned
abandonment: abandonment
abashed: abashed
abduction: abduction
abet: abetted
abhor: abhorred,abhors
abhorrence: abhorrence
abide: abide
abject: abject
abjure: abjured
abode: abode
abominable: abominable
abrupt: abrupt
abruptly: abruptly
absence: absence
absent: absent,absented
absolute: absolute
absolutely: absolutely
absolve: absolve,absolved
absorb: absorbed,absorbing
abstain: abstain,abstaining
abstinence: abstinence
abstract: abstract,abstracting
abstracted: abstracted
abstraction: abstraction
absurd: absurd
absurdity: absurdities,absurdity
abundant: abundant
abuse: abuse,abused,abusing
abyss: abyss
accede: accede
accent: accent,accents
accept: accept,accepted,accepting
access: access,accessed
accessible: accessible
accident: accident
accidental: accidental
accommodate: accommodate,accommodated
accommodation: accommodation,accommodations
accompany: accompanied,accompany,accompanying
accomplice: accomplice
accomplish: accomplished
accord: accord
accost: accosted
account: account
accumulation: accumulations
accursed: accursed
accusation: accusations
accuse: accuse,accused,accusing
accustom: accustomed
accustomed: accustomed
ache: ache,ached,aches,aching
achieve: achieved
acknowledge: acknowledge,acknowledged
acknowledgment: acknowledgment
acquaint: acquainted,acquainting
acquaintance: acquaintance,acquaintances
acquiesce: acquiesce,acquiesced
acquire: acquire,acquired
acquirement: acquirements
acquisition: acquisition,acquisitions
action: action,actions
active: active
activity: activity
actual: actual
actuate: actuate
add: add,adding
addition: addition,additions
additional: additional
address: address,addressed,addresses,addressing
adhere: adhere
adieu: adieu
adieux: adieux
adjective: adjective
adjourn: adjourned
adjuration: adjuration
administer: administer,administered
admirable: admirable
admiration: admiration
admire: admire,admired
admission: admission
admit: admit,admitted
admittance: admittance
admonition: admonition
ado: ado
adopt: adopt
adoration: adoration
adore: adored
adrift: adrift
adroitly: adroitly
advance: advance,advanced,advances,advancing
advantage: advantage,advantages
advent: advent
adventure: adventure,adventures
adversary: adversary
advice: advice
advise: advise,advised,advising
adviser: adviser
afeard: afeard
affair: affair,affairs
affect: affect
affectation: affectation,affectations
affection: affection,affections
affectionate: affectionate
affirm: affirm,affirmed,affirming,affirms
affirmation: affirmation,affirmations
afflict: afflict
affliction: affliction
afford: afford
afore: afore
afraid: afraid
afresh: afresh
afternoon: afternoon,afternoons
age: age,ages
aged: aged
agent: agent
aggravate: aggravate,aggravating
aggravation: aggravation
aggressor: aggressor
aghast: aghast
agility: agility
agitated: agitated
agitation: agitation
agony: agony
agree: agree,agreed
agreeable: agreeable
agreement: agreement
ague: ague
aha: aha
aid: aid,aided,aiding
ail: ail,ailing,ails
ailing: ailing
aim: aim,aimed
air: air
ajar: ajar
akin: akin
alacrity: alacrity
alarm: alarm,alarmed
alarmed: alarmed
alas: alas
ale: ale
alert: alert
alienation: alienation
alight: alighted
alike: alike
alive: alive
allay: allayed
alleviation: alleviation
alley: alley
alliance: alliance
allusion: allusion
ally: allies,ally
alms: alms
aloof: aloof
aloud: aloud
alter: alter,altered,altering
alteration: alteration,alterations
altered: altered
alternate: alternate
alternately: alternately
altogether: altogether
amang: amang
amaze: amazed
amazed: amazed
amazement: amazement
ambassadress: ambassadress
amber: amber
ambition: ambition
amend: amends
america: america
american: american
amiable: amiable
amiss: amiss
ample: ample
amuse: amuse,amused,amuses,amusing
amusement: amusement,amusements
anatomy: anatomy
ancestor: ancestors
ancient: ancient
anecdote: anecdote,anecdotes
anew: anew
angel: angel,angels
anger: anger,angered
angle: angle
angrily: angrily
angry: angry
anguish: anguish
anguished: anguished
animal: animal,animals
animate: animated
animation: animation
ankle: ankle
annie: annie
annihilate: annihilate,annihilated
anniversary: anniversary
announcement: announcement
annoy: annoy,annoyed
annoyance: annoyance,annoyances
annoyed: annoyed
annoying: annoying
annum: annum
anon: anon
answer: answer,answered,answering,answers
anticipate: anticipate,anticipated,anticipating
anticipation: anticipation,anticipations
antipathy: antipathy
antique: antique
anxiety: anxiety
anxious: anxious
anxiously: anxiously
apartment: apartment,apartments
apathetic: apathetic
apathy: apathy
ape: ape
apology: apology
appal: appal,appalled
appalling: appalling
apparent: apparent
apparition: apparition
appeal: appeal,appealing
appearance: appearance
appellation: appellation
appetite: appetite
applause: applause
apple: apple,apples
applicable: applicable
apply: applied,apply,applying
appoint: appointed
approach: approach,approached,approaching
approbation: approbation
approval: approval
approve: approve,approved
april: april
apron: apron
apt: apt
arabian: arabian
arc: arc
arch: arch
arched: arched
archer: archer
architect: architect
archive: archive
ardent: ardent
ardently: ardently
ardour: ardour
argue: argue,argued
argument: argument,arguments
arid: arid
arm: arm,arms
army: army
arn: arn
arouse: aroused
arrange: arrange,arranged
arrangement: arrangement,arrangements
array: array
arrest: arrest,arrested,arresting
arrival: arrival
arrive: arrive,arrived,arriving
arrogance: arrogance
arrow: arrows
art: art
artery: artery
artful: artful
article: article,articles
artillery: artillery
artist: artist
ascend: ascended,ascending
ascent: ascent
ascertain: ascertain,ascertained,ascertaining
ascii: ascii
ascribe: ascribed
ash: ash,ashes
ashamed: ashamed
askance: askance
asleep: asleep
aspect: aspect
aspiration: aspirations
aspire: aspiring
ass: ass,asses
assailant: assailant
assassin: assassin
assault: assault
assembly: assembly
assent: assent
assert: assert,asserted,asserting
assertion: assertion,assertions
asseverated: asseverated
assiduity: assiduity
assiduously: assiduously
assist: assist,assisting
assistance: assistance
assistant: assistant,assistants
associate: associate,associates
association: association,associations
assume: assume,assumed,assuming
assurance: assurance,assurances
assure: assure,assured,assuring
assuredly: assuredly
astir: astir
astonished: astonished
astonishing: astonishing
astonishment: astonishment
asunder: asunder
asylum: asylum
athletic: athletic
atlantic: atlantic
atmosphere: atmosphere
atmospheric: atmospheric
atom: atom,atoms
atrocious: atrocious
attach: attached
attachment: attachment,attachments
attack: attack,attacked
attain: attain,attained,attaining
attainment: attainments
attempt: attempt,attempted,attempting,attempts
attend: attend,attended,attending
attendance: attendance
attendant: attendant
attention: attention
attentive: attentive
attenuate: attenuated
attire: attire,attired
attitude: attitude
attorney: attorney
attract: attract,attracted
attraction: attraction,attractions
attractive: attractive
attribute: attribute,attributes
atween: atween
audacity: audacity
audible: audible
audibly: audibly
audience: audience
aught: aught
august: august
aunt: aunt
austere: austere
author: author
authoritative: authoritative
authoritatively: authoritatively
authority: authority
automaton: automatons
autumn: autumn
auxiliary: auxiliary
avail: avail,availed
avarice: avarice
avaricious: avaricious
aver: averred
aversion: aversion
avert: avert,averted,averting
avoid: avoid,avoided,avoiding,avoids
await: await,awaited,awaiting
awake: awake,awoke
awaken: awakened,awakens
aware: aware
awe: awe
awful: awful
awhile: awhile
awkward: awkward
awkwardly: awkwardly
awkwardness: awkwardness
awn: awn
ay: ay
baby: babies,baby
babyish: babyish
bacca: bacca
bad: bad,worse,worst
bade: bade
badly: badly,worse,worst
baht: baht
bairn: bairn,bairns
bait: bait,baiting
baking: baking
balance: balance,balancing
ball: ball
ballad: ballad
ban: ban,banning
band: band
bane: bane
bang: bang,banged
banish: banish,banished
banishment: banishment
banister: banister
bank: bank,banks
baptists: baptists
bar: barred,bars
bare: bare
barefoot: barefoot
barely: barely
bargain: bargain
bark: bark
barn: barn
barrel: barrel
barren: barren
barrier: barrier
base: base,based
basely: basely
basement: basement
baseness: baseness
bashfully: bashfully
bashfulness: bashfulness
basilisk: basilisk
basin: basin,basins
bask: basked
basket: basket
bass: bass
bassoon: bassoons
bath: bathed
bathos: bathos
battle: battle
battledore: battledores
bay: bay
beacon: beacon
bead: beaded
beamless: beamless
bear: bear,bearing,bore,born,borne
beard: beard
bearing: bearing
bearishly: bearishly
beast: beast,beasts
beat: beat,beaten,beating
beautiful: beautiful
beautifully: beautifully
beauty: beauty
beaver: beaver
beck: beck,becks
becloud: beclouded
bed: bed,beds
bedclothes: bedclothes
bedroom: bedroom
bedside: bedside
bedstead: bedstead
bedtime: bedtime
bee: bees
beef: beef
befall: befall,befallen
befitting: befitting
befriend: befriend
beg: beg,begged,begging
beggar: beggar,beggars
beggarly: beggarly
beginner: beginner
begone: begone
beguile: beguile,beguiled,beguiling
behalf: behalf
behave: behave,behaved,behaving
behaviour: behaviour
beheld: beheld
behest: behest
behold: beheld,behold,beholding
belie: belie,belied
belief: belief
bell: bell,bells
bellow: bellows
belong: belonged,belonging
beloved: beloved
bemoan: bemoaned
bench: bench,benches
bend: bend,bending,bent
beneath: beneath
benefactor: benefactor
beneficent: beneficent
benefit: benefit,benefiting
benevolence: benevolence
benevolent: benevolent
benign: benign
bent: bent
benumb: benumbed
bequeath: bequeath,bequeathed
bereavement: bereavement
beseech: beseech,beseeching,besought
besetting: besetting
bespeak: bespeak,bespoke
bestir: bestir,bestirring
bestow: bestow,bestowed,bestowing
betook: betook
betray: betray,betrayed
betrayal: betrayal
betrayer: betrayer
bevy: bevy
bewail: bewail
beware: beware
bewilder: bewildered,bewilders
bewilderment: bewilderment
bewitch: bewitched
bible: bible,bibles
bid: bade,bid,bidding
bidding: bidding
bide: bide
bilberry: bilberries,bilberry
billowy: billowy
binary: binary
bind: bind,binding,bound
birch: birches
bird: bird,birds
birth: birth
birthday: birthday
bit: bit,bits
bitch: bitch
bite: bit,bite,biting,bitten
biter: biter
bitter: bitter
bitterly: bitterly
bitterness: bitterness
black: black,blacker
blackberry: blackberry
blackbird: blackbirds
blacken: blackened
blackguard: blackguard
blackness: blackness
blacksmith: blacksmith
blade: blade
blamable: blamable
blame: blame,blamed,blaming
blanch: blanched
blank: blank,blanker
blasphemer: blasphemer
blast: blast
blaze: blaze,blazing
bleak: bleak
bleed: bled,bleed,bleeding,bleeds
bleeding: bleeding
blend: blended,blending
bless: bless,blessed
blessed: blessed
blessing: blessing
blight: blight,blighted
blightingly: blightingly
blind: blind,blinds
blindman: blindman
bliss: bliss
blissfully: blissfully
blister: blisters
block: block
blood: blood
blooded: blooded
bloodless: bloodless
bloody: bloody
bloom: bloom,bloomed,blooming
blossom: blossom,blossomed
blot: blotted
blow: blew,blow,blowing,blown,blows
blubber: blubbered,blubbering
bludgeon: bludgeon
blue: blue
bluebell: bluebells
bluff: bluff
blunder: blunder,blunders
blush: blush,blushed,blushing
bluster: blustered
board: board,boards
boast: boast,boasted
boastful: boastful
boastfully: boastfully
bode: boding
bodily: bodily
body: body
bog: bog
boil: boil,boiled,boiling
bold: bold
boldly: boldly
boldness: boldness
bolt: bolt,bolts
bond: bonds
bone: bones
bonnet: bonnet
bonnetless: bonnetless
bonny: bonniest,bonny
bony: bony
book: book,books
boor: boor
border: border,bordered,bordering,borders
borrow: borrowed,borrowing
bother: bother,bothered
bottle: bottle
bough: bough
bound: bounded,bounding,bounds
boundless: boundless
bountiful: bountiful
bout: bout
bow: bow,bowed
bowl: bowl
box: box,boxes
boy: boy,boys
boyhood: boyhood
brace: brace,bracing
brach: brach
brain: brain,brains
bran: bran
branch: branch,branches
branching: branching
brand: branded
brandy: brandy
brass: brass
brat: brat
brave: brave,braved
bravely: bravely
brazen: brazened
breach: breach
bread: bread
breadth: breadth
break: break,breaking,breaks,broke,broken
breakfast: breakfast,breakfasts
breast: breast
breath: breath,breaths
breathe: breathe,breathed,breathing
breathing: breathing
breathless: breathless
breathlessly: breathlessly
breeches: breeches
breed: bred,breed
breeding: breeding
breeze: breeze
brethren: brethren
bribe: bribed
bride: bride
bridegroom: bridegroom
bridle: bridle,bridles
bright: bright,brighter
brighten: brightened,brightening
brightness: brightness
brilliant: brilliant
brim: brim,brimmed
brimful: brimful
brindle: brindled
bring: bring,bringing,brings,brought
brink: brink
brisk: brisk
briskly: briskly
bristle: bristling
broad: broad
broken: broken
brood: brood,brooded,brooding
brooding: brooding
brook: brooks
brother: brother,brothers
brow: brow,brows
browed: browed
brown: brown
bruise: bruised,bruises
brush: brush,brushes,brushing
brutal: brutal
brutality: brutality
brutally: brutally
brute: brute
brutishness: brutishness
bud: bud,budded
buff: buff
bugbear: bugbear
build: build,building
building: building
bulk: bulk
bull: bull
bundle: bundle,bundled
buoyant: buoyant
burden: burden
burial: burial
burn: burn,burned,burning,burnt
burnished: burnished
burst: burst,bursting,bursts
bury: buried,buries,bury
bush: bushes
business: business
bustle: bustled,bustling
busy: busy
bye: bye
cabinet: cabinet
cake: cake,cakes
calamity: calamity
calculate: calculate,calculated
calf: calf
calling: calling
calm: calm,calmer
calmly: calmly
calmness: calmness
cambric: cambric
camel: camels
canary: canary
candid: candid
candle: candle,candles
candlelight: candlelight
candy: candy
canine: canine
canister: canister,canisters
cannibal: cannibal
canst: canst
canter: canter
canty: canty
cap: cap,caps
capable: capable
capacity: capacity
caper: caper,capering
capital: capital
caprice: caprice,caprices
captain: captain
capture: captured
caravan: caravan
carcass: carcass
card: card,cards
care: care,cared,cares
careful: careful
carefully: carefully
careless: careless
carelessly: carelessly
carelessness: carelessness
caress: caress,caressed,caresses
caricature: caricature
caring: caring
carol: carols
carpet: carpet,carpeted
carriage: carriage
carrion: carrion
carry: carried,carry,carrying
carrying: carrying
cart: cart
cartwheel: cartwheels
carve: carve,carved
carved: carved
carving: carving
casement: casement,casements
cash: cash
cast: cast,casting
castaway: castaway
castle: castle
cat: cat,cats
catastrophe: catastrophe
catch: catch,catching,caught
catechise: catechised
catechism: catechism
catgut: catgut
catherine: catherine
cathy: cathy
cattle: cattle
causeway: causeway
caution: cautions
cautious: cautious
cautiously: cautiously
cave: cave
cease: cease,ceased
ceiling: ceiling
cellar: cellar
cement: cemented
centipede: centipede
centre: centre,centred
centred: centred
century: century
ceremony: ceremony
certainty: certainty
chafe: chafing
chagrin: chagrin
chain: chain,chains
chair: chair,chairs
chamber: chamber,chambers
champion: champion
chance: chance,chanced
chandelier: chandelier
change: change,changed
changeling: changeling
channel: channel
chap: chap
chapel: chapel
chaplain: chaplain
chapter: chapter,chapters
character: character,characters
charge: charge,charged,charges
charitable: charitable
charitably: charitably
charity: charities,charity
charlie: charlie
charm: charm,charmed
charming: charming
chart: chart
chase: chase,chased
chasten: chastened
chastise: chastise
chastisement: chastisement
chat: chat
chatter: chatter,chattered,chattering
cheap: cheap
cheat: cheat,cheated,cheating
check: check,checked,checking,checks
cheek: cheek,cheeks
cheer: cheer
cheerful: cheerful
cheerfully: cheerfully
cheerfulness: cheerfulness
cheerless: cheerless
cheese: cheese
cherish: cherish,cherished,cherishing
cherub: cherub
chest: chest
chevy: chevy
chew: chewing
chicken: chicken
chide: chide,chided
chief: chief
child: child,children
childhood: childhood
childish: childish
chill: chill,chills
chillness: chillness
chimbley: chimbley
chime: chimed
chimney: chimney
chin: chin
china: china
chink: chinks
chip: chipping
chirp: chirping
chit: chit
chivalrous: chivalrous
choice: choice
choke: choke,choked,choking
choking: choking
choose: choose,chooses,choosing,chose,chosen
chord: chord
christen: christened
christendom: christendom
christian: christian
christmas: christmas
chubby: chubby
chuck: chuck,chucked
chuckle: chuckled
church: church
churchyard: churchyard
churl: churl
churlish: churlish
cinder: cinders
cipher: cipher
circle: circle
circuit: circuit
circumstance: circumstance,circumstances
city: city
civil: civil
civilised: civilised
civility: civilities,civility
civilized: civilized
claim: claim,claimed
claimant: claimant
clamber: clamber,clambered,clambering
clamorous: clamorous
clamorously: clamorously
clamour: clamour
clap: clapped
clasp: clasp,clasping
clasped: clasped
class: class
clatter: clatter
clause: clause
claw: claws
clay: clay
clean: clean,cleaner,cleaning
cleave: cleaved
cleft: clefts
clench: clenched,clenching
clergy: clergy
clergyman: clergyman
clever: clever
cleverly: cleverly
climax: climax
climb: climb,climbed,climbing
cling: clinging,clung
clo: cloes
cloak: cloak,cloaks
clock: clock
close: close,closed,closer,closing
closed: closed
closet: closet
cloth: cloth
clothes: clothes
cloud: cloud,clouded,clouds
clouded: clouded
cloudless: cloudless
cloudlessly: cloudlessly
cloudy: cloudy
clown: clown,clowns
club: clubs
clump: clump
clung: clung
cluster: clusters
clutch: clutch,clutched
coach: coach
coachman: coachman
coal: coal,coals
coarseness: coarseness
coast: coast
coat: coat
coax: coax,coaxed,coaxing
cobweb: cobweb
cock: cock,cocks
cockatrice: cockatrice
code: codes
coffee: coffee
coffin: coffin,coffins
cogitate: cogitating
cogitation: cogitations
coincide: coincide
cold: cold,colder,colds
coldly: coldly
coldness: coldness
collar: collar
collect: collect,collected,collecting
collection: collection
college: college
colony: colony
colossal: colossal
colour: colour,coloured,colours
colourless: colourless
colt: colt,colts
column: column
comb: comb,combed,combing
combat: combat
combatant: combatants
combine: combine
comer: comer
comfort: comfort,comforted,comforting,comforts
comfortable: comfortable
comfortably: comfortably
comfortless: comfortless
coming: coming
command: command,commanded,commanding,commands
commence: commence,commenced,commencing
commencement: commencement
commend: commending
commendation: commendation,commendations
comment: comment,commenting,comments
commentary: commentary
commercial: commercial
commission: commissioned
commit: commit,committed,committing
common: common,commonest
commonly: commonly
communicate: communicated
communication: communication
communion: communion
compactly: compactly
companion: companion,companions
companionable: companionable
companionship: companionship
company: company
comparatively: comparatively
compare: compare,compared
comparison: comparison
compassion: compassion
compassionate: compassionate
compel: compel,compelled
compelling: compelling
compensation: compensation
competent: competent
compilation: compilation
complacent: complacent
complacently: complacently
complain: complain,complained,complaining
complaining: complaining
complaint: complaint,complaints
complete: complete
completely: completely
complexion: complexion
complexioned: complexioned
compliance: compliance
compliment: compliment
comply: complied,comply,complying
compose: composed,composing
composition: composition
composure: composure
compound: compound,compounded,compounds
comprehend: comprehend,comprehended,comprehending,comprehends
comprehension: comprehension
compress: compressed,compressing
compulsion: compulsion
compulsory: compulsory
compunction: compunction
conceal: conceal,concealed,concealing,conceals
concealment: concealment
conceit: conceit
conceited: conceited
conceive: conceive,conceived
concentrate: concentrate
concentrated: concentrated
concept: concept
concern: concern,concerns
concernedly: concernedly
concession: concessions
conclude: concluded,concluding
conclusion: conclusion,conclusions
concourse: concourse
condemn: condemned
condense: condensed
condescend: condescend
condescendingly: condescendingly
condition: condition
condole: condoled
condolence: condolences
conduct: conduct,conducted,conducting
cone: cones
confess: confess,confessed
confession: confession,confessions
confide: confide,confiding
confidence: confidence
confident: confident
confidently: confidently
confine: confine,confined
confinement: confinement
confirm: confirmed,confirming
confirmation: confirmation
conflagration: conflagration
conflict: conflict
confluence: confluence
confound: confound,confounded
confused: confused
confusion: confusion
congratulate: congratulating
congratulation: congratulation
congregation: congregation
conjecture: conjecture,conjectured,conjectures
conjuring: conjuring
connect: connect,connected
connection: connection
conquer: conquered
conscience: conscience
conscious: conscious
consciously: consciously
consciousness: consciousness
consecrate: consecrated
consent: consent,consented
consequence: consequence,consequences
consequential: consequential
considerable: considerable
considerably: considerably
consideration: consideration
consist: consisted
consolation: consolation
console: console,consoled
conspire: conspire
constable: constable
constancy: constancy
constant: constant
constantly: constantly
consternation: consternation
constitution: constitution
constrain: constrained
construct: constructed
consult: consulting
consume: consumed,consuming
consumption: consumption
contact: contact
contaminate: contaminate
contemplate: contemplate,contemplated,contemplating
contemplation: contemplation
contempt: contempt
contemptible: contemptible
contemptuously: contemptuously
content: content
contented: contented
contentedly: contentedly
contents: contents
continent: continent
continual: continual
continually: continually
continue: continue,continued
contort: contort
contract: contract,contracted
contradict: contradict
contradiction: contradiction
contrariety: contrariety
contrary: contrary
contrast: contrast
contribute: contribute,contributed,contributes,contributing
contribution: contributions
contrite: contrite
contrivance: contrivances
contrive: contrive,contrives
contrived: contrived
control: control
convalescence: convalescence
convalescent: convalescent
convenience: convenience
convenient: convenient
conveniently: conveniently
conversant: conversant
conversation: conversation,conversations
converse: converse,conversing
convert: convert,converted,converting
convey: convey,conveyed,conveying
conviction: conviction
convince: convince,convinced
convinced: convinced
convulse: convulsed
convulsion: convulsions
convulsively: convulsively
cook: cooked,cooks
cookery: cookery
cool: cool
coolly: coolly
coolness: coolness
coom: coom
copestone: copestone
copious: copious
copper: copper
copying: copying
copyright: copyright
coquette: coquette
cord: cord
cordial: cordial
cordiality: cordiality
corn: corn
corner: corner,corners
corporation: corporation
corpse: corpse,corpses
correct: correct,correcting
correction: correction
correctly: correctly
correspond: correspond
correspondence: correspondence
corroborate: corroborating
corroboration: corroboration
corrugated: corrugated
corrupt: corrupt
cost: cost,costs
costly: costly
cot: cot
cottage: cottage
couch: couch
cough: cough,coughed,coughing,coughs
counsel: counsel,counselled
counsellor: counsellor
count: count,counted,counting
countenance: countenance,countenances
counter: counter
counteract: counteract
counterpart: counterpart
country: countries,country
couple: couple,coupled
courage: courage
court: court
courtesy: courtesy
cousin: cousin,cousins
cover: cover,covered,covering
covered: covered
covet: covet,coveting
covetousness: covetousness
cow: cow,cowed,cows
coward: coward,cowards
cowardice: cowardice
cowardly: cowardly
coxcomb: coxcomb
crack: cracked,cracking
crackling: crackling
crackly: crackly
cradle: cradle
craft: craft
crag: crags
crags: crags
cram: cram,crammed,cramming
cranky: cranky
crash: crash
crater: crater,craters
craving: craving
creak: creak
create: create,created,creating
creation: creation
creature: creature,creatures
credit: credit
creditor: creditor
credulity: credulity
creep: creep,creeping,crept
crescent: crescents
crestfallen: crestfallen
crew: crew
crimson: crimson
cringe: cringing
crisis: crisis
critical: critical
croak: croaked,croaking,croaks
croaker: croaker
crocus: crocuses
crooked: crooked
crop: cropped,cropping,crops
cross: cross,crossed,crosses,crossing
crosser: crosser
crossest: crossest
crossly: crossly
crouch: crouched
crowd: crowded
crown: crown
crowner: crowner
cruel: cruel
cruelly: cruelly
cruelty: cruelty
crumble: crumbling
crush: crush,crushed,crushing
crust: crust
crying: crying
cub: cub
cuckoo: cuckoo,cuckoos
cud: cud
cudgel: cudgel
cuff: cuffed
culinary: culinary
culpable: culpable
culpably: culpably
culprit: culprit
cultivate: cultivate
cultivation: cultivation
cunning: cunning
cunningly: cunningly
cup: cup,cups
cupboard: cupboard
cur: cur,curs
curate: curate
curb: curbed
cure: cure,cured
curiosity: curiosity
curious: curious
curiously: curiously
curl: curl,curled,curling,curls
currant: currant
current: current
curse: curse,cursed,curses,cursing
cursing: cursing
curtain: curtain,curtains
curtainless: curtainless
cushion: cushion
custody: custody
custom: custom
customary: customary
cut: cut,cutting
cutter: cutters
cynic: cynic
dad: dad
daddy: daddy
daily: daily
daintiness: daintiness
dainty: dainties,dainty
dairy: dairy
dairymaid: dairymaid
dairywoman: dairywoman
damage: damage,damaged
damaged: damaged
damages: damages
dame: dame
damn: damn
damnable: damnable
damnably: damnably
damnation: damnation
damned: damned
damp: damp
damper: damper
damsel: damsel
dance: dance
dancing: dancing
danger: danger
dangerous: dangerous
dangerously: dangerously
dappled: dappled
daresay: daresay
dark: dark
darken: darkened
darkness: darkness
darling: darling,darlings
darr: darr
dart: dart,darting
dash: dash,dashed,dashing
dastardly: dastardly
datum: data
daub: daubed
daughter: daughter
daunt: daunted
david: david
dawn: dawn
day: day,days
daylight: daylight
dead: dead
deaden: deadens
deadly: deadly
deaf: deaf
deal: deal
dealing: dealing
dean: dean
dearly: dearly
dearth: dearth
death: death
deathbed: deathbed
deathlike: deathlike
deave: deaved
debased: debased
debt: debt,debts
decamp: decamp
decanter: decanter
decay: decay,decayed
decease: decease
deceit: deceit
deceitful: deceitful
deceive: deceive,deceived,deceiving
deceiver: deceiver
december: december
decent: decent
decently: decently
decide: decide,decided
decidedly: decidedly
decipher: decipher
decision: decision
decisively: decisively
deck: decked
declare: declare,declared
decline: declined,declining
decorum: decorum
decoy: decoying
deductible: deductible
dee: dee
deed: deed,deeds
deem: deem,deemed
deep: deep,deeper
deepen: deepened
deeply: deeply
default: default
defeat: defeat
defect: defect,defects
defective: defective
defence: defence
defend: defend,defended,defending
defensive: defensive
defer: defer,deferred
defiance: defiance
deficiency: deficiencies,deficiency
deficient: deficient
definite: definite
deform: deformed
defy: defied,defies,defy,defying
defyingly: defyingly
degenerate: degenerates
degradation: degradation
degrade: degrade
degraded: degraded
degrading: degrading
degree: degree,degrees
deign: deigned
deity: deity
dejected: dejected
delay: delay,delayed
delectably: delectably
delegated: delegated
deletion: deletions
delf: delf
deliberate: deliberate
deliberately: deliberately
delicate: delicate
delight: delight,delighted,delighting,delights
delighted: delighted
delightedly: delightedly
delightful: delightful
delightfully: delightfully
delirious: delirious
deliriously: deliriously
delirium: delirium
deliver: deliver,delivered
deliverance: deliverance
dell: dells
delude: delude,deluded
deluge: deluge
delusion: delusion
delusive: delusive
delve: delve
demand: demand,demanded
demolish: demolish,demolished
demon: demon,demons
demonstration: demonstrations
demurely: demurely
den: den,dens
denial: denial
denominate: denominated
denomination: denomination
denounce: denounce
deny: denied,deny,denying
depart: depart,departed
departure: departure
depend: depended,depends
dependence: dependence
deplorable: deplorable
deportment: deportment
deposit: deposited
depreciate: depreciated
depreciation: depreciation
depress: depressed
depressed: depressed
depression: depression,depressions
deprive: deprive,deprived
depth: depth
depths: depths
derange: deranged
derangement: derangement
dereliction: derelictions
deride: deriding
derision: derision
derivative: derivative
derive: derive,derived,derives
descend: descend,descended,descending
descendant: descendant
descent: descent
description: description
descriptive: descriptive
desert: desert,deserted
deserted: deserted
desertion: desertion
deserve: deserve,deserved,deserves
design: design,designed,designing,designs
designing: designing
desirable: desirable
desire: desire,desired,desires,desiring
desirous: desirous
desist: desisting
desisted: desisted
desolate: desolate
desolation: desolation
despair: despair
despaired: despaired
despairing: despairing
despairingly: despairingly
despatch: despatched
desperate: desperate
desperately: desperately
desperation: desperation
despise: despise,despised
despond: despond
despondency: despondency
despot: despot
destination: destination
destine: destined
destiny: destiny
destitute: destitute
destroy: destroy,destroyed,destroying
destruction: destruction
detach: detach,detached
detached: detached
detain: detain
detainer: detainer
detect: detect,detected
detention: detention
deterioration: deterioration
determination: determination
determine: determine,determined
determined: determined
detest: detest,detested,detests
detestable: detestable
detestably: detestably
detestation: detestation
deuce: deuce
devastate: devastate
devastation: devastation
devil: devil
devilish: devilish
devoid: devoid
devotedly: devotedly
devotion: devotion
devour: devour,devoured,devouring
dew: dew
dewy: dewy
diabolical: diabolical
diamond: diamond,diamonds
diary: diary
dice: dice
dictate: dictating
dictionary: dictionary
didst: didst
die: die,died,dies,dying
difference: difference
difficult: difficult
difficulty: difficulty
dig: dig,digging,dug
digest: digest
dignified: dignified
dignity: dignity
dilapidation: dilapidation
dilate: dilating
dilatory: dilatory
diligence: diligence
dim: dim,dimmed
diminish: diminishing
dimly: dimly
din: din,dins
dine: dine
dingy: dingy
dinner: dinner
dip: dip,dips
direct: direct,directed,directing,directs
direction: direction,directions
dirtily: dirtily
dirty: dirty
disadvantage: disadvantage,disadvantages
disagreeable: disagreeable
disagreeably: disagreeably
disagreement: disagreement,disagreements
disappear: disappeared
disappearance: disappearance
disappoint: disappoint,disappointed
disappointed: disappointed
disappointment: disappointment
disapprove: disapproved
disapprovingly: disapprovingly
disarm: disarm,disarmed
disarrange: disarrange
disarrangement: disarrangement
discard: discarded
discern: discerned,discerning
discerning: discerning
discharge: discharge,discharged
discipline: discipline
disclaim: disclaim
disclaimer: disclaimer,disclaimers
disclosure: disclosure
discomfited: discomfited
discomfiture: discomfiture
discontent: discontent
discontinue: discontinue
discord: discord
discourse: discourse
discoursing: discoursing
discover: discover,discovered,discovering
discoverer: discoverer
discovery: discovery
discreet: discreet
discretion: discretion
discuss: discussed,discussing
discussion: discussion
disdain: disdaining
disdainfully: disdainfully
disease: disease
disenchanted: disenchanted
disengage: disengage,disengaged
disgrace: disgrace,disgraces
disgraceful: disgraceful
disguise: disguise,disguised,disguising
disgust: disgust,disgusted
disgusted: disgusted
dish: dish,dishes
disinclined: disinclined
disk: disk
dislike: dislike,disliked,dislikes
dismal: dismal
dismally: dismally
dismiss: dismiss,dismissed,dismisses
dismissal: dismissal
dismount: dismount,dismounted,dismounting
disobedience: disobedience
disobey: disobey
disorder: disorder,disordered
disorderly: disorderly
disown: disown,disowned
disparagement: disparagement
disparity: disparity
dispatch: dispatch
dispel: dispel
displace: displaced
displacing: displacing
display: display,displayed,displaying,displays
displeasure: displeasure
disposal: disposal
dispose: disposed
disposed: disposed
disposition: disposition,dispositions
disputant: disputant
dispute: dispute,disputed,disputes,disputing
disquietude: disquietude
disregard: disregard,disregarded,disregarding
disrelish: disrelish
disrespect: disrespect
dissent: dissented
dissimilar: dissimilar
dissipation: dissipation
dissolve: dissolve,dissolved,dissolving
distance: distance
distant: distant
distasteful: distasteful
distinct: distinct
distinction: distinction
distinctly: distinctly
distinguish: distinguish,distinguished
distinguishable: distinguishable
distort: distorted
distorted: distorted
distract: distract,distracted
distraction: distraction
distraught: distraught
distress: distress,distressed,distresses
distressed: distressed
distressing: distressing
distribute: distribute,distributed,distributing
distribution: distribution
distributor: distributor
district: district
disturb: disturb,disturbed,disturbing
disturbance: disturbance
disturbed: disturbed
disturber: disturber
diurnal: diurnal
dive: dived
diversion: diversion,diversions
divert: divert,diverted,diverting
divested: divested
divide: divide,divided,dividing
divine: divine,divined
division: division
dizzily: dizzily
dizzy: dizzy
doctor: doctor
document: documents
dog: dog,dogs
dogged: dogged
doggedly: doggedly
doleful: doleful
dolefully: dolefully
doll: doll
domain: domain
domestic: domestic,domestics
domineer: domineer
domineering: domineering
donate: donate
donation: donation,donations
donor: donors
doom: doomed
door: door,doors
doorway: doorway
dose: dose
dot: dot,dots,dotted
dote: dote,doted,dotes
double: double
doubt: doubt,doubted,doubting,doubts
doubtfully: doubtfully
doubtingly: doubtingly
doubtless: doubtless
dour: dour
dove: dove
downcast: downcast
download: downloading
downmost: downmost
downright: downright
downstairs: downstairs
doze: doze,dozed,dozing
dozen: dozen
drag: drag,dragged,dragging
drapery: drapery
draught: draughts
draw: draw,drawing,drawn,drew
drawer: drawer,drawers
drawing: drawing
drawl: drawled,drawling
dread: dread,dreaded,dreading
dreadful: dreadful
dreadfully: dreadfully
dream: dream,dreaming,dreams,dreamt
dreamily: dreamily
dreamy: dreamy
dreary: dreary
dree: dree
drench: drench,drenched
dress: dress,dressed,dressing
dressed: dressed
dresser: dresser
dressing: dressing
drift: drifts
drink: drank,drink,drinking
drinking: drinking
drip: dripped,dripping
drive: drive,driven,driving,drove
driving: driving
drizzle: drizzle
droll: droll
drop: drop,dropped,dropping,drops
drown: drowned
drowsily: drowsily
drowsiness: drowsiness
drowsy: drowsy
drunk: drunk
dry: dried,drier,dry,drying
duck: duck
dull: dull,duller
duly: duly
dumb: dumb
dunce: dunce
dungeon: dungeon
dunnock: dunnock
duration: duration
dusk: dusk
dusky: dusky
dust: dust
duster: duster,dusters
dusting: dusting
dutiful: dutiful
duty: duties,duty
dwarf: dwarf
dwell: dwell,dwelling,dwelt
dwelling: dwelling
dwindle: dwindling
eager: eager
eagerly: eagerly
eagerness: eagerness
ear: ear,ears
earn: earn,earned,earning
earnest: earnest
earnestly: earnestly
earnestness: earnestness
earshot: earshot
earth: earth
earthenware: earthenware
earthly: earthly
earthy: earthy
ease: ease
easily: easily
east: east
easter: easter
easy: easy
eat: ate,eat,eaten,eating,eats
eatable: eatable
eating: eating
eavesdropper: eavesdropper,eavesdroppers
eccentric: eccentric
echo: echo,echoed
ecstasy: ecstasy
edgar: edgar
edge: edge,edged,edges
edged: edged
edition: edition,editions
education: education
educational: educational
een: een
effectually: effectually
effeminate: effeminate
efficient: efficient
efficiently: efficiently
effort: effort,efforts
eft: eft
egg: egg,eggs
egotism: egotism
egress: egress
eighteen: eighteen
ejaculate: ejaculated,ejaculating
ejaculation: ejaculation,ejaculations
elapse: elapsed
elastic: elastic
elation: elation
elbow: elbow,elbows
eld: elder
elder: elder
elderly: elderly
elect: elect
electric: electric
electronic: electronic
electronically: electronically
elegance: elegance
elegancy: elegancies
elegant: elegant
elevate: elevate
elevated: elevated
elevation: elevation
elf: elf
elicit: elicit
ellen: ellen
eloquence: eloquence
eloquent: eloquent
eloquently: eloquently
elysium: elysium
em: ems
email: email
embalm: embalming
embarrassed: embarrassed
embarrassing: embarrassing
embarrassment: embarrassment
embellishment: embellishment
ember: embers
embody: embodies
embrace: embrace,embracing
embrown: embrowned
emerge: emerge,emerging
emily: emily
emissary: emissaries
emotion: emotion
emperor: emperor
emphasis: emphasis
emphatically: emphatically
employ: employed,employing
employee: employee,employees
employer: employer,employers
employment: employment,employments
empower: empower
emulate: emulated
emulous: emulous
enable: enable,enabled
enact: enacted
enchanting: enchanting
enclose: enclosed
encode: encoding
encompass: encompassed
encounter: encounter,encountered,encountering
encourage: encourage,encouraged,encouraging
encouragingly: encouragingly
encroach: encroached
endearment: endearment
endeavour: endeavour,endeavoured,endeavouring
endless: endless
endurable: endurable
endurance: endurance
endure: endure,endured,enduring
enemy: enemies,enemy
energetically: energetically
energy: energies,energy
eneugh: eneugh
engage: engage,engaged,engaging
engagement: engagement
england: england
english: english
engrossing: engrossing
enigmatical: enigmatical
enjoy: enjoy,enjoying
enjoyment: enjoyment,enjoyments
enlarge: enlarge
enlighten: enlightened,enlightening
enlist: enlisted
enormous: enormous
enow: enow
enrage: enraged
enraged: enraged
ensconce: ensconcing
ensue: ensued
ensure: ensure,ensuring
entangled: entangled
enter: enter,entered,entering,enters
entertain: entertain,entertained,entertains
entertainer: entertainer
entertaining: entertaining
entertainment: entertainment
entice: entice,enticed
entire: entire
entity: entity
entrails: entrails
entrance: entrance
entreat: entreated,entreating
entreaty: entreaties,entreaty
entrust: entrust
envious: envious
envy: envied,envy,envying
epistle: epistle,epistles
epithet: epithet
equal: equal,equalled
equality: equality
equally: equally
equanimity: equanimity
equip: equipping
equipment: equipment
erase: erase
ere: ere
erect: erect,erected,erecting
err: erred
errand: errand,errands
error: error,errors
escape: escape,escaped,escaping
escort: escort,escorted
espionage: espionage
essay: essay,essayed
essence: essence
establish: establish,established
establishment: establishment
estate: estate,estates
esteem: esteem,esteemed
esteemed: esteemed
estimate: estimating
eternal: eternal
eternally: eternally
eternity: eternity
evaporate: evaporated
evasive: evasive
eve: eve
evening: evening,evenings
event: event,events
everyday: everyday
evidence: evidence
evident: evident
evidently: evidently
evil: evil
evince: evince,evinced,evincing
exact: exact,exacting
exaggerate: exaggerate,exaggerated
exaggerated: exaggerated
exaggeratedly: exaggeratedly
exalt: exalting
examination: examination
examine: examine,examined,examining
exasperate: exasperate,exasperating
exceed: exceeded,exceeding
exceedingly: exceedingly
excellency: excellencies
excellent: excellent
excellently: excellently
exception: exception
excess: excess
excessive: excessive
exchange: exchange,exchanged,exchanging
excite: excite,excited
excited: excited
excitement: excitement
exciting: exciting
exclaim: exclaim,exclaimed,exclaiming
exclamation: exclamation
exclude: exclude,excluded
exclusion: exclusion
excommunicate: excommunicated
excursion: excursion,excursions
excuse: excuse,excused
execrate: execrated
execration: execrations
execute: execute,executed
execution: execution
exempt: exempt
exercise: exercise
exert: exerted,exerting
exertion: exertions
exhaust: exhausted,exhausting
exhausted: exhausted
exhaustion: exhaustion
exhibit: exhibit,exhibited,exhibiting
exhibition: exhibition
exile: exile
exist: exist,existed,exists
existence: existence
exit: exit
exotic: exotic
expand: expanded,expanding
expansive: expansive
expect: expect,expected,expecting,expects
expectation: expectation,expectations
expedient: expedient
expedition: expedition,expeditions
expeditiously: expeditiously
expend: expend
expense: expense,expenses
expensive: expensive
experience: experience,experienced
experienced: experienced
experiment: experiments
expire: expire,expiring
explain: explain,explained,explaining
explanation: explanation,explanations
explode: explode,exploded
explosion: explosion
export: exporting
expose: exposed,exposing
expostulate: expostulated,expostulating
expostulation: expostulations
express: express,expressed,expressing
expression: expression,expressions
expressive: expressive
exquisite: exquisite
extend: extended
extent: extent
exterior: exterior
external: external
extinct: extinct
extinguish: extinguish,extinguished,extinguishing
extinguisher: extinguisher
extort: extorted
extra: extra
extract: extract
extraordinary: extraordinary
extreme: extreme,extremes
extremely: extremely
extremity: extremities,extremity
extricate: extricate
exuberance: exuberance
exult: exulting
exultation: exultation
eye: eye,eyeing,eyes
eyed: eyed
eyesight: eyesight
fabulous: fabulous
facial: facial
facility: facility
faculty: faculties,faculty
fade: faded,fading
fagot: fagots
fail: fail,failed,failing
failing: failings
failure: failure
fain: fain
faint: faint,fainted
fair: fair
fairy: fairies,fairy
faith: faith
faithful: faithful
faithfully: faithfully
fall: fall,fallen,falling,falls,fell
fallen: fallen
falls: falls
false: false
falsehood: falsehood,falsehoods
familiar: familiar
familiarity: familiarity
family: family
famous: famous
fancied: fancied
fanciful: fanciful
fancy: fancied,fancies,fancy,fancying
fang: fangs
fanny: fanny
fantastic: fantastic
farm: farm,farming
farmer: farmer
farmhouse: farmhouse
farming: farming
farthing: farthing
fascinating: fascinating
fascination: fascination
fashion: fashion
fashioned: fashioned
fast: fast,fasted,faster
fasten: fasten,fastened,fastening
fastidiousness: fastidiousness
fasting: fasting
fat: fat
fate: fate,fated
father: father,fathers
fatherless: fatherless
fatigue: fatigue
fatigued: fatigued
fault: fault,faults
favour: favour,favoured,favours
favourable: favourable
favourite: favourite
fawn: fawn,fawning
fear: fear,feared,fearing,fears
fearful: fearful
fearfully: fearfully
fearless: fearless
feast: feast
feather: feather,feathers
feathered: feathered
feathery: feathery
feature: feature,features
featured: featured
february: february
federal: federal
fee: fee,fees
feeble: feeble
feebleness: feebleness
feebly: feebly
feed: fed,feed,feeding
feel: feel,feeling,feels
feeling: feeling,feelings
feign: feigned,feigning
fellow: fellow,fellows
fellowship: fellowship
felony: felony
female: female,females
fence: fence
fend: fend
fender: fender
ferocious: ferocious
ferociously: ferociously
ferocity: ferocity
ferret: ferret
fertile: fertile
fervently: fervently
fervour: fervour
festoon: festoons
fetch: fetch,fetched,fetches,fetching
fetcher: fetcher
feud: feud
fever: fever,fevers
feverish: feverish
fickleness: fickleness
fiddle: fiddle
fidget: fidgeting
fie: fie
field: field,fields
fiend: fiend,fiends
fiendish: fiendish
fierce: fierce,fiercer,fiercest
fiercely: fiercely
fiery: fiery
fight: fight,fighting,fought
figuratively: figuratively
figure: figure,figures
file: file,files
filial: filial
final: final
finally: finally
financial: financial
finding: finding
fine: fine,finer,finest
finger: finger,fingers
finish: finish,finished,finishing
fir: fir,firs
fireplace: fireplace
fireside: fireside
firm: firm,firmer
firmly: firmly
firstly: firstly
fist: fist,fists
fit: fit,fits,fitted
fitness: fitness
fixture: fixture
flag: flagged,flags
flake: flakes
flame: flame,flames,flaming
flap: flapping
flash: flash,flashed,flashing
flat: flatter
flatly: flatly
flatness: flatness
flatter: flattered
flattered: flattered
flattering: flattering
flattery: flattery
flaxen: flaxen
flay: flaying
flee: flee,flees
fleecy: fleecy
flesh: flesh
flight: flight,flighted,flights
flighty: flighty
flinch: flinched
fling: fling,flinging,flings,flung
flint: flint
flinty: flinty
flippant: flippant
flit: flit,flitting
float: floating
flock: flock
flog: flog,flogged,flogging
flood: flooding
floor: floor
flounder: floundered
flour: flour
flourish: flourishing
flow: flow,flowed,flows
flower: flower,flowers
fluent: fluent
flurried: flurried
flurry: flurried,flurry
flush: flushed
flutter: fluttered,fluttering
fly: flew,flies,flown,fly,flying
foam: foamed
foe: foe,foes
foil: foil
fold: fold,folded,folds
foliage: foliage
folk: folk,folks
follow: follow
follower: followers
folly: folly
fond: fond,fonder,fondest
fondle: fondling
fondling: fondling
fondness: fondness
food: food
fool: fool,fools
foolish: foolish
foolishly: foolishly
foolishness: foolishness
foot: feet,foot
footed: footed
footing: footing
footman: footman
footmark: footmarks
footstep: footstep,footsteps
footstool: footstool
forbear: forbearing
forbearance: forbearance
forbid: forbid,forbidden,forbidding,forbids
force: force,forced,forces,forcing
forcibly: forcibly
foreboding: forebodings
forebodingly: forebodingly
forego: forego
forehead: forehead
foreign: foreign
foreigner: foreigners
foremost: foremost
foresee: foresee
foresight: foresight
forge: forged
forget: forget,forgets,forgetting,forgot,forgotten
forgetful: forgetful
forgetfulness: forgetfulness
forgie: forgie
forgive: forgive,forgiven
forgiveness: forgiveness
fork: fork,forks
forlorn: forlorn
form: form,formed,forming,forms
formal: formal
formally: formally
format: format,formats
forrard: forrard
forsake: forsake,forsaken
forthwith: forthwith
fortnight: fortnight
fortunate: fortunate
fortunately: fortunately
fortune: fortune,fortunes
foster: foster,fostered
foul: foul
foundation: foundation
fourteen: fourteen
fourth: fourth
fowling: fowling
fox: fox
fraction: fractions
fragile: fragile
fragment: fragments
fragrance: fragrance
fragrant: fragrant
frail: frail
frame: frame,framed,framing
frances: frances
frank: frank
frankly: frankly
frantic: frantic
fraternal: fraternal
freely: freely
freeze: frozen
french: french
frenzied: frenzied
frenzy: frenzy
frequent: frequent
frequently: frequently
fresh: fresh,fresher
fret: fret,frets,fretted,fretting
fretful: fretful
fretfully: fretfully
friday: friday
friend: friend,friends
friendless: friendless
friendlessness: friendlessness
friendly: friendly
friendship: friendship
fright: fright
frighten: frighten,frightened,frightens
frightened: frightened
frightening: frightening
frightful: frightful
fringe: fringes
fritter: frittering
frivolous: frivolous
fro: fro
frock: frock
frost: frost
frosty: frosty
froth: frothing
frough: frough
frown: frown,frowned,frowning
frowning: frowning
fruit: fruit
frying: frying
fugitive: fugitives
fulfil: fulfil,fulfilled,fulfilling
fulfilment: fulfilment
fulness: fulness
fun: fun
funeral: funeral
fungus: fungus
funny: funny
fur: fur,furs
furious: furious
furiously: furiously
furnace: furnace
furnish: furnish,furnished
furniture: furniture
furred: furred
fury: fury
furze: furze
future: future
gable: gable
gad: gadding
gaily: gaily
gain: gain,gained,gaining
gait: gait
gaiter: gaiters
gall: gall
gallon: gallon
gallop: gallop,galloped,galloping,gallops
galloway: galloway
gallows: gallows
game: game
gaming: gaming
gang: gang,ganging,gangs
gaoler: gaoler
gap: gap,gaps
gape: gaping
gapingly: gapingly
garb: garb
garden: garden,gardens
gardener: gardeners
garment: garment,garments
garret: garret,garrets
gasp: gasp,gasped,gasping
gate: gate,gates
gather: gather,gathered,gathering,gathers
gathering: gathering
gaudily: gaudily
gauge: gauged
gaumless: gaumless
gaunt: gaunt
gauze: gauze
gay: gay
gaze: gaze,gazed,gazing
generality: generality
generation: generations
generosity: generosity
generous: generous
generously: generously
genial: genial
genius: genius
gentle: gentle
gentleman: gentleman
gentlemanly: gentlemanly
gentleness: gentleness
gently: gently
gentry: gentry
genuine: genuine
ghastly: ghastly
ghost: ghost,ghosts
ghostly: ghostly
ghoul: ghoul
ghoulish: ghoulish
gibberish: gibberish
giddiness: giddiness
giddy: giddy
gie: gie,gies
gift: gift,gifts
giggle: giggled
gin: gin
gingerbread: gingerbread
gipsy: gipsy
girl: girl,girls
girlhood: girlhood
girlish: girlish
girn: girn,girning
girned: girned
girt: girt
glad: glad
gladden: gladdened
gladly: gladly
gladness: gladness
glance: glance,glanced,glances,glancing
glare: glare,glared
glaring: glaring
glaringly: glaringly
glass: glass
gleam: gleam,gleamed
glee: glee,glees
gleefully: gleefully
glen: glen,glens
glide: glided,gliding
glimmer: glimmered
glimpse: glimpse,glimpses
glint: glinting
glisten: glisten
glitter: glitter,glittering
gloom: gloom
gloomy: gloomy
glorious: glorious
glory: glories,glory
glossy: glossy
glove: gloves
glow: glow,glowed,glowing
glower: glowered
glowing: glowing
gnarl: gnarl
gnash: gnash,gnashed
goa: goa
goad: goaded
goal: goal,goals
goan: goan
goblin: goblin,goblins
god: god
goddess: goddess
godless: godless
gold: gold
golden: golden
goodness: goodness
goose: goose
gooseberry: gooseberry
gospel: gospel
gossip: gossip,gossiping
gouge: gouge
govern: govern
gown: gown
grace: grace
graceful: graceful
graceless: graceless
gracious: gracious
gradual: gradual
gradually: gradually
grain: grain
grand: grand,grandest
grange: grange
grant: grant,granted
grapple: grappling
grasp: grasp,grasped,grasping,grasps
grass: grass
grassy: grassy
grat: grat
grate: grate,grated,grates
grateful: grateful
gratefully: gratefully
gratification: gratification
gratified: gratified
gratify: gratified
gratitude: gratitude
grave: grave,graver,graves
gravely: gravely
gravestone: gravestones
gravity: gravity
graze: graze,grazed
greatly: greatly
greedy: greedy
greek: greek
green: green
greet: greet
greeting: greeting
grey: grey,greyer
greyhound: greyhound
grief: grief,griefs
grievance: grievance
grieve: grieve,grieved
grieving: grieving
grievous: grievous
grievously: grievously
griffin: griffins
grim: grim
grimace: grimace,grimaces
grimalkin: grimalkin
grimly: grimly
grin: grin,grinned,grinning
grind: grind,grinding,grinds
gripe: gripe
groan: groan,groaned,groaning
groom: grooms
grope: groped
gross: gross
grotesque: grotesque
ground: ground
grounds: grounds
grouse: grouse
grovel: grovel,grovelled
grow: grew,grow,growing,grown,grows
growl: growled,growling
growth: growth
grudge: grudge,grudged
gruel: gruel
gruff: gruff
gruffly: gruffly
gruffness: gruffness
grumble: grumbled,grumbling
guard: guard,guarded,guarding,guards
guardian: guardian
guardianship: guardianship
guess: guess,guessed,guesses,guessing
guest: guest,guests
guffaw: guffaw
guidance: guidance
guide: guide,guided,guides
guiltily: guiltily
guiltless: guiltless
guilty: guilty
gullet: gullet
gun: gun,guns
gunpowder: gunpowder
gurgle: gurgling
gush: gush,gushed
gusto: gusto
gusty: gusty
guttural: guttural
ha: ha,hae
habit: habit,habits
habitual: habitual
habituate: habituated
hag: hag
haggard: haggard
haggardness: haggardness
hail: hailed,hailing
hair: hair
hairbreadth: hairbreadths
haired: haired
hairy: hairy
hale: hale
hall: hall
hallo: hallo,halloed
halloo: hallooed
halt: halt,halted,halting
ham: ham
hammer: hammer,hammers
hand: hand,handed,hands
handful: handful,handfuls
handiwork: handiwork
handkerchief: handkerchief
handle: handle
handsome: handsome,handsomest
handsomer: handsomer
hang: hang,hanged,hanging,hung
hanging: hanging
happen: happen,happened,happening
happily: happily
happiness: happiness
happy: happier,happiest,happy
harass: harass,harassed,harassing
harbour: harboured
hard: hard
harden: hardened
hardihood: hardihood
hardness: hardness
hardy: hardy
harebell: harebells
hark: hark
harm: harm,harmed,harming
harmless: harmless
harmlessly: harmlessly
harmonize: harmonized
harp: harped
harry: harried
harsh: harsh
harshness: harshness
hart: hart
harvest: harvest
hasp: hasped
haste: haste
hasten: hasten,hastened,hastening
hastily: hastily
hasty: hasty
hat: hat
hate: hate,hated,hates
hateful: hateful
hatless: hatless
hatred: hatred
haughty: haughtier,haughty
haunt: haunt,haunted,haunts
hause: hause
havoc: havoc
hay: hay
hayfield: hayfield
hazard: hazard,hazarding
hazel: hazel,hazels
hazy: hazy
head: head,headed,heads
headache: headache
headed: headed
headforemost: headforemost
headstone: headstone,headstones
headstrong: headstrong
health: health
healthy: healthier,healthy
heap: heap,heaped,heaping,heaps
hear: hear,heard,hearing
hearing: hearing
hearken: hearken
hearsay: hearsay
heart: heart,hearts
heartbroken: heartbroken
hearted: hearted
hearth: hearth
hearthstone: hearthstone
heartily: heartily
heartiness: heartiness
heartless: heartless
heartlessness: heartlessness
hearty: hearty
heat: heat
heath: heath
heathen: heathen
heathenism: heathenism
heather: heather
heating: heating
heave: heave,heaved
heaven: heaven,heavens
heaving: heaving
heavy: heavier,heaviest,heavy
hector: hector
hedge: hedge
heed: heed,heeding
heedless: heedless
heel: heels
heifer: heifers
height: height,heights
heights: heights
heir: heir,heirs
hellish: hellish
helmet: helmet
helpless: helpless
hem: hemmed
henceforth: henceforth
hend: hend
herb: herbs
hercules: hercules
herd: herd
heretofore: heretofore
hermit: hermit
hero: hero
heroine: heroine
herring: herrings
hesitate: hesitate,hesitated,hesitating
hesitatingly: hesitatingly
hesitation: hesitation
heterodox: heterodox
hey: hey
hidden: hidden
hide: hidden,hide
hideous: hideous
hieroglyphic: hieroglyphics
highly: highly
highway: highway,highways
hilarity: hilarity
hill: hill,hills
hillock: hillock,hillocks
hilly: hilly
hinder: hinder,hindered,hindering
hinge: hinges
hint: hint
hip: hips
hire: hired,hiring
history: history
hit: hit,hitting
hitherto: hitherto
hive: hive,hives
ho: ho
hoard: hoard
hoarse: hoarse
hoary: hoary
hob: hob
hold: held,hold,holding,holds
holder: holder
hole: hole,holes
holiday: holiday
hollow: hollow,hollows
hollowness: hollowness
holly: holly
holy: holier
homely: homely
homeward: homeward
homily: homily
honest: honest
honey: honey
honeymoon: honeymoon
honeysuckle: honeysuckles
honour: honour,honoured,honours
honourable: honourable
hook: hook
hoop: hoops
hope: hope,hoped,hopes,hoping
hopeful: hopeful
hopeless: hopeless
hopelessly: hopelessly
horizontal: horizontal
horizontally: horizontally
horn: horns
horrible: horrible
horrid: horrid
horrified: horrified
horror: horror
horse: horse,horses
horseback: horseback
hospitable: hospitable
host: host
hostess: hostess
hostile: hostile
hostility: hostilities,hostility
hot: hot,hottest
hound: hound
hour: hour,hours
house: house,houses
household: household
housekeeper: housekeeper
houseless: houseless
housewife: housewife
hovel: hovel
hover: hovered,hovering
howl: howl,howled
hubbub: hubbub
hue: hue
hug: hug,hugged
huge: huge
hum: humming
human: human
humanity: humanity
humiliation: humiliation
humility: humility
humour: humour,humoured,humouring,humours
humoured: humoured
humouring: humouring
hunger: hunger
hungry: hungry
hunt: hunting
hunter: hunter
hurl: hurl,hurled
hurried: hurried
hurriedly: hurriedly
hurry: hurried,hurry,hurrying
hurt: hurt
hurtful: hurtful
husband: husband,husbands
hush: hush
hypocrisy: hypocrisy
hypocrite: hypocrite
hysterical: hysterical
ice: ice
icicle: icicle
icily: icily
icy: icy
idea: idea,ideas
ideal: ideal
identification: identification
identify: identify
idiocy: idiocy
idiot: idiot,idiots
idiotic: idiotic
idle: idle
idleness: idleness
idol: idol,idols
ignoble: ignoble
ignominious: ignominious
ignorance: ignorance
ignorant: ignorant
iii: iii
illness: illness,illnesses
illumine: illumined
illusion: illusion,illusions
image: image
imaginable: imaginable
imaginary: imaginary
imagination: imagination
imagine: imagine,imagined,imagines,imagining
imbecile: imbecile
immeasurably: immeasurably
immense: immense
imminent: imminent
imminently: imminently
immolation: immolation
immortal: immortal
immovable: immovable
imp: imp,imps
impalpable: impalpable
impart: imparted,imparting
impassable: impassable
impatience: impatience
impatient: impatient
impatiently: impatiently
impel: impelled
imperceptibly: imperceptibly
imperfect: imperfect
imperious: imperious
imperiously: imperiously
impertinence: impertinence
impertinent: impertinent
implement: implements
implore: implore,implored,imploring
imploringly: imploringly
imply: implied,implying
import: import
importation: importation
importunate: importunate
importunately: importunately
importune: importuned
importunity: importunity
impose: impose,imposed
impossible: impossible
impracticable: impracticable
imprecation: imprecations
impress: impressed
impressed: impressed
impression: impression,impressions
imprison: imprisoned
improper: improper
improve: improve,improved,improving
improvement: improvement
impudence: impudence
impulse: impulse
inaccurate: inaccurate
inadequacy: inadequacy
inadequate: inadequate
inanimate: inanimate
inarticulate: inarticulate
inattention: inattention
inaudible: inaudible
incapability: incapability
incapable: incapable
incapacitated: incapacitated
incapacity: incapacity
incarnate: incarnate
incautiously: incautiously
incessantly: incessantly
inch: inch,inches
incident: incidents
incidental: incidental
incipient: incipient
incitement: incitement
inclination: inclination
incline: inclined
inclined: inclined
include: include,included,includes,including
including: including
incoherent: incoherent
income: income
incomparably: incomparably
incomplete: incomplete
incomprehensible: incomprehensible
inconsideration: inconsideration
inconvenience: inconvenience,inconvenienced
incorporeal: incorporeal
increase: increase,increased,increases,increasing
incredible: incredible
incredulous: incredulous
incur: incur
incurable: incurable
indefinite: indefinite
indemnify: indemnify
indemnity: indemnity
indentation: indentations
independent: independent
indian: indian
indication: indications
indicative: indicative
indies: indies
indifference: indifference
indifferent: indifferent
indigena: indigenae
indignant: indignant
indignantly: indignantly
indignation: indignation
indigo: indigo
indirect: indirect
indirectly: indirectly
indiscretion: indiscretion,indiscretions
indispensable: indispensable
indisposition: indisposition
indistinctly: indistinctly
individual: individual,individuals
indolence: indolence
indoor: indoor,indoors
indoors: indoors
induce: induced
indulge: indulge,indulged,indulging
indulgence: indulgence,indulgences
indulgent: indulgent
industry: industry
inefficient: inefficient
inexperienced: inexperienced
inexpressible: inexpressible
infamous: infamous
infancy: infancy
infant: infant
infantile: infantile
infatuate: infatuated
infatuated: infatuated
infatuation: infatuation
inferior: inferior
inferiority: inferiority
infernal: infernal
infernally: infernally
infinite: infinite
infinitely: infinitely
inflict: inflict,inflicted,inflicting
inflictor: inflictor
influence: influence
inform: inform,informed,informing
informant: informant
infringement: infringement
ingenious: ingenious
ingenuity: ingenuity
ingratitude: ingratitude
inhabit: inhabit
inhabitant: inhabitant,inhabitants
inherit: inherited
inhospitable: inhospitable
inhospitality: inhospitality
inhumanity: inhumanity
initiatory: initiatory
injudicious: injudicious
injunction: injunction,injunctions
injure: injure,injured
injury: injuries,injury
injustice: injustice,injustices
ink: ink
inmate: inmate,inmates
inn: inn
innate: innate
innocent: innocent
innuendo: innuendoes
innumerable: innumerable
inquire: inquire,inquired,inquiring
inquiry: inquiries,inquiry
inquisitive: inquisitive
inquisitively: inquisitively
inroad: inroads
insane: insane
insanity: insanity
inscribe: inscribed
inscription: inscription
insensible: insensible
insert: inserting
insipid: insipid
insist: insist,insisted,insisting
insolence: insolence
insolent: insolent
inspect: inspect,inspected,inspecting
inspection: inspection
inspector: inspector
inspiration: inspiration
install: install
instance: instance,instanced
instant: instant
instantaneously: instantaneously
instantly: instantly
instil: instil,instilled
instinct: instinct
instinctively: instinctively
instruct: instructed
instruction: instructions
instructor: instructors
instrument: instrument,instruments
insufferable: insufferable
insult: insult,insulted,insults
insure: insure
intellect: intellect
intellectual: intellectual
intelligence: intelligence
intelligent: intelligent
intelligible: intelligible
intend: intend,intended,intending
intense: intense,intensest
intensity: intensity
intent: intent
intention: intention,intentions
intently: intently
intentness: intentness
inter: interred
intercept: intercepted,intercepting
intercommunication: intercommunication
intercourse: intercourse
interdict: interdict
interfere: interfere,interfering
interference: interference
interim: interim
interior: interior
interloper: interloper
intermeddling: intermeddling
interment: interment
intermission: intermission
internal: internal
internally: internally
international: international
interpose: interpose,interposed
interpret: interpret,interpreted,interpreting
interpreter: interpreter
interrogatively: interrogatively
interrupt: interrupt,interrupted,interrupting
interrupted: interrupted
interruption: interruptions
intersperse: interspersed
interval: interval,intervals
interview: interview
intimacy: intimacy
intimate: intimate,intimated,intimating
intimately: intimately
intimation: intimation
intolerable: intolerable
intolerance: intolerance
intoxicated: intoxicated
intractable: intractable
introduce: introduce,introduced,introducing
introduction: introduction
introductory: introductory
intrude: intruded
intruder: intruder
intrusion: intrusion,intrusions
invade: invaded,invading
invalid: invalid
invalidity: invalidity
invariable: invariable
invariably: invariably
invent: invent,invented
invest: investing
inveterate: inveterate
invisible: invisible
invitation: invitation
invite: invited
invoke: invoked,invokes
involuntarily: involuntarily
involuntary: involuntary
involve: involving
irefully: irefully
irk: irks
irksome: irksome
iron: iron,ironed
ironing: ironing
irrational: irrational
irrationality: irrationality
irregular: irregular
irregularly: irregularly
irrepressible: irrepressible
irresistible: irresistible
irresistibly: irresistibly
irresolutely: irresolutely
irrevocably: irrevocably
irritable: irritable
irritate: irritating
irritated: irritated
irritation: irritation
irs: irs
isabel: isabel
isabella: isabella
island: island
isolation: isolation
issue: issue,issued,issuing
iteration: iteration
iv: iv
ix: ix
jacket: jacket
jade: jade
jailor: jailor
january: january
jargon: jargon
jaw: jaws
jealous: jealous
jealously: jealously
jealousy: jealousy
jenny: jenny
jerk: jerked,jerking
jest: jest
jesting: jesting
jet: jet
jewel: jewel
jock: jocks
john: john
joint: joint
joke: joke,joked,jokes
jonah: jonah
joseph: joseph
journey: journey,journeying,journeys
joy: joy
joyful: joyful
joyfully: joyfully
jubilee: jubilee
judas: judas
judge: judge,judged,judges,judging
judging: judging
judgment: judgment
judicious: judicious
jug: jug,jugs
july: july
jump: jump,jumped,jumping
jumping: jumping
june: june
junior: junior
juno: juno
justice: justice
justify: justified
justly: justly
jut: jutted,jutting
keen: keen
keeper: keeper
keeping: keeping
kennel: kennel
kenneth: kenneth
key: key
kick: kick,kicked,kicking,kicks
kicker: kicker
kidnap: kidnapped
kill: kill,killed,killing,kills
killing: killing
kin: kin
kindle: kindle,kindled,kindling
kindliness: kindliness
kindly: kindly
kindness: kindness
kindred: kindred
king: king
kingdom: kingdom,kingdoms
kinsman: kinsman
kirk: kirk
kirkyard: kirkyard
kiss: kiss,kissed,kisses,kissing
kitchen: kitchen
kitten: kitten
knack: knack
knave: knave
knaw: knaw
knee: knee,knees
kneel: kneel,kneeling,knelt
knife: knife,knives
knighthood: knighthood
knit: knitted
knitting: knitting
knock: knock,knocked,knocking,knocks
knot: knot,knotted
knowledge: knowledge
knuckle: knuckles
labour: labour,laboured,labouring,labours
labourer: labourer,labourers
lace: laced
lachrymose: lachrymose
lack: lack,lacked
laconic: laconic
lad: lad,lads
ladder: ladder
laden: laden
lady: lady
lair: lair
laith: laith
lake: lake
lamb: lamb,lambs
lame: lame,lamed
lament: lament,lamented,lamenting
lamentable: lamentable
lamentation: lamentation,lamentations
land: land,landed,lands
landing: landing
landlord: landlord
landmark: landmarks
landscape: landscape
lane: lane
lang: lang
language: language
languid: languid
lankly: lankly
lantern: lantern
lap: lap
laps: laps
lapse: lapse,lapsed
lapwing: lapwing,lapwings
larch: larch,larches
lark: larks
lascar: lascar
lash: lashes
lass: lass
latch: latch
late: late
lath: lath
latin: latin
latitude: latitude
lattice: lattice,lattices
laud: lauded
laugh: laugh,laughed,laughing,laughs
laughter: laughter
launch: launched
lave: lave
lavish: lavish,lavished,lavishing
law: law,laws
lawful: lawful
lawyer: lawyer
lay: laid,lay,laying
laziness: laziness
lazy: lazy
lead: lead,leading,leads,led
leaf: leaf,leaves
league: league,leagued
lean: lean,leaned,leaning,leant
leap: leap,leaped,leaping,leapt
leapt: leapt
lear: lear
learn: learn,learned,learning,learns,learnt
learning: learning
leave: leave,leaving,left
lecture: lecture,lectures
ledge: ledge
leech: leeches
lees: lees
left: left
leg: leg,legs
legal: legal
legally: legally
legged: legged
legion: legion,legions
legitimate: legitimate
leisure: leisure
leisurely: leisurely
lend: lend
lengthen: lengthened,lengthening
leniently: leniently
lesson: lesson,lessons
lethargy: lethargy
letter: letter,letters
level: level,levelled
lever: levers
leveret: leveret
levity: levity
liability: liability
liable: liable
liar: liar
liberal: liberal
liberally: liberally
liberate: liberated,liberating
liberated: liberated
liberty: liberties,liberty
library: library
license: license
licensed: licensed
lick: licking
lid: lid,lids
lie: lain,lie,lies,lying
lieu: lieu
life: life,lives
lifeless: lifeless
lifetime: lifetime
lift: lift,lifted,lifting
lig: lig
light: light,lighted,lighter,lightest,lighting,lights,lit
lighted: lighted
lighten: lightened,lightening
lightly: lightly
lightning: lightning
likeness: likeness
liker: liker
likes: likes
likker: likker
lilac: lilac
lilting: lilting
limb: limb,limbs
lime: lime
limit: limit,limited,limits
limitation: limitation
limited: limited
limp: limping
lineage: lineage
linen: linen
ling: ling
linger: linger,lingered,lingering
link: linked,links
linnet: linnets
lip: lip,lips
liquid: liquid
lisping: lisping
listen: listen,listened,listening
listener: listener
listless: listless
listlessness: listlessness
literally: literally
literary: literary
litter: litter
live: live,lived,lives,living
liveliness: liveliness
lively: lively
liver: liver
liverpool: liverpool
livid: livid
living: living
lo: lo
load: loading
loaded: loaded
lobby: lobbies,lobby
locality: locality
locate: located
location: locations
lock: lock,locked,locking,locks
locket: locket
lodge: lodge,lodged
lodging: lodging
lodgings: lodgings
loft: loft
london: london
loneliness: loneliness
lonely: lonelier,lonely
longing: longing
looker: looker
loop: looped
looping: looping
loose: loose,loosed
loosen: loosen,loosened
lord: lord
lore: lore
lose: lose,loses,losing,lost
loss: loss,losses
lost: lost
lot: lot,lots
loth: loth
lottery: lottery
loud: loud,louder
lounge: lounged
lounging: lounging
love: love,loved,loves,loving
lovely: lovely
lover: lover,lovers
loving: loving
loyal: loyal
luck: luck
luckily: luckily
luckless: luckless
lucky: lucky
lug: lug,lugs
lull: lull
lumber: lumber
lump: lumps
lunatic: lunatic
lung: lungs
lurk: lurk,lurked,lurking,lurks
lustre: lustre
lusty: lusty
luxuriant: luxuriant
luxury: luxury
machine: machine
mad: mad,madder
madam: madam
madden: maddening
maddening: maddening
madling: madling
madman: madman
madness: madness
magically: magically
magisterial: magisterial
magistrate: magistrate
magnanimity: magnanimity
magpie: magpie
maid: maid,maids
maiden: maiden
main: main
maintain: maintained,maintaining,maintains
maintenance: maintenance
maist: maister
maister: maister
maker: maker
malady: malady
male: male
malefactor: malefactors
malevolence: malevolence
malice: malice
malignant: malignant
malignantly: malignantly
malignity: malignity
malt: malt
mamma: mamma
manage: manage,managed
management: management
manager: manager
mane: mane
manger: manger
manhood: manhood
mania: mania
maniac: maniac
manifest: manifested
manifestation: manifestation,manifestations
manly: manly
manner: manner
manners: manners
mantle: mantle
manual: manual
manuscript: manuscript
mar: marred
march: march,marched,marching
mare: mare
mark: mark,marked,marking,marks
marked: marked
marred: marred
marriage: marriage
married: married
marry: married,marry,marrying
marrying: marrying
marsh: marsh,marshes
martyr: martyrs
marvel: marvel,marvelled,marvelling
marvellous: marvellous
marvellously: marvellously
mary: mary
mass: mass,masses
master: master,masters
mat: mat
match: match,matches
mate: mate
material: material,materials
matronly: matronly
matter: matter,matters
matthew: matthew
mattock: mattocks
mattress: mattress
mature: mature
maturity: maturity
mawkish: mawkish
maxillary: maxillary
maximum: maximum
meadow: meadow
meal: meal,meals
meaning: meaning
measles: measles
measure: measure,measured,measures,measuring
meat: meat
meddle: meddle,meddling
mediation: mediation
medical: medical
medicine: medicine,medicines
meditate: meditate,meditated,meditating
meditation: meditation,meditations
meditative: meditative
medium: medium
meek: meek
meet: meet,meeting,meets,met
meeterly: meeterly
meeting: meeting
melancholy: melancholy
mell: mells
mellow: mellow
melt: melt,melted,melting
memorandum: memoranda
memory: memories,memory
menace: menaced
mend: mend,mended,mending
mental: mental
mentally: mentally
mention: mention,mentioned,mentioning,mentions
merchant: merchant
merchantability: merchantability
mercy: mercy
mere: mere,merest
merit: merit,merited
merrily: merrily
merriment: merriment
merry: merry
mess: mess
message: message
messenger: messenger
method: method,methods
methodist: methodist
methodists: methodists
mew: mew
michael: michael
michaelmas: michaelmas
middle: middle
midnight: midnight
midst: midst
mightily: mightily
mighty: mighty
migrate: migrated
mild: mild
mildew: mildewed
mildness: mildness
mile: mile,miles
milk: milk,milking
miller: miller
milo: milo
mim: mim
mince: mincing
mind: mind,minded,minding,minds
minded: minded
mingle: mingled
minister: minister,ministering
minny: minny
minor: minor
minute: minute,minutes
minutely: minutely
minx: minx
mire: mire
mirror: mirror
mirth: mirth
misanthropical: misanthropical
misanthropist: misanthropist,misanthropists
misbehaviour: misbehaviour
mischief: mischief
mischievous: mischievous
miscreant: miscreants
misdoubting: misdoubting
miser: miser
miserable: miserable
misery: miseries,misery
misfortune: misfortune,misfortunes
misgiving: misgivings
misguided: misguided
misplace: misplaced
mispronunciation: mispronunciations
missile: missile
mission: mission
missis: missis
mississippi: mississippi
missive: missive
missy: missy
mist: mist
mistake: mistake,mistakes,mistaking
mistaken: mistaken
mistress: mistress
mistrust: mistrusting
misty: misty
misunderstand: misunderstood
misuse: misused
mitch: mitch
mither: mither
mitigate: mitigated,mitigating
mix: mixed
mixture: mixture
moan: moan,moaned,moaning,moans
mock: mock,mocking
mockery: mockery
mode: mode
model: model,modelled
moderate: moderate
modern: modern
modification: modification
modify: modified
moist: moist
moisture: moisture
molest: molest
moment: moment,moments
momentary: momentary
monday: monday
money: money
monkey: monkey
monomania: monomania
monopolise: monopolised,monopolising
monotonous: monotonous
monster: monster,monsters
month: month,months
monument: monument
mood: mood,moods
moodily: moodily
moody: moody
mool: mools
moon: moon,moons
moonbeam: moonbeam
moonlight: moonlight
moor: moor,moors
mope: moped
moral: moral
moralising: moralising
morally: morally
morbid: morbid
morn: morn
morning: morning
morose: morose
moroseness: moroseness
morrow: morrow
morsel: morsel,morsels
mortal: mortal
mortally: mortally
mortgage: mortgaged
mortgagee: mortgagee
mortification: mortification
mortified: mortified
mortify: mortifying
moss: moss
mossy: mossy
moth: moths
mother: mother
motion: motion,motioned,motioning
motionless: motionless
motive: motive,motives
mould: mould
mound: mound,mounds
mount: mount,mounted,mounting,mounts
mourn: mourn,mourned,mourning
mourner: mourner,mourners
mournful: mournful
mournfully: mournfully
mourning: mourning
mouse: mice,mouse
mouth: mouth
mouthed: mouthed
mouthful: mouthful
moveable: moveable
movement: movement,movements
mucky: mucky
mud: mud
mule: mule
mull: mulled
multiply: multiply
multitude: multitude,multitudes
mumble: mumbled
mumbling: mumbling
mummy: mummy
mun: mun
munch: munching
munificent: munificent
murder: murder,murdered
murderer: murderer,murderers
murderess: murderess
murderous: murderous
murmur: murmur,murmured,murmuring
murmured: murmured
murther: murthering
muscle: muscles
muse: muse,mused,musing
music: music
musical: musical
musing: musing
musingly: musingly
muster: mustered,mustering
musty: musty
mute: mute
mutely: mutely
mutter: mutter,muttered,muttering
muttering: muttering
mutton: mutton
mutual: mutual
mysterious: mysterious
mystery: mysteries,mystery
nab: nab
nail: nails
naked: naked
nameless: nameless
nap: nap
narrative: narrative
narrator: narrator
narrow: narrow
nasty: nasty
native: native
natural: natural
naturally: naturally
nature: nature
natured: natured
naught: naught
naughtiness: naughtiness
naughty: naughty
nausea: nausea
nearer: nearer
neat: neat
neatly: neatly
necessity: necessities,necessity
neck: neck
neckerchief: neckerchief
needful: needful
needle: needles
needless: needless
neglect: neglect,neglected,neglecting
negligence: negligence
negligent: negligent
negotiate: negotiated
negus: negus
neighbour: neighbour,neighbours
neighbourhood: neighbourhood
nell: nell
nelly: nelly
nephew: nephew,nephews
nerve: nerve,nerves
nerveless: nerveless
nervous: nervous
nervously: nervously
nervousness: nervousness
nest: nest,nests
nestle: nestling
network: network
newly: newly
news: news
newsletter: newsletter
nice: nice,nicer,nicest
nicely: nicely
nicety: nicety
nick: nick
nigh: nigh
night: night,nights
nightmare: nightmare
nimbly: nimbly
ninny: ninny
nip: nip
noa: noa
noah: noah
nobbut: nobbut
nobility: nobility
noble: noble
nod: nod,nodded,nodding
noise: noise,noises
noiselessly: noiselessly
noisily: noisily
noisy: noisy
nonproprietary: nonproprietary
nonsense: nonsense
nook: nook
noon: noon
north: north
norther: norther
northern: northern
nose: nose
nostril: nostril,nostrils
notable: notable
note: note,notes,noting
notice: notice,noticed,noticing
notify: notifies
notion: notion,notions
nought: nought
nourish: nourish
nourishment: nourishment
novelty: novelty
november: november
nowt: nowt
nudge: nudged
nuisance: nuisance
numerous: numerous
nurse: nurse,nursed,nursing
nursery: nursery
nursing: nursing
nursling: nursling
nurture: nurture
nut: nut
oak: oak,oaks
oat: oat
oatcake: oatcakes
oath: oath,oaths
oatmeal: oatmeal
oats: oats
obdurate: obdurate
obedient: obedient
obey: obey,obeyed,obeying,obeys
object: object,objected,objects
objection: objection,objections
obligation: obligation
oblige: oblige,obliged
obliterate: obliterated
oblivion: oblivion
obscure: obscure
obscurely: obscurely
obscurity: obscurity
observable: observable
observation: observation,observations
observe: observe,observed,observing
obsolete: obsolete
obstacle: obstacle
obstinacy: obstinacy
obstinate: obstinate
obstinately: obstinately
obtrusive: obtrusive
obviate: obviate
obvious: obvious
occasion: occasion,occasioned,occasions
occupant: occupant,occupants
occupation: occupation,occupations
occupied: occupied
occupy: occupied,occupy
occur: occur,occurs
occurrence: occurrence
ocean: ocean
october: october
odd: odd
oddly: oddly
odious: odious
odour: odour
offence: offence
offend: offend,offended,offending
offended: offended
offer: offer,offered,offering,offers
offering: offering
office: office
official: official
offspring: offspring
oftener: oftener
oho: oho
oil: oil
omen: omen
ominous: ominous
omit: omit
online: online
ony: ony
openly: openly
operation: operation
opinion: opinion
opponent: opponent
opportunely: opportunely
opportunity: opportunities,opportunity
oppose: oppose,opposed
opposition: opposition
oppression: oppression
oppressive: oppressive
oppressor: oppressor
orange: orange,oranges
ordinary: ordinary
organize: organized
origin: origin
original: original
originally: originally
originator: originator
orison: orison,orisons
ornament: ornament,ornamented
ornamented: ornamented
orphan: orphan
ostler: ostler
ousel: ousels
outcast: outcast
outcry: outcry
outdated: outdated
outdoor: outdoor
outer: outer
outlive: outlive
outmatch: outmatched
outrage: outrage
outrageous: outrageous
outright: outright
outstrip: outstripped
outward: outward
outweigh: outweighs
outwork: outworks
oven: oven
overcast: overcast
overcome: overcame,overcome,overcoming
overdo: overdone
overflow: overflowing
overforwardly: overforwardly
overhead: overhead
overhear: overhear,overheard,overhearing
overlay: overlaid
overlook: overlook,overlooked
overpass: overpass
overreach: overreach
overtake: overtaking
overwhelm: overwhelmed
overwhelmed: overwhelmed
owd: owd
owe: owe,owed,owes
owner: owner,owners
owt: owt
oyster: oyster
pace: pace,paced
pacify: pacified,pacify
pacing: pacing
pack: pack
pail: pail
pain: pain,pains
pained: pained
painful: painful
painfully: painfully
paint: paint,painted,painting
pair: pair
palace: palace
palaver: palaver
pale: pale
paleness: paleness
palm: palms
paltry: paltry
pan: pan
pane: pane,panes
panel: panelled,panels
panelled: panelled
pang: pang
pant: panted
panting: panting
papa: papa
paper: paper,papered,papers
paperwork: paperwork
paradise: paradise
paragon: paragon
paragraph: paragraph,paragraphs
pardon: pardon
pardonable: pardonable
pare: pared
parent: parent,parents
parentage: parentage
paring: parings
parish: parish
park: park
parlour: parlour,parlours
paroxysm: paroxysm
parry: parrying
parson: parson
partake: partake,partook
partial: partial
partiality: partiality
partially: partially
partly: partly
partner: partner
partook: partook
party: parties,party
pass: pass,passed,passes,passing
passage: passage,passages
passion: passion
passionate: passionate
passionately: passionately
passionless: passionless
passive: passive
pastor: pastor
pat: patted
paternal: paternal
paternity: paternity
path: path,paths
pathos: pathos
patience: patience
patient: patient
patiently: patiently
patriarch: patriarchs
patter: pattering
pattern: pattern
paul: paul
pause: pause,paused,pausing
pave: paving
paved: paved
pavement: pavement
paw: paw,paws
pay: paid,pay,paying,pays
payment: payment,payments
peace: peace
peaceful: peaceful
pear: pears
pearl: pearl
peat: peat
peaty: peaty
pebble: pebble,pebbles
peculiar: peculiar
peculiarity: peculiarity
peculiarly: peculiarly
peep: peep,peeped,peeping
peer: peer,peering
peevish: peevish
peevishly: peevishly
peevishness: peevishness
peg: peg
pen: pen,penning
penance: penance
pencil: pencil
pendent: pendent
penistone: penistone
penny: penny
pensive: pensive
perceive: perceive,perceived,perceives,perceiving
perceptible: perceptible
perdition: perdition
peremptorily: peremptorily
peremptory: peremptory
perfect: perfect
perfectly: perfectly
perforce: perforce
perform: perform,performed,performing
performance: performances
perfume: perfuming
peril: peril,perils
perilous: perilous
period: period
periodic: periodic
perish: perished
perishable: perishable
perishing: perishing
permanent: permanent
permission: permission
permit: permit,permitted,permitting
perpetual: perpetual
perpetually: perpetually
perplex: perplex,perplexed
perplexed: perplexed
perplexity: perplexities,perplexity
persecute: persecuting
persecution: persecutions
persecutor: persecutor
perseverance: perseverance
persevere: persevere,persevered,persevering
persist: persist,persisted
person: people,person,persons
personal: personal
personally: personally
personate: personated
personification: personification
personify: personified
perspicacity: perspicacity
perspiration: perspiration
persuade: persuade,persuaded,persuading
persuasion: persuasions
pert: pert
pertinacious: pertinacious
pertinaciously: pertinaciously
pertly: pertly
pertness: pertness
peruse: peruse,perused,perusing
pervading: pervading
perverse: perverse
perverseness: perverseness
perversity: perversity
pervert: perverted
pet: pet,petted
peter: peter
petition: petition
petrified: petrified
petting: petting
pettish: pettish
pettishly: pettishly
pettishness: pettishness
petulance: petulance
petulant: petulant
petulantly: petulantly
pewter: pewter
phalanx: phalanx
phantom: phantoms
pharisee: pharisee
phase: phase,phases
pheasant: pheasant,pheasants
philosopher: philosopher
philosophical: philosophical
phlegm: phlegm
phoenix: phoenix
phrase: phrase
phraseology: phraseology
physical: physical
physically: physically
physiognomy: physiognomy
pick: pick,picked
picture: picture,pictured,pictures,picturing
piece: piece,pieces
pierce: piercing
pigeon: pigeon,pigeons
pike: piked,pikes
pile: pile,piled
pilgrim: pilgrim
pilgrimage: pilgrimage
pill: pills
pillar: pillar
pillow: pillow,pillows
pinafore: pinafores
pincers: pincers
pinch: pinch,pinched,pinches
pine: pined,pines,pining
pinkness: pinkness
pint: pint
pious: pious
pipe: pipe
pistol: pistol,pistols
pit: pit,pits
pitch: pitch,pitched
pitcher: pitcher
pitchfork: pitchfork
piteous: piteous
pitiful: pitiful
pitiless: pitiless
pity: pitied,pity,pitying
placidly: placidly
plague: plague,plagued,plaguing
plaid: plaid
plain: plain,plainer
plainly: plainly
plan: plan,planned,planning,plans
plank: plank
plant: plant,planted,plants
plantation: plantation
plash: plash
plate: plate
plateful: plateful,platefuls
plausible: plausible
play: play,played,playing
playfellow: playfellow
playfulness: playfulness
playmate: playmate,playmates
plaything: playthings
plea: plea
plead: plead,pleaded
pleasant: pleasant,pleasanter,pleasantest
pleased: pleased
pleasure: pleasure
pledge: pledge,pledged,pledging
plentiful: plentiful
plentifully: plentifully
plenty: plenty
pliable: pliable
plight: plight
plisky: plisky
plod: plodding
plot: plot,plotted
ploughboy: ploughboy
pluck: pluck,plucked
plump: plump
plunder: plundered,plundering
plunge: plunge
poacher: poacher
pocket: pocket,pockets
pocketful: pocketful
poetry: poetry
poignant: poignant
pointer: pointer,pointers
poise: poised
poison: poison,poisoned,poisoning
poisonous: poisonous
poker: poker
policy: policy
polished: polished
politeness: politeness
ponder: pondered,pondering
pony: ponies,pony
poor: poor,poorer
porch: porch
porridge: porridge
portend: portended
porter: porter
portion: portion,portions
portrait: portrait,portraits
position: position,positions
positive: positive
possess: possess,possessed,possesses,possessing
possession: possession
possessor: possessor
possibility: possibility
post: post,posted
postern: postern
postpone: postpone,postponed
pot: pot,pots
potato: potatoes
potent: potent
pound: pounds
pour: pour,poured,pouring
pouting: pouting
powder: powders
power: power,powers
powerful: powerful
powerfully: powerfully
powerless: powerless
practicable: practicable
practically: practically
practice: practice
practise: practise,practised
praise: praise,praised,praising
praiseworthy: praiseworthy
prattle: prattled
pray: pray,prayed,praying
prayer: prayer,prayers
preach: preach,preached,preaching
preacher: preacher
precarious: precarious
precaution: precaution,precautions
precede: precede,preceded,preceding
precept: precept,precepts
precinct: precincts
precious: precious
precipitate: precipitating
precise: precise
precisely: precisely
preclude: precluded
predecessor: predecessor
predicament: predicament
prefer: preferred
preferable: preferable
preference: preference
prejudice: prejudice,prejudiced
prejudicial: prejudicial
prematurely: prematurely
premise: premises
preparation: preparation,preparations
prepare: prepare,prepared,preparing
preposterously: preposterously
presence: presence
presentable: presentable
presentiment: presentiment
presently: presently
preservation: preservation
preserve: preserve,preserved,preserving
preside: presiding
press: press,pressed,pressing
presume: presume,presumed,presuming
presumptuous: presumptuous
pretence: pretence
pretend: pretend,pretended,pretending
preterhuman: preterhuman
preternaturally: preternaturally
pretty: prettier,pretty
prevail: prevail,prevailing
prevent: prevent,prevented
previous: previous
prey: prey
price: price
prick: pricked
pride: pride
prime: prime
primitive: primitive
primrose: primrose,primroses
prince: prince
princess: princess
principal: principal
principle: principles
print: print,printed
printer: printer
prior: prior
prison: prison
prisoner: prisoner
private: private
privilege: privilege,privileges
probability: probability
probable: probable
proceed: proceed,proceeded,proceeding
proceeding: proceeding
proceedings: proceedings
process: process
processing: processing
proclaimant: proclaimant
procure: procure
produce: produce,produced
production: production
profane: profaned
professor: professor
profit: profiting,profits
profound: profound
profusely: profusely
prognosticate: prognosticate
progress: progress,progressed
prohibition: prohibition
project: project,projected,projecting
prolong: prolong,prolonged
prolonged: prolonged
prominently: prominently
promise: promise,promised,promises,promising
promote: promoting
promotion: promotion
prompt: prompt,prompted
prompter: prompters
prone: prone
pronoun: pronouns
pronounce: pronounce,pronounced,pronouncing
pronunciation: pronunciation
proof: proof,proofs
proofread: proofread
prop: prop
propensity: propensity
proper: proper
properly: properly
property: property
prophecy: prophecy
propitiate: propitiate
proportion: proportion
proposal: proposal
propose: propose,proposed,proposes,proposing
proprietary: proprietary
propriety: propriety
prose: prose
prosecute: prosecute
prospect: prospect
prospective: prospective
prostrate: prostrate
protect: protect,protected
protector: protector
protest: protested
protestation: protestations
protract: protract,protracted
protracted: protracted
proudly: proudly
prove: prove,proved,proves
provide: provide,providing
providence: providence
provident: provident
providential: providential
province: province
provincial: provincial
provision: provision,provisions
provoke: provoke,provoked,provokes,provoking
provoking: provoking
provokingly: provokingly
prowl: prowled
proximity: proximity
proxy: proxy
prudence: prudence
prudential: prudential
prudently: prudently
pry: prying
prying: prying
psalmody: psalmody
public: public
publicly: publicly
puff: puffed,puffs
pule: puling
puling: puling
pull: pull,pulled,pulling
pulpit: pulpit
pulse: pulse
pump: pump
punch: punch
punctually: punctually
punish: punish,punishing
punishment: punishment
punitive: punitive
puny: puny
pupil: pupil
puppy: puppies
pure: pure
purgatory: purgatory
purification: purification
purity: purity
purple: purple
purport: purport
purpose: purpose,purposes
purposely: purposely
pursue: pursue,pursued,pursuing
pursuit: pursuit,pursuits
push: push,pushed,pushing
puss: puss
puzzle: puzzle,puzzled
puzzled: puzzled
pyramid: pyramid
quaker: quaker
qualify: qualified
quality: qualities,quality
qualm: qualm
quantity: quantities,quantity
quarrel: quarrel,quarrelled,quarrelling,quarrels
quarrelling: quarrelling
quarry: quarries
quart: quart
quarter: quarter,quarters
quean: quean
queen: queen
queer: queer
quell: quelled
quench: quenched
querulous: querulous
quest: quest
question: question,questioned,questioning,questions
questioner: questioner
quick: quick,quicker
quiescence: quiescence
quiet: quiet,quieter,quietest
quietly: quietly
quietness: quietness
quilt: quilt
quit: quit,quitted,quitting
quiver: quiver,quivered,quivering
quote: quoting
rabbit: rabbit,rabbits
rabid: rabid
race: race
rack: racked
radiance: radiance
radiant: radiant
rafter: rafters
rage: rage,rages,raging
ragged: ragged
rail: rail,rails
rain: rain,rained,raining,rains
rainbow: rainbow
rainy: rainy
raise: raise,raised,raises,raising
rake: rake,raked
rally: rally,rallying
ramble: ramble,rambled,rambles,rambling
rambler: ramblers
rampart: ramparts
range: range,ranged,ranges,ranging
rank: ranks
rankle: rankled
rankness: rankness
ransack: ransacked
rapid: rapid
rapidly: rapidly
rapt: rapt
rapture: raptured
rapturously: rapturously
rare: rare
rarely: rarely
rascal: rascal,rascals
rascally: rascally
rash: rash
rate: rate
ratify: ratified
rating: rating
rational: rational
rationally: rationally
rattle: rattle,rattled,rattling
rave: raves,raving
raving: raving
ravings: ravings
ray: ray
reach: reach,reached,reaching
read: read,reading,reads
readable: readable
reading: reading
ready: ready
real: real
realisation: realisation
reality: reality
ream: reaming
reap: reaped
reaper: reapers
reappear: reappeared,reappearing
rear: rear,reared,rearing
reason: reason,reasoned,reasons
reasonable: reasonable
rebel: rebel
rebellion: rebellion
rebuff: rebuffing
rebuke: rebuke,rebuked
recall: recall,recalled,recalling
recantation: recantation
recapitulation: recapitulation
receipt: receipt
receive: receive,received,receiving
reception: reception
recess: recess,recesses
recipient: recipient
reciprocation: reciprocation
reckless: reckless
reckon: reckon,reckoned
recline: reclined,reclining
recluse: recluse
recognise: recognise,recognised,recognising
recognition: recognition
recoil: recoil,recoiled
recollect: recollect,recollected,recollecting
recollection: recollection
recommence: recommence,recommenced
recommend: recommend,recommended
recompense: recompense
reconcile: reconciled
reconciliation: reconciliation
recount: recounting
recover: recover,recovered,recovering
recovery: recovery
recriminate: recriminate
recur: recurred,recurring
red: red
redden: reddened,reddening
redeem: redeemed
redemption: redemption
redistribute: redistribute,redistributing
redistributing: redistributing
redistribution: redistribution
redouble: redoubled,redoubling
redound: redounded
reduce: reduce,reduced
reed: reed
refasten: refastening
refer: referring
reference: reference,references
refinement: refinement
reflect: reflect,reflected,reflecting
reflection: reflection,reflections
reflective: reflective
reform: reform,reformed
refrain: refrain,refrained
refresh: refresh
refreshing: refreshing
refreshment: refreshment
refuge: refuge
refund: refund
refusal: refusal
refuse: refuse,refused,refuses,refusing
refute: refute,refuted
regain: regained,regaining
regard: regard,regarded
regardlessly: regardlessly
region: regions
register: registered
regret: regret,regrets,regretted
regular: regular
regularly: regularly
regulate: regulating
reinstate: reinstate
reiterate: reiterated,reiterating
reject: reject,rejected,rejecting
rejoice: rejoice
rejoicing: rejoicing
rekindle: rekindle
relate: relating
relation: relation,relations
relationship: relationship
relax: relax,relaxed
relaxed: relaxed
release: release,released,releasing
relent: relent,relented
relentless: relentless
relic: relic
relief: relief
relieve: relieve,relieved,relieving
religious: religious
relinquish: relinquished
relish: relish,relished,relishing
reluctance: reluctance
reluctant: reluctant
reluctantly: reluctantly
remain: remain,remained,remaining,remains
remainder: remainder
remains: remains
remark: remark,remarked,remarking,remarks
remarkable: remarkable
remarkably: remarkably
remedy: remedies,remedy
remember: remember,remembered,remembering
remembered: remembered
remembrance: remembrance
remind: remind,reminded,reminding
remnant: remnant
remorse: remorse
remorselessly: remorselessly
removal: removal
remove: remove,removed,removing
rename: renamed
render: render,rendered,rendering,renders
renew: renew,renewed
rent: rent,rents
repair: repair,repairing
repass: repassing
repay: repaid,repay,repaying
repayment: repayment
repeal: repeal
repeat: repeat,repeated,repeating
repeatedly: repeatedly
repel: repelled,repelling
repellingly: repellingly
repent: repent,repented,repenting,repents
repenting: repenting
repetition: repetition
replace: replace,replaced,replacing
replacement: replacement
reply: replied,replies,reply
report: report,reported,reports
repose: repose,reposed
repossess: repossess
represent: represent,represented
representation: representations
representative: representatives
repress: repress,repressing
reprimand: reprimanded
reproach: reproached,reproaches
reproachful: reproachful
reproachfully: reproachfully
reprobate: reprobate
reproof: reproofs
reprove: reprove,reproved,reproving
reprover: reprover
reprovingly: reprovingly
reptile: reptile
repulse: repulsed,repulsing
repulsive: repulsive
repulsiveness: repulsiveness
reputation: reputation
request: request,requested,requesting
require: require,required,requires
requirement: requirements
rescue: rescue
resemblance: resemblance
resemble: resemble,resembled,resembles,resembling
resent: resent
resentment: resentment
reserve: reserve
reside: reside,resided
residence: residence
resident: resident
resign: resign,resigned
resignation: resignation
resist: resist,resisted
resolute: resolute
resolutely: resolutely
resolution: resolution,resolutions
resolve: resolve,resolved,resolving
resort: resort,resorted,resorting
resound: resounded
resource: resource,resources
respect: respect,respected,respecting
respectable: respectable
respectably: respectably
respected: respected
respire: respired
respite: respite
respond: responded
response: response
responsibility: responsibility
responsible: responsible
responsively: responsively
rest: rest,rested,resting
resting: resting
restless: restless
restlessly: restlessly
restoration: restoration
restore: restore,restored,restoring
restrain: restrain,restrained,restrains
restraint: restraint
restriction: restrictions
result: result
resume: resume,resumed,resuming
resurrection: resurrection
retain: retain,retained,retaining,retains
retaliate: retaliate
retaliation: retaliation
retire: retire,retired,retiring
retirement: retirement
retort: retorted
retrace: retrace,retracing
retract: retract
retreat: retreat,retreated,retreating
retrieval: retrieval
retrieve: retrieving
return: return,returned,returning,returns
reveal: reveal,revealed,revealing
revel: revelling
revelation: revelation,revelations
revenge: revenge,revenged
revenue: revenue
reverend: reverend
reverie: reverie
revert: reverting
revisit: revisit
revive: revive,revived,revives,reviving
revolt: revolted
reward: reward,rewarded
rheumatism: rheumatism
rib: ribs
riband: riband
ribbed: ribbed
ribbon: ribbon
rich: rich,richer
richly: richly
rid: rid
ride: ridden,ride,riding,rode
rider: rider
ridge: ridge
ridicule: ridicule,ridiculing
ridiculous: ridiculous
riding: riding
rig: rigs
righteous: righteous
righteously: righteously
rightly: rightly
rigidly: rigidly
ringlet: ringlets
riot: riot
ripen: ripening
ripple: ripples
rise: rise,risen,rises,rising,rose
risk: risk
rival: rival
rive: riven
riven: riven
road: road,roads
roadside: roadside
roam: roamed
roar: roar,roared,roaring
roast: roasting
roasted: roasted
rob: rob,robbing
robber: robbers
robert: robert
rock: rocked,rocking,rocks
rocking: rocking
rod: rod
rogue: rogue
roll: roll,rolled,rolling
romance: romance
romantic: romantic
roof: roof
root: roots
rooted: rooted
rose: rose
rosebush: rosebushes
rotten: rotten
rough: rough
roughly: roughly
roughness: roughness
rouse: rouse,roused
rousing: rousing
row: row
royalty: royalties,royalty
rub: rubbed,rubbing
ruddy: ruddy
rude: rude
rudely: rudely
rudeness: rudeness
rue: rue
ruffian: ruffian
ruffianly: ruffianly
ruffle: ruffling
rug: rug
ruin: ruin,ruined,ruining
rule: rules,ruling
rumble: rumbling
rume: rume
rummage: rummaged
rumour: rumour
runaway: runaway
running: running,runnings
rush: rush,rushed,rushing
rustic: rustic
rustle: rustle
rustling: rustling
sabbath: sabbath
sack: sack,sacks
sackless: sackless
sacrifice: sacrifice,sacrificed
sad: sad,sadder,saddest
saddle: saddle,saddled,saddles
sadly: sadly
sadness: sadness
safe: safe,safer
safely: safely
safety: safety
sagacity: sagacity
sail: sail
sailor: sailors
saint: saint,saints
sake: sake
sall: sall
sallow: sallow
sallower: sallower
sally: sallied
salt: salt
salubrious: salubrious
salutation: salutation,salutations
salute: salute,saluted
salvation: salvation
sample: samples
sanctimonious: sanctimonious
sanctum: sanctum
sand: sand
sane: sane
sanguine: sanguine
sarcastic: sarcastic
sarcastically: sarcastically
satan: satan
satellite: satellites
satisfaction: satisfaction
satisfactorily: satisfactorily
satisfactory: satisfactory
satisfied: satisfied
satisfy: satisfied,satisfy
saturnine: saturnine
sauce: sauce
saucepan: saucepans
saucer: saucer,saucers
sauciness: sauciness
saucy: saucier,saucy
saunter: saunter,sauntered,sauntering
savage: savage,savages
savagely: savagely
save: save,saved,saving
scale: scale
scalp: scalping
scamper: scamper,scampering
scandal: scandal
scandalous: scandalous
scarcely: scarcely
scare: scares
scared: scared
scarlet: scarlet
scatter: scattered
scene: scene,scenes
scenery: scenery
scent: scent,scented,scents
sceptre: sceptre
scheme: scheme,schemes
scholar: scholar
schoolboy: schoolboy
scintillate: scintillating
scissors: scissors
scold: scold,scolded,scolding
scolding: scolding
sconce: sconces
scoop: scooping
scope: scope
score: score
scorn: scorn,scorned,scorning,scorns
scornful: scornful
scornfully: scornfully
scorning: scorning
scoundrel: scoundrel
scour: scoured,scouring
scowl: scowl,scowled,scowling,scowls
scramble: scrambling
scrape: scrape,scraped
scratch: scratched
scratching: scratching
scrawl: scrawled
scream: scream,screamed,screaming
screen: screen
screw: screwed,screws
scripture: scripture
scroop: scroop
scrub: scrubbed
scruple: scruple,scruples
scrutinize: scrutinizing
scutter: scutter
scuttle: scuttles
scuttleful: scuttleful
sea: sea
seal: seal,sealed
search: search,searched,searching
season: season,seasoned,seasons
seat: seat,seated,seats
secluded: secluded
seclusion: seclusion
secret: secret,secrets
secretly: secretly
secure: secure,secured,securing
securely: securely
security: security
seed: seed
seek: seek,seeking,sought
seemingly: seemingly
seemly: seemly
seize: seize,seized,seizing
seldom: seldom
select: select,selected
selfish: selfish
selfishness: selfishness
sell: sold
send: send,sending,sends
sensation: sensation,sensations
sense: sense
senseless: senseless
sensitive: sensitive
sentence: sentence,sentences
sententiously: sententiously
sentiment: sentiment,sentiments
sentinel: sentinel
separate: separate,separated,separating
separation: separation
september: september
sequel: sequel
series: series
sermon: sermon,sermons
sermonising: sermonising
serpent: serpent
servant: servant,servants
serve: serve,served,serves,serving
service: service,services
serviceable: serviceable
set: set,setting
setting: setting
settle: settle,settled,settles
settled: settled
seventeen: seventeen
seventeenth: seventeenth
sever: sever
severe: severe
severely: severely
severity: severity
sewing: sewing
sexton: sexton
sha: sha
shabby: shabby
shade: shade,shaded
shadow: shadow,shadowing,shadows
shadowless: shadowless
shaft: shaft
shaggy: shaggy
shake: shake,shaken,shaking,shook
shaking: shaking
shallow: shallow
shame: shame
shameful: shameful
shamefully: shamefully
shameless: shameless
shape: shape,shaped
share: share,shared,sharing
sharp: sharp
sharpen: sharpen
sharply: sharply
sharpness: sharpness
shatter: shattered,shattering
shattered: shattered
shawl: shawl
shawlless: shawlless
sheaf: sheaves
sheep: sheep
sheer: sheer
sheet: sheet,sheets
shelf: shelf
shelter: shelter,sheltered
shew: shew
shielders: shielders
shift: shift,shifted,shifting
shilling: shilling,shillings
shimmering: shimmering
shine: shine,shining,shone
ship: ship
shirk: shirk
shirt: shirt
shiver: shiver,shivered,shivering,shivers
shiveringly: shiveringly
shock: shock,shocked,shocking
shocked: shocked
shocking: shocking
shockingly: shockingly
shoe: shoe,shoes
shoo: shoo
shoon: shoon
shoot: shoot,shot
shooting: shooting
shop: shop
shore: shore
short: short,shorter
shot: shot
shoulder: shoulder,shouldering,shoulders
shout: shout,shouted,shouting
shove: shoved
shovel: shovel
shovelful: shovelful
shower: shower,showers
showy: showy
shriek: shriek,shrieked,shrieking,shrieks
shrieking: shrieking
shrink: shrank,shrink,shrinking,shrunk
shrub: shrubs
shrug: shrugged
shudder: shudder,shuddered,shuddering,shudders
shuffle: shuffled
shuffling: shuffling
shun: shun,shunned,shunning
shut: shut,shutting
shutter: shutters
shutting: shutting
shuttlecock: shuttlecocks
shy: shied
sich: sich
sick: sick
sickly: sickly
sickness: sickness
sideboard: sideboard
sideways: sideways
sidle: sidled
sigh: sigh,sighed,sighing,sighs
sighing: sighing
sight: sight
sign: sign,signed,signing,signs
signal: signal
signature: signature
signet: signet
signify: signified,signify
signing: signing
silence: silence,silenced
silent: silent
silently: silently
silk: silk
silky: silky
sill: sill
silly: silly
silver: silver
silvery: silvery
simple: simple
simpleton: simpleton
simply: simply
simultaneously: simultaneously
sin: sin,sins
sincerely: sincerely
sincerity: sincerity
sinewy: sinewy
sing: sang,sing,singing,sung
singer: singer,singers
singing: singing
single: single
singular: singular
singularly: singularly
sinister: sinister
sink: sank,sink,sinking,sunk
sinner: sinner,sinners
sip: sip,sipping
sir: sir
sister: sister,sisters
sit: sat,sit,sits,sitting
sitting: sitting,sittings
situation: situation
sixteen: sixteen
sizar: sizar
size: sizes
skeleton: skeletons
sketch: sketch,sketched
skift: skift
skill: skill
skin: skin
skinned: skinned
skirmish: skirmishes
skirt: skirts
skittish: skittish
skulk: skulk,skulked
skulker: skulker
skull: skull
sky: skies,sky
skylight: skylight
slam: slam,slammed
slander: slander,slanders
slant: slant
slap: slap,slapped,slaps
slapping: slapping
slate: slate,slates
slattern: slattern
slave: slaves
slaver: slaver,slavered,slavering
slavish: slavish
sleep: sleep,sleeping,sleeps,slept
sleeper: sleeper,sleepers
sleeping: sleeping
sleepless: sleepless
sleeplessness: sleeplessness
sleepy: sleepy
sleet: sleet
sleeve: sleeve,sleeves
slender: slender
slide: slid,slide,sliding
slight: slight,slighter,slightest,slights
slim: slim
sling: slinging,slung
slip: slip,slipped
slipper: slippers
slit: slitting
slop: slop
slope: slope
slouch: slouching
slough: slough
slovenly: slovenly
slow: slow
slowly: slowly
slumber: slumber,slumbers
slut: slut
sly: sly
smack: smacked
smart: smart
smartly: smartly
smash: smash,smashed,smashing
smell: smelling,smelt
smile: smile,smiled,smiles,smiling
smite: smiting,smote
smith: smiths
smitten: smitten
smoke: smoked,smoking
smoking: smoking
smooth: smooth,smoothing
smother: smothered,smothering
smoulder: smouldered
smuggle: smuggled
snail: snail,snails
snake: snake
snap: snap,snapped,snapping
snappish: snappish
snappishly: snappishly
snarl: snarled
snatch: snatch,snatched,snatching
sneak: sneaking
sneer: sneer,sneered
sneering: sneering
sneeringly: sneeringly
snivel: snivel,snivelling
snivelling: snivelling
snoozle: snoozled
snort: snorting
snow: snow
snowy: snowy
snuff: snuffed,snuffing
snuffer: snuffers
snug: snug
soak: soaked
soap: soap
sob: sob,sobbed,sobbing,sobs
sober: sober,sobered
sobriety: sobriety
sociable: sociable
social: social
society: society
sod: sod,sods
sofa: sofa
soft: soft,softer
soften: soften,softened
softly: softly
softness: softness
soil: soil
solace: solace
solder: soldered
soldier: soldier
sole: sole
solemn: solemn
solemnly: solemnly
solicit: solicit,solicited,soliciting
solicitation: solicitation
soliloquise: soliloquised
soliloquy: soliloquy
solitary: solitary
solitude: solitude,solitudes
son: son
song: song,songs
soot: soot
soothe: soothe,soothed,soothing
soothed: soothed
soothing: soothing
soothingly: soothingly
sore: sore
sorrow: sorrow,sorrows
sorrowful: sorrowful
sorrowfully: sorrowfully
sort: sort,sorts
sough: sough
soul: soul,souls
sound: sound,sounded,sounding,sounds
soundly: soundly
sour: sour,sourest
source: source
sourly: sourly
south: south
southern: southern
sovereign: sovereign
sow: sow
sowl: sowl
space: space
spade: spade
spaniel: spaniel
spanish: spanish
spare: spare,spared,sparing
sparely: sparely
sparer: sparer
spark: spark,sparks
sparkle: sparkle,sparkled,sparkling
sparkling: sparkling
sparrow: sparrow
spatter: spatters
speak: spake,speak,speaking,speaks,spoke,spoken
speaker: speaker
spear: spears
special: special
species: species
specimen: specimen
speckless: speckless
spectacle: spectacle
spectacles: spectacles
spectator: spectator
spectre: spectre,spectres
speculation: speculation
speech: speech,speeches
speechless: speechless
speed: speed
speedily: speedily
speedy: speedy
spell: spell,spelt
spelling: spelling
spend: spend,spending,spends,spent
spice: spices
spider: spider
spill: spilling,spilt
spirit: spirit,spirits
spirited: spirited
spiritual: spiritual
spit: spat,spitted,spitting
spite: spite
spiteful: spiteful
spitefully: spitefully
spitting: spitting
splash: splashed,splashes
spleen: spleen
splendid: splendid
splendidly: splendidly
splinter: splinter,splinters
split: split,splitting
spoil: spoiled,spoils,spoilt
spoiled: spoiled
spontaneously: spontaneously
spoon: spoon,spoons
spoonful: spoonful
sport: sport
spot: spot,spots
spread: spread,spreading
spring: sprang,spring,springing,springs
springer: springer
sprinkle: sprinkled
sprinkling: sprinkling
spur: spur,spurred
spurn: spurn
spy: spies,spy
squalling: squalling
square: square,squares
squeal: squealing
squeeze: squeeze,squeezed
squint: squint
squire: squire
stab: stab
stable: stable,stables
stack: stack
staff: staff
stage: stage
stagger: staggered
stagnate: stagnates
stain: stained
stair: stairs
stale: stale
staling: staling
stall: stall,stalled
stalwart: stalwart
stammer: stammer,stammered
stammering: stammering
stamp: stamp,stamped,stamping
stanchion: stanchions
stand: stand,standing,stands,stood
standing: standing
staple: staple
star: stars
stare: stare,stared,staring
stark: stark
start: start,started
startle: startled,startles
startled: startled
startling: startling
starve: starve,starved,starving
statement: statement,statements
station: station,stationed
stationary: stationary
statue: statue
status: status
staunch: staunch
staunchly: staunchly
stave: staves
stay: stay,stayed,staying
steadfastly: steadfastly
steadily: steadily
steady: steady
steal: steal,stealing,stole
stealing: stealing
stealthily: stealthily
stealthy: stealthy
steel: steel
steep: steep,steeped
steer: steer
steering: steering
step: step,stepped,stepping,steps
stern: stern
sterner: sterner
sternly: sternly
sternness: sternness
stick: stick,sticking,stuck
stiff: stiff
stiffen: stiffens
stifle: stifled
stinging: stinging
stipend: stipend
stir: stir,stirred,stirring,stirs
stirring: stirring
stock: stock,stocks
stocking: stockings
stoical: stoical
stolidity: stolidity
stomach: stomach
stone: stone,stones
stony: stony
stool: stool
stoop: stoop,stooped,stooping
store: store,stored,storing
storm: storm,storms
stormy: stormy
story: stories,story
stout: stout
stow: stowing
straggle: straggling
straggler: stragglers
straight: straight
strain: strained,straining
strange: strange,strangest
strangely: strangely
stranger: stranger
strangle: strangle,strangled
stray: stray,strayed
stream: stream,streamed,streaming
streamer: streamers
streaming: streaming
street: street,streets
strength: strength
strenuous: strenuous
stretch: stretch,stretched,stretching
stretched: stretched
strew: strewn
stricken: stricken
strict: strict
strictly: strictly
stride: stride,strides,striding,strode
strike: strike,strikes,striking,struck
striking: striking
string: string
strive: striving,strove
stroke: stroke,stroked,stroking
stroll: stroll,strolled
strong: strong,stronger
stronghold: stronghold
structure: structure,structures
struggle: struggle,struggled,struggling
stubborn: stubborn
stubbornly: stubbornly
study: studied,studies,study,studying
stuff: stuff,stuffing
stumble: stumble,stumbled
stunned: stunned
stunt: stunted
stupefied: stupefied
stupid: stupid
stupidity: stupidity
style: style
subdue: subdue,subdued,subduing
subdued: subdued
subject: subject,subjects
submissive: submissive
subscribe: subscribe
subsequent: subsequent
subside: subsided
substance: substance
substantial: substantial
substitute: substitute
succeed: succeed,succeeded,succeeding
success: success
succession: succession
successor: successor
succinct: succinct
succour: succour
suck: sucked,sucking
sud: sud
sudden: sudden
suddenly: suddenly
sue: suing
suffer: suffer,suffered,suffers
suffering: suffering,sufferings
suffice: suffice,sufficed
sufficient: sufficient
suffocate: suffocate,suffocating
suffocating: suffocating
suffuse: suffused
sugar: sugar
suggestion: suggestion
suggestive: suggestive
suicidal: suicidal
suit: suit,suited
suitable: suitable
suitor: suitor
sulk: sulking
sulkily: sulkily
sulkiness: sulkiness
sulky: sulky
sullen: sullen
sullenly: sullenly
sullenness: sullenness
sultry: sultry
summer: summer
summit: summit
summon: summon,summoned,summoning
summons: summons
summut: summut
sun: sun
sunbeam: sunbeams
sunday: sunday
sundays: sundays
sundry: sundry
sunny: sunny
sunrise: sunrise
sunset: sunset
sunshine: sunshine
superfluous: superfluous
superintend: superintend
superior: superior
superiority: superiority
superstition: superstition
superstitious: superstitious
supper: supper
supplicate: supplicated
supplicating: supplicating
supplication: supplication,supplications
supply: supplied,supply
support: support,supported,supporting
supporter: supporter
suppose: suppose,supposed,supposing
suppress: suppress,suppressed,suppressing
surely: surely
surface: surface
surgeon: surgeons
surlily: surlily
surly: surly
surmise: surmise,surmised
surname: surname
surpass: surpassed
surprise: surprise,surprised
surprised: surprised
surprising: surprising
surrender: surrendered
surround: surrounded
survey: survey,surveyed,surveying
survive: survive,surviving
susceptibility: susceptibility
susceptible: susceptible
suspect: suspect,suspected,suspecting
suspend: suspend,suspended
suspense: suspense
suspicion: suspicion,suspicions
suspiciously: suspiciously
sustain: sustain,sustaining
sustenance: sustenance
swallow: swallow,swallowed,swallowing
swamp: swamp,swamps
swarm: swarm,swarmed,swarming
sway: swayed,swaying
swear: swear,swearing,swears,swore,sworn
swearing: swearing
sweat: sweat
sweep: sweep,sweeping,swept
sweeping: sweeping
sweet: sweet,sweeter,sweetest,sweets
sweetheart: sweetheart
sweetly: sweetly
sweetness: sweetness
swell: swelled,swells
swerve: swerved
swine: swine
swing: swing,swung
swinging: swinging
switch: switch
swoon: swoon
syllable: syllable,syllables
sympathetic: sympathetic
sympathise: sympathise,sympathised,sympathising
sympathising: sympathising
sympathy: sympathies,sympathy
symptom: symptoms
synonymous: synonymous
table: table,tables
tacit: tacit
taciturn: taciturn
tack: tacked
taen: taen
tail: tail,tails
tale: tale,tales
talk: talk,talked,talking,talks
talking: talking
tall: tall,taller,tallest
talon: talons
tame: tame
tangible: tangible
tankard: tankards
tap: taps
taper: tapers
tarnish: tarnish
tarry: tarry
tart: tarts
tartly: tartly
task: task,tasks
taste: taste,tasted,tastes
taunt: taunting
tauntingly: tauntingly
tax: tax,taxes
tea: tea
teach: taught,teach,teaches,teaching
teacher: teacher,teachers
teaching: teaching
tear: tear,tears,tore,torn
tease: tease,teased,teases,teasing
tedious: tedious
teens: teens
teethe: teething
teller: teller
temper: temper,tempered,tempers
temperate: temperate
tempest: tempest
temple: temples
temporary: temporary
tempt: tempt,tempted,tempting
temptation: temptation
tempter: tempter
tempting: tempting
tenacious: tenacious
tenant: tenant,tenants
tend: tend,tended,tending
tendency: tendency
tender: tender
tenderly: tenderly
tenderness: tenderness
tension: tension
tent: tent
tenure: tenure
term: term,termed,terms
terminate: terminating
termination: termination
terrible: terrible
terribly: terribly
terrier: terrier
terrific: terrific
terrified: terrified
terrify: terrified,terrify
terror: terror
testament: testament
thankful: thankful
thaw: thaw
thee: thee
theme: themes
thenceforth: thenceforth
theology: theology
thereat: thereat
thible: thible
thickening: thickening
thickly: thickly
thief: thief
thinking: thinking
thirsty: thirsty
thirteen: thirteen
thither: thither
thorn: thorn,thorns
thoughtless: thoughtless
thoughtlessly: thoughtlessly
thoughtlessness: thoughtlessness
thowt: thowt
thrang: thrang
thrash: thrash,thrashing
thread: thread
threat: threat,threats
threaten: threaten,threatened,threatening,threatens
threshold: threshold
thrice: thrice
thrill: thrill
thrilling: thrilling
thrive: thrive
thriven: thriven
throat: throat
throbbing: throbbing
throstle: throstles
throttle: throttled
throttler: throttler
throw: threw,throw,throwing,thrown
thrust: thrust,thrusting
thud: thud
thump: thumped
thunder: thunder,thundered,thundering
thursday: thursday
thwart: thwart,thwarting
thy: thy
ticket: ticket
tidy: tidied,tidy
tie: tie,tied,ties,tying
tiger: tiger,tigers
tight: tight
tighten: tightened
tigress: tigress
timber: timber
time: time,times
times: times
timid: timid
timidity: timidity
timidly: timidly
tin: tin
tingle: tingled,tingling
tiny: tiny
tiptoe: tiptoe
tire: tired
tired: tired
tiresome: tiresome
tiresomely: tiresomely
titan: titan
title: title
titter: titter,tittered
toast: toast,toasted
tobacco: tobacco
toil: toil,toiled
toilette: toilette
token: token
tolerable: tolerable
tolerably: tolerably
tolerate: tolerate,tolerated
tomb: tombs
tome: tome
tone: tone,tones
tongue: tongue,tongues
tool: tool,tools
tooth: teeth,tooth
toothless: toothless
topic: topic,topics
topmost: topmost
torch: torch
torment: torment,tormented,tormenting,torments
tormentor: tormentor
torrent: torrent
torture: torture,tortures
toss: tossed,tossing
tossing: tossing
total: total
totter: totter,tottered
touch: touch,touched,touches,touching
touchiness: touchiness
touching: touching
touchy: touchy
tough: tough
towel: towel
tower: towering
town: town,towns
toy: toys
trace: traces,tracing
track: tracked
trademark: trademark
trail: trail,trailed
train: train
trait: trait
traitor: traitor
tramp: tramped
trample: trample,trampled
tranquil: tranquil
tranquillity: tranquillity
transaction: transactions
transcribe: transcribe
transcription: transcription
transfigure: transfigured
transform: transformed,transforming
transformation: transformation
transgress: transgress
transgression: transgressions
transient: transient
transmit: transmit
transmute: transmuted
transplant: transplanted
trap: trap
trash: trash
travel: travel,travelling
traveller: traveller
travelling: travelling
travels: travels
traverse: traversed
tray: tray
treacherous: treacherous
treachery: treachery
tread: tread
treasure: treasure,treasures
treat: treat,treated,treating
treatment: treatment
treaty: treaty
tree: tree,trees
tremble: trembled,trembles,trembling
tremendous: tremendous
trepidation: trepidation
tress: tresses
trial: trial
trick: trick,tricks
trickle: trickle,trickled
trifle: trifle,trifles,trifling
trifling: trifling
trim: trim
trinket: trinket,trinkets
trio: trio
trip: tripped
triumph: triumph,triumphed
triumphant: triumphant
trodden: trodden
trombone: trombone
trot: trot,trotted
trouble: trouble,troubled,troubles,troubling
troubled: troubled
troublesome: troublesome
troublesomely: troublesomely
troubling: troubling
trough: trough
trousers: trousers
true: true,truer
trumpet: trumpet
trunk: trunk,trunks
trust: trust,trusted,trusting
trustee: trustees
trustful: trustful
truth: truth
tube: tube
tuck: tucked
tuesday: tuesday
tuft: tuft
tumbler: tumbler
tumult: tumult
tumultuously: tumultuously
tune: tune,tunes
tureen: tureen
turf: turf
turkey: turkey
turnip: turnip
tush: tush
tut: tut
tutor: tutor,tutored
twang: twang
twentieth: twentieth
twine: twined
twinkle: twinkle
twinkling: twinkling
twist: twist,twisted,twisting
twisted: twisted
twitch: twitched,twitches
type: type,types
tyrannical: tyrannical
tyrannically: tyrannically
tyranny: tyrannies
tyrant: tyrant
ud: ud
ugly: ugly
uh: uh
ull: ull
ultimate: ultimate
umbrella: umbrella
umph: umph
unable: unable
unacceptable: unacceptable
unaccompanied: unaccompanied
unaccountable: unaccountable
unachieved: unachieved
unalterably: unalterably
unannoyed: unannoyed
unanswered: unanswered
unavailing: unavailing
unavenged: unavenged
unavoidably: unavoidably
unbar: unbarred
unbeliever: unbeliever
unbidden: unbidden
uncarpeted: uncarpeted
unceremoniously: unceremoniously
uncertain: uncertain
uncertainly: uncertainly
unchain: unchain,unchained
unchained: unchained
unchangeable: unchangeable
unchanged: unchanged
unchristian: unchristian
uncivil: uncivil
uncle: uncle
uncleared: uncleared
unclose: unclose
unclosed: unclosed
uncombed: uncombed
uncomfortable: uncomfortable
uncommonly: uncommonly
uncomplaining: uncomplaining
uncompromising: uncompromising
unconscious: unconscious
unconsciously: unconsciously
unconsciousness: unconsciousness
uncontrollable: uncontrollable
uncovered: uncovered
uncoveted: uncoveted
uncultivated: uncultivated
uncurled: uncurled
uncurtained: uncurtained
undecided: undecided
undefined: undefined
undeniable: undeniable
undergo: undergo,undergone
underground: underground
underline: underlined
underling: underlings
understand: understand,understood
understanding: understanding
undertake: undertake,undertook
undertone: undertone
undeserved: undeserved
undisguised: undisguised
undisputed: undisputed
undisturbed: undisturbed
undo: undone
undress: undress,undressed
undulate: undulating
unearthly: unearthly
uneasily: uneasily
uneasiness: uneasiness
uneasy: uneasy
unenforceability: unenforceability
unequal: unequal
unexpected: unexpected
unexpectedly: unexpectedly
unfasten: unfastened
unfeeling: unfeeling
unfit: unfit
unfixed: unfixed
unfledged: unfledged
unflinching: unflinching
unfold: unfold
unformed: unformed
unfortunate: unfortunate
unfriended: unfriended
ungenerous: ungenerous
ungodly: ungodly
ungovernable: ungovernable
ungraciously: ungraciously
ungrateful: ungrateful
unhappy: unhappy
unharmed: unharmed
unhasp: unhasp
unheard: unheard
unheed: unheeding
uniform: uniform
uninhabited: uninhabited
union: union
unison: unison
united: united
universal: universal
universe: universe
unjustly: unjustly
unknot: unknotted
unknown: unknown
unlimited: unlimited
unlink: unlink
unlock: unlock
unluckily: unluckily
unlucky: unlucky
unmanned: unmanned
unmannerly: unmannerly
unmistakably: unmistakably
unmolested: unmolested
unmoved: unmoved
unnatural: unnatural
unnecessary: unnecessary
unnerve: unnerved
unnoticed: unnoticed
unobserved: unobserved
unobstructed: unobstructed
unperilous: unperilous
unpleasing: unpleasing
unprincipled: unprincipled
unprotected: unprotected
unquiet: unquiet
unreasonable: unreasonable
unreclaimed: unreclaimed
unreconciled: unreconciled
unresting: unresting
unrestrained: unrestrained
unrevenged: unrevenged
unripped: unripped
unruly: unruly
unsaid: unsaid
unsatisfactorily: unsatisfactorily
unseasonable: unseasonable
unseen: unseen
unsettle: unsettle,unsettled
unsling: unslinging
unsociable: unsociable
unsolicited: unsolicited
unspeakable: unspeakable
unspeakably: unspeakably
unsubstantial: unsubstantial
unsuccessful: unsuccessful
unsummoned: unsummoned
unsuspecting: unsuspecting
untenanted: untenanted
untidy: untidy
untie: untie,untied,untying
untold: untold
untroubled: untroubled
untruth: untruth
unusual: unusual
unutterable: unutterable
unutterably: unutterably
unvalued: unvalued
unwarrantable: unwarrantable
unwashed: unwashed
unwaveringly: unwaveringly
unwearied: unwearied
unwelcome: unwelcome
unwelcomed: unwelcomed
unwell: unwell
unwilling: unwilling
unwillingly: unwillingly
unwittingly: unwittingly
unwonted: unwonted
unworthy: unworthy
upbraid: upbraid
update: updated
upland: uplands
upper: upper
uppermost: uppermost
upright: upright
uproar: uproar
upset: upset
upstairs: upstairs
upward: upward
urge: urge,urged,urges,urging
urn: urn
usage: usage
useless: useless
uselessness: uselessness
user: user
usher: ushered
usual: usual
usurp: usurped
usurper: usurper
ut: ut
utensil: utensils
utmost: utmost
utter: utter,uttered,uttering
utterly: utterly
vacancy: vacancy
vacant: vacant
vagabond: vagabond
vagary: vagaries
vague: vague
vaguely: vaguely
vain: vain
vainly: vainly
valley: valley
valorously: valorously
valour: valour
valuable: valuable
vampire: vampire
vane: vane
vanilla: vanilla
vanish: vanish,vanished,vanishing
vanity: vanity
vanquish: vanquish,vanquished
vapid: vapid
vapour: vapour
variation: variations
variety: variety
vary: varied,varying
vast: vast
vastly: vastly
vegetable: vegetables
vehemence: vehemence
vehemently: vehemently
veil: veil
vein: vein,veins
vengeance: vengeance
venom: venom
venomous: venomous
vent: vent
ventilation: ventilation
venture: venture,ventured,venturing
venturesome: venturesome
verb: verbs
verdant: verdant
verge: verge,verging
verify: verified
verse: verse,verses
version: version
vessel: vessel
vestige: vestige
veto: veto
vex: vex,vexed
vexation: vexation
vexatious: vexatious
vial: vials
vibrate: vibrates
vice: vice
vicious: vicious
victim: victim
victuals: victuals
view: view,viewed,viewing
vigilance: vigilance
vigilant: vigilant
vigorous: vigorous
vigour: vigour
vii: vii
viii: viii
vile: vile
village: village
villager: villagers
villain: villain
villainous: villainous
vindictive: vindictive
vindictiveness: vindictiveness
vinegar: vinegar
viol: viol
violate: violates
violence: violence
violent: violent
viper: viper
virtue: virtue
virtuous: virtuous
virulency: virulency
virus: virus
vis: vis
visage: visage
visible: visible
visibly: visibly
vision: vision,visions
visit: visit,visited,visiting,visits
visitation: visitation,visitations
visitor: visitor,visitors
vivacity: vivacity
vivid: vivid
vividly: vividly
vivisection: vivisection
vixen: vixen
vocal: vocal
vocally: vocally
vocation: vocation,vocations
voce: voce
vociferate: vociferate,vociferated,vociferating
voice: voice,voices
void: void
volume: volume,volumes
volunteer: volunteer,volunteers
vouchsafe: vouchsafed
vow: vowed,vowing
vulgar: vulgar
wad: wad
wade: wading
waft: wafted
wag: wag
wage: wage
wager: wager
wages: wages
wah: wah
waif: waif
wail: wail,wailed,wailing
waistcoat: waistcoat
wait: wait,waited,waiting
wake: wake,wakes,waking,woke
waken: waken,wakened,wakens
walk: walk,walked,walking,walks
walking: walking
wall: wall,walls
wallflower: wallflowers
wan: wan
wander: wander,wandered,wandering,wanders
wanderer: wanderers
wanderings: wanderings
war: war
wardrobe: wardrobe
wark: wark,warks
warm: warm,warmed,warms
warmly: warmly
warmth: warmth
warn: warn,warned,warning
warning: warning
warrant: warrant
warranty: warranties,warranty
wash: wash,washed,washing
washing: washing
waste: waste,wasted
watch: watch,watched,watching
watchdog: watchdog
water: water,watered,watering
watery: watery
wave: waves,waving
waver: wavered
wax: wax,waxed,waxing
waxen: waxen
wayward: wayward
waywardness: waywardness
weak: weak,weaker
weakling: weakling
weakness: weakness
wealthy: wealthy
wean: weaned
weapon: weapon,weapons
wear: wearing,wore,worn
wearied: wearied
weariness: weariness
wearisome: wearisome
weary: wearied,wearies,weary,wearying
weasel: weasel
weather: weather,weathered
wedding: wedding
weed: weeds
week: week,weeks
weel: weel
weep: weep,weeping,wept
weigh: weighed,weighing,weighs
weight: weight
weighty: weighty
wer: wer
west: west
western: western
wet: wet,wetted
whatsoever: whatsoever
wheedle: wheedle,wheedling
wheel: wheeled,wheeling
whelp: whelp
whelphood: whelphood
whet: whet
whey: whey
whimper: whimper
whine: whining
whinstone: whinstone
whip: whip,whipping
whirl: whirl,whirled
whisker: whiskers
whisper: whisper,whispered,whispers
whist: whist
whistle: whistle,whistled
white: white
whiten: whitened
whiteness: whiteness
wholesome: wholesome
wholly: wholly
wi: wi
wick: wick
wicked: wicked
wickedly: wickedly
wickedness: wickedness
wicket: wicket
wide: wide,wider,widest
widespread: widespread
widow: widow
wield: wielded
wife: wife,wives
wild: wild
wilder: wildered
wilderness: wilderness
wildly: wildly
wildness: wildness
wilful: wilful
wilfully: wilfully
willingly: willingly
willow: willow
win: win,winning
wince: wince,wincing
wind: wind,winding,winds,wound
winding: windings
window: window,windows
wine: wine
wing: wing
wink: wink,winked,winking
winning: winning
winsome: winsome
winter: winter
wintry: wintry
wipe: wipe,wiped,wiping
wisdom: wisdom
wise: wise,wiser
wisely: wisely
wisht: wisht
wit: wit,wits
witch: witch,witched,witches
withdraw: withdraw,withdrawing,withdrew
withered: withered
withhold: withhold
witness: witness,witnessed,witnessing
wod: wod
wold: wold
wolf: wolf
wolfish: wolfish
wolfishly: wolfishly
woman: woman,women
wonderful: wonderful
wonderfully: wonderfully
wondrous: wondrous
wondrously: wondrously
wood: wood,woods
wooden: wooden
wool: wool
word: word
wordy: wordy
worldly: worldly
worm: worms
worry: worried,worries,worrying
worrying: worrying
worship: worship
worth: worth
worthless: worthless
worthy: worthy
wound: wound,wounded,wounds
wrangle: wrangle
wrap: wrap,wrapped,wrapping
wrath: wrath
wreath: wreath
wrench: wrench,wrenched,wrenching
wrest: wrest
wretch: wretch,wretches
wretched: wretched
wretchedness: wretchedness
wring: wring,wrung
wringing: wringing
wrinkle: wrinkles
wrist: wrist
write: write,writing,written,wrote
writer: writer
writhe: writhe,writhed,writhing
writing: writing
wrong: wrong,wronged,wrongs
wur: wur
wuthering: wuthering
xi: xi
xii: xii
xiii: xiii
xiv: xiv
xix: xix
xvi: xvi
xvii: xvii
xviii: xviii
xx: xx
xxi: xxi
xxii: xxii
xxiii: xxiii
xxiv: xxiv
xxv: xxv
xxx: xxx
yah: yah
yard: yard,yards
yawn: yawn,yawned,yawning
yawning: yawning
yearly: yearly
yearn: yearn,yearned
yearning: yearning
yell: yell,yelled,yelling,yells
yellow: yellow
yelp: yelped,yelping
yelping: yelping
yer: yer
yester: yester
yesterday: yesterday
yesternight: yesternight
yield: yield,yielded,yielding
yon: yon
yond: yonder
yonder: yonder
yorkshire: yorkshire
youngster: youngsters
youth: youth
youthful: youthful
zeal: zeal
zealous: zealous
zest: zest
zillah: zillah
