abandon: abandon,abandoned,abandoning
abasement: abasement
abate: abated,abating
abatement: abatement
abbacy: abbacies,abbacy
abbe: abbe
abbot: abbot
abhor: abhor
abhorrence: abhorrence
abide: abide
ability: abilities,ability
ablest: ablest
abode: abode
abolish: abolish,abolished
abolition: abolition
abound: abound,abounded,abounding,abounds
abovementioned: abovementioned
abraham: abraham
abridge: abridge,abridges,abridging
abridged: abridged
absolute: absolute
absolutely: absolutely
absorb: absorb,absorbed,absorbing,absorbs
abstain: abstain
abstract: abstract
abstracted: abstracted
abstruse: abstruse
absurd: absurd
absurdity: absurdity
absurdly: absurdly
abundance: abundance
abundant: abundant
abundantly: abundantly
abuse: abuse,abused,abuses,abusing
abusive: abusive
abyssinia: abyssinia
academic: academic
academy: academy
acapulco: acapulco
accelerate: accelerated,accelerating
accept: accept,accepted,accepting,accepts
acceptor: acceptor
accession: accession
accessory: accessory
accident: accident,accidents
accidental: accidental
accidentally: accidentally
accommodate: accommodate,accommodated
accommodation: accommodation
accompany: accompanied,accompanies,accompany
accomplished: accomplished
accomplishment: accomplishment,accomplishments
accord: accord
account: account,accounted,accounts
accountable: accountable
accountant: accountant,accountants
accumulate: accumulate,accumulated,accumulates,accumulating
accumulation: accumulation
accuracy: accuracy
accurate: accurate
accurately: accurately
accusation: accusation
accuse: accused,accusing
accustom: accustomed
accustomed: accustomed
achieve: achieving
achilles: achilles
acknowledge: acknowledge,acknowledged,acknowledges
acknowledgment: acknowledgment
acorn: acorn
acquaint: acquaint,acquainted
acquire: acquire,acquired,acquires,acquiring
acquirer: acquirer
acquisition: acquisition,acquisitions
acquit: acquitted
acre: acre,acres
action: action,actions
active: active
activity: activity
actor: actor,actors
actual: actual
acute: acute
acuteness: acuteness
adam: adam
adapt: adapted
add: add,adding,adds
addition: addition,additions
additional: additional
address: address,addressed
adduce: adduced
adieu: adieu
adjoining: adjoining
adjudge: adjudged
adjust: adjust,adjusted,adjusting,adjusts
administer: administer,administered,administering
administration: administration
administrator: administrator
admirable: admirable
admiral: admiral
admiralty: admiralty
admiration: admiration
admire: admired
admirer: admirers
admission: admission
admit: admit,admits,admitted,admitting
adopt: adopt,adopting,adopts
adorn: adorned,adorning
adriatic: adriatic
adulterated: adulterated
adulterine: adulterine
advance: advance,advanced,advances,advancing
advanced: advanced
advancement: advancement
advantage: advantage,advantages
advantageous: advantageous
advantageously: advantageously
adventure: adventure,adventures
adventurer: adventurer,adventurers
adventurous: adventurous
adversary: adversaries
adversity: adversity
advice: advice
adviser: advisers
aegean: aegean
aesop: aesop
affair: affair,affairs
affect: affect
affectation: affectation
affection: affection,affections
affectionate: affectionate
affinity: affinity
affirm: affirm
affix: affix,affixed
afflict: afflicted
affluence: affluence
affluent: affluent
afford: afford,afforded,affording,affords
aforesaid: aforesaid
afraid: afraid
africa: africa
african: african
agamemnon: agamemnon
age: age,ages
agen: agen
agency: agency
agent: agents
ages: ages
aggravate: aggravate,aggravated,aggravates
aggravation: aggravation
aggrieved: aggrieved
agility: agility
agio: agio
agrarian: agrarian
agree: agree,agreed,agreeing,agrees
agreeable: agreeable
agreeableness: agreeableness
agreement: agreement,agreements
agricultural: agricultural
agriculture: agriculture
aid: aid,aids
aim: aimed,aiming,aims
air: air,airs
aix: aix
alarm: alarm,alarmed
alarmed: alarmed
alarming: alarming
ale: ale
alehouse: alehouse,alehouses
alexander: alexander
alien: alien,aliens
alienate: alienate,alienating
alienated: alienated
alienation: alienation
alike: alike
alive: alive
alkaline: alkaline
allegation: allegations
allege: allege,alleged,alleging
allegiance: allegiance
alleviate: alleviate,alleviated,alleviating
alliance: alliance
alligator: alligator
allodial: allodial
allodially: allodially
allot: allotted
allotment: allotment
allowance: allowance,allowances
alloy: alloy
allure: allure
ally: allied,allies,ally
aloud: aloud
alps: alps
alter: alter,altered,altering
alteration: alteration,alterations
alternately: alternately
altogether: altogether
alum: alum
amass: amassed,amassing
ambassador: ambassador,ambassadors
ambiguity: ambiguity
ambiguously: ambiguously
ambition: ambition
ambitious: ambitious
amelioration: ameliorations
amenable: amenable
amend: amends
amercement: amercement
america: america
american: american,americans
ammunition: ammunition
ample: ample
amply: amply
amsterdam: amsterdam
amuse: amuse,amused
amusement: amusement,amusements
amusing: amusing
analogy: analogy
anarchy: anarchy
ancestor: ancestors
ancient: ancient,ancients
anciently: anciently
anderson: anderson
angola: angola
animal: animal,animals
animate: animate,animated,animates
animosity: animosity
annals: annals
anne: anne
annex: annex,annexed,annexing
annihilate: annihilate,annihilated
annual: annual
annually: annually
annuitant: annuitant
annuity: annuities,annuity
answer: answer,answered,answering
answerable: answerable
antecedent: antecedent
antidote: antidote
antipathy: antipathy
antiquarian: antiquarians
antiquated: antiquated
antiquity: antiquities,antiquity
antwerp: antwerp
anxiety: anxiety
anxious: anxious
anytime: anytime
apartment: apartment
aperea: aperea
apologize: apologizes
apologue: apologues
apology: apology
apoplexy: apoplexy
apothecaries: apothecaries
apothecary: apothecary
apparent: apparent
appeal: appeal,appealed
appearance: appearance,appearances
appease: appease
appellation: appellation
appendage: appendages
appendix: appendix
applause: applauses
apple: apples
applicable: applicable
application: application
apply: applied,applies,apply,applying
appoint: appoint,appointed,appointing,appoints
appointment: appointment,appointments
apprehend: apprehend,apprehended
apprehension: apprehensions
apprentice: apprentice,apprentices
apprenticeship: apprenticeship,apprenticeships
approach: approach,approached,approaches,approaching
approbation: approbation
appropriation: appropriation
approve: approve,approved
approximation: approximation
april: april
apt: apt
aqueduct: aqueduct
arab: arab,arabs
arabia: arabia
arabian: arabian
arabic: arabic
arable: arable
arbitrary: arbitrary
arbitration: arbitration
archbishop: archbishop
archery: archery
archipelago: archipelago
architect: architects
argument: argument,arguments
argyll: argyll
aristocracy: aristocracies,aristocracy
aristotle: aristotle
arithmetic: arithmetic
arithmetical: arithmetical
arm: arm,armed,arms
armada: armada
armour: armour
armourer: armourer
army: armies,army
arrange: arrange,arranged
arrangement: arrangement
arrear: arrear
arrival: arrivals
arrive: arrive,arrived
arrogant: arrogant
arrow: arrows
art: art,arts
artfully: artfully
article: article,articles
articles: articles
artifice: artifice,artifices
artificer: artificer,artificers
artificers: artificers
artificial: artificial
artificially: artificially
artillery: artillery
artist: artists
ascend: ascended
ascendant: ascendants
ascertain: ascertain,ascertained,ascertaining,ascertains
ascetic: ascetic
ascribe: ascribe,ascribed
ash: ashes
ashamed: ashamed
asia: asia
asiatic: asiatic
aspire: aspire
ass: ass,asses
assault: assault
assay: assaying
assemble: assemble,assembled,assembling
assembly: assemblies,assembly
assentation: assentation
assert: assert,asserted,asserting
assertion: assertion
assess: assess,assessed,assesses,assessing
assessment: assessment,assessments
assessor: assessors
assiento: assiento
assign: assign,assigned,assigning,assigns
assignment: assignment
assist: assist,assisted
assistance: assistance
assize: assize
association: associations
assortment: assortment
assume: assume,assumed,assumes,assuming
assurance: assurance
assure: assure,assured,assures
assuredly: assuredly
astonish: astonish,astonished
astonishment: astonishment
athenians: athenians
athens: athens
atlantic: atlantic
attach: attach,attached
attachment: attachment
attack: attack,attacked,attacking,attacks
attain: attain,attained,attaining
attempt: attempt,attempted,attempting,attempts
attend: attend,attended,attending,attends
attendance: attendance
attendant: attendant,attendants
attention: attention
attentive: attentive
attest: attested
attorney: attorney,attorneys
attract: attract,attracted,attracting,attracts
attraction: attraction,attractions
attribute: attributes
audience: audience
auditor: auditors
augment: augment,augmented,augmenting,augments
augmentation: augmentation,augmentations
august: august
augustine: augustine
augustus: augustus
auspices: auspices
austere: austere
austerity: austerities,austerity
austria: austria
austrian: austrian,austrians
authentic: authentic
authenticate: authenticated
authenticated: authenticated
author: author,authors
authorise: authorised
authority: authority
authorize: authorized
avail: avail
avarice: avarice
average: average
averse: averse
aversion: aversion
avidity: avidity
avoid: avoid,avoided,avoiding
avoirdupois: avoirdupois
avow: avow,avowed
avowed: avowed
awakening: awakening
aware: aware
awe: awe
awful: awful
awkward: awkward
awkwardness: awkwardness
ayrshire: ayrshire
azores: azores
babylon: babylon
babylonian: babylonian
backwardness: backwardness
bad: bad,worse,worst
badge: badge,badges
badly: worse
badness: badness
bahama: bahama
bailiff: bailiff,bailiffs
bake: baked
baker: baker,bakers
balance: balance,balancing
balboa: balboa
bale: bales
baltic: baltic
banana: bananas
band: bands
banditti: banditti
banish: banished,banishes
bank: bank,banks
banker: banker,bankers
banking: banking
banknote: banknotes
bankrupt: bankrupt,bankrupts
bankruptcy: bankruptcies,bankruptcy
banner: banner
banquet: banquet
bar: bar,bars
barbadoes: barbadoes
barbarian: barbarians
barbarism: barbarism
barbarous: barbarous
barbary: barbary
bare: bare
barefooted: barefooted
barely: barely
bargain: bargain,bargains
bargaining: bargaining
bark: bark
barley: barley
barn: barn
baron: baron,barons
barony: baronies,barony
barrack: barrack
barrel: barrel,barrels
barren: barren
barrenness: barrenness
barrier: barriers
barter: barter,bartered
base: base
basil: basil
bath: bath
battle: battle,battles
bauble: baubles
bay: bay
bean: beans
bear: bear,bearing,bears,bore,born,borne
bearer: bearer
beast: beast,beasts
beat: beats
beau: beau
beautiful: beautiful
beautify: beautify
beauty: beauty
beaver: beaver
becket: becket
bed: bed,beds
beef: beef
beer: beer
beg: beg,begging
beggar: beggar,beggars
beggarly: beggarly
beggary: beggary
behave: behave
behaviour: behaviour
behold: beheld,behold
belief: belief
bell: bell
bello: bello
bellow: bellows
belong: belong,belonged,belonging,belongs
beloved: beloved
bench: bench
bend: bend
benefactor: benefactor
benefice: benefice,benefices
beneficial: beneficial
benefit: benefit,benefited,benefits
benevolence: benevolence
bengal: bengal
bent: bent
benumb: benumb
bequeath: bequeathed
berne: berne
bestow: bestow,bestowed,bestowing,bestows
betake: betook
bethink: bethought
betoken: betokens
bible: bible
bid: bid
bind: bind,binding,binds,bound
birch: birch
bird: birds
birmingham: birmingham
birth: birth
bishop: bishop,bishops
bishopric: bishoprics
bit: bit,bits
black: black
blacksmith: blacksmith
blame: blame
blanc: blanc
blank: blanks
blanket: blankets
bleacher: bleacher,bleachers
bless: blessed
blockade: blockade
blood: blood
bloodshed: bloodshed
blossom: blossoms
blow: blows
blubber: blubber
blunder: blunders
blunt: blunt
board: board,boards
boast: boast,boasted
boat: boat,boats
bodied: bodied
bodily: bodily
body: bodies,body
bog: bog
bohemia: bohemia
boiler: boiler
boisterous: boisterous
bold: bold
boll: boll
bombay: bombay
bond: bond,bonds
bondman: bondmen
bondmen: bondmen
bone: bone,bones
book: book,books
bookseller: bookseller
boon: boon
boot: boot,boots
booth: booth
booty: booty
border: border
born: born
boroughs: boroughs
borrow: borrow,borrowed,borrowing,borrows
borrower: borrower,borrowers
borrowing: borrowing
boston: boston
bound: bound,bounded,bounding,bounds
boundary: boundaries,boundary
bounder: bounder
boundless: boundless
bounties: bounties
bounty: bounties,bounty
bourbon: bourbon
bow: bow,bows
bowels: bowels
bowsprit: bowsprits
box: box,boxes
boy: boy,boys
bracelet: bracelets
bramble: brambles
branch: branch,branches
brandy: brandies,brandy
brass: brass
brave: brave
brazier: brazier
brazil: brazil
brazilian: brazilians
brazils: brazils
breach: breach
bread: bread
breadth: breadth
break: break,breaking,breaks,broke,broken
breed: bred,breed,breeding
breeding: breeding
brethren: brethren
brew: brew
brewer: brewer
briar: briars
bribe: bribe,bribing
brick: brick,bricks
bricklayer: bricklayer,bricklayers
brickmaker: brickmaker
bridge: bridge,bridges
brilliant: brilliant
brimstone: brimstone
bring: bring,bringing,brings,brought
bringing: bringing
brink: brink
bristol: bristol
britain: britain
british: british
broad: broad
brocade: brocades
brook: brook
brother: brother,brothers
brown: brown
bruce: bruce
bruges: bruges
brutal: brutal
brutality: brutality
brutus: brutus
buccaneer: buccaneers
buck: buck
bucket: buckets
buckle: buckles
buckwheat: buckwheat
buenos: buenos
buffoon: buffoons
build: build,building,built
builder: builder,builders
building: building,buildings
bulk: bulk
bulky: bulky
bull: bull
bullion: bullion
burden: burden,burdened,burdens
burdensome: burdensome
burgh: burgh,burghs
burgher: burgher,burghers
burgomaster: burgomasters
burgundy: burgundy
burman: burman
burn: burn,burning,burnt
burner: burner
burrow: burrowed
burrower: burrower
bursary: bursaries
burthen: burthen
bury: bury
bus: bus,busses
bushel: bushel,bushels
bushels: bushels
business: business
buss: buss
busses: busses
butcher: butcher,butchers
butter: butter
button: button
buyer: buyer,buyers
buying: buying
bye: bye
byron: byron
cabbage: cabbages
cabinet: cabinet
cachet: cachet
caesar: caesar
calaminaris: calaminaris
calamity: calamities,calamity
calculate: calculated
calculation: calculation,calculations
calcutta: calcutta
calendar: calendar
calf: calf,calves
calico: calicoes
calling: callings
calm: calm
calvin: calvin
calvinistic: calvinistic
cambric: cambrics
camp: camp
campaign: campaign,campaigns
campus: campus
canada: canada
canal: canal,canals
canaries: canaries
cancel: cancelled
candid: candid
candidate: candidate,candidates
candle: candle,candles
candour: candour
cane: cane
cannon: cannon
canon: canon,canons
canterbury: canterbury
canton: canton,cantons
cap: cap
capable: capable
capacity: capacity
cape: cape
capetian: capetian
capital: capital,capitals
capitation: capitation
capitulation: capitulation
caprice: caprice
capricious: capricious
capriciously: capriciously
captain: captain,captains
capture: capture
carat: carats
caravan: caravans
carcase: carcase
card: cards
carder: carder
care: care,cared,cares
careful: careful
carefully: carefully
careless: careless
cargo: cargo,cargoes
caring: caring
carlisle: carlisle
carolina: carolina
carolinas: carolinas
caroline: caroline
carpenter: carpenter,carpenters
carriage: carriage,carriages
carrier: carrier,carriers
carrion: carrion
carrot: carrots
carry: carried,carries,carry,carrying
cart: cart,carts
carthaginian: carthaginian
carver: carver
cash: cash
cashier: cashier
cask: cask,casks
caspian: caspian
cassius: cassius
cast: cast,casts
casteth: casteth
castile: castile
castle: castle,castles
casual: casual
casualty: casualties
casuistry: casuistry
cat: cat,cats
catch: catch,catching,caught
catholic: catholic,catholics
cattle: cattle
caution: caution
cease: cease,ceased,ceases
cede: ceded
celebes: celebes
celebrate: celebrated,celebrating
celebrated: celebrated
cellar: cellar
censure: censure
cent: cent
central: central
centre: centre
century: centuries,century
ceremonial: ceremonial,ceremonials
ceremony: ceremonies
certainty: certainty
certificate: certificate,certificates
certificated: certificated
certify: certifies,certify,certifying
chace: chace
chaff: chaff
chair: chair,chairs
chairman: chairman,chairmen
chairmen: chairmen
chaldron: chaldron
chamber: chambers
chamberlain: chamberlain
champaign: champaign
chance: chance,chances
chancery: chancery
change: change,changed,changing
channel: channel,channels
chap: chap
chaplain: chaplain
chapter: chapter,chapters
character: character,characters
characteristic: characteristic
charcoal: charcoal
charge: charge,charged,charges
chargeable: chargeable
charitable: charitable
charity: charities,charity
charlemagne: charlemagne
charles: charles
charm: charms
charter: charter,charters
chase: chased
chastise: chastise,chastising
chastity: chastity
chattel: chattels
cheap: cheap,cheaper,cheapest
cheaply: cheaply
cheapness: cheapness
cheat: cheat,cheated
check: checking,checks
cheer: cheer
cheerful: cheerful
cheese: cheese
chest: chest
chief: chief,chiefs
chiefly: chiefly
chieftain: chieftain,chieftains
chieftainship: chieftainship
child: child,children
childish: childish
chili: chili
chimerical: chimerical
china: china
chinese: chinese
chivalry: chivalry
chocolate: chocolate
choice: choice
choose: choose,chooses,chose,chosen
christendom: christendom
christian: christian
christianity: christianity
christopher: christopher
chronological: chronological
church: church,churches
churchman: churchman,churchmen
churchwarden: churchwarden
chuse: chuse
cicero: cicero
circle: circle
circuit: circuit
circulate: circulate,circulated,circulates,circulating
circulation: circulation
circumspect: circumspect
circumspection: circumspection
circumstance: circumstance,circumstanced,circumstances
circumstantial: circumstantial
cities: cities
citizen: citizen,citizens
citizenship: citizenship
city: cities,city
civil: civil
civile: civile
civilization: civilization
civilized: civilized
claim: claim,claimed,claiming,claims
clamorous: clamorous
clamour: clamour,clamoured
clan: clan
clandestinely: clandestinely
claret: claret
class: class,classed,classes
classical: classical
clause: clause,clauses
clay: clay,clayed,claying
claying: claying
clean: clean,cleaning
cleanlier: cleanlier
cleanliness: cleanliness
cleanly: cleanly
cleanse: cleansing
clearing: clearing
clergy: clergy
clergyman: clergyman,clergymen
clerk: clerk,clerks
climate: climate
clip: clipping,clips
clipt: clipt
clock: clock,clocks
clog: clog,clogged
close: close
closely: closely
cloth: cloth,cloths
clothe: clothe,clothed
clothes: clothes
clothier: clothiers
clothing: clothing
clove: clove
clover: clover
coach: coach,coaches
coachmaker: coachmaker
coal: coal,coals
coarse: coarse,coarser,coarsest
coarser: coarser
coast: coast,coasting,coasts
coat: coat
cobweb: cobweb
cochin: cochin
cocoa: cocoa
cod: cod
code: code
coffee: coffee
coffer: coffer,coffers
cognizance: cognizance
coin: coin,coined,coining,coins
coinage: coinage
coincide: coincide,coinciding
coiner: coiner,coiners
coining: coining
cold: cold
collate: collated,collating
collateral: collateral,collaterals
collation: collation
collect: collect,collected,collecting,collects
collection: collection,collections
collector: collector,collectors
college: college,colleges
collier: collier,colliers
colonel: colonel
coloni: coloni
colonies: colonies
colonist: colonist,colonists
colonization: colonization
colonize: colonizing
colony: colonies,colony
colour: colour
coloured: coloured
columbus: columbus
columella: columella
comb: comb
comber: comber,combers
combination: combination,combinations
combine: combine,combined,combining
comer: comer
comet: comets
comfort: comfort
comfortable: comfortable
comfortably: comfortably
comforter: comforters
command: command,commanded,commanding,commands
commandery: commanderies
commanding: commanding
commence: commence
commencement: commencement
commend: commend,commended
commerce: commerce
commercial: commercial
commissary: commissaries,commissary
commission: commission,commissioned,commissions
commissioner: commissioners
commit: commit,committed,committing
committee: committee
committeeman: committeeman
commodity: commodities,commodity
common: common,commons
commonalty: commonalty
commonly: commonly
commonwealth: commonwealth
commotion: commotion
communicate: communicate,communicated,communicating
communication: communication,communications
community: community
companion: companion,companions
companionship: companionship
company: companies,company
comparative: comparative
comparatively: comparatively
compare: compare,compared,compares,comparing
comparison: comparison,comparisons
compass: compass
compel: compel
compensate: compensate,compensated,compensates,compensating
compensation: compensation
competent: competent
competition: competition
competitor: competitor,competitors
compile: compiled
complain: complain,complained,complaining,complains
complaint: complaint,complaints
complaisance: complaisance
complaisant: complaisant
complement: complement
complete: complete,completed,completes,completest
completely: completely
complex: complex
complexly: complexly
compliance: compliance
complicated: complicated
comply: complied,comply
component: component
compose: compose,composed
composition: composition
compound: compound,compounds
comprehend: comprehend,comprehended,comprehending,comprehends
comprehension: comprehension
comprehensive: comprehensive
compulsive: compulsive
computation: computation,computations
compute: compute,computed,computes,computing
conceal: conceal,concealed,concealing
concealment: concealment
conceit: conceit
conceited: conceited
conceive: conceive,conceived,conceives,conceiving
concern: concern,concerned,concerns
concerned: concerned
concert: concert
concession: concessions
conclude: conclude,concluded
conclusion: conclusion
conclusive: conclusive
concordat: concordat
concur: concur,concurred
concurrence: concurrence
condescend: condescend
condition: condition,conditions
condom: condom
conduce: conduces
conduct: conduct,conducted,conducting
conductor: conductors
coney: coney
confederacy: confederacy
confer: confer,conferred,conferring
confession: confession
confide: confide
confidence: confidence
confidently: confidently
confine: confine,confined,confining
confinement: confinement
confines: confines
confirm: confirm,confirmed,confirms
confiscate: confiscated
confound: confounded,confounds
confused: confused
confusion: confusion,confusions
congo: congo
congregation: congregation
congress: congress
conjectural: conjectural
conjecture: conjecture
conjunction: conjunction
connect: connect,connected,connecting,connects
connecticut: connecticut
connection: connection,connections
connexion: connexion
connivance: connivance
connive: connived
conquer: conquer,conquered,conquering
conquering: conquering
conqueror: conqueror,conquerors
conquest: conquest,conquests
conscience: conscience
conscientious: conscientious
conscious: conscious
consciousness: consciousness
consecrate: consecrated
consent: consent,consented
consequence: consequence,consequences
consequent: consequent
consequential: consequential
considerable: considerable
considerably: considerably
consideration: consideration,considerations
consign: consigned
consignment: consignments
consist: consist,consisted,consisting,consists
consistent: consistent
consistently: consistently
consistorial: consistorial
consolation: consolation
consolidate: consolidated
conspiracy: conspiracy
constable: constable
constancy: constancy
constant: constant
constantine: constantine
constantinople: constantinople
constantly: constantly
constituent: constituent,constituents
constitute: constitute,constituted,constitutes,constituting
constitution: constitution,constitutions
constraint: constraint
construct: construct,constructed,constructing
construe: construe
consul: consul,consuls
consult: consult,consulted,consulting,consults
consumable: consumable
consume: consume,consumed,consumes,consuming
consumer: consumer,consumers
consumption: consumption,consumptions
contact: contact
contemplation: contemplation
contempt: contempt
contemptible: contemptible
contemptuous: contemptuous
contemptuously: contemptuously
contend: contending
content: content,contenting
contented: contented
contentedly: contentedly
contents: contents
contest: contest
continent: continent,continents
continental: continental
contingent: contingent
continual: continual
continually: continually
continuance: continuance
continuation: continuation
continue: continue,continued,continues,continuing
continued: continued
contraband: contraband
contract: contract,contracted,contracts
contracting: contracting
contradistinction: contradistinction
contrary: contrary
contrast: contrast,contrasted
contribute: contribute,contributed,contributes,contributing
contribution: contribution,contributions
contributor: contributor,contributors
contrivance: contrivance,contrivances
contrive: contrive,contriving
contrived: contrived
contriver: contrivers
control: control,controlling,controls
controversy: controversy
controvert: controvert
conveniency: conveniencies,conveniency
convenient: convenient
conveniently: conveniently
conventicle: conventicle
conversation: conversation
converse: converse
conversion: conversion
convert: convert,converted,converting,converts
convey: convey,conveyed,conveying,conveys
conveyance: conveyance,conveyances
convict: convicted,convicting
conviction: conviction
convince: convince,convinced,convincing
convinced: convinced
convulsion: convulsion,convulsions
cook: cooking
copartnery: copartnery
copenhagen: copenhagen
copier: copiers
copper: copper
corn: corn
corner: corner,corners
cornwall: cornwall
corporate: corporate
corporation: corporation,corporations
correct: correct,corrected,correcting,corrects
correction: correction
correspond: correspond,corresponded,corresponds
correspondence: correspondence
correspondent: correspondent,correspondents
corrupt: corrupt,corrupted,corrupts
corrupted: corrupted
corruption: corruption
cortes: cortes
corvee: corvees
cossacks: cossacks
cost: cost,costs
costly: costly
cottager: cottagers
cottar: cottars
cotton: cotton
couch: couches
council: council,councils
counsellor: counsellor,counsellors
count: count,counted
countenance: countenance
counteract: counteract
counterbalance: counterbalance,counterbalanced
counterfeit: counterfeit,counterfeits
counting: counting
country: countries,country
countryman: countrymen
county: counties,county
courage: courage
court: court,courted,courts
cover: cover,covered,covering,covers
covered: covered
covet: coveting
cow: cow
coward: coward
cowardice: cowardice
craft: craft,crafts
crafty: crafty
cramp: cramping,cramps
crazy: crazy
create: create,created,creates,creating
creature: creature
credibility: credibility
credit: credit,credited,credits
creditable: creditable
creditor: creditor,creditors
credulity: credulity
creep: creep
creole: creoles
crew: crew
crime: crime,crimes
criminal: criminal,criminals
criterion: criterion,criterions
critical: critical
cromwell: cromwell
crop: crop,cropping,crops
cross: cross
crowd: crowd,crowded
crown: crown,crowns
crucible: crucible
cruel: cruel,cruellest
cruelly: cruelly
cruelty: cruelty
crumble: crumble
crusade: crusades
crush: crushes
cruzado: cruzadoes
cuba: cuba
cubic: cubic
cudgel: cudgel
cultivate: cultivate,cultivated,cultivates,cultivating
cultivation: cultivation
cultivator: cultivator,cultivators
culture: culture
cumbersome: cumbersome
curacoa: curacoa
curacy: curacies
curate: curate,curates
cure: cure,cured,cures,curing
curer: curers
curiosity: curiosities,curiosity
curious: curious
currant: currants
currency: currencies,currency
current: current
curse: curse
cursitor: cursitor
curtain: curtain
cushion: cushions
custom: custom,customs
customary: customary
customer: customer,customers
cut: cut,cuts
cutler: cutler,cutlers
cutter: cutter
cutting: cutting
cylinder: cylinder
cyprus: cyprus
daedalian: daedalian
daily: daily
dairy: dairies,dairy
dam: dam
damage: damage
damages: damages
damp: damp
dance: dance
dancer: dancers
dancing: dancing
danes: danes
danger: danger,dangers
dangerous: dangerous
daniel: daniel
danish: danish
danube: danube
darien: darien
daring: daring
darkness: darkness
dastardly: dastardly
daughter: daughter,daughters
dauphine: dauphine
dawn: dawning
day: day,days
dazzling: dazzling
dead: dead
deal: deal,dealing,deals,dealt
dealer: dealer,dealers
dealing: dealing
dealings: dealings
dean: deans
dearly: dearly
dearness: dearness
dearth: dearth,dearths
death: death
debase: debased
debased: debased
debasement: debasement
debate: debates
debauch: debauched
debt: debt,debts
debtor: debtor,debtors
decay: decay,decayed,decaying,decays
decaying: decaying
deceive: deceive,deceived
december: december
decency: decency
decent: decent
decently: decently
deception: deception
decide: decide,decided,decides,deciding
decision: decision,decisions
decisive: decisive
deck: decked
decker: decker
declamation: declamation
declaration: declaration
declare: declare,declared,declares,declaring
declension: declension
decline: decline,declined,declines,declining
decoy: decoy
decrease: decrease,decreased
decree: decrees
dedicate: dedicate
deducible: deducible
deduct: deduct,deducted,deducting
deduction: deduction,deductions
deed: deed,deeds
deem: deemed
deep: deep,deeper
deeply: deeply
deer: deer
deface: defaced
defaced: defaced
defame: defames
default: default
defeat: defeat,defeated
defect: defect,defects
defective: defective
defence: defence
defenceless: defenceless
defend: defend,defended,defending
defendant: defendant
defensive: defensive
defiance: defiance
deficiency: deficiency
deform: deformed
deformity: deformity
defraud: defraud,defrauded
defray: defray,defrayed,defraying,defrays
degeneracy: degeneracy
degenerate: degenerate,degenerated
degradation: degradation
degrade: degrade,degraded
degraded: degraded
degrading: degrading
degree: degree,degrees
deign: deign
deity: deity
delay: delay,delayed,delays
delegate: delegate
deliberate: deliberate,deliberated,deliberates
deliberation: deliberation,deliberations
delicacy: delicacy
delicate: delicate
delight: delights
delightful: delightful
deliver: deliver,delivered,delivering,delivers
delivery: delivery
delusion: delusion,delusions
demand: demand,demanded,demanding,demands
demander: demanders
demesne: demesne,demesnes
democracy: democracies,democracy
democratical: democratical
demonstrate: demonstrate,demonstrated,demonstrates
demonstration: demonstrations
demonstrative: demonstrative
denarii: denarii
denier: deniers
denmark: denmark
denominate: denominate
denomination: denomination,denominations
denote: denote,denotes,denoting
deny: denier
depart: depart,departing
department: department,departments
departure: departure
depend: depend,depended,depending,depends
dependant: dependants
dependence: dependence
dependency: dependencies,dependency
dependent: dependent,dependents
depopulate: depopulated
depopulation: depopulation
depose: deposed
deposit: deposit,deposited,deposits
depredation: depredation,depredations
depress: depress,depressed,depresses,depressing
depression: depression
deprivation: deprivation
deprive: deprive,deprived,depriving
depth: depth
depths: depths
deputy: deputies,deputy
derange: derange,deranged
derangement: derangement
deride: deride
derision: derision
derivative: derivative
derive: derive,derived,derives,deriving
des: des
descend: descend,descended
descendant: descendant,descendants
descent: descent
description: description
desert: desert,deserted,deserts
deserve: deserve,deserves,deserving
design: design,designs
designation: designation
desire: desire,desired,desires
desirous: desirous
despair: despair
despatch: despatches
desperate: desperate
despise: despise,despised,despises
desponding: desponding
despotic: despotic
despotical: despotical
despotism: despotism
destination: destination
destine: destined,destines
destroy: destroy,destroyed,destroying,destroys
destruction: destruction
destructive: destructive
detach: detach,detached
detachment: detachment,detachments
detain: detain,detaining
deter: deter
determine: determine,determined,determines,determining
detestable: detestable
detestation: detestation
detraction: detraction
devastation: devastation
deviate: deviates
deviation: deviations
device: device
devise: devise,devised
devolve: devolved
devoted: devoted
devotion: devotion
devour: devoured,devours
dexterity: dexterity
dial: dial
diamond: diamond,diamonds
dice: dice
dictate: dictate,dictated,dictates
die: die,died,dies
diet: diet
difference: difference,differences
difficult: difficult
difficulty: difficulties,difficulty
diffidence: diffidence
diffuse: diffuses
dig: dig,digging,dug
digest: digested
dignified: dignified
dignitary: dignitaries
dignity: dignities,dignity
digression: digression
diligence: diligence
diligent: diligent
dimension: dimensions
diminish: diminish,diminished,diminishes,diminishing
diminished: diminished
diminution: diminution
dine: dine
dining: dining
dinner: dinner
diocese: diocese
diogenes: diogenes
dion: dion
diplomata: diplomata
direct: direct,directed,directing,directs
direction: direction
director: director,directors
dirtiness: dirtiness
dirty: dirty
disable: disables
disabled: disabled
disadvantage: disadvantage,disadvantages
disadvantageous: disadvantageous
disagreeable: disagreeable
disagreeableness: disagreeableness
disagreeably: disagreeably
disappoint: disappointed
disappointed: disappointed
disappointment: disappointment
disapprobation: disapprobation
disaster: disaster,disasters
disband: disband
disbanding: disbanding
disburden: disburden,disburdened,disburdens
discern: discern
discharge: discharge,discharged,discharges
disciple: disciples
discipline: discipline,disciplined,disciplining
discontent: discontent
discontinue: discontinue
discord: discord
discount: discount,discounted,discounting,discounts
discountenance: discountenancing
discounting: discounting
discourage: discourage,discouraged,discourages,discouraging
discouraged: discouraged
discouragement: discouragement,discouragements
discourse: discourse
discourses: discourses
discover: discover,discovered,discovering,discovers
discovery: discoveries,discovery
discredit: discredit
discreditable: discreditable
discretion: discretion
discretionary: discretionary
discussion: discussion
disdain: disdain,disdained,disdains
disease: disease,diseases
disengage: disengaged
disfranchise: disfranchised
disgorge: disgorges
disgrace: disgrace
disgraced: disgraced
disgraceful: disgraceful
disguise: disguised
disgust: disgust,disgusted
dishearten: disheartened
disheartened: disheartened
disheartening: disheartening
dishonour: dishonour
dishonourableness: dishonourableness
dismal: dismal
dismember: dismembered
dismemberment: dismemberment
dismiss: dismiss,dismissed,dismissing
disobligation: disobligation
disoblige: disobliged
disorder: disorder,disorders
disorderly: disorderly
dispassionate: dispassionate
dispatch: dispatch
dispensation: dispensation
dispense: dispensed,dispenses
disperse: dispersed
dispersed: dispersed
displace: displace
displeasure: displeasure
disposal: disposal
dispose: dispose,disposed,disposes,disposing
disposed: disposed
disposition: disposition,dispositions
dispossession: dispossession
disproportion: disproportion
disputable: disputable
dispute: dispute,disputed,disputes,disputing
disqualify: disqualified,disqualify,disqualifying
disregard: disregarded
dissension: dissensions
dissent: dissenting
dissenter: dissenters
dissimilar: dissimilar
dissipate: dissipate,dissipated,dissipates
dissipation: dissipation
dissolute: dissolute
dissolution: dissolution
dissolve: dissolve,dissolved
dissuade: dissuading
distance: distance
distant: distant
distinct: distinct
distinction: distinction,distinctions
distinctly: distinctly
distinctness: distinctness
distinguish: distinguish,distinguished,distinguishes,distinguishing
distinguished: distinguished
distract: distract
distraction: distraction
distress: distress,distresses
distressed: distressed
distribute: distribute,distributed,distributing
distribution: distribution,distributions
district: district,districts
distrust: distrust
disturb: disturb,disturbed,disturbing
disturbance: disturbance,disturbances
disturber: disturbers
disuse: disuse
disused: disused
ditcher: ditcher
ditto: ditto
diver: divers
diversion: diversion,diversions
diversity: diversity
divert: divert,diverted
divide: divide,divided,divides,dividing
divided: divided
dividend: dividend
divine: divine,divines
divinity: divinity
division: division,divisions
docility: docility
doctor: doctor,doctors
doctrine: doctrine,doctrines
dog: dog,dogs
doge: doge
doleful: doleful
dollar: dollars
dollars: dollars
domain: domain
domestic: domestic
domineer: domineer,domineers
dominic: dominic
dominion: dominion,dominions
donation: donations
donor: donor,donors
doomsday: doomsday
door: door,doors
dorado: dorado
dotage: dotage
doth: doth
double: double,doubled,doubling
doubt: doubt,doubted
douglas: douglas
dowager: dowager
dower: dower
downright: downright
dozen: dozen
dr: dr
draco: draco
drag: drag
drain: drained,draining,drains
dramatic: dramatic
draper: draper,drapers
draught: draught,draughts
draw: draw,drawing,drawn,draws,drew
drawback: drawback,drawbacks
drawer: drawer,drawers
drawing: drawing
dread: dread
dreadful: dreadful
dream: dream,dreams
dress: dress,dresses,dressing
dressed: dressed
dresser: dresser,dressers
drill: drill
drink: drank
drive: drive,driven,drives,driving,drove
droits: droits
drop: drop
drought: drought
drown: drowned
drowsy: drowsy
drug: drug,drugs
drum: drums
drunk: drunk
drunkard: drunkard
drunkenness: drunkenness
dry: dried,dry
du: du
ducat: ducat,ducats
duchy: duchies,duchy
duke: duke,dukes
dull: dull
duly: duly
dung: dung
dunghill: dunghill
durable: durable
durableness: durableness
durably: durably
duration: duration
dust: dust
dutch: dutch
dutchy: dutchy
duty: duties,duty
dwell: dwell,dwelling,dwelt
dwelling: dwelling
dwindle: dwindled,dwindles
dye: dye,dyed
dyeing: dyeing
dyer: dyer,dyers
eager: eager
eagerly: eagerly
eagerness: eagerness
earl: earl,earls
earn: earn,earned,earns
earnest: earnest
earnestly: earnestly
earnings: earnings
earth: earth
earthen: earthen
earthquake: earthquake
ease: ease
easily: easily
easiness: easiness
east: east
eastern: eastern
eastland: eastland
easy: easier,easiest,easy
eat: eat,eats
ecclesiastic: ecclesiastic,ecclesiastics
ecclesiastical: ecclesiastical
eclipse: eclipses
economical: economical
economist: economist,economists
economy: economy
edge: edge,edges
edict: edict,edicts
edinburgh: edinburgh
edition: edition,editions
educate: educate,educated
education: education
edward: edward
efface: effaced
effects: effects
effectual: effectual
effectually: effectually
effectuate: effectuate,effectuated,effectuating
effectuation: effectuation
effeminate: effeminate
efficacy: efficacy
effort: effort,efforts
egypt: egypt
egyptian: egyptian,egyptians
eighteen: eighteen
eighth: eighth
ejectment: ejectment
el: el
elapse: elapsed
eld: elder,eldest
elder: elder
elect: elect,elected,electing,elects
election: election,elections
elector: elector
elegance: elegance
elegancy: elegancies
elegant: elegant
element: elements
elementary: elementary
elephant: elephants
elevation: elevation
eleventh: eleventh
elizabeth: elizabeth
eloquence: eloquence
eloquent: eloquent
emancipate: emancipate,emancipated
emancipated: emancipated
emancipation: emancipation
embarrass: embarrass,embarrassed,embarrasses
embarrassing: embarrassing
embarrassment: embarrassment
embassy: embassies,embassy
embellish: embellish,embellishes
embezzle: embezzling
embezzlement: embezzlement
embrace: embrace,embraced
embroidery: embroideries,embroidery
emerge: emerges
emergency: emergencies,emergency
emigration: emigration
eminence: eminence
eminent: eminent
emission: emission,emissions
emit: emitted
emolument: emoluments
emotion: emotion
emperor: emperor,emperors
empire: empire,empires
employ: employ,employed,employing,employs
employer: employer,employers
employment: employment,employments
emporium: emporium
empower: empowered,empowering
empress: empress
emulation: emulation
en: en
enable: enable,enabled,enables,enabling
enact: enact,enacted,enacting
encamp: encamped
encounter: encounter,encountered,encountering
encourage: encourage,encouraged,encourages,encouraging
encouragement: encouragement,encouragements
encroach: encroach,encroaches,encroaching
encroachment: encroachment,encroachments
encumber: encumbered,encumbers
endanger: endanger,endangered
endeavour: endeavour,endeavoured,endeavouring
endless: endless
endow: endowed
endowed: endowed
endowment: endowment,endowments
endure: endure,endured,endures
enemy: enemies,enemy
enforce: enforce,enforced,enforces,enforcing
enfranchise: enfranchised
engage: engage,engaged,engaging
engagement: engagements
engine: engine,engines
engineer: engineer
england: england
english: english
engross: engross,engrossed
engrossed: engrossed
engrosser: engrosser,engrossers
engrossing: engrossing
enhance: enhance,enhanced,enhances,enhancing
enhancement: enhancement,enhancements
enjoin: enjoin,enjoined
enjoy: enjoy,enjoyed,enjoying,enjoys
enjoyment: enjoyment,enjoyments
enlarge: enlarge,enlarged
enlargement: enlargement
enlist: enlist,enlists
enormity: enormities
enormous: enormous
enquire: enquire,enquired
enrage: enraged
enregister: enregister
enrich: enrich,enriched,enriches,enriching
ensue: ensuing
entail: entail,entailed,entails
enter: enter,entered,entering,enters
entertain: entertain,entertained,entertaining
entertainment: entertainment
enthusiasm: enthusiasm
enthusiast: enthusiast,enthusiasts
enthusiastic: enthusiastic
entice: entice,enticed,enticing
entire: entire
entitle: entitle,entitled,entitles,entitling
entrance: entrance
entreat: entreat
entrepot: entrepot,entrepots
entrust: entrust,entrusted
entry: entry
enumerate: enumerated
enumeration: enumeration
envoy: envoy
envy: envied,envy
eo: eo
episcopal: episcopal
equal: equal,equalled,equals
equality: equality
equally: equally
equilibrium: equilibrium
equipage: equipage
equipment: equipments
equitable: equitable
equity: equity
equivalent: equivalent,equivalents
erect: erect,erected,erecting,erects
erection: erection
error: error,errors
esau: esau
escape: escape,escaped,escapes
esquire: esquires
essay: essay,essays
essence: essence
essential: essential
essentially: essentially
establish: establish,established,establishes,establishing
established: established
establishment: establishment,establishments
estate: estate,estates
esteem: esteem,esteemed
esteemed: esteemed
estimate: estimate,estimated
estimation: estimation,estimations
eternal: eternal
ether: ether
ethic: ethics
eton: eton
eulogy: eulogy
europe: europe
european: european,europeans
euxine: euxine
evade: evade,evaded,evading
evasion: evasions
evening: evening
event: event,events
everyman: everyman
evidence: evidence
evident: evident
evidently: evidently
evil: evil
exact: exact,exacted,exacting,exacts
exaction: exaction,exactions
exactness: exactness
exaggerate: exaggerate,exaggerated
exaggerated: exaggerated
exaggeration: exaggeration,exaggerations
exaltation: exaltation
examination: examination
examine: examine,examined,examines,examining
exasperate: exasperating
exceed: exceed,exceeded,exceeding,exceeds
excel: excel,excelled,excels
excellence: excellence
excellency: excellency
excellent: excellent
exception: exception,exceptions
excess: excess,excesses
excessive: excessive
excessively: excessively
exchange: exchange,exchanged,exchanges,exchanging
exchangeable: exchangeable
exchequer: exchequer
excise: excise,excises
excite: excite,excited,excites
excited: excited
exciting: exciting
exclude: exclude,excluded,excludes,excluding
exclusion: exclusion
exclusive: exclusive
exclusively: exclusively
excommunicate: excommunicated
excommunication: excommunication
excuse: excused,excuses
execration: execration
execute: execute,executed,executes,executing
execution: execution
executioner: executioner
executive: executive
executor: executor
exemplary: exemplary
exempt: exempt,exempted,exempting
exemption: exemption,exemptions
exercise: exercise,exercised,exercises,exercising
exert: exert,exerted,exerting,exerts
exertion: exertion,exertions
exhaust: exhaust,exhausted
exhausted: exhausted
exhibition: exhibitions
exhortation: exhortation
exigency: exigencies,exigency
exigible: exigible
exist: exist,existed,existing,exists
existence: existence
exorbitant: exorbitant
expect: expect,expected,expecting,expects
expectation: expectation,expectations
expedient: expedient,expedients
expedition: expedition
expeditious: expeditious
expel: expel,expelled
expend: expended
expenditure: expenditure
expense: expense,expenses
expensive: expensive
experience: experience
experienced: experienced
experiment: experiment,experiments
experimental: experimental
expert: expert
expertness: expertness
expiration: expiration
expire: expire,expired,expiring
explain: explain,explained,explaining
explanation: explanation
explication: explication
explode: exploded
exploit: exploit,exploits
export: export,exported,exporting,exports
exportation: exportation
exporter: exporter,exporters
expose: expose,exposed,exposes,exposing
express: express,expressed,expresses,expressing
expression: expression,expressions
expressly: expressly
expulsion: expulsion
extend: extend,extended,extending,extends
extended: extended
extension: extension
extensive: extensive
extent: extent
extinguish: extinguish,extinguished
extirpate: extirpated,extirpating
extol: extolled
extort: extort,extorted,extorting
extortion: extortion
extra: extra
extract: extracts
extraction: extraction
extraneous: extraneous
extraordinary: extraordinary
extravagance: extravagance
extravagant: extravagant
extravagantly: extravagantly
extreme: extreme
extremely: extremely
extremity: extremities,extremity
extricate: extricate
eye: eye,eyes
fable: fables
fabric: fabric
fabrication: fabrication
fabulous: fabulous
facilitate: facilitate,facilitated,facilitates,facilitating
facility: facility
faction: faction,factions
factious: factious
factor: factor,factors
factory: factory
faculty: faculties,faculty
fail: fail,failed,fails
failure: failure
fair: fair,fairs
faith: faith
faithful: faithful
faithfully: faithfully
fall: fall,fallen,falling,falls,fell
fallacious: fallacious
fallacy: fallacy
fallow: fallow
false: false
falsehood: falsehood
falsely: falsely
familiar: familiar
family: families,family
famine: famine,famines
famous: famous
fan: fanning
fanatic: fanatics
fanatical: fanatical
fanaticism: fanaticism
fancy: fancied,fancies,fancy,fancying
fantastical: fantastical
fare: fare
farm: farm,farming,farms
farmer: farmer,farmers
farmers: farmers
farmhouse: farmhouses
farming: farming
farth: farthest
farthing: farthing,farthings
fashion: fashion,fashioning
fashionable: fashionable
fashionableness: fashionableness
fast: fast,faster,fastest
fat: fat
fatal: fatal
fate: fate
father: father,fathers
fathom: fathom
fatigue: fatigues
fatten: fattened,fattening
fault: fault
faulty: faulty
favour: favour,favoured,favouring,favours
favourable: favourable
favourably: favourably
favoured: favoured
favourite: favourite
fawn: fawning,fawns
fear: fear,feared,fearing,fears
feast: feast
february: february
fed: fed
fee: fee,fees
feeble: feeble
feed: fed,feed,feeding,feeds
feeding: feeding
feel: feel,feeling,feels
feller: feller
fellow: fellow,fellows
fellowship: fellowship
felon: felon,felons
felony: felony
female: female
fence: fence,fences
fencing: fencing
fermented: fermented
fertile: fertile
fertility: fertility
fervour: fervour
festival: festival
festivity: festivity
fetch: fetch,fetching
fetcher: fetchers
fetter: fetters
feudal: feudal
fiar: fiars
fiction: fictions
fictitious: fictitious
fidelity: fidelity
fief: fiefs
field: field,fields
fife: fifes
fifteenth: fifteenth,fifteenths
fifthly: fifthly
fiftieth: fiftieth
fight: fight,fought
figure: figure,figures
filial: filial
fillet: fillets
filth: filth
fin: fins
final: final
finally: finally
finances: finances
finder: finder
fine: fine,fined,finer,fines,finest
fineness: fineness
finery: finery
finish: finished
finished: finished
firearm: firearms
firma: firma
firmly: firmly
fish: fish,fishes
fisher: fishers
fisherman: fisherman,fishermen
fishery: fisheries,fishery
fishing: fishing
fit: fit,fits,fitted,fitter,fittest,fitting
fitness: fitness
fivepence: fivepence
fixation: fixation
fixed: fixed
flanders: flanders
flat: flatter
flatter: flattered
flattering: flattering
flattery: flattery
flavour: flavour
flax: flax
flee: fled
fleece: fleece,fleeces
fleet: fleet,fleets
flesh: flesh
flock: flock,flocks
floor: floor
florence: florence
florida: florida
florin: florins
flota: flota
flour: flour
flourish: flourish,flourished,flourishing
flourishing: flourishing
flow: flow,flowed,flowing,flows
flower: flowers
fluctuate: fluctuate,fluctuating
fluctuation: fluctuations
fly: fly
follow: follow
follower: followers
folly: folly
fond: fond,fondest
food: food
fool: fool,fools
foolish: foolish
foot: feet,foot
footing: footing
footman: footman,footmen
forage: forage
forbearance: forbearance
forbid: forbid
force: force,forced,forces,forcing
forced: forced
forcible: forcible
forcibly: forcibly
forefather: forefathers
forego: forego,foregoing
foregoing: foregoing
foreign: foreign
foreigner: foreigner,foreigners
forerunner: forerunner
foresee: foresaw,foresee,foreseen,foresees
foresight: foresight
forest: forest,forests
forestall: forestalled,forestalling
foretell: foretold
forfeit: forfeit,forfeited,forfeiting,forfeits
forfeiture: forfeiture,forfeitures
forge: forge,forges,forging
forger: forger
forget: forget,forgot
fork: forks
form: form,formed,forming,forms
formality: formalities
formidable: formidable
formulary: formularies
fort: fort,forts
fortieth: fortieth
fortification: fortification
fortified: fortified
fortify: fortified,fortify
fortitude: fortitude
fortress: fortresses
fortunate: fortunate
fortunately: fortunately
fortune: fortune,fortunes
forwards: forwards
fossil: fossils
foul: foul
foundation: foundation,foundations
founder: founder,founders
fourpence: fourpence
fourteen: fourteen
fourteenth: fourteenth
fourth: fourth,fourths
fourthly: fourthly
fowl: fowl,fowls
fraction: fraction
frame: frame,framed,frames
france: france
francis: francis
frankness: frankness
franks: franks
fraud: fraud,frauds
fraudulent: fraudulent
frederic: frederic
frederick: frederick
freebooter: freebooters
freedman: freedman
freedom: freedom
freehold: freehold,freeholds
freely: freely
freeman: freeman,freemen
freight: freight
french: french
frenzy: frenzies,frenzy
frequency: frequency
frequent: frequent,frequented,frequenting
frequently: frequently
fresh: fresh
friar: friars
friend: friend,friends
friendship: friendship
frighten: frighten
frivolous: frivolous
frontier: frontier,frontiers
frost: frost
frozen: frozen
frugal: frugal
frugality: frugality
fruit: fruit,fruits
fruitful: fruitful
fruitless: fruitless
fuel: fuel
fulfil: fulfil
fulling: fulling
function: function,functions
fund: fund,funds
fundamental: fundamental
funeral: funerals
fur: furs
furious: furious
furnace: furnace,furnaces
furnish: furnish,furnished,furnishes
furnished: furnished
furnishing: furnishing
furniture: furniture
fusion: fusion
futile: futile
futility: futility
future: future
gaiety: gaiety
gain: gain,gained,gaining,gains
gainer: gainer,gainers
gallant: gallant
gallican: gallican
galling: galling
gallows: gallows
game: game,games
gange: ganges
garb: garb
garbage: garbage
garden: garden,gardens
gardener: gardener,gardeners
garret: garret
garrison: garrison,garrisons
gather: gather,gathered,gathering
gatherer: gatherer,gatherers
gathering: gathering
gaudy: gaudy
gemel: gemel
genealogy: genealogies
generality: generalities,generality
generation: generation,generations
generosity: generosity
generous: generous
geneva: geneva
genius: genius,geniuses
genoa: genoa
genoese: genoese
gentle: gentle
gentleman: gentleman,gentlemen
gentleness: gentleness
gentoo: gentoo
gentry: gentry
geo: geo
geometrical: geometrical
geometry: geometry
george: george
georgia: georgia
german: german,germans
germany: germany
gesture: gestures
ghent: ghent
ghostly: ghostly
gibraltar: gibraltar
giddy: giddy
gift: gift
gilbert: gilbert
gild: gilding
ginger: ginger
glad: glad
gladly: gladly
glaring: glaring
glasgow: glasgow
glass: glass,glasses
glaucus: glaucus
glebe: glebe
glitter: glittering
globe: globe
gloomy: gloomy
glory: glory
glove: gloves
glue: glue
glutton: glutton
goa: goa
god: gods
golconda: golconda
gold: gold
golden: golden
goldsmith: goldsmith,goldsmiths
goodness: goodness
gospel: gospel
govern: govern,governed,governing,governs
government: government,governments
governor: governor,governors
grace: grace
gradation: gradation,gradations
gradual: gradual
gradually: gradually
graduate: graduates
graduation: graduation
grain: grain
grained: grained
granada: granada
granary: granaries,granary
grand: grand
grandee: grandee
grandeur: grandeur
grandfather: grandfather
grant: grant,granted,granting,grants
grantable: grantable
grantee: grantee
granting: granting
grape: grapes
grass: grass,grasses
grate: grate
gratification: gratification,gratifications
gratify: gratify,gratifying
gratis: gratis
gratitude: gratitude
gratuitously: gratuitously
grave: grave,gravest
gravelly: gravelly
gravitate: gravitating
grazier: grazier,graziers
grazing: grazing
greatly: greatly
greatness: greatness
grecian: grecian
greece: greece
greedily: greedily
greek: greek,greeks
green: green
greenland: greenland
gregory: gregory
grenada: grenada
grey: grey
greyhound: greyhound,greyhounds
grievance: grievance
grievous: grievous
grind: grind,grinding,grinds
groat: groat
grocer: grocer,grocers
grocery: grocery
gross: gross,grosser,grossest
grossly: grossly
ground: ground,grounded
groundless: groundless
grounds: grounds
grow: grew,grow,growing,grown,grows
grower: grower,growers
growing: growing
growth: growth
guarantee: guarantee
guard: guard,guarded,guarding
guardian: guardian,guardians
guernsey: guernsey
guess: guessed
guest: guests
guide: guides
guild: guilds
guilder: guilder,guilders
guilty: guilty
guinea: guinea,guineas
guineas: guineas
gulf: gulfs
gum: gum
gun: gun
gunpowder: gunpowder
gustavus: gustavus
gymnasia: gymnasia
gymnasium: gymnasium
gymnastic: gymnastic
habit: habit,habits
habitation: habitation,habitations
habituate: habituated
hackney: hackney
hair: hair
hales: hales
halfpence: halfpence
halfpenny: halfpenny
halifax: halifax
hall: hall
hamburg: hamburg
hamlet: hamlet
hammer: hammer
hampshire: hampshire
hand: hand,hands
handful: handful
handle: handle
handsome: handsome
hank: hanks
hanse: hanse
hanseatic: hanseatic
happen: happen,happened,happening
happily: happily
happiness: happiness
happy: happiest,happy
harangue: harangue
harass: harass
harbour: harbour,harbours
hard: hard,harder
harden: harden
hardiness: hardiness
hardness: hardness
hardship: hardship,hardships
hardware: hardware
hardy: hardiest,hardy
hare: hare,hares
harm: harm
harmless: harmless
harrower: harrower,harrowers
harvest: harvest
hastily: hastily
hasty: hasty
hat: hats
hatchet: hatchets
hate: hate,hated
hatred: hatred
hatter: hatter
haughty: haughty
hawker: hawkers
hawkins: hawkins
hay: hay
hazard: hazard,hazarding,hazards
hazardous: hazardous
head: head,heads
health: health
healthful: healthful
healthy: healthy
heap: heap
hear: hear,heard,hears
hearer: hearers
heart: heart
hearth: hearth,hearths
hearty: heartier,hearty
heat: heat,heats
heaven: heaven,heavens
heavenly: heavenly
heaver: heavers
heavy: heavier,heaviest,heavy
hebrew: hebrew
hedge: hedge
height: height
heighten: heighten
heir: heir,heirs
helpless: helpless
hemp: hemp
hempen: hempen
henceforth: henceforth
henry: henry
heptarchy: heptarchy
herb: herbs
hercules: hercules
herd: herd,herds
herdsman: herdsman,herdsmen
hereditary: hereditary
heresy: heresy
hero: heroes
herring: herring,herrings
herrings: herrings
hide: hide,hides
higgling: higgling
highland: highland,highlands
highlanders: highlanders
highlands: highlands
highly: highly
highroad: highroad
highway: highway,highways
hill: hills
hinder: hinder,hindered,hindering,hinders
hindrance: hindrance
hire: hire,hired,hiring
hispaniola: hispaniola
hist: hist
historian: historian,historians
historical: historical
history: histories,history
hitherto: hitherto
hoeing: hoeing
hog: hog,hogs
hogshead: hogshead,hogsheads
hold: held,hold,holds
holder: holder,holders
holiday: holidays
holland: holland
holstein: holstein
holy: holy
homage: homage
homely: homely
homemade: homemade
homer: homer
honest: honest
honorary: honoraries,honorary
honour: honour,honoured,honours
honourable: honourable
honourableness: honourableness
honourably: honourably
hood: hood
hop: hop,hops
hope: hope,hoped,hopes
horde: horde
horn: horns
horned: horned
horner: horner
horrid: horrid
horror: horrors
horse: horse,horses
horseback: horseback
hose: hose
hospital: hospitals
hospitality: hospitality
hostile: hostile
hostility: hostility
hot: hot
hound: hound
hour: hour,hours
house: house,housed,houses
household: household
houses: houses
hovel: hovel
huckster: hucksters
hudson: hudson
huge: huge
human: human
humanity: humanity
humanize: humanize
humble: humble
hume: hume
humiliating: humiliating
humour: humour,humouring,humours
hundredth: hundredth
hungarian: hungarian
hungary: hungary
hunger: hunger
hungry: hungry
hunt: hunt,hunted
hunter: hunter,hunters
hunting: hunting
hurry: hurry
hurt: hurt,hurting,hurts
hurtful: hurtful
husband: husband
husbandman: husbandman,husbandmen
husbandmen: husbandmen
husbandry: husbandry
hussar: hussars
hut: hut,huts
hypocritical: hypocritical
ice: ice
idea: idea,ideas
ideal: ideal
identical: identical
idle: idle
idleness: idleness
idly: idly
idyllium: idyllium
ignoble: ignoble
ignominious: ignominious
ignominy: ignominy
ignorance: ignorance
ignorant: ignorant
ignorantly: ignorantly
iguana: iguana
iii: iii
illegal: illegal
illegally: illegally
illiberal: illiberal
illusory: illusory
illustrate: illustrate,illustrated
illustration: illustration
illustrious: illustrious
image: images
imaginary: imaginary
imagination: imagination
imagine: imagine,imagined,imagines
imitate: imitated
imitation: imitation,imitations
immemorial: immemorial
immense: immense
immensely: immensely
immortal: immortal
immortality: immortality
immoveable: immoveable
impartial: impartial
impartiality: impartiality
impartially: impartially
impassable: impassable
impenetrable: impenetrable
imperfect: imperfect
imperfection: imperfection,imperfections
imperfectly: imperfectly
impertinence: impertinence
impertinent: impertinent
implicit: implicit
implicitly: implicitly
imply: imply
impolitic: impolitic
import: import,imported,importing,imports
importation: importation,importations
importer: importer,importers
importunity: importunity
impose: impose,imposed,imposes,imposing
imposition: imposition,impositions
impositions: impositions
impossibility: impossibility
impossible: impossible
impost: impost,imposts
imposture: imposture
impoverish: impoverish,impoverished
impoverished: impoverished
impoverishment: impoverishment
impracticable: impracticable
impressed: impressed
impression: impression
imprison: imprison,imprisoned
imprisonment: imprisonment
improbability: improbability
improbable: improbable
improper: improper
improperly: improperly
impropriety: impropriety
improve: improve,improved,improves,improving
improved: improved
improvement: improvement,improvements
improver: improver,improvers
improvident: improvident
imprudence: imprudence
imprudent: imprudent
impunity: impunity
impurity: impurity
imputation: imputation
impute: impute
imputed: imputed
inability: inability
inaccuracy: inaccuracy
inattention: inattention
incapable: incapable
incapacity: incapacity
inch: inch,inches
incident: incident
incitement: incitement,incitements
inclemency: inclemencies,inclemency
inclination: inclination,inclinations
incline: incline,inclined,inclines
inclined: inclined
inclose: inclose,inclosed,inclosing
inclosure: inclosure
include: include,included,includes,including
inclusive: inclusive
income: income
incomplete: incomplete
inconclusive: inconclusive
inconsiderable: inconsiderable
inconsistency: inconsistency
inconsistent: inconsistent
inconstancy: inconstancy
inconstant: inconstant
inconvenience: inconvenience,inconveniences
inconveniency: inconveniencies,inconveniency
inconvenient: inconvenient
incorporate: incorporate,incorporated
incorporated: incorporated
incorporation: incorporation,incorporations
incorrectness: incorrectness
increase: increase,increased,increases,increasing
incredible: incredible
inculcate: inculcate,inculcated,inculcates
incumbent: incumbent
incumbrance: incumbrance,incumbrances
incur: incur,incurred,incurring,incurs
incurably: incurably
incursion: incursion,incursions
indebted: indebted
indecency: indecency
indecent: indecent
indemnification: indemnification
indemnify: indemnify
indenture: indenture
independency: independency
independent: independent
independently: independently
independents: independents
india: india
indiaman: indiaman
indian: indian,indians
indication: indication,indications
indies: indies
indifference: indifference
indifferent: indifferent
indifferently: indifferently
indigence: indigence
indigent: indigent
indignation: indignation
indigo: indigo
indirect: indirect
indirectly: indirectly
indispensably: indispensably
indisputable: indisputable
indistinctly: indistinctly
individual: individual,individuals
individually: individually
indolence: indolence
indolent: indolent
indolently: indolently
indorse: indorsed
indorser: indorser,indorsers
induce: induce,induced
indulge: indulge,indulging
indulgence: indulgence
indulgent: indulgent
industrious: industrious
industry: industry
ineffectual: ineffectual
inequalities: inequalities
inequality: inequalities,inequality
inexhaustible: inexhaustible
inexperience: inexperience
infallible: infallible
infallibly: infallibly
infamous: infamous
infancy: infancy
infant: infant,infants
infantry: infantry
infer: infer,inferred,infers
inferior: inferior,inferiors
inferiority: inferiority
infest: infested
infidelity: infidelity
infinite: infinite
infirm: infirm
infirmity: infirmity
inflame: inflame,inflamed,inflames
inflict: inflicted
influence: influence,influenced,influencing
inform: inform,informed,informs
informed: informed
infringe: infringe,infringed
infuse: infusing
ingenious: ingenious
ingenuity: ingenuity
ingot: ingot,ingots
ingraftment: ingraftment
ingratitude: ingratitude
inhabit: inhabit,inhabited,inhabiting
inhabitancy: inhabitancy
inhabitant: inhabitant,inhabitants
inherent: inherent
inheritance: inheritance,inheritances
inhospitable: inhospitable
injudicious: injudicious
injure: injure,injured
injured: injured
injury: injuries,injury
injustice: injustice
inland: inland
inlet: inlet,inlets
inn: inn
innocent: innocent
inns: inns
innumerable: innumerable
inquire: inquire,inquired
inquiry: inquiries,inquiry
inquisition: inquisition
insecure: insecure
insensible: insensible
insensibly: insensibly
inseparable: inseparable
inseparably: inseparably
insert: insert,inserting
insidious: insidious
insignificancy: insignificancy
insignificant: insignificant
insinuate: insinuate
insist: insisted,insists
insolence: insolence
insolent: insolent
insolvency: insolvency
insolvent: insolvent
inspect: inspects
inspection: inspection
inspiration: inspiration
inspire: inspire,inspired,inspires,inspiring
instability: instability
installation: installation
instalment: instalment
instance: instance,instances
instant: instant
instantaneously: instantaneously
institute: instituted,instituting
institution: institution,institutions
instruct: instruct,instructed,instructing
instruction: instruction,instructions
instructive: instructive
instrument: instrument,instruments
insufficiency: insufficiency
insufficient: insufficient
insult: insults
insupportable: insupportable
insurance: insurance
insure: insure,insured,insures
insurer: insurers
insurmountable: insurmountable
insurrection: insurrection
integrity: integrity
intellectual: intellectual
intelligence: intelligence
intelligent: intelligent
intelligible: intelligible
intemperance: intemperance
intend: intended,intending,intends
intendant: intendant
intent: intent
intention: intention,intentions
intentional: intentional
intercept: intercept
intercourse: intercourse
interfere: interfere,interfered
interference: interference
interior: interior
interloper: interlopers
intermeddle: intermeddle,intermeddled
internal: internal
interpose: interposed,interposing
interposition: interposition
interpret: interpret,interpreting
interpretation: interpretation
interrupt: interrupt,interrupted,interrupting
interruption: interruption
intersect: intersected
interval: interval,intervals
intervention: intervention
intimate: intimated
intimidate: intimidate,intimidated
intolerable: intolerable
intractable: intractable
intricate: intricate
intrinsic: intrinsic
intrinsically: intrinsically
introduce: introduce,introduced,introduces,introducing
introduction: introduction
introductive: introductive
intrude: intruding
intruder: intruders
intrusion: intrusions
inundation: inundations
invade: invade,invaded
invader: invader
invalidity: invalidity
invariable: invariable
invasion: invasion
invent: invent,invented,inventing
inventive: inventive
inventor: inventor,inventors
inversely: inversely
invert: inverted
invest: invested
investigate: investigate
investiture: investiture
invidious: invidious
invigorate: invigorating
invincible: invincible
inviolable: inviolable
invisible: invisible
invite: invite
involve: involved,involves
ireland: ireland
irish: irish
iron: iron
irrecoverably: irrecoverably
irregular: irregular
irregularity: irregularity
irregularly: irregularly
irreproachable: irreproachable
irresistible: irresistible
irresistibly: irresistibly
irretrievable: irretrievable
irritate: irritate
irruption: irruption
isabella: isabella
island: island,islands
islands: islands
issue: issue,issued,issues,issuing
issuing: issuing
isthmian: isthmian
isthmus: isthmus
italian: italian,italians
italy: italy
itinerant: itinerant
iv: iv
ivory: ivory
ix: ix
jack: jack
jamaica: jamaica
james: james
january: january
japan: japan
japanese: japanese
javelin: javelin,javelins
jealous: jealous
jealousy: jealousy
jersey: jersey
jesuit: jesuit
jewel: jewels
jeweller: jeweller,jewellers
jews: jews
job: jobbing,jobs
john: john
joiner: joiner,joiners
joint: joint
jointly: jointly
josiah: josiah
journal: journal
journey: journeys
journeyman: journeyman,journeymen
judge: judge,judged,judges,judging
judging: judging
judgment: judgment
judicature: judicature
judicial: judicial
judicious: judicious
judiciously: judiciously
julius: julius
july: july
june: june
jurisdiction: jurisdiction,jurisdictions
justice: justice,justices
justify: justified,justify
justle: justle,justled
justly: justly
keen: keen
keeper: keeper,keepers
keeping: keeping
kelp: kelp
kent: kent
khan: khan
kidder: kidders
kill: kill,killed,kills
kindness: kindness
kindred: kindred
king: king,kings
kingdom: kingdom,kingdoms
kitchen: kitchen
knavery: knavery
knife: knives
knight: knights
knit: knit,knitting
knitting: knitting
knowingly: knowingly
knowledge: knowledge
laborious: laborious
labour: labour,laboured,labouring,labours
labourer: labourer,labourers
labourers: labourers
lace: lace,laces
lady: lady
lake: lakes
lama: lama
lamb: lamb,lambs
lament: lament
lancashire: lancashire
lancaster: lancaster
land: land,landed,lands
landlord: landlord,landlords
lands: lands
language: language,languages
languedoc: languedoc
languid: languid
languish: languished,languishing
lapis: lapis
lastage: lastage
lasting: lasting
lastly: lastly
late: late
lateness: lateness
latin: latin
laudable: laudable
laugh: laugh
launch: launch
law: law,laws
lawful: lawful
lawfully: lawfully
lawgiver: lawgiver
lawn: lawns
lawyer: lawyer,lawyers
lay: laid,lay,laying,lays
laziness: laziness
lazy: lazy
le: le
lead: lead,leading,leads,led
leader: leader,leaders
leading: leading
leaf: leaves
league: league,leagued,leagues
lean: lean,leans
learn: learn,learned,learning,learns,learnt
learning: learning
lease: lease,leased,leases
leasehold: leasehold
leather: leather
leave: leave,leaves,leaving,left
lecture: lecture,lectures,lecturing
leeds: leeds
left: left
legacy: legacies,legacy
legal: legal
legally: legally
leghorn: leghorn
legion: legions
legislative: legislative
legislator: legislator,legislators
legislature: legislature,legislatures
leisure: leisure
leith: leith
lend: lend,lending,lends,lent
lender: lender
lending: lending
lent: lent
leprosy: leprosy
les: les
lessee: lessee,lessees
lessen: lessens
lessening: lessening
lesser: lesser
lesson: lessons
lessor: lessor
letter: letters
levant: levant
level: level
levity: levity
levy: levied,levies,levy,levying
lewis: lewis
liable: liable
lib: lib
libel: libels
liberal: liberal
liberality: liberality
liberally: liberally
liberty: liberties,liberty
licence: licence,licences
license: license,licensed
licentious: licentious
licentiousness: licentiousness
lie: lain,lie,lies,lying
lieu: lieu
life: life,lives
light: light,lighted,lighter,lit
lighted: lighted
lighter: lighters
lighting: lighting
lightly: lightly
lightning: lightning
liking: liking
lima: lima
limit: limit,limited,limits
limitation: limitation
limited: limited
lineal: lineal
linen: linen,linens
linger: lingering
liquor: liquor,liquors
lisbon: lisbon
list: list
listen: listen,listened
literal: literal
literary: literary
litharge: litharge
live: live,lived,lives,living
livelihood: livelihood
liverpool: liverpool
livery: liveries,livery
living: living
livre: livre,livres
lizard: lizard
load: load,loaded,loading
loaden: loaden
loading: loading
loaf: loaves
loan: loan,loans
loathsome: loathsome
local: local
loch: lochs
lochaber: lochaber
lock: lock,locked,locks
locksmith: locksmiths
lodge: lodge,lodged,lodges
lodger: lodgers
lodging: lodging
lodgings: lodgings
lofty: lofty
logic: logic
lombard: lombard
london: london
lone: lone
loom: loom
loose: loose
lord: lord,lords
lorenzo: lorenzo
lose: lose,loses,losing,lost
loser: loser,losers
loss: loss,losses
lot: lot
lottery: lotteries,lottery
loud: loudest
loudly: loudly
louis: louis
love: love,loved,loves
lover: lover,lovers
lowering: lowering
lowness: lowness
loyalty: loyalty
lucern: lucern
lucian: lucian
luck: luck
lucrative: lucrative
luggage: luggage
lumber: lumber
luther: luther
lutheran: lutheran
luxury: luxuries,luxury
lyceum: lyceum
macedon: macedon
machiavel: machiavel
machination: machinations
machine: machine,machines
machinery: machinery
mad: madder
madder: madder
madeira: madeira
madeiras: madeiras
madman: madman
madras: madras
madrid: madrid
magazine: magazine,magazines
magistracy: magistracy
magistrate: magistrate,magistrates
magna: magna
magnanimity: magnanimity
magnificence: magnificence
magnificent: magnificent
magnify: magnified,magnify
magnifying: magnifying
mahomet: mahomet
mahometan: mahometan
maid: maid
maim: maimed
main: main
maintain: maintain,maintained,maintaining,maintains
maintenance: maintenance
maize: maize
majesty: majesty
majority: majority
maker: maker,makers
malacca: malacca
male: male
malice: malice
malicious: malicious
malignant: malignant
malt: malt
malta: malta
malversation: malversation
mamelukes: mamelukes
manage: manage,managed,manages,managing
management: management
manager: managers
managing: managing
manati: manati
manchester: manchester
mandamus: mandamus
mandarin: mandarins
manhood: manhood
manifest: manifest
manilla: manilla
mankind: mankind
manner: manner
manners: manners
manor: manor,manors
manse: manses
mansion: mansion
manual: manual
manufactory: manufactories,manufactory
manufacture: manufacture,manufactured,manufactures,manufacturing
manufactured: manufactured
manufacturer: manufacturer,manufacturers
manufactures: manufactures
manufacturing: manufacturing
manure: manure,manured,manuring
manured: manured
manuscript: manuscript,manuscripts
march: march,marched,marches
marco: marco
marine: marine
mariner: mariners
maritime: maritime
mark: mark,marked,marks
market: market,markets
marketing: marketing
marquis: marquis,marquises
marriage: marriage,marriages
married: married
marry: married,marry
marshal: marshal
mart: mart
martial: martial
martinico: martinico
martius: martius
marvellous: marvellous
mary: mary
maryland: maryland
mason: mason,masons
masquerade: masquerade,masquerades
mass: mass,masses
massachusetts: massachusetts
mast: masts
master: master,masters
masterpiece: masterpiece
mastiff: mastiff
masting: masting
match: match
mater: mater
material: material,materials
mathematics: mathematics
matter: matter,matters
matthew: matthew
maturity: maturity
maxim: maxim,maxims
mayor: mayor
meal: meal
meaning: meaning,meanings
meanly: meanly
meanness: meanness
measure: measure,measured,measures
meat: meat
mechanic: mechanic,mechanics
mechanical: mechanical
mediately: mediately
mediocrity: mediocrity
mediterranean: mediterranean
medium: medium
meet: meet
meeting: meetings
melancholy: melancholy
melt: melted,melting
melting: melting
memoire: memoire
memoirs: memoirs
memorable: memorable
memory: memory
mend: mend,mended,mending,mends
mendicant: mendicant
menial: menial
mental: mental
mention: mention,mentioned,mentions
mercantile: mercantile
mercenary: mercenary
mercer: mercers
merchandize: merchandize
merchant: merchant,merchants
merchantable: merchantable
merchants: merchants
mercury: mercury
mercy: mercy
mere: mere
merit: merit
merk: merks
merovingian: merovingian
merriment: merriment
mess: mess
metal: metal,metals
metallic: metallic
metaphor: metaphor
metaphysical: metaphysical
metaphysics: metaphysics
metayer: metayer
meteor: meteors
method: method,methods
methodical: methodical
methodist: methodists
metropolis: metropolis
mexico: mexico
michaelmas: michaelmas
middle: middle
middling: middling
midst: midst
milan: milan
milanese: milanese
mild: mild,milder
mile: mile,miles
military: military
militia: militia,militias
militiaman: militiaman
militias: militias
milk: milk
miller: miller,millers
millwright: millwright
mina: minae
mind: mind,minds
miner: miner,miners
mineral: mineral,minerals
mineralize: mineralized
mining: mining
minister: minister,ministers
ministry: ministry
minor: minor
minorca: minorca
minority: minority
mint: mint,mints
minute: minute,minutest
mirth: mirth
misapprehension: misapprehension
miscarriage: miscarriage
misconduct: misconduct
misdemeanour: misdemeanour
miserable: miserable
miserably: miserably
misery: miseries,misery
misfortune: misfortune,misfortunes
misinform: misinformed
misinformation: misinformation
mislead: mislead,misled
mismanage: mismanaged
mismanagement: mismanagement
misrepresent: misrepresenting
misrepresentation: misrepresentation
missionary: missionaries,missionary
mississippi: mississippi
mistake: mistake,mistaken
mistaken: mistaken
mistress: mistresses
mix: mix
mixed: mixed
mixture: mixture
mobbish: mobbish
mode: mode,modes
model: model
modena: modena
moderate: moderate,moderated,moderating
moderately: moderately
moderation: moderation
modern: modern
modesty: modesty
modify: modified
modius: modius
modus: modus
moist: moist
molasses: molasses
moment: moment,moments
momentary: momentary
monarch: monarch,monarchs
monarchical: monarchical
monarchy: monarchies,monarchy
monastery: monasteries,monastery
money: money,moneys
monied: monied
monk: monk,monks
monopolies: monopolies
monopolise: monopolised
monopolist: monopolist,monopolists
monopolize: monopolize,monopolizing
monopoly: monopolies,monopoly
montezuma: montezuma
month: month,months
monthly: monthly
monument: monuments
moor: moors
moors: moors
moral: moral,morals
moralist: moralists
morality: morality
morning: morning
morrow: morrow
mortal: mortal
mortality: mortality
mortar: mortar
mortgage: mortgage,mortgaged,mortgages
mortgaged: mortgaged
mortification: mortification
mortify: mortifies,mortifying
mortmain: mortmain
mosaical: mosaical
mother: mother
motion: motion
motive: motive,motives
moulder: mouldered
mount: mounted,mounts
mountain: mountain,mountains
mountainous: mountainous
mournful: mournful
mourning: mourning
mouth: mouths
moveable: moveable,moveables
movement: movement,movements
mulatto: mulattoes
mulberry: mulberry
mule: mules
multiplication: multiplication
multiplicity: multiplicity
multiply: multiplied,multiplies,multiply,multiplying
multitude: multitude,multitudes
multure: multure
mun: mun
mundic: mundic
munificent: munificent
munificently: munificently
murder: murdered
murmur: murmur
muscovado: muscovado
muscovite: muscovites
music: music
musical: musical
musician: musician,musicians
musket: musket
muslin: muslins
muster: muster
mutilate: mutilated
mutilation: mutilation
mutiny: mutiny
mutton: mutton
mutual: mutual
mutually: mutually
mystery: mysteries,mystery
nail: nail,nailed,nails
nailer: nailer
naked: naked
naples: naples
narrow: narrow,narrowed,narrower
narrowing: narrowing
narrowness: narrowness
nastiness: nastiness
nasty: nastiest
nat: nat
nation: nation,nations
national: national
native: native,natives
nativity: nativity
natural: natural
naturally: naturally
nature: nature
naval: naval
navigable: navigable
navigate: navigated
navigation: navigation
navigator: navigators
navy: navies,navy
nearer: nearer
neat: neat
necessaries: necessaries
necessitous: necessitous
necessity: necessities,necessity
needle: needles
neglect: neglect,neglected,neglecting,neglects
negligence: negligence
negligent: negligent
negligently: negligently
negotiate: negotiated,negotiating
negotiation: negotiation
negro: negro,negroes
neighbour: neighbour,neighbouring,neighbours
neighbourhood: neighbourhood
newcastle: newcastle
newfoundland: newfoundland
newly: newly
news: news
newspaper: newspapers
nice: nice,nicer
nicety: nicety
nigh: nigh
night: night,nights
nightingale: nightingale
nile: nile
ninepence: ninepence
nineteen: nineteen
nineteenth: nineteenth
ninth: ninth
nobility: nobility
noble: noble,nobler,nobles,noblest
nobleness: nobleness
noise: noise
nominal: nominal
nominally: nominally
nomination: nomination
nonsense: nonsense
norfolk: norfolk
norman: norman
north: north
northern: northern
norway: norway
notable: notable
note: note,notes
notice: notice
notion: notion,notions
notorious: notorious
nourishing: nourishing
nourishment: nourishment
nova: nova
novelty: novelty
november: november
noway: noway
nuisance: nuisance,nuisances
numerous: numerous
nurse: nurse
nut: nuts
nutmeg: nutmeg
oath: oath,oaths
oatmeal: oatmeal
oats: oats
obedience: obedience
obedient: obedient
obey: obey,obeys
object: object,objects
objection: objection,objections
oblation: oblations
obligation: obligation,obligations
oblige: oblige,obliged,obliges,obliging
obliterate: obliterated
obnoxious: obnoxious
obscure: obscure
obscurity: obscurity
obsequiousness: obsequiousness
observation: observation,observations
observe: observe,observed,observes,observing
observer: observer
obsolete: obsolete
obstacle: obstacle,obstacles
obstinately: obstinately
obstruct: obstruct,obstructed,obstructing,obstructs
obstruction: obstruction,obstructions
obviate: obviated
obvious: obvious
occasion: occasion,occasioned,occasioning,occasions
occasional: occasional
occasionally: occasionally
occupancy: occupancy
occupation: occupation,occupations
occupier: occupiers
occupy: occupied,occupies,occupy
occur: occur,occurred,occurring,occurs
ocean: ocean
october: october
odious: odious
odium: odium
oecumenical: oecumenical
offal: offals
offence: offence,offences
offend: offend,offends
offender: offender,offenders
offensive: offensive
offer: offer,offered,offering,offers
office: office,offices
officer: officer,officers
officiate: officiate
offspring: offspring
oft: oft
oil: oil
olive: olive
olympic: olympic
onion: onions
ontology: ontology
openly: openly
opera: opera
operate: operate,operated,operates
operation: operation,operations
opinion: opinion,opinions
opium: opium
opportunity: opportunities,opportunity
oppose: oppose,opposed,opposes,opposing
opposition: opposition
oppress: oppress,oppressed,oppresses,oppressing
oppressed: oppressed
oppression: oppression
oppressive: oppressive
oppressor: oppressors
option: option
optional: optional
opulence: opulence
opulent: opulent
orange: orange,oranges
orator: orator,orators
ordain: ordained,ordains
orderly: orderly
ordinance: ordinances
ordinary: ordinary
ordure: ordure
ore: ore
origin: origin
original: original,originals
originally: originally
orleans: orleans
ornament: ornament,ornamented,ornaments
ornamental: ornamental
ornamentally: ornamentally
orphan: orphans
orthodox: orthodox
orthodoxy: orthodoxy
ortolan: ortolans
ostentation: ostentation
ostentatious: ostentatious
ounce: ounce,ounces
oust: ousted
outer: outer
outfit: outfit
outgoing: outgoings
outline: outlines
outport: outports
outrage: outrage
outrun: outrun
outward: outward
outwards: outwards
oven: oven
overawe: overawe,overawes
overbalance: overbalance,overbalanced,overbalances
overboard: overboard
overburden: overburden
overburdened: overburdened
overcharge: overcharge,overcharged
overdo: overdo
overdrawn: overdrawn
overflow: overflow,overflowed,overflowing
overgrown: overgrown
overgrowth: overgrowth
overlook: overlooked
overpay: overpaid,overpays
overrate: overrate
overrun: overran
oversee: oversee,oversees
overseer: overseer,overseers
overstock: overstock,overstocked,overstocking
overturn: overturn,overturned
overvalue: overvalued
overwork: overwork
owe: owe,owed,owes
owner: owner,owners
ox: ox
oxen: oxen
oxford: oxford
pace: pace
pacification: pacification
pack: pack,packed,packs
package: package,packages
packer: packer
packet: packet
pageantry: pageantry
pain: pain,pains
painful: painful
paint: paint,painted
painter: painters
painting: painting
pair: pair,pairs
palace: palace,palaces
palliate: palliated
palliative: palliative
palpable: palpable
paltry: paltry
pampered: pampered
pamphlet: pamphlet,pamphlets
pan: pans
pannonian: pannonian
papal: papal
paper: paper
par: par
parade: parade
paradox: paradox,paradoxes
paradoxical: paradoxical
paragraph: paragraph
paraguay: paraguay
parcel: parcel,parcelled,parcels
parchment: parchment
pardon: pardon,pardoned
parent: parents
parental: parental
paris: paris
parish: parish,parishes
parity: parity
park: park,parks
parliament: parliament,parliaments
parliamentary: parliamentary
parma: parma
parochial: parochial
parsimonious: parsimonious
parsimony: parsimony
parson: parson
partake: partake
parthian: parthian
partial: partial
partiality: partiality
partially: partially
particle: particles
particulars: particulars
partition: partition
partly: partly
partner: partner,partners
partook: partook
party: parties,party
pass: pass,passed,passes,passing
passage: passage
passenger: passengers
passing: passing
passion: passion,passions
passionate: passionate
pastime: pastime,pastimes
pastor: pastor,pastors
pasture: pasture,pastured,pastures,pasturing
patent: patents
paternal: paternal
patience: patience
patiently: patiently
patrimony: patrimony
patron: patron,patrons
patronage: patronage
pattern: pattern
pave: paved,paving
paved: paved
pawn: pawn
pay: paid,pay,paying,pays
payable: payable
payment: payment,payments
peace: peace
peaceable: peaceable
peage: peages
pearl: pearl
peasant: peasant
pease: pease
pebble: pebbles
peck: peck,pecks
peculiar: peculiar
peculiarly: peculiarly
pecuniary: pecuniary
pedagogue: pedagogue
pedantic: pedantic
pedlar: pedlar,pedlars
peer: peers
pekin: pekin
pelham: pelham
peloponnesian: peloponnesian
peltry: peltry
penalty: penalties,penalty
penance: penance
pence: pence
penelope: penelope
penetrate: penetrate
pennsylvania: pennsylvania
penny: pence,pennies,penny
pennyworth: pennyworth,pennyworths
pension: pension,pensions
people: peopled
perceive: perceive
percent: percent
perceptible: perceptible
perfect: perfect,perfected,perfecting
perfection: perfection
perfectly: perfectly
perform: perform,performed,performing,performs
performance: performance
perilous: perilous
period: period,periods
periodical: periodical
perish: perish,perished,perishes,perishing
perishable: perishable
permanency: permanency
permanent: permanent
permission: permission
permit: permit,permits,permitted
pernicious: pernicious
perpetration: perpetration
perpetual: perpetual
perpetuate: perpetuate,perpetuated
perpetuity: perpetuities
perquisite: perquisite,perquisites
persecute: persecute,persecuted,persecuting
persecution: persecution
perseverance: perseverance
persia: persia
persian: persian
person: people,person,persons
personal: personal
perspicuous: perspicuous
persuade: persuade,persuaded,persuading
persuasion: persuasion
peru: peru
peruvian: peruvians
perversion: perversion
pervert: pervert,perverts
peter: peter
petition: petition,petitioned,petitioning
petty: petty
pewter: pewter
phenomena: phenomena
phenomenon: phenomena
philadelphia: philadelphia
philip: philip
philosophe: philosophe
philosopher: philosopher,philosophers
philosophical: philosophical
philosophy: philosophy
phoenicians: phoenicians
physic: physic
physician: physician,physicians
physics: physics
piastre: piastre,piastres
pick: picked,picking
picking: picking
picture: pictures
piddle: piddling
piece: piece,pieces
piedmont: piedmont
piety: piety
pig: pig,pigs
pile: pile
pillage: pillaged
pillar: pillars
pillory: pillory
pillow: pillows
pilot: pilot
pimento: pimento
pin: pin,pins
pint: pint
pious: pious
pipe: pipe,pipes
pirate: pirates
pisa: pisa
piston: piston
pit: pit
pitch: pitch
pius: pius
plague: plague
plain: plain,plainest,plains
plainly: plainly
plaintiff: plaintiff
plan: plan,planned,plans
plant: plant,planted,planting,plants
plantation: plantation,plantations
planter: planter,planters
planting: planting
plate: plate,plates,plating
plato: plato
plausible: plausible
play: play
player: players
playing: playing
plaything: playthings
plea: pleas
plead: plead
pleased: pleased
pleasure: pleasure,pleasures
pledge: pledge,pledged,pledges
plenipotentiary: plenipotentiaries
plentiful: plentiful
plentifully: plentifully
plenty: plenty
pliny: pliny
plodding: plodding
plough: plough,ploughed,ploughing,ploughs
ploughman: ploughman,ploughmen
plumage: plumage
plunder: plunder,plundered,plundering
plunderer: plunderers
plutarch: plutarch
plymouth: plymouth
pneumatic: pneumatics
pneumatology: pneumatology
poacher: poacher,poachers
pocket: pocket,pockets
poet: poets
poetry: poetry
poison: poison
poland: poland
police: police
policy: policy
politic: politic
political: political
politician: politician
politics: politics
poll: poll
pollute: polluted
polo: polo
pomp: pomp
pond: pond
pondo: pondo
pontage: pontage
poor: poor,poorer,poorest
poorness: poorness
pop: pop
pope: pope
poppy: poppies
populace: populace
popular: popular
popularity: popularity
population: population
populous: populous
populousness: populousness
porcelain: porcelain
pork: pork
port: port,ports
porter: porter,porters
portico: portico
portion: portion,portions
porto: porto
portugal: portugal
portuguese: portuguese
positive: positive
possess: possess,possessed,possesses,possessing
possession: possession,possessions
possessor: possessor
possibility: possibility
post: post
posterior: posterior
posterity: posterity
postscript: postscript
pot: pot,pots
potato: potatoes
potatoes: potatoes
pottage: pottage
poultry: poultry
pound: pound,pounds
poundage: poundage
pour: pour,poured
poverty: poverty
powder: powder
power: power,powers
powerful: powerful
practicable: practicable
practice: practice,practices
practise: practise,practised,practising
practitioner: practitioner,practitioners
praetor: praetor
pragmatic: pragmatic
praise: praise,praises
preacher: preachers
preamble: preamble
precarious: precarious
precaution: precaution
precede: preceded,precedes,preceding
precedency: precedency
precedent: precedent
preceding: preceding
precinct: precincts
precious: precious
precise: precise
precisely: precisely
precision: precision
preclude: preclude,precluded
predecessor: predecessors
predial: predial
predilection: predilection
predominate: predominate,predominates
preface: preface
prefer: prefer,preferred,preferring,prefers
preference: preference
preferment: preferment,preferments
prejudice: prejudice,prejudiced,prejudices
prelate: prelates
prematurely: prematurely
premise: premise
premium: premium,premiums
preparation: preparation
preparatory: preparatory
prepare: prepare,prepared,prepares,preparing
prepared: prepared
preponderancy: preponderancy
preponderate: preponderated,preponderates
prepossession: prepossession
prerogative: prerogative
presbyterian: presbyterian
presbytery: presbytery
prescribe: prescribe,prescribes
prescription: prescriptions
presence: presence
presentation: presentation
presentee: presentee
presently: presently
presentment: presentment
preservation: preservation
preserve: preserve,preserved,preserves,preserving
preside: presided
president: president
pressing: pressing
presume: presume,presumed
presumption: presumption
presumptuous: presumptuous
pretence: pretence,pretences
pretend: pretend,pretended,pretending,pretends
pretension: pretensions
pretext: pretext
pretium: pretium
pretty: pretty
prevail: prevail,prevailed,prevailing,prevails
prevalence: prevalence
prevalency: prevalency
prevent: prevent,prevented,preventing,prevents
prevention: prevention
preventive: preventive
previous: previous
prey: prey
price: price,prices
priced: priced
pride: pride
priest: priest,priests
prime: prime
primitive: primitive,primitives
primogeniture: primogeniture
prince: prince,princes
principal: principal
principality: principalities
principally: principally
principle: principle,principles
print: printed
printing: printing
prior: prior
prison: prison
private: private
privately: privately
privation: privation
privilege: privilege,privileges
privy: privy
prize: prize,prizes
probability: probabilities,probability
probable: probable
probation: probation
probity: probity
proceed: proceed,proceeded,proceeds
proceedings: proceedings
process: process
procession: procession
proclamation: proclamation
proconsul: proconsuls
proctor: proctors
procure: procure,procured,procures,procuring
prodigal: prodigal,prodigals
prodigality: prodigality
produce: produce,produced,produces,producing
producer: producer,producers
product: product
production: production,productions
productive: productive
profane: profane
profaneness: profaneness
profess: profess,professed,professes
profession: profession,professions
professor: professor,professors
proficiency: proficiency
profit: profit,profited,profits
profitable: profitable
profitableness: profitableness
profitably: profitably
profligacy: profligacy
profligate: profligate
profound: profound
profoundly: profoundly
profuse: profuse
profusion: profusion
progenitor: progenitors
progress: progress
progressive: progressive
prohibit: prohibit,prohibited,prohibiting,prohibits
prohibition: prohibition,prohibitions
project: project,projecting,projects
projector: projector,projectors
prolong: prolonged
prolongation: prolongations
promise: promise,promised,promises
promissory: promissory
promote: promote,promoted,promotes,promoting
promoter: promoters
prompt: prompt,prompted,prompts
pronounce: pronounced
proof: proof,proofs
propagate: propagate,propagated
propagation: propagation
propensity: propensity
proper: proper,properest
properest: properest
properly: properly
property: property
proportion: proportion,proportioned,proportioning,proportions
proportionable: proportionable
proportionably: proportionably
proportional: proportional
proportionally: proportionally
proportionate: proportionate
proposal: proposal,proposals
propose: propose,proposed,proposes,proposing
proposer: proposers
proposition: proposition
proprietor: proprietor,proprietors
propriety: propriety
proscribe: proscribe
prosecute: prosecute
prosecution: prosecution,prosecutions
proselyte: proselytes
prospect: prospect
prosper: prosper,prospered
prosperity: prosperity
prosperous: prosperous
prostitution: prostitution
protect: protect,protected,protecting,protects
protection: protection
protector: protector,protectors
protest: protested
protestant: protestant,protestants
protestation: protestations
prove: prove,proved
provence: provence
proverb: proverb,proverbs
proverbial: proverbial
provide: provide,providing
provident: provident
province: province,provinces
provincial: provincial
provision: provision,provisions
provocation: provocation
provoke: provoke,provoked,provokes
proximity: proximity
prudence: prudence
prudent: prudent
prudential: prudential
prudently: prudently
prussia: prussia
prussian: prussian,prussians
public: public
publican: publican
publication: publication,publications
publicly: publicly
publish: published,publishing
pull: pull
pulse: pulse
punctilious: punctilious
punctual: punctual
punic: punic
punish: punish,punishes
punishment: punishment,punishments
pupil: pupil,pupils
puppet: puppet
puppy: puppies,puppy
purchase: purchase,purchased,purchases,purchasing
purchaser: purchaser,purchasers
purchasing: purchasing
pure: pure
puritan: puritans
purpose: purpose,purposes
pursuance: pursuance
pursue: pursue,pursued,pursuing
pursuit: pursuit,pursuits
purveyance: purveyance
purveyor: purveyor
pusillanimity: pusillanimity
putrid: putrid
pythagoras: pythagoras
qr: qr
quadruped: quadruped
quadruple: quadrupled
quaker: quakers
quakers: quakers
qualification: qualification,qualifications
qualified: qualified
qualify: qualify
quality: qualities,quality
quantity: quantities,quantity
quarrel: quarrel
quarry: quarry
quart: quarts
quarter: quarter,quartered,quarters
quarto: quarto
queen: queen
quest: quest
question: question,questions
qui: qui
quick: quick,quicker
quicken: quicken,quickens
quiet: quiet
quintal: quintal
quire: quire
quit: quit,quits,quitted
quito: quito
rabbit: rabbit
rabble: rabble
race: race
rack: racked
raffle: raffle
rag: rags
rage: rage
rain: rain
raise: raise,raised,raises,raising
raising: raising
ralph: ralph
ram: rams
random: random
range: range
rank: rank,ranked,ranks
rapacity: rapacity
rapid: rapid
rapidity: rapidity
rapidly: rapidly
rapine: rapine
rare: rare,rarer
rarely: rarely
rarity: rarities,rarity
rash: rash
rashly: rashly
rashness: rashness
rat: rat
rate: rate,rated,rates,rating
ratification: ratification
ratify: ratify
rational: rational
ravage: ravaged
raw: raw
reach: reach,reaches
read: read,reading,reads
reader: reader
readiness: readiness
reading: reading
ready: readier,readiest,ready
real: real,reals
reality: reality
realize: realize,realized,realizes
realm: realm
ream: reams
reap: reap,reaps
reaper: reaper
rear: rear,reared,rearing
rearing: rearing
reason: reason,reasons
reasonable: reasonable
reasoning: reasoning,reasonings
rebel: rebel
rebellion: rebellion,rebellions
rebellious: rebellious
rebuild: rebuild,rebuilt
recall: recall
receipt: receipt,receipts
receive: receive,received,receives,receiving
receiver: receiver
recency: recency
reception: reception
reciprocal: reciprocal
reckon: reckon,reckoned,reckoning
recline: reclined
recoin: recoined
recoinage: recoinage
recollect: recollect
recommend: recommend,recommended,recommends
recompence: recompence
recompense: recompense,recompensed,recompenses
reconnoiter: reconnoitered
reconsider: reconsider
record: record,recorded,records
recording: recording
recourse: recourse
recover: recover,recovered,recovering,recovers
recovery: recovery
recruit: recruiting
rector: rectors
recur: recur
redeem: redeem,redeemed
redeemable: redeemable
redemption: redemption
redraw: redraw,redrawing,redraws
redrawer: redrawers
redrawing: redrawing
redress: redress
redrew: redrew
reduce: reduce,reduced,reduces,reducing
reducible: reducible
reduction: reduction,reductions
redundancy: redundancy
redundant: redundant
reed: reeds
reel: reel
refer: referring,refers
reference: reference
refine: refined,refines,refining
refined: refined
refinement: refinement
refinery: refinery
refining: refining
reflection: reflection,reflections
reform: reform,reforming
reformation: reformation
reformer: reformers
refractory: refractory
refrain: refrain
refuge: refuge
refuse: refuse,refused,refusing
regality: regality
regard: regard,regarded
regent: regent
regimen: regimen,regimens
regiment: regiment,regiments
regimented: regimented
region: regions
register: register,registered,registers
registered: registered
registration: registration
regular: regular
regularity: regularity
regularly: regularly
regulate: regulate,regulated,regulates,regulating
regulation: regulation,regulations
reign: reign,reigning,reigns
reimburse: reimburse
reimpose: reimposed
reinstate: reinstate
reject: reject,rejected,rejecting
relate: relate,relates,relating
relation: relation,relations
relative: relative
relax: relax,relaxed,relaxes
relaxation: relaxation
release: release
relief: relief
relieve: relieve,relieved,relieving
relieved: relieved
reliever: relievers
religion: religion,religions
religious: religious
relish: relish,relishing
reluctance: reluctance
remain: remain,remained,remaining,remains
remainder: remainder
remains: remains
remark: remark,remarked,remarking,remarks
remarkable: remarkable
remarkably: remarkably
remedy: remedied,remedies,remedy,remedying
remember: remember,remembered
remittance: remittance,remittances
remnant: remnant
remonstrance: remonstrances
remonstrate: remonstrated
remorse: remorse
remote: remote,remoter,remotest
remoteness: remoteness
remoter: remoter
remount: remounting
removable: removable
removal: removal
remove: remove,removed,removes,removing
render: render,rendered,rendering,renders
renew: renew,renewed,renewing
renewal: renewal
renowned: renowned
rent: rent,rented,renting,rents
rental: rental
rented: rented
repack: repack,repacked
repair: repair,repaired,repairing,repairs
reparation: reparation
repay: repaid,repay,repaying,repays
repayment: repayment,repayments
repeal: repeal,repealed,repeals
repeat: repeated
repel: repel,repelled,repelling,repels
repent: repent,repented
repetition: repetition
replace: replace,replaced,replaces,replacing
replenish: replenish,replenished,replenishing
reply: replied,reply
report: report,reported,reports
repose: repose,reposed,reposing
repository: repositories
represent: represent,represented,representing,represents
representation: representation,representations
representative: representative,representatives
reproach: reproach,reproaches
reproduce: reproduce,reproduced,reproduces,reproducing
reproduction: reproduction
republic: republic,republics
republican: republican
repurchase: repurchasing
reputable: reputable
reputation: reputation,reputations
repute: repute,reputed
request: request
require: require,required,requires,requiring
requisite: requisite,requisites
requisition: requisition,requisitions
rescind: rescind
resemblance: resemblance
resemble: resemble,resembled,resembles
resentment: resentment
reservation: reservation
reserve: reserve,reserves,reserving
reside: reside,resided,resides,residing
residence: residence
resident: resident
residue: residue
resist: resist,resisted,resisting
resistance: resistance
resolution: resolution,resolutions
resolve: resolve,resolved,resolves
resort: resort,resorted
resource: resource,resources
respect: respect,respected
respectable: respectable
respected: respected
respectful: respectful
respective: respective
respects: respects
respectum: respectum
responsible: responsible
rest: rest,rested
restoration: restoration
restore: restore,restored,restores,restoring
restrain: restrain,restrained,restraining,restrains
restrained: restrained
restraint: restraint,restraints
restrict: restrict,restricted,restricting
restricted: restricted
restriction: restriction,restrictions
result: result
resume: resume
retail: retail,retailed
retailer: retailer,retailers
retain: retain,retained,retaining
retainer: retainer,retainers
retaliate: retaliate
retaliation: retaliation,retaliations
retard: retard,retarded,retarding,retards
retarded: retarded
retinue: retinue
retire: retire,retired,retires,retiring
retribution: retribution
retrograde: retrograde
return: return,returned,returning,returns
revenge: revenge,revenged
revenue: revenue,revenues
revere: revered
reverence: reverence
reverend: reverend
reverse: reverse,reversed
review: review,reviewed
revive: revive,revived
revoke: revoked
revolt: revolt,revolted
revolution: revolution,revolutions
revulsion: revulsion
reward: reward,rewarded,rewards
rhetoric: rhetoric
rhetorician: rhetoricians
rhine: rhine
rice: rice
rich: rich,richer,richest
riches: riches
richness: richness
rid: rid
ridge: ridge
ridicule: ridicule
ridiculous: ridiculous
riding: riding
riga: riga
rightly: rightly
rigorous: rigorous
rigorously: rigorously
rigour: rigour
ringleader: ringleaders
ripe: ripe
rise: rise,risen,rises,rising,rose
risk: risk,risks
rival: rival,rivalled,rivals
rivalship: rivalship
river: river,rivers
rivet: riveted
riviere: riviere
rivulet: rivulets
rix: rix
road: road,roads
robbery: robbery
robert: robert
rock: rock,rocks
rod: rod
rom: rom
roman: roman,romans
romantic: romantic
rome: rome
roof: roof
root: root
rope: rope
rot: rot
rotation: rotation
rouen: rouen
rouge: rouge
rough: rough
routine: routine
royal: royal
rub: rubbing
rude: rude,rudest
ruder: ruder
rudiment: rudiments
ruffle: ruffles
rufus: rufus
ruin: ruin,ruined,ruining,ruins
ruinous: ruinous
rule: rule,rules
ruler: rulers
rum: rum
running: running
rupture: rupture
rural: rural
rush: rushes
russia: russia
russian: russian
rust: rust
rustic: rustic
rye: rye
sacred: sacred
sacrifice: sacrifice,sacrificed,sacrifices
sacrilege: sacrilege
sacrilegious: sacrilegious
safe: safe,safer,safest
safely: safely
safety: safety
sagacity: sagacity
sage: sages
sail: sail,sailed
sailing: sailing
sailor: sailor,sailors
sake: sake
salary: salaries,salary
sale: sale,sales
sallee: sallee
salmon: salmon
salt: salt,salted
saltmaker: saltmaker
saltpetre: saltpetre
sanctify: sanctified
sanction: sanction
sanctity: sanctity
sanctuary: sanctuaries
sand: sand
sandy: sandy
sanguinary: sanguinary
santa: santa
saracens: saracens
sardinia: sardinia
satisfaction: satisfaction
satisfactory: satisfactory
satisfied: satisfied
satisfy: satisfied,satisfies,satisfy,satisfying
saunter: saunters
sauntering: sauntering
savage: savage,savages
save: save,saved,saves,saving
saving: saving
savings: savings
savoy: savoy
saxon: saxon
saxons: saxons
scale: scales
scandal: scandal
scandinavian: scandinavians
scantily: scantily
scantiness: scantiness
scanty: scantiest,scanty
scarce: scarce,scarcer
scarcely: scarcely
scarcity: scarcity
scarlet: scarlet
scatter: scattered
scattered: scattered
scene: scene
scheme: scheme,schemes
schism: schism
scholar: scholar,scholars
scholarship: scholarships
school: school,schools
schoolmaster: schoolmaster
science: science,sciences
sciences: sciences
scorch: scorched
score: score
scotch: scotch
scotia: scotia
scotland: scotland
scots: scots
scramble: scramble
scribbler: scribbler
scriptures: scriptures
scruple: scruple
scrupulous: scrupulous
scrutiny: scrutiny
sculptor: sculptors
scythian: scythian
sea: sea,seas
seal: seal
seaman: seamen
search: search
season: season,seasons
seat: seat,seats
secrecy: secrecy
secret: secret,secrets
secretary: secretaries
secretly: secretly
sect: sect,sects
sectary: sectaries
secular: secular
secundum: secundum
secure: secure,secured,secures,securing
security: securities,security
sedition: sedition
seditious: seditious
seed: seed,seeds
seedtime: seedtime
seek: seek,seeking,seeks,sought
seemingly: seemingly
seige: seige
seigneurage: seigneurage
seignorage: seignorage
seize: seize,seized
seizure: seizure
seldom: seldom
seldomer: seldomer
select: select
selfish: selfish
sell: sell,selling,sells,sold
seller: seller,sellers
selling: selling
senate: senate
send: send,sending,sends
senega: senega
senegal: senegal
sense: sense
sensibly: sensibly
sentiment: sentiment,sentiments
separate: separate,separated,separates
separately: separately
separation: separation
september: september
septier: septier
serjeant: serjeant,serjeants
servant: servant,servants
serve: serve,served,serves,serving
service: service,services
serviceable: serviceable
servile: servile
servitude: servitude
servius: servius
session: session,sessions
sestertius: sestertius
set: set,sets,setting
setting: setting
settle: settle,settled,settling
settled: settled
settlement: settlement,settlements
settler: settlers
sevenpence: sevenpence
seventeen: seventeen
seventeenth: seventeenth
seventh: seventh
severally: severally
severe: severe,severest
severely: severely
severity: severity
sew: sew,sewn
sex: sex,sexes
seymour: seymour
shaft: shafts
shake: shaken
sham: sham
shape: shape,shapes
share: share,shared,shares,sharing
sharing: sharing
sharp: sharp
sharpen: sharpen
shear: shearing
shearing: shearing
shears: shears
sheep: sheep
sheet: sheet
sheffield: sheffield
shekel: shekels
shelter: shelter
shepherd: shepherd,shepherds
sheriff: sheriff
shetland: shetland
shew: shew,shewn,shews
shewn: shewn
shift: shift,shifting
shill: shilling
shilling: shilling,shillings
ship: ship,ships
shipping: shipping
shirt: shirt
shocking: shocking
shoe: shoe,shoes
shoemaker: shoemaker,shoemakers
shoot: shot
shop: shop,shops
shopkeep: shopkeeping
shopkeeper: shopkeeper,shopkeepers
shore: shore,shores
short: short,shorter,shortest
shortness: shortness
shot: shot
shred: shreds
shroff: shroff
shropshire: shropshire
shun: shun,shunned,shuns
shut: shut
siam: siam
siberia: siberia
sic: sic
sicilian: sicilian
sicily: sicily
sick: sick
sickness: sickness
siege: siege
sight: sight
sighted: sighted
sign: sign
signal: signal
signalize: signalized
signification: signification
signify: signified,signifies,signify
silence: silence
silent: silent
silently: silently
silesia: silesia
silk: silk,silks
silly: silly
silver: silver
simple: simple,simpler,simplest
simplicity: simplicity
simply: simply
sin: sin
sincerity: sincerity
sinew: sinews
singer: singers
single: single
singly: singly
singular: singular
singularity: singularity
sink: sink,sinking,sinks,sunk
sinking: sinking
sir: sir
sister: sisters
sit: sat,sit
situate: situated
situation: situation,situations
sixpence: sixpence,sixpences
sixteen: sixteen
sixteenth: sixteenth
sixth: sixth
size: size
sketch: sketches
skilful: skilful
skilfully: skilfully
skill: skill
skilled: skilled
skim: skimmed
skin: skin,skins
skirmish: skirmish
slacken: slackened
slave: slave,slaves
slavery: slavery
sleep: sleep
slender: slender
slight: slight,slightest
slip: slip
slipper: slippers
slit: slit
sloth: sloth
slothful: slothful
slovenly: slovenly
slow: slow,slower,slowest
slowly: slowly
slowness: slowness
smallness: smallness
smattering: smattering
smelting: smelting
smith: smith,smiths
smiths: smiths
smoke: smoke
smoother: smoothers
smoothness: smoothness
smuggle: smuggle,smuggled,smuggling
smuggler: smuggler,smugglers
smuggling: smuggling
sneak: sneaking
snuff: snuff
soap: soap
sober: sober,soberest
sobriety: sobriety
soccage: soccage
social: social
societies: societies
society: societies,society
soever: soever
soften: soften,softened
soil: soil,soils
soldier: soldier,soldiers
sole: sole
solely: solely
solemn: solemn
solemnity: solemnity
solicit: soliciting
solicitation: solicitation
solid: solid
solomon: solomon
solon: solon
son: son,sons
sooner: sooner
sophism: sophisms
sophist: sophists
sophistical: sophistical
sophistry: sophistry
sordid: sordid
sort: sort,sorts
sorter: sorter
sou: sou
soul: soul,souls
source: source,sources
sous: sous
south: south
southern: southern
sovereign: sovereign,sovereigns
sovereignty: sovereignty
sow: sow,sowed
sower: sower
sowing: sowing
space: space
spacious: spacious
spade: spade
spain: spain
spaniard: spaniard
spaniards: spaniards
spaniel: spaniel
spanish: spanish
spare: spare,spared
sparing: sparing
sparingly: sparingly
spartan: spartans
speak: speak,speaking
special: special
species: species
specific: specific
spectator: spectator
speculation: speculation,speculations
speculative: speculative
speech: speech
speedily: speedily
speedy: speedier,speediest,speedy
spend: spend,spending,spends,spent
spending: spending
spendthrift: spendthrift,spendthrifts
sphere: sphere
spice: spice,spices
spicery: spiceries
spin: spin,spun
spindle: spindle
spinner: spinner,spinners
spinning: spinning
spirit: spirit,spirits
spirited: spirited
spiritous: spiritous
spiritual: spiritual
spite: spite
splendid: splendid
splendour: splendour
spoil: spoil,spoiling
spontaneous: spontaneous
spontaneously: spontaneously
spot: spot
spread: spread,spreading,spreads
spring: spring,springs
spruce: spruce
square: square
squared: squared
squeeze: squeezed
squire: squires
stability: stability
stable: stable,stables
stack: stack
stadtholdership: stadtholdership
stage: stage,stages
staid: staid
stain: stained
stall: stall
stallage: stallage
stamp: stamp,stamped,stamps
stand: stand,standing,stands,stood
standard: standard,standards
standing: standing
stannary: stannaries
start: start
starve: starve,starved
starving: starving
stat: stat
statesman: statesman,statesmen
station: station,stations
stationary: stationary
statuary: statuaries
statue: statue,statues
statute: statute,statutes
statutory: statutory
stay: stay,staying
stead: stead
steadily: steadily
steadiness: steadiness
steady: steady
steal: stealing,stolen
steam: steam
steel: steel
step: steps
sterling: sterling
steward: steward,stewards
stick: stick,sticks,stuck
stinking: stinking
stint: stint
stipend: stipend,stipends
stipendiary: stipendiary
stipulate: stipulate,stipulated
stipulation: stipulation
stir: stirring,stirs
stiver: stivers
stock: stock,stocked,stocks
stocking: stockings
stoic: stoic
stoics: stoics
stomach: stomach
stone: stone,stones
stopt: stopt
store: store,stored,stores,storing
storehouse: storehouse
storey: storey,storeys
storm: storm,storms
story: story
straggling: straggling
straight: straight,straights
strain: strain
strait: strait,straits
straiten: straiten
strange: strange
stranger: strangers
straw: straw
stray: straying
stream: stream
street: street,streets
strength: strength
strengthen: strengthen,strengthening
strew: strewed
strict: strict,stricter,strictest
strictly: strictly
stride: strides
strike: struck
string: string
stript: stript
strong: strong,stronger,strongest
struggle: struggle
strumpet: strumpets
stuart: stuart
student: student,students
studio: studio
study: studied,studies,study,studying
stuff: stuff,stuffed,stuffs
stunt: stunt,stunted
stupid: stupid
stupidity: stupidity
subdivide: subdivide,subdivided
subdivision: subdivision,subdivisions
subdue: subdue,subdued,subduing
subject: subject,subjected,subjecting,subjects
subjoin: subjoined
sublime: sublime
submission: submission
submit: submit,submits,submitted,submitting
subordinate: subordinate
subordination: subordination
subscribe: subscribed
subscriber: subscribers
subscription: subscription,subscriptions
subsequent: subsequent
subservient: subservient
subsidiary: subsidiary
subsidy: subsidies,subsidy
subsist: subsist,subsisted,subsisting,subsists
subsistence: subsistence
substance: substance,substances
substantial: substantial
substitute: substitute,substituted,substitutes,substituting
substitution: substitution,substitutions
subtlety: subtleties,subtlety
suburb: suburbs
subversive: subversive
succeed: succeed,succeeded,succeeding,succeeds
success: success,successes
successful: successful
succession: succession,successions
successive: successive
successively: successively
successor: successor,successors
sudden: sudden
suddenly: suddenly
suddenness: suddenness
sue: sue,sued,sues
suffer: suffer,suffered,suffering,suffers
sufferance: sufferance
suffering: suffering
sufficiency: sufficiency
sufficient: sufficient
sugar: sugar,sugars
suggestion: suggestion
suit: suit,suited,suiting,suits
suitable: suitable
suitably: suitably
suited: suited
suitor: suitors
sum: sum,sums
summary: summary
summer: summer
sumptuary: sumptuary
sumptuous: sumptuous
sun: sun
sunday: sunday
sunt: sunt
superabundance: superabundance
superabundant: superabundant
superficial: superficial
superficially: superficially
superfine: superfine
superfluity: superfluities,superfluity
superfluous: superfluous
superintend: superintend,superintending,superintends
superintendency: superintendency
superior: superior,superiors
superiority: superiority
superstition: superstition
superstitious: superstitious
supplant: supplant
supplicate: supplicate
supply: supplied,supplies,supply,supplying
support: support,supported,supporting,supports
suppose: suppose,supposed,supposes,supposing
supposition: supposition,suppositions
suppress: suppress,suppressed,suppressing
suppression: suppression
supreme: supreme
sur: sur
surely: surely
surety: surety
surface: surface
surinam: surinam
surmount: surmount,surmounting
surmullet: surmullet
surpass: surpass,surpassed,surpasses
surplus: surplus
surprise: surprise,surprised,surprises
surprised: surprised
surround: surround,surrounded,surrounds
survey: survey
survive: survive
suspect: suspect,suspected
suspend: suspend,suspended
suspense: suspense
suspicion: suspicion,suspicions
suspicious: suspicious
sussex: sussex
sustain: sustain,sustained,sustains
sustenance: sustenance
swallow: swallowed
swear: swore
sweden: sweden
swedes: swedes
swedish: swedish
sweet: sweets
swell: swelled
swiftness: swiftness
swiss: swiss
switzerland: switzerland
sword: sword
symptom: symptom,symptoms
synonymous: synonymous
syracuse: syracuse
syria: syria
systematical: systematical
systems: systems
ta: ta
table: table,tables
tacit: tacit
taille: taille
tailor: tailor,tailors
takings: takings
tale: tale,tales
talent: talent,talents
talk: talk
tallage: tallage,tallages
tallow: tallow
tally: tallies
tamper: tamper,tampering
tan: tanned
tanner: tanner,tanners
tar: tar
tardy: tardy
tariff: tariff
tartar: tartar
tartars: tartars
tartary: tartary
taste: taste,tasting
tavern: tavern
tax: tax,taxed,taxes,taxing
taxable: taxable
taxation: taxation
te: te
tea: tea,teas
teach: taught,teach,teaching
teacher: teacher,teachers
teaching: teaching
team: team
tear: tear
tedious: tedious
temper: temper,tempered
temperate: temperate
temple: temple
temporal: temporal
temporary: temporary
tempt: tempt,tempted,tempts
temptation: temptation,temptations
tenacious: tenacious
tenant: tenant,tenanted,tenants
tenantry: tenantry
tend: tend,tended,tending
tendency: tendency
tender: tender
tenement: tenement
tenet: tenet,tenets
tenfold: tenfold
tenor: tenor
tenpence: tenpence
tent: tents
tenth: tenth,tenths
tenure: tenure,tenures
term: term,terms
terra: terra
terrify: terrify
territorial: territorial
territory: territories,territory
terror: terror,terrors
testament: testament,testaments
testamentary: testamentary
testator: testator
testimonial: testimonial
testimony: testimony
teutonic: teutonic
thenceforth: thenceforth
theology: theology
theory: theories,theory
thereabout: thereabouts
thicken: thickening
thinly: thinly
thirdly: thirdly
thirst: thirst
thirteen: thirteen
thirteenth: thirteenth
thirtieth: thirtieth
thither: thither
thomas: thomas
thorn: thorn
thoughtless: thoughtless
thoughtlessness: thoughtlessness
thousandth: thousandth
threaten: threatened
threepence: threepence
thresh: thresh
thrice: thrice
thrift: thrift
thrive: thrive,thriving
thriving: thriving
throne: throne,thrones
throw: threw,throw,throwing,thrown
thunder: thunder
thwart: thwart,thwarted
ticket: ticket,tickets
tide: tides
tie: tied,ties,tying
tillage: tillage
timaeus: timaeus
timber: timber
time: time,times
times: times
timid: timid
tin: tin
tithe: tithe,tithes
title: title
tobacco: tobacco
tod: tod
toil: toil
toilsome: toilsome
tolerable: tolerable
tolerably: tolerably
tolerate: tolerated
toll: toll,tolls
tom: tom
tome: tome
ton: ton,tons
tone: tone
tonnage: tonnage
tool: tool,tools
tooth: teeth
torpid: torpid
torpor: torpor
torrent: torrents
tot: tot
total: total,totals
totally: totally
touch: touch
tower: tower
town: town,towns
towns: towns
toy: toys
trace: trace
tract: tract,tracts
tracts: tracts
trade: trade,traded,trades,trading
trader: trader,traders
tradesman: tradesman,tradesmen
tradesmen: tradesmen
trading: trading
traffic: traffic
train: train
tranquillity: tranquillity
transact: transact,transacted,transacting
transaction: transaction,transactions
transcribe: transcribed,transcribing
transcriber: transcribers
transcription: transcription
transfer: transfer,transferred,transferring
transferability: transferability
transferable: transferable
transference: transference
transitory: transitory
translate: translated
translation: translation
transmit: transmitted,transmitting
transport: transport,transported,transporting
transportation: transportation
travel: travel,travelled,travelling
traveller: traveller,travellers
travels: travels
tread: treading
treasure: treasure,treasures
treasurer: treasurer
treasury: treasury
treat: treat,treated,treating,treats
treatise: treatise
treatment: treatment
treaty: treaties,treaty
treble: treble
tree: tree,trees
tremble: tremble
trench: trenches
trespass: trespass
trial: trial
tribe: tribe,tribes
tribunal: tribunal,tribunals
tribune: tribunes
trick: tricks
trifle: trifle,trifles,trifling
trifling: trifling
trinket: trinkets
tripartite: tripartite
triple: triple,tripled
triumphal: triumphal
trojan: trojan
troll: troll
troops: troops
tropics: tropics
trouble: trouble,troubling
troublesome: troublesome
trove: trove
troy: troy
truck: truck
trucking: trucking
true: true
trust: trust,trusted,trusting,trusts
trustee: trustees
truth: truth,truths
tumbrel: tumbrel
tumult: tumult
tumultuous: tumultuous
tune: tune
turbulence: turbulence
turbulent: turbulent
turf: turf
turkey: turkey
turkish: turkish
turks: turks
turnip: turnips
turnpike: turnpike,turnpikes
turpentine: turpentine
tuscany: tuscany
tutor: tutor,tutors
twelfth: twelfth
twelvemonth: twelvemonth
twentieth: twentieth
twopence: twopence,twopences
tyrannical: tyrannical
tyranny: tyranny
tyrant: tyrant
tythe: tythe
ukraine: ukraine
ultimate: ultimate
ultimately: ultimately
unable: unable
unaccountable: unaccountable
unacquainted: unacquainted
unalienable: unalienable
unalterable: unalterable
unanimity: unanimity
unanimous: unanimous
unavoidable: unavoidable
unbounded: unbounded
uncertain: uncertain
uncertainty: uncertainty
uncivilized: uncivilized
uncoined: uncoined
uncommon: uncommon
uncommonly: uncommonly
unconditional: unconditional
unconnected: unconnected
unconquerable: unconquerable
unconsumable: unconsumable
uncontested: uncontested
uncouth: uncouth
uncultivated: uncultivated
undeck: undecked
undeniable: undeniable
underdo: underdo
undergo: undergo,undergoing,undergone,underwent
underling: underling
underpaid: underpaid
underpeopled: underpeopled
undersell: undersell,underselling,undersold
understand: understand,understanding,understood
understanding: understanding,understandings
undertake: undertake,undertaken,undertakes
undertaker: undertaker,undertakers
undertaking: undertaking,undertakings
undervalue: undervalued
undiscerning: undiscerning
undisciplined: undisciplined
undisturbed: undisturbed
undivided: undivided
undo: undo,undone
undoubted: undoubted
undoubtedly: undoubtedly
undressed: undressed
uneasiness: uneasiness
uneasy: uneasy
unemployed: unemployed
unequal: unequal
unequally: unequally
uneven: uneven
unexceptionable: unexceptionable
unfashionable: unfashionable
unfavourable: unfavourable
unfavourableness: unfavourableness
unfavourably: unfavourably
unfit: unfit
unforeseen: unforeseen
unfortunate: unfortunate
unhappy: unhappy
unhealthful: unhealthful
uniform: uniform
uniformity: uniformity
uniformly: uniformly
unimproved: unimproved
uninclosed: uninclosed
uninhabited: uninhabited
uninstructed: uninstructed
uninterrupted: uninterrupted
union: union
unite: unite,united,unites,uniting
united: united
universal: universal
universally: universally
universe: universe
university: universities,university
unjust: unjust
unjustly: unjustly
unknown: unknown
unlawful: unlawful
unlearned: unlearned
unlimited: unlimited
unload: unload
unloading: unloading
unmanufactured: unmanufactured
unmerited: unmerited
unnatural: unnatural
unnecessarily: unnecessarily
unnecessary: unnecessary
unpaid: unpaid
unphilosophical: unphilosophical
unpleasant: unpleasant
unpopular: unpopular
unprepared: unprepared
unprincipled: unprincipled
unproductive: unproductive
unprofitable: unprofitable
unpromising: unpromising
unprosperous: unprosperous
unprovided: unprovided
unreasonable: unreasonable
unreasonableness: unreasonableness
unremitting: unremitting
unrestrained: unrestrained
unskilful: unskilful
unskilfulness: unskilfulness
unsocial: unsocial
unsold: unsold
unstable: unstable
unstamped: unstamped
unsuccessful: unsuccessful
unsuccessfully: unsuccessfully
unsuitable: unsuitable
unsupported: unsupported
untaxed: untaxed
untenanted: untenanted
unthought: unthought
unthrifty: unthrifty
unusual: unusual
unveil: unveil
unwarlike: unwarlike
unwholesome: unwholesome
unwholesomeness: unwholesomeness
unwilling: unwilling
upholsterer: upholsterers
upper: upper
upright: upright
upstart: upstart
urgent: urgent
usage: usage
useless: useless
usual: usual
usurer: usurers
usurious: usurious
usurp: usurped
usurpation: usurpations
usurped: usurped
usurper: usurpers
usury: usury
utensil: utensils
utility: utility
utmost: utmost
utopia: utopia
utrecht: utrecht
utterly: utterly
vacant: vacant
vacation: vacations
vacuity: vacuities
vagrant: vagrants
vague: vague
vain: vain
vainly: vainly
valid: valid
valour: valour
valuable: valuable
valuation: valuation,valuations
valve: valve
vanity: vanities,vanity
vanquish: vanquished
variable: variable
variance: variance
variation: variation,variations
variations: variations
varied: varied
variegated: variegated
variety: varieties,variety
vary: varied,varies,vary,varying
vasa: vasa
vassal: vassal,vassals
vast: vast
vastly: vastly
vegetable: vegetable,vegetables
vein: vein,veins
vel: vel
velvet: velvets
venality: venality
vendible: vendible
veneration: veneration
venetian: venetian,venetians
venice: venice
venison: venison
venture: venture,ventures
vera: vera
verbose: verbose
verd: verd
verify: verified
versailles: versailles
verse: verses
vessel: vessel,vessels
vest: vested
vestige: vestige
vestry: vestry
veteran: veteran,veterans
vexation: vexation,vexations
vexatious: vexatious
vice: vice,vices
viceroy: viceroy
victory: victories,victory
victual: victualled,victualling
victuals: victuals
vie: vie
vienna: vienna
view: view,views
vigilance: vigilance
vigilant: vigilant
vigorous: vigorous
vigour: vigour
vii: vii
viii: viii
vile: vile,vilest
villa: villa,villas
village: village,villages
villain: villain,villains
villanage: villanage
vindicate: vindicated
vine: vine
vinegar: vinegar
vineyard: vineyard,vineyards
vingtieme: vingtieme
violate: violate,violated,violates
violation: violation,violations
violence: violence
violent: violent
violently: violently
virgin: virgin
virginia: virginia
virtually: virtually
virtue: virtue,virtues
virtuous: virtuous
viscount: viscounts
vision: vision
visionary: visionary
visit: visit,visited,visiting,visits
vital: vital
viviparous: viviparous
vogue: vogue
voice: voice
void: void
voltaire: voltaire
volume: volumes
voluntarily: voluntarily
voluntary: voluntary
volunteer: volunteers
votary: votaries
vote: vote,votes
voyage: voyage,voyages
voyages: voyages
vulgar: vulgar
vulgarly: vulgarly
vulgate: vulgate
wage: wage
wages: wages
waggon: waggon,waggons
wait: wait,waiting
waiter: waiter
wales: wales
walk: walk,walks
wall: wall,walls
wander: wander,wandering
wanton: wanton
wantonly: wantonly
wantonness: wantonness
war: war,wars
ward: ward
warden: wardens
wardrobe: wardrobe
ware: ware
warehouse: warehouse,warehoused,warehouses
wares: wares
warfare: warfare
warlike: warlike
warm: warm
warmth: warmth
warn: warning
warning: warning
warp: warp
warrant: warrant,warrants
warrior: warrior,warriors
warwick: warwick
wash: washed
waste: waste,wasted,wasting
wastel: wastel
watch: watch,watched,watches
water: water,watered,waters
watering: watering
watery: watery
wave: waves
weak: weak,weaker
weaken: weaken,weakened,weakens
weakness: weakness
wealth: wealth
wealthy: wealthier,wealthiest,wealthy
weapon: weapon,weapons
wear: wear,wearing,wears,wore,worn
weary: weary
weather: weather
weave: weaving
weaver: weaver,weavers
weed: weed
week: week,weeks
weekly: weekly
weigh: weigh,weighing,weighs
weight: weight,weights
welfare: welfare
west: west
western: western
westminster: westminster
wet: wet
whale: whale
whalebone: whalebone
whatsoever: whatsoever
wheat: wheat
wheaten: wheaten
wheel: wheel,wheels
wheeled: wheeled
wheelwright: wheelwrights
wherewithal: wherewithal
whet: whetted
whey: whey
whit: whit
white: white
whitehall: whitehall
whiten: whiten
whites: whites
wholesale: wholesale
wholesome: wholesome
wholesomeness: wholesomeness
wholly: wholly
whosoever: whosoever
wickedness: wickedness
wide: wide,wider
widen: widen,widens
widow: widow,widows
wife: wife
wild: wild,wilds
william: william
willingly: willingly
wilton: wilton
winchester: winchester
wind: wind,winding,winds
window: window,windows
windsor: windsor
wine: wine,wines
wing: wings
winter: winter,winters
wire: wire
wisdom: wisdom
wise: wise,wiser,wisest
wisely: wisely
wit: wit
witchcraft: witchcraft
withdraw: withdraw,withdrawing,withdrawn,withdraws,withdrew
withers: withers
withholding: withholding
withstand: withstanding
witness: witness,witnesses
woman: woman,women
womb: womb
wonderful: wonderful
wonderfully: wonderfully
wood: wood,woods
woodcock: woodcocks
wooden: wooden
woof: woof
wool: wool,wools
woollen: woollen
woollens: woollens
word: word
workhouse: workhouse,workhouses
workman: workman,workmen
workmanship: workmanship
worm: worm,worms
worn: worn
worsted: worsted
worth: worth
worthless: worthless
worthy: worthy
wound: wounds
wreck: wreck
wrestling: wrestling
wretch: wretches
wretched: wretched
wretchedness: wretchedness
wright: wright
writ: writ
write: write,writes,writing,written,wrote
writer: writer,writers
writing: writing
writings: writings
wrong: wrong
xi: xi
xiv: xiv
xxi: xxi
yam: yams
yard: yard,yards
yarn: yarn
yearly: yearly
yeomanry: yeomanry
yield: yield,yielded,yielding,yields
york: york
yorkshire: yorkshire
youth: youth
youthful: youthful
zeal: zeal
zealand: zealand
zealous: zealous
zurich: zurich
