abandon: abandon,abandoned
abate: abated
abduction: abduction
abide: abide
ability: abilities,ability
abrupt: abrupt
abruptly: abruptly
absence: absence
absent: absent
absolute: absolute
absolutely: absolutely
absorb: absorbed
abundance: abundance
abuse: abuse
accept: accept,accepted,accepting,accepts
acceptable: acceptable
access: access,accessed
accessible: accessible
accommodate: accommodated
accompany: accompanied,accompany
accost: accost
account: account
accumulate: accumulated,accumulating
accusation: accusation,accusations
accuse: accused
ach: ach
ache: aching
achieve: achieve,achieved
achievement: achievement
acknowledge: acknowledge,acknowledged,acknowledging
acknowledgement: acknowledgement
acquaintance: acquaintance,acquaintances
acquire: acquire,acquired
acquisitive: acquisitive
acquit: acquit,acquitted
acquittal: acquittal,acquittals
action: action,actions
active: active
activity: activities,activity
actor: actors
actual: actual
acumen: acumen
add: add,adding
addition: addition,additions
additional: additional
address: address,addresses
adjoining: adjoining
adjust: adjusting
admiration: admiration
admit: admit,admits,admitted
ado: ado
adopt: adopt
adroit: adroit
advance: advance
advantage: advantage,advantages
advantageous: advantageous
adverse: adverse
adversely: adversely
advice: advice
advise: advise,advised
adviser: adviser
advisor: advisor
advocate: advocates
afar: afar
affair: affair,affairs
affect: affect
affection: affection
affirmation: affirmation
afford: afford
afraid: afraid
afternoon: afternoon
age: age
aged: aged
agenda: agenda
agent: agent
aghast: aghast
agitated: agitated
agitation: agitation
agree: agree,agreed
agreement: agreement
aimlessly: aimlessly
air: air
aisle: aisle
alarm: alarm
alarming: alarming
albeit: albeit
albert: albert
album: album
alert: alert
alive: alive
allocate: allocated,allocates
allure: allure
alright: alright
altar: altar,altars
alter: alter,altered
alteration: alteration
alternate: alternate
altogether: altogether
aluminium: aluminium
amazed: amazed
amazement: amazement
ambush: ambush
amend: amends
amiss: amiss
amuse: amused
anaemic: anaemic
ancient: ancient
angel: angels
anger: anger
angle: angle
angry: angry
anguish: anguish
angular: angular
animal: animal
animatedly: animatedly
anna: anna
annoyed: annoyed
answer: answer,answered,answering,answers
anticipate: anticipate
anticipation: anticipation
anxiety: anxiety
anxious: anxious
anxiously: anxiously
apathetic: apathetic
apologetic: apologetic
apologise: apologise,apologised,apologising
apology: apology
apparent: apparent
appeal: appeals
appearance: appearance,appearances
applaud: applaud,applauded
applause: applause
apple: apple
applicable: applicable
applicant: applicant
application: applications
apply: applied,applies,apply
appointment: appointment
apprentice: apprentice
approach: approach,approached,approaches,approaching
apron: apron,aprons
archive: archive
argue: argue
argument: argument
arithmetic: arithmetic
arm: arm,arms
armchair: armchair,armchairs
armour: armour
armpit: armpit
armrest: armrest,armrests
army: army
arouse: arouse
arrange: arrange
arrangement: arrangements
array: array
arrest: arrest,arrested,arresting
arrival: arrival
arrive: arrive,arrived
arrogance: arrogance
arrogant: arrogant
art: art
artificially: artificially
artistic: artistic
artistically: artistically
ascertain: ascertain
ascii: ascii
ashamed: ashamed
asleep: asleep
aspect: aspect
assemble: assemble,assembled
assembly: assembly
assert: asserting
assertion: assertion,assertions
assessment: assessment
assist: assisted
assistance: assistance
assistant: assistant,assistants
assume: assumed,assuming
astonish: astonished
astonished: astonished
astonishing: astonishing
astonishment: astonishment
astounded: astounded
astute: astute
atmosphere: atmosphere
attach: attach,attached,attaches
attack: attack,attacked,attacks
attain: attain,attained
attempt: attempt,attempted,attempting,attempts
attend: attend
attendant: attendant
attention: attention
attentive: attentive
attentively: attentively
attic: attic
attorney: attorney
attract: attract,attracted
attractive: attractive
audience: audience
augment: augment,augmented
aunt: aunt
author: author
authority: authorities,authority
automatically: automatically
autumn: autumn
average: average
avoid: avoid,avoided,avoiding
awake: awake
aware: aware
awareness: awareness
awful: awful
awkward: awkward
babble: babble
baby: babies
background: background
backrest: backrest
bad: bad,worse,worst
badge: badge,badges
badly: badly
balance: balanced,balancing
bald: bald
ball: ball,balled
balustrade: balustrade
ban: ban
bank: bank
banknote: banknotes
bar: bar,bars
bare: bare
barely: barely
bark: bark
barrack: barrack
barrister: barrister
base: base,based
basic: basic
basically: basically
basis: basis
bastard: bastard
bath: bath
battered: battered
beam: beam
bear: bear,bearing,bore
beard: beard,beards
bearer: bearer
bearing: bearing,bearings
beat: beat,beaten,beating
beating: beating
beautiful: beautiful
beckon: beckon,beckoned,beckons
bed: bed,beds
bedclothes: bedclothes
bedding: bedding
bedpost: bedpost
bedroom: bedroom
bedside: bedside
bedspread: bedspread
beg: beg,begged,begging
beggar: beggar,beggars
behalf: behalf
behave: behave,behaved,behaves,behaving
behaviour: behaviour
belief: belief,beliefs
bell: bell
belly: belly
belong: belong,belonged,belonging,belongs
beloved: beloved
belt: belt
bench: bench,benches
bend: bend,bends,bent
beneath: beneath
benefit: benefit
bent: bent
berthold: berthold
bet: bet
betray: betray,betrayed
bicycle: bicycle
binary: binary
bind: binding,bound
birth: birth
birthday: birthday
bit: bit
bite: bit,bite,biting
bitter: bitter
black: black
blade: blades
blame: blame
bland: bland
blanket: blanket
blankly: blankly
blatantly: blatantly
blindfold: blindfold
blink: blink,blinked
block: block,blocks
bloke: bloke
blonde: blonde
blood: blood
bloody: bloody
bloom: bloom
blot: blotted
blouse: blouse
blow: blew,blow,blown,blows
blubber: blubbered
blue: blue
board: board
boat: boat
bodily: bodily
body: bodies,body
bold: bold
bony: bony
boo: boo
booing: booing
book: book,books
bookshelf: bookshelves
boring: boring
borrow: borrowed
bother: bother,bothered
bottle: bottle,bottles
boundary: boundary
bow: bow,bowed,bows
box: box
boy: boy
brace: braces
branch: branch
brat: brats
bravo: bravo
brazenly: brazenly
breach: breach
bread: bread
breadth: breadth
break: break,breaking,broke,broken
breakfast: breakfast
breast: breast
breath: breath
breathe: breathe,breathed,breathing
bribe: bribe,bribed,bribes
bride: bride
bridge: bridge,bridges
briefcase: briefcase
bright: brighter
brighten: brightened
brightness: brightness
bring: bring,bringing,brings,brought
briskly: briskly
broad: broad
brow: brow,brows
brown: brown
brush: brushed
bucket: bucket
buckle: buckles
build: built
building: building
bulb: bulb
bulge: bulging
bunch: bunch,bunched,bunching
bundle: bundle
burden: burden
burn: burned,burning,burns
bury: buried
bush: bushes
bushy: bushy
business: business
businessman: businessman,businessmen
bustle: bustle
busy: busy
butcher: butcher
butter: buttered
button: button,buttoned,buttons
cab: cab
calculate: calculate,calculated
calculation: calculations
calm: calm,calmed,calmer
calmly: calmly
calmness: calmness
canal: canal
candle: candle,candles
cane: cane
canvas: canvas
capable: capable
captain: captain
captivate: captivated
car: car
card: card,cards
care: care
career: career,careers
careful: careful
carefully: carefully
carelessly: carelessly
carer: carer
caricature: caricature
carpet: carpet
carry: carried,carry,carrying
cart: cart
carve: carved
cassock: cassock
cast: casting
casually: casually
catch: catch,catching,caught
cathedral: cathedral
caution: caution
cautious: cautious
cautiously: cautiously
cease: cease
ceiling: ceiling
celebrate: celebrating
central: central
centre: centre
cereal: cereals
certainty: certainty
certificate: certificate
chain: chains
chair: chair,chairs
chance: chance
change: change,changed,changing
chaos: chaos
chapel: chapel
chaplain: chaplain
chapter: chapter
character: character
characterless: characterless
charge: charge,charges
charitable: charitable
charity: charities,charity
charming: charming
chase: chased,chases,chasing
chaser: chasers
chat: chat,chatted,chatting
chatter: chattering
cheap: cheap
cheaply: cheaply
cheat: cheat,cheated,cheating,cheats
check: check,checked,checking,checks
cheek: cheek,cheeks
cheerfully: cheerfully
chest: chest
chief: chief
child: child,children
childish: childish
childishness: childishness
chill: chill
chilly: chilly
chimney: chimney
chin: chin,chins
chit: chit
chocolate: chocolate,chocolates
choice: choice
choir: choir
choke: choking
choose: choose,chose,chosen
christ: christ
christian: christian
chronic: chronic
church: church
cigar: cigar
circle: circle,circles,circling
circumstance: circumstances
cite: cite
city: city
civil: civil
civilian: civilian
claim: claim
clamber: clambered
clap: clap,clapped
clasped: clasped
class: classes
claw: claw,clawing,claws
clean: clean,cleaned,cleaning
cleanliness: cleanliness
clearing: clearing
clench: clenched
clerk: clerk
clever: clever
client: client,clients
climb: climb,climbed,climbs
clock: clock
close: close,closed,closer,closing
closed: closed
closely: closely
cloth: cloth
clothes: clothes
clothing: clothing
clumsy: clumsy
coach: coach
coarse: coarse
coat: coat,coats
code: codes
coffee: coffee
coincidence: coincidence
cold: cold
collapse: collapse
collar: collar,collars
colleague: colleagues
collect: collect,collected
collection: collection
coloration: coloration
colour: colours
coloured: coloured
column: column
comb: combed
combat: combat
combination: combination
comfort: comfort
comfortable: comfortable
comfortably: comfortably
command: command,commands
commendable: commendable
comment: comment,commenting,comments
commentator: commentators
commercial: commercial
commit: committed
committed: committed
committee: committee
common: common
communicate: communicating
companion: companions
company: companies,company
comparatively: comparatively
compare: compared,compares,comparing
compassionate: compassionate
competent: competent
compilation: compilation
compile: compiled
complacency: complacency
complain: complain,complained
complaint: complaint,complaints
complete: complete,completed
completely: completely
completeness: completeness
complexity: complexity
compliance: compliance
complicated: complicated
compliment: compliment,compliments
comply: comply,complying
compose: composing
compress: compressed
compunction: compunction
comradeship: comradeship
conceal: conceal,concealed
concede: concede,conceded
conceited: conceited
conceivable: conceivable
concentrate: concentrate
concentrated: concentrated
concept: concept
concern: concern,concerned,concerns
concerned: concerned
conclude: concluded
conclusion: conclusion,conclusions
conclusive: conclusive
condescension: condescension
condition: condition,conditions
conduct: conduct,conducted,conducting
confess: confess,confessing
confession: confession
confidence: confidence
confident: confident
confirm: confirm,confirmed,confirms
confirmation: confirmation
confuse: confuse,confused
confused: confused
confusion: confusion
congregation: congregation
connect: connected,connecting
connection: connection,connections
conscientious: conscientious
conscious: conscious
consciousness: consciousness
consequence: consequences
consequential: consequential
considerable: considerable
considerate: considerate
consideration: consideration,considerations
consist: consist,consisted,consists
console: console,consoled
conspicuous: conspicuous
conspicuously: conspicuously
constant: constant
constitute: constitute
constrain: constrained
construction: constructions
consultation: consultation
contact: contact,contacted,contacting,contacts
contempt: contempt
contemptible: contemptible
contemptuous: contemptuous
content: content
contented: contented
continually: continually
continue: continue,continued,continuing
continuous: continuous
continuously: continuously
contract: contract
contradict: contradict,contradicted,contradicting
contradiction: contradiction,contradictions
contradictory: contradictory
contrary: contrary
contrast: contrast
contribute: contributed
contribution: contributions
contrived: contrived
control: control
convenience: convenience
convenient: convenient
conversation: conversation,conversations
convert: convert
convey: conveyed
convict: convicted
conviction: conviction
convince: convince,convinced
cook: cook
cooking: cooking
cool: cool
cope: cope
copper: coppers
copying: copying
copyright: copyright
corner: corner,corners
corporation: corporation
correct: correct,corrected
correctly: correctly
corridor: corridor,corridors
corrupt: corrupt
corruptible: corruptible
cost: cost,costs
costly: costly
costume: costume
cosy: cosy
couch: couch
cough: coughing
counsel: counsel
count: count,counting,counts
counter: counter,countered
counterpart: counterpart
countless: countless
country: countries,country
countryside: countryside
couple: couple
courage: courage
court: court,courts
courtesy: courtesies,courtesy
courtroom: courtroom,courtrooms
cover: cover,covered,covering,covers
covered: covered
covering: covering
coward: coward
cower: cowered
crack: crack
crash: crashing
crate: crate
crawl: crawl,crawled
crayon: crayon,crayons
crease: creases
creased: creased
create: create,created,creating
creation: creation
creature: creatures
credit: credit
creep: creep,crept
crime: crime
criminal: criminal
critical: critical
criticise: criticise,criticised
crony: cronies
crooked: crooked
cross: cross,crossed,crosses
crossly: crossly
crouch: crouching
crowd: crowd,crowded,crowds
crucial: crucial
crude: crude
crumb: crumb
crush: crush,crushed,crushing
cultural: cultural
cum: cum
cup: cup
cupboard: cupboard,cupboards
curiosity: curiosity
curious: curious
curiously: curiously
current: current
curse: curse,cursed,curses,cursing
curt: curt
curtain: curtains
curtly: curtly
curtsey: curtsey
curved: curved
cushion: cushion
custody: custody
cut: cut
damage: damage,damaging
damaged: damaged
damages: damages
damned: damned
damp: damp
dance: dance
danger: danger,dangers
dangerous: dangerous
dangle: dangled
daresay: daresay
dark: dark,darker
darkness: darkness
dashed: dashed
datum: data
daughter: daughter
david: david
day: day,days
daydreaming: daydreaming
daytime: daytime
dazzle: dazzled
deal: deal,dealing,dealt
death: death
decay: decay
deceit: deceit
deceive: deceive,deceived,deceiving
decent: decent
decide: decide,decided,decides,deciding
decision: decision,decisions
decisive: decisive
decisively: decisively
declare: declared
decorate: decorated
decoration: decoration
deductible: deductible
deem: deemed,deems
deep: deep,deeper,deepest
deeply: deeply
defect: defect,defects
defective: defective
defence: defence
defend: defend,defended,defending
defendant: defendant,defendants
deference: deference
deferentially: deferentially
deferment: deferment
defiance: defiance
deficiency: deficiency
definable: definable
definite: definite
deflect: deflect
degeneracy: degeneracy
degenerate: degenerate
degree: degrees
delay: delay,delayed,delaying,delays
delegate: delegate
deletion: deletions
deliberate: deliberate
deliberately: deliberately
delighted: delighted
delivery: delivery
delude: deluded
demand: demand
demeanour: demeanour
demented: demented
demur: demurred
densely: densely
deny: denied,deny,denying
department: department,departments
depend: depend,depends
dependent: dependent
depict: depict,depicted,depicting
depiction: depiction
depraved: depraved
depravity: depravity
depressing: depressing
depression: depression
deprive: depriving
depths: depths
deputy: deputy
derivative: derivative
derive: derive,derived
description: description
deserve: deserve
desire: desire
desk: desk,desks
despair: despair
desperately: desperately
despise: despised
destination: destination
destroy: destroy,destroyed,destroying
detach: detach
detailed: detailed
detain: detained
determine: determine,determined,determining
develop: develop,developed,developing
development: development
device: device
devoid: devoid
devote: devote
devotion: devotion
dialect: dialect
dialogue: dialogue
dictionary: dictionary
die: died,dies
difference: difference
difficult: difficult
difficulty: difficulties,difficulty
dignified: dignified
dignity: dignity
dim: dim
diminish: diminish
dining: dining
dinner: dinner
dip: dipping
direct: direct,directed,directing
direction: direction,directions
directive: directives
director: director
dirt: dirt
dirty: dirty
disadvantage: disadvantage,disadvantages
disagree: disagree
disappear: disappear,disappeared,disappears
disappoint: disappointed
disappointed: disappointed
disappointment: disappointment
disapprovingly: disapprovingly
disarray: disarray
discipline: discipline
disclaim: disclaim
disclaimer: disclaimer,disclaimers
discomfort: discomfort
disconcerted: disconcerted
discontinue: discontinue
discourteous: discourteous
discover: discover,discovered
discovery: discovery
discuss: discuss,discussed
discussion: discussion,discussions
disengage: disengage
disentangle: disentangle
disfavoured: disfavoured
disgrace: disgrace
disgraced: disgraced
disgracefully: disgracefully
disgust: disgusted
disgusting: disgusting
dish: dish,dishes
disheartening: disheartening
dishevelled: dishevelled
dishonest: dishonest
dishonourable: dishonourable
disinterested: disinterested
disk: disk
dislike: dislike
dismal: dismal
dismiss: dismissed,dismissing
dismissal: dismissal
disorder: disorder
dispatch: dispatch
dispensable: dispensable
dispirited: dispirited
display: display,displayed,displaying
disposal: disposal
disposed: disposed
disposition: disposition
disprove: disprove,disproved
dispute: dispute
disrupt: disrupted
disruption: disruptions
dissatisfied: dissatisfied
dissuade: dissuade,dissuaded
distance: distance
distinction: distinction
distinctly: distinctly
distinguish: distinguish,distinguished
distract: distract,distracted
distracted: distracted
distribute: distribute,distributed,distributing
distribution: distribution
distributor: distributor
disturb: disturb,disturbed,disturbing
disturbance: disturbance
disturbing: disturbing
disturbingly: disturbingly
diverse: diverse
divert: diverted
divide: divided
division: division
dizzy: dizzy
doctor: doctor
document: document,documents
dog: dog
domain: domain
dominate: dominated
donate: donate
donation: donation,donations
donor: donors
door: door,doors
doorkeeper: doorkeeper
doorman: doormen
doorstep: doorstep
doorway: doorway,doorways
double: double
doubt: doubt,doubts
download: downloading
downright: downright
downstairs: downstairs
drag: dragged,dragging
draught: draught,draughts
draw: draw,drawing,drawn,draws,drew
drawer: drawer,drawers
dreadful: dreadful
dream: dream,dreaming
dress: dress,dressed,dressing
dressed: dressed
dressing: dressing
drink: drank,drink,drinking
drinking: drinking
drip: dripped
drive: driven,driving,drove
driver: driver
droop: drooped
drop: drop,dropped
drown: drowning
drum: drummed
drunken: drunken
dry: dry
dull: dull,dulled
dumb: dumb
dust: dust
duty: duty
ear: ear
earn: earn
earnestly: earnestly
ease: ease,eased
easel: easel
easily: easily
easy: easier,easiest,easy
eat: ate,eat,eaten,eating,eats
ecstatic: ecstatic
edge: edge,edged,edges
edition: edition,editions
educational: educational
effective: effective
efficient: efficient
effort: effort,efforts
egg: eggs
eighteen: eighteen
elbow: elbow,elbows
elderly: elderly
elect: elect
electric: electric
electronic: electronic
electronically: electronically
elegance: elegance
elegant: elegant
elegantly: elegantly
elicit: elicit
elsa: elsa
email: email
embarrass: embarrassed
embarrassed: embarrassed
embarrassing: embarrassing
embarrassment: embarrassment
embittered: embittered
embrace: embrace,embracing
employ: employ,employs
employee: employee,employees
employment: employment
enchant: enchanted
encode: encoding
encompass: encompass
encounter: encountered
encourage: encourage,encouraged
encouragement: encouragement
encouraging: encouraging
endless: endless
endure: endure
enemy: enemy
energy: energy
engage: engaged
english: english
engross: engrossed
engrossed: engrossed
engrossing: engrossing
enjoy: enjoy,enjoyed,enjoying
enormous: enormous
enquiry: enquiry
enrage: enraged
ensure: ensuring
entail: entails
enter: enter,entered,entering
entertain: entertain,entertains
enthusiasm: enthusiasm
enthusiastically: enthusiastically
entire: entire
entity: entity
entrance: entrance,entrances
entrap: entrap
entry: entry
envy: envied
equal: equal
equally: equally
equip: equipped
equipment: equipment
erase: erased
erect: erect
error: error,errors
escape: escape,escaped
escort: escorted
essence: essence
essential: essential
establish: establish,established
esteem: esteem
estimate: estimated
eternal: eternal
evade: evade
evasively: evasively
evening: evening,evenings
evenness: evenness
event: event,events
eventually: eventually
evidence: evidence
exact: exact
exactitude: exactitude
exaggerate: exaggerate,exaggerated,exaggerating
exaggerated: exaggerated
exaggeration: exaggeration
examination: examination,examinations
examine: examine,examined,examining
exceedingly: exceedingly
exception: exception,exceptions
exceptional: exceptional
exceptionally: exceptionally
excessive: excessive
exchange: exchange,exchanged,exchanging
excited: excited
excitement: excitement
exclaim: exclaimed
exclamation: exclamations
exclude: excluded
exclusion: exclusion
exclusive: exclusive
excuse: excuse,excused,excuses,excusing
executioner: executioners
exempt: exempt
exercise: exercise
exertion: exertion,exertions
exhaust: exhausted
exhausted: exhausted
exhort: exhorting
exist: exists
existence: existence
exit: exit
expect: expect,expected,expecting,expects
expectation: expectation
expend: expend,expended
expense: expense,expenses
experience: experience,experienced,experiences
experienced: experienced
expertise: expertise
explain: explain,explained,explaining,explains
explanation: explanation,explanations
explicit: explicit
exploit: exploit,exploited,exploiting
export: exporting
expose: expose,exposed
express: express,expressed
expression: expression,expressions
extend: extended,extending
extent: extent
external: external
extinguish: extinguished
extract: extract,extracted
extraordinarily: extraordinarily
extraordinary: extraordinary
extremely: extremely
eye: eye,eyes
eyebrow: eyebrows
eyesight: eyesight
fabric: fabric
faced: faced
facility: facility
faction: faction,factions
factor: factor
fade: faded
fail: fail,failed
faith: faith
faithful: faithful
fall: fall,fallen,falling,falls,fell
false: false
familiar: familiar
family: families,family
farewell: farewell
farth: farthest
fashioned: fashioned
fast: fast,faster
fasten: fasten,fastened
fastidiously: fastidiously
fat: fat
fate: fate
father: father
fault: fault
favour: favour
favourable: favourable
favourably: favourably
favourite: favourite
fear: fear,feared,fears
fearful: fearful
feature: features
febrile: febrile
federal: federal
fee: fee,fees
feed: feed
feel: feel,feeling,feels
feeling: feeling,feelings
fellow: fellow
fend: fending
fetch: fetch,fetched
field: fields
fight: fight
figure: figure,figures
file: file,files
final: final
finally: finally
financial: financial
finding: finding
fine: fine
finger: finger,fingers
finish: finish,finished
finished: finished
firm: firm,firmer
firmly: firmly
firstly: firstly
fist: fist,fists
fit: fit,fits,fitted
fitness: fitness
fitting: fitting,fittings
fixture: fixtures
flagstone: flagstones
flake: flakes
flame: flame
flap: flap,flapped,flapping
flat: flat,flats
flattery: flattery
flea: fleas
flee: fled
fleshy: fleshy
flick: flicked
flicker: flicker,flickered,flickering
flight: flight
fling: flung
flog: flog,flogged,flogging
floor: floor
flow: flowed,flowing
flower: flower,flowers
fly: flies,flying
flypaper: flypaper
foe: foe
fog: fog
foible: foible
fold: folded,folds
foliage: foliage
follow: follow
fond: fond
foodstuff: foodstuffs
fool: fool,fooling
foot: feet,foot
footed: footed
footstep: footsteps
forbid: forbid,forbidden,forbidding
force: force,forced,forces,forcing
forced: forced
forcefully: forcefully
forcibly: forcibly
forefinger: forefinger
forego: forewent
forehead: forehead
foreign: foreign
foresee: foreseen
foretaste: foretaste
forget: forget,forgets,forgetting,forgot,forgotten
forgetful: forgetful
forgetfulness: forgetfulness
forgivable: forgivable
forgive: forgive,forgiven,forgiving
forgiveness: forgiveness
forgo: forgo
form: form,formed,forming,forms
formal: formal
formality: formalities
formally: formally
format: format,formats
formulate: formulated,formulating
forthcoming: forthcoming
fortunately: fortunately
forwards: forwards
foul: foul
foundation: foundation
fours: fours
fourth: fourth
fragment: fragments
frame: frame
framework: frameworks
frankly: frankly
franz: franz
fraud: fraud
freak: freak
freedom: freedom
freely: freely
french: french
frequent: frequent
frequently: frequently
fresh: fresh,fresher
freshness: freshness
friend: friend,friends
friendliness: friendliness
friendly: friendlier,friendly
friendship: friendship
frighten: frighten,frightened
frightening: frightening
fro: fro
frock: frock
frosted: frosted
frown: frown
fuggy: fuggy
fulfil: fulfil,fulfilled,fulfilling
fun: fun
function: function,functions
functionary: functionaries
fur: fur
furious: furious
furniture: furniture
fuss: fuss
futility: futility
future: future
gain: gain,gaining
gallery: gallery
gangway: gangway
gap: gap,gaps
gas: gas
gate: gate
gateway: gateway
gather: gather,gathered,gathering
gathering: gathering
gaze: gaze
generalise: generalise
generation: generations
gentle: gentle
gentleman: gentleman,gentlemen
gently: gently
genuflect: genuflected
german: german
gesture: gesture,gestured,gestures,gesturing
ghost: ghost
gift: gift,gifts
gilded: gilded
girl: girl,girls
giver: giver
glad: glad
gladly: gladly
glance: glance,glanced,glances,glancing
glass: glass,glasses
glassful: glassful
glaze: glazed
glee: glee
glimmer: glimmer
glimpse: glimpse,glimpsed
glitter: glitter,glittered
gloomy: gloomy
glove: gloves
glower: glowered
goal: goals
goatee: goatee
god: god
goddess: goddess
gold: gold
golden: golden
goodbye: goodbye
gout: gout
govern: govern,governing
gown: gown
grab: grab,grabbed
grade: grades
gradually: gradually
grammar: grammar
gramophone: gramophone
grand: grand
grant: grant,granted
grasp: grasp,grasped
grass: grass
grate: grating
grateful: grateful
gratefully: gratefully
gratitude: gratitude
gravel: gravel
greatly: greatly
greedily: greedily
green: green
greet: greet,greeted,greeting
greeting: greeting
grete: grete
grey: grey
grin: grin,grinned
grip: grip,gripping
groan: groaning
grope: groped
gross: gross
grossly: grossly
ground: ground
grounds: grounds
grow: grew,grow,grown
grumble: grumbled,grumbles
guarantee: guarantee,guaranteed
guard: guard,guarding
guardian: guardian
guess: guess,guessed
guest: guest,guests
guidance: guidance
guide: guide,guided
guilt: guilt
guilty: guilty
gulp: gulp
gush: gush,gushed
habit: habit,habits
haggle: haggled
hair: hair
haired: haired
hairline: hairline
hall: hall
hallway: hallway
halt: halt
hammer: hammers
hand: hand,handed,hands
handbag: handbag
handcart: handcarts
handkerchief: handkerchief,handkerchiefs
handle: handle,handled
handrail: handrail
handshake: handshake
hang: hang,hanging,hung
hangman: hangman
hans: hans
happen: happen,happened,happening
happiness: happiness
happy: happy
harass: harassing
hard: hard,harder,hardest
harden: hardened
harm: harm,harmed
harmless: harmless
harsh: harsher
hart: hart
hat: hat,hats
hatch: hatch
haul: hauled
haunt: haunted
haze: haze
head: head,heads
headache: headache,headaches
health: health
heap: heaped
hear: hear,heard,hearing
hearing: hearing,hearings
heart: heart
hearted: hearted
hearty: hearty
heat: heat
heavily: heavily
heavy: heavier,heavy
heed: heed
heel: heels
hefty: hefty
height: height,heights
helpful: helpful
helpless: helpless
helplessness: helplessness
heroic: heroic
hesitantly: hesitantly
hesitate: hesitate,hesitated
hesitatingly: hesitatingly
hesitation: hesitation
hide: hidden,hide,hiding
hideous: hideous
hiding: hiding
hierarchy: hierarchies
highly: highly
hinder: hindered
hinge: hinges
hint: hint,hinted,hints
hip: hip,hips
hiss: hiss
history: history
hit: hit,hitting
hold: held,hold,holding
holder: holder
hole: hole
holiday: holiday
honest: honest
honesty: honesty
honeypot: honeypot
honour: honour
hook: hook,hooks
hooked: hooked
hope: hope,hoped,hopes,hoping
hopeless: hopeless
horrible: horrible
horse: horse
hot: hot
hour: hour,hours
house: house,houses
huddle: huddled
human: human
humaneness: humaneness
humble: humble,humbling
humbly: humbly
humiliate: humiliate,humiliated,humiliating
humiliating: humiliating
humiliation: humiliation
hunch: hunched
hunchback: hunchback
hunchbacked: hunchbacked
hungry: hungry
hunt: hunt
hurriedly: hurriedly
hurry: hurried,hurry,hurrying
hurt: hurt,hurting
husband: husband
idea: idea,ideas
identifiable: identifiable
identification: identification
identify: identify
identity: identity
ignorant: ignorant
ignore: ignore,ignoring
illness: illness
illuminate: illuminate,illuminated
illusion: illusion
illustration: illustration
imagine: imagine,imagined,imagining
imitate: imitated
immaculate: immaculate
immensely: immensely
immerse: immersed
immobile: immobile
impartial: impartial
impartiality: impartiality
impatience: impatience
impatient: impatient
impatiently: impatiently
impede: impeding
impediment: impediment,impediments
imperfection: imperfections
implore: imploring
imploringly: imploringly
imply: implied,imply
impolite: impolite
importantly: importantly
importunate: importunate
impose: impose,imposed
impossible: impossible
impress: impress
impressed: impressed
impression: impression
impressive: impressive
improper: improper
improve: improve,improved,improving
improvement: improvements
inaccessible: inaccessible
inaccurate: inaccurate
inadequate: inadequate
inappropriate: inappropriate
inattentive: inattentive
incalculable: incalculable
incapable: incapable
incessant: incessant
incident: incident,incidents
incidental: incidental
incidentally: incidentally
incline: inclined,inclining
inclined: inclined
include: include,included,includes,including
including: including
income: income
incomparably: incomparably
incompatible: incompatible
incomplete: incomplete
incomprehensible: incomprehensible
inconsistency: inconsistencies
inconvenient: inconvenient
incorrectly: incorrectly
increase: increased,increasing
indecent: indecent
indecisively: indecisively
indemnify: indemnify
indemnity: indemnity
independent: independent
independently: independently
indict: indicted
indictment: indictment
indifference: indifference
indifferent: indifferent
indirect: indirect
indirectly: indirectly
indisputable: indisputable
indistinct: indistinct
individual: individual,individuals
induce: induce,induced
industrious: industrious
industry: industry
inept: inept
inexplicable: inexplicable
inextinguishable: inextinguishable
infer: infer
inferior: inferior
inflated: inflated
influence: influence,influenced
influential: influential
inform: inform,informed
infrequent: infrequent
infringement: infringement
ing: ing
ingenuously: ingenuously
inherit: inherited
inhumane: inhumane
initial: initial
initiate: initiate
injunction: injunctions
injustice: injustice
ink: ink
inkling: inkling
innocence: innocence
innocent: innocent
inquisitively: inquisitively
inquisitiveness: inquisitiveness
insatiable: insatiable
insight: insight
insinuate: insinuate
insist: insist,insisted,insists
insistent: insistent
inspection: inspection
instance: instance
instant: instant
instantly: instantly
instruct: instructed
instruction: instructions
instrument: instrument
insult: insult,insulting,insults
insulting: insulting
intact: intact
intellectual: intellectual
intend: intend,intended,intending
intent: intent
intention: intention,intentions
intercede: intercede
intercom: intercom
interfere: interfere,interfered,interfering
interment: interment
intermingle: intermingle
internal: internal
international: international
interpret: interpret,interpreted
interpretation: interpretation
interrogation: interrogations
interrupt: interrupt,interrupted,interrupting
interruption: interruption
interval: intervals
intervention: intervention
interview: interview
interwoven: interwoven
intimate: intimate
intimately: intimately
intonation: intonation
introduce: introduce,introduced
introduction: introductions
intrude: intrude
intrusive: intrusive
invalid: invalid
invalidity: invalidity
invent: invented
investigate: investigate,investigating
investigation: investigations
invigorate: invigorating
invisible: invisible
invitation: invitation
invite: invite,invited,invites,inviting
involuntarily: involuntarily
involuntary: involuntary
involve: involve,involved,involves
involved: involved
irksome: irksome
iron: iron
irrefutable: irrefutable
irrelevant: irrelevant
irrevocable: irrevocable
irritated: irritated
irritating: irritating
irritation: irritation
irs: irs
island: island
isolate: isolated
issue: issue,issuing
italian: italian
italy: italy
item: item,items
jabbed: jabbed
jacket: jacket
january: january
jealous: jealous
jest: jest
job: job,jobs
joiner: joiner
joint: joint
joke: joke,joked,joking
jolly: jolly
journey: journey
joy: joy
judge: judge,judged,judges,judging
judgement: judgement
judiciary: judiciary
jump: jump,jumped,jumping
junior: junior
junk: junk
jurisprudence: jurisprudence
justice: justice
justification: justifications
justify: justify
kafka: kafka
karl: karl
keen: keen
kennel: kennel
key: key
keyhole: keyhole
kick: kick
kid: kids
kill: kill,killing
kiss: kiss,kissed
kitchen: kitchen
knee: knee,knees
kneed: kneed
kneel: kneel,kneeling,knelt
knife: knife
knight: knight
knit: knitted
knock: knock,knocked,knocking,knocks
knowledge: knowledge
knuckle: knuckle,knuckles
lace: laced
lack: lacked,lacking
lad: lad,lads
lady: lady
lake: lake
lamp: lamp
land: land
landing: landing
landlady: landlady
landlord: landlord
landscape: landscape,landscapes
language: language
lap: lap,lapping
lassitude: lassitude
late: late
lateness: lateness
latin: latin
laugh: laugh,laughed,laughing,laughs
laughable: laughable
laughter: laughter
law: law,laws
lawyer: lawyer,lawyers
lay: laid,lay,laying
layabout: layabout
laziness: laziness
lazy: lazy
lead: lead,leading,led
leader: leader
leaf: leaves
lean: leaning,leant
leap: leap,leaps,leapt
leapt: leapt
learn: learn,learned,learning,learns
learning: learning
leather: leather
leave: leave,leaving,left
lecture: lecturing
ledge: ledge
left: left
leg: leg,legs
legal: legal
legally: legally
legend: legends
lend: lend
lesson: lesson
lethargically: lethargically
letter: letter,letters
level: level,levelled
liability: liability
liable: liable
liar: liars
liberation: liberation
liberty: liberty
library: library
license: license
licensed: licensed
lie: lain,lie,lied,lies,lying
lieu: lieu
life: life
lifeless: lifeless
lifespan: lifespan
lift: lift,lifted
light: light,lighting,lit
lightly: lightly
liking: liking
limit: limit,limited,limits
limitation: limitation
limited: limited
limp: limp,limped
linen: linen
link: linked,links
lip: lip,lips
liquid: liquid
list: list
listen: listen,listened,listening
listening: listening
literally: literally
literary: literary
litigant: litigants
live: live,lived,lives,living
lively: livelier,lively
living: living
local: local
locate: locate,located
location: locations
lock: lock,locked
lodging: lodging
lodgings: lodgings
lofty: lofty
logic: logic
loose: loose
loosely: loosely
loosen: loosen
lord: lord
lordship: lordship
lose: lose,losing,lost
loss: loss
lot: lot,lots
loud: loud,louder
loudly: loudly
loudness: loudness
lout: louts
love: love,loved,loves
lovely: lovely
lover: lover
lowly: lowliest
luck: luck
lucky: lucky
lump: lump
lure: lure
lurk: lurking
lush: lush
machine: machine
mad: mad
madly: madly
magistrate: magistrate
maid: maid
mail: mail
main: main
maintain: maintain,maintaining,maintains
major: major
majority: majority
malevolent: malevolent
manage: manage,managed
management: management
manager: manager
manner: manner
manners: manners
manufacturer: manufacturer
marble: marble
mark: marked
married: married
marry: married
mary: mary
mass: mass
massive: massive
mat: mat
match: matches
material: material,materials
matter: matter,matters
maximum: maximum
meaning: meaning
mechanical: mechanical
mechanically: mechanically
medicine: medicine
mediocre: mediocre
medium: medium
meet: meet,meeting,met
meeting: meeting,meetings
melt: melted
mental: mental
mention: mention,mentioned,mentioning
merchantability: merchantability
mercy: mercy
mere: mere
mess: mess
message: message
messenger: messengers
metal: metal
metamorphosis: metamorphosis
method: method,methods
michael: michael
midday: midday
middle: middle
military: military
mind: mind
minded: minded
minor: minor
minute: minute,minutes
mirror: mirror
misfortune: misfortune
misjudge: misjudged
misjudgement: misjudgement
mislay: mislaid
mislead: mislead,misleading,misled
misshapen: misshapen
mission: mission
mississippi: mississippi
mistake: mistake,mistakes
mistaken: mistaken
mistakenly: mistakenly
misunderstand: misunderstand,misunderstood
misunderstanding: misunderstanding
mix: mixed,mixes,mixing
mixture: mixture
mock: mocking
modest: modest
modification: modification
modify: modified
moment: moment,moments
money: money
monotonous: monotonous
month: month,months
monument: monument,monuments
mood: mood
moon: moon
moonlight: moonlight
moorland: moorland
morning: morning,mornings
motionless: motionless
motionlessness: motionlessness
moustache: moustache
mouth: mouth
movement: movement,movements
murderous: murderous
muscle: muscle
muster: muster
mute: mute
muttering: muttering
mutual: mutual
mutually: mutually
nail: nail
naked: naked
narrow: narrow
nasty: nasty
natural: natural
naturally: naturally
nature: nature,natures
nave: nave,naves
nearby: nearby
necessity: necessity
neck: neck,necks
needless: needless
neglect: neglect,neglecting
neglectful: neglectful
negligence: negligence
negligent: negligent
negotiate: negotiate,negotiating
negotiation: negotiations
neighbour: neighbouring,neighbours
nephew: nephew
nervous: nervous
nervously: nervously
network: network
news: news
newsletter: newsletter
newspaper: newspaper
nice: nice,nicer
niche: niche
night: night,nights
nightshirt: nightshirt
nod: nod,nodded,nodding
noise: noise
nonproprietary: nonproprietary
nonsense: nonsense
nonsensical: nonsensical
normal: normal
north: north
nose: nose
note: note,notes
notebook: notebook
notice: notice,noticed,notices,noticing
noticeable: noticeable
notification: notification
notify: notified,notifies,notify
nowadays: nowadays
nudge: nudge
nuisance: nuisance
numb: numb
nurse: nurses
oafish: oafish
obedient: obedient
obediently: obediently
obey: obey,obeyed
object: object
objection: objection,objections
objective: objective
obligation: obligation,obligations
obliquely: obliquely
obscure: obscure
observation: observation,observations
observe: observe,observed,observing
obsolete: obsolete
obvious: obvious
occasion: occasion,occasions
occasionally: occasionally
occupy: occupied,occupy,occupying
occur: occur,occurred
odd: odd
oddly: oddly
offence: offence
offend: offending
offended: offended
offensive: offensive
offer: offer,offered,offering,offers
office: office,offices
officer: officer,officers
official: official,officials
officially: officially
oil: oil
ominously: ominously
omniscience: omniscience
oneself: oneself
online: online
onlooker: onlooker
opener: opener
openly: openly
openness: openness
opinion: opinion,opinions
opportune: opportune
opportunity: opportunities,opportunity
oppose: oppose,opposed
oppressive: oppressive
optimistic: optimistic
oration: oration
orator: orator
orderly: orderly
ordinary: ordinary
organ: organ
organisation: organisation
organise: organised,organising
organism: organism
organize: organized
original: original
originally: originally
originator: originator
ostensible: ostensible
ostensibly: ostensibly
ottoman: ottoman
outbreak: outbreak
outburst: outburst
outcome: outcome
outcry: outcry
outdated: outdated
outer: outer
outlive: outlive
outlying: outlying
outrage: outrage
outstretched: outstretched
outweigh: outweighed
overcoat: overcoat
overcome: overcome
overcrowded: overcrowded
overlook: overlook,overlooking
overly: overly
overslept: overslept
owe: owed
owner: owner
pace: pace,paces
pack: pack,packed
package: package
pad: pad
pain: pain
pained: pained
painful: painful
painstaking: painstaking
paint: paint,painted,painting
paintbrush: paintbrush
painter: painter
painting: painting,paintings
pair: pair,pairs
pale: pale
pan: pan
panama: panama
pane: pane
paper: paper,papers
paperwork: paperwork
paragraph: paragraph,paragraphs
pardon: pardon
partially: partially
participant: participants
partly: partly
partner: partners
party: party
pass: pass,passed,passes,passing
passage: passage
passageway: passageway
passing: passing
passive: passive
passivity: passivity
pastel: pastel
pat: pat,patted
path: paths
patience: patience
patient: patient
patiently: patiently
pause: pause,paused
pay: paid,pay,paying
payment: payment,payments
peace: peace
peaceful: peaceful
peacefully: peacefully
peculiar: peculiar
peculiarity: peculiarity
peculiarly: peculiarly
pedantic: pedantic
pen: pen
pencil: pencil
penny: penny
pensively: pensively
pepper: pepper
perceive: perceived
perfect: perfect,perfecting
perfectly: perfectly
perform: perform,performed,performing
performance: performance,performances
perfumed: perfumed
period: period
periodic: periodic
permanent: permanent
permanently: permanently
permission: permission
permit: permit,permitted
persecute: persecuted
persecution: persecution
person: people,person
personal: personal
personally: personally
perspective: perspective
persuade: persuade,persuaded,persuading
petty: petty
pew: pew,pews
phenomenon: phenomenon
philanthropic: philanthropic
phone: phone
photograph: photograph,photographs
phrase: phrase,phrases
physical: physical
piano: piano
pick: pick,picked,picking,picks
picture: picture,pictures
piece: piece,pieces
pierce: pierced
pile: pile,piled
pillow: pillow,pillows
pin: pin
pinafore: pinafores
pinch: pinch,pinching
pipe: pipe
pitiful: pitiful
pity: pity
plain: plain
plan: plan,planned,plans
plank: planks
plant: planted
plate: plate
plausible: plausible
play: play,played,playing
playpen: playpen
plead: plead,pleading
pleasant: pleasant
pleasantly: pleasantly
pleased: pleased
pleasing: pleasing
pleasure: pleasure
plenty: plenty
plump: plump
pocket: pocket,pockets
podium: podium
pointless: pointless
pointlessness: pointlessness
pole: pole
police: police
policeman: policeman,policemen
polite: polite
politely: politely
politeness: politeness
political: political
poor: poor,poorer,poorest
popular: popular
porcelain: porcelain
porter: porter
portrait: portrait,portraits
pose: pose,posed,posing
position: position,positioned,positions
possess: possessed
possession: possession,possessions
possibility: possibilities,possibility
post: post,posted
posture: postures
pot: pot
pour: poured
poverty: poverty
power: power,powers
powerful: powerful
powerless: powerless
practical: practical
practically: practically
practice: practices
practise: practised
praise: praise,praised
prayer: prayer
preach: preach
preacher: preacher
precaution: precaution,precautions
precise: precise
precisely: precisely
precondition: precondition
prefer: prefer,preferred
preliminary: preliminary
preoccupy: preoccupied
preparation: preparation
prepare: prepare,prepared,preparing
prepared: prepared
presence: presence
preservation: preservation
preserve: preserve
president: president
press: press,pressed,pressing
pressed: pressed
pressure: pressure
presume: presume,presumes
presumption: presumptions
presuppose: presupposing
pretence: pretence
pretend: pretend,pretended,pretending
pretty: pretty
prevent: prevent,prevented
previous: previous
price: price
pride: pride
priest: priest
principle: principle
print: print,printed
prison: prison
prisoner: prisoner
private: private
privilege: privilege
probable: probable
procedure: procedure,procedures
proceed: proceed,proceeding
proceedings: proceedings
proceeds: proceeds
process: process,processed
processing: processing
produce: produce,produced
production: production
profession: professions
professional: professional
professor: professor
profit: profits
progress: progress,progressed,progressing
prohibition: prohibition
project: project
prominently: prominently
promise: promise,promised
promising: promising
promote: promoting
promotion: promotion
prompt: prompted
pronouncement: pronouncements
pronunciation: pronunciation
proof: proof,proofs
proofread: proofread
prop: propped
propel: propelled
proper: proper
properly: properly
property: property
proprietary: proprietary
prosecution: prosecutions
prospect: prospect
prospective: prospective
prospects: prospects
protect: protect,protected
protection: protection
protest: protest
prove: proved,proven
provide: provide,providing
provision: provision,provisions
provisionally: provisionally
provoke: provoke,provoked,provoking
pub: pub
public: public
publicly: publicly
pull: pull,pulled,pulling,pulls
pulpit: pulpit
pump: pump
punctual: punctual
punish: punish,punished
punishment: punishment
punitive: punitive
puppy: puppy
purpose: purpose,purposes
purse: purse,pursed,pursing
push: push,pushed,pushing
puzzle: puzzled
quality: quality
quarrel: quarrel
quarry: quarry
query: queries
question: question,questioned,questioning,questions
questionable: questionable
questioning: questioning
questioningly: questioningly
quick: quick,quicker,quickest
quiet: quiet,quieter
quietly: quietly
quietness: quietness
quilt: quilt
quiver: quivered,quivering
quivery: quivery
quizzically: quizzically
radiate: radiated
raff: raff
rage: rage,raging
rail: rail
railing: railing
rain: rain,raining
rainy: rainy
raise: raise,raised,raising
ramification: ramifications
range: range
rank: rank,ranks
rap: rapped
rare: rare
rash: rash
rat: rats
reach: reach,reached,reaches,reaching
read: read,reading
readable: readable
reading: reading
ready: ready
real: real
realisation: realisation
realise: realise,realised
rear: rear
reason: reason,reasons
reasonable: reasonable
reasoned: reasoned
reassure: reassure,reassured,reassuring
reassuring: reassuring
rebel: rebelling
receipt: receipt
receive: receive,received,receives,receiving
receiver: receiver
reception: reception
reckon: reckon
recognise: recognise,recognised
recommendation: recommendation,recommendations
reconcile: reconciled
reconciliation: reconciliation
reconsider: reconsidering
record: record,records
recover: recover
rectangular: rectangular
recurrence: recurrence
red: red
redbeard: redbeard
reddish: reddish
redistribute: redistribute,redistributing
redistributing: redistributing
redistribution: redistribution
reduce: reduce
reference: references
reflection: reflection
reflex: reflex
refresh: refreshing
refund: refund
refuse: refused,refuses
refute: refuted
regard: regard
register: registered
regret: regret,regrets,regretted,regretting
regrettable: regrettable
regular: regular,regulars
regularly: regularly
regulate: regulating
reinforce: reinforced
reinstate: reinstate
reject: reject
rejection: rejection
relation: relations
relationship: relationship,relationships
relax: relaxed
relaxed: relaxed
release: release,released
relevance: relevance
relevant: relevant
relief: relief
relieve: relieved
reluctance: reluctance
rely: rely,relying
remain: remain,remained,remaining,remains
remains: remains
remark: remark,remarked,remarks
remarkable: remarkable
remarkably: remarkably
remedy: remedies
remember: remember,remembered
remind: remind,reminded
remove: remove,removed
rename: renamed
renew: renewed
renown: renown
repair: repaired
repay: repay
repeat: repeat,repeated,repeating
repeatedly: repeatedly
repel: repelling
replace: replace
replacement: replacement
reply: replied,replies,reply
report: report,reported,reporting,reports
represent: represent,represented,representing
representation: representation,representations
representative: representatives
reprimand: reprimanding
reproach: reproach,reproached
reproachful: reproachful
repulsive: repulsive
reputation: reputation
request: request,requested,requests
require: require,required,requires
requirement: requirements
resentment: resentment
resist: resist,resisted
resistance: resistance
resolve: resolved
resound: resounded
resource: resources
respect: respect,respected
respectful: respectful
respects: respects
respond: respond,responded
response: response
responsibility: responsibility
responsible: responsible
rest: rest,rested,resting
restore: restored
restrict: restricted
restriction: restrictions
result: result
retain: retain,retains
retaliation: retaliation
retinue: retinue
retire: retired
retort: retorted
retreat: retreat
return: return,returned,returning,returns
reveal: revealed
revelation: revelations
revenge: revenge
revenue: revenue
reverse: reverse
revolt: revolt
revolting: revolting
reward: rewarded
rich: rich
rid: rid
ride: ride,riding
ridiculous: ridiculous
riff: riff
rightly: rightly
rinse: rinsed
rise: rise,rising,rose
riser: riser
risk: risk
road: road
rob: robbed,robbing
robber: robber
robe: robes
rock: rocked
rod: rod
role: role
roll: rolled
roof: roof
rope: rope
rough: rough
roughly: roughly
route: route
row: row,rows
royalty: royalties,royalty
rub: rubbed,rubbing
rudeness: rudeness
ruffle: ruffled
rule: rule,rules
rumour: rumour,rumours
running: running
rush: rush,rushed
rustling: rustling
sack: sack,sacking
sacrifice: sacrifice,sacrificing
sad: sad
sadly: sadly
safe: safe
sailing: sailing
sailor: sailor
saint: saint
sake: sake
salt: salt
salute: saluted
satisfactorily: satisfactorily
satisfied: satisfied
satisfy: satisfy
saturday: saturday
save: save
scabbard: scabbard
scale: scales
scan: scanned
scarcely: scarcely
scatter: scattered
scene: scene
schnapps: schnapps
school: school
schoolgirl: schoolgirl
schoolmaster: schoolmaster
scientific: scientific
scoundrel: scoundrels
scowl: scowl
scrap: scraps
scratch: scratch,scratching
scream: scream,screamed,screaming,screams
screech: screeching
scribe: scribes
scrutinise: scrutinised
scrutinize: scrutinizing
sculpt: sculpted
scurry: scurry
sea: sea
search: search,searching
seat: seat
secondary: secondary
secret: secret,secrets
secretly: secretly
secure: secure
security: security
seek: seek,seeking,sought
select: selected
sell: sell,selling
send: send,sending
senile: senile
senior: senior
sense: sense
sensibly: sensibly
sensitive: sensitive
sentence: sentence
separate: separate,separated
separately: separately
series: series
sermon: sermon
servant: servant,servants
serve: serve,served,serving
service: service,services
servitor: servitor,servitors
session: session,sessions
set: set,sets
setback: setback
settle: settle,settled
severe: severe
shade: shade,shaded,shading
shadow: shadow
shaft: shaft
shake: shake,shaken,shaking,shook
shame: shame,shamed
shamefully: shamefully
shape: shape
share: share,shared,sharing
sharp: sharp,sharper
sharply: sharply
sharpness: sharpness
shawl: shawl
sheath: sheath
shelf: shelf
shelter: shelter
shine: shine,shines,shining,shone
ship: ship
shirt: shirt
shiver: shiver,shivered,shivering
shock: shock,shocked,shocks
shocked: shocked
shockingly: shockingly
shoot: shot
shop: shop,shops
short: short,shorter
shortcoming: shortcoming,shortcomings
shortly: shortly
shoulder: shoulder,shoulders
shout: shout,shouted,shouting,shouts
shouting: shouting
shove: shove,shoved,shoving
shrug: shrugged
shuffle: shuffled
shuffling: shuffling
shut: shut
shy: shy
sick: sick
sickly: sickly
sickness: sickness
sideways: sideways
sigh: sigh,sighed,sighs
sight: sight,sights
sign: sign,signs
signature: signature,signatures
significance: significance
signify: signifies
silence: silence
silent: silent
silently: silently
silk: silk
sill: sill,sills
silly: silly
silver: silver
similarity: similarity
simple: simple,simplest
simplicity: simplicity
simply: simply
sin: sins
sincerely: sincerely
single: single
sink: sank,sinking,sunk
sir: sir
siren: siren
sister: sisters
sit: sat,sit,sits,sitting
situate: situated
situation: situation
sixth: sixth
size: size,sizes
sized: sized
sketch: sketched
skill: skill
skin: skin
skirt: skirt,skirts
skylight: skylight
slam: slammed
slap: slapped
sleep: sleep,sleeping,sleeps
sleeve: sleeves
slender: slender
slight: slight,slightest
slim: slim
slip: slip,slipped
slow: slow,slower
slowly: slowly
sly: sly
smash: smashed
smell: smell
smile: smile,smiled,smiling
smoke: smoke,smoking
smoking: smoking
smooth: smooth,smoothed,smoothing
smoothly: smoothly
snap: snapped
snatch: snatched
sniff: sniff
snoop: snoop
snow: snow
snowfall: snowfall
snuff: snuff
social: social
society: society
sofa: sofa
soft: soft
solely: solely
solemnity: solemnity
solicit: solicit
solicitation: solicitation
solid: solid
solution: solution
solve: solve
sombre: sombre
son: son
soot: soot
sorely: sorely
sorrow: sorrow
sort: sort,sorted,sorts
soul: soul
sound: sound,sounded,sounding
soup: soup
source: source
south: south
space: space,spaced
span: span
spare: spare,sparing
spasm: spasms
speak: speak,speaking,spoke,spoken
speaker: speaker
special: special
specially: specially
specific: specific
spectacle: spectacle
speech: speech,speeches
speed: speeding
spend: spend,spending,spent
spending: spending
spin: spun
spirit: spirit,spirits
spite: spite
spoil: spoils
spoon: spoon
spot: spot
spread: spread,spreading,spreads
spring: sprang,spring
spy: spy
spyhole: spyhole
squander: squandered
square: square
squashed: squashed
squeeze: squeeze,squeezed,squeezing
squirt: squirted
stab: stabbed
staff: staff
stage: stage,stages
stagger: staggered
stain: stained
stair: stair,stairs
staircase: staircase
stairway: stairway
stairwell: stairwell
stall: stalls
stamp: stamping
stand: stand,standing,stands,stood
standing: standing
stare: stare,stared,staring
start: start,started,starting,starts
startle: startle,startled
startled: startled
statement: statement,statements
statue: statue
status: status
stay: stay,stayed,staying,stays
steal: steal,stolen
steam: steaming
step: step,stepped,stepping,steps
stick: stick,sticking,stuck
stiff: stiff
stiffly: stiffly
stifle: stifled
stipulate: stipulates
stipulation: stipulations
stir: stirred
stock: stock,stocking
stocking: stocking,stockings
stone: stone
stonework: stonework
stool: stool
store: stored
storeroom: storeroom
storm: stormed
stormy: stormy
story: story
stout: stout
stove: stove,stoves
straight: straight
straighten: straightened
strain: strain
strand: strand
strange: strange
stranger: stranger,strangers
stratagem: stratagem,stratagems
straw: straw
street: street,streets
strength: strength
strengthen: strengthen
stress: stress
stretch: stretched,stretching
strict: strict
strictly: strictly
stride: strode
strike: striking,struck
striking: striking
strip: strip
stroke: stroke,stroked,strokes,stroking
strong: strong,stronger
structure: structure
struggle: struggle,struggling
strut: strut
stubborn: stubborn
student: student
studio: studio
study: studied,study,studying
stuffiness: stuffiness
stuffy: stuffy
stumble: stumbled
stupefy: stupefied
stupid: stupid,stupidest
stupidity: stupidity
sturdy: sturdy
style: style
subdued: subdued
subject: subject
subjugate: subjugate
submit: submit,submitted,submitting
subordinate: subordinate
subscribe: subscribe
substantial: substantial
substantiate: substantiated
substitute: substitute
substitution: substitution
suburb: suburb
succeed: succeed,succeeded
success: success,successes
successful: successful
successive: successive
sudden: sudden
suddenly: suddenly
suddenness: suddenness
suffer: suffer,suffered,suffering
suffering: suffering
suffice: suffice
sugar: sugar
suggestion: suggestion,suggestions
suit: suit,suited
suitable: suitable
sum: sum,summed
summer: summer
summon: summon,summoned
summons: summons
sun: sun
sunday: sunday
sundays: sundays
sunset: sunset
superficial: superficial
superfluous: superfluous
superior: superior,superiors
superiority: superiority
superstition: superstition,superstitions
superstitious: superstitious
supervise: supervised
supervisor: supervisor,supervisors
supple: supple
support: support,supported,supporting
suppose: suppose,supposed,supposing
supposedly: supposedly
supposition: supposition
suppress: suppressing
surgeon: surgeon
surprise: surprise,surprised,surprises
surprised: surprised
surprising: surprising
surprisingly: surprisingly
surround: surrounded,surrounding
survive: survive
suspect: suspected
suspension: suspension
suspicion: suspicion,suspicions
suspicious: suspicious
sustain: sustained
swallow: swallowing
swamp: swamp
swang: swang
sway: swaying
swear: swear
sweat: sweat
sweet: sweet,sweets
swiftly: swiftly
swing: swing
swinging: swinging
swirl: swirled
sword: sword
sympathy: sympathy
symptom: symptom
symptomatic: symptomatic
synonymous: synonymous
table: table,tables
tablecloth: tablecloths
tailor: tailored
talent: talent,talents
talk: talk,talked,talking,talks
talkative: talkative
talking: talking
tall: tall,taller
tan: tanned
tangible: tangible
tangle: tangled
tap: tap,tapped,tapping
tartar: tartar
task: task,tasks
taut: taut
tax: tax,taxes
taxi: taxi
tea: tea
teach: teach
teacher: teacher
tear: tear,tearing,tears,torn
telegram: telegram
telephone: telephone,telephones,telephoning
temerity: temerity
temper: temper
temple: temple,temples
temporarily: temporarily
temporary: temporary
tempt: tempted
temptation: temptation
tempting: tempting
tenant: tenant,tenants
tendency: tendency
tender: tender
tenderly: tenderly
tenement: tenement
tenor: tenors
tense: tense
tension: tension
term: term,terms
terrace: terrace
terrible: terrible
theatre: theatre
theme: themes
theory: theory
thief: thief
thieving: thieving
thigh: thigh
thinking: thinking
thirsty: thirsty
thirteen: thirteen
thirtieth: thirtieth
thoughtfully: thoughtfully
thoughtless: thoughtless
thread: thread,threads
threat: threat,threats
threaten: threaten,threatened,threatening
throat: throat
throne: throne
throttle: throttle
throw: threw,throw,throwing,thrown
thrust: thrust
thug: thugs
thumb: thumb,thumbing
thumbing: thumbing
thump: thump,thumped,thumping
thumping: thumping
thunder: thundering
ticket: tickets
tidy: tidied,tidy,tidying
tight: tighter
tightly: tightly
time: time,times
timid: timid
timidly: timidly
tin: tin
tiny: tiniest,tiny
tiptoe: tiptoe
tire: tire,tires
tired: tired
tiredness: tiredness
tireless: tireless
tiring: tiring
title: title
togetherness: togetherness
tolerate: tolerate,tolerated
tomorrow: tomorrow
tone: tone
tong: tongs
tongue: tongue
tooth: teeth
torch: torch
torrent: torrent
torture: torture,tortured
torturer: torturers
total: total
totally: totally
touch: touch,touched,touching
touching: touching
tour: tour
tourist: tourist
town: town
trace: trace
track: track
trade: trade
trademark: trademark
tradesmen: tradesmen
tradition: tradition
train: train
tram: tram
transcribe: transcribe
transcription: transcription
transition: transition
translate: translated
translation: translation
translator: translator
trap: trap,trapped
travel: travelling
treat: treated,treating,treats
treatment: treatment
tree: trees
tremble: trembling
trial: trial,trials
triangle: triangle
triangular: triangular
trick: trick,tricks
trip: trip
trot: trot
trouble: trouble
troublesome: troublesome
trouser: trouser
trousers: trousers
true: true,truer
trundle: trundled
trunk: trunk
trust: trust,trusts
trustee: trustee
trustingly: trustingly
trustworthiness: trustworthiness
truth: truth
tub: tub
tune: tune
twist: twisted,twisting
twitching: twitching
type: types
typist: typist
tyranny: tyranny
ugly: ugly
unabashed: unabashed
unable: unable
unambiguous: unambiguous
unambiguously: unambiguously
unassailable: unassailable
unattainable: unattainable
unavoidable: unavoidable
unaware: unaware
unawares: unawares
unbearable: unbearable
unbutton: unbuttoned
uncertain: uncertain
uncertainty: uncertainty
unchanged: unchanged
unchanging: unchanging
uncle: uncle
unclear: unclear
uncomfortable: uncomfortable
uncomprehending: uncomprehending
unconscious: unconscious
unconsciously: unconsciously
uncontrollable: uncontrollable
uncouth: uncouth
underclothes: underclothes
understand: understand,understanding,understands,understood
understandable: understandable
understanding: understanding
undertake: undertake,undertaken
undertaking: undertaking
undervalue: undervalued
underway: underway
undirected: undirected
undisturbed: undisturbed
undressed: undressed
unease: unease
uneasily: uneasily
uneasy: uneasy
unenforceability: unenforceability
unexpected: unexpected
unexpectedly: unexpectedly
unfaithful: unfaithful
unfamiliar: unfamiliar
unfavourable: unfavourable
unfavourably: unfavourably
unfinished: unfinished
unflattering: unflattering
unfortunate: unfortunate
unframed: unframed
ungenerous: ungenerous
unhappy: unhappy
unhealthy: unhealthy
unheard: unheard
uniform: uniform,uniforms
unimportant: unimportant
unintentionally: unintentionally
unit: unit
united: united
unknown: unknown
unlink: unlink
unlit: unlit
unlock: unlock,unlocked
unlucky: unlucky
unmistakably: unmistakably
unnecessary: unnecessary
unneeded: unneeded
unnoticed: unnoticed
unobjectionable: unobjectionable
unobtrusive: unobtrusive
unpainted: unpainted
unpleasant: unpleasant
unpleasantness: unpleasantness
unpractised: unpractised
unprepared: unprepared
unprincipled: unprincipled
unprotected: unprotected
unrealistic: unrealistic
unselfish: unselfish
unsolicited: unsolicited
unspeaking: unspeaking
unsuitable: unsuitable
unsure: unsure
unsuspecting: unsuspecting
unsuspicious: unsuspicious
untidy: untidy
untried: untried
unusable: unusable
unusual: unusual
unusually: unusually
unwelcome: unwelcome
unwell: unwell
unyielding: unyielding
update: updated
uphold: upheld
upper: upper
upright: upright
upset: upset
upstairs: upstairs
urge: urged,urging
urgency: urgency
urgent: urgent
usable: usable
usage: usage
useless: useless
user: user
usher: usher
usual: usual
ut: ut
utter: utter
vague: vague
vaguely: vaguely
vain: vain
valuable: valuable
vanilla: vanilla
vanish: vanished
varied: varied
variety: variety
vary: varying
vaulting: vaulting
veil: veil
ventilate: ventilated
ventilation: ventilation
verbally: verbally
verdict: verdict
version: version,versions
victory: victory
view: view,viewed,viewing,views
vigilance: vigilance
vigorous: vigorous
vigorously: vigorously
vigour: vigour
vindictive: vindictive
violate: violated,violates,violating
violently: violently
virgin: virgin
virtually: virtually
virus: virus
visible: visible
visibly: visibly
vision: vision
visit: visit,visited,visiting,visits
visitor: visitor,visitors
voice: voice
void: void
volunteer: volunteer,volunteers
vulnerable: vulnerable
wage: wage
wagon: wagons
wail: wail
waistcoat: waistcoat
wait: wait,waited,waiting,waits
waiting: waiting
waitress: waitress
wake: wake,wakes,woken
walk: walk,walked,walking,walks
wall: wall,walls
wallet: wallet
wardrobe: wardrobe
warehouse: warehouse,warehouses
warm: warm
warmth: warmth
warn: warn,warned,warning
warning: warning
warrant: warrant,warrants
warranty: warranties,warranty
wary: wary
wash: wash,washing
washerwoman: washerwoman
washing: washing
waste: waste,wasted,wasting
watch: watch,watched,watches,watching
water: water
wave: wave,waved,waving
wax: wax
weak: weak,weaker
weaken: weaken,weakened
weakened: weakened
weakling: weakling
weakly: weakly
weakness: weakness
wear: wear,wearing,wears,wore,worn
weather: weather
week: week
weekday: weekdays
weigh: weighed
weight: weight
west: west
wet: wet
whatsoever: whatsoever
wheeze: wheezing
whine: whining
whip: whip,whipped
whirl: whirled
whisper: whisper,whispered,whispering
white: white
whitish: whitish
wholly: wholly
wick: wick
wide: wide,widest
widespread: widespread
wife: wife
wild: wild
win: win
wince: wince
window: window,windows
windowed: windowed
windowless: windowless
wine: wine
wing: wings
winter: winter
wipe: wipe,wiped
wit: wits
witch: witch
withdraw: withdraw,withdrawing,withdrawn,withdrew
witness: witness
witted: witted
witty: witty
wizened: wizened
woman: woman,women
wood: wood
wooden: wooden
word: word
workday: workday
worker: worker,workers
workings: workings
workplace: workplace
workshop: workshop
worm: worm
worn: worn
worried: worried
worry: worried,worries,worry,worrying
worth: worth
worthless: worthless
worthwhile: worthwhile
worthy: worthy
wound: wound
wrap: wrap,wrapped
wrench: wrenching
wretched: wretched
wringing: wringing
wrist: wrist
write: write,writes,writing,written,wrote
writer: writer
writing: writing
wrong: wrong
yank: yank,yanked
yard: yard
yeah: yeah
yell: yelled
yellow: yellow,yellowing
yellowish: yellowish
yelp: yelping
yesterday: yesterday
yield: yield
youth: youth,youths
zone: zone
