abandon: abandon,abandoned
abandonedly: abandonedly
abase: abase,abased
abashed: abashed
abate: abated
abhor: abhor,abhorred,abhorring
abide: abide,abided,abiding
ability: abilities,ability
abject: abject
abler: abler
abode: abode
abolish: abolished
abominable: abominable
abound: abound,abounded
abraham: abraham
abridged: abridged
absence: absence
absent: absent
absolute: absolute
absolutely: absolutely
absorb: absorb
abstemious: abstemious
abstinence: abstinence
abstract: abstract
abstruser: abstruser
absurd: absurd
absurdity: absurdity
absurdly: absurdly
abundance: abundance
abundant: abundant
abundantly: abundantly
abuse: abuse
abyss: abyss
academic: academics
academicians: academicians
academics: academics
accent: accents
accept: accept,accepted,accepting
acceptable: acceptable
acceptably: acceptably
access: access,accessed
accessible: accessible
accompany: accompany
accomplice: accomplices
accomplish: accomplish,accomplished
accord: accord
account: account,accounted
accursed: accursed
accuse: accuse,accused,accusing
accuser: accuser
accustomed: accustomed
ache: aches
achieve: achieve
acknowledge: acknowledge,acknowledged
acquaint: acquainted
acquaintance: acquaintance
acquiesce: acquiesce
acquire: acquire,acquired
action: action,actions
active: active
actor: actor,actors
actual: actual
acute: acute
acuteness: acuteness
adam: adam
adapt: adapt,adapted
add: add,adding
addition: addition,additions
additional: additional
address: address,addresses
adeodatus: adeodatus
admirable: admirable
admiration: admiration
admire: admire,admired,admiring
admission: admission
admit: admit,admitted
admonish: admonish,admonished
admonition: admonition
adoption: adoption
adore: adored
adorn: adorned
adorning: adorning
adulterer: adulterer
adulteress: adulteress
adulterous: adulterous
adultery: adultery
advance: advance
advantage: advantage
adversary: adversary
adversity: adversities,adversity
advice: advice,advices
advise: advised,advising
afar: afar
affair: affairs
affect: affect
affection: affection,affections
affiance: affianced
affianced: affianced
affirm: affirm,affirmed,affirming
affliction: affliction
afford: afford
affright: affright,affrighted
affrighted: affrighted
aforesaid: aforesaid
aforetime: aforetime
afraid: afraid
afric: afric
africa: africa
african: african
afternoon: afternoon
afterward: afterward
age: age,ages
aged: aged
agent: agent,agents
aghast: aghast
agonise: agonised
agonistic: agonistic
agony: agony
agree: agree,agreed
agreeable: agreeable
agreement: agreement
aid: aid,aided
ail: ails
aim: aim
air: air
alarm: alarmed
alas: alas
alexandria: alexandria
alike: alike
alive: alive
allay: allay,allaying
allaying: allaying
allege: allege,alleging
allegorically: allegorically
allegory: allegory
allot: allotted
allowance: allowances
alloy: alloy
allurement: allurements
alluring: alluring
almighty: almighty
alms: alms
aloft: aloft
aloud: aloud
altar: altar
alter: altered
alteration: alteration,alterations
alternate: alternate,alternates
alternately: alternately
altogether: altogether
amazed: amazed
amazement: amazement
amazing: amazing
ambition: ambition,ambitions
ambitious: ambitious
ambrose: ambrose
ambrosian: ambrosian
amen: amen
amend: amend
amendment: amendment
amiable: amiable
amiss: amiss
amphitheatre: amphitheatre
ample: ample
ancient: ancient
angel: angel,angels
angels: angels
anger: anger,angered,angers
angry: angry
anguish: anguish
animal: animal,animals
animate: animate
anniversary: anniversary
annoyance: annoyance
annual: annual
anon: anon
answer: answer,answered,answering,answers
answerably: answerably
antecedent: antecedent
anticipate: anticipate,anticipated,anticipating
antidote: antidote
antony: antony
anubis: anubis
anxiety: anxieties,anxiety
anxious: anxious
anxiously: anxiously
apollinarian: apollinarian
apostle: apostle,apostles
apostles: apostles
apostolic: apostolic
apparel: apparel
apparent: apparent
appeal: appeal
appearance: appearance
appetite: appetite
applaud: applauded,applauds
applause: applauses
applicable: applicable
application: application
apply: applied,apply
appoint: appointed,appointing
appointment: appointment,appointments
apportion: apportioned
apprehend: apprehend,apprehended,apprehending
apprehension: apprehension
approach: approach,approached,approaching
approbation: approbation
approve: approve,approved,approving
apt: apt
aptly: aptly
aquatic: aquatic
architect: architect,architects
archive: archive
ardent: ardent
ardently: ardently
argument: argument,arguments
aright: aright
aristotle: aristotle
arithmetic: arithmetic
arm: armed,arms
armed: armed
armory: armory
army: army
arrange: arrange,arranged
array: array
arrival: arrival
arrive: arrive,arrived,arriving
arrogancy: arrogancy
arrogant: arrogant
arrow: arrows
art: art,arts
artifice: artifice,artifices
artificer: artificer
ascend: ascend,ascended,ascending
ascension: ascension
ascertain: ascertained
ascii: ascii
ascribe: ascribe,ascribed
ash: ashes
ashamed: ashamed
asleep: asleep
aspirate: aspirate
assail: assail,assailed
assay: assaying
assembly: assembly
assent: assent,assented,assenting
assessor: assessor
assiduously: assiduously
assign: assign,assigned
assistance: assistance
associate: associate
assuage: assuaged
assume: assume
assurance: assurance
assure: assure,assured,assuring
assuredly: assuredly
astonished: astonished
astonishment: astonishment
astray: astray
astrologer: astrologer,astrologers
asunder: asunder
athenians: athenians
athirst: athirst
atrociously: atrociously
attach: attached
attack: attack,attacked
attain: attain,attained,attaining
attemper: attempered
attempt: attempt,attempted
attend: attended
attendant: attendant
attention: attention
attentive: attentive
attentively: attentively
attest: attested
attract: attracted,attracts
attractiveness: attractiveness
attribute: attributed,attributing
attuned: attuned
audacious: audacious
audaciously: audaciously
audience: audience
auditor: auditor,auditors
aught: aught
augment: augmented,augmenting
augustine: augustine
author: author,authors
authority: authority
avail: avail,availed
avenge: avenged
avenue: avenue,avenues
aver: averred
averse: averse
avert: avert
avoid: avoid,avoided,avoiding
await: awaited,awaiting
awake: awake,awoke
aware: aware
awe: awe
awful: awful
awfulness: awfulness
awhile: awhile
babe: babe,babes
baby: baby
babylon: babylon
babylonian: babylonian
bad: bad,worse
badge: badge
baggage: baggage
bait: bait
ball: ball,balls
balm: balm
balneum: balneum
band: bands
banish: banished
banner: banner
banqueting: banquetings
banter: banter
baptise: baptise,baptised
baptism: baptism
bar: barred
barbarian: barbarian
barbarism: barbarism
bare: bare,bared
bargain: bargain
bark: bark,barked,barking
barren: barren
base: base,based,basest
baseness: baseness
bashfulness: bashfulness
basilica: basilica
basket: basket
bath: bath,bathed,bathing,baths
bathe: bathe
battle: battle
bawler: bawler
beam: beams
bear: bear,bearing,bears,bore,born,borne
bearer: bearer
beast: beast,beasts
beat: beat,beaten,beating
beatific: beatific
beating: beatings
beauteous: beauteous
beautiful: beautiful
beautify: beautified
beauty: beauties,beauty
beck: beck
becloud: beclouded
beclouded: beclouded
becometh: becometh
bed: bed
bedew: bedewed
bedimmed: bedimmed
befall: befalls,befell
befitting: befitting
beg: beg,begged,begging
beget: begat,beget
beggar: beggar
beggary: beggary
begotten: begotten
beguile: beguile,beguiled
beguiling: beguiling
behalf: behalf
behold: beheld,behold,beholding,beholds
beholder: beholder
belief: belief
believer: believer
believeth: believeth
belly: belly
belong: belong,belonging,belongs
beloved: beloved
bemoan: bemoaned,bemoaning
bend: bend,bends,bent
beneath: beneath
benediction: benediction
benefit: benefit,benefits
bereave: bereaved
beseech: beseech
beset: beset,besets
bespeak: bespoken
besprinkle: besprinkle,besprinkling
bestow: bestow,bestowed
betake: betake,betook
bethink: bethink
betroth: betrothed
betters: betters
betwixt: betwixt
bewail: bewail,bewailed,bewailing
beware: beware
bewitch: bewitched
bib: bibbing
bibber: bibber
bible: bible
bid: bade,bid,bidden
bier: bier
billow: billows
binary: binary
bind: bind,bound
bird: bird,birds
birdlime: birdlime
birth: birth,births
birthright: birthright
bishop: bishop
bite: biting
bitter: bitter
bitterly: bitterly
bitterness: bitterness
black: black
blade: blade
blame: blame,blamed
blameless: blameless
blameworthy: blameworthy
blasphemous: blasphemous
blasphemy: blasphemies,blasphemy
blast: blasts
bleeding: bleeding
blend: blending
bless: bless,blessed,blesses
blessed: blessed
blessedly: blessedly
blessedness: blessedness
blessing: blessing,blessings
blest: blest
blind: blind,blinded
blindness: blindness
blissful: blissful
blood: blood
bloody: bloody
bloom: bloom
blot: blotted
blow: blew,blow,blowing
blunt: blunt,blunted
blush: blush,blushed
boast: boast
boastfulness: boastfulness
boasting: boasting
bodily: bodily
body: bodies,body
boil: boil,boiled,boiling,boils
bold: bold
boldly: boldly
boldness: boldness
bond: bond,bonds
bondage: bondage
bone: bones
book: book,books
books: books
bore: bore
borrow: borrow
bosom: bosom
boss: bosses
bottomless: bottomless
bough: boughs
bound: bound,bounded,bounds
boundary: boundary
boundless: boundless
bow: bowed,bowing,bows
bowels: bowels
bower: bowers
boy: boy,boys
boyhood: boyhood
boyish: boyish
brackishness: brackishness
brain: brain
breach: breach
bread: bread
breadth: breadth
break: break,breaking,broke,broken
breaker: breakers
breast: breast,breasts
breath: breath
breathe: breathe,breathed
breathing: breathing
breed: bred
brethren: brethren
briar: briars
bribe: bribe
bridal: bridal
bride: bride,brides
bridegroom: bridegroom
bridle: bridle
brier: briers
bright: bright,brighter
brightness: brightness
brim: brim
bring: bring,bringing,brings,brought
bringeth: bringeth
brittle: brittle
broad: broad
broken: broken
brook: brooks
brother: brother
brotherly: brotherly
brow: brow,brows
brute: brute
bubble: bubbling
buckler: buckler
bud: bud
build: builded,building,built
builder: builder
building: building,buildings
bulk: bulk
bulky: bulky
burden: burden
burial: burial
burn: burn,burned,burning,burnt
burning: burning
burst: burst,bursting
burthen: burthen,burthened
bury: buried,bury
bushel: bushel
business: business
bustle: bustle
busy: busied,busy
butler: butler
buyer: buyers
buzz: buzz,buzzed,buzzing
cabinet: cabinets
caesar: caesar
cake: cakes
calamity: calamities,calamity
calculate: calculate,calculated
calculation: calculation,calculations
calf: calf
calling: calling
calm: calm,calmed
calmly: calmly
calumny: calumnies
camp: camp
candid: candid
candle: candle
cane: cane
canst: canst
canticles: canticles
canvass: canvassing
capable: capable
capacity: capacities,capacity
capital: capital
captain: captain
captious: captious
captive: captive
captivity: captivity
carcase: carcase
card: card
care: care,cared,cares
careful: careful
carefully: carefully
careless: careless
carelessly: carelessly
caress: caresses
carest: carest
carnal: carnal
carry: carried,carry,carrying
carthaginian: carthaginian
cast: cast,casting,casts
caster: casters
catch: catch,catching,caught
catechumen: catechumen
catholic: catholic
catholics: catholics
catiline: catiline
cattle: cattle
cauldron: cauldron
cave: caves
cavern: caverns
cease: cease,ceased,ceases,ceasing
ceasing: ceasing
cedar: cedars
celebrate: celebrated
celebration: celebration
celestial: celestial
celibacy: celibacy
cellar: cellar,cellars
censer: censers
censure: censured
centre: centre
certainty: certainties,certainty
chain: chain,chains
chair: chair
challenge: challenged,challenges
chamber: chamber,chambers
chambering: chambering
chance: chance
change: change,changed,changing
changeable: changeable
changeableness: changeableness
chant: chant,chanting
chapter: chapter
character: character
charge: charge,charges
chariot: chariots
charioteer: charioteer
charitable: charitable
charity: charities,charity
charm: charmed
chaste: chaste
chastely: chastely
chasten: chastened
chastity: chastity
cheap: cheap
check: check,checked,checking,checks
cheek: cheeks
cheer: cheer,cheered
cheerful: cheerful
cheerfulness: cheerfulness
cherish: cherish,cherished
cherubim: cherubim
chest: chest
chew: chewing
chief: chief,chiefest
chiefly: chiefly
child: child,children
childbearing: childbearing
childhood: childhood
childish: childish
chill: chill
chilled: chilled
choice: choice
choke: choked
choler: choler
choleric: choleric
choose: choose,chooses,choosing,chose,chosen
christ: christ
christian: christian,christians
church: church,churches
churches: churches
cicero: cicero
circensian: circensian
circle: circles
circuit: circuit,circuits
circumcise: circumcise
circumlocution: circumlocutions
circumstance: circumstance
circus: circus
citizen: citizen,citizens
city: cities,city
claim: claim
clank: clanking
clasp: clasp
clasped: clasped
class: class
classic: classics
clay: clay
clean: clean
cleanse: cleanse,cleansed
cleansing: cleansing
cleared: cleared
clearness: clearness
cleave: clave,cleave,cleaved,cleaving
climb: climb
cloak: cloak,cloaked
clog: clog
close: close,closed,closes,closing
closed: closed
clothe: clothe,clothed
clothing: clothing
cloud: cloud,clouds
cloudiness: cloudiness
cloudy: cloudy
cloven: cloven
cloy: cloyed
cloyedness: cloyedness
coal: coals
coat: coats
code: codes
coeternal: coeternal
cogitate: cogitated
cogitation: cogitation
cogito: cogito
cold: cold
collect: collect,collected,collects
collection: collection
collectively: collectively
colour: colour,coloured,colours
colouring: colouring
combination: combinations
combine: combine,combined
comely: comely
cometh: cometh
comfort: comfort,comforted,comforting,comforts
comforter: comforter
command: command,commanded,commanding,commands
commander: commander
commandment: commandment,commandments
commemorate: commemorated
commence: commencing
commencement: commencement
commend: commend,commended
commendable: commendable
commender: commender
commercial: commercial
commiserate: commiserate,commiserates,commiserating
commission: commission
commit: commit,commits,committed,committing
committed: committed
common: common
commonly: commonly
communicate: communicate,communicated
communication: communication
community: community
compact: compact,compacting
companion: companion,companions
company: company
compare: compare,compared,comparing
comparison: comparison
compass: compass,compassing
compassion: compassion
compassionate: compassionate
compel: compelled
compendiously: compendiously
compilation: compilation
complain: complain
complaint: complaints
complete: complete,completed
compliance: compliance
comply: comply,complying
compose: compose,composed,composing
compound: compound
comprehend: comprehend,comprehended,comprehending
compress: compressed
comprise: comprise,comprised
conceal: conceal,concealed
conceit: conceit,conceits
conceive: conceive,conceived,conceives,conceiving
concentrate: concentrated
concept: concept
conception: conception,conceptions
concern: concern,concerns
concerned: concerned
concernment: concernment
conclude: conclude,concluded
concord: concord
concubinage: concubinage
concubine: concubine
concupiscence: concupiscence
condemn: condemned,condemning,condemns
condemnation: condemnation
condense: condensed
condition: condition
condole: condole
confer: confer,conferring
conference: conference
confess: confess,confessed,confesses,confessing
confession: confession,confessions
confessions: confessions
confide: confiding
confidence: confidence
confidentially: confidentially
confidently: confidently
confine: confine,confined
confirm: confirm,confirmed
confirmation: confirmation
conflict: conflict,conflicting
conflicting: conflicting
conform: conform,conformed
conformably: conformably
conformity: conformity
confound: confound,confounded
confuse: confused
confused: confused
confusedly: confusedly
confusedness: confusedness
confusion: confusions
confute: confute,confuted
congratulate: congratulated,congratulating
congratulation: congratulation
congregation: congregations
conjecture: conjecture,conjectures,conjecturing
conjoin: conjoined
conjugal: conjugal
connect: connects
conquer: conquer,conquered,conquering
conquest: conquests
conscience: conscience
conscious: conscious
consciousness: consciousness
consecrate: consecrate,consecrated,consecrating
consecration: consecration
consent: consent,consented,consenting
consequence: consequences
consequential: consequential
considerable: considerable
consideration: consideration
consign: consigned
consist: consist,consisting,consists
consistent: consistent
consistently: consistently
consolation: consolation,consolations
conspiracy: conspiracy
conspirator: conspirators
constant: constant
constantly: constantly
constellation: constellations
constitute: constitute,constituted
constrain: constrain,constrained
constraint: constraint
consult: consult,consulted,consulting
consulter: consulter
consulting: consulting
consume: consume,consumed,consuming
consumption: consumption
contact: contact
contagion: contagion
contemn: contemn
contemplate: contemplate,contemplating
contemplation: contemplation
contemporary: contemporary
contempt: contempt
contemptible: contemptible
contend: contend
content: content
contented: contented
contention: contention,contentions
contentious: contentious
contentiousness: contentiousness
contentment: contentment
contents: contents
contest: contests
continence: continence
continency: continency
continent: continent
continently: continently
continual: continual
continually: continually
continuance: continuance
continue: continue,continued
continued: continued
contract: contract,contracted
contradict: contradict,contradicting
contradiction: contradiction,contradictions
contradictory: contradictory
contrary: contrary
contribution: contributions
contrite: contrite
contrition: contrition
controversy: controversy
convenient: convenient
conventicle: conventicle
conventionally: conventionally
conversation: conversation,conversations
converse: converse,conversing
conversion: conversion
convert: convert,converted,converting
convey: convey,conveyed,conveying,conveys
convict: convict,convicted
convince: convinced
convinced: convinced
copious: copious
copying: copying
copyright: copyright
corn: corn
corner: corner,corners
corporation: corporation
corporeal: corporeal
corporeally: corporeally
corpse: corpse
correct: correct,corrected
correction: correction
correspond: corresponded
correspondence: correspondence
corrigible: corrigible
corrupt: corrupt,corrupted,corrupting
corruptible: corruptible
corruption: corruption,corruptions
corruptly: corruptly
cost: cost,costs
cottage: cottage
couch: couch
couldest: couldest
councillor: councillor
counsel: counsel,counselled,counsels
count: count,counted,counts
countenance: countenance
counterfeit: counterfeit
countermanding: countermanding
country: countries,country
countryman: countryman
courage: courage
court: court,courts
courteously: courteously
courtesy: courtesy
courtly: courtly
covenant: covenant
covenanted: covenanted
cover: cover,covered
covetous: covetous
covetousness: covetousness
cower: cower
crafty: craftier,crafty
create: create,created,creating
creation: creation
creator: creator
creature: creature,creatures
credence: credence
credibility: credibility
credit: credit
credulity: credulity
creep: creep,creeping,crept
crime: crime,crimes
crisis: crisis
critical: critical
criticise: criticised,criticising
crooked: crooked
crookedly: crookedly
crookedness: crookedness
cross: cross,crossed,crosses
crown: crown,crowned
crucifixion: crucifixion
crudity: crudities
cruel: cruel
cruelty: cruelty
crying: crying
cubit: cubit,cubits
cud: cud
cultivate: cultivated,cultivating
culture: culture
cunning: cunning
cup: cup
cupboard: cupboards
cupidity: cupidity
curb: curb
cure: cure,cured,curing
curiosity: curiosities,curiosity
curious: curious
curiously: curiously
current: current,currents
curtailment: curtailment
custom: custom,customs
cut: cut,cutting
cyprian: cyprian
daemon: daemon,daemons
daily: daily
damage: damage
damaged: damaged
damages: damages
damnable: damnable
danae: danae
danger: danger,dangers
dangerous: dangerous
dark: dark,darkest
darken: darkened
darkly: darkly
darkness: darkness
darksome: darksome
dash: dashed
dashed: dashed
datum: data
daughter: daughter,daughters
david: david
dawn: dawn,dawned
day: day,days
dead: dead
deadly: deadly
deaf: deaf
deafen: deafen
deafness: deafness
deal: deal,dealt
death: death,deaths
debase: debasing
debate: debated
debt: debts
debtor: debtor,debtors
decay: decay,decays
deceased: deceased
deceit: deceit,deceits
deceitful: deceitful
deceivableness: deceivableness
deceive: deceive,deceived,deceiving
deceiver: deceivers
deception: deception
decide: decide,decided
deck: decked
declaim: declaiming
declamation: declamation
declare: declare,declared
decline: decline
decree: decree
decrepit: decrepit
dedicate: dedicate,dedicated
deductible: deductible
deed: deed,deeds
deem: deem,deemed
deep: deep,deeper,deepest,deeps
deeply: deeply
deepness: deepness
defect: defect,defects
defection: defection
defective: defective
defence: defence
defend: defended,defending,defends
defender: defender
defer: deferred,deferring,defers
defile: defile,defiled
defilement: defilements
define: define,defined,defining
definite: definite
deform: deformed
deformity: deformities,deformity
degrade: degraded
degree: degree,degrees
deity: deity
dejectedness: dejectedness
delay: delay,delayed
deletion: deletions
deliberate: deliberate,deliberates,deliberating
deliberation: deliberation
delight: delight,delighted,delighting,delights
delighted: delighted
delightful: delightful
delightfulness: delightfulness
delightsome: delightsome
deliver: deliver,delivered,delivering,delivers
delude: deluded,deluding
delusion: delusions
demand: demand,demanded,demanding,demands
demander: demander
demonstrate: demonstrate,demonstrated
den: dens
denote: denoted,denotes
deny: denied,denies,deny
depart: depart,departed,departing
departure: departure
depend: depend,depending,depends
depraved: depraved
deprive: deprived
depth: depth
depths: depths
deride: deride,derided,derides,deriding
derider: deriders
derision: derision
derivative: derivative
derive: derive,derived
descend: descend,descending
descendant: descendants
descent: descent
desert: deserted,deserts
deserter: deserters
deserve: deserve,deserved
deserved: deserved
deservedly: deservedly
deserving: deserving,deservings
design: designs
desire: desire,desired,desires,desiring
desirous: desirous
despair: despair,despaired
despaired: despaired
despairing: despairing
desperate: desperate
despise: despise,despised,despising
despising: despising
destine: destined
destroy: destroy,destroying
destroyer: destroyers
destruction: destruction
detach: detach,detached
detain: detain
detect: detected
determine: determine,determined
detest: detest,detested,detesting
detriment: detriment
deus: deus
devil: devil,devils
devilish: devilish
devise: devised
devoted: devoted
devotion: devotion
devotions: devotions
devour: devour,devoured
devout: devout
devoutly: devoutly
devoutness: devoutness
dew: dew
dialogue: dialogue
diddest: diddest
dido: dido
didst: didst
die: die,died,dies,dying
difference: difference
difficult: difficult
difficulty: difficulties,difficulty
diffuse: diffused
dig: dug
digest: digest,digested
digit: digits
dignity: dignities,dignity
diligence: diligence
diligent: diligent
diligently: diligently
dilute: diluted
dimension: dimensions
diminish: diminish,diminished,diminishing
diminution: diminution
din: din
dining: dining
dinner: dinner
direct: direct,directed,directing
direction: direction,directions
director: director
disagree: disagreeing
disagreement: disagreements
disallow: disallowing
disappear: disappear
disapprove: disapproved
discern: discern,discerned
discerning: discerning
discharge: discharge
disciple: disciple,disciples
discipline: discipline
disclaim: disclaim
disclaimer: disclaimer,disclaimers
disclose: disclose,disclosed
discomfort: discomfort
discontent: discontent
discontinue: discontinue
discord: discord
discordant: discordant
discourage: discourage
discourse: discourse,discoursed,discourses,discoursing
discoursing: discoursing
discover: discover,discovered,discovering,discovers
discoverable: discoverable
discovery: discovery
discreet: discreet
discreetly: discreetly
discretion: discretion
discuss: discuss,discussed
discussion: discussion
disdain: disdained
disease: disease,diseases
diseased: diseased
disembowel: disembowelled
disengage: disengage
disentangle: disentangle,disentangled
disgrace: disgraced
disgraceful: disgraceful
disguise: disguise,disguised,disguising
disgust: disgust
disgusted: disgusted
dish: dishes
dishonour: dishonour
disk: disk
dislike: disliked
dismiss: dismiss
disobey: disobeyed
disorder: disorder,disorders
disordered: disordered
dispel: dispel
dispense: dispense,dispensed,dispensing
dispenser: dispenser,dispensers
dispersed: dispersed
dispersion: dispersion
displace: displace
displacing: displacing
display: display,displayed,displaying
displease: displease,displeased,displeasing
displeased: displeased
dispose: dispose,disposed
disposer: disposer
disposition: disposition
dispraise: dispraise,dispraised
disprove: disprove
dispute: dispute,disputed,disputes,disputing
disputer: disputer
disquiet: disquiet,disquieted
disquieted: disquieted
disregard: disregard
dissent: dissent
dissipate: dissipated
dissipation: dissipation
dissoluteness: dissoluteness
dissolution: dissolution
dissolve: dissolved
distance: distance,distances
distant: distant
distemper: distempered
distempered: distempered
distended: distended
distil: distilled
distill: distill
distinct: distinct
distinction: distinction
distinctly: distinctly
distinguish: distinguish,distinguished,distinguishing
distract: distract,distracted
distracted: distracted
distractedly: distractedly
distracting: distracting
distraction: distraction,distractions
distress: distress
distribute: distribute,distributed,distributing
distribution: distribution
distributor: distributor
distrust: distrusted
disturb: disturb,disturbed
disturbed: disturbed
dive: dive
diver: divers
diverse: diverse
diversely: diversely
diversity: diversity
diversly: diversly
divide: divide,divided,dividing
divination: divination,divinations
divine: divine
diving: diving
divinity: divinity
division: division,divisions
docile: docile
doctrine: doctrine
doer: doer
doest: doest
dog: dog
doings: doings
doleful: doleful
domain: domain
domestic: domestic
domine: domine
dominion: dominion
dominions: dominions
donate: donate
donation: donation,donations
donor: donors
door: door,doors
dormant: dormant
dost: dost
dotage: dotages
dotard: dotards
dote: doted,doting
doth: doth
double: double,doubled
doubt: doubt,doubted,doubting,doubts
doubtfulness: doubtfulness
doubtless: doubtless
downfall: downfall
download: downloading
downward: downward
drag: dragging
dragon: dragon,dragons
draught: draught
draw: draw,drawing,drawn,draws,drew
dread: dread,dreaded,dreading
dreadful: dreadful
dream: dream,dreams
drench: drenched
drink: drank,drink,drinking,drunk
drinking: drinking
drive: drive,driven,drives,drove
drop: drop,drops
drowsiness: drowsiness
drowsy: drowsy
drudgery: drudgery
drunk: drunk
drunkard: drunkard,drunkards
drunken: drunken
drunkenness: drunkenness
dry: dried,dry
dryness: dryness
duad: duad
dull: dull,duller
dully: dully
dumb: dumb
durst: durst
dust: dust
dutiful: dutiful
duty: duties,duty
dwell: dwell,dwelling,dwelt
dweller: dwellers
dwelling: dwelling
dwelt: dwelt
eager: eager
eagerly: eagerly
eagerness: eagerness
eagle: eagle
ear: ear,ears
earnest: earnest
earnestly: earnestly
earnestness: earnestness
earth: earth
earthly: earthly
ease: ease,eased
easeful: easeful
easily: easily
east: east
eastern: eastern
easy: easier,easy
eat: eat,eaten,eating
eating: eating
ebb: ebb,ebbing,ebbs
ecclesiastical: ecclesiastical
echo: echo,echoed,echoes
eclipse: eclipsed,eclipses
edge: edged
edification: edification
edify: edify
edition: edition,editions
educate: educate,educated
education: education
educational: educational
edward: edward
efface: effaced,effaces
effort: effort,efforts
egypt: egypt
egyptian: egyptian
eighth: eighth
eld: elder
elder: elder,elders
elect: elect
electronic: electronic
electronically: electronically
element: element,elements
elephant: elephant
elevated: elevated
elevation: elevation
eligible: eligible
elijah: elijah
eloquence: eloquence
eloquent: eloquent
eloquently: eloquently
elude: eluding
email: email
embalm: embalmed
embarrassment: embarrassments
embittered: embittered
emblem: emblem
embrace: embrace,embraced,embraces
embracement: embracement
embryo: embryo
emerge: emerge,emerging
eminence: eminence
eminent: eminent
eminently: eminently
emotion: emotion,emotions
emperor: emperor
empire: empire
employ: employ,employed
employee: employee,employees
empress: empress
emptiness: emptiness
enable: enabled
enact: enact,enacted
enamoured: enamoured
enchantment: enchantment
encompass: encompass
encourage: encouraging
encumber: encumbered
encumbrance: encumbrances
endanger: endangers
endear: endeared
endearment: endearments
endeavour: endeavour,endeavoured,endeavouring
endlessly: endlessly
endue: endued
endurance: endurance
endure: endure,endured,endures,enduring
enemy: enemies,enemy
energy: energy
enervate: enervated
enforce: enforced
enforcement: enforcement
engage: engage,engaged,engages
engine: engine
english: english
engraff: engraff
enigma: enigma
enjoin: enjoin,enjoined
enjoy: enjoy,enjoyed,enjoying
enlarge: enlarge,enlarged,enlarging
enlighten: enlighten,enlightened,enlightening,enlightens
enlightened: enlightened
enlightener: enlightener
enlist: enlisted
enmity: enmities,enmity
enounce: enounce
enquire: enquire,enquired,enquiring
enquiry: enquiries,enquiry
enricher: enricher
ensample: ensample
enslave: enslaved
ensnare: ensnared,ensnaring
ensue: ensues,ensuing
ensure: ensuring
entangle: entangle,entangled,entangling
entangled: entangled
enter: enter,entered,entering,enters
enthral: enthralled
entice: enticed
enticement: enticements
enticing: enticing
entire: entire
entireness: entireness
entitle: entitled
entity: entity
entrails: entrails
entrance: entrance
entreat: entreat,entreated
entreaty: entreaties
entrust: entrust,entrusted
entwine: entwine
enumeration: enumeration
envenom: envenomed
envious: envious
environing: environing
envy: envy,envying
envying: envying
episcopal: episcopal
epistles: epistles
equably: equably
equal: equal,equalled,equals
equally: equally
equinox: equinoxes
equipment: equipment
equity: equity
ere: ere
ergo: ergo
err: err,erred
error: error,errors
erst: erst
esau: esau
escape: escape,escaped
espouse: espoused
essay: essay,essayed
essence: essence
establish: establish,established
estate: estate
esteem: esteem,esteemed,esteeming
esteemed: esteemed
estimation: estimation
estrange: estranged
eternal: eternal
eternally: eternally
eternity: eternity
eunuch: eunuchs
evangelists: evangelists
evaporate: evaporates
eve: eve
evening: evening
event: events
everlasting: everlasting
everlastingly: everlastingly
evidence: evidence
evident: evident
evidently: evidently
evil: evil,evils
evince: evincing
exact: exact,exacted,exacting
exalt: exalted
exaltedness: exaltedness
examine: examine,examined,examining
examiner: examiner
exceed: exceeded,exceeding
exceedingly: exceedingly
excel: excel,excelled,excelling,excels
excellence: excellence
excellency: excellencies,excellency
excellent: excellent
excellently: excellently
exception: exceptions
excess: excess
excessive: excessive
exchange: exchanged
excite: excited,excites
excitement: excitement
exclaim: exclaim
exclude: exclude,excluded
exclusion: exclusion
excursive: excursive
excuse: excuse,excused,excuses
execrable: execrable
execrate: execrate
execute: execute
exempt: exempt
exercise: exercise,exercised
exhalation: exhalation
exhaust: exhausted
exhausted: exhausted
exhibit: exhibit,exhibited
exhort: exhort,exhorted,exhorting
exhortation: exhortation,exhortations
exigency: exigency
exile: exiled
exist: exist,existing,exists
existence: existence
exodus: exodus
expansive: expansive
expect: expect,expected,expects
expectation: expectation
expend: expend
expense: expense,expenses
experience: experience,experienced
experienced: experienced
experiment: experiments
explain: explain,explained,explaining
explanation: explanation
export: exporting
expose: expose,exposed
expound: expound,expounded,expounding
express: express,expressed
expression: expression,expressions
exquisitely: exquisitely
extend: extended
extended: extended
extension: extension
extent: extent
exterior: exterior
external: external
extinguish: extinguish,extinguished
extol: extol,extolled
extoller: extollers
extract: extracted
extreme: extreme,extremest
extremely: extremely
extremest: extremest
extricate: extricate,extricated
exuberance: exuberance
exuberant: exuberant
exude: exude
exult: exult
exultation: exultation
eye: eye,eyes
eyesight: eyesight
fable: fable,fables
fabric: fabric
fabulous: fabulous
facility: facility
faculty: faculties,faculty
fail: fail,failing
failure: failure
fain: fain
faint: faint,fainting
faintly: faintly
fair: fair,fairer,fairest
fairness: fairness
faith: faith
faithful: faithful
faithfully: faithfully
faithfulness: faithfulness
fall: fall,fallen,falling,falls,fell
fallacy: fallacies
false: false
falsehood: falsehood,falsehoods
falsely: falsely
falsify: falsified
fame: fame
familiar: familiar
familiarise: familiarised
familiarly: familiarly
family: family
famine: famine
famished: famished
famous: famous
fan: fanned
fancy: fancies,fancy
fantastic: fantastic
fantasy: fantasies
fare: fared
farness: farness
fashion: fashion,fashioned
fast: fast,faster
fastidiousness: fastidiousness
fasting: fasting,fastings
fat: fat
father: father,fathers
fatherless: fatherless
fatherly: fatherly
fatigue: fatigues
fatness: fatness
fault: fault,faults
faultfinder: faultfinders
faulty: faulty
favour: favour,favoured,favours
fear: fear,feared,fearing,fears
fearful: fearful
fearfully: fearfully
fearlessly: fearlessly
feast: feast
fed: fed
federal: federal
fee: fee,fees
feed: fed,feed,feeding,feeds
feeding: feeding
feel: feel,feeling,feels
feeling: feeling,feelings
feign: feigned
feigned: feigned
felicity: felicity
fellow: fellow,fellows
female: female,females
fence: fence
fervent: fervent
fervently: fervently
fervid: fervid
festival: festival
fetch: fetched
fetter: fettered,fetters
fever: fever
feverishness: feverishness
fiction: fiction,fictions
field: field,fields
fierce: fiercest
fiercely: fiercely
fig: fig
fight: fight,fighting,fought
fighter: fighter
figurative: figurative
figuratively: figuratively
figure: figure,figured,figures
figured: figured
file: file,files
filth: filth,filths
filthy: filthy
finally: finally
financial: financial
finding: finding
fine: fine,finest
finger: finger,fingers
finish: finish,finished
finite: finite
firm: firm
firmament: firmament
firmly: firmly
firmness: firmness
fish: fish,fishes
fit: fit,fitted,fitter,fittest,fitting
fitness: fitness
fitting: fitting
fixedly: fixedly
flagitiousness: flagitiousness
flagon: flagon
flame: flame
flash: flash,flashes,flashing
flattering: flattering
fledged: fledged
flee: fled,flee,fleeing
fleeting: fleeting
flesh: flesh
fleshly: fleshly
fleshy: fleshy
flight: flights
fling: fling,flung
float: floating
flock: flock,flocks
flood: flood,floods
flour: flour
flourish: flourished
flow: flow,flowed,flowing,flows
flower: flower,flowers
fluctuate: fluctuate,fluctuates,fluctuating
fluctuation: fluctuations
fluently: fluently
fluidness: fluidness
flux: flux
fly: flew,flies,flown,fly,flying
foam: foamed
fog: fog
fold: folded
folk: folk,folks
follow: follow
follower: followers
followeth: followeth
folly: follies,folly
foment: foment,fomenting
food: food
fool: fool,fools
foolish: foolish
foolishly: foolishly
foolishness: foolishness
foot: feet,foot
footed: footed
footstep: footsteps
forasmuch: forasmuch
forbare: forbare
forbear: forbear
forbid: forbade,forbid,forbidden
force: force,forced
forcibly: forcibly
fore: fore
forefather: forefathers
forego: forego,foregoing
forehead: forehead
foreign: foreign
foreigner: foreigner
foreknowledge: foreknowledge
foremention: forementioned
forename: forenamed
forenoon: forenoon,forenoons
forepassed: forepassed
foresee: foresaw,foresee
foreshow: foreshow,foreshowed
foreshower: foreshower
foresignify: foresignify
forest: forests
foretell: foretell,foretelling,foretold
forethink: forethink,forethinking
forethinking: forethinking
forethought: forethought
forge: forge,forging
forget: forget,forgetting,forgot,forgotten
forgetful: forgetful
forgetfulness: forgetfulness
forgive: forgave,forgive,forgiven,forgiving
form: form,formed,forming,forms
format: format,formats
formation: formation
formless: formless
formlessness: formlessness
fornicate: fornicating
fornication: fornication,fornications
forsake: forsake,forsaken,forsaking,forsook
forsooth: forsooth
forthcoming: forthcoming
forthwith: forthwith
fortunate: fortunate
fortune: fortunes
forum: forum
forwards: forwards
foster: foster,fostering
foul: foul,fouls
foully: foully
foulness: foulness
foundation: foundation,foundations
fountain: fountain
fourth: fourth
fourthly: fourthly
fowl: fowl,fowls
fragment: fragment,fragments
fragrance: fragrance
fragrant: fragrant
frailness: frailness
frame: frame,framed
framer: framers
frantic: frantic
fraud: fraud
fraught: fraught
freak: freaks
freedom: freedom
freely: freely
freeman: freeman
frenzied: frenzied
frenzy: frenzies,frenzy
frequent: frequent
frequently: frequently
fresh: fresh
freshness: freshness
fret: fretted
friend: friend,friends
friendship: friendship
frightful: frightful
fro: fro
frozen: frozen
fruit: fruit,fruits
fruitful: fruitful
fruitfully: fruitfully
fruitfulness: fruitfulness
fruitless: fruitless
fruitlessly: fruitlessly
fuel: fuel
fugitive: fugitives
fulfil: fulfil,fulfilled,fulfils
fulness: fulness
fume: fumed,fumes
function: functions
funeral: funeral
furious: furious
furnace: furnace
furnish: furnish,furnished
furnishing: furnishing
furtherance: furtherance
fury: fury
future: future
gain: gain,gained,gaining,gains
gainful: gainful
gainsay: gainsay
gainsayer: gainsayer,gainsayers
gainst: gainst
galatian: galatians
gale: gales
gall: gall
gallantry: gallantry
game: game,games
garb: garb
garden: garden,gardens
garland: garland,garlands
garment: garment
garner: garner
gasp: gasped
gate: gate,gates
gather: gather,gathered,gathering,gathers
gathering: gathering
gay: gay
gaze: gaze,gazing
gazer: gazers
generate: generate
generation: generation,generations
genesis: genesis
genius: genius
gentile: gentiles
gentiles: gentiles
gentle: gentle
gentleness: gentleness
gently: gently
genuinely: genuinely
geometry: geometry
gesture: gestures
ghastly: ghastly
ghost: ghost,ghosts
giant: giant
gift: gift,gifted,gifts
gifted: gifted
gilded: gilded
gird: girded
girl: girl,girls
giver: giver,givers
giveth: giveth
glad: glad
gladden: gladdened,gladdens
gladiator: gladiators
gladly: gladly
gladness: gladness
gladsome: gladsome
glance: glance,glances
glass: glass
gleam: gleam,gleams
glide: glide,glided,gliding
glitter: glittering
glorify: glorified,glorifies,glorify
glorious: glorious
glory: gloried,glories,glory,glorying
glow: glow,glowed,glows
glowing: glowing
glue: glue
gnash: gnashed
gnaw: gnawed,gnawing
goad: goad,goaded,goads
goading: goading
goal: goals
god: god,gods
godhead: godhead
godless: godless
godly: godly
gods: gods
gold: gold
golden: golden
goodliness: goodliness
goodly: goodly
goodness: goodness
gorgeous: gorgeous
gospel: gospel
govern: govern,governed
government: government
governor: governor,governors
gown: gowned
grace: grace
graceful: graceful
gracefulness: gracefulness
gracious: gracious
gradation: gradation
gradually: gradually
grammar: grammar
grammarian: grammarian,grammarians
grandchild: grandchildren
grant: grant,granted
grasp: grasp,grasps
grass: grass
grassy: grassy
gratefully: gratefully
gratias: gratias
gratification: gratification
grating: gratings
gratuitous: gratuitous
gratuitously: gratuitously
grave: grave
gravity: gravity
greatly: greatly
greatness: greatness
greave: greaves
grecian: grecian
greedily: greedily
greediness: greediness
greedy: greedy
greek: greek,greeks
green: green
greet: greet,greeted
grief: grief,griefs
grieve: grieve,grieved,grieves
grieving: grieving
grievous: grievous
grievously: grievously
groan: groan,groaned,groaning,groans
groaning: groaning
groat: groat
gross: gross
grossness: grossness
ground: ground,grounded
grounds: grounds
grove: groves
grow: grew,grow,growing,grown
grown: grown
growth: growth
guard: guarded
guardian: guardian
guardianship: guardianship
guess: guess,guessed
guidance: guidance,guidances
guide: guide
guilt: guilt
guiltless: guiltless
guilty: guilty
gulf: gulf
gush: gushed
habit: habit,habits
habitation: habitation
hadst: hadst
hail: hail
hair: hair,hairs
hale: hale,haled
hallow: hallow
hallowed: hallowed
hallowing: hallowing
halve: halved
hand: hand,hands
handkerchief: handkerchief
handle: handled,handling
handmaid: handmaid
handwriting: handwriting
hang: hang,hanging,hung
hap: hap
haphazard: haphazard
hapless: hapless
haply: haply
happen: happen,happened
happily: happily
happiness: happiness
happy: happier,happy
harass: harass
harbour: harbour,harbouring
hard: hard,harder
hardheartedness: hardheartedness
hardship: hardship
hare: hare
hark: hark
harlotry: harlotries
harm: harm,harmed
harmless: harmless
harmonious: harmonious
harmoniously: harmoniously
harmonise: harmonise,harmonising
harmonize: harmonizing
harmonized: harmonized
harmony: harmony
harsh: harsh
hart: hart,harts
harvest: harvest
hast: hast,hasting
haste: haste
hasten: hasten,hastened,hastening
hatchet: hatchet
hate: hate,hated
hateful: hateful
hatred: hatred
haughtiness: haughtiness
haunt: haunt
hay: hay
head: head,heads
headlong: headlong
heal: heal,healed,healing
healing: healing
health: health
healthful: healthful
healthfully: healthfully
healthy: healthy
heap: heaped,heaps
hear: hear,heard,hearing,hears
hearer: hearer,hearers
hearing: hearing
hearken: hearken
hearsay: hearsay
heart: heart,hearts
hearted: hearted
heartedness: heartedness
heat: heat,heated
heathen: heathen
heaven: heaven,heavens
heavenly: heavenly
heavens: heavens
heavily: heavily
heavy: heavier,heavy
hebrew: hebrew
hedge: hedged
heed: heed,heeded
height: height,heights
heighten: heightening
heinous: heinous
hellish: hellish
helmet: helmet
helper: helper
helpful: helpful
henceforth: henceforth
herb: herb,herbs
hereat: hereat
hereditary: hereditary
hereof: hereof
hereon: hereon
heresy: heresies,heresy
heretic: heretics
heretics: heretics
heretofore: heretofore
hereunto: hereunto
hesitate: hesitate,hesitated,hesitating
hesitation: hesitation
hidden: hidden
hide: hidden,hide
hideous: hideous
highly: highly
highness: highness
hill: hills
hinder: hinder,hindered
hindrance: hindrance
hint: hint
hippo: hippo
hippocrates: hippocrates
history: history
hitherto: hitherto
hoar: hoar
hog: hogs
hold: held,hold,holding,holds
holden: holden
holder: holder
holding: holding
holily: holily
holiness: holiness
holy: holies,holy
homer: homer
honest: honest
honestly: honestly
honesty: honesty
honey: honey
honied: honied
honour: honour,honoured,honouring,honours
honourable: honourable
hook: hook,hooks
hope: hope,hoped,hopes,hoping
hopeful: hopeful
horn: horns
horrible: horrible
horror: horror
horse: horse,horses
host: host,hosts
hosts: hosts
hot: hot
hotly: hotly
hour: hour,hours
house: house,houses
household: household
houseless: houseless
hover: hovered
howsoever: howsoever
hug: hugging
huge: huge
human: human
humane: humane
humanity: humanity
humble: humble,humbled
humility: humility
hunger: hunger,hungered,hungering
hungering: hungering
hungry: hungry
hunt: hunting
hurried: hurried
hurriedly: hurriedly
hurry: hurried,hurrying
hurt: hurt,hurting
hurtful: hurtful
husband: husband,husbands
hush: hushed
husk: husks
hymn: hymn,hymns
hymns: hymns
ice: ice
idea: ideas
identification: identification
identify: identify
idle: idle
idleness: idleness
idly: idly
idol: idol,idols
ignoble: ignoble
ignorance: ignorance
ignorant: ignorant
iii: iii
illuminate: illuminate,illuminating
illumine: illumined
illusion: illusion
image: image,images
imaginary: imaginary
imagination: imagination,imaginations
imagine: imagine,imagined,imagining
imbibe: imbibe,imbibed
imbue: imbue
imitate: imitate,imitated,imitating
imitation: imitation
immense: immense
immerse: immersed
immoderate: immoderate
immortal: immortal
immortality: immortality
immortally: immortally
immovably: immovably
immutable: immutable
impair: impair,impaired
impart: impart,imparted,imparts
impatience: impatience
impatient: impatient
impatiently: impatiently
imperfect: imperfect
imperfection: imperfection,imperfections
imperishable: imperishable
imperturbable: imperturbable
impiety: impiety
impious: impious
implant: implanted,implanting
imply: implied,imply
importunity: importunity
impose: imposed
impostor: impostors
impotent: impotent
impregnable: impregnable
impress: impress,impressed,impressing
impressed: impressed
impression: impression,impressions
imprint: imprinted
improperly: improperly
impudently: impudently
impulse: impulses
impunity: impunity
impure: impure
impurity: impurity
impute: impute
inaccessible: inaccessible
inaccurate: inaccurate
inactive: inactive
inanimate: inanimate
inappropriately: inappropriately
incarnation: incarnation
incense: incense,incensed
inchoate: inchoate
incidental: incidental
inclination: inclination
incline: incline,inclined
include: include,included,includes,including
including: including
incommutable: incommutable
incomparably: incomparably
incomplete: incomplete
incomprehensible: incomprehensible
incongruously: incongruously
incorporeal: incorporeal
incorrect: incorrect
incorruptible: incorruptible
incorruptibly: incorruptibly
incorruption: incorruption
increase: increase,increased,increasing
incredible: incredible
incredibly: incredibly
incumbrance: incumbrances
incur: incurred
incurable: incurable
indebted: indebted
indefinitely: indefinitely
indemnify: indemnify
indemnity: indemnity
indenture: indentures
indication: indications
indigent: indigent
indigested: indigested
indignant: indignant
indirect: indirect
indirectly: indirectly
indite: indite,indited
individual: individual
indue: indued
indulgent: indulgent
inebriate: inebriate
inebriated: inebriated
inebriation: inebriation
inevitable: inevitable
inevitably: inevitably
inexperienced: inexperienced
inexpressible: inexpressible
infancy: infancy
infant: infant,infants
infantine: infantine
infected: infected
infection: infection
infer: infer
inferior: inferior
infidel: infidels
infidelity: infidelity
infinite: infinite
infinitely: infinitely
infinitude: infinitude
infirmity: infirmities,infirmity
inflame: inflame,inflamed
inflammation: inflammation
inflection: inflection
inflict: inflicted
influence: influence,influenced,influences
inform: informed,informing
infringement: infringement
infuse: infuse,infused
ingraft: ingrafted
inhabit: inhabited
inhabitant: inhabitant,inhabitants
inharmonious: inharmonious
inheritance: inheritance
iniquity: iniquities,iniquity
initiate: initiated,initiating
initiation: initiation
initiatory: initiatory
injurable: injurable
injure: injure,injured,injures
injurious: injurious
injury: injury
injustice: injustice
inmost: inmost
innate: innate
innocence: innocence
innocency: innocency
innocent: innocent
innumerable: innumerable
innumerably: innumerably
inordinate: inordinate
insatiable: insatiable
insatiate: insatiate
insensibly: insensibly
inseparable: inseparable
insert: inserted
insight: insight
insolently: insolently
insomuch: insomuch
inspect: inspect,inspecting
inspiration: inspiration
inspire: inspire,inspired,inspiring
instability: instability
instance: instance,instances
instant: instant
instantly: instantly
instinct: instinct
instinctive: instinctive
institute: instituted
institution: institution
instruct: instruct,instructed
instruction: instruction
instructor: instructor
insult: insult
insultingly: insultingly
intellectual: intellectual
intelligence: intelligence,intelligences
intelligent: intelligent
intelligible: intelligible
intemperance: intemperance
intend: intend,intended
intense: intense,intensest
intensely: intensely
intenseness: intenseness
intent: intent
intention: intention
intently: intently
intercede: intercede
intercept: intercepting
intercession: intercession
intercourse: intercourse
interior: interior
intermission: intermission
intermit: intermit,intermitted,intermitting
internal: internal
international: international
interpose: interpose,interposed,interposing
interpret: interpret,interpreted,interpreting
interpretation: interpretation
interpreter: interpreter
interrupt: interrupt
interrupted: interrupted
interruption: interruption
interval: interval,intervals
intimacy: intimacy
intimate: intimate,intimated
intimately: intimately
intolerable: intolerable
intoxicate: intoxicated
intoxicated: intoxicated
intricate: intricate
introduce: introduced
intrude: intrude
inured: inured
invalidity: invalidity
inveigler: inveigler
invest: invest,invests
invisible: invisible
invite: invite,invited,inviting
involve: involved
inwardly: inwardly
iron: iron,irons
irrational: irrational
irresoluteness: irresoluteness
irrevocable: irrevocable
irritate: irritate
irs: irs
isaac: isaac
isaiah: isaiah
israel: israel
issue: issue,issued
italian: italian
italy: italy
itch: itch
itching: itching
iv: iv
ix: ix
jacob: jacob
jarring: jarring
jealous: jealous
jealousy: jealousy
jeer: jeer
jeering: jeering
jerusalem: jerusalem
jest: jest,jests
jesus: jesus
jew: jew
jews: jews
joint: joint
jointly: jointly
joke: joking
jordan: jordan
joseph: joseph
journey: journey,journeyed
jove: jove
joy: joy,joyed,joying,joys
joyed: joyed
joyful: joyful
joyfulness: joyfulness
joying: joying
joyous: joyous
joyously: joyously
joyousness: joyousness
judge: judge,judged,judges,judging
judgement: judgements
judging: judging
judgment: judgment,judgments
julian: julian
juncture: juncture
juno: juno
jupiter: jupiter
justice: justice
justification: justification
justify: justify
justina: justina
justly: justly
keen: keen
keeper: keeper
keeping: keeping
ken: ken
kick: kicking
kill: kill,killed
kindle: kindle,kindled
kindly: kindly
kindness: kindness
kindred: kindred
king: king,kings
kingdom: kingdom,kingdoms
knee: knee,knees
knit: knit
knitting: knitting
knock: knock,knocked,knocking,knocks
knot: knots
knottiness: knottiness
knotty: knotty
knoweth: knoweth
knowingly: knowingly
knowledge: knowledge
labour: labour,laboured,labours
labourer: labourers
lack: lack,lacking
lacking: lacking
laden: laden
lake: lake
lament: lament,lamented
lamentable: lamentable
lancet: lancet
land: land,lands
language: language,languages
languish: languishing
lanthorn: lanthorn
lap: lap
largeness: largeness
lash: lashed,lashes
lastly: lastly
late: late
lathe: lathe
latin: latin
latins: latins
lattice: lattice
laugh: laugh,laughed
laughter: laughter
launch: launched
law: law,laws
lawful: lawful
lawfully: lawfully
lawless: lawless
lawyer: lawyer
laxly: laxly
lay: laid,lay,laying,lays
lead: lead,leading,leads,led
leaden: leaden
leadeth: leadeth
leaf: leaves
lean: leaning
leap: leaps
learn: learn,learned,learning,learnt
learner: learner
learning: learning
lease: leasing
leasing: leasing
leave: leave,leaves,leaving,left
leaven: leaven
lecture: lecture,lectured
legal: legal
legally: legally
leisure: leisure
lend: lends
lengthen: lengthened
lessen: lessen
lesson: lesson,lessons
lethargy: lethargy
letter: letter,letters
lewd: lewd
liability: liability
liable: liable
liar: liar
liberal: liberal
liberality: liberality
liberty: liberty
library: library
licence: licence
license: license
licensed: licensed
lick: lick
lie: lie,lied,lies,lying
lieu: lieu
life: life,lives
lift: lift,lifted,lifts
lifter: lifter
light: light,lighted,lights
lighten: lighten,lightened
lightly: lightly
lightsome: lightsome
likeness: likeness,likenesses
lily: lilies
limb: limbs
lime: limed
limit: limited,limits
limitation: limitation
limited: limited
lineage: lineage
lineament: lineaments
linger: linger,lingered,lingering
link: linked,links
lion: lion
lip: lip,lips
list: list,lists
listen: listened,listening
literally: literally
literary: literary
literature: literature
litigation: litigation
liv: livest
live: live,lived,lives,living
livelihood: livelihood
lively: lively
liveth: liveth
living: living
lizard: lizard
lo: lo
load: load,loads
loathe: loathed
loathing: loathing
loathsome: loathsome
locate: located
location: locations
lock: locking
locust: locusts
lodging: lodging
lofty: lofty
logic: logic
longing: longing,longings
looker: looker
loose: loose,loosed
loosen: loosen
loosest: loosest
loquacity: loquacity
lord: lord,lords
lose: lose,loses,losing,lost
loss: loss
lost: lost
lot: lot
loth: loth
lottery: lottery
loud: loud
loudly: loudly
love: love,loved,loves,loving
loveliness: loveliness
lovely: lovely
lover: lover,lovers
loving: loving
lovingly: lovingly
lowlily: lowlily
lowliness: lowliness
lowly: lowly
lucid: lucid
lucre: lucre
ludicrous: ludicrous
lull: lulled
luminary: luminaries
lump: lump
lung: lungs
lure: lure,lures
lust: lust,lusted,lusting,lusts
lustful: lustful
lustfulness: lustfulness
luxuriousness: luxuriousness
luxury: luxury
macedonia: macedonia
machine: machine
mad: mad
madly: madly
madness: madness
magical: magical
magistrate: magistrates
magnify: magnified,magnify
magnitude: magnitudes
maid: maid
maiden: maiden,maidens
maim: maimed
maimed: maimed
main: main
maintain: maintain,maintained,maintaining
maintainer: maintainers
majesty: majesty
maker: maker,makers
male: male
malice: malice
malicious: malicious
maliciously: maliciously
malignant: malignant
mammon: mammon
manager: manager
manfully: manfully
mangled: mangled
manhood: manhood
manichaean: manichaean
manichee: manichee
manifest: manifest,manifested
manifestation: manifestation
manifestly: manifestly
manifold: manifold
manifoldly: manifoldly
manifoldness: manifoldness
mankind: mankind
manna: manna
manner: manner
manners: manners
manor: manors
mansion: mansion
mantle: mantles
manufacture: manufactures
march: march
mariner: mariners
mark: mark,marked,marking,marks
market: market
marriage: marriage
marriageable: marriageable
married: married
marrow: marrow
marry: married,marry
marrying: marrying
mars: mars
mart: marts
martyr: martyr,martyrs
marvel: marvel,marvelled
mary: mary
masculine: masculine
mass: mass,masses
master: master,mastered,masters
mastery: mastery
material: material,materials
mathematicians: mathematicians
matron: matrons
matter: matter,matters
mature: maturing
maximum: maximum
mayest: mayest
maze: mazes
meaning: meaning,meanings
meanly: meanly
measurable: measurable
measure: measure,measured,measures,measuring
measuring: measuring
meat: meat,meats
meddle: meddle
meddling: meddling
medea: medea
mediator: mediator
medicine: medicine,medicines
medicining: medicining
meditate: meditate,meditated,meditating
meditation: meditations
medium: medium
meek: meek
meekness: meekness
meet: meet,meeting,meets,met
melodious: melodious
melody: melodies,melody
melt: melt,melted
memory: memory
mentally: mentally
mention: mention,mentioned,mentioning
merchantability: merchantability
merciful: merciful
mercifully: mercifully
mercy: mercies,mercy
mere: mere
merged: merged
merit: merits
merrily: merrily
merry: merry
messenger: messengers
method: method,methods
metre: metre,metres
michael: michael
middle: middle
mightily: mightily
mightiness: mightiness
mighty: mightier,mighty
milan: milan
milanese: milanese
mild: milder
mildly: mildly
milk: milk
milky: milky
mimic: mimic
mind: mind,minds
minded: minded
mindful: mindful
minerva: minerva
mingle: mingle,mingled,mingling
minister: minister,ministers
ministry: ministry
minute: minute,minutest
miracle: miracles
mire: mire
mirth: mirth
mirthful: mirthful
mischief: mischief
misdeed: misdeeds
miserable: miserable
miserably: miserably
misery: miseries,misery
mislike: mislike,misliked
mission: mission
mississippi: mississippi
mist: mist,mists
mistaken: mistaken
mistress: mistress,mistresses
mixture: mixture
moan: moan
mock: mock,mocked,mocking
mocker: mockers
mockery: mockeries,mockery
mode: mode,modes
model: models
moderate: moderate
moderation: moderation
modestly: modestly
modesty: modesty
modification: modification
modify: modified
modulation: modulation
moist: moist
molest: molest
molten: molten
moment: moment,moments
momentary: momentary
momentous: momentous
monad: monad
monastery: monasteries,monastery
money: money
monk: monk
monster: monster
monstrous: monstrous
monstrousness: monstrousness
month: month,months
monument: monument
moon: moon
moral: moral
morning: morning
morrow: morrow
morsel: morsel
mortal: mortal,mortals
mortality: mortality
mortify: mortified
moses: moses
mother: mother,mothers
motherly: motherly
motion: motion,motions
motive: motive
mould: mould,moulded
moulded: moulded
mount: mounting
mountain: mountain,mountains
mourn: mourn,mourned,mourning
mourner: mourners
mournful: mournful
mourning: mourning
mouth: mouth,mouthed,mouths
muddy: muddy
mule: mule
multiplicity: multiplicity
multiply: multiplied,multiply,multiplying
multitude: multitude,multitudes
murder: murder,murdered,murdering
murmur: murmur,murmured
muse: musing
music: music
musical: musical
mutability: mutability
mutable: mutable
mute: mute
mutter: muttering
muttering: muttering
mutual: mutual
mutually: mutually
mysterious: mysterious
mysteriously: mysteriously
mystery: mysteries,mystery
mystic: mystic
mystically: mystically
nail: nails
naked: naked
narrow: narrow,narrower
narrowly: narrowly
narrowness: narrowness
nation: nation,nations
native: native
nativity: nativity
natural: natural
naturally: naturally
nature: nature,natures
nearer: nearer
neatly: neatly
neatness: neatness
necessaries: necessaries
necessity: necessities,necessity
neck: neck
needful: needful
needy: needy
neglect: neglect,neglected,neglecting
negligence: negligence
negligent: negligent
neighbour: neighbour,neighbouring,neighbours
neptune: neptune
nest: nest,nests
network: network
newsletter: newsletter
nigh: nigh
night: night,nights
nill: nill,nilled
nimble: nimble
nineteenth: nineteenth
ninth: ninth
noah: noah
nobility: nobility
noble: noble
nod: nod
noise: noise
nonproprietary: nonproprietary
noon: noon
north: north
nostril: nostrils
note: note,notes
notice: notice,notices
notify: notifies
notion: notion,notions
notorious: notorious
nought: nought
nourish: nourish,nourished,nourishing
nourishment: nourishment,nourishments
novelty: novelty
novice: novice
numberless: numberless
numerous: numerous
nurse: nurse,nurses
nursery: nursery
nut: nuts
obedience: obedience
obedient: obedient
obediently: obediently
obey: obey,obeyed,obeying,obeys
object: object,objected,objects
objection: objections
oblation: oblation
obscure: obscure
obscurely: obscurely
observance: observance
observation: observation
observe: observe,observed,observes,observing
obsolete: obsolete
obstinacy: obstinacy
occasion: occasion,occasioned
occupy: occupy,occupying
occur: occur,occurred,occurs
ocean: ocean
odour: odour,odours
offence: offence,offences
offend: offend,offended
offensive: offensive
offer: offer,offered,offers
offering: offerings
office: office,offices
officer: officer,officers
official: official
offspring: offspring
oft: oft
oftentimes: oftentimes
ofttimes: ofttimes
oil: oil
ointment: ointments
omened: omened
omit: omit
omnipotency: omnipotency
omnipotent: omnipotent
omnium: omnium
online: online
openest: openest
openly: openly
operation: operations
opinion: opinion,opinions
opinionative: opinionative
opportunity: opportunities,opportunity
oppose: oppose,opposed,opposing
opposed: opposed
oppressed: oppressed
oppression: oppression
oracle: oracle,oracles
orally: orally
orations: orations
orator: orator
oratory: oratory
orb: orbs
ordain: ordained
ordainer: ordainer
orderer: orderer
ordinance: ordinance
ordinarily: ordinarily
ordinary: ordinary
orestes: orestes
organ: organs
organize: organized
origin: origin
original: original
originator: originator
ornament: ornamenting
ostentation: ostentation
ostia: ostia
otherwhere: otherwhere
otherwhile: otherwhiles
ourself: ourself
outdated: outdated
outer: outer
outrage: outrages
outset: outset
outward: outward
outwardly: outwardly
overboldness: overboldness
overcast: overcast
overcharge: overcharged
overcloud: overclouded
overcome: overcame,overcome,overcoming
overflow: overflow,overflowed,overflowing
overflowing: overflowing
overhastily: overhastily
overjoyed: overjoyed
overpass: overpass
overpast: overpast
overspread: overspread
overspreading: overspreading
overtake: overtake
overthrow: overthrew,overthrow
overturn: overturned
overwhelm: overwhelmed
overwhelmed: overwhelmed
owe: owe,owed,owes
owner: owner
pain: pain,pains
painful: painful
pair: pair,pairs
palace: palace,palaces
palate: palate
pale: pale
palm: palm
pamperedness: pamperedness
pander: pander
panegyric: panegyric
pang: pangs
pant: pant,panted
panting: panting
paper: paper
paperwork: paperwork
par: par
paraclete: paraclete
paradise: paradise
paragraph: paragraph,paragraphs
parched: parched
pardon: pardoned
pare: pared
parent: parent,parents
parental: parental
parity: parity
parley: parley
partake: partake
partaker: partaker
participation: participation
particle: particle,particles
partly: partly
partner: partners
party: parties,party
pass: pass,passed,passes,passing
passage: passage,passages
passenger: passengers
passible: passible
passing: passing
passion: passion,passions
passionately: passionately
pastime: pastime,pastimes
patched: patched
path: path,paths
patience: patience
patiently: patiently
pattern: pattern,patterns
paul: paul
paulus: paulus
pause: pause,pauses
pay: paid,pay,paying
payment: payments
peace: peace
peaceful: peaceful
peacefully: peacefully
peacemaker: peacemaker
pear: pear,pears
pearl: pearl
peculiar: peculiar
peculiarly: peculiarly
pen: pen
penal: penal
penally: penally
penalty: penalties,penalty
pence: pence
penetrate: penetrating
penitent: penitent
peradventure: peradventure
perceivable: perceivable
perceive: perceive,perceived,perceives,perceiving
perchance: perchance
perdition: perdition
perfect: perfect,perfected,perfecting
perfecting: perfecting
perfection: perfection
perfectly: perfectly
perform: perform,performed,performing
performance: performances
peril: peril,perils
perilous: perilous
period: period,periods
periodic: periodic
perish: perish,perished
perishable: perishable
permanent: permanent
permission: permission
permit: permit,permitted
pernicious: pernicious
perpetual: perpetual
perplex: perplexed
perplexed: perplexed
perplexity: perplexities
persecute: persecuted,persecutes,persecuting
persevere: persevering
person: people,person,persons
personage: personages
personally: personally
personated: personated
perspicuous: perspicuous
persuade: persuade,persuaded
persuasion: persuasions
persuasive: persuasive
pertain: pertain,pertained,pertaining
perturbation: perturbations
peruse: perused
perverse: perverse
perverseness: perverseness
perversion: perversion
perversity: perversity
pervert: pervert,perverted,perverting
perverted: perverted
pervertedly: pervertedly
pervious: pervious
pestilent: pestilent
petition: petitions
petty: petty
petulantly: petulantly
phantasm: phantasm,phantasms
phantom: phantom,phantoms
philippians: philippians
philosopher: philosophers
philosophy: philosophy
phrase: phrase,phrases
physic: physic
physical: physical
physician: physician,physicians
picture: picture,pictures
piece: piece,pieces
piecemeal: piecemeal
pierce: pierce,pierced,piercing
piety: piety
pile: pile,piled
pilgrim: pilgrim,pilgrims
pilgrimage: pilgrimage
pinch: pinching
pine: pines
pious: pious
piously: piously
pit: pit
pitch: pitch
pitiable: pitiable
pitiful: pitiful
pity: pitied,pity
pitying: pitying
plague: plague
plain: plain,plainer,plains
plainly: plainly
plainness: plainness
plan: plan
planet: planets
plant: plant,plants
plausibility: plausibility
play: play,playing,plays
plea: plea
plead: plead
pleasant: pleasant,pleasanter
pleasantly: pleasantly
pleasantness: pleasantness
pleased: pleased
pleasing: pleasing
pleasurable: pleasurable
pleasure: pleasure,pleasures
plenary: plenary
plenteous: plenteous
plenteousness: plenteousness
plentiful: plentiful
plentifully: plentifully
plenty: plenty
pliant: pliant
plot: plot,plots,plotting
pluck: pluck,plucked,plucking
plunge: plunged,plunging
plural: plural
poem: poems
poesy: poesy
poet: poet,poets
poetic: poetic
poise: poise
poison: poison
pole: pole
polished: polished
pollute: polluted
pollution: pollution
poor: poor
popular: popular
popularity: popularity
portion: portion,portions
position: position
possess: possess,possessed,possesses
possession: possession
possessor: possessor
possibility: possibility
post: posted
potent: potent
potter: potter
pour: pour,poured
poverty: poverty
power: power,powers
powerful: powerful
powers: powers
practically: practically
practice: practice
practise: practise,practised
practised: practised
praetorian: praetorian
praise: praise,praised,praises
prate: prated,prating
prater: praters
prating: prating
pray: pray,prayed,praying
prayer: prayer,prayers
preach: preach,preached,preaching
preacher: preacher,preachers
preaching: preachings
precede: precede,preceded,precedes
precept: precepts
precious: precious
precipice: precipice
precipitate: precipitated
precisely: precisely
predestinate: predestinated
predestination: predestination
predicament: predicament,predicaments
predicate: predicated
predict: predict,predicted
preeminence: preeminence
preeminent: preeminent
prefect: prefect
prefer: prefer,preferred,preferring
preferable: preferable
preference: preference
prejudice: prejudice
prelate: prelate
prepare: prepare,prepared,prepares,preparing
prerogative: prerogative
presbyter: presbyters
prescribe: prescribed,prescribes
prescript: prescripts
presence: presence
presently: presently
preserve: preserve,preserved,preserving
preside: presides,presiding
presidentship: presidentship
press: press,pressed
pressure: pressure
presume: presume,presumed,presuming
presumption: presumption
pretend: pretend
prevail: prevail,prevailed,prevailing,prevails
prevent: prevent,prevented,preventing
previous: previous
prey: prey
price: price,prices
prick: pricked,pricks
pride: pride
priest: priest
primary: primary
primitive: primitive
prince: prince,princes
principalities: principalities
principally: principally
principle: principles
print: print,printed
prior: prior
prison: prison
prisoner: prisoner
privacy: privacy
private: private
privately: privately
privation: privation
privily: privily
prize: prize,prizes
probable: probable
proceed: proceed,proceeded,proceeding
proceeding: proceeding
processing: processing
proclaim: proclaim,proclaiming
proconsul: proconsul
proconsular: proconsular
procure: procure,procured
prodigality: prodigality
produce: produce,produced
production: production
profane: profane
profess: profess,professed,professing
profession: profession
professor: professor
professorship: professorship
proffer: proffer,proffering
proficiency: proficiency
profit: profit,profited,profits
profitable: profitable
profligate: profligate
profound: profound,profounder
profoundly: profoundly
progress: progress
prohibition: prohibition
project: project
prolix: prolix
prolong: prolonged
prominently: prominently
promise: promise,promised,promises
promising: promising
promote: promoting
promotion: promotion
pronounce: pronounce,pronounced,pronounces,pronouncing
pronounced: pronounced
pronouncing: pronouncing
pronunciation: pronunciation
proof: proof
proofread: proofread
prop: prop
proper: proper
properly: properly
property: property
prophecy: prophecy
prophet: prophet,prophets
proportion: proportion,proportions
propose: proposed
propound: propound
proprietary: proprietary
prose: prose
prosper: prosper
prosperity: prosperities,prosperity
protect: protect,protected
protection: protection
protest: protest,protesting
protract: protracted
protraction: protraction
prouder: prouder
proudly: proudly
prove: prove,proved
provide: provide,providing
providence: providence
province: province
provincial: provincial
provision: provision,provisions
provoke: provoke
prudent: prudent
prune: prunes
pryer: pryers
psalm: psalm
psalmody: psalmody
psalms: psalms
psalter: psalter
psaltery: psaltery
public: public
publicly: publicly
puff: puffed
pulse: pulse
punish: punish,punished
punishable: punishable
punishment: punishment,punishments
punitive: punitive
pupil: pupils
puppy: puppies
purchase: purchase,purchased,purchasing
pure: pure,purer,purest
purely: purely
purge: purged
purify: purified
purity: purity
purpose: purpose,purposed,purposes,purposing
pursue: pursue,pursued,pursues,pursuing
pursuit: pursuits
putrefied: putrefied
pylades: pylades
qualify: qualified
quality: qualities
quarrel: quarrel,quarrels
quarter: quarter
queen: queen
quench: quench
quest: quest
question: question,questioned,questioning,questions
questioning: questionings
quick: quick,quicker
quicken: quicken,quickened
quickness: quickness
quiet: quiet,quieter
quit: quit,quitting
quoth: quoth
race: race,races
rack: racked,racks
rage: rage,raged,raging
rais: rais
raise: raise,raised,raises,raising
random: random
range: range,ranged
rank: rank,ranked
ransom: ransom
rapture: rapture
rare: rare
rash: rash
rashly: rashly
rashness: rashness
rational: rational
raven: raven
ravish: ravish
reach: reach,reached,reaching
read: read,reading,reads
readable: readable
reader: reader,readers
readier: readier
readiness: readiness
reading: reading
ready: ready
real: real
realise: realised
reality: realities,reality
reap: reap
reason: reason,reasons
reasonable: reasonable
reasoning: reasoning,reasonings
reawaken: reawakened
rebel: rebel,rebelled
rebellious: rebellious
rebuke: rebuke,rebuked
recall: recall,recalled,recalling,recalls
receipt: receipt
receive: receive,received,receives,receiving
receptacle: receptacle
recess: recess,recesses
recite: recite,recited
reckon: reckon,reckoned,reckons
reckoning: reckoning
reclaim: reclaim,reclaiming
recognise: recognise,recognised,recognising
recollect: recollect,recollected,recollecting
recollection: recollection
recommend: recommend,recommended,recommending
reconcile: reconcile,reconciled
reconcilement: reconcilement
reconciliation: reconciliation
recondite: recondite
record: record,recorded
recount: recount,recounts
recourse: recourse
recover: recover,recovered,recovering
recovered: recovered
recovery: recovery
recruit: recruiting
recruiting: recruiting
rectify: rectify
recur: recur,recurring
redeem: redeem,redeemed
redeemer: redeemer
redemption: redemption
redistribute: redistribute,redistributing
redistributing: redistributing
redistribution: redistribution
redouble: redoubling
refer: refer,referred
reference: reference,references
reflect: reflect
reform: reform,reformed
refrain: refrain,refrained,refraining
refresh: refresh,refreshed,refreshing
refreshment: refreshment
refuge: refuge
refund: refund
refuse: refuse,refused,refusing
refute: refute
regard: regard,regarded
regenerate: regenerated
regeneration: regeneration
region: region,regions
register: registered
regular: regular
regulate: regulate,regulating
rehearse: rehearse
reign: reigning,reigns
rein: rein,reins
reinvolve: reinvolved
reject: reject,rejected,rejects
rejection: rejection
rejoice: rejoice,rejoiced,rejoices,rejoicing
rejoicing: rejoicing
relapse: relapse
relate: relate,relating
relater: relater
relation: relation,relations
relationship: relationship
relative: relative
relator: relators
relax: relaxing
relaxation: relaxation
relaxedly: relaxedly
release: release,released
relic: relics
relief: relief
relieve: relieve
religion: religion
religious: religious
religiously: religiously
rely: relied
remain: remain,remained,remaining,remains
remainder: remainder
remarkable: remarkable
remedy: remedies
remember: remember,remembered,remembering,remembers
remembered: remembered
remembering: remembering
remembrance: remembrance,remembrances
remind: reminded
remission: remission
remit: remitted
remnant: remnants
remorse: remorse
removal: removal
remove: remove,removed
rename: renamed
rend: rend
render: render
renew: renew,renewed,renewing
renounce: renounce
renowned: renowned
rent: rent
repair: repair
repay: repay
repeat: repeat,repeated,repeating
repel: repel,repelled
repent: repent
repentance: repentance
replace: replace,replacing
replacement: replacement
replenish: replenish,replenished,replenishing
reply: replied,replies,reply
report: report,reported,reports
reporter: reporters
repose: repose,reposed,reposes,reposing
represent: represent
representation: representations
repress: repress
reproach: reproach
reproachful: reproachful
reproof: reproof
reprove: reproved,reproves
reptile: reptiles
reputation: reputation
repute: repute
reputed: reputed
request: request
require: require,required,requiring
requirement: requirements
requital: requital
requite: requited
rescue: rescue,rescued,rescuing
resemble: resemble,resembling
resent: resent
reside: reside
resign: resigned
resist: resist,resisted,resisting
resistance: resistance
resolute: resolute
resolutely: resolutely
resolution: resolution
resolve: resolved
respect: respect,respected
respective: respective
respects: respects
respite: respite
rest: rest,rested,resting
resting: resting
restless: restless
restlessly: restlessly
restlessness: restlessness
restoration: restoration
restore: restore,restored,restoring
restrain: restrain,restrained,restraining,restrains
restraint: restraint
restrict: restricted
restriction: restrictions
result: result
resume: resumed,resumes
resurrection: resurrection
retain: retain,retained
retard: retard
retire: retire,retired,retiring
retreat: retreat
return: return,returned,returning,returns
reveal: reveal,revealed,revealing
revelation: revelation,revelations
revenge: revenge,revenged,revenges
revenue: revenue
reverence: reverence
reverential: reverential
reverently: reverently
review: review,reviewing
revile: reviled
revive: revive
revolt: revolt,revolting
revolting: revolting
revolve: revolved,revolving
revolving: revolving
reward: reward,rewards
rhetoric: rhetoric
rich: rich,richer
riches: riches
riddle: riddle
ridiculous: ridiculous
righteous: righteous
righteousness: righteousness
rightful: rightful
rightly: rightly
rigidly: rigidly
rigorous: rigorous
rioting: rioting
riotous: riotous
ripe: riper
ripen: ripened
riper: riper
rise: rise,risen,rising,rose
risk: risk
rite: rites
river: rivers
rivet: riveted
roar: roared
rob: rob
robber: robber
robbery: robbery
robe: robing
robert: robert
rock: rocks
rod: rods
roll: roll,rolled,rolling
rolling: rolling
roman: roman
rome: rome
rood: rood
root: root
rottenness: rottenness
rough: rough
rouse: rouse,roused
rove: rove
roving: roving,rovings
royalty: royalties,royalty
rude: rude
rudely: rudely
rudiment: rudiments
rugged: rugged
ruggedness: ruggedness
ruinous: ruinous
rule: rule,ruled,rules
ruler: ruler
ruminate: ruminate,ruminating
rush: rush,rushing
sabbath: sabbath
sacrament: sacrament,sacraments
sacraments: sacraments
sacrifice: sacrifice,sacrificed,sacrifices,sacrificing
sacrilegious: sacrilegious
sad: sad
sadness: sadness
safe: safe,safer
safety: safety
sail: sail,sails
sailor: sailors
saint: saint,saints
saints: saints
saith: saith
sake: sake,sakes
salary: salary
sale: sale
salt: salt,salted
salvation: salvation
sanctification: sanctification
sanctify: sanctified
sanctity: sanctity
sanctuary: sanctuary
sand: sand
sate: sate,sated
satiate: satiate,satiated
satiety: satiety
satisfaction: satisfaction
satisfactorily: satisfactorily
satisfied: satisfied
satisfy: satisfied,satisfy,satisfying
saturn: saturn
saul: saul
savage: savage
savageness: savageness
save: save,saved,saving
saving: saving
saviour: saviour
savour: savour,savoured
savoury: savoury
sayest: sayest
scantling: scantling
scarce: scarce
scarcely: scarcely
scatter: scatter,scattered
scattered: scattered
scenical: scenical
sceptre: sceptre
scholar: scholar,scholars
school: school,schools
science: science,sciences
scoff: scoffed,scoffing
scorn: scorn,scorned
scornful: scornful
scornfully: scornfully
scourge: scourge,scourged,scourges
scrape: scraped
scratch: scratch,scratching
scripture: scripture,scriptures
scriptures: scriptures
scroll: scroll
scruple: scruple
sea: sea,seas
seal: sealed
search: search,searched,searches,searching
searcher: searcher
season: season,seasoned,seasons
seasonably: seasonably
seat: seat,seated,seats
secondary: secondary
secrecy: secrecies
secret: secret,secrets
secretly: secretly
sect: sect
secular: secular
secure: secure
securely: securely
seduce: seduce,seduced,seducing
seducer: seducers
seduction: seduction,seductions
seductive: seductive
seed: seed
seek: seek,seeking,seeks,sought
seemly: seemly
seize: seize,seized,seizes
seldomness: seldomness
select: selected
sell: sell,selling,sold
seller: sellers
semblance: semblance
senator: senator,senators
send: send,sending
seneca: seneca
sensation: sensation,sensations
sense: sense
senseless: senseless
sensibly: sensibly
sensitive: sensitive
sentence: sentence,sentences
sentiment: sentiment
separate: separate,separated,separating
seraphim: seraphim
serene: serene
serenity: serenity
sermon: sermons
serpent: serpent,serpents
servant: servant,servants
serve: serve,served,serves,serving
service: service,services
serviceable: serviceable
servitude: servitude
set: set,sets,setting
settle: settle,settled,settling
settled: settled
seventh: seventh
sever: sever,severed,severing
severally: severally
severe: severe,severer
severely: severely
severity: severity
sex: sex
shade: shade
shadow: shadow,shadowed,shadows
shadowy: shadowy
shady: shady
shaggy: shaggy
shake: shake,shaken,shakes,shook
shalt: shalt
shame: shame
shameful: shameful
shamefulness: shamefulness
shameless: shameless
shamelessness: shamelessness
shape: shape,shapes
shapen: shapen
share: share,shared,shares,sharing
sharer: sharers
sharp: sharp,sharper
sharpen: sharpen
sharply: sharply
sharpness: sharpness
shatter: shatter,shattered
sheep: sheep
shelter: shelter
shepherd: shepherd
shield: shield
shift: shifted,shifting
shine: shine,shines,shining,shone
ship: ship,ships
shipwreck: shipwreck
shoe: shod,shoe,shoes
shoot: shoot
shop: shop,shops
shore: shore
short: short,shorter
shorten: shortened
shortly: shortly
shoulder: shoulder,shoulders
shouldest: shouldest
shout: shouted
shower: shower
shrink: shrink,shrunk
shrinking: shrinking
shudder: shudder
shun: shunning,shuns
shut: shut
sick: sick
sickly: sickly
sickness: sickness,sicknesses
siege: siege
sigh: sigh,sighed,sighing,sighs
sighing: sighing
sight: sight,sights
sighted: sighted
sign: sign,signs
signification: significations
signify: signified,signifies,signify
silence: silence,silenced
silent: silent
silently: silently
silly: silly
silver: silver
silversmith: silversmiths
similitude: similitude
simple: simple
simplicity: simplicity
simply: simply
sin: sin,sinned,sins
sincerely: sincerely
sinful: sinful
sing: sang,sing,singing,sings,sung
singing: singing
single: single
singly: singly
singsong: singsong
singular: singular
singularly: singularly
sink: sank,sink,sinking,sinks,sunk
sinner: sinner,sinners
sip: sipped,sips
sit: sat,sit,sits,sitting
sixteenth: sixteenth
sixth: sixth
size: size
skilful: skilful
skill: skill
skilled: skilled
skin: skin,skins
skirmish: skirmishes
skirt: skirts
sky: skies,sky
slacken: slackened
slackness: slackness
slave: slave,slaves
slavery: slavery
slavish: slavish
slay: slain,slay
slaying: slaying
sleep: sleep,sleeping,slept
sleeper: sleeper
sleeping: sleeping
slew: slew
slight: slight,slighting
slip: slipped
slippery: slippery
sloth: sloth
slothful: slothful
slow: slow,slower
slowly: slowly
sluggish: sluggish
slumber: slumber,slumbers
smart: smarting
smell: smell,smelling,smells
smile: smile,smiled,smiling
smite: smiting
smoke: smoke
smooth: smooth,smoothed,smoothing
snare: snare,snares
snow: snow
soar: soaring
sober: sober
soberly: soberly
sobriety: sobriety
society: society
sodom: sodom
soever: soever
soft: soft
soften: softening
softened: softened
softly: softly
soil: soil
solace: solaces
soldier: soldier
sole: sole
solecism: solecism
solemn: solemn
solemnise: solemnise
solemnity: solemnities,solemnity
solicit: solicit,solicits
solicitation: solicitation
solid: solid
solidity: solidity
solitude: solitude
solomon: solomon
solstice: solstices
solve: solve,solving
son: son,sons
song: song,songs
sooner: sooner
soothe: soothed,soothes
sore: sore,sores
sorely: sorely
sorrow: sorrow,sorrowed,sorrows
sorrowful: sorrowful
sorrowfulness: sorrowfulness
sort: sort,sorts
soul: soul,souls
sound: sound,sounded,sounding,sounds
sounder: sounder
soundly: soundly
soundness: soundness
sour: sour
source: source,sources
sovereign: sovereign
sovereignly: sovereignly
sow: sowing
space: space,spaces
spacious: spacious
spare: spare
spark: sparks
sparrow: sparrow,sparrows
speak: spake,speak,speaking,speaks,spoke,spoken
speaker: speakers
speaking: speaking
special: special
species: species
specimen: specimens
spectacle: spectacle
spectacles: spectacles
spectator: spectator,spectators
speech: speech,speeches
speechless: speechless
speed: speed
speedily: speedily
spend: spend,spent
spice: spices
spider: spider
spirit: spirit,spirits
spiritual: spiritual
spiritually: spiritually
spoil: spoil
spoken: spoken
sponge: sponge
sport: sport,sports
sportively: sportively
spot: spot,spots
spout: spouts
spread: spread,spreading,spreads
spring: sprang,spring,springs,sprung
spurn: spurn
stable: stable
stablish: stablished
staff: staff
stage: stage,stages
stagger: staggered
stand: stand,standing,stands,stood
standeth: standeth
standing: standing
stanza: stanza,stanzas
star: star,stars
starry: starry
start: start
starting: starting
startle: startled,startles
startled: startled
stateliness: stateliness
statement: statement,statements
station: station
statue: statue
stature: stature
status: status
stay: stay,stayed,stays
stead: stead
steadfast: steadfast
steal: steal,stealing,steals,stole,stolen
stealth: stealth
steep: steep
steeping: steeping
steer: steer,steered
step: step,steps
stick: stick,sticking,stuck
stiff: stiff
stiffly: stiffly
stiffneckedness: stiffneckedness
stiffness: stiffness
stimulus: stimulus
sting: stung
stink: stank
stipend: stipend
stir: stir,stirred,stirring
stolidity: stolidity
stomach: stomach,stomachs
stone: stone,stones
stoop: stoop,stooping
store: store,stored,stores,storing
storm: storm,stormed
stormy: stormy
story: stories,story
stow: stowed
straighten: straightening
strain: strained
strait: strait
straitly: straitly
straitness: straitness
strange: strange
strangely: strangely
stranger: stranger,strangers
stray: strayed,straying
stream: stream,streaming,streams
street: streets
strength: strength
strengthen: strengthen,strengthened
strengthless: strengthless
stretch: stretch,stretched,stretching
stricken: stricken
strict: strict
strictness: strictness
strife: strife,strifes
strike: strike,strikes,striking,struck
striking: striking
string: strings
strip: stripped
stripe: stripes
strive: strive,strives,striving
stroke: stroke
strong: strong
stronghold: strongholds
structure: structure
struggle: struggle,struggled,struggles,struggling
stuck: stuck
student: student,students
studious: studious
studiously: studiously
study: studied,studies,study,studying
stuff: stuff
stumble: stumble,stumbled,stumbling
stupidity: stupidity
style: style,styled
subdue: subdued,subduing
subject: subject,subjected,subjects
subjection: subjection
subjoin: subjoined,subjoins
sublime: sublime
sublimely: sublimely
sublimer: sublimer
sublimity: sublimities,sublimity
submit: submit,submitted,submitting
subordinate: subordinate
subscribe: subscribe
subsequently: subsequently
subsist: subsist,subsists
substance: substance,substances
substantial: substantial
subtile: subtile
subtilty: subtilty
subtle: subtle
subversion: subversion
subvert: subverted
subverters: subverters
succeed: succeed,succeeded,succeeding
succession: succession
successive: successive
successively: successively
succour: succour
suck: suck,sucking
suckling: sucklings
sudden: sudden
suddenly: suddenly
suffer: suffer,suffered,suffering,suffers
suffering: suffering
suffice: suffice,sufficed
sufficient: sufficient
suffocate: suffocated
suffrage: suffrages
suggestion: suggestion,suggestions
suitable: suitable
suitably: suitably
sum: summing
summer: summer
summit: summit
sumptuously: sumptuously
sun: sun
sunder: sunder
supercelestial: supercelestial
supereminence: supereminence
supereminent: supereminent
superfluously: superfluously
superior: superior
superstition: superstition
superstitious: superstitious
suppliant: suppliant
supply: supplied,supplies
support: support,supported,supporting
suppose: suppose,supposed,supposing
suppress: suppress,suppressed
supreme: supreme
supremely: supremely
surely: surely
surface: surface
surfeiting: surfeiting
surmount: surmount,surmounted
surpass: surpassed,surpasses
surpassingly: surpassingly
surprise: surprises
surround: surrounded
survey: surveyed
survive: survive
suspect: suspect,suspected
suspense: suspense
suspicion: suspicions
suspicious: suspicious
sustenance: sustenance
swallow: swallowed
swamp: swamp
sway: swaying
sweat: sweat
sweep: swept
sweet: sweet,sweeter
sweeten: sweeten,sweetened
sweetly: sweetly
sweetness: sweetness
swell: swelled,swelling,swollen
swelling: swelling
swerve: swerving
swift: swift
swiftness: swiftness
swine: swine
swollen: swollen
swoon: swoon
sword: sword
syllable: syllable,syllables
sympathy: sympathy
synonymous: synonymous
syrian: syrian
tabernacle: tabernacle
table: table
taketh: taketh
tale: tale,tales
talent: talent,talents
talented: talented
talk: talk,talked,talking
talker: talkers
tame: tame,tamed,tamer,taming
tardy: tardy
task: task
taste: taste,tasted,tastes,tasting
taunt: taunt,taunted
tax: tax,taxes
teach: taught,teach,teaches,teaching
teacher: teacher,teachers
teaching: teaching,teachings
tear: tear,tears,tore,torn
tearful: tearful
tediousness: tediousness
teem: teeming
temper: temper,tempered,tempers
temperament: temperament
temperance: temperance
tempestuously: tempestuously
temple: temple,temples
temporal: temporal
temporary: temporary
tempt: tempt,tempted,tempts
temptation: temptation,temptations
tempting: tempting
tend: tend,tending
tender: tender
tenderly: tenderly
tenderness: tenderness
tenet: tenet,tenets
tenor: tenor
terence: terence
term: termed,terms
terrestrial: terrestrial
terrible: terrible
terribly: terribly
terror: terrors
testament: testament
testify: testified
testimony: testimonies,testimony
thankful: thankful
thanksgiving: thanksgiving,thanksgivings
theatre: theatre,theatres
theatrical: theatrical
thee: thee
theft: theft,thefts
thenceforth: thenceforth
therefrom: therefrom
thereon: thereon
therewith: therewith
thicket: thickets
thief: thief
thieve: thieve
thine: thine
thirdly: thirdly
thirst: thirst,thirsted,thirsts
thirtieth: thirtieth
thither: thither
thorn: thorns
thraldom: thraldom
thread: thread
threat: threats
threaten: threatens
threefold: threefold
thrice: thrice
thriven: thriven
throat: throat
throne: throne
thrones: thrones
throng: throng,throngs
throw: thrown
thrust: thrust
thunder: thunder,thundered,thundering
thunderer: thunderer
thwart: thwart
thy: thy
thyself: thyself
tickle: tickled
tide: tide,tides
tie: tie
time: time,times
times: times
tire: tire
tired: tired
title: title
tobias: tobias
toil: toil,toiled,toiling
toilsome: toilsome
token: token
tolerate: tolerated,tolerating
tomorrow: tomorrow
tone: tone,tones
tongue: tongue,tongues
tooth: teeth
torment: torment,tormented,torments
torpor: torpor
torrent: torrent
torture: torture
toss: toss,tossed,tosses
touch: touch,touched,touching
towardliness: towardliness
tower: tower
town: town
townsman: townsman
toy: toys
trace: trace,traced,traces
track: track
trade: trade
trademark: trademark
tradition: tradition
tragical: tragical
trail: trailed
trample: trample,trampled
tranquil: tranquil
tranquillity: tranquillity
transcribe: transcribe
transcription: transcription
transfer: transferred,transferring
transform: transformed,transforming
transgress: transgressing
transgression: transgression,transgressions
transgressor: transgressors
transition: transition
transitory: transitory
translate: translated
translator: translator
transmit: transmitted
transparent: transparent
transport: transported
travail: travail,travailed,travailing,travails
traveller: traveller
treacherous: treacherous
treachery: treachery
tread: tread,trod
treasure: treasure,treasured,treasures
treasury: treasury
treat: treat
treatment: treatment
treble: treble
tree: tree,trees
tremble: tremble,trembled,trembling
trial: trial,trials
tribulation: tribulation
tribute: tribute
triers: triers
trifle: trifles
trifling: trifling
trine: trine
trinity: trinity
triple: triple
triumph: triumph,triumphed
trojan: trojan
troop: troop
troops: troops
trouble: trouble,troubled,troubles
troubled: troubled
troublesome: troublesome
troy: troy
true: true,truer
trust: trust,trusting
truth: truth,truths
tumble: tumbling
tumult: tumult,tumults
tumultuous: tumultuous
tumultuously: tumultuously
tumultuousness: tumultuousness
tune: tune
turbulence: turbulence
turbulent: turbulent
turmoil: turmoiling,turmoils
tutor: tutor,tutors
twentieth: twentieth
twin: twins
twinkling: twinkling
twisted: twisted
type: types
ulcerous: ulcerous
unable: unable
unacquainted: unacquainted
unadorned: unadorned
unaided: unaided
unallowed: unallowed
unalterable: unalterable
unanxious: unanxious
unarranged: unarranged
unassuming: unassuming
unawares: unawares
unbecoming: unbecoming
unbeliever: unbelievers
unbelieving: unbelieving
unbend: unbending
unbeseemingly: unbeseemingly
unbounded: unbounded
unbroken: unbroken
uncase: uncase
unceasing: unceasing
uncertain: uncertain
uncertainty: uncertainties,uncertainty
unchain: unchain
unchangeable: unchangeable
unchangeableness: unchangeableness
unchangeably: unchangeably
unchanged: unchanged
unclean: unclean
uncleanness: uncleanness
unconscious: unconscious
unconsciously: unconsciously
uncorrupted: uncorrupted
uncorruptible: uncorruptible
uncorruptness: uncorruptness
uncultivated: uncultivated
undefilable: undefilable
undergo: undergo,underwent
understand: understand,understanding,understands,understood
understanding: understanding
undertake: undertake,undertook
undistracted: undistracted
undisturbed: undisturbed
undo: undid,undo
unemployed: unemployed
unenforceability: unenforceability
unexpected: unexpected
unexpectedly: unexpectedly
unexplained: unexplained
unfailingly: unfailingly
unfair: unfair
unfeigned: unfeigned
unfledged: unfledged
unforgotten: unforgotten
unformed: unformed
unfriendly: unfriendly
ungodlily: ungodlily
ungodliness: ungodliness
ungodly: ungodly
ungoverned: ungoverned
unhappily: unhappily
unhappiness: unhappiness
unhappy: unhappy
unharmonise: unharmonising
unhealthiness: unhealthiness
unhesitatingly: unhesitatingly
unholy: unholy
uniform: uniform
uninjurable: uninjurable
uninjuriousness: uninjuriousness
unintelligible: unintelligible
union: union
unite: united
united: united
unity: unity
universal: universal
universally: universally
universe: universe
unjust: unjust
unjustly: unjustly
unkindled: unkindled
unkindness: unkindness
unknowing: unknowing
unknowingly: unknowingly
unknown: unknown
unlawful: unlawful
unlearned: unlearned
unlicensed: unlicensed
unlikeliness: unlikeliness
unlikeness: unlikeness
unlimited: unlimited
unlink: unlink
unlock: unlocked
unlook: unlooked
unlooked: unlooked
unmarried: unmarried
unmeasurable: unmeasurable
unmeasured: unmeasured
unnatural: unnatural
unpassable: unpassable
unperceived: unperceived
unpleasantly: unpleasantly
unpraise: unpraised
unprotected: unprotected
unpunished: unpunished
unquiet: unquiet
unravel: unravelled
unreal: unreal
unreasoning: unreasoning
unresolved: unresolved
unrighteous: unrighteous
unrulily: unrulily
unruly: unruly
unsearchable: unsearchable
unseemly: unseemly
unseen: unseen
unsettle: unsettled
unsettled: unsettled
unshaken: unshaken
unshakenly: unshakenly
unskilful: unskilful
unskilfulness: unskilfulness
unsolicited: unsolicited
unsought: unsought
unsound: unsound
unspeakable: unspeakable
unstable: unstable
unstayed: unstayed
unsuitably: unsuitably
unsure: unsure
untainted: untainted
unteach: unteach
unteachable: unteachable
unthankful: unthankful
unthought: unthought
untruly: untruly
untruth: untruth
unused: unused
unusual: unusual
unutterable: unutterable
unutterably: unutterably
unveil: unveiled
unwarm: unwarmed
unwearied: unwearied
unwholesome: unwholesome
unwilling: unwilling
unwonted: unwonted
unworthy: unworthy
unyielding: unyielding
upborne: upborne
upbraid: upbraid,upbraided
update: updated
uphold: upheld,uphold
upper: upper
upright: upright
uprightness: uprightness
uproar: uproar
upward: upward
urge: urge,urged
urgently: urgently
usage: usage
user: user
usher: ushered
usual: usual
usury: usury
ut: ut
utensil: utensils
utmost: utmost
utter: utter,uttered
utterance: utterance
utterly: utterly
vacation: vacation
vagrant: vagrant
vail: vail
vain: vain
vainglorious: vainglorious
vainly: vainly
valentinian: valentinian
valiant: valiant
valley: valley
valuable: valuable
vanilla: vanilla
vanish: vanished
vanity: vanities,vanity
vanquish: vanquished
vapours: vapours
variable: variable
variableness: variableness
variance: variance
variation: variation,variations
varied: varied
variety: varieties,variety
variously: variously
vary: varied,varies,vary,varying
vast: vast,vaster
vaunt: vaunt
vehemence: vehemence
vehement: vehement
vehemently: vehemently
veil: veil,veiled
vein: vein
venerable: venerable
vengeance: vengeance
vent: vent
venture: venture,ventures,venturing
venus: venus
verily: verily
verity: verity
verse: verse,verses
version: version
vessel: vessel,vessels
vestige: vestige
vex: vex,vexed
vice: vice,vices
viciousness: viciousness
vicissitude: vicissitude,vicissitudes
victim: victim
victor: victor
victorious: victorious
victory: victory
view: view,viewed,viewing
vigorous: vigorous
vigour: vigour
vii: vii
viii: viii
vile: vile
vileness: vileness
villa: villa
villainy: villainies
vindicate: vindicating
vineyard: vineyard
vintage: vintage
violate: violated,violates
violence: violence
violent: violent
violet: violets
viper: viper
virgil: virgil
virgin: virgin,virgins
virginity: virginity
virtue: virtue
virtuous: virtuous
virus: virus
visible: visible
vision: vision,visions
visit: visit
vital: vital
vivid: vivid
vocal: vocal
vocally: vocally
voice: voice,voices
void: void
volume: volume,volumes
voluntarily: voluntarily
volunteer: volunteer,volunteers
voluptuous: voluptuous
voluptuousness: voluptuousness
vomit: vomited
vouchsafe: vouchsafe,vouchsafed
vow: vow,vowed,vowing
vows: vows
voyage: voyage
vulgar: vulgar
waft: waft
wage: waged
wages: wages
wail: wail
wait: wait,waited,waiting
wake: waking,woke
walk: walk,walked,walking,walks
wall: walls
wallow: wallow,wallowed
wander: wander,wandered,wandering
wanderer: wanderer
wanderings: wanderings
wanton: wanton
wantonly: wantonly
wantonness: wantonness
war: war,warring,wars
warfare: warfare
warmth: warmth
warn: warned,warning
warped: warped
warrant: warranted
warranty: warranties,warranty
wash: wash
washing: washing
wast: wast
waste: waste,wasted,wasting
watch: watch,watched
watchfully: watchfully
watching: watchings
water: water,watered,waters
watery: watery
wave: waves
waver: waver,wavered,wavering
wavy: wavy
wax: wax
wayfaring: wayfaring
wayward: wayward
weak: weak,weaker,weakest
weaken: weaken,weakened
weakly: weakly
weakness: weakness,weaknesses
weal: weal
wealth: wealth
wealthy: wealthy
weapon: weapon
wear: wear,wearing,worn
wearied: wearied
weariness: weariness
wearisome: wearisome
weary: wearied,weary
weave: wove
weaving: weaving
wedlock: wedlock
weep: weep,weeping,weeps,wept
weigh: weigh,weighed,weighing
weight: weight,weights
weighty: weighty
welter: weltering
wert: wert
west: west
whale: whales
whatsoever: whatsoever
wheat: wheat
wheel: wheel
whencesoever: whencesoever
whereat: whereat
wherefore: wherefore
wherefrom: wherefrom
whereof: whereof
whereon: whereon
wheresoever: wheresoever
whereto: whereto
wherewith: wherewith
whichsoever: whichsoever
whirl: whirling
whirlpool: whirlpool,whirlpools
whisper: whispered,whispers
whispering: whisperings
whit: whit
white: white
whithersoever: whithersoever
whitherto: whitherto
whitherward: whitherward
wholesome: wholesome
wholesomely: wholesomely
wholesomeness: wholesomeness
wholly: wholly
whoring: whoring
whoso: whoso
whosoever: whosoever
wicked: wicked
wickedly: wickedly
wickedness: wickedness
wide: wide,widest
widespread: widespread
widow: widow,widows
wife: wife,wives
wild: wild
wilderness: wilderness
wildness: wildness
wilfully: wilfully
wilfulness: wilfulness
willed: willed
willingly: willingly
wills: wills
wilt: wilt
win: win,wins
wind: wind,winding,winds,wound
winding: windings
window: window
windy: windy
wine: wine
wing: wings
wink: winked
winning: winning
wipe: wipe
wisdom: wisdom
wise: wise,wiser
wisely: wisely
wit: wit
withal: withal
withdraw: withdraw,withdrawing,withdrawn,withdrew
wither: wither,withered,withering
withstand: withstood
witness: witness,witnesses
witting: witting
wittingly: wittingly
wizard: wizard
woe: woe,woes
woman: woman,women
womanish: womanish
womb: womb
wonderful: wonderful
wonderfully: wonderfully
wonderfulness: wonderfulness
wondrous: wondrous
wondrously: wondrously
wonted: wonted
woo: wooed
wood: wood
wooden: wooden
word: word
wordy: wordy
workhouse: workhouse
workings: workings
workmanship: workmanship
workmaster: workmaster
worldly: worldly
worldy: worldy
worm: worm
worn: worn
worship: worship,worshipped,worshipping
worshipper: worshipper,worshippers
worshipping: worshipping
worst: worsted
worthless: worthless
worthy: worthy
wouldest: wouldest
wound: wound,wounded,wounds
wounded: wounded
wrap: wrap
wrath: wrath
wrench: wrench
wrest: wrested
wretch: wretch
wretched: wretched
wretchedness: wretchedness
wring: wring
wrinkle: wrinkle
writ: writ
write: write,writing,written,wrote
writer: writer
writing: writing
writings: writings
wrong: wrong,wronged
wronging: wronging
wroth: wroth
xi: xi
xii: xii
xiii: xiii
yea: yea
yesterday: yesterday
yield: yield,yielded,yielding,yields
yoke: yoke
youth: youth,youths
youthful: youthful
youthfulness: youthfulness
zeal: zeal
zealous: zealous
zealously: zealously
