aback: aback
abandon: abandon,abandoned,abandoning
abasement: abasement
aberration: aberration
abide: abiding
ability: ability
abject: abject
abjectly: abjectly
abjectness: abjectness
abjure: abjure
abnegation: abnegation
abnormal: abnormal
abnormality: abnormality
abolition: abolition
abominably: abominably
abortion: abortions
abraham: abraham
abrupt: abrupt
abruptly: abruptly
abscess: abscess
absence: absence
absent: absent
absolute: absolute
absolutely: absolutely
absorb: absorbed
abstain: abstain
abstract: abstract
absurd: absurd
absurdity: absurdity
absurdly: absurdly
abundant: abundant
abuse: abuse,abused,abusing
abyss: abyss
academy: academy
accelerate: accelerate
accent: accent
accept: accept,accepted
acceptance: acceptance
accident: accident
accidentally: accidentally
acclamation: acclamations
accommodate: accommodating
accompaniment: accompaniment
accompany: accompanied,accompanying
accomplice: accomplice
accomplish: accomplished
accord: accord
account: account,accounted,accounts
accumulate: accumulated
accurately: accurately
accurse: accursed
accursed: accursed
accusation: accusation,accusations
accuse: accuse,accused,accusing
accustom: accustomed
accustomed: accustomed
ach: ach
ache: ache,ached,aches,aching
achilles: achilles
acknowledge: acknowledge
acknowledgment: acknowledgments
acquaint: acquainted
acquaintance: acquaintance,acquaintances
acquiesce: acquiesce
acquire: acquired,acquiring
acquirement: acquirements
acquit: acquitted
action: action,actions
active: active
actively: actively
activity: activity
actor: actors
actual: actual
actuality: actuality
acute: acute
acutely: acutely
adaptable: adaptable
add: add,adding,adds
addition: addition,additions
addle: addled
address: address,addressed,addressing
adhere: adhered,adheres
adieu: adieu
adjoin: adjoined,adjoining
administrative: administrative
admiration: admiration
admire: admire,admired,admiring
admission: admission
admit: admit,admitted,admitting
admonish: admonishes,admonishing
admonition: admonition
adopt: adopt
adore: adores,adoring
adorn: adorned
adornment: adornment
adrift: adrift
advance: advance,advanced
advanced: advanced
advantage: advantage,advantages
advantageous: advantageous
adventure: adventure,adventures
adventuress: adventuresses
advertising: advertising
advice: advice
advisability: advisability
advise: advise
advocate: advocating
afar: afar
affable: affable
affably: affably
affair: affair,affairs
affect: affect
affectation: affectation
affection: affection
afford: afford,afforded
affront: affront,affronted
affronted: affronted
afraid: afraid
afresh: afresh
africa: africa
afternoon: afternoon
age: age,ages
aged: aged
aggrieved: aggrieved
agitate: agitated
agitated: agitated
agitation: agitation
agitator: agitators
aglow: aglow
agonise: agonised
agonising: agonising
agonisingly: agonisingly
agony: agonies,agony
agree: agree,agreed
agreeable: agreeable
agreement: agreement
aha: aha
aid: aid
ail: ailing
aim: aim,aimed,aims
aimlessly: aimlessly
air: air
airlessness: airlessness
ajar: ajar
akin: akin
alabaster: alabaster
alarm: alarm,alarmed
alarmed: alarmed
alarming: alarming
alas: alas
album: album
alcohol: alcohol
algebra: algebra
alike: alike
alive: alive
allah: allah
allay: allayed
allegorical: allegorical
alley: alley,alleys
allude: allude,alluded,alluding
allurement: allurement
alluring: alluring
allusion: allusions
alma: alma
almighty: almighty
alms: alms
aloof: aloof
aloud: aloud
altar: altars
alter: alter,altered,alters
alternate: alternating
alternative: alternatives
altogether: altogether
amalgamated: amalgamated
amass: amassed,amassing
amateur: amateur
amaze: amaze
amazed: amazed
amazement: amazement
amazing: amazing
ambiguous: ambiguous
america: america
american: american
ami: ami
amiable: amiable
amiably: amiably
amiss: amiss
amorous: amorous
amply: amply
amputate: amputated
amuse: amuse,amused,amuses
amusement: amusement,amusements
amusing: amusing
analyse: analyse,analysed
analysis: analysis
anatomy: anatomy
ancestor: ancestors
anchorage: anchorage
ancient: ancient
anecdote: anecdotes
anew: anew
angel: angel
anger: anger,angered,angers
angle: angle
angrily: angrily
angry: angry
anguish: anguish
angular: angular
animal: animal
animate: animate,animated
animated: animated
animation: animation
anna: anna
annihilate: annihilate,annihilated
annoy: annoy,annoyed,annoys
annoyance: annoyance
annoyed: annoyed
annoying: annoying
answer: answer,answered,answering,answers
ant: ant
anticipate: anticipate,anticipated,anticipating
anticipation: anticipation,anticipations
anxiety: anxieties,anxiety
anxious: anxious
anxiously: anxiously
apartment: apartments
apathy: apathy
apologetically: apologetically
apologise: apologise,apologised,apologising
apology: apologies
apoplexy: apoplexy
appal: appalled
appallingly: appallingly
apparent: apparent
apparition: apparitions
appeal: appeal,appealed
appearance: appearance,appearances
appetite: appetite
apply: applied,apply
apprehension: apprehension,apprehensions
approach: approach,approached,approaching
appropriately: appropriately
approval: approval
approve: approve,approved
approvingly: approvingly
approximate: approximate
apropos: apropos
apt: apt
aptly: aptly
arbiter: arbiter
arbitrary: arbitrary
arched: arched
ardent: ardent
ardour: ardour
argue: argue,argued,arguing
argument: argument,arguments
aristocratic: aristocratic
arithmetic: arithmetic
ark: ark
arm: arm,armed,arms
armhole: armhole
army: armies,army
arouse: arouse,aroused
arrange: arrange,arranged
arrangement: arrangement,arrangements
arrest: arrest,arrested
arrival: arrival,arrivals
arrive: arrive,arrived,arriving
arrogance: arrogance
arrogant: arrogant
arrow: arrow
arson: arson
art: art
artfully: artfully
article: article,articles
articulate: articulate,articulated,articulating
articulately: articulately
artificial: artificial
artisan: artisan
artist: artist
artistically: artistically
ascend: ascending
ascent: ascent
ascertain: ascertain,ascertaining
ascetic: ascetic
ascribe: ascribed
ash: ash,ashes
ashamed: ashamed
asia: asia
askance: askance
askew: askew
aslant: aslant
asleep: asleep
asparagus: asparagus
aspect: aspect,aspects
aspiration: aspirations
ass: ass
assailant: assailant
assault: assault,assaults
assemble: assembled
assent: assented
assert: assert,asserted
assessor: assessor
asset: asset,assets
assign: assigned
assist: assist,assisting
assistance: assistance
assistant: assistant
associate: associate
association: associations
assume: assume,assumed,assumes,assuming
assumption: assumption
assure: assure,assured,assuring
astonish: astonished
astonished: astonished
astonishing: astonishing
astonishment: astonishment
astounded: astounded
astute: astute
asylum: asylum,asylums
atheist: atheists
atmosphere: atmosphere
atone: atone
atonement: atonement
atrocious: atrocious
attach: attach,attached
attack: attack,attacked,attacking,attacks
attain: attain,attained
attempt: attempt,attempted,attempting
attend: attend,attended,attending,attends
attendance: attendance
attendant: attendant
attention: attention,attentions
attentive: attentive
attentively: attentively
attest: attested
attic: attic
attire: attire
attitude: attitude
attorney: attorney
attract: attract,attracted,attracting
attraction: attraction,attractions
attractive: attractive
attribute: attribute,attributed
audible: audible
audibly: audibly
audience: audience
augen: augen
aunt: aunt
aureole: aureole
aus: aus
austrian: austrian
authentic: authentic
author: author,authors
authority: authorities,authority
autre: autre
autumn: autumn
ave: ave
avenge: avenge,avenging
avenue: avenue
average: average
aversion: aversion
avert: averted
avoid: avoid,avoided,avoiding
await: await,awaited,awaiting
awake: awake
awaken: awaken
awakening: awakening
aware: aware
awe: awe
awful: awful
awkward: awkward
awkwardly: awkwardly
awkwardness: awkwardness
awry: awry
axe: axe
axiom: axiom
axis: axes
babble: babble,babbled,babbling
babe: babe
baby: babies,baby
bacchus: bacchus
bachelor: bachelor
bad: bad,worse,worst
badly: badly,worse
bag: bags
baggage: baggage
bah: bah
bake: baking
baked: baked
balance: balance,balancing
balcony: balconies,balcony
bald: bald
ball: ball,balls
balloon: balloon
bandage: bandage
bang: banging
banishment: banishment
bank: bank,banks
banknote: banknotes
bankrupt: bankrupt
banquet: banquets
banter: banter,bantering
bar: bar,barred
barber: barber
bare: bare,bared
barefoot: barefoot
barefooted: barefooted
barehead: bareheaded
bareheaded: bareheaded
barely: barely
bargain: bargain,bargained
barge: barge
baring: baring
bark: barking
barn: barn
barracks: barracks
barrel: barrel
barricade: barricade
barrier: barrier,barriers
barrow: barrows
barter: barter
base: base,basest
basely: basely
basement: basement,basements
baseness: baseness
baser: baser
bashful: bashful
bashfulness: bashfulness
basin: basin
basis: basis
basket: basket
basque: basque
bass: bass
bath: bath,bathed,bathing,baths
bathe: bathe
bathing: bathing
battalion: battalion
batter: battered
battered: battered
battery: battery
battle: battle
bawl: bawled,bawling
bawling: bawling
bay: bay
bazaar: bazaar
bead: beaded,beads
beam: beam
bear: bear,bearing,bore,born,borne
beard: beard
bearing: bearing
beast: beast
beastliness: beastliness
beat: beat,beaten,beating,beats
beating: beating
beautiful: beautiful
beauty: beauty
beckon: beckon,beckoning
bed: bed,beds
bedclothes: bedclothes
bedecked: bedecked
bedlam: bedlam
bedroom: bedroom
bedside: bedside
bedstead: bedstead
bedtime: bedtime
beef: beef
beer: beer
beetle: beetle,beetles
befall: befallen
befogged: befogged
befriend: befriend,befriending
beg: beg,begged,begging,begs
beggar: beggar
beggarly: beggarly
beggary: beggary
behave: behave,behaved,behaves
behavior: behavior
behaviour: behaviour
behold: behold
belaud: belauded
belfry: belfry
belief: belief,beliefs
believer: believer
believeth: believeth
bell: bell,bells
belong: belong,belonged,belonging,belongs
belongings: belongings
beloved: beloved
belt: belt
bench: bench
bend: bend,bending,bent
beneath: beneath
benefactor: benefactor,benefactors
beneficent: beneficent
beneficial: beneficial
benefit: benefit,benefits
benevolence: benevolence
benevolent: benevolent
bent: bent
bequeath: bequeathed
bereaved: bereaved
berg: berg
berlin: berlin
beseech: beseech,beseeching,besought
bespatter: bespattered
bestow: bestowed
bet: bet,betting
bethink: bethought
betray: betray,betrayed,betraying,betrays
betrayal: betrayal
betroth: betrothed
beware: beware
bewilder: bewildered
bewilderment: bewilderment
bible: bible
bid: bade,bid,bids
bide: biding
bigotry: bigotry
bilious: bilious
billiard: billiard
billiards: billiards
bind: binding,bound
biography: biography
bird: bird,birds
birth: birth
birthday: birthday
bit: bit,bits
bite: bit,bite,biting,bitten
bitter: bitter
bitterly: bitterly
bitterness: bitterness
blab: blab
black: black
blacken: blackened
blackguard: blackguard
blade: blade
blame: blame,blamed,blames,blaming
blanc: blanc
blank: blank
blanket: blanket
blankly: blankly
blankness: blankness
blasphemer: blasphemer
blast: blast
bleed: bleed
bleeding: bleeding
bless: bless,blessed
blessing: blessing,blessings
blind: blind,blinded
blink: blinking
bliss: bliss
bloated: bloated
block: block,blocking
blockhead: blockhead,blockheads
blood: blood
bloodshed: bloodshed
bloodshot: bloodshot
blossoming: blossoming
blotchy: blotchy
blow: blew,blow,blowing,blows
blue: blue
blunder: blunder,blundering,blunders
blunt: blunt
bluntly: bluntly
blur: blur,blurs
blurt: blurt,blurted,blurting,blurts
blush: blush,blushed,blushing
blushed: blushed
boarding: boarding
boast: boast
boastful: boastful
boat: boat,boats
bodice: bodice
body: bodies,body
boil: boiled,boiling,boils
bold: bold,bolder
boldly: boldly
boldness: boldness
bolster: bolster
bolt: bolt,bolted,bolting
bombard: bombarding
bond: bond,bonds
bondage: bondage
bone: bone,bones
bonjour: bonjour
bonne: bonne
bony: bony
book: book,books
bookcase: bookcase
bookish: bookish
bookseller: bookseller,booksellers
boom: boom
boot: boot,boots
booth: booth,booths
booty: booty
booze: boozed
border: bordering
bore: bored,boring
bored: bored
borrow: borrow,borrowed,borrowing
bosom: bosom
bother: bother,bothered,bothering
bottle: bottle,bottles
boulevard: boulevard
bound: bound,bounded,bounding,bounds
bounty: bounty
bourgeois: bourgeois
bout: bout
bow: bow,bowed,bowing,bows
bowl: bowled
box: box,boxes
boy: boy,boys
boyish: boyish
brace: braced
bracelet: bracelets
brag: brag,bragging
braggart: braggart
bragging: bragging
brain: brain,brains
brainless: brainless
branch: branch
brand: branded
brandish: brandished,brandishing
bravado: bravado
brave: brave
bravely: bravely
bravo: bravo
breach: breach,breaches
bread: bread
breadth: breadth
break: break,breaking,breaks,broke,broken
breakfast: breakfast
breaking: breaking
breast: breast
breath: breath,breaths
breathe: breathe,breathed,breathing
breathing: breathing
breathless: breathless
breathlessly: breathlessly
breathlessness: breathlessness
breeches: breeches
breed: bred,breeding
breeding: breeding
brew: brew
bribe: bribes
brick: brick,bricks
bride: bride
bridge: bridge
bridle: bridle
brigand: brigand,brigands
bright: bright,brighter,brightest
brighten: brightened
brightly: brightly
brightness: brightness
brilliance: brilliance
brilliant: brilliant
brimless: brimless
bring: bring,bringing,brings,brought
broad: broad,broader
broaden: broadened
broadly: broadly
brocade: brocade
broke: broke
broken: broken
brokenly: brokenly
bronze: bronze
brooch: brooch
brood: brood,brooded
brooding: brooding
broom: broom
brother: brother,brothers
brow: brow,brows
brown: brown
bruise: bruise,bruised,bruises
brush: brush,brushed,brushes,brushing
brutal: brutal
brutality: brutality
brutally: brutally
brute: brute,brutes
brutish: brutish
bubble: bubble
bucket: bucket
bud: bud
buffoon: buffoon
build: build,building,builds,built
builder: builder
building: building,buildings
bulge: bulged
bulldog: bulldog
bullet: bullet
bullock: bullock
bun: bun
bunch: bunch
bundle: bundle,bundles
burden: burden
burdensome: burdensome
bureau: bureau
burial: burial
burn: burn,burning,burnt
burning: burning
burnous: burnous
burst: burst,bursting
bury: buried,bury,burying
bush: bush,bushes
busily: busily
business: business
businesslike: businesslike
bustle: bustle
busy: busy
busybody: busybody
butcher: butcher,butchered
butter: butter
butterfly: butterfly
button: buttoned,buttons
buttonhole: buttonhole
buxom: buxom
buzz: buzz,buzzed
bye: bye
cab: cab,cabs
cabbage: cabbage
cabin: cabin
cabinet: cabinet
cabman: cabman
cackle: cackled
cad: cad
cage: cage
calamity: calamities,calamity
calculate: calculated,calculating
calculated: calculated
calculation: calculation,calculations
calculus: calculus
callous: callous
calm: calm,calmer
calmly: calmly
calumny: calumny
cambric: cambric
camel: camels
canal: canal
canary: canary
cancan: cancan
candid: candid
candidly: candidly
candle: candle,candles
candlestick: candlestick
candour: candour
cane: cane
cannon: cannon
canvas: canvas
cap: cap,caps
capable: capable
capacity: capacities,capacity
cape: cape
capital: capital
capitally: capitally
capitol: capitol
capricious: capricious
capriciously: capriciously
capsule: capsule
captain: captain
capture: capture,captured
caravan: caravan
card: card,cards
care: care,cared,cares,caring
career: career
careful: careful
carefully: carefully
carefulness: carefulness
careless: careless
carelessly: carelessly
carelessness: carelessness
caress: caressing
caressingly: caressingly
careworn: careworn
caricature: caricature
carnage: carnage
carpenter: carpenter
carpet: carpet,carpeted
carriage: carriage,carriages
carrot: carrot
carry: carried,carries,carry,carrying
cart: cart,carts
cartload: cartload
carve: carved
cash: cash
cashmere: cashmere
cask: casks
cast: cast
castigate: castigate
castle: castle
casual: casual
casually: casually
casuist: casuists
casuistry: casuistry
cat: cat
catastrophe: catastrophe
catch: catch,catching,caught
category: categories,category
cathedral: cathedral
caution: caution
cautious: cautious
cautiously: cautiously
cavalry: cavalry
cave: cave
cease: cease,ceased,ceasing
ceiling: ceiling,ceilings
celebrate: celebrate
celebrity: celebrity
cellar: cellar,cellars
cemetery: cemetery
censorship: censorship
censure: censure
cent: cent
center: centered
central: central
centre: centre,centres
century: century
ceremonious: ceremonious
ceremoniously: ceremoniously
ceremony: ceremonies,ceremony
certainty: certainty
certificate: certificate
cesspool: cesspool,cesspools
chain: chain,chains
chair: chair,chairs
chalk: chalk
challenge: challenge,challenged,challenging
challenging: challenging
chamois: chamois
champagne: champagne
champion: champion
chance: chance,chanced
chandler: chandler
change: change,changed,changing
changed: changed
chant: chanted
chantant: chantant
chaotic: chaotic
chapel: chapel
chapter: chapter
character: character,characters
characteristic: characteristic,characteristics
charge: charge,charged,charges
charitable: charitable
charity: charity
charlatanism: charlatanism
charm: charm,charmed
charmer: charmer
charming: charming
charwoman: charwoman
chase: chase,chased,chasing
chaste: chaste
chastise: chastise
chastity: chastity
chat: chat,chatting
chatter: chatter,chattered,chattering
chatterbox: chatterbox
cheap: cheap,cheapest
cheat: cheat
check: checked,checking
cheek: cheek,cheeks
cheeked: cheeked
cheer: cheer
cheerful: cheerful
cheerfully: cheerfully
chemise: chemise
chemist: chemist
cher: cher
cherish: cherish,cherished,cherishing
chest: chest
chew: chewed
chicken: chicken
chief: chief
chiefly: chiefly
child: child,children
childhood: childhood
childish: childish
childishness: childishness
chill: chill
chilled: chilled
chin: chin
china: china
chink: chinks
chintz: chintz
chirrup: chirruping
chisel: chiselled
choice: choice
choke: choked,chokes,choking
choose: choose,choosing,chose,chosen
chop: chop,chopped
chord: chord
chorus: chorus
christ: christ
christen: christened
christening: christening
christian: christian
christmas: christmas
chronicle: chronicle
chuckle: chuckled,chuckling
chunk: chunk,chunks
church: church
churl: churls
cigar: cigar,cigars
cigarette: cigarette,cigarettes
circle: circle,circles,circling
circulate: circulating
circulation: circulation
circumstance: circumstance,circumstances
circumstantial: circumstantial
circumstantially: circumstantially
citizen: citizen
city: city
civil: civil
civilian: civilian
civilised: civilised
civilly: civilly
claim: claim,claiming
clamber: clambered
clamour: clamour,clamouring
clank: clanking,clanks
clap: clap
clapping: clapping
clarionet: clarionet
clash: clashed
clasp: clasping
clasped: clasped
class: class,classes
clean: clean,cleaned,cleaning
cleanliness: cleanliness
clearness: clearness
cleft: cleft
clench: clenched,clenching
clerk: clerk,clerks
clever: clever,cleverer,cleverest
cleverly: cleverly
climate: climate
climber: climbers
cling: cling,clinging
cloak: cloak
clock: clock
close: close,closed,closer,closing
closed: closed
closely: closely
closeness: closeness
clot: clotted
cloth: cloth
clothes: clothes
cloud: cloud,clouded,clouds
clouded: clouded
clout: clout
clove: clove
clown: clown
club: club,clubs
clue: clue
clumsily: clumsily
clumsiness: clumsiness
clumsy: clumsy
clutch: clutch,clutched,clutching
coachman: coachman
coal: coal
coarse: coarse,coarser,coarsest
coarsely: coarsely
coarsen: coarsened
coat: coat,coated,coats
coax: coaxed
cock: cock
cockaded: cockaded
cocked: cocked
code: code
coffee: coffee
coffin: coffin
coherence: coherence
coherent: coherent
coil: coil
coin: coin
coincide: coincides
coincidence: coincidence,coincidences
coiner: coiners
cold: cold
coldly: coldly
collapse: collapses
collar: collar,collars
collect: collect,collected
colonel: colonel
colour: colour,coloured,colours
colourless: colourless
comb: comb,combed
combination: combinations
combustion: combustion
comer: comer,comers
cometh: cometh
comfort: comfort,comforted,comforts
comfortable: comfortable
comfortably: comfortably
comforting: comforting
comic: comic
comical: comical
coming: coming
command: command,commands
comme: comme
commence: commenced
comment: commented
commercial: commercial
commiserate: commiserating
commissariat: commissariat
commission: commission,commissions
commit: commit,commits,committed,committing
common: common
commonplace: commonplace,commonplaces
commotion: commotion
commune: commune
communicate: communicating
communication: communication
communicative: communicative
community: communities,community
commute: commuted
companion: companion,companions
companionship: companionship
company: company
compare: compared
comparison: comparison
compassion: compassion
compassionate: compassionate
compassionately: compassionately
compel: compelled,compels
compensate: compensate
competent: competent
complacent: complacent
complain: complain,complained,complaining
complaint: complaint,complaints
complete: complete,completed
completely: completely
completeness: completeness
complex: complex
compliment: compliment
compose: composed
composed: composed
composure: composure
comprehend: comprehend
comprehensible: comprehensible
compress: compressed
compressed: compressed
compromise: compromised,compromises
compulsory: compulsory
comrade: comrade,comrades
conceal: conceal,concealed,concealing
concealment: concealment
conceit: conceit,conceited
conceited: conceited
conceive: conceived,conceiving
concentrate: concentrate,concentrated
concentrated: concentrated
concentration: concentration
conception: conception
concern: concern,concerned,concerns
concerned: concerned
concertina: concertina
conclude: concluded,concluding
conclusion: conclusion,conclusions
conclusive: conclusive
conclusively: conclusively
concubine: concubine
condemn: condemn,condemned
condescend: condescended
condescending: condescending
condescension: condescension
condition: condition,conditions
conduct: conduct,conducting
conductor: conductor
confectioner: confectioner
confess: confess,confessed,confessing
confession: confession
confessions: confessions
confessor: confessor
confide: confide,confided
confidence: confidence
confident: confident
confidently: confidently
confine: confined
confirm: confirm,confirmed
conflagration: conflagrations
conflict: conflict
confound: confound,confounded
confront: confront,confronted,confronting
confuse: confuse,confused
confused: confused
confusion: confusion
congeal: congealed
congratulate: congratulate
conjecture: conjecture
conjugal: conjugal
conjunction: conjunction
connect: connected
connection: connection,connections
conscience: conscience
conscientious: conscientious
conscientiously: conscientiously
conscious: conscious
consciously: consciously
consciousness: consciousness
consent: consent,consented,consenting
consequence: consequence,consequences
conservative: conservative
considerable: considerable
considerably: considerably
considerate: considerate
considerately: considerately
consideration: consideration
consist: consisted,consisting,consists
consistent: consistent
consolation: consolation,consolations
consolatory: consolatory
console: console,consoled
consoling: consoling
conspicuous: conspicuous
conspirator: conspirator
constable: constable
constance: constance
constantly: constantly
consternation: consternation
constitute: constitutes
constrain: constrained
constrained: constrained
constraint: constraint
construction: construction
consult: consult,consulted
consultation: consultation
consumption: consumption
consumptive: consumptive
contact: contact
contemplate: contemplated
contemplation: contemplation
contempt: contempt
contemptible: contemptible
contemptuous: contemptuous
contemptuously: contemptuously
contend: contend
content: content
contented: contented
contention: contention
contents: contents
contingency: contingencies
continual: continual
continually: continually
continue: continue,continued,continuing
continuous: continuous
contorted: contorted
contract: contract,contracted
contractor: contractors
contradict: contradict,contradicted,contradicts
contradiction: contradiction
contralto: contralto
contrary: contrary
contribute: contribute,contributed
contribution: contribution
contrived: contrived
control: control,controlled,controlling
convenient: convenient
conveniently: conveniently
convention: convention
conventional: conventional
conventionally: conventionally
conversation: conversation,conversations
converse: converse
convert: convert
convey: conveyed
conveyance: conveyance,conveyances
convict: convict,convicts
conviction: conviction,convictions
convince: convince,convinced
convinced: convinced
convincing: convincing
convulsion: convulsion,convulsions
convulsive: convulsive
convulsively: convulsively
cook: cook,cooked,cooks
cooking: cooking
cookshop: cookshop
cool: cool,cooler
coolly: coolly
coolness: coolness
copeck: copeck,copecks
copper: copper,coppers
copse: copse
corn: corn
corner: corner,corners
corners: corners
corpse: corpse,corpses
corpulence: corpulence
correct: correct,corrected
correction: correction
corrective: corrective
correctly: correctly
correspondence: correspondence
corridor: corridor
corruption: corruption
cost: cost,costs
costume: costume,costumes
cottage: cottage
cotton: cotton
cough: cough,coughed,coughing
councillor: councillor
councillors: councillors
counsel: counsel
counsellor: counsellor
count: count,counted,counting
countenance: countenance
counter: counter
countess: countess
country: country
couple: couple
courage: courage
court: court,courts
courteous: courteous
courteously: courteously
courtesy: courtesy
courtship: courtship
courtyard: courtyard,courtyards
cousin: cousin
cover: cover,covered,covering,covers
covered: covered
covering: covering
cow: cow
coward: coward,cowards
cowardice: cowardice
cowardly: cowardly
cowshed: cowshed
coxcomb: coxcombs
crab: crab
crack: crack,cracked,cracking
crafty: crafty
cramp: cramp,cramped
cramped: cramped
cramping: cramping
crash: crash,crashing
cravat: cravat
crave: craved
craving: craving
crawl: crawling
craze: crazed
crazy: crazy
cream: cream
create: created
creation: creation
creator: creator
creature: creature,creatures
credit: credit
creditor: creditor
credulous: credulous
creed: creed
creep: creep,crept
crest: crest
crestfallen: crestfallen
crier: criers
crime: crime,crimes
criminal: criminal,criminals
criminality: criminality
crimson: crimson,crimsoned
cringing: cringing
crinoline: crinoline
cripple: crippled
crisis: crisis
critic: critic
criticise: criticise,criticised
criticism: criticism
croak: croak
crockery: crockery
crooked: crooked
crop: crop
cross: cross,crossed,crosses,crossing
crossing: crossing
crouch: crouched
crow: crow
crowbar: crowbar
crowd: crowd,crowded,crowding,crowds
crowded: crowded
crown: crown,crowned
crucify: crucified,crucify
crude: crude,crudest
cruel: cruel
cruelly: cruelly
cruelty: cruelty
crumple: crumpled
crumpled: crumpled
crush: crush,crushed,crushing
crust: crust
crutch: crutches
crying: crying
cuckoo: cuckoo
cucumber: cucumber,cucumbers
cue: cue
cuff: cuffs
cultivate: cultivated
culture: culture
cunning: cunning
cup: cup,cups
cupboard: cupboard,cupboards
cupola: cupola
cure: cure,cured,curing
curiosity: curiosity
curious: curious
curiously: curiously
curl: curled,curls
curly: curly
current: current
curse: curse,cursed,curses,cursing
curtain: curtain,curtains
curtsey: curtseys
curtsy: curtsied,curtsy,curtsying
curtsying: curtsying
curve: curve
customer: customers
cut: cut,cuts,cutting
cynic: cynic
cynical: cynical
cynicism: cynicism
cypress: cypress
cyprus: cyprus
cyrus: cyrus
dagestan: dagestan
daintily: daintily
dainty: dainty
damages: damages
dame: dame,dames
damn: damn
damnable: damnable
damnation: damnation
damned: damned
damp: damp
dampness: dampness
damsel: damsels
dance: dance,danced,dances,dancing
dancing: dancing
dandle: dandling
dandy: dandy
danger: danger
dangerous: dangerous
danke: danke
daresay: daresay
daring: daring
dark: dark,darker
darken: darkening
darkness: darkness
darling: darling
darn: darn,darning
dart: dart,darted
darwinian: darwinian
darya: darya
dash: dashed,dashes
datum: data
daughter: daughter,daughters
dawn: dawn,dawned
day: day,days
daybreak: daybreak
daylight: daylight
daytime: daytime
daze: dazed
dazzling: dazzling
dead: dead
deadly: deadly
deaf: deaf
deal: deal,dealing,dealt
dealer: dealer
dealings: dealings
dearly: dearly
death: death
deathly: deathly
debate: debate
debauchery: debauchery
debt: debt,debts
debtor: debtor,debtors
decamp: decamped
decanter: decanter
decay: decay
deceased: deceased
deceitful: deceitful
deceive: deceive,deceived,deceiving
decent: decent
decently: decently
deception: deception
decide: decide,decided
decision: decision,decisions
decisive: decisive
decisively: decisively
deck: deck,decked,decking
declaim: declaim,declaimed
declaration: declaration
declare: declare,declared,declaring
decorate: decorated
decoration: decoration
decorous: decorous
decorously: decorously
decoy: decoy
decree: decree
decrepit: decrepit
deduce: deduced
deduct: deducted
deduction: deduction
deed: deed,deeds
deep: deep,deepest
deeply: deeply
defect: defects
defence: defence
defenceless: defenceless
defend: defend,defended,defending
deference: deference
defiance: defiance
defiant: defiant
defiantly: defiantly
defile: defiled
define: defined
definite: definite
definition: definition
deform: deformed
degradation: degradation
degrade: degrade
degraded: degraded
degrading: degrading
degree: degree,degrees
deign: deigned,deigning
dejected: dejected
dejectedly: dejectedly
dejection: dejection
delay: delay,delayed
deliberate: deliberate,deliberating
deliberately: deliberately
deliberation: deliberation
delicacy: delicacy
delicate: delicate
delicately: delicately
delicious: delicious
delight: delight,delighted
delighted: delighted
delightful: delightful
delirious: delirious
delirium: delirium
deliver: delivered
deliverance: deliverance
delusion: delusions
demand: demand,demanded,demands
demonstration: demonstrations
demoralisation: demoralisation
den: den,dens
dense: dense,denser
deny: denied,deny,denying
depart: depart,departed,departing
department: department
departure: departure
depend: depend,depended,depending,depends
dependent: dependent
depose: depose
deposit: depositing
deposition: deposition
depraved: depraved
depravity: depravity
depressed: depressed
depression: depression
deprive: deprived,depriving
depth: depth
depths: depths
deputy: deputies
der: der
derange: deranged
derangement: derangement
derive: derive
descend: descend,descended,descending
description: description
descriptive: descriptive
desert: desert,deserted,deserting
deserted: deserted
deserve: deserve,deserves,deserving
deserving: deserving
design: design,designed,designs
desire: desire,desired,desires
desirous: desirous
despair: despair
despairing: despairing
despairingly: despairingly
despatch: despatched
desperate: desperate
desperately: desperately
desperation: desperation
despicable: despicable
despicably: despicably
despise: despise,despised,despises,despising
despot: despot
despotism: despotism
destine: destined
destiny: destinies,destiny
destitute: destitute
destitution: destitution
destroy: destroy,destroyed
destroyer: destroyers
destruction: destruction
detain: detain,detained
detect: detected
detective: detective
deter: deterred
deteriorate: deteriorated
determination: determination
determine: determine,determined,determining
determined: determined
detest: detest
detract: detract
deuce: deuce
develop: developed,developing,develops
developed: developed
development: development
device: device,devices
devil: devil
devote: devote,devoted
devoted: devoted
devotion: devotion
devour: devour,devoured,devouring
diagnose: diagnosed
diamond: diamond,diamonds
dictate: dictate,dictating
dictation: dictation
dictionary: dictionary
die: die,died,dies,dying
difference: difference,differences
difficult: difficult
difficulty: difficulties,difficulty
diffident: diffident
dig: digging,dug
digest: digest
dignified: dignified
dignity: dignity
dim: dim
dimension: dimensions
diminutive: diminutive
dimly: dimly
din: din
dine: dine,dined,dining
dining: dining
dinner: dinner,dinners
direct: direct,directed
direction: direction,directions
directress: directress
dirt: dirt
dirty: dirty
disappear: disappeared
disappointment: disappointment
disapproval: disapproval
disarm: disarm,disarmed,disarming
disaster: disaster
disavowal: disavowal
disbelieve: disbelieved
disbelieving: disbelieving
discharge: discharged
disciplinary: disciplinary
discolour: discoloured
discomfort: discomfort
disconcert: disconcert,disconcerted
disconcerted: disconcerted
disconnected: disconnected
discontentedly: discontentedly
discord: discord
discourse: discourse
discourteous: discourteous
discover: discover,discovered,discovering
discovery: discoveries
discuss: discuss,discusses,discussing
discussion: discussion,discussions
disdain: disdain,disdained,disdaining
disdainfully: disdainfully
disease: disease,diseases
disfigured: disfigured
disgrace: disgrace
disgraceful: disgraceful
disguise: disguise,disguised
disgust: disgust
disgusted: disgusted
disgusting: disgusting
disgustingly: disgustingly
dish: dish,dished,dishes
disheartening: disheartening
dishevelled: dishevelled
dishonest: dishonest
dishonour: dishonour
dishonourable: dishonourable
disillusion: disillusion,disillusioned
disillusioned: disillusioned
disinclined: disinclined
disinterestedly: disinterestedly
dislike: dislike,disliked,dislikes
dislocate: dislocated
dismay: dismay
dismiss: dismiss,dismissed
dismissal: dismissal
disobedient: disobedient
disobey: disobeyed
disorder: disorder
disordered: disordered
disorderly: disorderly
display: display,displayed
displease: displeased
displeased: displeased
displeasure: displeasure
disposal: disposal
dispose: dispose,disposed
disposed: disposed
disposition: disposition
disproportionate: disproportionate
disproportionately: disproportionately
dispute: dispute,disputing
disregard: disregarded,disregarding
disreputable: disreputable
disrespect: disrespect
disrespectful: disrespectful
dissembler: dissembler
dissension: dissension
dissenter: dissenter
dissolute: dissolute
distance: distance
distant: distant
distantly: distantly
distasteful: distasteful
distinct: distinct
distinctly: distinctly
distinguish: distinguish,distinguished
distinguished: distinguished
distinguishing: distinguishing
distort: distort,distorted
distorted: distorted
distortion: distortion
distract: distract
distracted: distracted
distractedly: distractedly
distraction: distraction
distraught: distraught
distress: distress,distressed
distressed: distressed
distressing: distressing
district: district
distrust: distrust
distrustfully: distrustfully
disturb: disturb,disturbing
disturbance: disturbance
disturbed: disturbed
disturbing: disturbing
divert: divert,diverted
divide: divided,dividing
divine: divine,divined
divinity: divinity
division: division
divorce: divorced
dizzy: dizzier,dizzy
doctor: doctor,doctors
doctrine: doctrine,doctrines
document: document,documents
documentary: documentary
dog: dog,dogging,dogs
doggedly: doggedly
doings: doings
domain: domain
domestic: domestic
donation: donation
door: door,doors
doorkeeper: doorkeeper
doorway: doorway
dormouse: dormouse
dost: dost
dostoevsky: dostoevsky
double: double
doubt: doubt,doubted,doubts
doubtfully: doubtfully
doubtless: doubtless
douche: douches
downcast: downcast
downhearted: downhearted
downright: downright
downstairs: downstairs
dowry: dowry
doze: dozed,dozing
dozen: dozen,dozens
drag: drag,dragged
drain: drained
dram: dram
draught: draught
draw: draw,drawing,drawn,drew
drawback: drawback
drawer: drawer,drawers
drawing: drawing
drawl: drawled,drawling
dray: dray
dread: dread,dreaded
dreaded: dreaded
dreadful: dreadful
dreadfully: dreadfully
dream: dream,dreamed,dreaming,dreams,dreamt
dreamer: dreamer
dreamily: dreamily
dreaminess: dreaminess
dreamy: dreamy
dreary: dreary
dregs: dregs
drench: drenched
dress: dress,dressed,dresses,dressing
dressed: dressed
dressing: dressing
dressmaker: dressmaker
drily: drily
drink: drank,drink,drinking,drinks
drinker: drinkers
drinking: drinking
drip: drip
drive: drive,driven,drives,driving,drove
driver: driver,drivers
drop: drop,dropped,dropping,drops
drown: drown,drowned,drowning
drowsiness: drowsiness
drowsy: drowsy
drubbing: drubbing
drudge: drudge
drum: drum
drunk: drunk
drunkard: drunkard,drunkards
drunken: drunken
drunkenness: drunkenness
dry: dried,dry,drying
dryly: dryly
dryness: dryness
du: du
dull: dull,dullest
dullard: dullards
dully: dully
dumb: dumb
dumbfounded: dumbfounded
dupe: duping
dusk: dusk
dust: dust
dusty: dustier,dusty
duty: duties,duty
dwell: dwelling
dying: dying
eager: eager
eagerly: eagerly
eagerness: eagerness
ear: ear,ears
earn: earn,earned
earnest: earnest
earnestly: earnestly
earnestness: earnestness
earnings: earnings
earth: earth
earthenware: earthenware
earthly: earthly
ease: ease
easily: easily
easter: easter
easy: easier,easiest,easy
eat: ate,eat,eaten,eating
eater: eater
eating: eating
ebb: ebb
eccentric: eccentric
echo: echoed
eclipse: eclipse
economic: economic
economy: economy
ecstasy: ecstasies,ecstasy
ecstatic: ecstatic
ecstatically: ecstatically
edge: edge,edged,edges,edging
edifying: edifying
editor: editor
educate: educated
educated: educated
education: education
efface: efface
effective: effective
effort: effort,efforts
effusion: effusions
egg: egg
eggshell: eggshells
egoist: egoist
egypt: egypt
egyptian: egyptian
eighteen: eighteen
ejaculate: ejaculated
ejaculation: ejaculations
elaborate: elaborate
elapse: elapse
elbow: elbow,elbows
eld: eldest
elder: elder
elderly: elderly
elect: elect,elected
elegant: elegant
element: element,elements
elementary: elementary
eleventh: eleventh
eliminate: eliminate
elle: elle
elope: elope
eloquence: eloquence
elude: eluded
emaciated: emaciated
emancipation: emancipation
embankment: embankment
embarrassed: embarrassed
embarrassing: embarrassing
embarrassment: embarrassment
embassy: embassy
ember: ember
embrace: embrace,embraced,embracing
embroider: embroidered,embroiders
embryo: embryo
emergency: emergency
emigrate: emigrate
emotion: emotion
emotional: emotional
emphasis: emphasis
emphasise: emphasise,emphasising
emphatic: emphatic
emphatically: emphatically
employ: employed
employment: employment
en: en
enable: enable
enamel: enamelled
enchanted: enchanted
encourage: encourage,encouraged
endeavour: endeavoured
endless: endless
endow: endowed
endurance: endurance
endure: endure,endured
enemy: enemies,enemy
energy: energies,energy
engage: engage,engaged,engaging
engaged: engaged
engagement: engagement
engineering: engineering
england: england
english: english
englishmen: englishmen
engrave: engraved
enigmatic: enigmatic
enigmatically: enigmatically
enjoy: enjoy,enjoyed
enjoyment: enjoyment
enlarge: enlarge,enlarged,enlarging
enlightened: enlightened
enlightenment: enlightenment
ennoble: ennobled
enormously: enormously
enrage: enrage,enraged
enraged: enraged
ensure: ensure
enter: enter,entered,entering
enterprise: enterprise
entertain: entertain,entertained,entertaining
entertainment: entertainment
enthusiasm: enthusiasm
enthusiastically: enthusiastically
entrails: entrails
entrance: entrance,entrances
entreat: entreat,entreating
entreaty: entreaties,entreaty
entrust: entrusted
entry: entry
envious: envious
environment: environment
ephemeral: ephemeral
epilepsy: epilepsy
epileptic: epileptic
epilogue: epilogue
episode: episodes
epithet: epithet
epoch: epoch
equal: equal
equality: equality
equivalent: equivalent
eradicate: eradicate
err: err
errand: errand
error: error
escape: escape,escaped,escaping
escort: escort,escorting
especial: especial
essay: essays
essence: essence
essential: essential,essentials
essentially: essentially
est: est
establish: establish,established,establishing
establishment: establishment,establishments
estate: estate
esteem: esteem,esteems
esteeming: esteeming
estimable: estimable
estrange: estrange
eternal: eternal
eternity: eternity
etiquette: etiquette
europe: europe
european: european
evasiveness: evasiveness
eve: eve
evening: evening,evenings
event: event,events
everlasting: everlasting
everlastingly: everlastingly
everyday: everyday
evidence: evidence
evident: evident
evidently: evidently
evil: evil,evils
exact: exact
exactitude: exactitude
exactness: exactness
exaggerate: exaggerate,exaggerated,exaggerating
exaggerated: exaggerated
exalt: exalted
examination: examination,examinations
examine: examine,examined,examining
exasperate: exasperated
exasperated: exasperated
exasperation: exasperation
exceed: exceed,exceeds
exceedingly: exceedingly
excellency: excellency
excellent: excellent
exception: exception
exceptional: exceptional
exceptionally: exceptionally
exceptionalness: exceptionalness
excessive: excessive
excessively: excessively
exchange: exchange,exchanged,exchanging
excite: excite,excited,excites
excited: excited
excitement: excitement
exciting: exciting
exclaim: exclaimed,exclaiming
exclamation: exclamation,exclamations
exclude: excluded
exclusively: exclusively
excusable: excusable
excuse: excuse,excuses
execute: executed,executing
execution: execution
exemplary: exemplary
exempt: exempt
exercise: exercise
exert: exert
exertion: exertions
exhaust: exhausted
exhausted: exhausted
exhaustion: exhaustion
exhibit: exhibit,exhibited
exhilarate: exhilarated
exhilarated: exhilarated
exhortation: exhortations
exile: exiles
exist: exist,existed,existing,exists
existence: existence
expand: expand
expect: expect,expected,expecting,expects
expectation: expectation,expectations
expedition: expedition
expense: expense,expenses
expensive: expensive
experience: experience,experienced,experiences
experienced: experienced
experiment: experiment,experiments
expiate: expiate,expiating
expiation: expiation
explain: explain,explained,explaining
explanation: explanation,explanations
exploit: exploit
explosion: explosion
explosive: explosive
expose: expose
expostulate: expostulating
exposure: exposure
expound: expound,expounding
express: express,expressed,expresses,expressing
expression: expression,expressions
expressive: expressive
expressively: expressively
expressly: expressly
exquisite: exquisite
extend: extended
extent: extent
extenuate: extenuating
exterior: exterior
external: external
externally: externally
extinguish: extinguished
extract: extracts
extraordinarily: extraordinarily
extraordinary: extraordinary
extreme: extreme,extremes
extremely: extremely
extremity: extremity
eye: eye,eyes
eyebrow: eyebrows
eyed: eyed
eyelash: eyelashes
eyelid: eyelids
faced: faced
facilitate: facilitate
faculty: faculties,faculty
fade: faded,fading
fail: fail,failed,failing,fails
failing: failings
failure: failure,failures
faint: faint,fainted,faintest,fainting
fainting: fainting
faintly: faintly
faintness: faintness
fair: fair,fairest
fairy: fairy
faith: faith
faithful: faithful
faithfully: faithfully
fall: fall,fallen,falling,falls,fell
fallen: fallen
false: false
falsehood: falsehood
falsetto: falsetto
falsity: falsity
falter: faltered,faltering
falteringly: falteringly
familiar: familiar
familiarise: familiarised
familiarity: familiarity
family: families,family
famine: famine
famous: famous
fanaticism: fanaticism
fancied: fancied
fanciful: fanciful
fancy: fancied,fancies,fancy,fancying
fantastic: fantastic
fantasy: fantasy
farce: farce
fare: fare,fared,fares
farewell: farewell
farthing: farthing,farthings
fascinate: fascinate,fascinated
fascinated: fascinated
fascinating: fascinating
fascination: fascination
fashion: fashion
fashionable: fashionable
fashionably: fashionably
fashioned: fashioned
fast: fast,fastest
fasten: fasten,fastened,fastening
fastening: fastening
fastidiousness: fastidiousness
fasting: fasting
fat: fat
fatal: fatal
fate: fate
fateful: fateful
father: father
fatherless: fatherless
fatigue: fatigue,fatiguing
fatness: fatness
fattish: fattish
fatuity: fatuity
fault: fault
favour: favour
favourable: favourable
favourite: favourite
fawn: fawn,fawned,fawning
fear: fear,feared,fearing,fears
fearful: fearful
fearfully: fearfully
feast: feast
feather: feather
feature: feature,features
fee: fee,fees
feeble: feeble,feebler
feebly: feebly
feed: fed,feed
feeding: feeding
feel: feel,feeling,feels
feeling: feeling,feelings
feign: feign
feigned: feigned
felicitous: felicitous
fellow: fellow,fellows
fellowship: fellowship
female: female
feminine: feminine
fence: fence,fenced,fences
ferment: fermenting
ferocious: ferocious
ferociously: ferociously
ferocity: ferocity
fervent: fervent
fervently: fervently
fervour: fervour
festive: festive
festivity: festivity
fetch: fetch,fetched,fetching
fetter: fetters
fever: fever
feverish: feverish
feverishly: feverishly
fib: fibbing
fidelity: fidelity
fidget: fidget,fidgeted,fidgeting
fie: fie
field: field
fiend: fiend
fiendish: fiendish
fiercely: fiercely
fifteenth: fifteenth
fifthly: fifthly
fight: fight,fighting,fought
fighting: fighting
figure: figure,figures
filigree: filigree
filth: filth
filthiness: filthiness
filthy: filthy
final: final
finally: finally
financial: financial
finding: finding
fine: fine
finery: finery
finger: finger,fingers
finish: finish,finished,finishing
finn: finn
finnish: finnish
firm: firm,firmer
firmly: firmly
firmness: firmness
fish: fish,fishes
fist: fist,fists
fit: fit,fits,fitted,fitting
fitting: fitting
fixed: fixed
fixedly: fixedly
flabby: flabby
flag: flag,flagging
flagrant: flagrant
flame: flame,flames
flannel: flannel
flap: flapping
flare: flaring
flash: flash,flashed,flashes,flashing
flat: flat,flats,flatter
flatly: flatly
flatter: flattered
flatterer: flatterers
flattering: flattering
flattery: flattery
flaw: flaw
flaxen: flaxen
fleck: flecked
fleeting: fleeting
fleetingly: fleetingly
flesh: flesh
fleshly: fleshly
fleshy: fleshy
flicker: flickering
flight: flight,flights
flighty: flighty
flinch: flinch,flinching
fling: fling,flinging,flung
flint: flint
float: float,floated,floating
flock: flocks
flog: flog
flood: flood,flooded,flooding
floor: floor,floors
flop: flop
flour: flour
flow: flow,flowed,flowing,flows
flower: flower,flowers
fluently: fluently
flung: flung
flunkey: flunkey
flush: flush,flushed,flushes,flushing
flustered: flustered
flutter: flutter,fluttered
fly: flew,flies,flown,fly,flying
foam: foam
fog: fog
fogey: fogeys
fold: fold,folded,folding
foliage: foliage
folk: folk,folks
follow: follow
folly: folly
fond: fond
fondly: fondly
foo: foo
food: food
fool: fool,fools
foolish: foolish
foolishly: foolishly
foolishness: foolishness
foot: feet,foot
footing: footing
footman: footman
footstep: footsteps
foppish: foppish
forasmuch: forasmuch
forbid: forbid,forbidden
force: force,forced,forcing
forcibly: forcibly
fore: fore
foreboding: foreboding
forehead: forehead
foreign: foreign
foreigner: foreigner,foreigners
foremost: foremost
foresee: foresaw,foresee,foreseeing,foreseen
forest: forest,forests
foretaste: foretaste
foretell: foretold
forfeit: forfeit
forge: forge,forging
forget: forget,forgets,forgetting,forgot,forgotten
forgetful: forgetful
forgetfulness: forgetfulness
forgive: forgive,forgiven
forgiveness: forgiveness
fork: forks
form: form,formed,forming,forms
formal: formal
formality: formalities,formality
formally: formally
formidable: formidable
forsake: forsaken
fortitude: fortitude
fortnight: fortnight
fortress: fortress
fortunate: fortunate
fortunately: fortunately
fortune: fortune,fortunes
forwards: forwards
foundation: foundation,foundations
fount: fount
fountain: fountains
fourier: fourier
fourteen: fourteen
fourth: fourth
fourthly: fourthly
fraction: fraction
fracture: fractured
fragment: fragments
fragrant: fragrant
frail: frail
frame: frame,frames
framework: framework
france: france
frank: frankest
frankly: frankly
frankness: frankness
frantic: frantic
frantically: frantically
fray: fray,frayed
freedom: freedom
freely: freely
freeze: froze
french: french
frenchman: frenchman
frenzied: frenzied
frenzy: frenzy
frequent: frequent,frequented
frequently: frequently
fresh: fresh,fresher
freshen: freshen
freshly: freshly
freshness: freshness
fret: fretted,fretting
friend: friend,friends
friendliness: friendliness
friendly: friendly
friendship: friendship
fright: fright
frighten: frighten,frightened,frightens
frightened: frightened
frightening: frightening
frightful: frightful
frill: frill
fringe: fringe
frivolous: frivolous
fro: fro
frock: frock
frost: frost
frown: frown,frowned,frowning
frowned: frowned
fruit: fruits
fry: frying
frying: frying
fuel: fuel
fulfil: fulfil
fulfilment: fulfilment
fullness: fullness
fumble: fumbled,fumbling
fume: fumes,fuming
fun: fun
fund: funds
fundamental: fundamental
fundamentally: fundamentally
funeral: funeral
funk: funk
funniest: funniest
funny: funny
fur: fur
furious: furious
furiously: furiously
furnish: furnished
furnished: furnished
furnishing: furnishing
furniture: furniture
fury: fury
fuss: fuss
fussily: fussily
future: future
gabble: gabbled
gaily: gaily
gain: gain,gained,gaining
gait: gait
gallery: gallery
galling: galling
gallop: gallop,galloping
gambler: gambler
game: game
gang: gang
gape: gape,gaping
garden: garden,gardens
garment: garment,garments
garnett: garnett
garret: garret
gash: gashed
gasp: gasp,gasped,gasping,gasps
gate: gate,gates
gateway: gateway
gather: gather,gathered
gathering: gathering,gatherings
gaudy: gaudy
gawky: gawky
gay: gay
gaze: gaze,gazed,gazing
generation: generation
generosity: generosity
generous: generous
generously: generously
genial: genial
genially: genially
genius: genius,geniuses
genteel: genteel
genteelly: genteelly
gentility: gentility
gentle: gentle
gentlefolk: gentlefolk
gentleman: gentleman,gentlemen
gentlemanly: gentlemanly
gentleness: gentleness
gentlewoman: gentlewoman
gently: gently
genuine: genuine
genuinely: genuinely
geography: geography
geranium: geraniums
german: german,germans
gesticulate: gesticulating
gesticulation: gesticulations
gesture: gesture,gestures
ghost: ghosts
ghostly: ghostly
giant: giant
gibe: gibing
giddiness: giddiness
giddy: giddy
gift: gift,gifts
gigantic: gigantic
giggle: giggle,giggles
gingerbread: gingerbread
girl: girl,girls
glad: glad
glance: glance,glanced,glances,glancing
glaring: glaring
glass: glass,glasses
glassful: glassful
gleam: gleam,gleamed
glee: glee
gleefully: gleefully
glimpse: glimpse
glisten: glistened
glitter: glittered,glittering
gloat: gloated,gloating
globe: globe
gloomily: gloomily
gloomy: gloomy
glory: glory
glove: gloves
glow: glow,glowed,glowing
glowing: glowing
glutton: glutton
gnaw: gnawing
goal: goal
goatskin: goatskin
god: god
godless: godless
gold: gold
golden: golden
golgotha: golgotha
goodness: goodness
goodwill: goodwill
goose: goose
gorgeous: gorgeous
gospel: gospel
gossip: gossip,gossiping
gourmand: gourmand
governess: governess
government: government
governor: governor
governorship: governorship
gown: gown,gowns
grace: grace
graceful: graceful
gracious: gracious
graciously: graciously
grade: grades
gradual: gradual
gradually: gradually
grain: grain
grammar: grammar
grand: grand
grandiloquent: grandiloquent
grandmother: grandmother
granite: granite
grant: grant,granted
grasp: grasp,grasped,grasping
grass: grass
grate: grating
grateful: grateful
gratified: gratified
gratify: gratified,gratify
gratitude: gratitude
grave: grave,graver,gravest
gravely: gravely
graveyard: graveyard
gravity: gravity
graze: grazed
grease: grease
greasy: greasy
greatcoat: greatcoat
greatly: greatly
greedily: greedily
greediness: greediness
greek: greek
green: green
greenish: greenish
greenness: greenness
greet: greet,greeted,greeting
greeting: greeting
grey: grey
greyish: greyish
grief: grief
grieve: grieve,grieved
grieving: grieving
grime: grime
grimly: grimly
grimy: grimy
grin: grin,grinned
grind: grinding,ground
grinder: grinder,grinders
grip: grip,gripped,gripping
grit: gritting
grizzled: grizzled
groan: groan,groaned,groaning
gross: gross
grossly: grossly
grotesque: grotesque
ground: ground
groundlessness: groundlessness
grounds: grounds
grouse: grouse
grovel: grovelling
grow: grew,grow,growing,grown,grows
grown: grown
grudge: grudged
gruffly: gruffly
grumble: grumbled
guard: guard
guardian: guardian
guerre: guerre
guess: guess,guessed,guessing
guest: guest,guests
guffaw: guffaw,guffawed,guffawing
guidance: guidance
guide: guiding
guilt: guilt
guilty: guilty
guitar: guitar
gulf: gulf
gulp: gulped,gulping,gulps
gurgle: gurgling
gush: gushed
gutter: gutter
guttural: guttural
guzzle: guzzling
gymnasium: gymnasium
ha: ha
habit: habit,habits
habitual: habitual
hack: hack
hadst: hadst
hag: hag
hail: hail
hair: hair
hairdresser: hairdresser
haired: haired
halfpenny: halfpenny
halfway: halfway
hall: hall
hallucination: hallucination
halt: halt,halted
hamlet: hamlet
hammer: hammering
hand: hand,handed,handing,hands
handed: handed
handful: handful
handkerchief: handkerchief,handkerchiefs
handle: handle
handsome: handsome
handwriting: handwriting
hang: hang,hanged,hanging,hung
hanging: hangings
hapless: hapless
happen: happen,happened,happening
happily: happily
happiness: happiness
happy: happier,happiest,happy
harangue: harangue
harass: harassed,harassing
harbour: harbour
hard: hard,harder,hardest
harden: harden,hardened
hardship: hardship,hardships
hardworking: hardworking
hare: hare,hares
harlot: harlot
harm: harm
harmful: harmful
harmless: harmless
harmoniously: harmoniously
harmony: harmony
harness: harnessed
harp: harping
harpy: harpy
harsh: harsh
harshly: harshly
hash: hash
hast: hast
haste: haste
hasten: hasten,hastened,hastening
hastily: hastily
hasty: hasty
hat: hat,hats
hatch: hatched,hatching
hate: hate,hated
hateful: hateful
hatred: hatred
hatter: hatter
haughtily: haughtily
haughtiness: haughtiness
haughty: haughty
haul: hauled
haunch: haunches
haunt: haunt,haunted,haunts
hay: hay
head: head,headed,heads
headdress: headdress
headed: headed
headgear: headgear
headlong: headlong
headstrong: headstrong
health: health
healthy: healthy
heap: heap,heaped
hear: hear,heard,hearing,hears
hearing: hearing
heart: heart,hearts
hearted: hearted
heartfelt: heartfelt
heartily: heartily
heartless: heartless
heartrending: heartrending
heat: heat
heave: heaved
heaven: heaven,heavens
heavenly: heavenly
heavily: heavily
heaving: heaving
heavy: heavy
hectic: hectic
heed: heeding
heedless: heedless
heedlessly: heedlessly
heedlessness: heedlessness
heel: heels
height: height
helmet: helmet
helpless: helpless
helplessly: helplessly
helplessness: helplessness
hem: hem,hemmed
hempen: hempen
hen: hen
herewith: herewith
hermit: hermit
heroic: heroic
heroism: heroism
herring: herrings
hesitate: hesitate,hesitated,hesitating
hesitatingly: hesitatingly
hesitation: hesitation
hey: hey
hidden: hidden
hide: hidden,hide,hides,hiding
hideous: hideous
hideously: hideously
hideousness: hideousness
hiding: hiding
highly: highly
hill: hill
hinder: hinder,hindered,hindering
hindrance: hindrance
hint: hint,hinted,hinting,hints
hip: hips
hire: hired
historical: historical
history: histories,history
hit: hit,hitting
hitch: hitch
hitherto: hitherto
ho: ho
hoarding: hoarding
hoarse: hoarse
hold: held,hold,holding,holds
hole: hole,holes
holiday: holiday,holidays
hollow: hollow
holstein: holstein
holy: holy
homage: homage
homewards: homewards
homicidal: homicidal
honest: honest
honestly: honestly
honesty: honesty
honey: honey
honour: honour,honoured,honours
honourable: honourable
honoured: honoured
hood: hood
hoof: hoof,hoofs
hook: hook,hooked,hooks
hope: hope,hoped,hopes,hoping
hopeless: hopeless
hopelessly: hopelessly
hopelessness: hopelessness
horizon: horizon
horizontally: horizontally
horn: horn
horrible: horrible
horribly: horribly
horrid: horrid
horrified: horrified
horrify: horrified
horror: horror,horrors
horse: horse,horses
horseback: horseback
hospital: hospital,hospitals
hospitality: hospitality
host: host
hostile: hostile
hostility: hostility
hot: hot
hotel: hotel
hotly: hotly
hour: hour,hours
house: house,houses
household: household
hover: hovering
howl: howled,howling
huckster: huckster
huddle: huddled
huffily: huffily
hug: hug,hugged,hugging,hugs
huge: huge
hullo: hullo
hulloa: hulloa
hum: hummed,humming
human: human
humane: humane
humanity: humanity
humble: humble,humbled
humbly: humbly
humbugging: humbugging
humiliate: humiliate,humiliated
humiliating: humiliating
humiliation: humiliation
humility: humility
humour: humour,humoured
humoured: humoured
hunchback: hunchback
hundredth: hundredth
hundredweight: hundredweight
hunger: hunger
hungering: hungering
hungry: hungry
hunt: hunted,hunting
hunter: hunter
hurrah: hurrah
hurricane: hurricane
hurried: hurried
hurriedly: hurriedly
hurry: hurried,hurry,hurrying
hurt: hurt,hurting,hurts
husband: husband,husbands
hush: hush,hushed,hushing
huskily: huskily
husky: husky
hussar: hussar
hussy: hussy
hypochondria: hypochondria
hypochondriac: hypochondriac
hypochondriacal: hypochondriacal
hypocrisy: hypocrisy
hypothesis: hypothesis
hysteric: hysterics
hysterical: hysterical
hysterically: hysterically
ice: ice
ich: ich
icy: icy
idea: idea,ideas
ideal: ideals
idealism: idealism
idealist: idealist
idiocy: idiocy
idiot: idiot,idiots
idiotic: idiotic
idiotically: idiotically
idle: idle
idleness: idleness
idly: idly
ignominy: ignominy
ignorance: ignorance
ignorant: ignorant
iii: iii
ikon: ikon,ikons
illness: illness,illnesses
ilya: ilya
image: image,images
imaginary: imaginary
imagination: imagination
imagine: imagine,imagined,imagines,imagining
imbecile: imbecile
imbecility: imbecility
imbibe: imbibed
immeasurable: immeasurable
immeasurably: immeasurably
immemorial: immemorial
immense: immense
imminent: imminent
immoderate: immoderate
immovable: immovable
immovably: immovably
imp: imps
impartially: impartially
impatience: impatience
impatient: impatient
impatiently: impatiently
impel: impelled
imperative: imperative
imperious: imperious
imperiously: imperiously
impertinence: impertinence
impertinent: impertinent
impetuously: impetuously
implicit: implicit
implore: implored,imploring
imploringly: imploringly
imply: implied
impose: impose,imposed,imposing
impossibility: impossibility
impossible: impossible
impotence: impotence
impracticality: impracticality
impress: impress,impressed,impresses
impressed: impressed
impression: impression,impressions
impressionable: impressionable
impressive: impressive
impressively: impressively
imprisonment: imprisonment
impromptu: impromptu
improve: improve,improved
improvement: improvement,improvements
imprudently: imprudently
impudence: impudence
impudent: impudent
impudently: impudently
impulse: impulse,impulses
impulsiveness: impulsiveness
impunity: impunity
inappropriately: inappropriately
inarticulately: inarticulately
inartistic: inartistic
inattention: inattention
inattentive: inattentive
inaudibly: inaudibly
incapable: incapable
incautious: incautious
incautiously: incautiously
incense: incense
incensed: incensed
incessant: incessant
incessantly: incessantly
inch: inch,inches
incident: incident,incidents
incidentally: incidentally
incitement: incitement
inclination: inclination
incline: inclined
include: including
incognito: incognito
incoherence: incoherence
incoherent: incoherent
incoherently: incoherently
incomparably: incomparably
incompatible: incompatible
incomplete: incomplete
inconceivable: inconceivable
incongruity: incongruity
incongruous: incongruous
incontestably: incontestably
inconvenience: inconvenience
inconvenient: inconvenient
incorrect: incorrect
incorruptible: incorruptible
increase: increase,increased,increasing
incredible: incredible
incredibly: incredibly
incredulity: incredulity
incredulous: incredulous
indebt: indebted
indebted: indebted
indecision: indecision
indecorous: indecorous
indecorously: indecorously
indefinitely: indefinitely
indelible: indelible
indelicate: indelicate
independence: independence
independent: independent
independently: independently
indescribable: indescribable
india: india
indication: indications
indifference: indifference
indifferent: indifferent
indifferently: indifferently
indignant: indignant
indignantly: indignantly
indignation: indignation
indirectly: indirectly
indiscretion: indiscretion
indiscriminately: indiscriminately
indispensable: indispensable
indistinct: indistinct
indistinctly: indistinctly
indistinguishable: indistinguishable
individual: individual
individualism: individualism
indoor: indoor
induce: induce,induced
inducement: inducements
indulgence: indulgence
industrious: industrious
ineptitude: ineptitude
inequality: inequality
ineradicable: ineradicable
inevitable: inevitable
inevitably: inevitably
inexperience: inexperience
inexperienced: inexperienced
inexplicable: inexplicable
inexpressibly: inexpressibly
infallible: infallible
infamous: infamous
infamy: infamies,infamy
infantry: infantry
infatuation: infatuation
infect: infected
infection: infection
infectious: infectious
inferior: inferior
inferiority: inferiority
infidel: infidel,infidels
infidelity: infidelity
infinite: infinite
infinitely: infinitely
infinitesimal: infinitesimal
inflamed: inflamed
inflammation: inflammation
inflate: inflated
inflict: inflicted,inflicting
influence: influence,influenced,influences,influencing
inform: inform,informed
infrequent: infrequent
infrequently: infrequently
infuriate: infuriated
ingenious: ingenious
ingenuously: ingenuously
ingratitude: ingratitude
inhabit: inhabited
inherit: inheriting
inhumanly: inhumanly
iniquity: iniquity
initial: initial
initiation: initiation
injure: injure,injured
injured: injured
injurious: injurious
injury: injury
inkling: inkling
inkpot: inkpot
inmate: inmates
innate: innate
innkeeper: innkeeper
innocence: innocence
innocent: innocent
innumerable: innumerable
inquest: inquest
inquire: inquire,inquired,inquiring
inquiring: inquiring
inquiringly: inquiringly
inquiry: inquiries,inquiry
inquisitive: inquisitive
inquisitively: inquisitively
insane: insane
insanity: insanity
insatiable: insatiable
inscribe: inscribed
insect: insect
insensibility: insensibility
insight: insight
insignificance: insignificance
insignificant: insignificant
insinuate: insinuating
insinuation: insinuation,insinuations
insist: insist,insisted,insists
insistence: insistence
insistent: insistent
insistently: insistently
insolence: insolence
insolent: insolent
insolently: insolently
inspire: inspired
instalment: instalment
instance: instance,instances
instant: instant
instantaneously: instantaneously
instantly: instantly
instigation: instigation
instigator: instigator
instinct: instinct
instinctive: instinctive
instinctively: instinctively
institution: institution,institutions
instruct: instruct
instruction: instruction,instructions
insufferable: insufferable
insufferably: insufferably
insult: insult,insulted,insulting,insults
insulting: insulting
insure: insured
insurmountable: insurmountable
integral: integral
intellect: intellect
intellectual: intellectual
intellectually: intellectually
intelligence: intelligence
intelligent: intelligent
intelligible: intelligible
intend: intend,intended,intending
intense: intense
intensely: intensely
intensity: intensity
intent: intent
intention: intention,intentioned,intentions
intentional: intentional
intentionally: intentionally
intently: intently
interfere: interfere,interfered
interpose: interpose,interposed
interpret: interpret,interpreted
interpretation: interpretation
interrogate: interrogated
interrogation: interrogations
interrogator: interrogator
interrupt: interrupt,interrupted,interrupting
interrupted: interrupted
interruption: interruptions
intersperse: interspersing
interval: interval,intervals
intervene: intervened,intervening
interview: interview,interviews
intimacy: intimacy
intimate: intimate
intimidate: intimidated
intolerable: intolerable
intonation: intonation
intrigue: intrigue
intriguing: intriguing
introduce: introduce,introduced,introduces,introducing
introduction: introduction
intrude: intrude
intrusive: intrusive
invalid: invalid
invaluable: invaluable
invariably: invariably
invent: invent,invented,invents
investigate: investigate,investigated,investigating
investigation: investigation,investigations
investigator: investigators
inveterate: inveterate
invitation: invitation
invite: invite,invited,inviting
involuntarily: involuntarily
involuntary: involuntary
involve: involved,involving
inwardly: inwardly
iou: iou
irksome: irksome
iron: iron
ironical: ironical
ironically: ironically
irony: irony
irrational: irrational
irrefutable: irrefutable
irregular: irregular
irregularity: irregularity
irrelevant: irrelevant
irreproachable: irreproachable
irresistible: irresistible
irresistibly: irresistibly
irresponsible: irresponsible
irrevocable: irrevocable
irrevocably: irrevocably
irritability: irritability
irritable: irritable
irritably: irritably
irritate: irritate,irritating
irritated: irritated
irritating: irritating
irritation: irritation
island: island,islands
islands: islands
isolate: isolated
isolation: isolation
issue: issued,issuing
item: item,items
iv: iv
ivan: ivan
ivory: ivory
jack: jack
jacket: jacket
jam: jam
jamaica: jamaica
january: january
jar: jar
jargon: jargon
jaundice: jaundice
jauntily: jauntily
jaunty: jaunty
jealous: jealous
jealously: jealously
jealousy: jealousy
jeer: jeer,jeered,jeering
jeering: jeering
jeeringly: jeeringly
jelly: jelly
jerk: jerked
jerkily: jerkily
jerky: jerky
jerusalem: jerusalem
jest: jest
jesuitical: jesuitical
jesus: jesus
jew: jew
jewel: jewel,jewels
jeweler: jeweler
jeweller: jeweller
jewellery: jewellery
jewish: jewish
jews: jews
jingle: jingling
job: job,jobs
jog: jog
johann: johann
john: john
joke: joke,jokes,joking
jolly: jolly
jostle: jostled,jostling
journal: journal
journalist: journalist
journey: journey
journeyman: journeyman
jove: jove
jovial: jovial
joy: joy
joyful: joyful
judge: judge,judged,judges,judging
judgment: judgment
judy: judy
jug: jug
july: july
jump: jump,jumped,jumping
june: june
jury: juries
juster: juster
justice: justice
justifiable: justifiable
justification: justification
justified: justified
justify: justify
justly: justly
juxtaposition: juxtaposition
karl: karl
keen: keen
keenly: keenly
keeper: keeper,keepers
keeping: keeping
keepsake: keepsake
kerchief: kerchief
key: key
keyhole: keyhole
kick: kick,kicking
kill: kill,killed,killing
killer: killer
kiln: kiln,kilns
kindle: kindle,kindled
kindliness: kindliness
kindly: kindly
kindness: kindness
king: king
kingdom: kingdom
kiss: kiss,kissed,kisses,kissing
kissing: kissing
kitchen: kitchen,kitchens
knack: knacks
knave: knave,knaves
knee: knee,knees
kneel: kneel,kneeling,knelt
knick: knick
knife: knife,knives
knit: knits,knitted,knitting
knock: knock,knocked,knocking,knocks
knot: knot,knotted
knowledge: knowledge
koch: koch
labour: labour
lace: lace
lachrymose: lachrymose
lack: lack
lad: lads
laden: laden
lady: ladies,lady
lagging: lagging
lamb: lamb
lame: lame
lament: lamenting
lamp: lamp
lamplight: lamplight
lamps: lamps
land: land
landing: landing
landlady: landlady
landlord: landlord
landowner: landowner
landscape: landscape
language: language,languages
languid: languid
languidly: languidly
lanky: lanky
lantern: lantern
lash: lash,lashed
latch: latch,latched
late: late
laugh: laugh,laughed,laughing,laughs
laughter: laughter
launch: launched
laundry: laundry
lavender: lavender
lavish: lavish,lavished
law: law,laws
lawful: lawful
lawgiver: lawgiver
lawyer: lawyer,lawyers
lay: laid,lay,laying
lazarus: lazarus
lazily: lazily
laziness: laziness
lazy: lazy
le: le
lead: lead,leading,leads,led
leaden: leaden
leader: leaders
leaf: leaf
lean: leaned,leaning
leap: leap,leaped,leaping,leapt
leapt: leapt
learn: learn,learned,learning,learns,learnt
learning: learning
leather: leather
leave: leave,leaves,leaving,left
lecture: lectures
lecturer: lecturer
ledge: ledge
left: left
leg: leg,legs
legacy: legacy
legal: legal
legality: legality
legally: legally
legend: legend
legibly: legibly
legion: legion
legislator: legislators
legitimate: legitimate
lemon: lemon
lend: lend,lent
lent: lent
les: les
lessen: lessen
lessening: lessening
lesson: lesson,lessons
lessons: lessons
lethargy: lethargy
lett: lett
letter: letter,letters
level: level
liable: liable
liar: liar
libel: libel
liberal: liberal
liberalism: liberalism
liberality: liberality
liberty: liberty
lice: lice
licence: licence
license: license
lick: licking
lid: lid,lids
lida: lida
lie: lie,lied,lies,lying
lieutenant: lieutenant
life: life,lives
lifeless: lifeless
lifetime: lifetime
lift: lift,lifted,lifting
light: light,lighted,lighter,lightest,lighting,lights
lighted: lighted
lighten: lightened
lightheaded: lightheaded
lighthearted: lighthearted
lightly: lightly
lightning: lightning
likes: likes
liking: liking
lilac: lilac
limb: limb,limbs
limit: limit,limits
linen: linen
linger: linger,lingered,lingering
lining: lining
lip: lip,lips
liquor: liquor
lisbon: lisbon
lisp: lisp
listen: listen,listened,listening,listens
listener: listener,listeners
listless: listless
listlessly: listlessly
listlessness: listlessness
literally: literally
literary: literary
literature: literature
litigation: litigation
litter: littered
live: live,lived,lives,living
livelihood: livelihood
liveliness: liveliness
lively: lively
liveth: liveth
living: living
load: load,loaded
loaf: loaf
loan: loan
loathe: loathe,loathed
loathing: loathing
loathsome: loathsome
loathsomeness: loathsomeness
lobster: lobster
locality: locality
lock: lock,locked,locking,locks
locksmith: locksmiths
lodge: lodge,lodged,lodges
lodger: lodger,lodgers
lodging: lodging
lodgings: lodgings
loftily: loftily
lofty: lofty
log: log,logs
logic: logic
logical: logical
logically: logically
lonely: lonelier
longing: longing
loop: loop
loose: loose
lord: lord
lords: lords
lose: lose,losing,lost
loss: loss
lost: lost
lot: lot,lots
lottery: lottery
loud: loud,louder
loudly: loudly
loudness: loudness
lounge: lounging
louse: louse
love: love,loved,loves,loving
loved: loved
lover: lover
luck: luck
luckily: luckily
luckless: luckless
lucky: lucky
luggage: luggage
lullaby: lullaby
lump: lump,lumps
lunatic: lunatic
lunch: lunch
lung: lungs
lurch: lurched
lust: lusts
lustreless: lustreless
luxurious: luxurious
luxury: luxuries,luxury
lying: lying
lymph: lymph
mack: mack
mad: mad,madder
madam: madam
madame: madame
madden: maddened
madeira: madeira
mademoiselle: mademoiselle
madhouse: madhouse
madman: madman,madmen
madness: madness
madonna: madonna
madwoman: madwoman
magazine: magazine,magazines
magnanimity: magnanimity
magnanimous: magnanimous
magnificent: magnificent
mahomet: mahomet
maid: maid
maiden: maiden
maidish: maidish
maidservant: maidservants
mail: mail
main: main
mainland: mainland
maintain: maintain,maintained
majestic: majestic
majesty: majesty
major: major
majority: majority
maker: maker
malaya: malaya
male: male
malice: malice
malicious: malicious
maliciously: maliciously
malignance: malignance
malignant: malignant
malignantly: malignantly
mamma: mamma
mammy: mammy
manage: manage,managed,managing
mane: manes
mangy: mangy
mania: mania
maniac: maniac,maniacs
manifestation: manifestations
mankind: mankind
manly: manly
manner: manner
mannered: mannered
manners: manners
manoeuvre: manoeuvre
mantle: mantle
manual: manuals
manuscript: manuscript,manuscripts
marble: marble
march: march
mare: mare
maria: maria
mark: mark,marked,marking,marks
marked: marked
market: market
marriage: marriage,marriages
married: married
marry: married,marry,marrying
mars: mars
marshal: marshal
martha: martha
martyrdom: martyrdom
marvel: marvelled
mary: mary
mask: mask
mass: mass,masses
massacre: massacre
massive: massive
master: master,mastered
masterful: masterful
masterly: masterly
mastery: mastery
match: match,matches
mate: mates
material: material,materials
mathematical: mathematical
mathematically: mathematically
mathematics: mathematics
matter: matter,matters
mature: matured
maturer: maturer
maturity: maturity
maurice: maurice
mawkish: mawkish
mazurka: mazurka
meadow: meadows
meal: meal,meals
meaning: meaning
meaningless: meaningless
meanness: meanness
measure: measure,measured,measures,measuring
meat: meat
mechanic: mechanics
mechanically: mechanically
medal: medal
meddle: meddle,meddling
mediation: mediation
medical: medical
medicine: medicine
meditate: meditate,meditating
meditation: meditation
meditatively: meditatively
medium: medium
meek: meek
meekly: meekly
meekness: meekness
meet: meet,meeting,meets,met
meeting: meeting,meetings
melancholy: melancholy
mell: mell
melodramatic: melodramatic
melt: melting
melteth: melteth
melting: melting
memorial: memorial
memory: memory
menacing: menacing
menage: menage
mend: mend,mended,mending
mental: mental
mentally: mentally
mention: mention,mentioned,mentioning
merchant: merchant,merchants
merciful: merciful
merciless: merciless
mercilessly: mercilessly
mercy: mercy
mere: mere,merest
merit: merit
merriment: merriment
merry: merry
mess: mess
message: message
messenger: messenger
metal: metal
metaphysical: metaphysical
method: method,methods
microbe: microbes
midday: midday
middle: middle
midnight: midnight
midst: midst
midwife: midwives
mighty: mighty
mild: mild
mile: mile,miles
military: military
milkman: milkman
milksop: milksop
milky: milky
millionaire: millionaire
millionth: millionth
mince: mincing
mind: mind,minded,minds
minded: minded
mindedly: mindedly
mingle: mingle
ministry: ministry
minor: minor
minute: minute,minutes,minutest
minutely: minutely
minuteness: minuteness
miracle: miracle
mirage: mirage
mire: mire
mirror: mirror
mirth: mirth
mirthful: mirthful
mischance: mischance
mischief: mischief
misdeed: misdeed
miserable: miserable
miserably: miserably
misery: misery
misfortune: misfortune,misfortunes
misgiving: misgivings
mislead: mislead
misrepresent: misrepresent,misrepresenting
missy: missy
mist: mist
mistake: mistake,mistaken,mistakes
mistaken: mistaken
mistakenly: mistakenly
mistiness: mistiness
mistress: mistress
mistrust: mistrust,mistrusting
mistrustful: mistrustful
mistrustfully: mistrustfully
misunderstand: misunderstand
misunderstanding: misunderstanding
mitigation: mitigation
mix: mixed,mixing
mixed: mixed
moan: moan,moaned,moaning,moans
mobile: mobile
mock: mock,mocked,mocking
mockery: mockery
mockingly: mockingly
moderate: moderate
moderation: moderation
modern: modern
modest: modest
modestly: modestly
modesty: modesty
mohair: mohair
moi: moi
mole: mole
moment: moment,moments
momentary: momentary
mon: mon
monastery: monastery
money: money
monk: monk
monologue: monologues
monomania: monomania
monomaniac: monomaniac,monomaniacs
monster: monster
monstrous: monstrous
monstrously: monstrously
mont: mont
month: month,months
monument: monument,monuments
monumental: monumental
mood: mood
moody: moody
moon: moon
moonlight: moonlight
moor: moored
moral: moral,morals
morality: morality
morally: morally
morbid: morbid
morbidly: morbidly
morning: morning
morose: morose
morosely: morosely
morrow: morrow
morsel: morsel
mortal: mortal
mortar: mortar
mortified: mortified
moscow: moscow
mother: mother,mothers
motion: motioned,motioning
motionless: motionless
motive: motive,motives
mount: mount,mounted,mounting
mountain: mountain
mourn: mourning
mourner: mourners
mournful: mournful
mournfully: mournfully
mourning: mourning
mouse: mice,mouse
moustache: moustache,moustaches
mouth: mouth,mouths
mouthed: mouthed
movable: movables
movement: movement,movements
mud: mud
muddle: muddle,muddled,muddles
muddled: muddled
muddy: muddy
multitude: multitude
mumble: mumbled
munich: munich
murder: murder,murdered,murdering,murders
murderer: murderer,murderers
murmur: murmur,murmured,murmurs
mus: mus
muse: mused,musing
mushroom: mushrooms
music: music
musical: musical
musician: musician
musing: musing
muslin: muslin
muss: muss
mustard: mustard
mute: mute
mutilate: mutilated
mutter: mutter,muttered,muttering
muttering: muttering
mutton: mutton
mutual: mutual
mysterious: mysterious
mysteriously: mysteriously
mystery: mystery
mystic: mystic
mystification: mystification
mystify: mystified,mystify
nag: nag,nags
nail: nail,nailed,nails
naked: naked
nap: nap
nape: nape
napkin: napkin
naples: naples
napoleon: napoleon,napoleons
napoleons: napoleons
narcissus: narcissus
narrow: narrow
nastiness: nastiness
nasty: nasty
national: national
native: native
natural: natural
naturally: naturally
naturalness: naturalness
nature: nature
natured: natured
naughty: naughty
navel: navel
nearer: nearer
neatly: neatly
necessity: necessity
neck: neck
necked: necked
needful: needful
needle: needle
negative: negative
neglect: neglect,neglected
neighbour: neighbour,neighbouring,neighbours
neighbourhood: neighbourhood
nephew: nephews
nerve: nerve,nerves
nervous: nervous
nervously: nervously
nest: nest
nestle: nestled
newly: newly
news: news
newspaper: newspaper,newspapers
newton: newton
nice: nice
nicely: nicely
nicety: nicety
nicher: nicher
nicholas: nicholas
nick: nick
nickname: nickname
niece: niece
nigger: nigger
night: night,nights
nightingale: nightingale
nightmare: nightmare
nights: nights
nihil: nihil
nihilist: nihilist,nihilists
nihilists: nihilists
nil: nil
nines: nines
nineteen: nineteen
nineteenth: nineteenth
noah: noah
nobility: nobility
noble: noble,nobler
nobleman: nobleman,noblemen
nobly: nobly
nod: nodded,nodding
noise: noise
noiseless: noiseless
noiselessly: noiselessly
noisily: noisily
noisy: noisy
nomad: nomads
nonchalance: nonchalance
nonchalant: nonchalant
nonentity: nonentity
nonsense: nonsense
nonsensical: nonsensical
noose: noose
normal: normal
north: north
nose: nose,noses
nosed: nosed
nosegay: nosegays
notch: notches
notched: notched
note: note,notes
notebook: notebook,notebooks
noteworthy: noteworthy
notice: notice,noticed,noticing
noticeable: noticeable
noticeably: noticeably
notion: notion,notions
notorious: notorious
notoriously: notoriously
notre: notre
nou: nou
novelty: novelties
novice: novice,novices
nowadays: nowadays
noxious: noxious
nudging: nudging
nuisance: nuisance
numb: numb,numbed
numerous: numerous
nun: nun
nunnery: nunnery
nurse: nurse,nursing
nut: nuts
oasis: oasis
oath: oath,oaths
obedience: obedience
obedient: obedient
obediently: obediently
obey: obey,obeyed,obeying
object: object,objects
objection: objections
objectless: objectless
obligation: obligations
oblige: obliged
obliged: obliged
oblivion: oblivion
oblivious: oblivious
obscure: obscure,obscures
obsequious: obsequious
observant: observant
observation: observation,observations
observe: observe,observed,observes,observing
obsession: obsession
obstacle: obstacles
obstinacy: obstinacy
obstinate: obstinate
obstinately: obstinately
obstruct: obstructing
obtuse: obtuse
obvious: obvious
occasion: occasion,occasions
occasional: occasional
occasionally: occasionally
occupant: occupants
occupation: occupation
occupy: occupied,occupy
occur: occur,occurred,occurs
occurrence: occurrence
ocean: ocean
och: och
odd: odd
oddity: oddities
oddly: oddly
odour: odours
offence: offence
offend: offend,offended,offending
offended: offended
offensive: offensive
offer: offer,offered,offering,offers
offering: offering
office: office,offices
officer: officer,officers
official: official,officials
officially: officially
oftener: oftener
oho: oho
oil: oil
ointment: ointment
omen: omen
omit: omit,omitting
omniscient: omniscient
oneself: oneself
onion: onion
ooze: oozed
openly: openly
openness: openness
operation: operation
opinion: opinion,opinions
opponent: opponent
opportunity: opportunity
oppose: oppose,opposed,opposing
oppress: oppress,oppressed
oppression: oppression
oppressive: oppressive
oracle: oracle
oraison: oraison
orator: orator
ordeal: ordeal
ordinary: ordinary
organ: organ
organisation: organisation
organise: organise,organised
organism: organism
origin: origin
original: original
originality: originality
originate: originated
ornament: ornament
orphan: orphan,orphans
ostrich: ostrich
ounce: ounces
outbreak: outbreak
outburst: outburst
outcry: outcries,outcry
outer: outer
outfit: outfit
outgrow: outgrown
outlet: outlet
outline: outlines
outrage: outrage,outraged
outsider: outsider,outsiders
outspoken: outspoken
outspread: outspread
outstretched: outstretched
outwards: outwards
outweigh: outweigh
oval: oval
overawe: overawe
overbalancing: overbalancing
overbearing: overbearing
overburdened: overburdened
overcoat: overcoat
overcome: overcame,overcome
overdo: overdo
overdriven: overdriven
overflow: overflowed,overflowing
overgrown: overgrown
overhear: overhear,overheard
overjoy: overjoyed
overjoyed: overjoyed
overlook: overlook,overlooked,overlooking
oversleep: overslept
overstep: overstep,overstepped,overstepping
overstrain: overstrained
overstrained: overstrained
overtake: overtake,overtaken,overtakes,overtook
overturn: overturned
overween: overweening
overwhelm: overwhelmed,overwhelming
overwhelmed: overwhelmed
overwhelming: overwhelming
overwrought: overwrought
owe: owe,owed
owl: owl
owner: owner
pace: pace,paced,paces
pacing: pacing
pack: pack,packed,packing
pail: pail
pailful: pailfuls
pain: pain,pains
painful: painful
painfully: painfully
paint: paint,painted,painting,paints
painter: painter,painters
painting: painting
pair: pair
palace: palace
palais: palais
palate: palate,palates
pale: pale
paleness: paleness
paler: paler
pallor: pallor
palm: palms
paltry: paltry
pamphlet: pamphlets
pan: pan
pancake: pancake,pancakes
pane: pane,panes
pang: pang
pani: pani
panic: panic
pant: panted
panting: panting
papa: papa
paper: paper,papering,papers
parabola: parabola
parade: parades
parallel: parallel
paralysed: paralysed
paralysis: paralysis
parapet: parapet
parasol: parasol
parcel: parcel,parcels
parched: parched
pardon: pardon,pardoned
pardonable: pardonable
parent: parent,parents
parenthesis: parenthesis
paris: paris
park: park
parlour: parlour
paroxysm: paroxysm,paroxysms
parry: parried
parsimony: parsimony
parti: parti
partial: partial
particulars: particulars
partition: partitioned
partly: partly
partner: partner
partnership: partnership
party: party
pas: pas
pass: pass,passed,passing
passage: passage,passages
passenger: passengers
passer: passer,passers
passing: passing
passion: passion
passionate: passionate
passionately: passionately
passively: passively
passport: passport,passports
pat: patted,patting
patched: patched
patchwork: patchwork
path: path,paths
patience: patience
patient: patient,patients
patiently: patiently
patriarchal: patriarchal
patron: patrons
patronage: patronage
patroness: patroness
patronise: patronising
patter: pattered
pattern: pattern,patterns
pause: pause,paused
pavement: pavement
paw: paws
pawn: pawn,pawned
pawnbroker: pawnbroker
pay: paid,pay,paying,pays
payment: payment
pea: peas
peace: peace
peaceably: peaceably
peaceful: peaceful
peacefully: peacefully
pearl: pearls
peasant: peasant,peasants
peck: pecking
peculiar: peculiar
peculiarity: peculiarities,peculiarity
peculiarly: peculiarly
pecuniary: pecuniary
pedestal: pedestal
pedlar: pedlar,pedlars
peel: peeling
peep: peep,peeped,peeping
peeping: peeping
peer: peering
peevish: peevish
peevishly: peevishly
pelisse: pelisse
pell: pell
pen: pen,penned,pens
penal: penal
pencil: pencil,pencilled
penetrate: penetrate,penetrated,penetrating
penetration: penetration
penitence: penitence
penitent: penitent
penny: penny
pension: pension
pensive: pensive
peony: peony
people: peoples
pepper: pepper
perceive: perceive,perceived
percent: percent
percentage: percentage
perceptible: perceptible
perceptibly: perceptibly
perception: perceptions
peremptorily: peremptorily
peremptory: peremptory
perfect: perfect
perfection: perfection
perfectly: perfectly
perform: perform,performed,performing
performance: performance
performer: performer
period: period,periods
periodical: periodical
permanence: permanence
permanent: permanent
permanently: permanently
permissable: permissable
permissible: permissible
permission: permission
permit: permitted
pernicious: pernicious
perpetration: perpetration
perpetual: perpetual
perpetuity: perpetuity
perplex: perplexed
perplexed: perplexed
perplexity: perplexities,perplexity
persecute: persecute,persecuted,persecuting
persecution: persecution
persevere: persevere
persia: persia
persist: persist,persisted
persistent: persistent
persistently: persistently
person: people,person,persons
personage: personage,personages
personal: personal
personally: personally
perspiration: perspiration
perspire: perspired
persuade: persuade,persuaded,persuading
perturb: perturbed
perturbation: perturbation
pester: pester,pestered,pestering
petal: petals
petersburg: petersburg
petition: petition
petrified: petrified
petticoat: petticoats
pettifogging: pettifogging
pettishly: pettishly
petty: petty
phalanstery: phalanstery
phantom: phantom,phantoms
phenomenal: phenomenal
phenomenally: phenomenally
phenomenon: phenomenon
phew: phew
philip: philip
philosopher: philosopher,philosophers
philosophy: philosophy
photographer: photographer
phrase: phrase,phrases
physical: physical
physically: physically
physiology: physiology
piano: piano
pianoforte: pianoforte
pick: pick,picked,picking,picks
picker: pickers
pickpocket: pickpocket
picture: picture,pictures,picturing
picturesque: picturesque
pie: pie,pies
piece: piece,pieces
pierce: pierced,piercing
pig: pig
pikestaff: pikestaff
pill: pill
pillow: pillow,pillows
pin: pin,pins
pincers: pincers
pinch: pinched
pine: pine
pink: pink
pint: pint
pipe: pipe,pipes
piping: piping
pique: pique,piqued
pistol: pistol
pitch: pitch,pitched
pitched: pitched
piteous: piteous
piteously: piteously
pitiful: pitiful
pitilessly: pitilessly
pity: pitied,pity
plagiarist: plagiarists
plague: plague
plain: plain
plainly: plainly
plainness: plainness
plaintive: plaintive
plaintively: plaintively
plait: plaited
plan: plan,planned,planning,plans
plane: planed
plank: plank,planks
planning: planning
plant: plants
plantation: plantation
plaster: plaster
plate: plate,plates
plausible: plausible
plausibly: plausibly
play: play,played,playing
playful: playful
playfulness: playfulness
plaything: plaything
pleasant: pleasant
pleasantly: pleasantly
pleased: pleased
pleasure: pleasure,pleasures
pledge: pledge,pledged,pledges
plenty: plenty
plot: plotted
plump: plump
plunder: plunder
plunge: plunged
ply: plying
pock: pock
pocket: pocket,pockets
poem: poems
poet: poet,poets
poignant: poignant
poison: poison,poisoned
poke: poked,poking
pole: pole,poles
poles: poles
police: police
policeman: policeman,policemen
policy: policy
polish: polish
polished: polished
polite: polite
politely: politely
politeness: politeness
political: political
pomade: pomaded
pomatum: pomatum
pompous: pompous
ponder: pondered,pondering
poof: poof
pooh: pooh
pool: pool
poor: poor,poorest
pop: popped
poppet: poppet
population: population
porch: porch
pork: pork
porter: porter,porters
portly: portly
portrait: portrait
pose: pose,posed,poses,posing
position: position
positive: positive
positively: positively
possess: possessed
possession: possession
possibility: possibilities,possibility
post: post,posted,posts
postman: postman
postmaster: postmaster
pot: pot,pots
potato: potatoes
pothouse: pothouse
pounce: pounce,pounced
pounced: pounced
pound: pound,pounds
pour: pour,poured,pouring
pouting: pouting
poverty: poverty
powder: powder
power: power,powers
powerful: powerful
practical: practical
practicality: practicality
practically: practically
practice: practice
practise: practise,practised
praise: praise,praised,praises
praiseworthy: praiseworthy
prank: pranks
pray: pray,prayed
prayer: prayer,prayers
preach: preach,preached
precaution: precaution
precede: preceding
precedence: precedence
precedent: precedent
precious: precious
precipice: precipice
precise: precise
precisely: precisely
precision: precision
preconceived: preconceived
predestined: predestined
predict: predicted
predisposition: predisposition
predominate: predominated
preening: preening
preface: preface
prefer: prefer,preferred
prejudice: prejudice,prejudiced,prejudices
preliminary: preliminary
prematurely: prematurely
preoccupation: preoccupation,preoccupations
preoccupied: preoccupied
preoccupy: preoccupied
preordained: preordained
preparation: preparation,preparations
preparatory: preparatory
prepare: prepare,prepared,preparing
prepared: prepared
preponderance: preponderance
prepossess: prepossessing
prepossessing: prepossessing
presence: presence
presentable: presentable
presentiment: presentiment,presentiments
presently: presently
preserve: preserve,preserved,preserving
preside: preside,presiding
press: press,pressed,pressing
pressing: pressing
pressure: pressure
presume: presume,presumed
presumption: presumption
presuppose: presupposes
pretend: pretend,pretended,pretending
pretension: pretensions
pretentious: pretentious
preternatural: preternatural
pretext: pretext
pretty: pretty
prevaricate: prevaricate
prevent: prevent,prevented
previous: previous
prey: prey
price: price
prick: prick
pride: pride
priest: priest,priests
primeval: primeval
prince: prince
princess: princess,princesses
principal: principal
principally: principally
principle: principle,principles
prinking: prinking
print: print,printed,prints
printing: printing
prison: prison,prisons
prisoner: prisoner,prisoners
privacy: privacy
private: private
privately: privately
privation: privation,privations
privilege: privilege
privileged: privileged
privy: privy
prize: prize,prized
probability: probability
probable: probable
probe: probing
proceed: proceed,proceeded
proceeding: proceeding
proceedings: proceedings
process: process
procession: procession
proclaim: proclaim
produce: produce,produced
product: product
profession: profession
professional: professional
professor: professor
professorship: professorship
proffer: proffered
profile: profile
profit: profit
profitable: profitable
profligate: profligate
profound: profound,profoundest
progress: progress
progressive: progressive,progressives
progressively: progressively
prohibit: prohibited
prohibition: prohibition
project: project,projected,projecting
prolong: prolonged
prolonged: prolonged
prominent: prominent
promise: promise,promised,promises,promising
promote: promote,promotes,promoting
prompt: prompting
pronounce: pronounced
pronounced: pronounced
proof: proof,proofs
prop: propping
propaganda: propaganda
propensity: propensity
proper: proper
properly: properly
property: property
prophet: prophet
proportion: proportion,proportioned,proportions
proportionately: proportionately
proposal: proposal,proposals
propose: propose,proposed,proposing
proposition: proposition,propositions
propound: propounds
prosecute: prosecute
prosecution: prosecution
prosecutor: prosecutor
prospect: prospect
prospective: prospective
prosperous: prosperous
prostrate: prostrate
protect: protect,protected,protecting
protector: protectors
protest: protest,protested,protesting,protests
protrude: protruded
proudly: proudly
prove: prove,proved,proves,proving
proverb: proverb
provide: provide
providence: providence
providential: providential
province: province,provinces
provincial: provincial
provision: provisions
provocative: provocative
provoke: provoking
proximity: proximity
prudence: prudence
prudent: prudent
pruning: pruning
prussian: prussian
psychological: psychological
psychologically: psychologically
psychologist: psychologist
psychology: psychology
public: public
publication: publications
publicity: publicity
publish: publish,published,publishing
publisher: publisher,publishers
publishing: publishing
pudding: pudding
puddle: puddle
puff: puffing
puffing: puffing
puffy: puffy
pull: pull,pulled,pulling,pulls
pulse: pulse
punch: punch,punching
punchinello: punchinello
punctiliousness: punctiliousness
punctually: punctually
punish: punish,punished,punishing
punishment: punishment
puppy: puppy
purchase: purchase,purchased,purchases,purchasing
pure: pure
purely: purely
purify: purify
purity: purity
purple: purple
purplish: purplish
purpose: purpose,purposes
purposely: purposely
purse: purse
pursue: pursued,pursuing
pursuit: pursuit
push: push,pushed,pushing
puzzle: puzzled
puzzled: puzzled
pyramid: pyramid,pyramids
quadrangle: quadrangle
quadrangular: quadrangular
quaking: quaking
quality: qualities,quality
quantity: quantities,quantity
quarrel: quarrel,quarrelled,quarrelling
quarrelsome: quarrelsome
quart: quart
quarter: quarter,quarters
queen: queen
queer: queer
queerness: queerness
quench: quenching
question: question,questioned,questioning,questions
questioner: questioner
questioning: questioning
quick: quick,quicker
quicken: quicken
quiet: quiet
quietly: quietly
quilt: quilt
quiver: quiver,quivered,quivering
quote: quoted
rabbit: rabbits
race: race,races
rack: rack,racking
radiance: radiance
radiant: radiant
radical: radical
radish: radish
raff: raff
raft: rafts
rag: rag,rags
rage: rage,raged,raging
ragged: ragged
rail: rail
railing: railing
railway: railway,railways
rain: rain
rainbow: rainbow
rainy: rainy
raise: raise,raised,raising
raisin: raisins
raising: raising
rakishly: rakishly
random: random
range: range
rank: rank,ranks
ransack: ransack,ransacked,ransacking
rap: rapping
raphael: raphael
rapid: rapid
rapidity: rapidity
rapidly: rapidly
rapture: rapture
rare: rare
rarely: rarely
rascal: rascal
rascally: rascally
rash: rash
raspberry: raspberries,raspberry
rat: rat,rats
rate: rate
rational: rational
rattle: rattle
rave: rave,raving
raving: raving
ray: ray,rays
razor: razor,razors
reach: reach,reached,reaching
reaction: reaction
reactionary: reactionaries,reactionary
read: read,reading
reader: reader
readiness: readiness
reading: reading
ready: ready
real: real
realise: realise,realised,realising
reality: realities,reality
reap: reap
reason: reason,reasons
reasoning: reasoning
reassure: reassure,reassured
reaumur: reaumur
rebellious: rebellious
rebound: rebounding
recall: recall,recalled,recalling
recantation: recantation
receipt: receipts
receive: receive,received,receiving
receiver: receiver
reception: reception
reckless: reckless
recklessly: recklessly
recklessness: recklessness
reckon: reckon,reckoned,reckoning
reckoning: reckoning
recognise: recognise,recognised,recognising
recognition: recognition
recoil: recoiled
recollect: recollect,recollected,recollecting
recollection: recollection,recollections
recommend: recommend,recommended
recommendation: recommendation
reconcile: reconciled
reconciliation: reconciliation
recount: recounted
recourse: recourse
recover: recover,recovered,recovering
recovery: recovery
recur: recurring,recurs
red: red
reddish: reddish
redecorate: redecorated
redeem: redeem,redeemed
redeemer: redeemer
redouble: redoubled
reduce: reduce,reduced,reducing
reek: reeked
reeking: reeking
reel: reeled
refer: refer,referred,referring
reference: reference
refine: refined
refined: refined
reflect: reflect,reflected,reflecting,reflects
reflection: reflection,reflections
reform: reform,reforms
refrain: refrain,refrained
refresh: refreshed
refreshing: refreshing
refuse: refuse,refused,refusing
refute: refute
regain: regain,regained,regaining
regard: regard,regarded
regeneration: regeneration
regiment: regiment
regimental: regimental
regret: regret,regretted,regretting
regular: regular
regularity: regularity
regularly: regularly
rehearsal: rehearsal
rehearse: rehearse
reign: reign,reigned,reigning
rein: reins
reinforce: reinforced
reinstate: reinstating
reject: reject,rejected
rejoice: rejoice,rejoiced
relapse: relapse,relapsed,relapsing
relation: relation,relations
relationship: relationship
relative: relative
release: released
reliable: reliable
reliance: reliance
reliant: reliant
relief: relief
relieve: relieve,relieved,relieves
relieved: relieved
religion: religion
religious: religious
religiously: religiously
relish: relish,relished
reluctance: reluctance
reluctant: reluctant
reluctantly: reluctantly
rely: relied,relies,rely,relying
remain: remain,remained,remaining,remains
remark: remark,remarked,remarking,remarks
remarkable: remarkable
remarkably: remarkably
remarkedly: remarkedly
remember: remember,remembered,remembering,remembers
remind: remind,reminded,reminding
remit: remit
remittance: remittance
remnant: remnants
remorse: remorse
remote: remote
remoteness: remoteness
remove: remove,removed,removing
rend: rend,rending
render: rendered
renew: renew,renewed,renews
renewal: renewal
renounce: renounce,renounced
rent: rent
repair: repairs
repay: repay,repaying
repeat: repeat,repeated,repeating
repeatedly: repeatedly
repel: repel,repelling
repellent: repellent
repent: repent,repented
repentance: repentance
repetition: repetition
replace: replaced
reply: replied,reply,replying
report: report,reported,reporting,reports
represent: represent,representing
repress: repress
reproach: reproach,reproached,reproaches
reproachfully: reproachfully
reproduce: reproduce,reproduced,reproducing
reproof: reproof
repugnance: repugnance
repulse: repulse
repulsion: repulsion
repulsive: repulsive
reputable: reputable
reputation: reputation
repute: reputed
request: request
requiem: requiem
require: required,requiring
rescue: rescue,rescued,rescuing
resemble: resembled,resembling
resent: resent,resented
resentful: resentful
resentfully: resentfully
reserve: reserve
resignation: resignation
resist: resist,resisted
resistance: resistance
resolute: resolute
resolutely: resolutely
resolution: resolution,resolutions
resolve: resolved
resort: resort,resorted
resound: resounded
resource: resource,resources
resourcefulness: resourcefulness
respect: respect,respected,respects
respectability: respectability
respectable: respectable
respected: respected
respectful: respectful
respectfully: respectfully
respects: respects
respond: respond,responds
response: response
responsibility: responsibility
responsible: responsible
responsive: responsive
rest: rest,rested,resting,rests
restaurant: restaurant,restaurants
restful: restful
restive: restive
restless: restless
restlessness: restlessness
restore: restore,restored
restrain: restrain,restrained,restraining
restrained: restrained
restraint: restraint
result: result
resume: resumed,resuming
resurrection: resurrection
retain: retain,retained,retaining
retire: retired,retiring
retired: retired
retort: retort,retorted
retract: retract
retreat: retreat,retreated,retreating
retrograde: retrograde
return: return,returned,returning
reveal: reveal,revealed
reveller: revellers
revenge: revenge
revenue: revenue
reverence: reverence
reverently: reverently
reverie: reverie
revert: reverting
review: review
revile: reviling
revive: revive,revived
revolt: revolt
revolting: revolting
revolution: revolution
revolutionist: revolutionist
revolver: revolver
revulsion: revulsion
reward: reward
rhyme: rhymes
rhythmically: rhythmically
rib: ribs
ribbon: ribbons
rice: rice
rich: rich
rickety: rickety
rid: rid
riddle: riddle,riddles
ridicule: ridicule
ridiculous: ridiculous
riff: riff
rig: rig
rigamarole: rigamarole
righteous: righteous
righteousness: righteousness
rigid: rigid
rigidity: rigidity
rigueur: rigueur
rim: rim
ringleader: ringleaders
rinse: rinsing
riotous: riotous
rise: rise,risen,rising,rose
rising: rising
risk: risk,risked
risky: risky
rite: rite
river: river
rivet: riveted
road: road
roar: roar,roared,roaring
rob: rob,robbed,robbing
robber: robber
robbery: robbery
robbing: robbing
rock: rock
rogue: rogue
roll: roll,rolled,rolling,rolls
rolling: rolling
romantic: romantic
romeo: romeo
roof: roof
root: root,rooted,roots
rose: roses
rosy: rosy
rot: rot
rotten: rotten
rouble: rouble,roubles
rough: rough
roughly: roughly
roundabout: roundabout
rouse: rouse,roused
rousing: rousing
rousseau: rousseau
routine: routine
row: row,rows
rub: rubbed,rubbing
rubber: rubber
rubbish: rubbish
rubbishly: rubbishly
rude: rude,rudest
rudely: rudely
rudeness: rudeness
ruder: ruder
ruffian: ruffian
ruffle: ruffled
rug: rug,rugs
ruin: ruin,ruining,ruins
rule: rule,rules
rum: rum
rummage: rummaged,rummaging
rumour: rumours
running: running
rupture: rupture
rush: rush,rushed,rushing
russia: russia
russian: russian,russians
rustle: rustle
rusty: rusty
rut: rut
ruthlessly: ruthlessly
sabre: sabre
sack: sack,sacks
sacking: sacking
sacrament: sacrament
sacred: sacred
sacrifice: sacrifice,sacrifices,sacrificing
sad: sad
sadly: sadly
sadness: sadness
safe: safe
safety: safety
sage: sage
saint: saint
saith: saith
sake: sake,sakes
salary: salary
sally: sally
saloon: saloon
salt: salt
samovar: samovar,samovars
sanction: sanction
sand: sand
sanity: sanity
sarcasm: sarcasm
sarcastic: sarcastic
sarcastically: sarcastically
sash: sash
satin: satin
satire: satire
satisfaction: satisfaction
satisfactorily: satisfactorily
satisfactory: satisfactory
satisfied: satisfied
satisfy: satisfied,satisfy
saturday: saturday
saucer: saucer
sausage: sausage
savage: savage
save: save,saved,saving
savings: savings
saviour: saviour
savoury: savouries,savoury
scaffold: scaffold
scaffolding: scaffolding
scale: scale
scallop: scallops
scamp: scamp
scan: scanned,scanning
scandal: scandal,scandals
scandalise: scandalising
scandalous: scandalous
scantiness: scantiness
scarcely: scarcely
scare: scare,scared
scared: scared
scarf: scarf
scatter: scattering
scene: scene,scenes
scent: scent,scented
sceptic: sceptic,sceptics
sceptical: sceptical
schiller: schiller
school: school
schoolboy: schoolboy
science: science
scientific: scientific
scoffer: scoffers
scold: scolded,scolding
scorch: scorches
score: score
scornful: scornful
scornfully: scornfully
scoundrel: scoundrel,scoundrels
scoundrelly: scoundrelly
scowl: scowl,scowled,scowling
scrap: scraps
scrape: scraped
scratch: scratched
scratching: scratching
scrawl: scrawl
scream: scream,screamed,screaming,screams
screech: screeched
screen: screen,screening
screw: screwed,screwing
scribble: scribble,scribbled
scripture: scripture
scrofulous: scrofulous
scrub: scrubbed,scrubbing,scrubs
scrupulously: scrupulously
scrutinise: scrutinised,scrutinising
scrutiny: scrutiny
scuffle: scuffling
scuttle: scuttling
sea: sea
seal: seal,sealed
search: search,searched,searching
season: seasons
seat: seat,seated,seating,seats
seated: seated
secluded: secluded
secondary: secondary
secret: secret,secrets
secretary: secretary
secretly: secretly
sect: sect
secure: secure
security: securities,security
sedate: sedate
sedately: sedately
sedentary: sedentary
seduce: seduced
seductive: seductive
seductively: seductively
seed: seed
seek: seek,seeking,seeks,sought
seemingly: seemingly
seize: seize,seized,seizing
selfish: selfish
selfishness: selfishness
sell: sell,selling,sold
selling: selling
semblance: semblance
senate: senate
send: send,sending,sends
sensation: sensation,sensations
sense: sense
senseless: senseless
sensibly: sensibly
sensitive: sensitive
sensitiveness: sensitiveness
sensual: sensual
sensualist: sensualist
sensuality: sensuality
sentence: sentence,sentenced,sentences
sententiously: sententiously
sentiment: sentiments
sentimental: sentimental
sentimentality: sentimentality
sentinel: sentinel
sentry: sentry
separate: separate,separated
separation: separation
serenity: serenity
serf: serf,serfs
serfdom: serfdom
seriousness: seriousness
servant: servant,servants
serve: serve,served,serves,serving
server: server
service: service,services
serviceable: serviceable
servile: servile
servitude: servitude
set: set,sets,setting
setting: setting
settle: settle,settled,settling
settled: settled
sevastopol: sevastopol
seventeen: seventeen
seventh: seventh
severe: severe
severely: severely
severity: severity
sew: sew,sewed
sewing: sewing
sex: sex,sexes
sha: sha
shabbiness: shabbiness
shabby: shabby
shade: shade,shaded
shadow: shadow
shaft: shaft,shafts
shake: shake,shaken,shakes,shaking,shook
shallow: shallow
shame: shame
shamefaced: shamefaced
shameful: shameful
shameless: shameless
shamelessly: shamelessly
shanty: shanties
shape: shape,shaped,shapes
share: share,shared,shares,sharing
sharp: sharp,sharper,sharpest
sharper: sharpers
sharply: sharply
shatter: shattered
shattered: shattered
shave: shave,shaved
shaven: shaven
shawl: shawl,shawls
sheepish: sheepish
sheer: sheer
sheet: sheet,sheets
shelter: shelter
shh: shh
shift: shifting
shine: shine,shining,shone
shirk: shirking
shirt: shirt,shirts
shiver: shiver,shivered,shivering,shivers
shock: shock,shocks
shocked: shocked
shocking: shocking
shod: shod
shoe: shoe,shoes
shoot: shoot,shooting,shot
shooting: shooting
shop: shop,shops
shopkeeper: shopkeeper
shopman: shopmen
shopmen: shopmen
shore: shore
short: short,shorter,shortest
shortcoming: shortcoming
shorten: shortened
shortly: shortly
shot: shot
shoulder: shoulder,shoulders
shouldest: shouldest
shout: shout,shouted,shouting,shouts
shove: shove
shower: shower,showered
shred: shreds
shriek: shriek,shrieked,shrieking,shrieks
shrill: shrill
shrilly: shrilly
shrine: shrine
shrink: shrink,shrinking
shroud: shroud
shrug: shrugged
shudder: shudder,shuddered,shuddering
shut: shut
shutter: shutters
shy: shy
shyness: shyness
siberia: siberia
sick: sick
sickening: sickening
sickly: sickly
sidelong: sidelong
sideways: sideways
siege: siege
sigh: sigh,sighed,sighing,sighs
sighing: sighing
sight: sight
sighted: sighted
sign: sign,signed,signing,signs
signal: signal,signalling
signature: signature,signatures
significance: significance
silence: silence
silent: silent
silently: silently
silk: silk
silky: silky
sill: sill,sills
silly: sillies,silliest,silly
silver: silver
silversmith: silversmith
simple: simple,simpler,simplest
simpleton: simpleton,simpletons
simplicity: simplicity
simply: simply
sin: sin,sinned,sins
sincerely: sincerely
sincerity: sincerity
sinful: sinful
sing: sang,sing,singing,sings,sung
singer: singer,singers
singing: singing
single: single
singular: singular
sinister: sinister
sink: sank,sink,sinking,sinks,sunk,sunken
sinless: sinless
sinner: sinner
sip: sip,sipped,sipping
sir: sir
sister: sister,sisters
sistine: sistine
sit: sat,sit,sits,sitting
situation: situation
sixteen: sixteen
sixth: sixth
sixthly: sixthly
size: size
sized: sized
sketchily: sketchily
skill: skill
skin: skin
skinned: skinned
skinny: skinny
skip: skip,skipped,skipping
skirt: skirt,skirted,skirts
skull: skull
sky: sky
slack: slack
slam: slam,slammed
slander: slander,slandered,slandering
slanderer: slanderer
slant: slanting
slap: slapped,slapping,slaps
slave: slave
slavish: slavish
slavishly: slavishly
slay: slay
sleep: sleep,sleeping,sleeps,slept
sleepless: sleepless
sleepy: sleepy
sleeve: sleeve
slice: sliced
slight: slight,slighted,slightest
slim: slim
sling: sling
slip: slip,slipped,slipping
slipper: slippers
slippery: slippery
slope: sloping
sloppy: sloppy
sloven: sloven
slow: slow
slowly: slowly
slut: slut
sly: sly
slyly: slyly
slyness: slyness
smallness: smallness
smart: smart
smarten: smartened
smartly: smartly
smartness: smartness
smash: smashed,smashing
smear: smeared,smearing
smell: smell,smelling,smells,smelt
smile: smile,smiled,smiles,smiling
smirch: smirched
smite: smiting,smitten,smote
smoke: smoke,smoking
smoking: smoking
smolder: smoldering
smooth: smooth,smoothed,smoother
smoothly: smoothly
smutty: smutty
snake: snake
snap: snap,snapped,snapping
snare: snare
snatch: snatch,snatched,snatching
sneer: sneer
sneering: sneering
sneeze: sneeze,sneezing
sniff: sniffed
snigger: snigger,sniggered,sniggering
snore: snoring
snow: snow
snub: snub
snug: snug
soak: soaked
soaking: soaking
soap: soap
soar: soars
sob: sobbed,sobbing,sobs
sober: sober
sobering: sobering
soberly: soberly
social: social
socialist: socialist,socialists
society: society
sock: sock,socks
socket: sockets
sofa: sofa
soft: soft,softer
soften: soften,softened
softly: softly
softness: softness
sojourn: sojourning
soldier: soldier,soldiers
soldierly: soldierly
sole: sole,soles
solely: solely
solemnity: solemnity
solemnly: solemnly
solicitude: solicitude
solid: solid
solitary: solitary
solitude: solitude
solon: solon
solution: solution
solve: solved
sombre: sombre
someway: someway
son: son
song: song,songs
sooner: sooner
soothe: soothe,soothed
soothing: soothing
sorcery: sorcery
sore: sore
sorrel: sorrel
sorrow: sorrow
sorrowful: sorrowful
sort: sort,sorts
soul: soul
sound: sound,sounded,sounds
soundly: soundly
soup: soup
sour: sour
source: sources
sourly: sourly
sous: sous
souse: sousing
sovereign: sovereign
space: space
spacious: spacious
span: span
spare: spare,spared,sparing
spark: spark
sparrow: sparrow
spasm: spasm
spatter: spattered
speak: speak,speaking,speaks,spoke,spoken
speaker: speaker
speaking: speaking
special: special
specialist: specialist
specially: specially
specialty: specialty
species: species
specimen: specimen,specimens
speck: speck,specks
spectacle: spectacle
spectacles: spectacles
spectator: spectator,spectators
speculator: speculator
speech: speech,speeches
speechify: speechifying
speechless: speechless
speed: speed
speedy: speedy
spell: spell
spelling: spelling
spend: spend,spending,spent
spending: spending
spermaceti: spermaceti
spick: spick
spider: spider,spiders
spill: spilling
spilt: spilt
spine: spine
spiral: spiral
spirit: spirit,spirits
spirited: spirited
spiritual: spiritual
spit: spat,spit,spitting
spite: spite
spiteful: spiteful
spleen: spleen
splendid: splendid
splendidly: splendidly
splinter: splinter
split: split
splutter: splutter,spluttering
spoil: spoil,spoiled
spontaneous: spontaneous
spontaneously: spontaneously
spoon: spoon,spoons
spoonful: spoonful,spoonfuls
sport: sport
spot: spot,spots
spotless: spotless
spotty: spotty
spouse: spouse
spread: spread,spreading
spree: spree
spring: sprang,spring,springing,springs,sprung
sprinkle: sprinkled
spy: spy
squabble: squabbles,squabbling
squabbling: squabbling
squander: squandering
square: square,squares
squat: squatting
squeal: squealed,squealing,squeals
squeeze: squeeze,squeezed,squeezing
stab: stabbed,stabbing
stable: stable
stage: stage,stages
stagger: staggered,staggering
staggering: staggering
stagnant: stagnant
stagnate: stagnating
stain: stained,stains
stair: stairs
staircase: staircase,staircases
stake: stake,stakes
stale: stale
stalk: stalks
stammer: stammer,stammered,stammering,stammers
stamp: stamp,stamped,stamping
stand: stand,standing,stands,stood
standard: standard
standing: standing
standstill: standstill
starch: starched
stare: stare,stared,staring
start: start,started,starting
starting: starting
startle: startled
startled: startled
starvation: starvation
starve: starve,starved,starving
statement: statement
statesman: statesman
station: station
stay: stay,stayed,staying
staying: staying
steadily: steadily
steak: steak
steal: steal,stealing,steals,stole,stolen
stealthily: stealthily
steam: steam
steamer: steamer
steed: steed
steel: steel
steep: steep
steeple: steeple
stench: stench
step: step,stepped,stepping,steps
stepdaughter: stepdaughter
stepmother: stepmother
steppe: steppe
stern: stern
sterner: sterner
sternly: sternly
stew: stew
stick: stick,sticking,sticks,stuck
sticky: sticky
stiff: stiff
stiffly: stiffly
stifle: stifle,stifled,stifling
stifling: stifling
stillness: stillness
stimulate: stimulated,stimulating
stimulus: stimulus
sting: sting,stung
stinginess: stinginess
stink: stinking
stir: stir,stirred
stirring: stirring
stock: stock,stocks
stocking: stockings
stockingless: stockingless
stolidly: stolidly
stomach: stomach
stone: stone,stones
stoop: stoop,stooped,stooping
store: store,stored
storey: storey,storeys
storied: storied
storm: storm,stormed,storms
stormy: stormy
story: stories,story
stout: stout
stoutly: stoutly
stove: stove,stoves
straight: straight
straightforward: straightforward
strain: strain,strained,straining
strained: strained
strand: stranded
strange: strange,strangest
strangely: strangely
strangeness: strangeness
stranger: stranger,strangers
strangle: strangle,strangled
stratagem: stratagem
straw: straw,straws
stray: stray,strayed
streak: streak,streaked
stream: stream,streamed,streaming,streams
streaming: streaming
street: street,streets
strength: strength
strengthen: strengthened
stress: stress
stretch: stretched
strew: strewn
stricken: stricken
strictly: strictly
stride: striding,strode
strike: strike,strikes,striking,struck
striking: striking
strikingly: strikingly
string: string
strip: strip
stripe: stripes
striped: striped
strive: strive,striving,strove
stroke: stroke
stroll: strolled
strong: strong,stronger
struggle: struggle,struggled,struggling
strum: strum
stubbly: stubbly
stubborn: stubborn
stubbornly: stubbornly
stuck: stuck
stud: stud,studded
student: student,students
studiously: studiously
study: studied,studies,study,studying
stuff: stuff,stuffed,stuffing
stuffy: stuffy
stumble: stumbled,stumbling
stumbling: stumbling
stun: stunned
stunning: stunning
stupefaction: stupefaction
stupefy: stupefied
stupid: stupid,stupider,stupids
stupidity: stupidity
stupidly: stupidly
style: style
stylish: stylish
subdue: subdue
subdued: subdued
subject: subject,subjects
subjection: subjection
submission: submission
submissive: submissive
submissively: submissively
submissiveness: submissiveness
submit: submit,submitting
subscribe: subscribing
subscription: subscription
subside: subside
substantial: substantial
succeed: succeed,succeeded
success: success
successful: successful
successive: successive
succour: succour
succumb: succumbed
suck: sucking
sudden: sudden
suddenly: suddenly
suffer: suffer,suffered,suffering
sufferer: sufferers
suffering: suffering,sufferings
sufficiency: sufficiency
sufficient: sufficient
suffocate: suffocating
sugar: sugar
suggestion: suggestion,suggestions
suicide: suicide,suicides
suit: suit,suited,suits
suitable: suitable
suitably: suitably
suited: suited
suitor: suitor
sulkiness: sulkiness
sulky: sulky
sullen: sullen
sullenly: sullenly
sum: sum,sums
summer: summer
summon: summon,summoned,summoning
summons: summons
sumptuous: sumptuous
sun: sun
sunday: sunday
sundays: sundays
sunken: sunken
sunlight: sunlight
sunny: sunny
sunrise: sunrise
sunset: sunset
sunshine: sunshine
superciliously: superciliously
superciliousness: superciliousness
superficially: superficially
superfluous: superfluous
superintend: superintend
superintendent: superintendent
superior: superior,superiors
superiority: superiority
superstition: superstition
superstitious: superstitious
superstitiously: superstitiously
supper: supper
suppliant: suppliant
supplication: supplication,supplications
support: support,supported,supporting
suppose: suppose,supposed,supposing
supposing: supposing
supposition: supposition,suppositions
suppress: suppressed,suppressing
surely: surely
surface: surface
surge: surged,surging
surgery: surgery
surmise: surmise,surmises
surname: surname
surprise: surprise,surprised,surprises
surprised: surprised
surprising: surprising
surrender: surrender,surrendered
surround: surrounded,surrounding
surroundings: surroundings
survey: survey
suspect: suspect,suspected,suspects
suspense: suspense
suspicion: suspicion,suspicions
suspicious: suspicious
suspiciously: suspiciously
suspiciousness: suspiciousness
swallow: swallow,swallowed,swallowing
swam: swam
swan: swan
swarm: swarmed,swarming
sway: swaying
swear: swear,swore,sworn
swearing: swearing
sweat: sweat
sweep: sweep,sweeping,sweeps,swept
sweet: sweet,sweeter
sweetheart: sweetheart,sweethearts
sweetie: sweetie
sweetmeat: sweetmeat
swell: swollen
swim: swim
swindler: swindler
swine: swine
swing: swing,swung
swinging: swinging
swinishness: swinishness
swirl: swirling
switch: switch,switches
switzerland: switzerland
swollen: swollen
swoon: swoon,swooning
syllable: syllable
symbol: symbol
symbolism: symbolism
sympathetic: sympathetic
sympathetically: sympathetically
sympathise: sympathise
sympathy: sympathy
symptom: symptom
systematic: systematic
table: table,tables
tablecloth: tablecloth
tacitly: tacitly
tactic: tactics
tail: tail
tailor: tailor,tailors
tale: tale,tales
talent: talent,talents
talk: talk,talked,talking,talks
talkative: talkative
talking: talking
tall: tall
tallow: tallow
tambourine: tambourine
tangible: tangible
tangle: tangle,tangled
tantalise: tantalising
tap: tap,tapped,tapping
tape: tape,tapes
tar: tarred
taradiddle: taradiddle
task: task
taste: taste,tasted,tasting
tattered: tattered
tatters: tatters
tattoo: tattoo
tavern: tavern,taverns
tea: tea
teach: taught,teach,teaches,teaching
teacher: teacher,teachers
teapot: teapot
tear: tear,tearing,tears,tore,torn
tearful: tearful
tearfully: tearfully
tease: tease,teasing
teaspoon: teaspoon
tedious: tedious
telling: telling
temper: temper
temperament: temperament
tempered: tempered
tempest: tempest
temple: temple
temporary: temporary
tempt: tempted
temptation: temptation
tend: tending
tendency: tendencies,tendency
tender: tender
tenderness: tenderness
tenement: tenements
tenez: tenez
tent: tents
tentative: tentative
tentatively: tentatively
term: term,terms
terrace: terrace
terrible: terrible
terribly: terribly
terrified: terrified
terrify: terrified
terrifying: terrifying
terror: terror,terrors
testament: testament
testify: testifies
testimony: testimony
thankful: thankful
thanksgiving: thanksgiving
thee: thee
theme: theme,themes
theory: theories,theory
thickly: thickly
thickness: thickness
thief: thief,thieves
thinkable: thinkable
thinking: thinking
thinness: thinness
thirdly: thirdly
thirst: thirst,thirsting
thirteen: thirteen
thirteenth: thirteenth
thoroughfare: thoroughfare,thoroughfares
thoughtful: thoughtful
thoughtfully: thoughtfully
thrash: thrash,thrashed,thrashing
thread: thread,threads
threadbare: threadbare
threat: threat,threats
threaten: threatened,threatening
threshold: threshold
thrice: thrice
thrill: thrill
throat: throat
throb: throb,throbbed,throbbing
throbbing: throbbing
throng: throng,thronged,thronging
throw: threw,throw,throwing,thrown,throws
thrust: thrust
thud: thud,thuds
thump: thumping
thunder: thunder
thunderbolt: thunderbolt
thunderclap: thunderclap
thunderstorm: thunderstorm
thunderstruck: thunderstruck
thy: thy
tick: ticking
ticket: ticket,tickets
tickle: tickled,tickling
ticklish: ticklish
tiding: tidings
tidy: tidy
tie: tie,tied
tight: tight
tightly: tightly
tilted: tilted
time: time,times
timid: timid
timidity: timidity
timidly: timidly
timorous: timorous
tin: tin
tinge: tinge
tinkle: tinkle,tinkled
tinkling: tinkling
tiny: tiniest,tiny
tipsily: tipsily
tipsy: tipsy
tiptoe: tiptoe
tirade: tirade
tired: tired
tiresome: tiresome
tit: tit
title: title,titles
titter: tittered
titular: titular
tobacco: tobacco
toe: toes
tomb: tomb
ton: ton
tone: tone,tones
tongue: tongue,tongues
tool: tool
tooth: teeth,tooth
topsy: topsy
torment: torment,tormented,tormenting
tormentor: tormentor
torn: torn
tortoise: tortoise
torture: torture,tortured,torturing
torturer: torturer
toss: tossed
total: total
totter: tottered
touch: touch,touched,touches,touching
touching: touching
touchingly: touchingly
tough: tough
tout: tout
towel: towel
tower: tower
town: town,towns
townspeople: townspeople
trace: trace,traces
track: track,tracking,tracks
trade: trade,trades
tradesman: tradesman
trading: trading
tradition: tradition,traditions
traditional: traditional
traffic: traffic
tragic: tragic
trail: trailed
train: train,trained
tramp: tramp,tramps
trample: trample,trampled
transfer: transferring
transfigure: transfigured
transform: transform,transformed
transgress: transgress,transgressed
translate: translated,translating
translation: translation
translator: translator
transparent: transparent
transport: transport
trap: trap,trapped
trash: trash
trashy: trashy
travel: travel
travelling: travelling
travels: travels
tray: tray
treachery: treachery
treacle: treacle
tread: tread
treasure: treasure
treat: treat,treated,treating
treatise: treatise
treatment: treatment
tree: tree,trees
tremble: tremble,trembled,trembling
tremendous: tremendous
tremendously: tremendously
tremor: tremor
tremulously: tremulously
trepidation: trepidation
trial: trial,trials
tribulation: tribulation
trick: trick,tricks
trickle: trickled
trifle: trifle,trifles,trifling
trifling: trifling
trigger: trigger
trill: trilled
trim: trimmed
trinity: trinity
trinket: trinket,trinkets
triumph: triumph,triumphed
triumphant: triumphant
triumphantly: triumphantly
trivial: trivial
triviality: trivialities
trodden: trodden
troops: troops
trouble: trouble,troubled,troubles,troubling
troubled: troubled
troublesome: troublesome
troubling: troubling
trousers: trousers
trousseau: trousseau
trudge: trudging
true: true,truer
trumpet: trumpet
trunk: trunk,trunks
trust: trust,trusted,trusts
trustful: trustful
truth: truth
truthful: truthful
tryst: tryst
tsar: tsar
tub: tub
tubercle: tubercles
tuck: tucked
tug: tugged,tugging
tune: tune
turban: turban
turk: turk
turkish: turkish
turmoil: turmoil
turvy: turvy
tut: tut
twelfth: twelfth
twilight: twilight
twinge: twinge
twinkle: twinkling
twist: twist,twisted,twisting
twitch: twitch,twitched
twitching: twitching
type: type,types
typhus: typhus
tyranny: tyranny
tyrant: tyrant
tyrolese: tyrolese
ugh: ugh
ugliness: ugliness
ugly: ugly
ulterior: ulterior
unable: unable
unaccountable: unaccountable
unadorned: unadorned
unaffected: unaffected
unalloyed: unalloyed
unattainable: unattainable
unavoidable: unavoidable
unaware: unaware
unawares: unawares
unbearable: unbearable
unbelieving: unbelieving
unbending: unbending
unbound: unbound
unbounded: unbounded
unbutton: unbuttoned
uncanny: uncanny
unceremonious: unceremonious
unceremoniously: unceremoniously
uncertain: uncertain
uncertainly: uncertainly
uncertainty: uncertainties,uncertainty
unchildish: unchildish
unchildlike: unchildlike
uncle: uncle
uncleanliness: uncleanliness
uncleanness: uncleanness
uncomfortable: uncomfortable
unconcealed: unconcealed
unconscious: unconscious
unconsciously: unconsciously
unconsciousness: unconsciousness
uncontrollable: uncontrollable
uncouth: uncouth
uncover: uncovered
uncritically: uncritically
underclothes: underclothes
undergo: undergoing,undergone
underground: underground
underlip: underlip
understand: understand,understanding,understands,understood
understanding: understanding
undertake: undertake,undertaken,undertook
undertaking: undertaking
undertone: undertone
undeservedly: undeservedly
undisguised: undisguised
undismay: undismayed
undo: undid,undo
undoubted: undoubted
undoubtedly: undoubtedly
undress: undressed,undressing
undressed: undressed
unearth: unearthed
uneasily: uneasily
uneasiness: uneasiness
uneasy: uneasy
uneducated: uneducated
unendurable: unendurable
unequal: unequal
unexpected: unexpected
unexpectedly: unexpectedly
unfailing: unfailing
unfair: unfair
unfairly: unfairly
unfamiliar: unfamiliar
unfasten: unfastened
unfastened: unfastened
unfavourable: unfavourable
unfeigned: unfeigned
unfold: unfold,unfolded,unfolding
unforeseen: unforeseen
unfortunate: unfortunate
ungentlemanly: ungentlemanly
ungovernable: ungovernable
ungrateful: ungrateful
unguarded: unguarded
unhappily: unhappily
unhappy: unhappier,unhappy
unhealthy: unhealthy
unheard: unheard
unheeded: unheeded
unhewn: unhewn
unhinge: unhinged
unholy: unholy
unhurried: unhurried
uniform: uniform
unimpaired: unimpaired
uninhabited: uninhabited
unintentional: unintentional
unintentionally: unintentionally
uninterrupted: uninterrupted
uninvited: uninvited
unique: unique
unite: united
united: united
universal: universal
university: university
unjust: unjust
unkempt: unkempt
unknown: unknown
unlatch: unlatched
unlock: unlocked,unlocking
unlooked: unlooked
unloose: unloosed
unmarried: unmarried
unmasked: unmasked
unmerited: unmerited
unmistakable: unmistakable
unmistakably: unmistakably
unmitigated: unmitigated
unmixed: unmixed
unmoved: unmoved
unnatural: unnatural
unnecessarily: unnecessarily
unnecessary: unnecessary
unnoticed: unnoticed
unobserved: unobserved
unopened: unopened
unpainted: unpainted
unpardonable: unpardonable
unpardonably: unpardonably
unpleasant: unpleasant
unpleasantly: unpleasantly
unpleasantness: unpleasantness
unpleasing: unpleasing
unpractised: unpractised
unprecedented: unprecedented
unprincipled: unprincipled
unpunctual: unpunctual
unreal: unreal
unreasonably: unreasonably
unreasoning: unreasoning
unredeemed: unredeemed
unreserved: unreserved
unrestrained: unrestrained
unsafe: unsafe
unsatisfactory: unsatisfactory
unscrupulous: unscrupulous
unseemly: unseemly
unseen: unseen
unsettle: unsettled
unsettled: unsettled
unshaven: unshaven
unsolved: unsolved
unspeakable: unspeakable
unspoken: unspoken
unsteadier: unsteadier
unsteadily: unsteadily
unsuccessful: unsuccessful
untenanted: untenanted
unthinkable: unthinkable
untie: untie,untied,untying
untouched: untouched
untried: untried
untrustworthy: untrustworthy
unutterable: unutterable
unveil: unveil
unveiling: unveiling
unwarily: unwarily
unwashed: unwashed
unwelcome: unwelcome
unwell: unwell
unwhitewashed: unwhitewashed
unwilling: unwilling
unwillingly: unwillingly
unwittingly: unwittingly
unworthy: unworthy
unwritten: unwritten
upbraid: upbraiding
upholster: upholstered
upholsterer: upholsterers
upper: upper
uppermost: uppermost
upright: upright
uproar: uproar
uproarious: uproarious
uproot: uproot
upset: upset
upsetting: upsetting
upshot: upshot
upstairs: upstairs
urge: urge,urged,urging
urgent: urgent
useless: useless
uselessly: uselessly
usual: usual
utmost: utmost
utter: utter,uttered,uttering
utterly: utterly
vacantly: vacantly
vagabond: vagabond
vague: vague
vaguely: vaguely
vain: vain
vale: vale
valuable: valuable
van: van
vanish: vanished,vanishing
vanity: vanities,vanity
varied: varied
variety: variety
vast: vast
vauxhall: vauxhall
veal: veal
vehemence: vehemence
vein: veins
venerable: venerable
venetian: venetian
venomous: venomous
vent: vent
venture: venture,ventured,venturing
verandah: verandahs
verb: verb
verbal: verbal
verdict: verdict
verge: verging
verse: verse,versed
version: version
verst: versts
vertu: vertu
vestal: vestal
vex: vexed
vexation: vexation
vibrate: vibrating
vice: vice
vicious: vicious
victim: victim,victims
view: view,views
vigilant: vigilant
vigorous: vigorous
vigorously: vigorously
vigour: vigour
vii: vii
viii: viii
vile: vile
vileness: vileness
viler: viler
villa: villa
village: village,villages
villager: villagers
villain: villain
vin: vin
vindictive: vindictive
vindictively: vindictively
violate: violates
violence: violence
violent: violent
violently: violently
violin: violin
virgin: virgin
virtue: virtue,virtues
virtuous: virtuous
vis: vis
vise: vise
visible: visible
vision: vision,visions
visit: visit,visited,visiting,visits
visitation: visitations
visitor: visitor,visitors
vital: vital
vive: vive
vivid: vivid
vividly: vividly
vividness: vividness
vivisect: vivisecting
vocation: vocation
vodka: vodka
voice: voice,voices
voices: voices
voluntary: voluntary
volunteer: volunteered
voluptuous: voluptuous
vouchsafe: vouchsafe,vouchsafed
vow: vowed
vulgar: vulgar
vulgarise: vulgarise
vulgarity: vulgarity
wad: wadded
wadded: wadded
wade: wade,wading
wag: wagging
waggon: waggon
wagner: wagner
wail: wail,wailed,wailing
waist: waist
waistcoat: waistcoat
waisted: waisted
wait: wait,waited,waiting,waits
waiter: waiter,waiters
waiting: waiting
wake: wake,waked,waking,woke
walk: walk,walked,walking,walks
walking: walking
wall: wall,walls
wander: wander,wandered,wandering
wanderer: wanderers
wanderings: wanderings
wantonness: wantonness
ward: ward
warder: warder
wares: wares
warhorse: warhorse
warm: warm,warmer,warming
warming: warming
warmly: warmly
warmth: warmth
warn: warn,warned
warning: warning
warrant: warrant
wash: wash,washed,washing
washing: washing
wasp: wasp
waste: waste,wasted,wastes,wasting
watch: watch,watched,watching
water: water,waters
waterfall: waterfall
waterloo: waterloo
watery: watery
wave: wave,waved,waving
wax: wax,waxed
weak: weak,weaker
weaken: weakened
weakly: weakly
weakness: weakness,weaknesses
wealth: wealth
weapon: weapon
wear: wear,wearing,wears,wore,worn
wearily: wearily
weary: weary
weave: weave,weaving
wedding: wedding
wedlock: wedlock
week: week,weeks
weekly: weekly
weep: weep,weeping,wept
weigh: weigh,weighed,weighing,weighs
weight: weight
weighty: weighty
welfare: welfare
wench: wench,wenches
wet: wet,wetted,wetting
whale: whales
whatsoever: whatsoever
wheel: wheel,wheeled,wheels
whereabouts: whereabouts
whimper: whimper,whimpering
whine: whined
whip: whip,whipped,whips
whirl: whirl,whirling
whirling: whirling
whisk: whisked
whisker: whiskers
whiskered: whiskered
whisper: whisper,whispered,whispering,whispers
whistle: whistled,whistling
white: white
whitish: whitish
wholly: wholly
whosoever: whosoever
wicked: wicked
wide: wide,wider
widow: widow,widows
widower: widower
wife: wife,wives
wild: wild
wilderness: wilderness
wildly: wildly
wiles: wiles
willow: willow
wily: wily
win: win
wind: wind,winding,wound
winded: winded
window: window,windows
wine: wine,wines
wineglassful: wineglassful
wink: wink,winked,winking
winter: winter
wipe: wipe,wiped,wiping
wisdom: wisdom
wise: wise,wiser
wit: wit,wits
witch: witch
withdraw: withdraw,withdrawing,withdrew
wither: withered
witness: witness,witnesses
witted: witted
witticism: witticism
wittily: wittily
witty: wittier,witty
woe: woes
woman: woman,women
womanish: womanish
wonderful: wonderful
wonderfully: wonderfully
wonderingly: wonderingly
wood: wood
wooden: wooden
woollen: woollen
word: word
worker: workers
workman: workman,workmen
workshop: workshop,workshops
worldly: worldly
worm: worm
worn: worn
worried: worried
worry: worried,worries,worry,worrying
worship: worship
worth: worth
worthless: worthless
worthy: worthy
wound: wound,wounded
wounded: wounded
wrap: wrapped,wrapping
wrapper: wrappers
wrath: wrath
wrathful: wrathful
wrathfully: wrathfully
wreath: wreath,wreaths
wreathe: wreathed
wreck: wreck
wretch: wretch,wretches
wretched: wretched
wretchedness: wretchedness
wriggle: wriggling
wring: wringing,wrung
wringing: wringing
wrinkle: wrinkled,wrinkles
writ: writ
write: write,writes,writing,written,wrote
writer: writer,writers
writhe: writhe,writhing
writing: writing
writings: writings
wrong: wrong,wronged,wrongs
wrongdoing: wrongdoing
wrongly: wrongly
yard: yard,yards
yawn: yawn,yawned,yawning
yawning: yawning
yea: yea
yell: yelled
yellow: yellow
yellowish: yellowish
yesterday: yesterday
yield: yielded
yielding: yielding
yonder: yonder
youngster: youngster
youth: youth
youthful: youthful
zeal: zeal
zeus: zeus
zigzag: zigzags
