abandon: abandon,abandoned
abate: abate
abbot: abbot
abhorrence: abhorrence
ability: abilities,ability
abject: abject
ablutions: ablutions
abnormal: abnormal
abode: abode,abodes
abominable: abominable
abomination: abomination
aboriginal: aboriginal
abound: abound,abounded,abounding,abounds
abreast: abreast
abrupt: abrupt
abruptly: abruptly
absence: absence
absent: absent
absolute: absolute
absolutely: absolutely
abstain: abstained,abstaining
absurd: absurd
absurdity: absurdities,absurdity
abundance: abundance
abundant: abundant
abundantly: abundantly
academical: academical
accede: accede,acceded
accept: accept,accepted,accepting
access: access
accession: accession
accident: accident,accidents
accidentally: accidentally
acclamation: acclamations
acclimate: acclimated
acclivity: acclivities
accommodate: accommodate,accommodated,accommodating
accommodation: accommodation,accommodations
accompany: accompanied,accompanies,accompany,accompanying
accomplish: accomplish,accomplished
accomplished: accomplished
accomplishment: accomplishments
accord: accord,accorded,accords
account: account,accounted,accounts
accoutrements: accoutrements
accumulate: accumulate,accumulated,accumulating
accuracy: accuracy
accurate: accurate
accurately: accurately
accuse: accused
accustom: accustomed
accustomed: accustomed
acid: acid
acknowledge: acknowledge,acknowledged
acotyledonous: acotyledonous
acquaint: acquainted
acquaintance: acquaintance,acquaintances
acquire: acquire,acquired,acquiring
acquirement: acquirements
acquisition: acquisition
acre: acres
acrid: acrid
action: action,actions
active: active
actively: actively
activity: activity
actual: actual
aculeata: aculeata
acuminate: acuminated
acute: acute
acutely: acutely
acuteness: acuteness
adam: adam
adamant: adamant
adapt: adapted
adaptation: adaptation
add: add,adding,adds
addict: addicted
addicted: addicted
addiction: addiction
addition: addition,additions
additional: additional
address: address,addressed,addressing
adept: adept
adequate: adequate
adhere: adhered
adherence: adherence
adieu: adieu
adjoin: adjoining
adjust: adjusted
adjutant: adjutant
administration: administration
admirable: admirable
admirably: admirably
admiration: admiration
admire: admire
admired: admired
admit: admit,admits,admitted
adopt: adopt,adopting
adoration: adoration
adorn: adorned,adorning
adultery: adultery
advance: advance,advanced,advances,advancing
advantage: advantage,advantages
advantageously: advantageously
advent: advent
adventure: adventure,adventures
adventurous: adventurous
advice: advice
advisable: advisable
advise: advised,advises
adviser: advisers
adyta: adyta
affability: affability
affable: affable
affair: affair,affairs
affect: affect
affectation: affectation
affection: affection,affections
affectionate: affectionate
affinity: affinity
affirm: affirmed
affirmative: affirmative
affix: affix
affluence: affluence
afford: afford,afforded,affording,affords
affront: affront
afloat: afloat
africa: africa
afternoon: afternoon
agar: agar
age: age,ages
aged: aged
agency: agency
agent: agent,agents
aggrandize: aggrandize
aggregate: aggregate,aggregated
aggression: aggression
agility: agility
agitate: agitate,agitated
agitated: agitated
agra: agra
agree: agree,agreed
agreeable: agreeable
agreeably: agreeably
agricultural: agricultural
agriculture: agriculture
aid: aid,aided
ail: ailing
aim: aim,aimed,aims
air: air,aired
alacrity: alacrity
alar: alar
alarm: alarm
alarmed: alarmed
alba: alba
albino: albino,albinos
albinos: albinos
alcedo: alcedo
alcyonium: alcyonium
alight: alighted,alighting
alignment: alignments
alike: alike
aliment: aliment
alimentary: alimentary
alive: alive
alkali: alkali
allege: alleged,alleging
allegorical: allegorical
alliance: alliance
alligator: alligator,alligators
allot: allot,allotted
allude: allude,alluded
alluvial: alluvial
alluvion: alluvion
ally: allied,allies
almighty: almighty
aloud: aloud
alpine: alpine
altar: altar
alter: alter,altered
alteration: alteration,alterations
alternate: alternate,alternated
alternately: alternately
altitude: altitude
altogether: altogether
aluminous: aluminous
amass: amassed
ambassador: ambassador,ambassadors
ambition: ambition
ambitious: ambitious
ameliorate: ameliorate,ameliorated
amelioration: amelioration
amenable: amenable
american: american,americans
amiable: amiable
amicably: amicably
amiss: amiss
amity: amity
amomum: amomum
amoy: amoy
ample: ample
amply: amply
amuse: amuse,amused
amusement: amusement,amusements
analogous: analogous
analogy: analogies,analogy
analysis: analysis
anana: ananas
anarchy: anarchy
anatomist: anatomist
ancestor: ancestors
anchor: anchor,anchored
anchorage: anchorage
ancient: ancient
anciently: anciently
ancle: ancle
anecdote: anecdote
anger: anger
angle: angle
angular: angular
animal: animal,animals
animated: animated
animation: animation
animus: animus
annals: annals
annex: annexed
annoyance: annoyance
annoyed: annoyed
annual: annual
annually: annually
anoint: anoint
answer: answer,answered,answers
antelope: antelope
anticipate: anticipated
antidote: antidote
antiquity: antiquity
antonio: antonio
anxiety: anxiety
anxious: anxious
apartment: apartment,apartments
apathetic: apathetic
apathy: apathy
aperture: aperture
apex: apex
apis: apis
apology: apology
apostrophe: apostrophes
appalling: appalling
apparatus: apparatus
apparent: apparent
appearance: appearance,appearances
appellation: appellation
appellative: appellative
appendage: appendages
appendix: appendix
appetite: appetites
apple: apple,apples
applicable: applicable
application: application
apply: applied,apply
appoint: appoint,appointed
appointment: appointment
appreciable: appreciable
apprehend: apprehended
apprehension: apprehension,apprehensions
approach: approach,approached,approaches,approaching
approbation: approbation
approve: approve
april: april
apt: apt
aquatic: aquatic
arab: arab,arabs
arabia: arabia
arabian: arabian
arbitrary: arbitrary
arborescent: arborescent
arch: arch
arched: arched
archipelago: archipelago
architect: architects
architectural: architectural
architecture: architecture
arctic: arctic
ardent: ardent
ardour: ardour
arduous: arduous
areca: areca
argue: argue,argued,arguing
argument: argument,arguments
argus: argus
arid: arid
ark: ark
arm: arm,armed,arms
armament: armament
armed: armed
army: armies,army
aromatic: aromatic,aromatics
arrack: arrack
arrange: arrange,arranged
arrangement: arrangement,arrangements
array: arrayed
arrival: arrival
arrive: arrive,arrived,arrives,arriving
arrogance: arrogance
arrogant: arrogant
arrogate: arrogate,arrogated
art: art,arts
artful: artful
article: article,articles
artificer: artificers
artificial: artificial
artillery: artillery
artisan: artisans
artist: artist,artists
arum: arum
ascend: ascend,ascended,ascending,ascends
ascent: ascent
ascertain: ascertain,ascertained,ascertaining
ascertainable: ascertainable
ascertainment: ascertainment
ash: ashes
ashamed: ashamed
asia: asia
asiatic: asiatic
asleep: asleep
aspect: aspect,aspects
aspiration: aspirations
aspire: aspire,aspired,aspires
assemblage: assemblage
assemble: assembled
assent: assent
assert: assert,asserted,asserting
assertion: assertion
assiduity: assiduity
assiduous: assiduous
assign: assigned
assimilate: assimilate,assimilated,assimilating
assist: assist,assisted,assisting
assistance: assistance
assistant: assistant,assistants
associate: associate
assume: assume,assumed,assumes,assuming
assurance: assurance
assure: assure,assured,assuring
assuredly: assuredly
asteria: asteria
astonish: astonish,astonished
astonishing: astonishing
astonishment: astonishment
astringent: astringent
astrologer: astrologers
astrology: astrology
asylum: asylum
athletic: athletic
atmosphere: atmosphere
atmospheric: atmospheric
attach: attach,attached,attaches,attaching
attachment: attachment
attack: attack,attacked,attacking
attain: attain,attained,attaining,attains
attemper: attempered
attempt: attempt,attempted,attempts
attend: attend,attended,attending
attendance: attendance
attendant: attendant,attendants
attention: attention,attentions
attentive: attentive
attentively: attentively
attest: attest,attested
attire: attire
attitude: attitude,attitudes
attract: attract,attracted
attractive: attractive
attribute: attribute,attributed,attributes,attributing
audience: audience,audiences
augment: augment,augmented,augments
augur: augur
augury: auguries
august: august
auspicious: auspicious
authenticity: authenticity
author: author,authors
authoritative: authoritative
authority: authority
authorize: authorized
ava: ava
avail: avail,availed,availing
avarice: avarice
avaricious: avaricious
avenue: avenues
average: average
averse: averse
aversion: aversion
aves: aves
aviary: aviaries
avidity: avidity
avoid: avoid
avowed: avowed
awaken: awaken,awakened
awakening: awakening
award: awarded
aware: aware
awe: awe
awful: awful
awkward: awkward
awkwardly: awkwardly
awkwardness: awkwardness
awning: awning
axis: axes
babylon: babylon
background: background
bad: bad,worse,worst
bag: bag
baggage: baggage
balance: balanced
bale: bales
baleful: baleful
ball: ball
ballast: ballast
bamboo: bamboo,bamboos
ban: ban
banana: banana
band: band,bands
banditti: banditti
baneful: baneful
banish: banishing
banishment: banishment
bank: bank,banks
bar: bar,bars
barbaric: barbaric
barbarous: barbarous
barbet: barbet
bare: bare
barely: barely
barge: barge,barges
barges: barges
bark: bark
barman: barman
barometer: barometer
barometric: barometric
barouche: barouche
barracks: barracks
barren: barren
barrier: barrier,barriers
barringtonia: barringtonia
barrow: barrow
basalt: basalt
basaltic: basaltic
base: base
basin: basin,basins
basis: basis
bask: basking
basket: basket,baskets
bastion: bastions
bat: bats
battery: battery
battle: battle
bay: bay,bays
bayonet: bayonet,bayonets
bazar: bazar,bazars
beach: beach,beaches
bear: bear,bearing,bears,bore,born
beard: beard
bearer: bearers
bearing: bearings
beast: beast,beasts
beat: beat,beaten,beats
beau: beau
beautiful: beautiful
beautifully: beautifully
beauty: beauties,beauty
becalm: becalmed
bed: bed,beds
beef: beef
beg: begged,begging
begirt: begirt
begonia: begonia
behave: behaved
behaviour: behaviour
belief: belief
belly: belly
belong: belong,belonged,belonging,belongs
beloved: beloved
belt: belt
bench: bench,benches
bend: bending,bends
beneath: beneath
benefit: benefit,benefited,benefits
bengal: bengal
benign: benign
benignity: benignity
benignly: benignly
bent: bent
benzoin: benzoin
bespeak: bespoke
bespoke: bespoke
bestow: bestow,bestowed
betel: betel
betray: betrayed
beverage: beverage
bias: bias
bid: bade
bidder: bidder
bilious: bilious
billet: billets
bind: binds,bound
biographical: biographical
bird: bird,birds
birdlime: birdlime
birth: birth
bishop: bishop
bit: bits
bitter: bitter
black: black
blackish: blackish
blacksmith: blacksmith
blame: blame
blank: blank
blast: blasts
blasting: blasting
blaze: blaze
bleach: bleach
blend: blended
blended: blended
blessing: blessing
blind: blind
bliss: bliss
bloated: bloated
block: blocks
blood: blood
blossom: blossom
blow: blow,blowing,blows
blue: blue
bluish: bluish
board: board,boarded,boards
boast: boast,boasts
boat: boat,boats
boats: boats
bodily: bodily
body: bodies,body
boggy: boggy
boil: boiled,boiling
bold: bold
boldly: boldly
boldness: boldness
boletus: boletus
bombay: bombay
bond: bonds
bone: bone,bones
bono: bono
book: book,books
boon: boon
boot: boots
borassus: borassus
border: border,borders
borneo: borneo
borrow: borrowed
bos: bos
botanical: botanical
botanist: botanist,botanists
botany: botany
bottle: bottle,bottles
bound: bounded,bounds
boundary: boundaries,boundary
boundless: boundless
bountiful: bountiful
bow: bow,bowed
box: box,boxes
boxes: boxes
boy: boy,boys
braced: braced
brahman: brahman
brahmans: brahmans
branch: branch,branched,branches
brandy: brandy
brass: brass
brave: brave
bravery: bravery
breach: breach
breadth: breadth
break: break,breaking,breaks,broken
breakfast: breakfast
breast: breast
breed: bred
breeding: breeding
breeze: breeze,breezes
brick: brick,bricks
bride: bride
bridge: bridges
brig: brig
bright: bright
brighten: brighten
brightness: brightness
brilliant: brilliant
bring: bring,bringing,brought
briskly: briskly
bristle: bristles
britain: britain
british: british
brittle: brittle
broad: broad,broadest
bromelia: bromelia
brother: brother,brothers
brothers: brothers
brow: brows
brown: brown
brumal: brumal
brushwood: brushwood
brutal: brutal
brutalize: brutalized,brutalizing
brute: brute
buceros: buceros
bucket: bucket
bud: bud
buddha: buddha
buffalo: buffalo,buffaloes
build: build,building,built
building: building,buildings
bulk: bulk
bulky: bulky
bull: bull,bulls
bullock: bullock,bullocks
bulwark: bulwark
bunch: bunches
bundle: bundle,bundles
bungalows: bungalows
burden: burden
burn: burn,burned,burning,burnt
burns: burns
burst: burst
bury: buried
bush: bushes
bushy: bushy
business: business
buskin: buskin
bustle: bustle
bustling: bustling
busy: busied,busy
button: buttoned,buttoning,buttons
cabalistic: cabalistic
cabin: cabin
cage: cage
cake: cakes
calamus: calamus
calcareous: calcareous
calculate: calculated,calculating
calcutta: calcutta
calendar: calendar
calf: calf
calibre: calibre
calling: calling
calm: calm
calophyllum: calophyllum
cambodia: cambodia
cambodian: cambodians
campong: campong
canal: canal,canals
cancer: cancer
candid: candid
candidly: candidly
candle: candles
candour: candour
candy: candy
cane: cane,canes
canine: canine
canna: canna
cannon: cannon
canoe: canoe,canoes
canopy: canopies,canopy
canton: canton
cantonment: cantonment
cap: cap,caps
capable: capable
capacity: capacity
cape: cape
capital: capital,capitals
capricious: capricious
capsicum: capsicum
captain: captain,captains
captivate: captivated
capture: capture,captured
carcass: carcass
card: cards
cardamom: cardamoms
cardamoms: cardamoms
cardamum: cardamums
care: care,cares
career: career
careful: careful
carefully: carefully
careless: careless
carex: carex
cargo: cargo,cargoes
carica: carica
carnivorous: carnivorous
carpenter: carpenter
carpet: carpet,carpets
carriage: carriages
carry: carried,carries,carry,carrying
cartouche: cartouche
cartridge: cartridge
carve: carved
carved: carved
caryota: caryota
casque: casque
cast: cast
caste: caste
casuarina: casuarina
cat: cat
catalogue: catalogue,catalogues
catastrophe: catastrophes
catch: caught
catechu: catechu
catholic: catholic
cattle: cattle
catty: catties
caucasian: caucasian
caudata: caudata
cauldron: cauldron
cautiously: cautiously
cave: cave,caves
cavity: cavities,cavity
cease: cease,ceased
ceiling: ceiling
celebes: celebes
celebrated: celebrated
celestial: celestial
cell: cells
cellular: cellular
cement: cement
cent: cent
central: central
centre: centre
century: centuries
ceremonies: ceremonies
ceremony: ceremonies,ceremony
certainty: certainty
certhia: certhia
ceylon: ceylon
cha: cha
chain: chain,chains
chair: chair,chairs
cham: cham
chamber: chamber,chambers
chan: chan
chance: chance
chandelier: chandeliers
chang: chang
change: change,changed,changing
channel: channel,channels
chapter: chapter
character: character,characters
characteristic: characteristic
characterize: characterize,characterizes
charcoal: charcoal
charge: charge,charged,charges
charitable: charitable
chart: chart,charts
chasm: chasms
chastity: chastity
cheap: cheap,cheaper,cheapest
cheapness: cheapness
check: check,checked
chee: chee
cheek: cheek,cheeks
cheer: cheers
cheerful: cheerful
cheerfulness: cheerfulness
cherish: cherished,cherishing
cheroot: cheroots
chess: chess
chest: chest
chevalier: chevalier
chew: chewed,chewing
chia: chia
chicken: chickens
chief: chief,chiefs
chiefly: chiefly
child: children
chilli: chillies
chin: chin
china: china
chinaman: chinaman
chinamen: chinamen
chinese: chinese
chink: chink
chintz: chintz
chirp: chirping
chisel: chisels
chit: chit
choice: choice
choke: choking
cholera: cholera
chook: chook
choose: choose,chose,chosen
christian: christian,christians
chroma: chroma
church: church
cinnamon: cinnamon
cir: cir
circle: circle
circuit: circuit
circuitous: circuitous
circular: circular
circumference: circumference
circumscribe: circumscribed
circumstance: circumstance,circumstances
citadel: citadel
citizen: citizens
city: cities,city
civil: civil
civility: civilities,civility
civilization: civilization
civilized: civilized
claim: claim,claimed,claims
clamorous: clamorous
claret: claret
class: class,classes
classical: classical
claw: claws
clay: clay
claystone: claystone
clean: clean
cleanliness: cleanliness
cleanly: cleanly
clearing: clearing
clenched: clenched
clergy: clergy
clerical: clerical
clerk: clerk
clever: clever
cliff: cliffs
climate: climate,climates
climb: climbs
cloak: cloak
clog: clogs
close: close,closer
closely: closely
cloth: cloth
clothe: clad,clothed
clothes: clothes
clothing: clothing
cloud: clouds
cloudy: cloudy
clove: clove
club: clubs
clumsily: clumsily
clumsy: clumsy
coarse: coarse,coarser
coarsely: coarsely
coarseness: coarseness
coast: coast,coasting,coasts
coasting: coasting
coating: coating
cochin: cochin
cock: cock
cocoa: cocoa
code: code
coerce: coerce
coffee: coffee
cognizance: cognizance
coincide: coincide
coincidence: coincidences
cold: cold
collar: collar
collect: collect,collected,collecting
collection: collection,collections
collector: collector,collectors
colonel: colonel
colony: colonies,colony
colour: colour,coloured,colours
coloured: coloured
columba: columba
column: column
comb: comb
combat: combat
combination: combination
combine: combining
combined: combined
combustible: combustible
combustion: combustion
comedy: comedy
comfort: comfort,comforted,comforts
comfortable: comfortable
comfortably: comfortably
command: command,commanded,commanding,commands
commander: commander
commemorate: commemorate
commence: commence,commenced,commences
commencement: commencement
comment: comment
commerce: commerce
commercial: commercial
commission: commission
commit: committed
commo: commo
commodious: commodious
commodity: commodities
common: common
commonly: commonly
commotion: commotion
communicate: communicate,communicated
communication: communication,communications
communicative: communicative
communis: communis
community: community
compact: compact
companion: companions
company: company
comparative: comparative
comparatively: comparatively
compare: compare,compared,compares
comparison: comparison,comparisons
compartment: compartments
compass: compass
compatible: compatible
compel: compelled
compensate: compensated,compensating
compensation: compensation
competence: competence
competition: competition
compilation: compilation
complain: complain,complained
complaint: complaint,complaints
complete: complete,completed,completes,completing
completely: completely
complex: complex
complexion: complexion
compliance: compliance
compliment: compliment
complimentary: complimentary
comply: complied,comply,complying
compose: compose,composed,composes,composing
compound: compound,compounds
comprehend: comprehend,comprehended
compress: compressed
compressed: compressed
compulsion: compulsion
conceal: conceal,concealed,concealing
concede: conceded
conceited: conceited
conceive: conceive,conceived,conceives,conceiving
concentrated: concentrated
concern: concerns
concerned: concerned
concession: concession,concessions
conchoidal: conchoidal
conciliate: conciliating
conciliation: conciliation
conclude: conclude,concluded,concluding
conclusion: conclusion
conclusive: conclusive
concourse: concourse
concrete: concrete
condescend: condescend
condescension: condescension
condiment: condiment
condition: condition,conditions
condor: condor
conducive: conducive
conduct: conduct,conducted,conducting,conducts
cone: cone
confer: confer,conferred,conferring,confers
conference: conference,conferences
confess: confess,confessed
confidence: confidence
configuration: configuration
confine: confine,confined
confinement: confinement
confines: confines
confirm: confirm,confirmed
confirmation: confirmation
conflagration: conflagration
confucius: confucius
congenial: congenial
conglomerate: conglomerate
congratulate: congratulate
conical: conical
conjecture: conjecture
conjointly: conjointly
conjunction: conjunction
connect: connected,connecting
connected: connected
connexion: connexion
conquer: conquered
conquest: conquest
conscience: conscience
conscious: conscious
consent: consent,consented
consequence: consequence,consequences
considerable: considerable
considerably: considerably
consideration: consideration
consign: consigned
consist: consist,consisted,consisting,consists
consistence: consistence
consistent: consistent
conspicuous: conspicuous
conspiracy: conspiracy
conspire: conspired
constant: constant
constantine: constantine
constantly: constantly
constitute: constitute,constituted,constitutes,constituting
constitution: constitution,constitutions
constrain: constrained
construct: construct,constructed,constructing
construction: construction
consul: consul
consult: consult
consume: consumed
consumption: consumption
contact: contact
contemplate: contemplate,contemplated
contemplative: contemplative
contempt: contempt
contemptible: contemptible
contend: contend,contending
content: content
contented: contented
contents: contents
contest: contest
contiguous: contiguous
continent: continent
continental: continental
continual: continual
continually: continually
continuance: continuance
continue: continue,continued,continues,continuing
continued: continued
continuous: continuous
contorted: contorted
contraband: contraband
contract: contract,contracted
contrary: contrary
contrast: contrast,contrasted
contribute: contributed,contributing
contrivance: contrivance
contrived: contrived
control: control
convenience: convenience
convenient: convenient
conversation: conversation,conversations
converse: converse,conversed,conversing
convert: converted,converting,converts
convexity: convexity
convey: convey,conveyed,conveying
conveyance: conveyance
convince: convinced
convoluted: convoluted
convolvuli: convolvuli
convolvulus: convolvulus
cook: cooked,cooking
cool: cool
coolly: coolly
coolness: coolness
copious: copious
copper: copper
coral: coral,corals
corals: corals
cord: cord,cords
cordage: cordage
cordiality: cordiality
corn: corn,corns
corner: corner
coromandel: coromandel
corona: corona
coronoid: coronoid
corporal: corporal
corporation: corporation
corpse: corpse
corpus: corpus
correct: correct,corrected
correctly: correctly
correctness: correctness
correspond: correspond,corresponds
correspondence: correspondence
corrugated: corrugated
corrupt: corrupt
corvus: corvus
cosmetic: cosmetic
cost: cost,costs
costly: costly
costume: costume
cotton: cotton
couch: couch
council: councils
counselling: counselling
counsellor: counsellor
count: count
countenance: countenance,countenances
counter: counter
counteract: counteract
countermand: countermand
counterpart: counterpart
countless: countless
country: countries,country
countryman: countrymen
coup: coup
couple: couple
courage: courage
court: court,courted,courts
courtly: courtly
cover: cover,covered,covering,covers
covered: covered
covering: covering
cow: cow,cows
cows: cows
crab: crabs
crania: crania
cranium: cranium
crape: crape,crapes
crawl: crawl,crawled,crawling
crazy: crazy
create: created
creation: creation
creature: creature,creatures
credentials: credentials
credible: credible
credit: credit,credited
creditable: creditable
creek: creek,creeks
creep: creep,creeping
crevice: crevice
crew: crew
crime: crime,crimes
criminal: criminal
crinum: crinum
crooked: crooked
crop: crops
cross: cross,crossed,crossing
crouch: crouched
crout: crout
crowd: crowd,crowded,crowds
crowded: crowded
crown: crown,crowned
crude: crude
cruel: cruel
cruelty: cruelty
crush: crushed
crustacea: crustacea
crystal: crystals
crystallize: crystallized
cube: cubes
culinary: culinary
culpable: culpable
culprit: culprit
cultivate: cultivate,cultivated
cultivation: cultivation
cultivator: cultivator,cultivators
culture: culture
cunning: cunning
cup: cup,cups
cupboard: cupboard
cupidity: cupidity
cure: cure
curiosity: curiosity
curious: curious
curl: curl,curled
current: current,currents
currier: currier
cursory: cursory
curtain: curtain,curtains
curved: curved
cushion: cushion,cushions
custard: custard
custom: custom,customs
customary: customary
customs: customs
cut: cut,cuts,cutting
cuticle: cuticle
cuticular: cuticular
cycas: cycas
cylindrical: cylindrical
cymbal: cymbals
cynosurus: cynosurus
dagoba: dagoba
daily: daily
damage: damaged
damp: damp
danger: danger,dangers
dangerous: dangerous
daring: daring
dark: dark,darker
darken: darkened
darkness: darkness
datum: data
daughter: daughter,daughters
day: day,days
dead: dead
deafness: deafness
death: death
debase: debased
debased: debased
debasing: debasing
debt: debt,debted
debtor: debtors
decanter: decanters
decapitation: decapitation
decay: decayed
decayed: decayed
deceased: deceased
deceitful: deceitful
deceive: deceive
december: december
decency: decency
decent: decent
decently: decently
decide: decide,decided
decidedly: decidedly
decision: decision,decisions
decisive: decisive
deck: deck
declare: declared
decline: decline,declined,declines
decoction: decoction
decompose: decompose,decomposed
decomposition: decomposition
decoration: decorations
decorous: decorous
decorum: decorum
decrease: decreasing
decrepit: decrepit
dedicate: dedicated
deed: deed
deem: deem,deemed
deep: deep,deeper,deepest
deer: deer
defective: defective
defence: defence
defend: defend
defiance: defiance
deficiency: deficiency
deficient: deficient
define: defined
deform: deformed
degenerate: degenerated
degradation: degradation
degrade: degrade,degraded
degrading: degrading
degree: degree,degrees
deign: deign,deigned
deity: deities,deity
delay: delay,delayed
delectable: delectable
delegate: delegated
delhi: delhi
deliberate: deliberate
deliberation: deliberation
delicacy: delicacies,delicacy
delicate: delicate
delicious: delicious
delight: delight
delighted: delighted
delightful: delightful
deliver: deliver,delivered,delivers
delivery: delivery
deluge: deluged
demand: demand,demanded,demands
demeanour: demeanour
demolish: demolishing
demonstration: demonstration
dense: dense
densely: densely
density: density
dentition: dentition
deny: denied,deny
depart: depart,departed
department: department,departments
departure: departure
depend: depend,depended
dependence: dependence
dependent: dependent
deposit: deposited,depositing
depository: depositories
depress: depressed
depth: depth
depths: depths
deputation: deputation,deputations
deputy: deputies,deputy
derision: derision
derive: derive,derived,derives,deriving
dernier: dernier
des: des
descend: descend,descended,descending,descends
descendant: descendants
description: description,descriptions
descry: descry
desert: desert,deserted,deserts
deserted: deserted
deserve: deserve,deserves,deserving
deserving: deserving
design: design
designate: designate
desirable: desirable
desire: desire,desired,desiring
desirous: desirous
desisted: desisted
despatch: despatched
despise: despise
despot: despots
despotic: despotic
despotism: despotism
dessert: dessert
destine: destined
destitute: destitute
destroy: destroyed,destroying
destruction: destruction
destructive: destructive
desultory: desultory
detach: detached,detaches
detachment: detachment
detain: detain,detained
detect: detect,detected,detecting
determination: determination
determine: determine,determined
detritus: detritus
develop: developed
developed: developed
developement: developement
development: development
deviate: deviate
deviation: deviation
device: devices
devise: devise
devote: devote,devoted
devoted: devoted
devotion: devotion
devotions: devotions
devour: devoured
devout: devout
dew: dews
dexterity: dexterity
dexterous: dexterous
dharma: dharma
di: di
dialect: dialects
diameter: diameter,diameters
diamond: diamonds
dice: dice
dictate: dictate,dictates
die: died,dies
diet: diet
difference: difference,differences
difficult: difficult
difficulty: difficulties,difficulty
diffuse: diffuse
dignified: dignified
dignity: dignity
digression: digression
dim: dim
dimension: dimension,dimensions
diminish: diminish,diminished,diminishes,diminishing
diminished: diminished
diminutive: diminutive
dine: dine,dined
dining: dining
dinner: dinner
dioscorea: dioscorea
dip: dip,dipping
diplomatic: diplomatic
direct: direct,directed,directing
direction: direction,directions
director: director,directors
dirty: dirty
dis: dis
disagreeable: disagreeable
disappear: disappear,disappeared
disappoint: disappoint,disappointed
disappointed: disappointed
disappointment: disappointment
disastrous: disastrous
discerning: discerning
discernment: discernment
discharge: discharge,discharged,discharges
disciple: disciples
discipline: discipline
disclaim: disclaimed
disconcert: disconcerted
discontent: discontent
discordant: discordant
discourage: discouraging
discover: discover,discovered,discovering,discovers
discoverable: discoverable
discoverer: discoverer
discovery: discoveries,discovery
discreditable: discreditable
discriminate: discriminating
discrimination: discriminations
discuss: discussed
discussion: discussion
disease: disease,diseases
diseased: diseased
disembark: disembarked
disfigured: disfigured
disgrace: disgrace
disgraceful: disgraceful
disgust: disgust
disgusting: disgusting
dish: dish,dishes
dishonest: dishonest
disintegrate: disintegrated
disinterested: disinterested
disinterestedness: disinterestedness
disjointed: disjointed
dislocate: dislocated
dismount: dismounted
disorganized: disorganized
disparagement: disparagement
dispense: dispensed
disperse: disperse,dispersed
dispirited: dispirited
displace: displaced
display: display,displayed
displease: displeasing
displeased: displeased
disposal: disposal
dispose: dispose,disposed,disposing
disposed: disposed
disposition: disposition
disproportionate: disproportionate
dispute: disputes
disregard: disregard,disregarding
disregarding: disregarding
disreputable: disreputable
disrespect: disrespect
disrespectful: disrespectful
disseminate: disseminated
dissimilar: dissimilar
dissolute: dissolute
distance: distance,distances
distant: distant
distended: distended
distending: distending
distil: distilling
distinct: distinct
distinction: distinction,distinctions
distinctive: distinctive
distinctly: distinctly
distinguish: distinguish,distinguished
distinguished: distinguished
distract: distracted
distress: distress,distresses
distressing: distressing
distribute: distributed
distribution: distribution
distributive: distributive
district: district,districts
distrust: distrust
disturb: disturbed
disturbance: disturbance
dit: dit
ditch: ditch
diurnal: diurnal
diver: diver
diversified: diversified
diversify: diversified
diversity: diversity
divide: divide,divided,divides,dividing
divination: divination
divine: divine
divinity: divinity
division: division
doctrine: doctrine,doctrines
document: document,documents
dodecahedral: dodecahedral
dog: dog,dogs
dollar: dollar,dollars
dolomite: dolomite
domain: domain
dome: dome
domestic: domestic
domesticate: domesticated
domini: domini
dominion: dominion,dominions
donald: donald
dong: dong
doom: doomed
door: door,doors
dot: dots,dotted
dotted: dotted
double: double
doubt: doubt,doubted,doubting,doubts
doubtless: doubtless
dove: dove
dow: dowed
dozen: dozen
drachm: drachms
drag: dragged
dragon: dragon
dragoon: dragoons
draining: draining
drama: drama
draw: draw,drawn,draws,drew
drawing: drawings
dread: dread,dreaded
dream: dreamt
dreary: dreary
drench: drenched
drenching: drenching
dress: dress,dressed,dresses,dressing
dressed: dressed
drink: drink
drive: drive,driven,driving,drove
drop: drop,dropped
drought: drought
dry: dried,dry,drying
dryly: dryly
du: du
duan: duan
duck: ducks
dugong: dugong
dull: dull
duly: duly
duodecennial: duodecennial
duplicate: duplicate
duplicity: duplicity
durable: durable
durian: durian
dust: dust
dutch: dutch
duty: duties,duty
dwell: dwell,dwelt
dwelling: dwelling
dwellings: dwellings
dye: dye,dyed
dyn: dyn
eager: eager
eagerly: eagerly
eagerness: eagerness
ear: ear
earnest: earnest
earnestly: earnestly
earnestness: earnestness
earth: earth
earthen: earthen
earthless: earthless
earthly: earthly
earthy: earthy
ease: ease
easily: easily
east: east
easterly: easterly
eastern: eastern
easy: easier,easy
eat: ate,eat,eaten,eating
eating: eating
ebb: ebb
eccentricity: eccentricity
echini: echini
eco: eco
economical: economical
economy: economy
edge: edge,edges
edifice: edifice,edifices
edinburgh: edinburgh
editor: editor
educate: educate,educated
education: education
effects: effects
effervesce: effervesce
effort: effort,efforts
egg: eggs
eggs: eggs
egypt: egypt
egyptian: egyptian,egyptians
eheu: eheu
eighteen: eighteen
eighth: eighth
elapse: elapse,elapsed
elasticity: elasticity
elate: elate
elated: elated
elbow: elbow
eld: eldest
elderly: elderly
electric: electric
eleemosynary: eleemosynary
elegance: elegance
elegant: elegant
elegantly: elegantly
element: element,elements
elephant: elephant,elephants
elephantiasis: elephantiasis
elevate: elevated
elevated: elevated
elevation: elevation,elevations
elicit: elicited,eliciting
elongated: elongated
embalm: embalming
embankment: embankment,embankments
embark: embark,embarked
embarkation: embarkation
embassy: embassy
embayed: embayed
emblem: emblem,emblems
emblematical: emblematical
emblems: emblems
emboss: embossed
embrace: embrace,embraces
embrasure: embrasures
embroider: embroidered
embroidery: embroidery
emerald: emerald
emerge: emerges
emigrant: emigrant,emigrants
emigrants: emigrants
emigration: emigration
eminence: eminences
eminent: eminent
eminently: eminently
emit: emit,emits
empire: empire
employ: employ,employed,employing
employer: employers
employment: employment,employments
emporium: emporium
en: en
enable: enable,enabled
enactment: enactment
enclose: enclose,enclosed,encloses
enclosure: enclosure,enclosures
encomium: encomium
encourage: encourage,encouraged
encouragement: encouragement
encroach: encroaches,encroaching
encroachment: encroachment
endear: endear
endeavour: endeavour,endeavoured,endeavouring
endless: endless
endow: endowed
endowment: endowment
endue: endued
enemy: enemies,enemy
energetic: energetic
energy: energy
enforce: enforce,enforced
engage: engage,engaged,engaging
engaged: engaged
engagement: engagements
engine: engine,engines
england: england
english: english
engrave: engraved
engross: engrosses
enjoy: enjoy,enjoyed,enjoying
enjoyment: enjoyment
enlarge: enlarge,enlarged
enlighten: enlightened
enliven: enliven
enormous: enormous
enrich: enrich,enriched,enriching
enrol: enrolled
enslave: enslaved
ensue: ensued
ensure: ensure
entail: entail
enter: enter,entered,entering
enterprise: enterprise
enterprising: enterprising
entertain: entertain,entertained,entertaining
entertained: entertained
entertaining: entertaining
entertainment: entertainment,entertainments
enthusiastically: enthusiastically
entice: enticed
entire: entire
entitle: entitle,entitled
entrance: entrance
entrenchment: entrenchments
entry: entries
enumerate: enumerate,enumerated
envelop: enveloped
enviable: enviable
environs: environs
envoy: envoy,envoys
epic: epic
epicurean: epicurean
epidendrum: epidendrum
epidermis: epidermis
equable: equable
equal: equal,equalled
equally: equally
equator: equator
equatorial: equatorial
equip: equipped
equipment: equipment,equipments
equitable: equitable
equity: equity
equivalent: equivalent
equivocate: equivocated
era: era
erect: erect,erected
erratum: erratum
erroneous: erroneous
erroneously: erroneously
error: errors
erythrina: erythrina
escape: escaped,escaping
esculent: esculent
essay: essay
essential: essential
essentially: essentially
establish: establish,established,establishing
established: established
establishment: establishment
esteem: esteem,esteemed
esteemed: esteemed
estimate: estimate,estimated
ether: ether
ethiopia: ethiopia
ethiopian: ethiopian
ethiopic: ethiopic
etiquette: etiquette
eunuch: eunuch
euphorbia: euphorbia
europe: europe
european: european,europeans
evade: evaded
evaporation: evaporation
evasive: evasive
evening: evening
event: event,events
everard: everard
everlasting: everlasting
evidence: evidence
evident: evident
evidently: evidently
evil: evil,evils
evince: evince,evinced
exact: exact,exacted
exaggerate: exaggerated,exaggerating
exaggerated: exaggerated
exalt: exalted
examination: examination,examinations
examine: examine,examined,examining
exceed: exceed,exceeded,exceeding,exceeds
exceedingly: exceedingly
excel: excel
excellence: excellence
excellent: excellent
exception: exception,exceptions
excess: excess
excessive: excessive
excessively: excessively
exchange: exchange
excite: excite,excited,excites
excited: excited
excitement: excitement
exciting: exciting
exclaim: exclaimed
exclude: excluded,excluding
exclusion: exclusion
exclusive: exclusive
exclusively: exclusively
excursion: excursion,excursions
excuse: excused
execute: execute,executed
execution: execution
exemplar: exemplar,exemplars
exemplify: exemplified
exempt: exempt,exempted
exercise: exercise,exercises
exert: exert,exerted,exerts
exertion: exertion,exertions
exhalation: exhalations
exhale: exhaled
exhaustion: exhaustion
exhibit: exhibit,exhibited,exhibiting,exhibits
exhibition: exhibition
exile: exile,exiled
exist: exist,existed,existing,exists
existence: existence
existing: existing
exit: exit
expand: expanded,expands
expanse: expanse
expansion: expansion
expatiate: expatiate
expect: expect,expected
expectant: expectant
expectation: expectation,expectations
expedient: expedient
expedite: expedite
expedition: expedition
expel: expelled
expend: expended,expends
expense: expense
expensive: expensive
experience: experience,experienced
experienced: experienced
experiment: experiment,experiments
expert: expert
expiration: expiration
explain: explain,explained,explaining,explains
explanatory: explanatory
explore: exploring
export: export,exported
exportation: exportation
expose: expose,exposed,exposes,exposing
exposed: exposed
exposure: exposure
express: express,expressed,expresses,expressing
expression: expression,expressions
expressive: expressive
expressly: expressly
extend: extend,extended,extending,extends
extensive: extensive
extensively: extensively
extent: extent
extenuation: extenuation
exterior: exterior
external: external
externally: externally
extinguish: extinguished,extinguishing
extol: extolled
extra: extra
extract: extract,extracts
extraction: extraction
extraordinary: extraordinary
extravagance: extravagance
extravagant: extravagant
extreme: extreme
extremely: extremely
extremity: extremities,extremity
extricate: extricate
exuberant: exuberant
exultation: exultation
eye: eye,eyes
eyebrow: eyebrows
eyelid: eyelid
fabric: fabric
fabulous: fabulous
facial: facial
facility: facilities,facility
factions: factions
factory: factory
faculty: faculties,faculty
fail: fail,failed,failing
failing: failings
fair: fair
faith: faith
faithful: faithful
falco: falco
fall: fall,fallen,falling,fell
fallacious: fallacious
false: false
falsehood: falsehood
fame: fame
familiar: familiar
familiarity: familiarity
family: families,family
famine: famine
famished: famished
famous: famous
fan: fans
fanaticism: fanaticism
fanciful: fanciful
fancy: fancied,fancy
fane: fane
fantastic: fantastic
fare: fare,faring
farinaceous: farinaceous
farrel: farrel
fascinate: fascinate
fashion: fashion,fashioned
fashionable: fashionable
fast: fast,faster
fasten: fastened
fat: fat
fatal: fatal
fatality: fatality
fate: fate
father: father
fathom: fathoms
fatigue: fatigue,fatiguing
fault: fault
favour: favour,favoured
favourable: favourable
favourably: favourably
favoured: favoured
favourite: favourite
fawn: fawning
fear: fear,feared,fears
fearful: fearful
feast: feast,feasted
feat: feats
feather: feathers
feature: feature,features
february: february
feeble: feeble
feed: fed,feed,feeding,feeds
feeder: feeders
feeding: feeding
feel: feel,feeling
feeler: feelers
feeling: feeling,feelings
feign: feigned
feldspar: feldspar
felicity: felicity
felis: felis
fell: felled
fellow: fellow
female: female,females
females: females
feminine: feminine
fence: fences
fern: fern,ferns
ferocious: ferocious
ferry: ferried
fertile: fertile
fertility: fertility
festival: festival,festivals
festivity: festivities,festivity
festoon: festoons
fever: fever
fibre: fibre,fibres
fibrous: fibrous
fickle: fickle
ficus: ficus
fidelity: fidelity
field: field,fields
fierce: fierce,fiercest
fiery: fiery
fight: fight,fighting
figure: figure,figures
filial: filial
filiation: filiation
final: final
finally: finally
fine: fine,finer,finest
finely: finely
finger: finger
finish: finished
finished: finished
firewood: firewood
firm: firm,firmest
firmly: firmly
firmness: firmness
fish: fish,fishes
fisherman: fishermen
fishery: fisheries
fishing: fishing
fissure: fissure
fist: fist
fit: fit,fitted,fitting
fitness: fitness
fitzclarence: fitzclarence
flabby: flabby
flag: flag
flageolet: flageolet
flame: flame
flank: flanks
flannel: flannel
flap: flap
flat: flat
flatly: flatly
flatness: flatness
flatter: flattered
flattering: flattering
flattery: flattery
flavour: flavour
fledge: fledged
fleet: fleet,fleets
flesh: flesh
fleshy: fleshy
flexile: flexile
flicker: flickering
flight: flight,flights
flint: flint
flinty: flinty
float: float,floated,floating,floats
floor: floor,floors
flourish: flourish
flourishing: flourishing
flow: flow,flowing
flower: flower,flowered,flowering,flowers
flowering: flowering
fluency: fluency
fluid: fluid,fluids
fluted: fluted
flutter: fluttered
fly: flies,fly,flying
flying: flying
foh: foh
foil: foil
foliage: foliage
foliated: foliated
follow: follow
follower: followers
folly: folly
fond: fond
food: food
foolish: foolish
foot: feet,foot
footed: footed
footing: footing
footnote: footnotes
footstep: footsteps
foramen: foramen
forbid: forbid,forbidding,forbids
force: force,forced,forces
forcibly: forcibly
fore: fore
forehead: forehead
foreign: foreign
foreigner: foreigners
forenoon: forenoon
foresee: foreseen
forest: forest,forests
foretaste: foretaste
forewarn: forewarned
forget: forgetting,forgotten
forgive: forgive,forgiven
form: form,formed,forming,forms
formal: formal
formality: formality
formation: formation,formations
formidable: formidable
forsake: forsaken
fort: fort
fortification: fortification,fortifications
fortified: fortified
fortify: fortified
fortress: fortress
fortunate: fortunate
fortunately: fortunately
fortune: fortune,fortunes
foster: fostering
foundation: foundation,foundations
fours: fours
fourteen: fourteen
fourth: fourth,fourths
fowl: fowl,fowls
fowls: fowls
fracture: fracture,fractured
fragment: fragments
fragmented: fragmented
fragrance: fragrance
frail: frail
frailty: frailties
frame: frame,frames
france: france
francis: francis
frangible: frangible
fraternity: fraternity
freedom: freedom
freely: freely
freight: freighted
french: french
frenchman: frenchman,frenchmen
frenchmen: frenchmen
frequency: frequency
frequent: frequent,frequented
frequently: frequently
fresh: fresh
friable: friable
friday: friday
friend: friend,friends
friendly: friendly
friendship: friendship
frigate: frigate
frightened: frightened
frightful: frightful
fringe: fringe
frippery: frippery
fro: fro
frond: frond,fronds
frontier: frontier
frontispiece: frontispiece
fruit: fruit,fruits
frustrated: frustrated
fu: fu
fuci: fuci
fucus: fucus
fuel: fuel
fulfil: fulfilled
fulica: fulica
fulness: fulness
function: function,functions
fund: funds
funeral: funeral,funerals
funereal: funereal
fungi: fungi
fur: fur
furious: furious
furiously: furiously
furnish: furnish,furnished,furnishes
furnished: furnished
furnishing: furnishing
furniture: furniture
furs: furs
fury: fury
future: future
futurity: futurity
gain: gain,gained,gaining,gains
galeopithecus: galeopithecus
gallinaceous: gallinaceous
gallus: gallus
gambir: gambir
gambling: gambling
gamboge: gamboge
game: games
gange: ganges
gangetic: gangetic
gangway: gangway
garcinia: garcinia
garden: garden,gardens
garment: garment,garments
garrison: garrison
gate: gate,gates
gather: gathered
gaudy: gaudy
gay: gay,gayest
gaze: gazed
gelatinous: gelatinous
genera: genera
generality: generality
generate: generates
generation: generation
generic: generic
generosity: generosity
generous: generous
genial: genial
genius: genius
gentle: gentle
gentleman: gentleman,gentlemen
gently: gently
genuine: genuine
genuineness: genuineness
genus: genus
geographic: geographic
geographical: geographical
geologic: geologic
geological: geological
geology: geology
george: george
german: german
germinate: germinating
gibe: gibes
gift: gift,gifts
gigantic: gigantic
gild: gilding
gilded: gilded
gilt: gilt
girl: girl,girls
girth: girth
glabellum: glabellum
glacis: glacis
glad: glad
glance: glance
gland: gland
glandular: glandular
glare: glare
glass: glass,glasses
glazed: glazed
gleam: gleam
globe: globe
globular: globular
globule: globules
gloomy: gloomy
glory: glory
gneiss: gneiss
goat: goat,goats
goats: goats
gobble: gobbled
goblet: goblet
goblin: goblins
god: god,gods
goitre: goitre
gold: gold
golden: golden
goose: geese
govern: governed
government: government,governments
governor: governor
gown: gown,gowns
gradual: gradual
gradually: gradually
grain: grain,grained,grains
grained: grained
grammar: grammar
granary: granaries
grand: grand
grandeur: grandeur
granite: granite
granitic: granitic
grant: grant,granted,granting
granular: granular
grape: grape,grapes
grasp: grasped
grass: grass,grasses
grassy: grassy
grate: grating
grateful: grateful
gratification: gratification
gratified: gratified
gratify: gratified,gratify,gratifying
gratifying: gratifying
gratitude: gratitude
grave: grave
gravity: gravity
gray: gray
grayish: grayish
greatly: greatly
grecian: grecian
gree: gree
greek: greek
green: green,greens
greenish: greenish
gregarious: gregarious
grey: grey
grievance: grievance,grievances
grimace: grimace
grind: grinding,ground
grisly: grisly
gritty: gritty
gross: gross
grotesque: grotesque
ground: ground
groundless: groundless
grounds: grounds
grovel: grovelling
grovelling: grovelling
grow: grew,grow,growing,grown,grows
growl: growl
growth: growth
guard: guard,guarded,guards
guide: guided,guides,guiding
guilty: guilty
gulf: gulf
gummy: gummy
gun: gun,guns
gymnastic: gymnastic
habiliment: habiliments
habit: habit,habited,habits
habitation: habitation,habitations
habituated: habituated
hail: hailed
hair: hair,hairs
hairy: hairy
hale: hale
hall: hall
halt: halted
halted: halted
ham: ham
hamilton: hamilton
hammer: hammer
hammock: hammock,hammocks
han: han
hand: hand,handed,hands
handful: handful
handkerchief: handkerchief
handle: handles
handsome: handsome,handsomest
hang: hang,hung
happen: happened,happening
happiness: happiness
happy: happiest,happy
harass: harassing
harbour: harbour,harbours
hard: hard
hardness: hardness
hardship: hardship,hardships
hardy: hardy
hare: hare
hares: hares
harmonize: harmonize
harmony: harmony
harsh: harsh
harshness: harshness
harvest: harvest
haste: haste
hasty: hasty
hat: hat,hats
hatch: hatched
hatchet: hatchets
hateful: hateful
hatred: hatred
haughty: haughty
haul: hauled
haunt: haunt,haunts
hawk: hawked,hawking
haya: haya
hazardous: hazardous
head: head,headed,heading,heads
headed: headed
health: health
healthy: healthy
heap: heaped
hear: hear,heard,hearing
hearing: hearing
heart: heart
hearted: hearted
heartily: heartily
heat: heat
heaven: heaven
heavily: heavily
heaviness: heaviness
heavy: heavy
hedge: hedge,hedges
height: height,heights
heighten: heightened,heightening
heightened: heightened
heir: heir
heliotrope: heliotrope
helmet: helmet,helmets
helpless: helpless
helplessness: helplessness
hemisphere: hemisphere,hemispheres
herb: herb,herbs
herbaceous: herbaceous
herbage: herbage
herd: herd
hero: hero,heroes
heron: heron
hesitate: hesitate
hesitation: hesitation
hibiscus: hibiscus
hic: hic
hide: hides
hideous: hideous
highly: highly
hill: hill,hills
hilly: hilly
himalaya: himalaya
himalayan: himalayan
hind: hind
hindu: hindu
hinduism: hinduism
hindus: hindus
hindustani: hindustani
hint: hint,hinted,hints
hippopotamus: hippopotamus
historical: historical
history: history
hitherto: hitherto
hoard: hoard
hobgoblin: hobgoblins
hoc: hoc
hog: hogs
hold: held,hold,holding,holds
hole: holes
hollow: hollow,hollowed,hollowing
holothuria: holothuria
homage: homage
homogeneous: homogeneous
honest: honest
honesty: honesty
honey: honey
honour: honour,honoured,honours
honourable: honourable
honourably: honourably
hope: hope,hoped,hopes,hoping
hopeless: hopeless
hora: hora
horizon: horizon
horizontal: horizontal
horizontally: horizontally
horn: horn,horns
hornblende: hornblende
horrible: horrible
horrid: horrid
horror: horror
horse: horse,horses
horseback: horseback
hospitable: hospitable
hospitably: hospitably
hospital: hospital
hospitality: hospitality
host: host,hosts
hostile: hostile
hot: hot
hour: hour,hours
hourly: hourly
house: house,houses
household: household
houses: houses
housing: housings
hover: hover,hovering
hoya: hoya
hue: hue
huge: huge
human: human
humane: humane
humanity: humanity
humble: humble
humbly: humbly
humid: humid
humiliating: humiliating
humour: humour
humoured: humoured
hung: hung
hunger: hunger
hungry: hungry
hunterian: hunterian
hunting: hunting
hurt: hurt
hurtful: hurtful
husband: husband
hut: hut,huts
idea: idea,ideas
identify: identified,identify
idle: idle,idling
idleness: idleness
idly: idly
idol: idol,idols
ignominy: ignominy
ignorance: ignorance
ignorant: ignorant
iii: iii
illegitimate: illegitimate
illiberal: illiberal
illness: illness
illustrate: illustrate,illustrated
illustrative: illustrative
image: image,images
imaginary: imaginary
imagination: imagination
imaginative: imaginative
imagine: imagine,imagined
imbecility: imbecility
imbed: imbedded
imbue: imbued
immaterial: immaterial
immense: immense
immerse: immersed
immoderate: immoderate
immoderately: immoderately
immoveable: immoveable
immunity: immunities
immutable: immutable
imp: imps
impatient: impatient
impede: impede,impeded
impel: impel
impenetrable: impenetrable
imperceptible: imperceptible
imperfect: imperfect
imperfection: imperfection
imperfectly: imperfectly
imperial: imperial
impervious: impervious
impetuosity: impetuosity
impiously: impiously
implacable: implacable
implant: implanted
imply: imply
impolite: impolite
import: import,imported
importunate: importunate
importune: importune
importunity: importunities
impose: imposed,imposing
imposing: imposing
impossible: impossible
impoverished: impoverished
impracticable: impracticable
impress: impress
impressed: impressed
impression: impression
impressive: impressive
imprint: imprinted
improbable: improbable
improper: improper
improve: improve,improved
improvement: improvement,improvements
impudent: impudent
impudently: impudently
impulse: impulse,impulses
impunity: impunity
inadequate: inadequate
inanimate: inanimate
inattention: inattention
inattentive: inattentive
inauspicious: inauspicious
incalculable: incalculable
incapable: incapable
incapacity: incapacity
incessant: incessant
incessantly: incessantly
inch: inch,inches
incidentally: incidentally
incisor: incisors
incisorial: incisorial
inclination: inclination,inclinations
incline: inclining
inclined: inclined
include: included,including
incomparably: incomparably
inconceivable: inconceivable
inconceivably: inconceivably
inconsiderable: inconsiderable
inconsistency: inconsistencies,inconsistency
inconsistently: inconsistently
inconvenience: inconvenience,inconveniences
inconvenient: inconvenient
incorporate: incorporated
incorrect: incorrect
increase: increase,increased,increasing
incredible: incredible
incrustation: incrustation
inculcate: inculcated,inculcates,inculcating
incumbent: incumbent
incur: incur,incurred
incurious: incurious
indebt: indebted
indebted: indebted
indecorum: indecorum
indefatigable: indefatigable
indefinite: indefinite
independence: independence
independent: independent
india: india
indian: indian,indians
indication: indication,indications
indifference: indifference
indifferent: indifferent
indifferently: indifferently
indigenous: indigenous
indignation: indignation
indirectly: indirectly
indispensable: indispensable
indistinct: indistinct
individual: individual,individuals
individually: individually
indolence: indolence
indolent: indolent
indolently: indolently
induce: induce,induced,induces,inducing
indulge: indulge,indulged
indulgence: indulgence
indulgent: indulgent
indurate: indurated
industrious: industrious
industry: industry
inebriety: inebriety
inelegant: inelegant
inequality: inequality
inevitable: inevitable
inexhaustible: inexhaustible
infamous: infamous
infancy: infancy
infant: infant
infatuated: infatuated
infer: infer,inferred
inference: inference
inferior: inferior
infernal: infernal
infinitely: infinitely
infirmity: infirmity
inflict: inflict,inflicted,inflicting
influence: influence,influenced,influencing
inform: inform,informed
informal: informal
infrequent: infrequent
infringe: infringe
ing: ing
ingenious: ingenious
ingenuity: ingenuity
inglorious: inglorious
ingress: ingress
inhabit: inhabit,inhabited,inhabiting
inhabitant: inhabitant,inhabitants
inhabitants: inhabitants
inharmonious: inharmonious
inherent: inherent
inhospitable: inhospitable
inhospitality: inhospitality
injunction: injunction
injure: injure,injured
injury: injuries,injury
inlaid: inlaid
inland: inland
inlay: inlaid
inlet: inlet,inlets
inmate: inmate
inn: inn
innermost: innermost
innocence: innocence
innocent: innocent
innumerable: innumerable
inoffensive: inoffensive
inoffensively: inoffensively
inordinate: inordinate
inorganic: inorganic
inquire: inquire,inquired,inquiring
inquirer: inquirer
inquiry: inquiries,inquiry
inquisitive: inquisitive
insalubrity: insalubrity
insatiable: insatiable
inscription: inscriptions
insect: insects
insecure: insecure
insensibility: insensibility
insensible: insensible
inseparable: inseparable
insert: inserted
insight: insight
insignificant: insignificant
insinuate: insinuated
insist: insist,insisted,insisting
insolence: insolence
insomuch: insomuch
inspection: inspection
inspector: inspector
inspire: inspire
inspissate: inspissated
instance: instance,instances
instant: instant
instantaneous: instantaneous
instantly: instantly
instil: instilled
institute: institute,instituted
institution: institution,institutions
instruct: instructed
instruction: instruction,instructions
instructor: instructors
instrument: instrument,instruments
instrumental: instrumental
insular: insular
insulated: insulated
insult: insult,insults
insuperable: insuperable
insurmountable: insurmountable
intact: intact
integral: integral
integrity: integrity
intellect: intellect
intelligence: intelligence
intelligent: intelligent
intelligible: intelligible
intemperate: intemperate
intend: intend,intended,intending
intense: intense
intensely: intensely
intensity: intensity
intention: intention,intentions
intentional: intentional
inter: inter,interred
intercession: intercessions
intercourse: intercourse
interfere: interferes
interior: interior
intermeddle: intermeddle
intermediate: intermediate
intermingle: intermingled
intermission: intermission
intermittent: intermittent
intermix: intermixed,intermixes
intermixture: intermixture
internal: internal
internally: internally
interpret: interpreted
interpretation: interpretations
interpreter: interpreter,interpreters
interrupt: interrupted
interrupted: interrupted
interruption: interruption
intersect: intersect,intersected,intersects
intersperse: interspersed
interstitial: interstitial
intertropical: intertropical
interval: interval,intervals
intervene: intervenes,intervening
interview: interview,interviews
interweave: interwoven
interwoven: interwoven
intimacy: intimacy
intimate: intimate,intimated
intimately: intimately
intimation: intimation
intimidate: intimidated
intolerance: intolerance
intolerant: intolerant
intoxicate: intoxicate
intoxicating: intoxicating
intrepidity: intrepidity
intricate: intricate
intriguer: intriguers
introduce: introduced,introducing
introduction: introduction
intrust: intrusted
inundate: inundated
inundation: inundation,inundations
inure: inured
invariable: invariable
invariably: invariably
investigate: investigated
investigation: investigation
invitation: invitation
invite: invite,invited,inviting
involve: involved,involving
involved: involved
iris: irides,iris
irksome: irksome
iron: iron
irregular: irregular
irregularly: irregularly
irresistible: irresistible
irresistibly: irresistibly
irrigation: irrigation
island: island,islands
islander: islanders
islands: islands
isles: isles
isolate: isolate,isolated
isolated: isolated
issue: issue,issuing
iv: iv
ivory: ivory
ix: ix
ixora: ixora
jack: jack
jackal: jackals
jacket: jacket,jackets
james: james
january: january
japan: japan,japanned
japonica: japonica
jar: jar,jars
jargon: jargon
jasmine: jasmine
jasminum: jasminum
jasper: jasper
jatropha: jatropha
java: java
jaw: jaw,jaws
jay: jay
jealous: jealous
jealously: jealously
jealousy: jealousy
jee: jee
jeering: jeering
jelly: jellies
jesuit: jesuit
jesuits: jesuits
jewel: jewels
jocular: jocular
john: john
joke: jokes
joseph: joseph
joss: joss
jot: jot
journal: journal
journey: journey
joy: joy
judge: judge,judged,judging
judging: judging
judgment: judgment
judicial: judicial
juice: juice,juices
july: july
junction: junction
june: june
jungle: jungle
junk: junk,junks
jurisdiction: jurisdiction
justice: justice
justicia: justicia
justifiable: justifiable
justify: justify
justly: justly
ka: ka
kab: kab
kalendar: kalendar
kam: kam
kan: kan
kay: kay
keen: keen
keeper: keepers
keeping: keeping
key: key
kha: kha
khan: khan
kill: kill,killed,killing
kin: kin
kindly: kindly
kindness: kindness
king: king,kings
kingdom: kingdom,kingdoms
knee: knee,knees
kneel: kneeling
knife: knife,knives
knob: knobs
knot: knot,knotted
knowledge: knowledge
ko: ko
kui: kui
labellum: labellum
laborious: laborious
labour: labour,laboured,labouring,labours
labourer: labourer,labourers
labrusca: labrusca
lac: lac
lace: lace
lacerta: lacerta
lacker: lackered
lacquered: lacquered
ladder: ladder
laden: laden
lady: ladies,lady
lake: lake,lakes
lament: lamented
lamentable: lamentable
lamp: lamps
lance: lance,lances
land: land,landed,landing,lands
landing: landing
landscape: landscape,landscapes
lane: lane
language: language,languages
languages: languages
lank: lank
lanky: lanky
lantern: lantern,lanterns
laos: laos
lap: laps
lapse: lapse
lash: lashes
lastly: lastly
lat: lat
late: late
lateness: lateness
lateral: lateral
laterally: laterally
latin: latin
latitude: latitude
latitudes: latitudes
latitudinal: latitudinal
laudable: laudable
laugh: laugh,laughed,laughing
laughable: laughable
launch: launch
laurus: laurus
lavishly: lavishly
law: law,laws
lax: lax
lay: laid,lay,laying,lays
layer: layers
layman: laymen
lazy: lazy
le: le
lead: lead,leading,leads,led
leader: leader
leading: leading
leaf: leaf,leaves
lean: leaned
leap: leaping,leaps
leapt: leapt
learn: learn,learned,learning,learnt
leather: leather
leathery: leathery
leave: leave,leaves,leaving,left
ledge: ledges
lee: lee
left: left
leg: leg,legs
legal: legal
leisure: leisure
lemur: lemur
lengthen: lengthened
leopard: leopard,leopards
leopards: leopards
lessening: lessening
letter: letter,letters
level: level
levy: levied,levy
leyden: leyden
liable: liable
liberal: liberal
liberality: liberality
liberty: liberty
library: library
lid: lids
lie: lain,lie,lies,lying
lieutenant: lieutenant
life: life,lives
lift: lifting
ligature: ligatures
light: light,lighted,lighter,lights
lighted: lighted
lighten: lightening
lightning: lightning
lignum: lignum
limb: limb,limbs
lime: lime,limes
limestone: limestone
limit: limit,limited,limits
limitation: limitation
limited: limited
limpid: limpid
lineage: lineage
linear: linear
link: link,linked
lion: lion
lip: lip,lips
liqueur: liqueur
liquid: liquid
liquor: liquor
list: list,lists
listen: listen,listened
listless: listless
literally: literally
live: live,lived,living
livelihood: livelihood
liveliness: liveliness
lively: lively
liver: liver
living: living
lizard: lizard,lizards
loathsome: loathsome
lobelia: lobelia
locality: localities,locality
lock: lock,locked
lodge: lodged
lodger: lodgers
lodging: lodging
lofty: loftier,loftiest,lofty
loin: loins
loll: lolling
london: london
lone: lone
lonely: lonely
longitude: longitude
longitudinal: longitudinal
longitudinally: longitudinally
loop: loops
loose: loose
loosely: loosely
looseness: looseness
loquacious: loquacious
lord: lord
lordship: lordship
lose: lose,loses,losing,lost
loss: loss
lot: lot
lou: lou
loud: loud,louder
loudly: loudly
louis: louis
lour: lour
loutish: loutish
love: love
lowness: lowness
luckily: luckily
lucky: lucky
lucrative: lucrative
ludicrous: ludicrous
lui: lui
lumber: lumbered
luminous: luminous
lung: lungs
luscious: luscious
lustre: lustres
luxuriance: luxuriance
luxuriancy: luxuriancy
luxuriant: luxuriant
luxuriantly: luxuriantly
luxurious: luxurious
luxuriously: luxuriously
macao: macao
macassar: macassar
mace: mace
maceration: maceration
machinery: machinery
madras: madras
madrepore: madrepore
magazine: magazines
magician: magicians
magnificence: magnificence
magnificent: magnificent
magnify: magnified
magnitude: magnitude
maha: maha
maintain: maintain,maintained,maintaining,maintains
maintenance: maintenance
majestic: majestic
majesty: majesty
majority: majority
maker: makers
malabar: malabar
malacca: malacca
malay: malay
malayan: malayan
malays: malays
male: male,males
mallet: mallet
malwa: malwa
mammalia: mammalia
manage: managed,managing
management: management
mandarin: mandarin,mandarins
mandarins: mandarins
mangle: mangle
mangosteen: mangosteen
mangrove: mangrove,mangroves
mangroves: mangroves
mania: mania
manifest: manifest
manifestly: manifestly
manihot: manihot
manilla: manilla
mankind: mankind
manly: manly
manned: manned
manner: manner
manners: manners
mansion: mansion
mantle: mantle
manufactory: manufactories
manufacture: manufacture,manufactured,manufactures
manufacturer: manufacturer
manufactures: manufactures
manufacturing: manufacturing
marauder: marauders
march: march
margin: margin,margins
marine: marine
mariner: mariners
maritime: maritime
mark: mark,marked,marks
marked: marked
market: market,markets
marquis: marquis
marriage: marriage,marriages
married: married
marsh: marsh,marshes
marshy: marshy
mas: mas
mask: masks
mason: mason
masonry: masonry
mass: mass,masses
massacre: massacred,massacres
mast: masts
master: master,masters
masters: masters
mat: mat,mats,matted,matting
mate: mate,mates
material: material,materials
materially: materially
matrimonial: matrimonial
matter: matter,matters
matting: matting
mattress: mattress,mattresses
maximum: maximum
maya: maya
mays: mays
maze: mazes
meagre: meagre
meal: meal,meals
meaning: meaning
meanly: meanly
meanness: meanness
measure: measure,measured,measures
measurement: measurement
meat: meat,meats
mechanic: mechanics
mechanical: mechanical
mechanically: mechanically
media: media
medical: medical
medicine: medicine,medicines
meditate: meditates
medium: medium
meet: meet,met
meeting: meeting
melancholy: melancholy
melastoma: melastoma
melon: melons
melt: melted
membrane: membrane
memoir: memoir
memoirs: memoirs
memorable: memorable
memorandum: memoranda,memorandum
memorial: memorial
memory: memory
menial: menial,menials
menispermum: menispermum
mental: mental
mention: mention,mentioned,mentioning
merchandise: merchandise
merchant: merchant,merchants
mercury: mercury
mercy: mercy
mere: mere
meridian: meridian
merit: merit,merits
meritorious: meritorious
message: message
messenger: messenger
metal: metal
metempsychosis: metempsychosis
method: method
metropolis: metropolis
mi: mi
mia: mia
mica: mica
middle: middle
midnight: midnight
midst: midst
mighty: mighty
mild: mild,milder
mildness: mildness
mile: mile,miles
military: military
militate: militate
milk: milk
milky: milky
mimosa: mimosa
mind: mind,minds
minded: minded
mineral: mineral,minerals
mines: mines
mingle: mingled,mingling
minimum: minimum
mining: mining
minister: minister,ministers
ministers: ministers
ministry: ministry
minor: minor
minute: minute,minutes
minutely: minutely
minuteness: minuteness
mirror: mirrors
mirth: mirth
mischief: mischief
mischievous: mischievous
miserable: miserable
miserably: miserably
misery: miseries,misery
misfortune: misfortunes
mismanagement: mismanagement
misrepresent: misrepresent,misrepresenting
misrepresentation: misrepresentation
mission: mission
missionary: missionaries
mist: mist
mistake: mistake,mistaken,mistaking
mistaken: mistaken
misunderstand: misunderstand
mitis: mitis
mity: mity
mix: mixed
mnevis: mnevis
mock: mocks
mockery: mockery
mode: mode
model: model
moderate: moderate
moderately: moderately
moderation: moderation
modern: modern
modest: modest
modesty: modesty
modification: modification
modify: modified
modulate: modulating
moghul: moghul
moist: moist
moisture: moisture
molest: molested
molucca: molucca
moment: moment,moments
momordica: momordica
monarch: monarch,monarchs
monastery: monastery
monastic: monastic
monday: monday
monde: monde
money: money
mongol: mongol
mongols: mongols
monkey: monkey,monkeys
monkish: monkish
monopoly: monopolies,monopoly
monsoon: monsoon,monsoons
monster: monsters
monstrous: monstrous
month: month,months
monument: monument,monuments
monumental: monumental
moo: moo
moody: moody
moon: moon
moor: moored
moorman: moorman
moormen: moormen
mopla: mopla
moral: moral,morals
morality: morality
morass: morasses
morbus: morbus
morinda: morinda
morning: morning
morose: morose
morrow: morrow
morsel: morsels
mortal: mortal,mortals
mortality: mortality
mortar: mortar,mortars
moslem: moslems
mosquito: mosquitoes
moss: moss
motacilla: motacilla
mother: mother
motion: motion
motive: motive,motives
motley: motley
mould: mould
moulding: mouldings
mount: mount,mounted
mountain: mountain,mountains
mountainous: mountainous
mountains: mountains
mourning: mourning
mouth: mouth,mouths
moveable: moveable
movement: movements
mud: mud
muddy: muddy
multitude: multitude,multitudes
muong: muong
murder: murder
murray: murray
musa: musa
musci: musci
muscle: muscles
muscular: muscular
muscularity: muscularity
museum: museum
music: music
musical: musical
musician: musician,musicians
musket: musket,muskets
muslin: muslin,muslins
muster: musters
mutual: mutual
mya: mya
myriad: myriads
mysteriously: mysteriously
mystery: mysteries,mystery
mythology: mythology
nail: nails
naked: naked
nakedness: nakedness
nam: nam
nan: nan
nape: nape
narrow: narrow,narrower
nat: nat
nation: nation,nations
national: national
nationally: nationally
nations: nations
native: native,natives
natural: natural
naturalist: naturalist,naturalists
naturalize: naturalized
naturally: naturally
nature: nature
natured: natured
naught: naught
nautical: nautical
naval: naval
navigable: navigable
navigate: navigate
navigation: navigation
navigator: navigators
navy: navy
neat: neat
neater: neater
neatly: neatly
neatness: neatness
necessity: necessities,necessity
neck: neck
necklace: necklace
necromancer: necromancers
necromancy: necromancy
needle: needle
needy: needy
neglect: neglect,neglected
negligence: negligence
negligent: negligent
negligently: negligently
negotiate: negotiate
negotiation: negotiation,negotiations
neighbour: neighbour,neighbouring,neighbours
neighbourhood: neighbourhood
nephew: nephew
neptunian: neptunian
nerve: nerves
ness: ness
nest: nests
netting: netting
nettle: nettles
niche: niche
night: night,nights
nile: nile
nipa: nipa
noble: noble
nodular: nodular
nodule: nodules
noise: noise
noisome: noisome
noisy: noisy
nomade: nomade
nong: nong
noon: noon
north: north
northern: northern
northwards: northwards
nose: nose
notation: notation
note: note,notes
notice: notice,noticed,noticing
notify: notified
notion: notion,notions
notoriety: notoriety
notoriously: notoriously
nourishment: nourishment
november: november
nudity: nudity
numeral: numerals
numerous: numerous
nunc: nunc
nut: nut,nuts
nutmeg: nutmeg
nutriment: nutriment
nutritious: nutritious
oar: oar,oars
obedience: obedience
obedient: obedient
obeisance: obeisance
obesity: obesity
obey: obeyed
object: object,objected,objects
objection: objection,objections
objectionable: objectionable
obligation: obligations
oblige: obliged,obliging
oblique: oblique
obliquity: obliquity
oblong: oblong
obscene: obscene
obscure: obscure
obscurity: obscurity
obsequy: obsequies
observable: observable
observation: observation,observations
observations: observations
observe: observe,observed,observes,observing
observer: observer
obstacle: obstacle,obstacles
obstruct: obstructed,obstructing
obtuse: obtuse
obviate: obviate
obvious: obvious
oc: oc
occasion: occasion,occasioned,occasions
occasional: occasional
occasionally: occasionally
occipital: occipital
occiput: occiput
occupant: occupants
occupation: occupation,occupations
occupier: occupiers
occupy: occupied,occupies,occupy,occupying
occur: occur,occurred,occurs
occurrence: occurrence
ocean: ocean
oceanic: oceanic
ochry: ochry
october: october
odious: odious
odoriferous: odoriferous
odour: odour
offence: offences
offend: offending
offended: offended
offensive: offensive
offer: offer,offered,offering,offers
offering: offerings
office: office,offices
officer: officer,officers
official: official
offspring: offspring
oil: oil
omission: omission
onion: onions
openly: openly
operate: operate,operates
operation: operation,operations
operose: operose
opinion: opinion,opinions
opium: opium
opponent: opponents
opportunity: opportunities,opportunity
oppose: oppose,opposed,opposes,opposing
opposed: opposed
opposition: opposition
oppression: oppression
oppressive: oppressive
oppressively: oppressively
opulence: opulence
opulent: opulent
ora: ora
orang: orang
orange: oranges
orbicular: orbicular
orchideous: orchideous
orderly: orderly
ordinary: ordinary
ore: ore
organ: organ,organs
organic: organic
organization: organization
organized: organized
orientals: orientals
origin: origin
original: original
originally: originally
originate: originated
orna: orna
ornament: ornament,ornamented,ornaments
ornamental: ornamental
ornamented: ornamented
ostensible: ostensible
ostentation: ostentation
outer: outer
outermost: outermost
outhouse: outhouse
outlet: outlet
outline: outline
outward: outward
outwards: outwards
outweigh: outweigh
overboard: overboard
overcome: overcome,overcoming
overflow: overflowed
overfly: overflown
overgrown: overgrown
overload: overloading
overlook: overlook,overlooked
overrule: overruled
overtake: overtaken
owe: owe,owed,owes
owner: owner,owners
ox: ox
oyster: oysters
pace: pace,paces
paddle: paddles
pain: pain,pains
painful: painful
paint: painted,paints
painter: painter
painting: painting,paintings
pair: pair
palace: palace,palaces
palanquin: palanquin,palanquins
palate: palates
pale: pale
pali: pali
paling: paling,palings
palm: palm,palms
palmate: palmated
palmer: palmer
palms: palms
palmyra: palmyra
palpable: palpable
paltry: paltry
pandanus: pandanus
panna: panna
pant: pant
pantaloons: pantaloons
paper: paper,papers
papilionaceous: papilionaceous
parallel: parallel
parasite: parasites
parasitical: parasitical
parent: parent,parents
parental: parental
paris: paris
parotid: parotid
partake: partake,partaken,partakes,partaking,partook
partaking: partaking
partial: partial
partiality: partiality
partially: partially
participate: participate
particle: particle,particles
particulars: particulars
parties: parties
partition: partition
partly: partly
partook: partook
party: parties,party
pass: pass,passed,passes,passing
passable: passable
passage: passage,passages
passer: passer
passeres: passeres
passerine: passerine
passing: passing
passion: passion,passions
passionately: passionately
passport: passport
paste: paste
pastor: pastor
pat: pat
patch: patch,patches
patella: patella
patente: patente
path: path
pathetic: pathetic
pathway: pathways
patience: patience
patient: patient
patriarchal: patriarchal
patriot: patriot
patron: patron
patronage: patronage
pau: pau
paucity: paucity
pave: paved
paved: paved
pavement: pavement
paw: paw
pay: paid,pay,paying,pays
payt: payt
pea: pea
peace: peace
peaceable: peaceable
peaceful: peaceful
peak: peak,peaked,peaks
pearl: pearl,pearls
peasant: peasant
peasantry: peasantry
peat: peat
pebble: pebbles
pectoral: pectoral
peculiar: peculiar
peculiarity: peculiarities,peculiarity
peculiarly: peculiarly
pecuniary: pecuniary
ped: ped
pee: pee
peg: pegs
pekin: pekin
pelican: pelican
pelvis: pelvis
pen: pen
penang: penang
penetrable: penetrable
penetrate: penetrate,penetrated,penetrating
peninsula: peninsula
pentagon: pentagon
penury: penury
pepper: pepper
perceive: perceive,perceived
perceptible: perceptible
perceptibly: perceptibly
percolate: percolates
peremptory: peremptory
perfect: perfect
perfection: perfection
perfectly: perfectly
perform: perform,performed,performing,performs
performance: performance,performances
performer: performer,performers
perfume: perfume
period: period,periods
periodical: periodical
perish: perished
perisperm: perisperm
permanent: permanent
permission: permission
permit: permitted
pernicious: pernicious
perpendicular: perpendicular
perpetrator: perpetrator
perpetual: perpetual
perpetually: perpetually
perseverance: perseverance
person: people,person,persons
personage: personage,personages
personal: personal
persuade: persuade,persuaded
persuasion: persuasion
pervade: pervade
pestilence: pestilence
petal: petals
petaurista: petaurista
petty: petty
pharaoh: pharaoh
phasianus: phasianus
pheasant: pheasant
phenomena: phenomena
phenomenon: phenomena,phenomenon
phi: phi
philosophic: philosophic
phlegmatic: phlegmatic
phosphorescent: phosphorescent
phosphorus: phosphorus
phraseology: phraseology
phthisis: phthisis
phut: phut
physical: physical
physiognomy: physiognomy
physiological: physiological
physiologist: physiologist
physiology: physiology
pia: pia
piazza: piazza
pickle: pickled
picture: picture
picturesque: picturesque
piece: piece,pieces
pig: pig,pigs
pigeon: pigeon,pigeons
pilaw: pilaw
pile: pile
pillar: pillar,pillars
pillow: pillow,pillows
pilot: pilot,pilots
pin: pin
pinch: pinch
pine: pine
pink: pink
pinnate: pinnated
pipe: pipe,pipes
piper: piper
pique: piqued
pit: pits
pitch: pitch
pithy: pithy
pitiful: pitiful
pity: pity
placid: placid
plain: plain,plains
plainly: plainly
plains: plains
plaintive: plaintive
plan: plan,plans
plank: planks
plant: plant,planted,plants
plantain: plantain,plantains
plantation: plantation,plantations
planter: planter
plaster: plaster,plastered
plastic: plastic
plate: plates
platform: platform,platforms
play: play,played,playing,plays
player: player,players
playful: playful
plaything: playthings
pleasant: pleasant
pleased: pleased
pleasing: pleasing
pleasure: pleasure,pleasures
plentiful: plentiful
plight: plight
plot: plot
plough: plough
pluck: plucking
plume: plume
plumose: plumose
plunder: plunder
ply: plying
pneumonia: pneumonia
po: po
poem: poem
poet: poet
pole: pole,poles
police: police
policy: policy
polished: polished
polite: polite
politeness: politeness
political: political
politics: politics
pollen: pollen
pomegranate: pomegranates
pomp: pomp
pon: pon
ponderous: ponderous
pony: ponies
pool: pools
poop: poop
poor: poor,poorer,poorest
populace: populace
popular: popular
popularity: popularity
population: population
populous: populous
porcelain: porcelain
pork: pork
porphyritic: porphyritic
porphyry: porphyry
porpoise: porpoise
port: port,ports
porter: porters
portion: portion,portions
portrait: portrait
portray: portrayed,portrays
portuguese: portuguese
pose: pose
position: position
positive: positive
possess: possess,possessed,possesses,possessing
possession: possession,possessions
possessor: possessor
possibility: possibility
post: post,posted,posts
posture: posture,postures
pot: pots
potash: potash
potato: potatoes
potentate: potentates
pothos: pothos
potstone: potstone
poultry: poultry
pound: pound,pounds
pour: pour,poured
poverty: poverty
powder: powder,powdered
power: power,powers
powerful: powerful
practicable: practicable
practice: practice,practices
practise: practised
praise: praise,praises
prau: prau
praus: praus
prayer: prayers
precarious: precarious
precaution: precaution
precede: preceded,preceding
precedence: precedence
precept: precepts
precinct: precincts
precious: precious
precipice: precipice,precipices
precipitous: precipitous
precise: precise
precisely: precisely
preclude: precluded
precocity: precocity
predaceous: predaceous
predecessor: predecessor,predecessors
predominant: predominant
predominate: predominating
preface: preface
prefer: preferred
preferable: preferable
pregnant: pregnant
prejudice: prejudices
prejudicial: prejudicial
premature: premature
preparation: preparation,preparations
prepare: prepare,prepared
prepared: prepared
preposterous: preposterous
prescribe: prescribed
presence: presence
presentation: presentation
preserve: preserve,preserved,preserves,preserving
press: pressing
pressure: pressure
presume: presume,presumed
presumption: presumption
pretend: pretended
pretension: pretension,pretensions
pretext: pretext
pretty: pretty
prevail: prevailed,prevails
prevalence: prevalence
prevalent: prevalent
prevent: prevent,prevented,preventing,prevents
prevention: prevention
previous: previous
prey: prey
price: price,prices
pricker: pricker
pride: pride
priest: priests
priesthood: priesthood
prime: prime
priming: priming
primitive: primitive
prince: prince,princes
principal: principal,principals
principally: principally
principle: principle,principles
print: printed
printing: printing
prison: prison
prisoner: prisoner,prisoners
private: private
privilege: privilege,privileges
privileges: privileges
probability: probability
probable: probable
proceed: proceed,proceeded,proceeding,proceeds
proceeding: proceeding
proceedings: proceedings
proceeds: proceeds
process: process
procession: procession
procurable: procurable
procure: procure,procured,procuring
prodigiously: prodigiously
produce: produce,produced,produces,producing
product: product,products
production: production,productions
productive: productive
profane: profane
profess: profess,professing
profession: profession
professional: professional
professor: professor,professors
proffer: proffered
proficiency: proficiency
profit: profited,profiting,profits
profitable: profitable
profound: profound
profuse: profuse
profusion: profusion
progress: progress
prohibit: prohibited
prohibitory: prohibitory
project: project,projected,projecting,projects
projection: projection
prolong: prolonging
promenade: promenade
prominent: prominent
promiscuous: promiscuous
promise: promised,promises
promote: promote,promoting
promptitude: promptitude
pronounce: pronounce
proof: proof,proofs
prop: props
propagate: propagated,propagating
propensity: propensities,propensity
proper: proper
properly: properly
property: properties,property
propitiate: propitiate
proportion: proportion,proportioned
proportionate: proportionate
proposal: proposal,proposals
propose: propose,proposed,proposing
proposition: proposition
propounder: propounders
proprietor: proprietors
propriety: propriety
prosecute: prosecute,prosecuting
prosecution: prosecution
prospect: prospect
prospects: prospects
prosperity: prosperity
prostitution: prostitution
prostrate: prostrate
protect: protect,protected
protection: protection
protest: protest
prototype: prototype
protract: protracted
protuberant: protuberant
prove: prove,proved,proving
provide: provide,providing
province: province,provinces
provincial: provincial
provision: provision,provisions
proximity: proximity
prudent: prudent
pry: pry,prying
pteromys: pteromys
pteropus: pteropus
public: public
publication: publication
publicly: publicly
publish: published
publisher: publisher
puddle: puddle,puddles
puerile: puerile
pull: pull,pulled
pulp: pulp
pulse: pulse
pumpkin: pumpkins
punctilio: punctilio
punctuation: punctuation
punishable: punishable
punishment: punishment
puny: puny
pupil: pupils
pur: pur
purchase: purchase,purchased,purchasing
pure: pure
purely: purely
purity: purity
purpose: purpose,purposes
purposely: purposely
purse: pursed,purses
pursue: pursue,pursued,pursuing
pursuit: pursuit,pursuits
push: pushed
pusillanimity: pusillanimity
putrefaction: putrefaction
putrefactive: putrefactive
putrid: putrid
pya: pya
pyramid: pyramid,pyramids
pyramidal: pyramidal
pyramids: pyramids
quadrangle: quadrangles
quadrangular: quadrangular
quadruped: quadruped,quadrupeds
quadrupedal: quadrupedal
quaint: quaint
qualified: qualified
qualify: qualify
quality: qualities,quality
quantity: quantities,quantity
quantum: quantum
quarter: quarter,quarters
quartz: quartz
query: queries
quest: quest
question: question,questions
questionable: questionable
quick: quick
quicken: quickening
quickness: quickness
quiet: quiet
quietly: quietly
quill: quill
quit: quitted,quitting
ra: ra
rabbit: rabbit,rabbits
rabble: rabble
race: race,races
rack: racks
raffles: raffles
rafflesia: rafflesia
raft: rafts
rag: rag,rags
rah: rah
railing: railing
rain: rain,rained,rains
rainy: rainy
raise: raise,raised,raising
rajah: rajah
rampart: rampart,ramparts
range: range,ranged,ranges
rank: rank,ranked,ranks
rapacious: rapacious
rapid: rapid
rapidity: rapidity
rapidly: rapidly
rapine: rapine
rare: rare,rarest
rarely: rarely
rat: rat,rats
rate: rate,rated
rattan: rattan,rattans
ravages: ravages
ravenous: ravenous
ravine: ravines
ray: ray
rea: rea
reach: reach,reached,reaches,reaching
read: read,reading
reader: reader
readiness: readiness
ready: ready
real: real
reality: reality
realize: realize,realized
realm: realm
reap: reaped
rear: rear,reared
reason: reason,reasons
rebellious: rebellious
rebuke: rebuke
recede: recede
receive: receive,received,receives,receiving
reception: reception
recess: recess,recesses
recitative: recitative
recite: recite,reciting
reckless: reckless
reckon: reckon,reckoned
recline: recline,reclining
recognise: recognise,recognised
recollect: recollected
recollection: recollections
recommence: recommenced
recommend: recommend,recommended
recommendation: recommendation
reconcile: reconcile,reconciled
record: records
recourse: recourse
recover: recover,recovered
recovery: recovery
rectitude: rectitude
recumbent: recumbent
recurrence: recurrence
red: red
reddish: reddish
redoubt: redoubts
redress: redress
reduce: reduce,reduced,reduces,reducing
reduction: reduction
reed: reeds
refer: refer,referred,refers
referable: referable
reference: reference
refine: refined
refinement: refinement
reflect: reflected,reflecting
reflection: reflection,reflections
refreshment: refreshment,refreshments
refusal: refusal
refuse: refuse,refused
regal: regal
regard: regard,regarded
regiment: regiment,regiments
region: region,regions
register: register
regret: regret,regrets,regretted
regular: regular
regularity: regularity
regularly: regularly
regulate: regulated,regulating
regulation: regulations
regulations: regulations
reid: reid
reign: reign,reigning
reiterate: reiterated
reject: reject,rejected
rejoice: rejoiced
relapse: relapses
relate: relate,relating
relation: relation,relations
relative: relative
relic: relic,relics
relieve: relieved
religion: religion
religious: religious
religiously: religiously
relinquish: relinquish
relish: relish
reluctant: reluctant
reluctantly: reluctantly
remain: remain,remained,remaining,remains
remainder: remainder
remains: remains
remark: remark,remarked,remarks
remarkable: remarkable
remarkably: remarkably
remarks: remarks
remedy: remedy
remembrance: remembrance
remind: remind,reminded,reminds
remittent: remittent
remote: remote
remove: remove,removed,removing
render: render,rendered,rendering,renders
rent: rent
repass: repassed,repassing
repassing: repassing
repast: repast
repeat: repeat,repeated,repeating
repeatedly: repeatedly
repetition: repetition
replace: replaced
reply: replied,reply,replying
report: report,reported,reports
repose: repose
represent: represent,represented,representing
representation: representation,representations
reproach: reproach
reptile: reptiles
reptilia: reptilia
repulse: repulsed
repute: repute,reputed
request: request,requested,requesting,requests
require: require,required,requires,requiring
required: required
requisite: requisite,requisites
researches: researches
resemblance: resemblance
resemble: resemble,resembled,resembles,resembling
reserve: reserve
reside: reside,resided,resides
residence: residence
resin: resin
resist: resist,resisted
resistance: resistance
resistless: resistless
resolute: resolute
resolution: resolution
resort: resort,resorted,resorting
resource: resources
respect: respect,respected,respecting
respectability: respectability
respectable: respectable
respectful: respectful
respectfully: respectfully
respective: respective
respects: respects
rest: rest,rested,resting,rests
restless: restless
restore: restoring
restrain: restraining
restrict: restrict,restricted,restricting
restriction: restriction,restrictions
result: result
retain: retain,retained,retaining
retainer: retainers
retentive: retentive
retiform: retiform
retinue: retinue,retinues
retire: retire,retiring
retired: retired
retract: retracted
retreat: retreat,retreated,retreating
return: return,returned,returning,returns
revenue: revenue
revere: reveres
reverence: reverence
reverend: reverend
reverse: reverse,reversed,reverses
reversed: reversed
revert: revert
review: review,reviewing
revise: revise
revolting: revolting
revolution: revolution,revolutions
reward: reward,rewarded,rewards
rhinoceros: rhinoceros,rhinoceroses
rhizophora: rhizophora
rice: rice
rich: rich,richest
richard: richard
richardson: richardson
riches: riches
richly: richly
richness: richness
ricinus: ricinus
ride: ride,riding
ridge: ridge,ridges
ridgy: ridgy
ridiculous: ridiculous
ridiculously: ridiculously
rig: rigged
rigging: rigging
rightful: rightful
rigour: rigour
ripe: ripe
ripple: ripple
rise: rise,risen,rises,rising,rose
risk: risk
rite: rites
rivalship: rivalship
river: river,rivers
rivers: rivers
rivulet: rivulets
road: road,roads
roast: roast
roasted: roasted
robe: robes
roberts: roberts
robust: robust
rock: rock,rocks
rocky: rocky
rod: rod
roi: roi
roll: rolled,rolling
rome: rome
roof: roof,roofed,roofs
roop: roop
root: root,roots
rope: rope
rotten: rotten
rotundity: rotundity
rough: rough
rounded: rounded
rouse: rouse
route: route
rove: roving
roving: roving
row: row,rowed,rows
rower: rowers
rowing: rowing
roxburgh: roxburgh
roy: roy
royal: royal
royalty: royalty
rub: rubbed
ruby: rubies
rude: rude
ruder: ruder
rueful: rueful
ruffle: ruffled
rugged: rugged
ruin: ruin,ruined,ruins
rule: rule,rules
ruminate: ruminating
rumour: rumour,rumoured
rump: rump
rupee: rupee,rupees
rural: rural
rusa: rusa
rush: rush,rushed,rushing
rutherford: rutherford
sab: sab
sac: sac
sacred: sacred
sacrifice: sacrifice,sacrificed,sacrifices
sad: sad
safe: safe
safety: safety
saffron: saffron
sago: sago
saigon: saigon
sail: sail,sailed,sailing,sails
sailing: sailing
sailor: sailor
saim: saim
sak: sak
sake: sake
salary: salary
sale: sale
salient: salient
saline: saline
salt: salt,salted
salubrious: salubrious
salubrity: salubrity
salutation: salutation,salutations
salute: salute,saluted
salvation: salvation
sam: sam
sambas: sambas
sampan: sampan,sampans
sanctity: sanctity
sand: sand,sands
sandal: sandal
sandstone: sandstone,sandstones
sandy: sandy
sanskrit: sanskrit
sao: sao
sapan: sapan
sapphire: sapphires
sarcophagus: sarcophagus
satin: satin,satins
satisfaction: satisfaction
satisfactorily: satisfactorily
satisfactory: satisfactory
satisfied: satisfied
satisfy: satisfied,satisfy
saturation: saturation
saturday: saturday
sauger: sauger
saunter: saunter,sauntering
savage: savage,savages
save: save,saving
savoury: savoury
scabbard: scabbards
scale: scale
scalp: scalp
scan: scan
scantily: scantily
scantiness: scantiness
scanty: scanty
scarce: scarce
scarcely: scarcely
scarcity: scarcity
scarlet: scarlet
scatter: scattered,scattering
scattered: scattered
scene: scene,scenes
scenery: scenery
scenic: scenic
scent: scented
sceptre: sceptre
scheme: scheme
scholar: scholar
school: schools
schorl: schorl
science: science,sciences
scissors: scissors
sciurus: sciurus
scolopendrium: scolopendrium
scorch: scorching
score: score
scornful: scornful
scotland: scotland
scourge: scourges
scrap: scraps
scream: screaming
screen: screen
scruple: scruple
scrupulous: scrupulous
scrutinize: scrutinize
scrutiny: scrutiny
sea: sea,seas
seal: seal,sealed
seam: seam,seamed,seams
search: search,searching
seas: seas
season: season,seasons
seat: seat,seated,seats
seclusion: seclusion
secondary: secondary
secret: secret
secretary: secretary
secrete: secreted
sect: sect
secure: secure,secured,securing
security: security
sedition: sedition
seduce: seduce
sedulously: sedulously
seed: seed,seeds
seek: seeking,sought
seemingly: seemingly
seep: seep
segment: segment
seine: seine
seize: seize,seized
sel: sel
seldom: seldom
select: select,selected,selecting
selection: selection
selfish: selfish
selfishness: selfishness
sell: selling,sold
seller: seller
semblance: semblance
semibarbarous: semibarbarous
semicircular: semicircular
seminary: seminary
send: send,sending,sends
senior: senior
sensation: sensation
sense: sense
senseless: senseless
sensibly: sensibly
sentence: sentenced
sentiment: sentiment,sentiments
sentinel: sentinels
sentry: sentries,sentry
separate: separate,separated,separates
separately: separately
sepia: sepia
sepoy: sepoy,sepoys
september: september
sepulchral: sepulchral
sepulchre: sepulchre
sequel: sequel
serene: serene
serenity: serenity
serge: serge
series: series
serjeant: serjeant
serpent: serpents
serrated: serrated
servant: servant,servants
serve: serve,served,serves
service: service,services
serviceable: serviceable
servility: servility
servitude: servitude
sesamum: sesamum
sessile: sessile
set: set
settle: settled
settlement: settlement,settlements
settler: settlers
seventeen: seventeen
seventh: seventh
severe: severe
severely: severely
severity: severity
sew: sewed
sex: sexes
shade: shade,shaded
shades: shades
shaft: shaft
shaggy: shaggy
shake: shook
shallow: shallow
shameful: shameful
shape: shape,shaped
shaped: shaped
share: share
sharp: sharp
sharpness: sharpness
shave: shave
shawl: shawl,shawls
sheath: sheath
sheet: sheet
shelly: shelly
shelter: shelter,sheltered
sheltered: sheltered
shew: shew,shewed,shewing,shewn
shewing: shewing
shield: shield,shields
shift: shift
shine: shines,shining,shone
ship: ship,ships
shipping: shipping
shipwreck: shipwreck
shirt: shirt
shoal: shoal
shocking: shocking
shoe: shoe,shoes
shoot: shoots,shot
shop: shop,shops
shops: shops
shore: shore,shores
short: short,shorter
shot: shot
shoulder: shoulder,shouldered,shoulders
shout: shout,shouting
shower: shower,showers
showy: showy
shred: shreds
shrill: shrill
shrine: shrine,shrines
shrivel: shrivelled
shriveled: shriveled
shrub: shrub,shrubs
shrubby: shrubby
shuffle: shuffled
shuffling: shuffling
shun: shunned
shut: shut
siam: siam
siamese: siamese
siberian: siberian
sic: sic
sicca: sicca
sick: sick
sickly: sickly
sickness: sickness
sienite: sienite
sight: sight,sights
sign: sign,signs
signification: signification
signify: signified,signify,signifying
silence: silence
silent: silent
silk: silk,silks
silken: silken
silly: silly
silver: silver
silversmith: silversmiths
simia: simia
simple: simple,simplest
simplicity: simplicity
simply: simply
simultaneously: simultaneously
sincerely: sincerely
sincerity: sincerity
sinciput: sinciput
sing: sung
singapore: singapore
single: single
singular: singular
singularity: singularity
singularly: singularly
sink: sink,sinking,sunk
sir: sir
sisting: sisting
sit: sat,sit,sitting
situ: situ
situate: situated
situated: situated
situation: situation,situations
sixteen: sixteen
size: size,sizes
skeleton: skeleton,skeletons
sketch: sketch
skilful: skilful
skill: skill
skin: skin,skins
skipper: skipper
skirt: skirts
sky: sky
slate: slate
slaty: slaty
slave: slave,slaves
slavery: slavery
slay: slay
sleep: sleep,sleeping,slept
sleepy: sleepy
sleeve: sleeves
sleight: sleight
slender: slender
sliced: sliced
slight: slight,slighted,slightest
slimy: slimy
slip: slip
slippery: slippery
slit: slit
slop: slop
slope: slope,sloped,slopes,sloping
slothful: slothful
slouch: slouched
slovenliness: slovenliness
slovenly: slovenly
slow: slow
slowly: slowly
sluice: sluice
slung: slung
smart: smart,smartest
smartness: smartness
smile: smile,smiles
smith: smith
smoke: smoke,smoking
smooth: smooth,smoothest
smother: smothered
snakes: snakes
snatch: snatched
snow: snow
soapy: soapy
sober: sober
sobriety: sobriety
social: social
society: society
soft: soft,softer,softest
softish: softish
softness: softness
soil: soil,soils
soldier: soldier,soldiers
sole: sole,soles
solely: solely
solemn: solemn
solemnity: solemnity
solicit: solicit,solicited
solicitation: solicitations
solid: solid
solitary: solitary
solitude: solitude
soluble: soluble
son: son,sons
song: song
soothing: soothing
sordid: sordid
sorrow: sorrow,sorrows
sort: sort,sorts
soul: soul,souls
sound: sound,sounding,sounds
sour: sour
source: source,sources
south: south
southern: southern
southward: southward
sovereign: sovereign
sow: sowing,sown
space: space
spacious: spacious
spain: spain
spanish: spanish
spare: spare,spared,sparing
sparganium: sparganium
spark: spark
spawn: spawn
speak: speak,speaking,speaks,spoke,spoken
speaking: speaking
spear: spear,spears
special: special
species: species
specimen: specimen,specimens
spectacle: spectacle
spectacles: spectacles
spectator: spectator,spectators
speculation: speculation,speculations
speedily: speedily
spend: spent
sphere: sphere
spice: spices
spike: spike
spiraculum: spiraculum
spiral: spiral
spirally: spirally
spire: spire
spirit: spirit,spirits
spirited: spirited
splendid: splendid
splinter: splinters
splintery: splintery
split: split
sponge: sponge
spongy: spongy
spontaneous: spontaneous
spontaneously: spontaneously
spot: spot,spots
spotted: spotted
spread: spread,spreading
sprightliness: sprightliness
spring: springing,sprung
sprinkle: sprinkling
sprite: sprites
sprout: sprouts
spy: spy
squalid: squalid
squamate: squamate
square: square,squares
squat: squat,squatted
squatness: squatness
squeeze: squeeze
squirrel: squirrel,squirrels
stable: stable,stables
staff: staff
stage: stage,stages
stagnant: stagnant
stake: stake,stakes
stalk: stalk
stamp: stamp,stamped
stand: stand,standing,stands,stood
standard: standard,standards
star: star
start: start,started
starve: starving
stately: stately
statesman: statesmen
station: station,stationed,stations
stationary: stationary
statue: statue,statues
stature: stature
stay: stay
stead: stead
steadily: steadily
steadiness: steadiness
steady: steady
steal: steal,steals,stolen
steep: steep,steepest
steer: steer
stem: stem,stems
step: step,steps
sterile: sterile
sterility: sterility
sterling: sterling
stern: stern
sterna: sterna
stick: stick,sticking,sticks,stuck
sticks: sticks
stiff: stiff
stigma: stigma
stimulate: stimulates
sting: stinging
stipulate: stipulate
stitch: stitch
stock: stock
stomach: stomach
stone: stone,stones
stony: stony
stool: stool
stoop: stooping
store: store
storm: storm,storms
story: stories,story
stout: stout,stoutest
stoutly: stoutly
straggle: straggling
straight: straight
strain: strain
strait: straits
straits: straits
strange: strange
stranger: stranger,strangers
strangers: strangers
strap: straps
strata: strata
stratification: stratification
stratified: stratified
stratum: strata
straw: straw,straws
stream: stream,streams
street: street,streets
strength: strength
strengthen: strengthened
strenuously: strenuously
stress: stress
stretch: stretch,stretched,stretches,stretching
strew: strewed
striate: striated
strict: strict,strictest
strictly: strictly
strictness: strictness
strike: strikes,striking,struck
striking: striking
strikingly: strikingly
string: strings
stringed: stringed
strip: strip,strips
stripe: stripe,stripes
stroke: stroke,strokes
stroll: strolled
strong: strong
structure: structure
struggle: struggles
stubborn: stubborn
stud: studded
student: student
study: studied,studies,study
stunt: stunted
stupendous: stupendous
stupid: stupid
stupidity: stupidity
stupor: stupor
style: style,styled
subdue: subdued,subduing
subdued: subdued
subject: subject,subjected,subjects
subjection: subjection
sublime: sublime
submerge: submerged
submission: submission
submissive: submissive
submit: submit,submitted
subsequent: subsequent
subsequently: subsequently
subservient: subservient
subside: subsided,subsides
subsist: subsist
subsistence: subsistence
substance: substance,substances
substantial: substantial
substitute: substitute,substituted
substratum: substratum
subversive: subversive
succeed: succeed,succeeded,succeeding
success: success,successes
successful: successful
succession: succession
successive: successive
successively: successively
successor: successor,successors
succulent: succulent
sudden: sudden
suddenly: suddenly
suffer: suffer,suffered,suffers
sufficient: sufficient
sugar: sugar
suit: suited
suitable: suitable
suite: suite,suites
suited: suited
sullen: sullen
sulphur: sulphur
sulphuric: sulphuric
sum: sum
sumatra: sumatra
sumatran: sumatran
sumi: sumi
summit: summit,summits
summon: summoned
sun: sun
sunday: sunday
superficial: superficial
superfine: superfine
superfluity: superfluity
superfluous: superfluous
superincumbent: superincumbent
superintend: superintend
superior: superior,superiors
superiority: superiority
superstition: superstition,superstitions
superstitious: superstitious
superstructure: superstructure
supple: supple
suppliant: suppliant
supplication: supplication
supply: supplied,supplies,supply
support: support,supported,supporting,supports
supporter: supporters
suppose: suppose,supposed,supposing
supposition: supposition
supra: supra
supreme: supreme
supremely: supremely
sur: sur
sura: sura
surely: surely
surf: surf
surface: surface
surgeon: surgeon
surgery: surgery
surmount: surmount,surmounted,surmounting
surprise: surprise
surprised: surprised
surprising: surprising
surround: surround,surrounded,surrounding,surrounds
survey: surveying
survivor: survivors
surya: surya
susceptible: susceptible
suspect: suspect,suspected
suspend: suspended
suspense: suspense
suspension: suspension
suspicion: suspicion
suspicious: suspicious
sustain: sustained
sustenance: sustenance
swallow: swallow
swamp: swamps
swampy: swampy
swarm: swarms
sweet: sweet,sweetest,sweets
sweetmeat: sweetmeats
sweetness: sweetness
swell: swell,swelling,swollen
swivel: swivels
sword: swords
sybil: sybil
symbolic: symbolic
symmetrical: symmetrical
symmetry: symmetry
symptom: symptom,symptoms
syngenesious: syngenesious
synopsis: synopsis
systematic: systematic
ta: ta
table: table,tables
tablet: tablet
tablets: tablets
tabular: tabular
tackle: tackling
tail: tail
tailor: tailors
talc: talc
tale: tale
talent: talent,talents
talk: talk,talked
talking: talking
tall: tall,taller,tallest
tamarind: tamarind
tameness: tameness
tank: tank,tanks
tanning: tanning
tao: tao
taper: taper,tapers
tar: tar
tardy: tardy
tariff: tariff
tarnish: tarnished
tart: tart
tartar: tartar
task: task
taste: taste,tastes
tasteless: tasteless
tattered: tattered
tawdrily: tawdrily
tawdry: tawdry
tax: tax,taxed,taxes
taxation: taxation
taylor: taylor
tea: tea
teach: taught,teaching
teak: teak
tear: torn
tedious: tedious
teem: teem,teeming
teeth: teeth
temper: temper
temperate: temperate
temperature: temperature
tempest: tempest,tempests
tempestuous: tempestuous
temple: temple,temples
temporary: temporary
tempt: tempts
temptation: temptation
tenacious: tenacious
tenant: tenants
tend: tended,tending
tendency: tendency
tender: tender,tendered
tendon: tendons
tenet: tenets
tenfold: tenfold
tenor: tenor
tenure: tenure
ter: ter
term: term,termed,terms
terminate: terminated,terminates,terminating
termination: termination
terra: terra
terrace: terraces
terre: terre
terrestrial: terrestrial
territorial: territorial
territory: territory
terror: terrors
testify: testify
testimony: testimony
texture: texture,textures
tha: tha
thankfulness: thankfulness
thatch: thatch,thatched
thatching: thatching
theatre: theatre
thee: thee
theft: theft
theism: theism
theology: theology
thereon: thereon
thermometer: thermometer
thickly: thickly
thickness: thickness
thigh: thighs
thirst: thirst
thirteen: thirteen
thoght: thoght
thomas: thomas
thong: thongs
thoughtlessness: thoughtlessness
thread: thread,threads
threat: threats
threaten: threatened,threatening
threshold: threshold
thrive: thrive,thrives,thriving
throne: throne
throw: threw,throw,throwing,thrown,throws
thrust: thrusting
thursday: thursday
thwart: thwarted
thy: thy
tical: tical,ticals
tide: tide,tides
tie: tied,ties
tiger: tiger,tigers
tight: tight
tightly: tightly
tile: tiled,tiles
timber: timber
time: time,times
timid: timid
tin: tin
tinction: tinction
tinder: tinder
tine: tined
tinge: tinge
tinsel: tinsel
tired: tired
tiresome: tiresome
tissue: tissue
title: title
tobacco: tobacco
toe: toes
toil: toil,toils
toilsome: toilsome
token: token
tolerable: tolerable
tolerably: tolerably
tomb: tombs
ton: tons
tone: tone,tones
tongue: tongue
tonsure: tonsure
tooth: teeth
topic: topic,topics
torch: torch,torches
torrent: torrents
torrid: torrid
tortuous: tortuous
torture: tortured
toss: tossed,tosses
total: total
totally: totally
touch: touch,touched,touches,touching
tough: tough
tout: tout
town: town
toy: toy,toys
trace: trace,traced,traces
track: track
tract: tract,tracts
trade: trade,trades
trader: trader,traders
tradescantia: tradescantia
tradesman: tradesmen
tradespeople: tradespeople
trading: trading
traffic: traffic
train: train,trains
trait: trait,traits
trammel: trammels
trample: trample,trampled
tranquil: tranquil
tranquillity: tranquillity
tranquilly: tranquilly
transact: transact,transacted
transaction: transactions
transcribe: transcribed
transcriber: transcriber
transfer: transferred
transient: transient
transition: transition
translation: translation,translations
translucent: translucent
transmit: transmitted
transparent: transparent
transpire: transpired
transport: transport,transported
transverse: transverse
trap: trap
trapezium: trapeziums
travel: travel,travelled,travelling
traveller: traveller,travellers
travelling: travelling
traverse: traversed,traversing
tray: trays
treachery: treachery
tread: treading
treasure: treasures
treasury: treasury
treat: treat,treated
treatment: treatment
treaty: treaties,treaty
tree: tree,trees
tremble: tremble
trepang: trepang
trial: trial
triangular: triangular
tribe: tribe,tribes
tribunal: tribunal
tribute: tribute
trickle: trickle
trifid: trifid
trifle: trifle,trifling
trifling: trifling
trimmed: trimmed
triumph: triumph
trivial: trivial
troops: troops
tropic: tropic
tropics: tropics
trouble: trouble
troublesome: troublesome
true: true
trumpet: trumpets
trunk: trunk,trunks
trust: trusting
truth: truth
tuan: tuan
tub: tubs
tube: tube,tubes
tuber: tubers
tuberosity: tuberosities,tuberosity
tuberous: tuberous
tuesday: tuesday
tuft: tuft,tufts
tuition: tuition
tumid: tumid
tumultuary: tumultuary
tumultuous: tumultuous
tune: tuned,tunes
turban: turban,turbans
turbid: turbid
turmeric: turmeric
turtle: turtle
tusk: tusks
tutelary: tutelary
twig: twigs
twin: twin
typhoon: typhoons
tyrannical: tyrannical
tyranny: tyranny
tyrant: tyrants
ubi: ubi
ultimately: ultimately
ultra: ultra
umbrella: umbrella,umbrellas
unable: unable
unaccompanied: unaccompanied
unaccountable: unaccountable
unaccustomed: unaccustomed
unacquaint: unacquainted
unalloyed: unalloyed
unalterable: unalterable
unappreciated: unappreciated
unarmed: unarmed
unassuming: unassuming
unauthorised: unauthorised
unauthorized: unauthorized
unavailing: unavailing
unavoidably: unavoidably
unbending: unbending
unbounded: unbounded
unceasing: unceasing
uncertain: uncertain
uncertainty: uncertainty
unchanged: unchanged
unchastened: unchastened
uncle: uncle
unclean: unclean
unclouded: unclouded
uncommon: uncommon
uncommonly: uncommonly
unconnected: unconnected
undefined: undefined
undergo: undergo,undergone,underwent
understand: understand,understood
undertake: undertake
undertaking: undertakings
underwood: underwood
undescribed: undescribed
undeviating: undeviating
undiluted: undiluted
undisguised: undisguised
undisputed: undisputed
undistinguishing: undistinguishing
undisturbed: undisturbed
undoubtedly: undoubtedly
undulate: undulating
undulating: undulating
unequal: unequal
unequalled: unequalled
unequivocal: unequivocal
unequivocally: unequivocally
unexpected: unexpected
unexpectedly: unexpectedly
unexplored: unexplored
unfavourable: unfavourable
unfeeling: unfeeling
unfinished: unfinished
unfit: unfit
unfold: unfolded
unfortunate: unfortunate
unfrequent: unfrequented
unfrequented: unfrequented
ungallant: ungallant
ungenial: ungenial
ungrateful: ungrateful
unhallowed: unhallowed
unhappy: unhappy
uniform: uniform
uniformity: uniformity
unintelligible: unintelligible
uninteresting: uninteresting
uninterrupted: uninterrupted
union: union
unite: unite,united,uniting
united: united
universal: universal
universally: universally
universe: universe
university: university
unjust: unjust
unknown: unknown
unlimited: unlimited
unlucky: unlucky
unmanageable: unmanageable
unmarried: unmarried
unmeaning: unmeaning
unmixed: unmixed
unnatural: unnatural
unnecessary: unnecessary
unnumbered: unnumbered
unobserved: unobserved
unparalleled: unparalleled
unpleasing: unpleasing
unprejudiced: unprejudiced
unpretending: unpretending
unproductive: unproductive
unprotected: unprotected
unprovoked: unprovoked
unquestionable: unquestionable
unquestionably: unquestionably
unreal: unreal
unreasonable: unreasonable
unremitted: unremitted
unremitting: unremitting
unrestrained: unrestrained
unrestricted: unrestricted
unrivalled: unrivalled
unruffled: unruffled
unseen: unseen
unserviceable: unserviceable
unsettled: unsettled
unshackle: unshackled
unsocial: unsocial
unsoldierlike: unsoldierlike
unsparing: unsparing
unsuccessful: unsuccessful
unsupported: unsupported
untouched: untouched
untried: untried
untruth: untruth
untutored: untutored
unusual: unusual
unusually: unusually
unwarrantable: unwarrantable
unwearied: unwearied
unwholesome: unwholesome
unwieldy: unwieldy
unwilling: unwilling
unwonted: unwonted
unworthy: unworthy
upland: upland
upper: upper
upright: upright
upward: upward
urbanity: urbanity
urge: urged
urgency: urgency
urgent: urgent
urtica: urtica
usage: usage,usages
useless: useless
uselessly: uselessly
usual: usual
usurp: usurped
ut: ut
utensil: utensils
utility: utility
utmost: utmost
vacancy: vacancy
vacant: vacant
vacate: vacated
vaccination: vaccination
vagrant: vagrant
vague: vague
vain: vain
vainly: vainly
validity: validity
valley: valley,valleys
valour: valour
valuable: valuable
van: van
vanity: vanity
variation: variation,variations
varied: varied
variegate: variegated
variety: varieties,variety
variously: variously
varnish: varnish,varnished
vary: varied,varies,vary,varying
vast: vast
vastly: vastly
vegetable: vegetable,vegetables
vegetation: vegetation
vegetative: vegetative
vehement: vehement
vehicle: vehicle,vehicles
vein: vein,veins
vela: vela
velocity: velocity
velvet: velvet
veneration: veneration
ventilate: ventilated
venture: ventured
verandah: verandah,verandahs
verbal: verbal
verbatim: verbatim
verify: verified
verse: verse,versed
version: version
vespertilio: vespertilio
vessel: vessel,vessels
vestige: vestige
vexatious: vexatious
viand: viands
vice: vice
viceroy: viceroy
vicinity: vicinity
vicissitude: vicissitudes
victim: victim
victory: victory
vie: vie,vying
view: view,viewed,viewing,views
vigilant: vigilant
vigorous: vigorous
vigour: vigour
vii: vii
viii: viii
village: village,villages
villages: villages
villous: villous
vinca: vinca
vindicate: vindicate
vine: vine,vines
violence: violence
violent: violent
virtue: virtue,virtues
visage: visage
visible: visible
visionary: visionary
visit: visit,visited,visiting,visits
visitor: visitor,visitors
vitality: vitality
vitis: vitis
vivacious: vivacious
vivacity: vivacity
viverra: viverra
vocabulary: vocabulary
vocal: vocal
vogue: vogue
voice: voice
volcanic: volcanic
voltaire: voltaire
volume: volume
voluntarily: voluntarily
voluntary: voluntary
von: von
voracity: voracity
votive: votive
voyage: voyage,voyages
voyager: voyagers
vulgar: vulgar
vulgare: vulgare
vulture: vulture,vultures
wages: wages
waist: waist,waists
wait: wait,waited,waiting
waiting: waiting
waive: waive
wales: wales
walk: walk,walked,walking,walks
wall: wall,walls
walrus: walrus
wander: wander
wanton: wanton
war: war,wars
ware: ware
warehouse: warehouses
wares: wares
warlike: warlike
warm: warm
warmth: warmth
warp: warping
warty: warty
wash: wash,washed,washing
waste: waste
watch: watch,watched,watches
watchful: watchful
watchfulness: watchfulness
water: water,waters
watering: watering
waterloo: waterloo
wave: wave,waved
wax: wax
weak: weak,weaker
weakness: weakness
wealth: wealth
wealthy: wealthiest,wealthy
wear: wear,wearing,wore,worn
weather: weather,weathers
wednesday: wednesday
weed: weeds
week: week,weeks
weigh: weighed,weighing
weight: weight
weighty: weighty
welfare: welfare
west: west
western: western
westward: westward
wet: wet
whimsical: whimsical
whisper: whisper,whispered,whispers
white: white,whitest
whiteness: whiteness
whitish: whitish
wicket: wicket
wide: wide
wife: wife,wives
wig: wig
wild: wild,wilds
wilderness: wildernesses
wildest: wildest
william: william
willingly: willingly
wind: wind,winds
window: windows
windward: windward
wine: wine
wing: wing,wings
winged: winged
winter: winter
wire: wire
wisdom: wisdom
wisely: wisely
withdraw: withdrawn
withhold: withheld
witness: witness,witnessed
woman: woman,women
womb: womb
wonderful: wonderful
wong: wong
wood: wood,woods
wooden: wooden
woolly: woolly
word: word
worker: workers
workmanship: workmanship
workshop: workshop
worship: worship,worshipped
worth: worth
worthless: worthless
worthy: worthy
wound: wound,wounded,wounds
wounded: wounded
wrap: wrap,wrapped,wrapping
wrapt: wrapt
wreath: wreaths
wreck: wreck
wretch: wretch
wretched: wretched
wrinkle: wrinkled,wrinkles
write: write,writing,written,wrote
writer: writer,writers
writing: writing
writings: writings
wrong: wrong
xi: xi
xii: xii
xiii: xiii
xiv: xiv
xix: xix
xvi: xvi
xvii: xvii
xviii: xviii
xx: xx
xxi: xxi
xxii: xxii
xxiii: xxiii
xxiv: xxiv
xxv: xxv
xxx: xxx
ya: ya
yam: yam,yams
yan: yan
yard: yard,yards
yat: yat
yellow: yellow
yellowish: yellowish
yesterday: yesterday
yew: yew
yield: yield,yielded,yields
yoke: yoke
yot: yot
youth: youth
youthful: youthful
zag: zag
zea: zea
zeal: zeal
zig: zig
zone: zone,zones
zoological: zoological
zoology: zoology
zygoma: zygoma
