abandon: abandon,abandoned,abandoning
abandonment: abandonment
abantes: abantes
abate: abate,abated,abating
abatement: abatement
abdicate: abdicate
abed: abed
abet: abetted
abettor: abettors
abhor: abhor,abhorred,abhorring,abhors
abhorrence: abhorrence
abide: abide
ability: abilities,ability
abject: abject
abjectly: abjectly
abjure: abjure
ablest: ablest
ablutions: ablutions
aboard: aboard
abode: abode
abolish: abolished,abolishing
abominable: abominable
abound: abound,abounding,abounds
abridge: abridged
absence: absence
absent: absent,absented
absented: absented
absolute: absolute
absolutely: absolutely
absolve: absolve
absolved: absolved
abstain: abstain,abstained,abstaining
abstemiousness: abstemiousness
abstinence: abstinence
abstract: abstract
abstruse: abstruse
absurd: absurd
absurdity: absurdity
absurdly: absurdly
abundance: abundance
abundant: abundant
abundantly: abundantly
abuse: abuse,abused
academia: academia
academic: academic
academus: academus
academy: academy
acastus: acastus
acca: acca
accede: acceded,acceding
accent: accent
accept: accept,accepted,accepting
acceptable: acceptable
acceptance: acceptance
access: access
accessible: accessible
accession: accession
accessory: accessory
accident: accident,accidents
accidental: accidental
accidentally: accidentally
acclamation: acclamation,acclamations
accommodate: accommodate,accommodated,accommodating
accommodation: accommodation
accompaniment: accompaniment
accompany: accompanied,accompany,accompanying
accomplice: accomplice,accomplices
accomplish: accomplished
accomplished: accomplished
accomplishment: accomplishment,accomplishments
accord: accord,accorded
accost: accost
account: account,accounted,accounting,accounts
accountable: accountable
accrue: accrued
accumulate: accumulated
accurate: accurate
accurately: accurately
accursed: accursed
accusation: accusation,accusations
accuse: accuse,accused,accusing
accuser: accuser,accusers
accustom: accustom,accustomed
accustomed: accustomed
achaean: achaean
achieve: achieve,achieved,achieving
achievement: achievement,achievements
achilles: achilles
acilius: acilius
acknowledge: acknowledge,acknowledged
acknowledgment: acknowledgment,acknowledgments
acontium: acontium
acorn: acorn,acorns
acquaint: acquainted,acquainting
acquaintance: acquaintance
acquainted: acquainted
acquiesce: acquiesce,acquiesced
acquiescence: acquiescence
acquire: acquire,acquired,acquiring
acquisition: acquisition,acquisitions
acquit: acquit,acquitted
acquittal: acquittal
acre: acres
acron: acron
acropolis: acropolis
actaeon: actaeon
acting: acting
action: action,actions
active: active
activity: activity
actor: actor,actors
actress: actresses
actual: actual
actuate: actuate,actuated,actuates
acute: acute
adamant: adamant
adapt: adapt,adapted,adapting
add: add,adding,adds
addict: addicted
addicted: addicted
addition: addition
additional: additional
address: address,addressed,addresses,addressing
adduce: adduce,adduced,adduces,adducing
adhere: adhere,adhered,adhering
adherent: adherents
adieu: adieu
adjacent: adjacent
adjoin: adjoin,adjoining
adjoining: adjoining
adjourn: adjourned
adjudge: adjudge,adjudged
adjunct: adjunct
adjust: adjust,adjusted
admeasurement: admeasurement
admetus: admetus
administer: administer,administered,administering
administration: administration,administrations
admirable: admirable
admirably: admirably
admiral: admiral,admirals
admiration: admiration
admire: admire,admired,admiring
admired: admired
admirer: admirer,admirers
admission: admission,admissions
admit: admit,admits,admitted,admitting
admittance: admittance
admixture: admixture
admonish: admonished,admonishes,admonishing
admonition: admonition,admonitions
ado: ado
adonis: adonis
adopt: adopt,adopting
adoration: adoration
adore: adore
adorer: adorers
adorn: adorn,adorned,adorning
adorning: adorning
adriatic: adriatic
adult: adult,adults
adulterer: adulterer,adulterers
adultery: adultery
advance: advance,advanced,advancing
advanced: advanced
advancement: advancement
advantage: advantage,advantages,advantaging
advantaged: advantaged
advantageous: advantageous
advantageously: advantageously
adventitious: adventitious
adventure: adventure,adventured,adventures
adventurer: adventurers
adventurous: adventurous
adversary: adversaries,adversary
adverse: adverse
adversity: adversity
advertise: advertise,advertised
advice: advice,advices
advisable: advisable
advise: advise,advised,advising
advisedly: advisedly
adviser: adviser,advisers
advocate: advocate,advocates
aeacides: aeacides
aeacus: aeacus
aedile: aedile,aediles
aediles: aediles
aedileship: aedileship
aegean: aegean
aegina: aegina
aegle: aegle
aenean: aenean
aeneas: aeneas
aeolia: aeolia
aeolian: aeolian
aeschylus: aeschylus
aesculapius: aesculapius
aesop: aesop
aetolian: aetolian
afar: afar
affable: affable
affair: affair,affairs
affect: affect
affectation: affectation
affection: affection,affections
affectionate: affectionate
affinity: affinity
affirm: affirm,affirmed,affirming,affirms
affirmative: affirmative
afflict: afflict,afflicted,afflicts
afflicting: afflicting
affliction: affliction
affluence: affluence
afford: afford,afforded,affording
affright: affright,affrighted
affrighted: affrighted
affront: affront,affronted,affronts
afire: afire
afloat: afloat
afoot: afoot
aforesaid: aforesaid
afraid: afraid
afresh: afresh
africa: africa
african: african,africans
afternoon: afternoon
aftertime: aftertimes
afterward: afterward
agamemnon: agamemnon
age: age,aged,ages
aged: aged
agency: agency
agent: agents
agger: agger
aggrandizement: aggrandizement
aggravate: aggravated,aggravating
aggravation: aggravation
aggressor: aggressors
aggrieved: aggrieved
aghast: aghast
agile: agile
agility: agility
agitate: agitated
agitation: agitation,agitations
agnus: agnus
agree: agree,agreed,agreeing,agrees
agreeable: agreeable
agreeableness: agreeableness
agreeably: agreeably
agreement: agreement
agriculture: agriculture
aid: aid,aided,aiding,aids
aider: aiders
aim: aim,aimed,aiming,aims
air: air,airs
ajax: ajax
akin: akin
alacrity: alacrity
alarm: alarm,alarmed,alarming,alarms
alarmed: alarmed
alarming: alarming
alas: alas
alba: alba
alban: alban
albanian: albanians
alcibiades: alcibiades
alea: alea
alexander: alexander
alexandria: alexandria
alien: alien,aliens
alienated: alienated
alight: alight,alighted,alighting
alike: alike
aliment: aliment
alive: alive
allay: allay,allayed,allaying
allege: allege,alleged,alleges,alleging
allegiance: allegiance
alleviate: alleviate
alley: alleys
alliance: alliance,alliances
allot: allotted,allotting
allotment: allotment
allowable: allowable
allowance: allowance,allowances
allude: alluded,alludes
alluding: alluding
allure: allure,allured
allurement: allurements
alluring: alluring
allusion: allusion
ally: allied,allies,ally
alms: alms
aloud: aloud
alpine: alpine
alps: alps
altar: altar,altars
alter: alter,altered,altering
alteration: alteration,alterations
alternative: alternative
altogether: altogether
amass: amassed
amaze: amaze
amazed: amazed
amazement: amazement
amazon: amazon
amazonian: amazonian
amazons: amazons
ambassador: ambassador,ambassadors
ambiguity: ambiguity
ambiguous: ambiguous
ambition: ambition
ambitious: ambitious
ambitiously: ambitiously
ambuscade: ambuscade
ambush: ambush,ambushes
amend: amend,amended,amending,amends
amendment: amendment,amendments
amiable: amiable
amicable: amicable
amicably: amicably
amiss: amiss
amity: amity
ammunition: ammunition
amorous: amorous
amour: amour
amours: amours
amphictyonic: amphictyonic
amphictyons: amphictyons
amphitryon: amphitryon
ample: ample
amply: amply
amulet: amulet
amuse: amuse,amused,amusing
amusement: amusement,amusements
anaces: anaces
anacreon: anacreon
analogy: analogy
anapaestic: anapaestic
anarchy: anarchy
anathematize: anathematize
ancestor: ancestor,ancestors
ancestral: ancestral
anchor: anchor,anchored,anchors
ancient: ancient,ancients
anciently: anciently
ancilia: ancilia
ancon: ancon
andria: andria
androcles: androcles
andromache: andromache
andronicus: andronicus
anecdote: anecdotes
anew: anew
angelus: angelus
anger: anger,angered
angle: angles
angrily: angrily
angry: angry
anguish: anguish
animal: animal,animals
animate: animate,animated,animating
animosity: animosities,animosity
annals: annals
annex: annex,annexed
annihilation: annihilation
anniversary: anniversary
announcement: announcement
annoy: annoy,annoyed
annoyance: annoyance,annoyances
annoyed: annoyed
annual: annual
annually: annually
annul: annul
anoint: anoint,anointed,anointing,anoints
answer: answer,answered,answering,answers
answerable: answerable
answerably: answerably
answering: answering
ant: ants
antaeus: antaeus
antagonist: antagonist,antagonists
antenor: antenor
anthemion: anthemion
anthesterion: anthesterion
anticipate: anticipate,anticipated
anticipation: anticipation
antigone: antigone
antigonus: antigonus
antilochus: antilochus
antiope: antiope
antiphon: antiphon
antiquated: antiquated
antique: antique
antiquity: antiquity
antony: antony
anxiety: anxieties,anxiety
anxious: anxious
anxiously: anxiously
anytime: anytime
apartment: apartment,apartments
aphrodite: aphrodite
apollo: apollo
apollonia: apollonia
apologize: apologize,apologized
apology: apology
apothegm: apothegms
appalling: appalling
apparatus: apparatus
apparel: apparel
apparent: apparent
apparition: apparition,apparitions
appeal: appeal,appealed,appealing
appearance: appearance,appearances
appease: appease,appeased,appeasing
appellation: appellation,appellations
appetite: appetite,appetites
appius: appius
applaud: applaud,applauded,applauding
applause: applause,applauses
apple: apple
applicable: applicable
application: application,applications
apply: applied,applies,apply,applying
appoint: appoint,appointed,appointing
appointment: appointment
appositely: appositely
apposition: apposition
appreciation: appreciation
apprehend: apprehend,apprehended,apprehending
apprehension: apprehension,apprehensions
apprehensive: apprehensive
approach: approach,approached,approaches,approaching
approbation: approbation
appropriation: appropriation,appropriations
approve: approve,approved,approving
appurtenance: appurtenances
april: april
apt: apt
aptera: aptera
aptly: aptly
arab: arabs
arabian: arabians
arable: arable
arbela: arbela
arbiter: arbiter
arbitrament: arbitrament
arbitrary: arbitrary
arbitrate: arbitrated
arbitration: arbitration
arbitrator: arbitrator,arbitrators
arbor: arbors
arcadia: arcadia
arcadian: arcadian,arcadians
arch: arch,arched
archelaus: archelaus
archer: archers
archery: archery
archidamus: archidamus
archimedes: archimedes
architect: architect
architrave: architraves
archive: archives
archon: archon,archons
archonship: archonship
arctic: arctic
ardea: ardea
ardor: ardor
areopagus: areopagus
arete: arete
arethusa: arethusa
argive: argive
argo: argo
argos: argos
argue: argue,argued,argues,arguing
argument: argument,arguments
ariadne: ariadne
aright: aright
aristeas: aristeas
aristides: aristides
aristippus: aristippus
aristocracy: aristocracy
aristocratic: aristocratic
aristocratical: aristocratical
aristotle: aristotle
arm: arm,armed,arming,arms
armada: armada
armament: armament,armaments
armed: armed
armenia: armenia
armenian: armenian
armenians: armenians
armlet: armlets
armor: armor
armorer: armorers
armory: armory
army: armies,army
arouse: arousing
arraign: arraign,arraigned
arrange: arrange,arranged,arranging
arrangement: arrangement,arrangements
arranger: arranger
array: array,arrayed
arrest: arrest,arrested
arrival: arrival
arrive: arrive,arrived,arriving
arrogance: arrogance
arrogancy: arrogancy
arrogant: arrogant
arrogantly: arrogantly
arrogate: arrogated,arrogating
arrow: arrow,arrows
arsenal: arsenal
art: art,arts
artemis: artemis
artemisia: artemisia
artemisium: artemisium
artemon: artemon
article: article,articles
articulate: articulate
articulation: articulation
artifice: artifice,artifices
artificer: artificers
artificial: artificial
artisan: artisans
artist: artist,artists
aruspex: aruspex
aruspice: aruspices
ascanius: ascanius
ascend: ascend,ascended,ascending,ascends
ascent: ascent,ascents
ascribe: ascribe,ascribed,ascribes,ascribing
ash: ashes
ashamed: ashamed
ashore: ashore
asia: asia
asiatic: asiatic
askance: askance
asleep: asleep
asparagus: asparagus
aspasia: aspasia
aspect: aspect
asperse: aspersed
aspirant: aspirants
aspire: aspire,aspired,aspires,aspiring
aspiring: aspiring
aspis: aspis
ass: ass,asses
assail: assailed
assailable: assailable
assailant: assailant,assailants
assassin: assassin
assassinate: assassinate,assassinated
assault: assault,assaulted,assaults
assemblage: assemblages
assemble: assemble,assembled,assembling
assembly: assemblies,assembly
assent: assent,assented,assenting
assert: assert,asserted,asserting,asserts
asserter: asserter
assertion: assertions
assess: assess,assessed
assessment: assessment
assiduous: assiduous
assign: assign,assigned,assigns
assignation: assignation
assimilate: assimilate
assist: assist,assisted,assisting
assistance: assistance
assistant: assistant,assistants
assister: assister
associate: associate,associates,associating
association: association
assuage: assuage
assume: assume,assumed,assumes,assuming
assumption: assumption
assurance: assurance,assurances
assure: assure,assured,assures,assuring
assuredly: assuredly
assyrians: assyrians
asteria: asteria
astern: astern
astonish: astonished
astonished: astonished
astonishing: astonishing
astonishment: astonishment
astounded: astounded
astray: astray
astrologer: astrologer
astronomy: astronomy
asunder: asunder
asylum: asylum
athenian: athenian,athenians
athenians: athenians
athens: athens
athlete: athlete
athletic: athletic
atlantic: atlantic
atmosphere: atmosphere
atonement: atonement
atrabilious: atrabilious
atreus: atreus
attach: attached,attaching
attachment: attachment
attack: attack,attacked,attacking,attacks
attain: attain,attained,attaining
attainder: attainder
attainment: attainment
attempt: attempt,attempted,attempting,attempts
attend: attend,attended,attending
attendance: attendance
attendant: attendant,attendants
attention: attention,attentions
attentive: attentive
attentively: attentively
attentiveness: attentiveness
attest: attested
attestation: attestation
attic: attic
attire: attire,attired
attitude: attitude
attract: attracted
attractive: attractive
attractiveness: attractiveness
attribute: attribute,attributed,attributes,attributing
auction: auction
audience: audience,audiences
auditor: auditors
auger: auger
aught: aught
augment: augmented
augmentation: augmentation
augur: augur,augurs
augural: augural
augury: auguries
august: august
augustness: augustness
augustus: augustus
aunt: aunt
aurelius: aurelius
auspices: auspices
auspicious: auspicious
austere: austere
austerity: austerity
authentic: authentic
author: author,authors
authority: authorities,authority
autumn: autumn
autumnal: autumnal
auxiliary: auxiliaries,auxiliary
avail: avail,availed,availing
avarice: avarice
avaricious: avaricious
avenge: avenge
aventine: aventine
avenue: avenue,avenues
aver: avers
averse: averse
aversion: aversion
avert: avert,averted
avocation: avocation
avoid: avoid,avoided,avoiding,avoids
avow: avowed,avowing
avowal: avowal
avowed: avowed
await: await,awaited,awaiting
awake: awake,awoke
awaken: awakened
award: award,awarding
aware: aware
awe: awe
awhile: awhile
awkwardly: awkwardly
axe: axe
axis: axes
axone: axones
ay: ay
babe: babes
babylon: babylon
babylonian: babylonian
bacchides: bacchides
bacchus: bacchus
bachelor: bachelors
backwardness: backwardness
bacula: bacula
bad: bad,worse,worst
bade: bade
badge: badge,badges
badness: badness
baffle: baffled
bag: bag,bags
baggage: baggage
bailiff: bailiffs
bait: bait,baited
balance: balance,balanced,balancing
balcony: balconies
bald: bald
ball: ball
ballast: ballast
band: band,banded,bands
bandage: bandage,bandages
banditti: banditti
bandy: bandied,bandy
banish: banish,banished,banishing
banishment: banishment
bank: bank,banks
banquet: banquet,banquets
banqueting: banqueting
banter: banter
bar: bar,barred
barathrum: barathrum
barbarian: barbarian,barbarians
barbaric: barbaric
barbarism: barbarism
barbarize: barbarized
barbarous: barbarous
barcas: barcas
bare: bare
barely: barely
bargain: bargain,bargains
bark: bark,barking,barks
barley: barley
barrel: barrels
barren: barren
barrenness: barrenness
base: base,basest
basely: basely
baseness: baseness
baser: baser
basilica: basilica
basin: basin,basins
basis: basis
basket: basket
bastard: bastard,bastards
bath: bath,bathed,baths
bathe: bathe
bathing: bathing
battalia: battalia
battalion: battalion
battering: battering
battery: battery
battle: battle,battles
battlements: battlements
bay: bay
beach: beach
beacon: beacons
beadle: beadles
beak: beak
beaked: beaked
beam: beams
bean: bean,beans
bear: bear,bearing,bears,bore,born,borne
beard: beard,beards
beardless: beardless
bearer: bearer,bearers
bearing: bearing
beast: beast,beasts
beastlike: beastlike
beat: beat,beaten,beating
beating: beating
beauteous: beauteous
beautified: beautified
beautiful: beautiful
beautify: beautified
beauty: beauty
beck: beck
beckon: beckoning
bed: bed,beds
bedchamber: bedchamber
bedding: bedding
bedstead: bedsteads
bee: bees
befall: befall,befallen,befalling,befell
befit: befit,befits,befitted
befitting: befitting
befoul: befouled
befriend: befriend,befriended
beg: beg,begged,begging
beget: beget,begot,begotten
begotten: begotten
behalf: behalf
behave: behave,behaved,behaving
behavior: behavior
behead: beheaded
behold: beheld,behold,beholding
beholden: beholden
beholder: beholders
beleaguer: beleaguering
belie: belying
belief: belief
bellerophon: bellerophon
bellona: bellona
belly: belly
belong: belong,belonged,belonging,belongs
beloved: beloved
belt: belt,belting,belts
belvedere: belvederes
bench: bench
bend: bend,bending,bent
bender: bender
beneath: beneath
benediction: benediction
benefactor: benefactor,benefactors
beneficence: beneficence
beneficial: beneficial
benefit: benefit,benefited,benefits
benevolence: benevolence
benignant: benignant
benignity: benignity
bent: bent
benumb: benumbing
bequeath: bequeathed,bequeathing
bequest: bequest
bereave: bereave,bereaved
bereavement: bereavement
berenice: berenice
beseech: beseech,beseeching,besought
beset: beset
besiege: besiege,besieged,besieging
besieger: besiegers
besmear: besmeared
besot: besotting
besought: besought
bespatter: bespattered
bespeak: bespoke
bestow: bestow,bestowed,bestowing
betake: betake,betaken,betaking,betook
bethink: bethink
bethought: bethought
betime: betimes
betimes: betimes
betoken: betokened
betook: betook
betray: betray,betrayed,betraying
betrayal: betrayal
betrayer: betrayer,betrayers
betroth: betrothed
betters: betters
betwixt: betwixt
bewail: bewail,bewailed,bewailing
beware: beware
bias: bias
bibulus: bibulus
bid: bade,bid,bidden,bidding
bidder: bidders
bidding: bidding
bide: bides,biding
bier: bier
bigness: bigness
bind: bind,binding,bound
biography: biographies
bion: bion
bird: bird,birds
birdlime: birdlime
birth: birth,births
birthday: birthday,birthdays
bisaltae: bisaltae
bit: bit,bits
bitch: bitch
bite: bit,bite
bitter: bitter,bitterest
bitterly: bitterly
bitterness: bitterness
black: black
blacken: blackening
bladder: bladder
blade: blade
blamable: blamable
blame: blame,blamed,blaming
blameless: blameless
blameworthy: blameworthy
blast: blast
blaze: blazed,blazing
blemish: blemish,blemishes
bless: bless,blessed,blest
blessed: blessed
blessedness: blessedness
blessing: blessing,blessings
blest: blest
blind: blind,blinded
blindly: blindly
block: block,blocked,blocking
blockade: blockade,blockaded,blockading
blood: blood
bloodshed: bloodshed
bloody: bloodiest,bloody
bloom: bloom,bloomed
blotch: blotches
blow: blew,blow,blowing,blown,blows
blue: blue
blunt: blunt
blush: blush,blushed,blushes
bluster: blustering
boar: boar,boars
board: board,boards
boast: boast,boasted,boasting,boasts
boaster: boasters
boastful: boastful
boastfulness: boastfulness
boasting: boasting,boastings
boastingly: boastingly
boat: boat,boats
boatswain: boatswains
bodily: bodily
boding: boding
body: bodies,body
boedromion: boedromion
boeotia: boeotia
boeotian: boeotian
bog: bogs
boil: boil,boiled,boiling
boisterous: boisterous
bola: bola
bold: bold,bolder,boldest
boldly: boldly
boldness: boldness
bond: bond,bonds
bondage: bondage
bone: bone,bones
book: book,books
boot: boots
booty: booty
border: border,bordered,bordering,borders
bore: bore,bored
borrow: borrow,borrowed
bosom: bosom,bosoms
bosporus: bosporus
bough: bough,boughs
bound: bound,bounded,bounding,bounds
boundary: boundaries,boundary
bountiful: bountiful
bounty: bounties,bounty
bout: bout
bow: bows
bowels: bowels
bowl: bowl,bowls
box: box
boy: boy,boys
boyish: boyish
bracelet: bracelet,bracelets
brag: brag
brain: brain,brains
brained: brained
branch: branch,branches
brand: branded,brands
brandish: brandished,brandishing
brass: brass
brave: brave,bravest
bravely: bravely
braveness: braveness
braver: braver
bravery: bravery
bray: brayed
brazen: brazen
brazier: braziers
breach: breach,breaches
bread: bread
breadth: breadth
break: break,breaking,breaks,broke,broken
breakfast: breakfast
breaking: breaking
breast: breast,breasts
breastplate: breastplate,breastplates
breath: breath
breathe: breathed
breathing: breathing
breathless: breathless
breed: bred,breed,breeds
breeder: breeder,breeders
breeding: breeding
breeze: breeze
brethren: brethren
brevity: brevity
briareus: briareus
bribe: bribe,bribed,bribes,bribing
bribery: bribery
brick: brick
bridal: bridal
bride: bride,brides
bridegroom: bridegroom
bridge: bridge,bridges
bridle: bridle,bridling
bright: bright
brightness: brightness
brilliant: brilliant
bring: bring,bringing,brings,brought
bringer: bringer
brink: brink
brisk: brisker
briskly: briskly
bristle: bristles,bristling
broad: broad
broadside: broadside
broil: broils
broke: broke
broken: broken
brood: brooding
brook: brooked,brooks
brooking: brooking
broth: broth
brother: brother,brothers
brothers: brothers
bruise: bruised,bruising
brushwood: brushwood
brutal: brutal
brute: brute,brutes
brutish: brutish
brutus: brutus
bubble: bubble
bucket: buckets
buckle: buckle,buckled
buckler: buckler,bucklers
bud: bud,buds
buffoon: buffoons
buffoonery: buffooneries
build: build,building,built
builder: builders
building: building,buildings
bulk: bulk
bulky: bulky
bull: bull
bulla: bulla
bullion: bullion
bulwark: bulwark,bulwarks
bundle: bundle,bundles
burden: burden,burdened
burdensome: burdensome
burial: burial,burials
burn: burn,burned,burning,burnt
burning: burning
burst: burst
bury: buried,bury,burying
bushel: bushel,bushels
business: business
buskin: buskin,buskins
busy: busied,busies,busy
butcher: butcher,butchered
buteo: buteo
butt: butt
buyer: buyer
buying: buying
buzz: buzz
bystander: bystanders
byzantine: byzantine
byzantium: byzantium
cabal: cabals
cabbage: cabbage
cabin: cabins
cabinet: cabinet
cabiri: cabiri
cable: cables
cackling: cackling
cadence: cadence
cadmus: cadmus
caecilia: caecilia
caesar: caesar
cage: caged
cake: cakes
calamitously: calamitously
calamity: calamities,calamity
calculate: calculated,calculating
calculation: calculation
calendar: calendar
calends: calends
calf: calf
calling: calling
calm: calm
calmly: calmly
calmness: calmness
calumniate: calumniate
calumny: calumnies,calumny
calydonian: calydonian
camel: camel,camels
camillus: camillus
camp: camp,camps
campaign: campaign,campaigns
campania: campania
campus: campus
cancel: cancel,canceled,canceling
candid: candid
candidate: candidate,candidates
candor: candor
canon: canons
canopus: canopus
canst: canst
canvass: canvassing
cap: cap,caps
capable: capable
capacity: capacities,capacity
cape: cape
capital: capital
capitol: capitol
capitoline: capitoline
capitulate: capitulating
capitulation: capitulation
cappadocian: cappadocian
capra: capra
captain: captain,captains
captaincy: captaincy
captivate: captivate,captivated
captive: captive,captives
captivity: captivity
capture: capture,captured,capturing
capturing: capturing
car: cars
carbo: carbo
carcass: carcasses
carcer: carcer
care: care,cared,cares,caring
career: career
careful: careful
carefully: carefully
careless: careless
carelessly: carelessly
carelessness: carelessness
caress: caress,caressed,caresses
cargo: cargo
carian: carian
carman: carmen
carouse: carouse
carousing: carousing
carpenter: carpenter,carpenters
carpet: carpet
carriage: carriage,carriages
carrier: carrier,carriers
carrion: carrion
carry: carried,carries,carry,carrying
cart: cart
carter: carter
carthaginian: carthaginian
cartilage: cartilage
carve: carved
carver: carver
cashier: cashiered
caspian: caspian
cassius: cassius
cast: cast,casting,casts
castle: castle,castles
castor: castor
casual: casual
casually: casually
casualty: casualties
catalog: catalog
catalogue: catalogue,catalogues
catarrh: catarrhs
catch: catch,catching,caught
catiline: catiline
cattle: cattle
caucasus: caucasus
causality: causality
causeless: causeless
caution: caution,cautioning
cautious: cautious
cautiousness: cautiousness
cavalry: cavalry
cave: cave
cavil: caviled,cavilled
cease: cease,ceased,ceases
cecrops: cecrops
ceiling: ceiling,ceilings
celebrate: celebrate,celebrated,celebrates,celebrating
celebrated: celebrated
celebration: celebration
celebrity: celebrity
celerity: celerity
celestial: celestial
cell: cell
celtic: celtic
cement: cement,cemented
censor: censor,censors
censors: censors
censorship: censorship
censurable: censurable
censure: censure,censured,censuring
centaurs: centaurs
center: center,centered,centering
central: central
centurion: centurion,centurions
century: centuries
cerberus: cerberus
ceremonial: ceremonial
ceremony: ceremonies,ceremony
ceres: ceres
certainty: certainty
certify: certified
cessation: cessation
chafe: chafing
chain: chained,chains
chained: chained
chair: chair,chairs
chalcis: chalcis
chalcus: chalcus
chaldean: chaldean
challenge: challenge,challenged,challenges,challenging
challenger: challenger
chamber: chamber,chambers
chameleon: chameleon
champain: champain
champing: champing
champion: champion,champions
chance: chance,chanced,chances
change: change,changed,changing
changefulness: changefulness
channel: channel
chapel: chapel,chapels
chaplet: chaplet,chaplets
character: character,characters
characteristic: characteristic,characteristics
characterize: characterized
chares: chares
charge: charge,charged,charges,charging
chargeable: chargeable
chariot: chariot,chariots
charioteer: charioteer
charitably: charitably
charity: charity
charlatan: charlatan
charm: charm,charmed,charms
charming: charming
charmingly: charmingly
charon: charon
chase: chase,chased,chasing
chasm: chasm,chasms
chaste: chaste
chasten: chastened
chastener: chasteners
chastise: chastise,chastised
chastisement: chastisement
chastity: chastity
cheap: cheapest
cheat: cheat,cheated
check: check,checked,checking
cheer: cheer,cheered
cheerful: cheerful
cheerfully: cheerfully
cheerfulness: cheerfulness
cheese: cheese
chelidonian: chelidonian
cherish: cherish,cherished,cherishing
chersonese: chersonese
chest: chest,chests
chestnut: chestnut
chew: chew
chid: chid
chide: chid,chide
chief: chief,chiefest,chiefs
chiefly: chiefly
chieftain: chieftain,chieftains
child: child,children
childbirth: childbirth
childhood: childhood
childish: childish
childishly: childishly
childlike: childlike
chimerical: chimerical
chimney: chimney
chin: chin
chiron: chiron
chiton: chiton
choice: choice,choicest
choir: choirs
choke: choke
choose: choose,chooses,choosing,chose,chosen
choosing: choosing
choral: choral
chorus: chorus,choruses
chronic: chronic
chronological: chronological
chronology: chronology
chronos: chronos
cicero: cicero
cilician: cilician
cimbri: cimbri
cimbrian: cimbrian
cimmerian: cimmerian
cinnamon: cinnamon
circe: circe
circle: circle
circuit: circuit
circular: circular
circulate: circulate,circulated
circulation: circulation
circumambient: circumambient
circumference: circumference
circumspection: circumspection
circumstance: circumstance,circumstances
circumstantial: circumstantial
circumvallation: circumvallation
circumvent: circumvent,circumvented
circus: circus,circuses
citadel: citadel,citadels
cite: cite,cited,cites,citing
citizen: citizen,citizens
citizenship: citizenship
city: cities,city
civil: civil
civilize: civilizing
civilized: civilized
civilly: civilly
clad: clad
claim: claim,claimed,claiming,claims
clamber: clambered
clamor: clamor,clamored,clamors
clamoring: clamoring
clamorous: clamorous
clandestinely: clandestinely
clap: clapped,claps
clapping: clapping
clash: clash,clashed,clashing
class: class,classes
clatter: clattering
claudian: claudian
claudius: claudius
clause: clause
claw: claws
clay: clay
clean: clean
cleanly: cleanly
cleanse: cleanse,cleanses
cleansing: cleansing
cleave: cleaving
clemency: clemency
cleopatra: cleopatra
clerk: clerk
clever: clever
client: client,clients
cliff: cliff,cliffs
climate: climate
climb: climb,climbed,climbing
climbing: climbing
cling: cling,clinging,clung
clip: clipped,clips
cloak: cloak,cloaks
clod: clod
clog: clogged
close: close,closed,closer,closest,closing
closely: closely
closeness: closeness
closet: closet
closing: closing
cloth: cloth,cloths
clothe: clad
clothes: clothes
clothing: clothing
cloud: cloud,clouds
cloudy: cloudy
clough: clough
clownish: clownish
cloy: cloyed
club: club,clubs
clubman: clubmen
clue: clue
cluster: clustering
coalition: coalition
coarse: coarse
coast: coast,coasts
coat: coat,coats
coax: coaxing
cock: cock,cocks
codrus: codrus
coffin: coffin,coffins
cogency: cogency
cognizance: cognizance
cohabit: cohabiting
coheir: coheirs
cohort: cohorts
coil: coil
coin: coin,coined,coins
coincide: coinciding
coincident: coincident
colchis: colchis
cold: cold
coldness: coldness
colias: colias
collar: collars
colleague: colleague,colleagues
collect: collect,collected,collecting
collected: collected
collection: collection
collector: collector,collectors
colline: colline
colloquy: colloquy
colonist: colonists
colonnade: colonnade,colonnades
colony: colonies,colony
colophon: colophon
color: color,coloring,colors
colored: colored
colossal: colossal
colt: colt,colts
column: column,columns
combat: combat,combats
combatant: combatants
combination: combination,combinations
combine: combine,combined,combines,combining
combustible: combustible,combustibles
combustion: combustion
comedian: comedian
comedy: comedies,comedy
comeliness: comeliness
comely: comelier,comely
comer: comer,comers
comfort: comfort,comforted,comforting
comic: comic
coming: coming
comitia: comitia
comitium: comitium
command: command,commanded,commanding,commands
commander: commander,commanders
commanding: commanding
commemorate: commemorate,commemorated
commemoration: commemoration
commence: commence,commenced,commences,commencing
commencement: commencement
commend: commend,commended,commending,commends
commendable: commendable
commendably: commendably
commendation: commendation,commendations
commentary: commentaries,commentary
commerce: commerce
commiserate: commiserate,commiserating
commiseration: commiseration
commission: commission,commissioned,commissions
commissioner: commissioner,commissioners
commit: commit,committed,committing
committee: committee
commodious: commodious
commodiousness: commodiousness
common: common,commons
commonalty: commonalty
commonly: commonly
commonness: commonness
commonwealth: commonwealth,commonwealths
commotion: commotion,commotions
communicate: communicate,communicated,communicating
communication: communication,communications
community: community
compact: compact,compacted
companion: companion,companions
company: companies,company
comparable: comparable
comparatively: comparatively
compare: compare,compared,comparing
comparison: comparison
compass: compass,compassing
compassion: compassion
compassionate: compassionate
compatible: compatible
compel: compel,compelled
compelled: compelled
compeller: compeller
compelling: compelling
compensate: compensated
compensation: compensation
compete: compete,competed,competing
competent: competent
competition: competition
competitor: competitor,competitors
compilation: compilation
compile: compiled
complain: complain,complained,complaining
complaint: complaint,complaints
complaisance: complaisance
complaisant: complaisant
complement: complement
complete: complete,completed
completely: completely
completion: completion
complexion: complexion
compliance: compliance
complicated: complicated
complication: complication
compliment: compliment,complimented,complimenting,compliments
comply: complied,comply,complying
compose: compose,composed,composing
composedly: composedly
composer: composers
composition: composition,compositions
composure: composure
compound: compound,compounded
comprehend: comprehend,comprehended
comprehension: comprehension
comprehensive: comprehensive
compress: compressed,compressing
compulsion: compulsion
computation: computation
compute: computing
comrade: comrades
concave: concave
conceal: conceal,concealed,concealing,conceals
concealment: concealment
concede: concede,concedes
conceit: conceit
conceited: conceited
conceivable: conceivable
conceive: conceive,conceived,conceiving
concentrate: concentrate
conception: conception,conceptions
concern: concern,concerned,concerns
concerned: concerned
concert: concert,concerting
concerted: concerted
concession: concession,concessions
conclude: conclude,concluded,concluding
conclusion: conclusion,conclusions
conclusive: conclusive
concord: concord
concourse: concourse
concubine: concubine,concubines
concur: concur,concurred,concurring
concurrence: concurrence
concussion: concussion
condemn: condemn,condemned,condemning,condemns
condemnation: condemnation,condemnations
condense: condensed,condensing
condition: condition,conditioning,conditions
conditionally: conditionally
condole: condole,condoled,condoling
condolence: condolence
conduce: conduce,conduced
conduct: conduct,conducted,conducting,conducts
conductor: conductor
conductress: conductress
conduit: conduits
confederacy: confederacy
confederate: confederate,confederated,confederates
confer: confer,conferred,conferring
conference: conference,conferences
confess: confess,confessed,confessing
confessedly: confessedly
confession: confession
confidant: confidants
confide: confide,confided,confiding
confidence: confidence
confident: confident
confidential: confidential
confidently: confidently
configuration: configuration
confine: confine,confined
confinement: confinement
confines: confines
confirm: confirm,confirmed,confirming,confirms
confirmation: confirmation
confiscate: confiscated
confiscation: confiscation
conflict: conflict,conflicts
confluence: confluence
conform: conform
conformable: conformable
conformity: conformity
confound: confound,confounded,confounding
confront: confront,confronting
confused: confused
confusedly: confusedly
confusion: confusion
confute: confute,confuted,confutes
congeal: congealed
congratulate: congratulated,congratulating
congratulating: congratulating
congratulation: congratulations
congress: congress,congresses
congruous: congruous
conical: conical
conjectural: conjectural
conjecture: conjecture,conjectured,conjectures,conjecturing
conjunction: conjunction
conjuncture: conjuncture
conjuring: conjuring
connect: connected
connection: connection,connections
connive: connive,connived
conquer: conquer,conquered,conquering,conquers
conquering: conquering
conqueror: conqueror,conquerors
conquest: conquest,conquests
consanguinity: consanguinity
conscious: conscious
consciousness: consciousness
conscription: conscription
consecrate: consecrate,consecrated,consecrating
consecrated: consecrated
consecutive: consecutive
consent: consent,consented,consenting,consents
consequence: consequence,consequences
consequent: consequent
conserve: conserve
considerable: considerable
considerably: considerably
considerate: considerate
consideration: consideration,considerations
consign: consigned
consist: consist,consisted,consisting,consists
consistence: consistence
consistency: consistency
consistent: consistent
consistently: consistently
consolation: consolation
console: console,consoled
consolidate: consolidating
consonance: consonance
consonant: consonant
consort: consort
conspicuous: conspicuous
conspicuously: conspicuously
conspiracy: conspiracy
conspirator: conspirator,conspirators
conspire: conspire,conspired,conspiring
constancy: constancy
constant: constant
constantly: constantly
consternation: consternation
constitute: constitute,constituted,constituting
constitution: constitution,constitutions
constitutional: constitutional
constrain: constrain,constrained,constraining
constraint: constraint
construct: constructed,constructing
construction: construction
construe: construe
consul: consul,consuls
consular: consular
consulate: consulate,consulates
consulship: consulship,consulships
consult: consult,consulted,consulting
consultation: consultation,consultations
consulter: consulter
consume: consume,consumed,consumes
consummate: consummate,consummated,consummating
consummation: consummation
contact: contact
contagion: contagion
contemn: contemn,contemned,contemning
contemned: contemned
contemner: contemner
contemplate: contemplating
contemplation: contemplation
contemplative: contemplative
contemporary: contemporaries,contemporary
contempt: contempt
contemptible: contemptible
contemptuous: contemptuous
contemptuously: contemptuously
contemptuousness: contemptuousness
contend: contend,contended,contending
content: content,contenting
contented: contented
contention: contention
contentious: contentious
contents: contents
contest: contest,contested,contesting,contests
continence: continence
continent: continent,continents
contingent: contingents
continual: continual
continually: continually
continuance: continuance
continue: continue,continued,continues,continuing
continuous: continuous
contract: contract,contracted,contracting,contracts
contraction: contraction
contradict: contradict,contradicted,contradicting
contradiction: contradiction,contradictions
contrariety: contrariety
contrariwise: contrariwise
contrary: contrary
contrast: contrast,contrasting
contribute: contribute,contributed,contributes,contributing
contribution: contribution,contributions
contrivance: contrivance,contrivances
contrive: contrive,contriving
contrived: contrived
control: control,controlled
controller: controllers
controversy: controversy
contumacious: contumacious
contumaciously: contumaciously
contumacy: contumacy
contumelious: contumelious
contumeliously: contumeliously
contumely: contumelies,contumely
convene: convene,convened,convening
convenience: convenience,conveniences
convenient: convenient
convention: convention
convergence: convergence
conversant: conversant
conversation: conversation,conversations
converse: converse,conversed,conversing
convert: convert,converted,converting
convey: convey,conveyed,conveying
conveyance: conveyance
convict: convicted
conviction: conviction,convictions
convince: convinced
convoy: convoy
convulsion: convulsions
cook: cook,cooked,cooks
cookery: cookery
cooking: cooking
cool: cool,cooled,cooling
coolness: coolness
coop: cooped,coops
cooperate: cooperating
cooperation: cooperation
copartner: copartner
cope: cope
copious: copious
copper: copper
coppersmith: coppersmith
cora: cora
cord: cord,cords
corinth: corinth
corinthian: corinthian,corinthians
coriolanus: coriolanus
cork: corks
corn: corn
cornel: cornel
cornelia: cornelia
cornelius: cornelius
corner: corner,corners
cornet: cornets
cornutus: cornutus
corpse: corpse
corpulency: corpulency
correct: correct,corrected
correction: correction
corrective: correctives
correctly: correctly
correctness: correctness
correspond: corresponded,corresponds
correspondence: correspondence
corrupt: corrupt,corrupted,corrupting
corrupted: corrupted
corruption: corruption,corruptions
corslet: corslet
cos: cos
cosmographer: cosmographer
cost: cost
costliness: costliness
costly: costly
cotta: cotta
cottage: cottage
couch: couch,couches
council: council,councils
councilor: councilors
councils: councils
counsel: counsel,counseled,counseling,counsels
counseling: counseling
counselor: counselor,counselors
count: count,counted,counting
countenance: countenance,countenanced,countenances
counter: counter
counterbalance: counterbalance
counterfeit: counterfeit,counterfeited,counterfeiting
counterfeiting: counterfeiting
counterpoise: counterpoise
countless: countless
country: countries,country
countryman: countryman,countrymen
countrywoman: countrywoman
countrywomen: countrywomen
couple: couple
courage: courage
courageous: courageous
courageously: courageously
courser: courser
court: court,courted,courting,courts
courteous: courteous
courteously: courteously
courtesan: courtesan,courtesans
courtesy: courtesies,courtesy
courtship: courtship
cousin: cousin,cousins
covenant: covenant
cover: cover,covered,covering,covers
covered: covered
covering: coverings
coverlet: coverlets
covert: covert
covertly: covertly
covet: covet,coveted,coveting
covetous: covetous
covetousness: covetousness
cow: cow,cows
coward: coward,cowards
cowardice: cowardice
cowardly: cowardly
cower: cowering
cowherd: cowherds
crack: cracking
cradle: cradle
craft: craft
craftsman: craftsmen
crafty: craftiest,crafty
craggy: craggy
cramp: cramps
crane: crane,cranes
craven: craven
crawl: crawling
create: create,created,creates,creating
creation: creation
creature: creature,creatures
credibility: credibility
credible: credible
credit: credit,credited,crediting
creditable: creditable
creditor: creditor,creditors
creep: creep,creeping,crept
crest: crest,crests
cretan: cretan
crete: crete
crier: crier,criers
crime: crime,crimes
criminal: criminal,criminals
criminality: criminality
cringe: cringing
cripple: cripple,crippled
crisis: crisis
critical: critical
criticism: criticism
criticize: criticize,criticized,criticizing
crooked: crooked
crookedly: crookedly
crop: crop,crops
cross: cross,crossed,crossing
croton: croton
crow: crows
crowd: crowd,crowded,crowding,crowds
crown: crown,crowned,crowns
crowning: crowning
crucify: crucified,crucify
cruel: cruel
cruelty: cruelties,cruelty
cruise: cruised,cruising
crush: crush,crushed
crying: crying
cube: cube
cubit: cubit,cubits
cud: cud
cuff: cuff
culprit: culprit
cultivate: cultivate,cultivated
cultivation: cultivation
culture: culture
cumber: cumbered
cumbersome: cumbersome
cumbrous: cumbrous
cunning: cunning
cunningly: cunningly
cup: cup,cups
cupid: cupid
cupidity: cupidity
curb: curb,curbed
cure: cure,cured,cures,curing
curia: curiae
curiae: curiae
curio: curio
curiosity: curiosities,curiosity
curious: curious
curiously: curiously
curiousness: curiousness
curl: curl
curly: curly
currency: currency
current: current,currents
curse: curse,cursed,curses,cursing
cursing: cursing
curtail: curtail
curtain: curtain,curtained,curtains
curule: curule
curve: curves
curvilinear: curvilinear
custody: custody
custom: custom,customs
customary: customary
cut: cut,cuts,cutting
cutter: cutters
cutting: cutting
cuttlefish: cuttlefish
cyanean: cyanean
cybele: cybele
cyclades: cyclades
cyclops: cyclops
cylinder: cylinder
cyme: cyme
cynosarges: cynosarges
cypress: cypress
cyprus: cyprus
cyrus: cyrus
dactyli: dactyli
daedalus: daedalus
daemon: daemon
dagger: dagger,daggers
daily: daily
dainty: dainties,dainty
dam: dam,damming
damage: damage,damaged
damages: damages
dame: dame
damon: damon
damp: damp
damsel: damsel
dance: dance,danced,dances,dancing
dancer: dancer,dancers
dancing: dancing
danger: danger,dangers
dangerous: dangerous
dangerously: dangerously
dangle: dangling
danube: danube
daphne: daphne
daric: darics
daring: daring
darius: darius
dark: dark
darken: darkened
darkness: darkness
dart: dart,darted,darting
darts: darts
dash: dashed,dashes
daub: daubed
daughter: daughter,daughters
daunt: daunted
daunted: daunted
daunting: daunting
dawn: dawn
day: day,days
daybreak: daybreak
daylight: daylight
daytime: daytime
dazzle: dazzle,dazzling
dead: dead
deadly: deadly
deaf: deaf
deal: deal,dealing,deals,dealt
dealer: dealer
dealing: dealing
dealings: dealings
dearest: dearest
dearly: dearly
dearth: dearth
death: death,deaths
debar: debarred
debate: debate,debated,debates
debauch: debauch,debauched,debauches
debauched: debauched
debauchee: debauchee
debauchery: debaucheries
debt: debt,debts
debtor: debtor,debtors
decamp: decamped
decay: decay,decayed
decayed: decayed
decease: decease,deceased
deceased: deceased
deceit: deceit
deceitful: deceitful
deceive: deceive,deceived,deceiving
december: december
decency: decency
decent: decent
decently: decently
decide: decide,decided,deciding
decidedly: decidedly
decision: decision
decisive: decisive
deck: deck,decked,decks
declaim: declaim,declaimed
declamation: declamation,declamations
declaration: declaration
declare: declare,declared,declares,declaring
declination: declination
decline: decline,declined,declines,declining
decorum: decorum
decoy: decoys
decrease: decrease,decreasing
decree: decree,decreed,decreeing,decrees
decrepit: decrepit
dedicate: dedicate,dedicated,dedicating
dedicated: dedicated
dedication: dedication
deduce: deduce,deduced,deduces
deduction: deductions
deed: deed,deeds
deem: deemed,deeming
deep: deep
deepen: deepened
deeply: deeply
deface: deface,defaced,defacing
defacing: defacing
defame: defame
defaulter: defaulters
defeat: defeat,defeated,defeats
defect: defect,defects
defective: defective
defend: defend,defended,defending,defends
defendant: defendant,defendants
defender: defender,defenders
defense: defense
defenseless: defenseless
defensive: defensive
defer: defer,deferred,deferring
deference: deference
defiance: defiance
deficiency: deficiencies
deficient: deficient
defile: defile,defiled
define: define
definition: definition
deform: deform,deformed
deformity: deformity
defraud: defraud,defrauded
defray: defray,defrayed
defy: defied,defying
degenerate: degenerated
degradation: degradation
degrade: degraded
degree: degree,degrees
deify: deifying
deign: deign
deity: deities,deity
dejected: dejected
dejection: dejection
delay: delay,delayed,delaying,delays
delegate: delegated
deliberate: deliberate,deliberating
deliberately: deliberately
deliberation: deliberation
delicacy: delicacies
delicate: delicate
delicately: delicately
delicious: delicious
delight: delight,delighted,delighting,delights
delighted: delighted
delightful: delightful
delinquent: delinquents
delirious: delirious
delirium: delirium
deliver: deliver,delivered,delivering,delivers
deliverance: deliverance
deliverer: deliverer,deliverers
delivery: delivery
delphian: delphian
delphinium: delphinium
delude: delude,deluded,deluding
deluge: deluge
demagogue: demagogue,demagogues
demand: demand,demanded,demanding,demands
demeaning: demeaning
demeanor: demeanor
demerit: demerits
demi: demi
demigod: demigod
democracy: democracy
democratic: democratic
democratical: democratical
demolish: demolish,demolished,demolishing
demon: demon
demonstrate: demonstrate,demonstrated,demonstrating
demonstration: demonstration,demonstrations
demophon: demophon
demur: demur,demurred
den: den,dens
denarii: denarii
denarius: denarius
denial: denial
denomination: denominations
denote: denote,denoting
denounce: denounce,denounced
dense: dense
density: density
deny: denied,denies,deny,denying
depart: depart,departed
departure: departure
depend: depend,depended,depending,depends
dependence: dependence
dependency: dependencies
dependent: dependent,dependents
deplorable: deplorable
deplore: deplored
depopulate: depopulated
depopulated: depopulated
depopulation: depopulations
deportment: deportment
depose: depose,deposed
deposing: deposing
deposit: deposit,deposited
depravation: depravation
depraved: depraved
depraver: depravers
deprecate: deprecate,deprecating
deprecatory: deprecatory
depreciate: depreciate
depredation: depredation
depress: depress,depressing
depression: depression
depressure: depressure
deprivation: deprivation
deprive: deprive,deprived
depth: depth
deputation: deputation,deputations
deputy: deputies,deputy
derange: deranged
deride: deride,derided,deriding
derision: derision
derivation: derivation
derive: derive,derived,derives,deriving
derogate: derogating
descend: descend,descended,descending
descendant: descendant,descendants
descended: descended
descent: descent,descents
description: description,descriptions
descry: descried,descry
desert: desert,deserted,deserting,deserts
deserted: deserted
deserter: deserter,deserters
deserve: deserve,deserved,deserves,deserving
deserved: deserved
deservedly: deservedly
deserving: deserving
design: design,designed,designing,designs
designedly: designedly
desirable: desirable
desire: desire,desired,desires,desiring
desirous: desirous
desist: desist,desisting
desisted: desisted
desolate: desolate,desolating
desolation: desolation
despair: despair,despaired
despaired: despaired
despairing: despairing
desperate: desperate
desperately: desperately
desperation: desperation
despicable: despicable
despise: despise,despised,despises,despising
despoil: despoiled
despondency: despondency
despondent: despondent
despot: despot
despotic: despotic
despotism: despotisms
destine: destined
destiny: destiny
destitute: destitute
destitution: destitution
destroy: destroy,destroyed,destroying,destroys
destroyer: destroyer,destroyers
destruction: destruction
destructive: destructive
detach: detached,detaching
detachment: detachment
detain: detain,detained,detaining
detect: detect,detected,detecting
detection: detection
deter: deter,deterred
determinate: determinate
determination: determination,determinations
determine: determine,determined,determining
determined: determined
determiner: determiners
detest: detested
detestation: detestation
detract: detracted
detraction: detraction,detractions
detractor: detractors
detrimental: detrimental
deucalion: deucalion
devastation: devastation,devastations
deviate: deviated
device: device
devise: devises
devoid: devoid
devolve: devolved,devolving
devote: devoted,devoting
devoted: devoted
devotion: devotion
devotions: devotions
devour: devour,devoured,devouring
devourer: devourer
devout: devout
devoutness: devoutness
dewy: dewy
dexterity: dexterity
dexterously: dexterously
diadem: diadem
diagram: diagram,diagrams
dial: dials
dialect: dialect
dialogue: dialogue,dialogues
diana: diana
dice: dice
dictate: dictates
dictator: dictator,dictators
dictatorship: dictatorship
diction: diction
dictum: dictum
didymus: didymus
die: die,died,dies,dying
diem: diem
diet: diet
difference: difference,differences
difficult: difficult
difficulty: difficulties,difficulty
diffidence: diffidence
diffident: diffident
diffuse: diffused
diffusion: diffusion
dig: dig,digging,dug
digest: digest,digested
digestion: digestion
dignity: dignities,dignity
digress: digressed
dilatory: dilatory
diligence: diligence
diligent: diligent
diligently: diligently
dilute: diluted
dim: dim
dimension: dimension
diminish: diminish,diminished,diminishing
diminution: diminution
diminutive: diminutive
dindymene: dindymene
dine: dine,dines
dining: dining
dinner: dinner,dinners
diogenes: diogenes
diomedes: diomedes
dion: dion
dioscuri: dioscuri
dip: dipped,dips
dipping: dipping
dipt: dipt
dipylon: dipylon
direct: direct,directed,directing
direction: direction,directions
direful: direful
dirt: dirt
dirty: dirty
disable: disabled
disabled: disabled
disadvantage: disadvantage,disadvantages
disadvantageous: disadvantageous
disaffect: disaffecting
disaffected: disaffected
disagree: disagreed,disagreeing
disagreeable: disagreeable
disagreement: disagreement
disallow: disallowed
disappear: disappeared,disappears
disappearance: disappearance
disappoint: disappoint,disappointed
disappointed: disappointed
disappointment: disappointment
disapprove: disapprove
disaster: disaster,disasters
disband: disband
disbelieve: disbelieve,disbelieved
disbelieved: disbelieved
disbursement: disbursement,disbursements
discern: discern,discerned,discerning
discernible: discernible
discerning: discerning
discernment: discernment
discharge: discharge,discharged,discharges,discharging
discharging: discharging
disciple: disciple
discipline: discipline,disciplined,disciplining
disciplined: disciplined
disclose: disclose,disclosed,discloses,disclosing
discomfited: discomfited
discompose: discompose,discomposed
discomposed: discomposed
discomposure: discomposure
disconcerted: disconcerted
disconsolate: disconsolate
discontent: discontent,discontented,discontents
discontented: discontented
discord: discord
discordance: discordance
discordant: discordant
discourage: discourage,discouraged
discouraged: discouraged
discouragement: discouragement
discourse: discourse,discoursed,discourses,discoursing
discoursing: discoursing
discover: discover,discovered,discovering
discoverer: discoverer
discovery: discoveries,discovery
discredit: discredit
discreditable: discreditable
discreet: discreet,discreetest
discretion: discretion
discrimination: discrimination
discuss: discuss,discussed,discussing
discussion: discussion,discussions
disdain: disdain,disdained,disdaining,disdains
disdainfully: disdainfully
disease: disease,diseases
diseased: diseased
disembark: disembark,disembarked,disembarking
disencumbrance: disencumbrance
disengage: disengage,disengaged
disentangle: disentangle,disentangled
disfigure: disfigure
disfigured: disfigured
disfranchise: disfranchised,disfranchises
disgrace: disgrace,disgraced,disgracing
disgraceful: disgraceful
disgracefully: disgracefully
disguise: disguise,disguised,disguises,disguising
disgust: disgust,disgusted
disgusted: disgusted
dish: dish,dishes
dishearten: dishearten,disheartened
dishonest: dishonest
dishonesty: dishonesty
dishonor: dishonor,dishonored
dishonorable: dishonorable
dishonorably: dishonorably
disinterested: disinterested
dislike: dislike,disliked,disliking
dislocated: dislocated
dislodge: dislodge,dislodged,dislodging
dismal: dismal
dismantle: dismantled
dismay: dismay,dismayed
dismayed: dismayed
dismiss: dismiss,dismissed,dismissing
dismount: dismount,dismounted
disobedience: disobedience
disobedient: disobedient
disobey: disobey,disobeying
disoblige: disoblige,disobliged
disorder: disorder,disordered,disordering,disorders
disordered: disordered
disorderly: disorderly
disown: disown,disowned,disowning
disparage: disparaging
disparagement: disparagement
disparity: disparity
dispassionate: dispassionate
dispatch: dispatch,dispatched,dispatches,dispatching
dispense: dispensing
disperse: disperse,dispersed,dispersing
dispersed: dispersed
dispersion: dispersion
dispirited: dispirited
displace: displaced
display: display,displayed,displaying,displays
displease: displease,displeased
displeased: displeased
displeasure: displeasure
disposal: disposal
dispose: dispose,disposed,disposing
disposed: disposed
disposition: disposition,dispositions
dispossess: dispossess,dispossessed
dispraise: dispraise
disproof: disproof
disproportionable: disproportionable
disproportionate: disproportionate
disprove: disproved,disproves
dispute: dispute,disputed,disputes,disputing
disquiet: disquiet,disquieted
disquieting: disquieting
disquisition: disquisition
disregard: disregard,disregarded,disregarding
disrepute: disrepute
disrespect: disrespect
disruption: disruption
dissatisfied: dissatisfied
dissemble: dissemble,dissembled,dissembling
dissembling: dissembling
dissension: dissension,dissensions
dissipate: dissipate,dissipated
dissipation: dissipation
dissolute: dissolute
dissoluteness: dissoluteness
dissolution: dissolution
dissolve: dissolve,dissolved
dissuade: dissuade,dissuaded,dissuading
dissuasion: dissuasions
distance: distance
distant: distant
distaste: distaste,distastes
distasteful: distasteful
distemper: distemper
distempered: distempered
distention: distention
distich: distich
distinct: distinct
distinction: distinction,distinctions
distinctly: distinctly
distinguish: distinguish,distinguished,distinguishing
distinguished: distinguished
distort: distort,distorted
distract: distract,distracted,distracting,distracts
distracted: distracted
distraction: distraction,distractions
distress: distress,distressed,distresses
distressed: distressed
distressing: distressing
distribute: distribute,distributed,distributing
distribution: distribution,distributions
district: district,districts
distrust: distrust,distrusted
disturb: disturb,disturbed,disturbing
disturbance: disturbance,disturbances
disturbed: disturbed
disturber: disturber
ditch: ditch,ditches
dithyrambic: dithyrambic
diver: divers
diverse: diverse
diversify: diversified,diversifies
diversion: diversion,diversions
diversity: diversities,diversity
divert: divert,diverted,diverting
divertisement: divertisement
divi: divi
divide: divide,divided,divides,dividing
divided: divided
divination: divination,divinations
divine: divine,divined
divinely: divinely
diviner: diviner,diviners
divinest: divinest
divinity: divinities,divinity
division: division,divisions
divorce: divorce,divorced
divulge: divulged
dizziness: dizziness
dizzy: dizzied
docile: docile
docility: docility
dock: dock,docks
doctrine: doctrine,doctrines
dodona: dodona
doer: doer,doers
dog: dog,dogging,dogs
dole: dole,doled
dolphin: dolphin
domestic: domestic,domestics
dominant: dominant
domineering: domineering
dominion: dominion,dominions
domitian: domitian
donation: donations
donative: donative
door: door,doors
doorway: doorway
dorian: dorian
doric: doric
doris: doris
dost: dost
dotage: dotage
dote: dote,doted
doth: doth
double: double,doubled
doubt: doubt,doubted,doubting
doubtfully: doubtfully
doubtless: doubtless
dough: dough
dower: dower
downright: downright
downward: downward
dowry: dowries,dowry
drachma: drachma,drachmas
draco: draco
draft: draft
drag: drag,dragged,dragging
dragon: dragon
drain: drain,drained,drains
drama: drama
dramatic: dramatic
draught: draught
draw: draw,drawing,drawn,draws,drew
drawing: drawing
dread: dread,dreaded,dreading
dreadful: dreadful
dream: dream,dreamed,dreaming,dreams,dreamt
dreamer: dreamer
drench: drenched
dress: dress,dressed,dresses,dressing
dressed: dressed
dresser: dressers
drink: drank,drink,drinking
drinkable: drinkable
drinker: drinker
drinking: drinking
drive: drive,driven,driving,drove
driver: driver
drone: drones
droop: drooping
drop: drop,dropped,dropping,drops
drought: drought
droughty: droughty
drown: drowned
drudgery: drudgery
drudging: drudging
drug: drugs
drunk: drunk
drunkard: drunkard
drunken: drunken
drunkenness: drunkenness
dry: dried,dry
dubious: dubious
duck: duck
duel: duel
dull: dull
duly: duly
dungeon: dungeon
duo: duos
durable: durable
durst: durst
dust: dust
dutiful: dutiful
duty: duties,duty
dwell: dwell,dwelling,dwelt
dweller: dwellers
dwelling: dwelling,dwellings
dye: dye,dyed,dyes
dyer: dyers
eager: eager
eagerly: eagerly
eagerness: eagerness
eagle: eagle,eagles
ear: ear,ears
earn: earned
earnest: earnest
earnestly: earnestly
earth: earth
earthborn: earthborn
earthen: earthen
earthenware: earthenware
earthquake: earthquake,earthquakes
ease: ease,eased,easing
easily: easily
easiness: easiness
easing: easing
east: east
eastern: eastern
eastward: eastward
easy: easier,easiest,easy
eat: ate,eat,eating,eats
eater: eater,eaters
eating: eating
eau: eau
ebony: ebony
echo: echo,echoed
eclipse: eclipse,eclipsed,eclipses
economical: economical
economics: economics
economist: economist
economy: economy
edge: edge,edged,edges
edged: edged
edict: edict,edicts
edifice: edifices
educate: educate,educated
educated: educated
education: education
eel: eels
efface: effaced
effective: effective
effectual: effectual
effectually: effectually
effeminacy: effeminacy
effeminate: effeminate
effeminately: effeminately
efficient: efficient
effluvia: effluvia
efflux: effluxes
effort: effort,efforts
effrontery: effrontery
effusion: effusion
egeria: egeria
egg: egg,eggs
egress: egress
egypt: egypt
egyptian: egyptian,egyptians
eighteen: eighteen
eighteenth: eighteenth
eighth: eighth
eiresione: eiresione
ejaculation: ejaculation
eject: ejected
elaborate: elaborate
elate: elate
elated: elated
elation: elation
elbow: elbow
eld: elder,eldest
elder: elder,elders
elderly: elderly
elean: elean
eleatic: eleatic
elect: elect,elected,electing
election: election,elections
elective: elective
elector: electors
electra: electra
elegance: elegance
elegant: elegant
elegantly: elegantly
elegiac: elegiac
elegies: elegies
elegy: elegies,elegy
element: element,elements
elephant: elephant,elephants
eleusinia: eleusinia
eleutheria: eleutheria
elevate: elevate,elevated
elevated: elevated
elevation: elevation
eleventh: eleventh
eligible: eligible
ellipsis: ellipsis
eloquence: eloquence
eloquent: eloquent
eloquently: eloquently
elude: elude
emancipation: emancipation
embark: embark,embarked,embarking
embarkation: embarkation
embarrassment: embarrassment,embarrassments
embassy: embassies,embassy
embattle: embattled
embattled: embattled
embellish: embellish,embellished,embellishing
embellishment: embellishment,embellishments
ember: embers
embittered: embittered
emblem: emblem
embody: embodied
embolden: emboldened
emboss: embossed
embrace: embrace,embraced,embraces,embracing
embroider: embroidered
embroiderer: embroiderers
embroil: embroil,embroiling
emerald: emerald
emergency: emergency
eminence: eminence
eminent: eminent
eminently: eminently
emissary: emissaries
emolument: emolument
emotion: emotion
emperor: emperor
empire: empire
employ: employ,employed,employing,employs
employment: employment,employments
empower: empowered,empowering
emptiness: emptiness
emulate: emulating
emulation: emulation,emulations
enable: enable,enabled,enables
enact: enact,enacted,enacting
enactment: enactment,enactments
enamor: enamored
enamored: enamored
encamp: encamp,encamped,encamping
encamping: encamping
encampment: encampment,encampments
encircle: encircled
enclose: enclose,enclosed,enclosing
enclosure: enclosures
encomium: encomium,encomiums
encompass: encompass,encompassed,encompassing
encounter: encounter,encountered,encountering,encounters
encourage: encourage,encouraged,encouraging
encouraged: encouraged
encouragement: encouragement
encouraging: encouraging
encroach: encroached
encroachment: encroachments
encumber: encumbered
endanger: endanger,endangered,endangering
endangered: endangered
endear: endeared
endearing: endearing
endearment: endearments
endeavor: endeavor,endeavored,endeavoring,endeavors
endless: endless
endow: endowed
endowment: endowment,endowments
endue: endued
endurance: endurance
endure: endure,endured,enduring
endymion: endymion
enemy: enemies,enemy
energetic: energetic
energy: energy
enfeeble: enfeebled
enforce: enforce
enfranchise: enfranchise,enfranchised
engage: engage,engaged,engaging
engaged: engaged
engagement: engagement,engagements
engaging: engaging
engine: engine,engines
engineer: engineer,engineers
engineering: engineering
engrave: engraved
engraven: engraven
engraver: engraver
enhance: enhance
enjoin: enjoined
enjoy: enjoy,enjoyed,enjoying,enjoys
enjoyment: enjoyment,enjoyments
enlarge: enlarge,enlarged,enlarging
enlighten: enlightened
enlist: enlist,enlisted,enlisting
enmity: enmities,enmity
ennoble: ennobled
enormity: enormities
enormous: enormous
enrage: enraged
enraged: enraged
enrich: enrich,enriched,enriching
enriched: enriched
enrol: enrolled
enroll: enroll
ensign: ensign,ensigns
enslave: enslave,enslaved,enslaving
ensnare: ensnare,ensnared
ensue: ensue,ensued,ensues,ensuing
entangle: entangling
enter: enter,entered,entering,enters
enterprise: enterprise,enterprised,enterprises
enterprising: enterprising
entertain: entertain,entertained,entertaining
entertained: entertained
entertaining: entertaining
entertainment: entertainment,entertainments
enthusiasm: enthusiasm
entice: entice,enticed
entire: entire
entitle: entitle,entitled
entitled: entitled
entomb: entombed
entrail: entrails
entrails: entrails
entrance: entrance,entrances
entrap: entrap,entrapped
entreat: entreat,entreated,entreating
entreaty: entreaties,entreaty
entrench: entrenched
entrenchment: entrenchment,entrenchments
entrust: entrust,entrusted,entrusting
entry: entries,entry
enumerate: enumerating
enumeration: enumeration
envied: envied
envier: enviers
envious: envious
enviousness: enviousness
environ: environ,environed
envoy: envoys
envy: envied,envy,envying
ephesians: ephesians
ephetae: ephetae
ephialtes: ephialtes
ephor: ephors
ephori: ephori
ephors: ephors
ephorus: ephorus
epicrates: epicrates
epicure: epicure
epigonus: epigonus
epigram: epigram
epileptic: epileptic
epitaph: epitaph
epithet: epithet
eponymus: eponymus
equal: equal,equaled,equaling,equals
equality: equality
equalization: equalization
equally: equally
equanimity: equanimity
equestrian: equestrian
equilibrium: equilibrium
equinox: equinox
equip: equipped
equipage: equipage
equipped: equipped
equitable: equitable
equity: equity
equivalent: equivalent
era: era
ere: ere
erechtheus: erechtheus
erect: erect,erected,erecting
erelong: erelong
erianthus: erianthus
ericius: ericius
errand: errand,errands
error: error,errors
eryx: eryx
escape: escape,escaped,escaping
escort: escort,escorted,escorting
especial: especial
espouse: espouse,espoused,espousing
espy: espied,espy
esquiline: esquiline
essay: essayed,essays
essential: essential
establish: establish,established,establishing
established: established
establisher: establisher
establishment: establishment
estate: estate,estates
esteem: esteem,esteemed,esteeming
esteemed: esteemed
esteeming: esteeming
estimate: estimate,estimated
estimation: estimation
estrangement: estrangement
eternal: eternal
eternity: eternity
ethereal: ethereal
ethiopian: ethiopians
etruria: etruria
etruscan: etruscan
etruscans: etruscans
eudaemon: eudaemon
euergetes: euergetes
eulogy: eulogy
eumenes: eumenes
eumolpus: eumolpus
eunuch: eunuch,eunuchs
euphrates: euphrates
euripides: euripides
europe: europe
eurytus: eurytus
euterpe: euterpe
euxine: euxine
evaporation: evaporation,evaporations
evasion: evasion
evening: evening
evenness: evenness
event: event,events
eventually: eventually
everlasting: everlasting
evidence: evidence,evidences
evident: evident
evidently: evidently
evil: evil,evils
evolution: evolutions
exact: exact,exacted
exacter: exacter
exaction: exactions
exactness: exactness
exaggerate: exaggerated,exaggerating
exaggerated: exaggerated
exaggeration: exaggeration
exalt: exalted
examination: examination
examine: examine,examined,examining
exasperate: exasperate,exasperated,exasperating
exasperated: exasperated
exceed: exceed,exceeded,exceeding,exceeds
exceedingly: exceedingly
excel: excel,excelled,excelling,excels
excellence: excellence,excellences
excellent: excellent
excellently: excellently
exception: exception,exceptions
excess: excess,excesses
excessive: excessive
exchange: exchange,exchanged,exchanges
exchequer: exchequer
excitable: excitable
excite: excite,excited
excited: excited
excitement: excitement
exciting: exciting
exclaim: exclaim,exclaimed,exclaiming,exclaims
exclamation: exclamation,exclamations
exclude: exclude,excluded,excluding
exclusion: exclusion
exculpation: exculpation
excursion: excursions
excuse: excuse,excused,excuses,excusing
execrable: execrable
execration: execrations
execute: execute,executed,executing
execution: execution,executions
executioner: executioner
exempt: exempt,exempted
exemption: exemption
exercise: exercise,exercised,exercises,exercising
exert: exert,exerted,exerting
exertion: exertions
exhaust: exhaust,exhausted
exhausted: exhausted
exhibit: exhibited
exhibition: exhibitions
exhibitor: exhibitors
exhort: exhort,exhorted,exhorting
exhortation: exhortations
exigence: exigence
exigency: exigency
exile: exile,exiled,exiles
exist: exist,existed,existing,exists
existence: existence
exit: exit
exonerate: exonerate
exorbitant: exorbitant
expect: expect,expected,expecting,expects
expectation: expectation,expectations
expediency: expediency
expedient: expedient,expedients
expedite: expedite
expedition: expedition,expeditions
expeditiously: expeditiously
expel: expel,expelled,expelling
expend: expended,expending
expenditure: expenditure
expense: expense,expenses
expensive: expensive
expensively: expensively
expensiveness: expensiveness
experience: experience,experienced
experienced: experienced
experiment: experiment
experimentally: experimentally
expert: expert
expiate: expiated
expiation: expiation
expiatory: expiatory
expiration: expiration
expire: expire,expired,expiring
explain: explain,explained
explanation: explanation,explanations
exploit: exploit,exploits
export: export,exported
exportation: exportation
expose: expose,exposed,exposing
expostulate: expostulate,expostulating
expostulation: expostulation
exposure: exposure
express: express,expressed,expresses,expressing
expression: expression,expressions
expressive: expressive
expressly: expressly
expulsion: expulsion
exquisite: exquisite
exquisitely: exquisitely
extant: extant
extempore: extempore
extend: extend,extended,extending
extended: extended
extension: extension
extensive: extensive
extent: extent
extenuate: extenuate,extenuating
exterior: exterior
external: external
extinct: extinct
extinction: extinction
extinguish: extinguish,extinguished
extirpate: extirpate,extirpated
extirpation: extirpation
extol: extol,extolled,extolling
extort: extort,extorted
extortion: extortion
extra: extra
extraction: extraction
extraordinarily: extraordinarily
extraordinary: extraordinary
extravagance: extravagance
extravagant: extravagant
extravagantly: extravagantly
extreme: extreme,extremes,extremest
extremely: extremely
extremity: extremities,extremity
extricate: extricate
exuberant: exuberant
exult: exulting
exultation: exultation
eye: eye,eyes
eyed: eyed
eyewitness: eyewitness
fable: fable,fables
fabric: fabric
fabulous: fabulous
facetious: facetious
facility: facility
faction: faction,factions
factious: factious
faculty: faculties,faculty
fagot: fagots
fail: fail,failed,failing,fails
failing: failings
failure: failure
fain: fain
faint: faint,fainted,fainting
faintheart: fainthearted
fainthearted: fainthearted
fair: fair,fairer,fairest
faith: faith
faithful: faithful
faithfully: faithfully
faithless: faithless
falchion: falchions
fall: fall,fallen,falling,falls,fell
fallacious: fallacious
fallow: fallow,fallows
false: false
falsehood: falsehood
falsely: falsely
falsity: falsity
falter: falter,faltering
fame: fame,faming
famed: famed
familiar: familiar,familiars
familiarity: familiarity
familiarly: familiarly
family: families,family
famine: famine
famous: famous
fancied: fancied
fanciful: fanciful
fancy: fancied,fancies,fancy,fancying
fane: fane
fannia: fannia
fare: fare,fared
farewell: farewell
farm: farm,farming,farms
farmer: farmers
farth: farthest
farthing: farthing
fashion: fashion,fashioned,fashions
fast: fast,faster
fasten: fasten,fastened,fastening
fastening: fastening,fastenings
fasting: fasting
fat: fat,fattest
fatal: fatal
fatality: fatality
fate: fate,fates
father: father,fathers
fatherly: fatherly
fathom: fathom
fatigue: fatigue
fatness: fatness
fatten: fatten,fattened,fattening
fault: fault,faults
faulty: faulty
faunus: faunus
favor: favor,favored,favoring,favors
favorable: favorable
favorer: favorer,favorers
favorite: favorite,favorites
fawn: fawn,fawning,fawns
fear: fear,feared,fearing,fears
fearful: fearful
fearless: fearless
feast: feast,feasted,feasts
feasting: feasting
feat: feat,feats
feather: feathers
february: february
fecial: fecials
fee: fee,fees
feeble: feeble
feebleness: feebleness
feebly: feebly
feed: fed,feed,feeding
feeder: feeders
feeding: feeding
feel: feel,feeling
feeling: feeling,feelings
feign: feign,feigned,feigning,feigns
feint: feints
felicitation: felicitations
felicity: felicities,felicity
felix: felix
fell: felled
fellow: fellow,fellows
fellowship: fellowship
female: female
fen: fens
fence: fence,fences
fenestella: fenestella
feretrum: feretrum
ferry: ferry,ferrying
fertile: fertile
festival: festival,festivals
festive: festive
festivity: festivities
fetch: fetch,fetched
fetter: fetters
feud: feud,feuds
fever: fever
feverfew: feverfew
fewness: fewness
fiction: fiction,fictions
fictitious: fictitious
fidelity: fidelity
field: field,fields
fierce: fierce,fiercer,fiercest
fiercely: fiercely
fierceness: fierceness
fiery: fiery
fifteenth: fifteenth
fiftieth: fiftieth
fig: fig,figs
fight: fight,fighting,fights,fought
fighter: fighters
fighting: fighting
figurative: figurative
figure: figure,figures
file: files
fillet: fillet,fillets
filthy: filthy
fimbria: fimbria
final: final
finally: finally
fine: fine,fined,finer,fines,finest
finely: finely
finger: finger,fingers
finish: finish,finished,finishing
finished: finished
fir: fir
firebrand: firebrands
firm: firm,firmer
firmans: firmans
firmly: firmly
firmness: firmness
fish: fish,fishes
fisher: fisher,fishers
fisherman: fishermen
fishing: fishing
fist: fist
fit: fit,fits,fitted,fitter,fittest,fitting
fitly: fitly
fitting: fitting
flag: flag
flagon: flagon
flagrant: flagrant
flagrantly: flagrantly
flail: flail
flame: flame,flames,flaming
flamen: flamen
flamens: flamens
flamines: flamines
flaming: flaming
flaminian: flaminian
flank: flank,flanks
flashing: flashing
flat: flat,flatter
flatter: flattered
flatterer: flatterers
flattering: flattering
flattery: flatteries,flattery
flavius: flavius
flax: flax
flaying: flaying
flee: fled,flee
fleet: fleet,fleets
flesh: flesh
flexible: flexible
flier: fliers
flight: flight,flights
flinch: flinch,flinching
fling: fling,flinging,flung
flit: flit
float: floated
flock: flock,flocked,flocking,flocks
flood: flood
floor: floor
flour: flour
flourish: flourish,flourished,flourishing
flourishing: flourishing
flow: flow,flowed,flowing,flows
flower: flower,flowers
flowery: flowery
fluctuation: fluctuation
fluid: fluid
flush: flushed
flute: flute,flutes
flux: flux
fly: flew,flies,flown,fly,flying
flyer: flyers
flying: flying
foal: foal,foals
foam: foam,foaming
fodder: fodder
foe: foe,foes
fog: fog
foggy: foggy
foil: foil,foiled,foils
fold: folded,folding,folds
folding: folding
folk: folks
follow: follow
follower: follower,followers
folly: follies,folly
foment: fomented
fomenter: fomenter
fond: fond
fondness: fondness
food: food
fool: fool,fools
foolery: foolery
foolhardiness: foolhardiness
foolish: foolish
foot: feet,foot,footing
footboy: footboys
footed: footed
footing: footing
footman: footmen
forage: forage,foraging
forbear: forbear,forbore,forborne
forbearance: forbearance
forbid: forbade,forbid,forbidden,forbidding,forbids
forbidding: forbidding
forbore: forbore
forborne: forborne
force: force,forced,forces,forcing
forcible: forcible
forcibly: forcibly
ford: ford,forded
fordable: fordable
fording: fording
fore: fore
forebode: foreboded
foreboding: forebodings
forecast: forecast
foredeck: foredeck
forefather: forefathers
forego: foregoing
forehead: forehead,foreheads
foreign: foreign
foreigner: foreigner,foreigners
foreknow: foreknow,foreknown
foremost: foremost
forepart: forepart
forerunner: forerunners
foresee: foresaw,foresee,foreseeing,foreseen
foreshow: foreshown
foresight: foresight
forest: forest,forests
foretaste: foretaste
foretell: foretell,foretelling,foretold
forethought: forethought
forevermore: forevermore
forewarn: forewarn,forewarned
forfeit: forfeit,forfeited,forfeiting
forge: forged
forget: forget,forgetting,forgot,forgotten
forgetfulness: forgetfulness
forgive: forgave,forgive,forgiven
forlorn: forlorn
form: form,formed,forming,forms
formal: formal
formality: formality
formally: formally
formation: formation
formidable: formidable
forsake: forsake,forsaken,forsook
forsooth: forsooth
fort: fort,forts
forthwith: forthwith
fortification: fortifications
fortified: fortified
fortify: fortified,fortify,fortifying
fortitude: fortitude
fortress: fortress,fortresses
fortunate: fortunate
fortunately: fortunately
fortune: fortune,fortunes
forum: forum
forwardness: forwardness
fossa: fossa
foster: foster,fostering
foul: foul
foulness: foulness
foundation: foundation,foundations
founder: founder,foundering,founders
founding: founding
fountain: fountain,fountains
fourscore: fourscore
fourteen: fourteen
fourth: fourth
fowl: fowl
fox: fox,foxes
fraction: fraction
fragment: fragments
frailty: frailty
frame: frame,framed,frames
franchise: franchise,franchises
frank: frank
frankincense: frankincense
frankly: frankly
frankness: frankness
frantic: frantic
fraternities: fraternities
fraternity: fraternity
fraud: fraud
fray: fray
freak: freaks
freeborn: freeborn
freedman: freedman,freedmen
freedmen: freedmen
freedom: freedom
freely: freely
freeman: freeman,freemen
freewill: freewill
freeze: frozen
freight: freight,freighted
frenzy: frenzies,frenzy
frequency: frequency
frequent: frequent,frequented
frequently: frequently
fresh: fresh
freshness: freshness
fret: fretted,fretting
friend: friend,friends
friendly: friendly
friendship: friendship,friendships
frieze: frieze
fright: fright,frighted,frights
frighted: frighted
frighten: frighten,frightened
frightful: frightful
frightfulness: frightfulness
fringe: fringe
fringed: fringed
frivolous: frivolous
fro: fro
frock: frock,frocks
frolic: frolic
frontier: frontier,frontiers
frost: frost
frozen: frozen
frugal: frugal
frugality: frugality
fruit: fruit,fruits
fruitful: fruitful
frustrate: frustrated
frustrated: frustrated
fuel: fuel
fugitive: fugitive,fugitives
fulfil: fulfilled
fulfill: fulfill
fulfillment: fulfillment
fullness: fullness
function: functions
fund: fund
fundamental: fundamentals
funeral: funeral,funerals
furca: furca
furies: furies
furious: furious
furiously: furiously
furlong: furlongs
furnace: furnace
furnish: furnish,furnished
furnished: furnished
furnishing: furnishing
furniture: furniture
furrow: furrow
fury: fury
future: future
gaily: gaily
gain: gain,gained,gaining,gains
gait: gait
galatian: galatian
galatians: galatians
gale: gale
gall: galled
gallant: gallant
gallantly: gallantly
gallantry: gallantry
gallery: galleries,gallery
galley: galley,galleys
gallic: gallic
gallon: gallons
gallop: galloping
gally: gallies
game: game,games
games: games
garb: garb
garden: garden,gardens
gardener: gardeners
garland: garland,garlanded,garlands
garment: garment,garments
garrison: garrison,garrisoned,garrisons
gash: gash,gashes
gate: gate,gates
gates: gates
gather: gather,gathered,gathering
gathering: gathering,gatherings
gaudiness: gaudiness
gaul: gaul,gauls
gaulish: gaulish
gauls: gauls
gay: gay
gaze: gazed
genealogy: genealogies,genealogy
generalissimo: generalissimo
generalship: generalship
generate: generated
generation: generation,generations
generosity: generosity
generous: generous
generously: generously
genius: genius
gentle: gentle,gentler,gentlest
gentleness: gentleness
gently: gently
genuine: genuine
geographer: geographer,geographers
geometrical: geometrical
geometrician: geometricians
geometry: geometry
german: german,germans
germany: germany
gesticulation: gesticulations
gesture: gesture,gestures
ghastly: ghastly
ghost: ghost
giant: giant,giants
giddy: giddy
gift: gift,gifts
gifted: gifted
gigantic: gigantic
gild: gild,gilding
gilded: gilded
gilt: gilt
gird: girding
girdle: girdle,girdles
girl: girl,girls
girt: girt
girth: girths
giver: givers
glad: glad
gladiator: gladiators
gladly: gladly
gladness: gladness
glance: glance,glances
glaring: glaring
glass: glass
gleam: gleaming
glistening: glistening
glitter: glittering
globe: globe
gloom: gloom
gloominess: gloominess
glorify: glorified,glorifying
glorious: glorious
gloriously: gloriously
glory: gloried,glories,glory
glow: glowing
gnash: gnash
gnaw: gnawed
goal: goal
goat: goat,goats
goblet: goblet,goblets
god: god,gods
goddess: goddess,goddesses
godhead: godhead
godlike: godlike
gods: gods
gold: gold
golden: golden
goldsmith: goldsmiths
goodliness: goodliness
goodly: goodliest
goodness: goodness
goose: geese
gordius: gordius
gore: gore
gorge: gorging
gorgeous: gorgeous
gout: gout
gouty: gouty
govern: govern,governed,governing,governs
governable: governable
governance: governance
government: government,governments
governor: governor,governors
gown: gown,gowns
grace: grace,graced,graces
graceful: graceful
gracefully: gracefully
gracefulness: gracefulness
graces: graces
gracious: gracious
graciously: graciously
gradual: gradual
gradually: gradually
grain: grain
grammar: grammar
grammarian: grammarian
granary: granaries
grand: grand
grandchild: grandchild,grandchildren
granddaughter: granddaughter
grandeur: grandeur
grandfather: grandfather
grandson: grandson
grant: grant,granted,granting,grants
grape: grapes
grapple: grapple,grappling
grasp: grasped,grasping
grass: grass
grasshopper: grasshopper
grateful: grateful
gratefully: gratefully
gratification: gratification,gratifications
gratified: gratified
gratify: gratified,gratify,gratifying
gratifying: gratifying
gratitude: gratitude
gratuity: gratuities
grave: grave,graven,graves,graving
gravely: gravely
gravity: gravity
gray: gray
graze: graze,grazed,grazing
grazier: graziers
grazing: grazing
grease: grease
greatly: greatly
greatness: greatness
greave: greaves
grecian: grecian,grecians
greece: greece
greedily: greedily
greediness: greediness
greedy: greedy
greek: greek,greeks
green: green
greenness: greenness
greet: greet,greeting
greeting: greeting
grief: grief
grievance: grievance,grievances
grieve: grieve,grieved
grievous: grievous
grievously: grievously
grim: grim
grind: ground
groan: groan,groaned,groaning,groans
groin: groin
groom: groom,grooms
gross: gross
grossly: grossly
ground: ground,grounded
groundless: groundless
grounds: grounds
groundwork: groundwork
grove: grove,groves
grow: grew,grow,growing,grown,grows
grown: grown
growth: growth
grudge: grudge,grudged,grudges,grudging
grumble: grumbling
guard: guard,guarded,guarding,guards
guardian: guardian,guardians
guess: guess,guessed,guessing
guesswork: guesswork
guest: guest,guests
guidance: guidance
guide: guide,guided,guides,guiding
guild: guilds
guile: guile
guilt: guilt
guilty: guilty
gulf: gulf
gush: gush
gymnasiarch: gymnasiarch
gymnasium: gymnasium
gymnastic: gymnastic
habit: habit,habited,habits
habitable: habitable
habitation: habitation,habitations
habitual: habitual
habituate: habituate,habituating
hack: hack
hacking: hacking
hail: hail
hair: hair,hairs
halfpenny: halfpenny
halicarnassian: halicarnassian
hall: hall,halls
halloo: halloo
hallowed: hallowed
halt: halt,halted,halting
halter: halter,halters
halting: halting
hand: hand,handed,hands
handed: handed
handful: handful,handfuls
handicraftsman: handicraftsmen
handle: handle,handled
handling: handling
handmaid: handmaid
handsome: handsome
handsomely: handsomely
handy: handiest
hang: hang,hanged,hanging,hung
hanger: hangers
hanging: hanging,hangings
hannibal: hannibal
hap: hap,haps
happen: happen,happened,happening
happily: happily
happiness: happiness
happy: happier,happiest,happy
harangue: harangue,harangued,harangues,haranguing
harass: harass,harassed
harbor: harbor,harbored,harbors
hard: hard,harder,hardest
harden: harden,hardened
hardiness: hardiness
hardship: hardship,hardships
hardy: hardier,hardy
hare: hare
hares: hares
harlot: harlot,harlots
harm: harm
harmless: harmless
harmony: harmony
harness: harnessed
harp: harp,harps
harpalus: harpalus
harpy: harpies
harsh: harsh
harshly: harshly
harshness: harshness
harvest: harvest
harvests: harvests
hast: hast,hasted
haste: haste
hasten: hasten,hastened,hastening
hastily: hastily
hastiness: hastiness
hasting: hasting
hasty: hasty
hat: hat,hats
hatch: hatched,hatches
hatchet: hatchets
hate: hate,hated,hating
hateful: hateful
hater: hater
hatred: hatred,hatreds
haughtily: haughtily
haughtiness: haughtiness
haughty: haughtier,haughty
haul: haul,hauling
haunt: haunted
havoc: havoc
hawk: hawks
hazard: hazard,hazarded,hazarding,hazards
hazarding: hazarding
hazardous: hazardous
head: head,headed,heads
headband: headband
headland: headland
headless: headless
headlong: headlong
headpiece: headpiece,headpieces
headsman: headsman
heal: heal,healed
health: health
healthful: healthful
healthy: healthy
heap: heap,heaped,heaping,heaps
hear: hear,heard,hearing,hears
hearer: hearer,hearers
hearing: hearing
hearken: hearkened
heart: heart,hearts
hearted: hearted
hearten: heartened
hearth: hearth
heat: heat,heated,heats
heated: heated
heaven: heaven,heavens
heavenly: heavenly
heavens: heavens
heavily: heavily
heavy: heavier,heaviest,heavy
hecate: hecate
hecatomb: hecatomb
hecatombaeon: hecatombaeon
hecatompedon: hecatompedon
hector: hector
hecuba: hecuba
hedge: hedged,hedges
heed: heed
heedless: heedless
heedlessly: heedlessly
heel: heels
heifer: heifer,heifers
height: height,heights
heighten: heighten,heightened,heightening,heightens
heinous: heinous
heir: heir,heirs
heiress: heiress,heiresses
helen: helen
helenus: helenus
helicon: helicon
hellespont: hellespont
helm: helm
helmet: helmet,helmets
helot: helots
helots: helots
helper: helpers
helpless: helpless
helplessness: helplessness
hem: hem,hemmed
henceforth: henceforth
henceforward: henceforward
heraclidae: heraclidae
herald: herald,heralds
herb: herb,herbs
herbage: herbage
hercules: hercules
hercynian: hercynian
herd: herd,herds
herdsman: herdsmen
hereabouts: hereabouts
hereat: hereat
hereditary: hereditary
heretofore: heretofore
heritage: heritage
hermae: hermae
hermes: hermes
hermione: hermione
hero: hero,heroes
heroic: heroic
hesitate: hesitate,hesitated,hesitating
hesitation: hesitation
hew: hewing
hidden: hidden
hide: hide,hiding
hideous: hideous
hierophant: hierophant
highly: highly
highway: highways
hilarity: hilarity
hill: hill,hills
hilliness: hilliness
hilly: hilly
hilt: hilt
himation: himation
hind: hinds
hinder: hinder,hindered,hindering,hinders
hindmost: hindmost
hindrance: hindrance
hinge: hinges
hint: hint,hints
hip: hip
hippo: hippo
hippocrates: hippocrates
hippodamia: hippodamia
hippolytus: hippolytus
hire: hire,hired,hiring
historian: historian,historians
historical: historical
history: histories,history
hit: hit
hitherto: hitherto
hive: hive
hoar: hoar
hoard: hoarded
hoc: hoc
hog: hog,hogs
hogshead: hogshead
hoist: hoisted
hoisting: hoisting
hold: held,hold,holding,holds
hole: holes
holiday: holiday,holidays
holily: holily
hollow: hollow,hollows
holy: holy
homage: homage
homely: homely
homer: homer
homeward: homeward
homicide: homicide
honest: honest
honestest: honestest
honestly: honestly
honesty: honesty
honey: honey
honor: honor,honored,honoring,honors
honorable: honorable
honorably: honorably
honored: honored
hope: hope,hoped,hopes,hoping
hopeful: hopeful
hopeless: hopeless
hoplite: hoplites
hoplites: hoplites
horace: horace
horatius: horatius
horn: horn,horns
horns: horns
horrible: horrible
horrid: horrid
horror: horror
horse: horse,horses
horseback: horseback
horseman: horseman,horsemen
horsemanship: horsemanship
hospitable: hospitable
hospitably: hospitably
hospitality: hospitalities,hospitality
host: host,hosts
hostage: hostage,hostages
hostess: hostess
hostile: hostile
hostility: hostilities,hostility
hot: hot,hottest
hotly: hotly
hound: hounds
hour: hour,hours
house: house,houses
household: household,households
housekeeping: housekeeping
housewifery: housewifery
hovel: hovels
hover: hover,hovered,hovering
howl: howling
huddle: huddled
huge: huge
human: human
humane: humane
humanely: humanely
humanity: humanity
humanize: humanizing
humble: humble,humbled,humbling
humbly: humbly
humid: humid
humiliate: humiliate,humiliated,humiliating
humiliation: humiliation
humility: humility
humor: humor,humored,humoring,humors
humored: humored
hunger: hunger
hungry: hungry
hunt: hunted,hunting
hunter: hunter,hunters
hunting: hunting
huntsman: huntsman,huntsmen
hurried: hurried
hurry: hurried,hurry,hurrying
hurt: hurt,hurts
hurtful: hurtful
husband: husband,husbanded,husbands
husbandman: husbandman,husbandmen
husbandmen: husbandmen
husbandry: husbandry
hustings: hustings
hut: hut
huzza: huzza
hyacinthian: hyacinthian
hyacinthus: hyacinthus
hydra: hydra
hyle: hyle
hyllus: hyllus
hymenaeus: hymenaeus
hymn: hymn,hymns
hyperbole: hyperboles
hyrcanian: hyrcanian
iacchus: iacchus
iberians: iberians
ibycus: ibycus
ice: ice
ida: ida
idea: idea,ideas
identical: identical
identity: identity
ides: ides
idiom: idiom
idle: idle,idling
idleness: idleness
idly: idly
idomeneus: idomeneus
ignite: igniting
ignoble: ignoble
ignobly: ignobly
ignominious: ignominious
ignominiously: ignominiously
ignominy: ignominy
ignorance: ignorance
ignorant: ignorant
ilia: ilia
ilium: ilium
illegal: illegal
illegally: illegally
illegitimate: illegitimate
illiterate: illiterate
illumine: illumined
illustrate: illustrate,illustrating
illustration: illustration
illustrious: illustrious
illyrian: illyrian
image: image,images
imaginable: imaginable
imagination: imagination,imaginations
imaginative: imaginative
imagine: imagine,imagined,imagines,imagining
imbecility: imbecility
imbue: imbued
imitate: imitate,imitated,imitating
imitation: imitation
imitative: imitative
imitator: imitator
immature: immature
immeasurably: immeasurably
immense: immense
imminent: imminent
immoderate: immoderate
immoderately: immoderately
immodest: immodest
immodesty: immodesty
immolate: immolate,immolated,immolating
immolation: immolation
immortal: immortal
immortality: immortality
immovable: immovable
immunity: immunities
immutable: immutable
impair: impair,impaired
impart: impart,imparted
impartial: impartial
impassable: impassable
impatience: impatience
impatient: impatient
impatiently: impatiently
impeach: impeach,impeached,impeaching
impeachment: impeachment
impede: impede,impeded
impediment: impediment
impel: impelled
imperator: imperator
imperfect: imperfect
imperfection: imperfection
imperious: imperious
imperiousness: imperiousness
impetuosity: impetuosity
impetuous: impetuous
impetus: impetus
impiety: impiety
impious: impious
implacable: implacable
implant: implanted
implement: implement,implements
implicate: implicated
implore: implore,imploring
imply: implied,implies,implying
import: import,importing,imports
importunate: importunate
importune: importuning
importunity: importunities,importunity
impose: impose,imposed,imposing
imposing: imposing
imposition: impositions
impossibility: impossibilities,impossibility
impossible: impossible
imposthume: imposthume
impostor: impostor
imposture: imposture
impoverish: impoverished
impoverished: impoverished
impoverisher: impoverisher
impracticable: impracticable
imprecate: imprecate
imprecation: imprecations
impregnable: impregnable
impress: impress,impressed
impression: impression,impressions
impressive: impressive
imprint: imprinted
imprison: imprison,imprisoned
imprisonment: imprisonment
improbability: improbabilities
improve: improve,improved,improving
improvement: improvement
imprudence: imprudence
impudence: impudence
impudent: impudent
impulse: impulse,impulses
impunity: impunity
impurity: impurity
imputable: imputable
imputation: imputation,imputations
impute: impute
imputed: imputed
inaccessible: inaccessible
inaction: inaction
inactive: inactive
inadequate: inadequate
inadvertency: inadvertencies,inadvertency
inadvertently: inadvertently
inanimate: inanimate
inaptly: inaptly
inarticulate: inarticulate
inartificial: inartificial
inattentive: inattentive
inauspicious: inauspicious
inauspiciously: inauspiciously
inbred: inbred
incapable: incapable
incense: incense,incensed
incensed: incensed
incentive: incentives
incessant: incessant
incessantly: incessantly
incident: incident,incidents
incite: incite,incited,inciting
incitement: incitement,incitements
inclinable: inclinable
inclination: inclination,inclinations
incline: incline,inclined,inclines,inclining
inclined: inclined
include: include,included,including
income: income
incommode: incommoded
incommodious: incommodious
incomparable: incomparable
incomparably: incomparably
incompatibility: incompatibility
incompetent: incompetent
inconclusive: inconclusive
incongruity: incongruity
incongruous: incongruous
inconsiderable: inconsiderable
inconsiderate: inconsiderate
inconsiderately: inconsiderately
inconsistency: inconsistencies,inconsistency
inconsistent: inconsistent
inconstancy: inconstancy
inconstant: inconstant
incontinent: incontinent
inconvenience: inconvenience
inconvenient: inconvenient
incorporate: incorporate,incorporated
incorrupt: incorrupt
incorruptible: incorruptible
increase: increase,increased,increasing
incredible: incredible
incredulity: incredulity
inculcate: inculcate,inculcated
incur: incur,incurred,incurring
incurable: incurable
incursion: incursion,incursions
indebt: indebted
indebted: indebted
indecently: indecently
indecorum: indecorum
indefatigable: indefatigable
indemnity: indemnity
independence: independence
independent: independent
indian: indians
indication: indication,indications
indict: indicted,indicting
indictment: indictment,indictments
indies: indies
indifference: indifference
indifferent: indifferent
indigence: indigence
indigent: indigent
indignant: indignant
indignantly: indignantly
indignation: indignation
indignity: indignities,indignity
indiscreet: indiscreet
indispensable: indispensable
indispose: indispose,indisposed
indisposition: indisposition
indissoluble: indissoluble
individual: individual,individuals
individually: individually
indolence: indolence
indolent: indolent
induce: induce,induced,inducing
inducement: inducement,inducements
indulge: indulge,indulged,indulging
indulgence: indulgence,indulgences
indulgent: indulgent
industrious: industrious
industry: industry
ineffectual: ineffectual
inefficient: inefficient
inequality: inequality
inexcusable: inexcusable
inexorable: inexorable
inexorableness: inexorableness
inexpediency: inexpediency
inexperience: inexperience
inexperienced: inexperienced
infamous: infamous
infancy: infancy
infant: infant,infants
infantry: infantry
infect: infected,infecting
infection: infection
infelicity: infelicity
inferior: inferior,inferiors
infernal: infernal
infest: infested
infinite: infinite
infinitely: infinitely
infirm: infirm
infirmity: infirmity
inflame: inflamed,inflames,inflaming
inflamed: inflamed
inflammation: inflammation
inflexible: inflexible
inflict: inflict,inflicted,inflicting
infliction: inflictions
influence: influence,influenced,influences
influential: influential
influx: influx
inform: inform,informed,informing
informer: informer,informers
infrequency: infrequency
infrequent: infrequent
infuse: infused
ingenious: ingenious
ingeniously: ingeniously
ingenuity: ingenuity
ingenuous: ingenuous
ingenuousness: ingenuousness
inglorious: inglorious
ingloriously: ingloriously
ingrained: ingrained
ingratiate: ingratiate,ingratiated,ingratiates
ingratiating: ingratiating
ingratitude: ingratitude
ingredient: ingredient
ingress: ingress
inhabit: inhabit,inhabited,inhabiting
inhabitant: inhabitants
inhalation: inhalation
inherit: inherit,inherited
inheritance: inheritance,inheritances
inhospitable: inhospitable
inhuman: inhuman
inhumanity: inhumanity
inimitable: inimitable
iniquitous: iniquitous
iniquity: iniquity
initial: initial
initiate: initiated,initiates
initiates: initiates
initiation: initiation
initiators: initiators
injunction: injunction,injunctions
injure: injure,injured,injures,injuring
injured: injured
injuriously: injuriously
injury: injuries,injury
injustice: injustice,injustices
ink: ink
inland: inland
innate: innate
innocence: innocence
innocent: innocent
innocently: innocently
innovation: innovation,innovations
innovator: innovators
innumerable: innumerable
ino: ino
inordinate: inordinate
inquire: inquire,inquired,inquiring
inquirer: inquirer
inquiry: inquiries,inquiry
inquisition: inquisition
inroad: inroad,inroads
insane: insane
insatiable: insatiable
insatiably: insatiably
inscribe: inscribed,inscribing
inscription: inscription,inscriptions
insensibility: insensibility
insensible: insensible
insensibly: insensibly
insert: inserted
insignificant: insignificant
insinuate: insinuate,insinuating
insist: insist,insisted,insisting
insolence: insolence
insolent: insolent
insolently: insolently
insolvent: insolvent
insomuch: insomuch
inspect: inspect,inspected
inspection: inspection
inspector: inspectors
inspiration: inspiration
inspire: inspire,inspired,inspires,inspiring
inspirit: inspirited
instability: instability
install: installed
instance: instance,instanced,instances
instant: instant
instantly: instantly
instigate: instigated
instigation: instigation
instigator: instigator
instill: instill
instinct: instinct
institute: instituted,institutes,instituting
institution: institution,institutions
instruct: instruct,instructed,instructing
instruction: instruction,instructions
instructor: instructor,instructors
instrument: instrument,instruments
instrumental: instrumental
instrumentality: instrumentality
insufferable: insufferable
insufficiency: insufficiency
insufficient: insufficient
insult: insult,insulted,insulting,insults
insulting: insulting
insultingly: insultingly
insupportable: insupportable
insupportableness: insupportableness
insupportably: insupportably
insure: insure,insuring
insurgent: insurgents
insurrection: insurrection,insurrections
integrity: integrity
intellect: intellect,intellects
intellectual: intellectual
intelligence: intelligence
intelligent: intelligent
intelligible: intelligible
intemperance: intemperance
intemperate: intemperate
intemperately: intemperately
intend: intend,intended,intending
intended: intended
intense: intense
intent: intent
intention: intention,intentions
inter: inter,interred
intercalary: intercalary
intercede: intercede,interceded
intercept: intercepted,intercepting,intercepts
intercession: intercession
intercessor: intercessor,intercessors
interchange: interchange,interchanging
interchangeably: interchangeably
intercourse: intercourse
interdependence: interdependence
interdict: interdict
interfere: interfere,interfered,interferes,interfering
interim: interim
interior: interior
interjacent: interjacent
interlude: interludes
intermarriage: intermarriage
intermeddle: intermeddle,intermeddling
intermeddler: intermeddler
interment: interment
intermingle: intermingle,intermingled,intermingling
intermission: intermission
intermit: intermitted
intermix: intermixed
intermixture: intermixture
internal: internal
interpose: interpose,interposed,interposing
interposition: interposition
interpret: interpret,interpreted,interpreting
interpretation: interpretation
interpreter: interpreter,interpreters
interregnum: interregnum
interrex: interrex
interrogate: interrogated
interrupt: interrupt,interrupted,interrupting
interstice: interstices
interval: interval,intervals
intervene: intervening
intervention: intervention
interview: interview,interviews
interweave: interweaving,interwoven
interwoven: interwoven
intestine: intestine
intimacy: intimacy
intimate: intimate,intimated,intimating
intimation: intimation,intimations
intimidate: intimidate,intimidated
intolerable: intolerable
intractable: intractable
intrepid: intrepid
intricate: intricate
intrigue: intrigue
intriguing: intriguing
introduce: introduce,introduced,introduces,introducing
introduction: introduction
intrude: intrude
inundation: inundation
inure: inured,inuring
invade: invade,invaded,invading
invader: invader,invaders
invalidate: invalidate
invasion: invasion,invasions
invective: invective,invectives
inveigh: inveighed,inveighing,inveighs
inveigle: inveigled,inveigling
invent: invent,invented,inventing,invents
inventor: inventors
inventory: inventory
invest: invested,investing
investigate: investigate
investigation: investigation
inveterate: inveterate
invidious: invidious
invidiously: invidiously
invincible: invincible
inviolable: inviolable
inviolably: inviolably
invisible: invisible
invitation: invitation,invitations
invite: invite,invited,invites,inviting
invoke: invoke,invoked,invoking
involuntary: involuntary
involve: involve,involved,involving
involved: involved
inwardly: inwardly
inwards: inwards
ion: ion
ionian: ionian
iou: iou
iron: iron,ironed
irrational: irrational
irreconcilable: irreconcilable
irreconcilably: irreconcilably
irrecoverably: irrecoverably
irregular: irregular
irregularity: irregularities,irregularity
irreligiously: irreligiously
irreparable: irreparable
irresistible: irresistible
irrespectively: irrespectively
irresponsible: irresponsible
irreverence: irreverence
irritate: irritating
irritated: irritated
irruption: irruption
island: island,islands
islander: islanders
islands: islands
isle: isle,isles
issue: issue,issued,issuing
isthmian: isthmian
isthmus: isthmus
italian: italian,italians
italy: italy
item: item
itinerant: itinerant
ivory: ivory
ivy: ivy
jacket: jacket
jaded: jaded
jail: jail
janiculum: janiculum
january: january
janus: janus
jar: jars
jason: jason
javelin: javelin,javelins
jaw: jaws
jealous: jealous
jealousy: jealousies,jealousy
jeer: jeered
jeeringly: jeeringly
jest: jest,jested,jesting,jests
jester: jesters
jesting: jesting
jestingly: jestingly
jewel: jewels
jeweler: jeweler
joint: joint
jointly: jointly
joke: joke,jokes
journey: journey,journeys
journeyman: journeymen
jove: jove
joy: joy,joys
joyful: joyful
joyfully: joyfully
juba: juba
judge: judge,judged,judges,judging
judging: judging
judgment: judgment,judgments
judicature: judicature
judicial: judicial
judicially: judicially
judicious: judicious
juggler: juggler,jugglers
juicy: juicy
julia: julia
julius: julius
july: july
jump: jumped
jumping: jumping
juncture: juncture
june: june
junior: junior
junius: junius
juno: juno
jupiter: jupiter
jurisdiction: jurisdiction
juror: jurors
jury: juries
juster: juster
justest: justest
justice: justice
justifiable: justifiable
justifiably: justifiably
justified: justified
justify: justify,justifying
justly: justly
jut: jutted,jutting
keen: keen,keenest
keenly: keenly
keeper: keeper,keepers
keeping: keeping
key: key
kick: kick
kill: kill,killed,killing,kills
killing: killing
kin: kin
kindle: kindle,kindled,kindles,kindling
kindliness: kindliness
kindly: kindly
kindness: kindness,kindnesses
kindred: kindred
king: king,kings
kingdom: kingdom,kingdoms
kingly: kingly
kingship: kingship
kinsman: kinsman,kinsmen
kiss: kissed,kisses,kissing
knave: knaves
knavery: knavery
knead: knead
knee: knee,knees
knife: knife
knight: knights
knit: knit
knock: knock,knocked,knocking,knocks
knowledge: knowledge
labor: labor,labored,laboring,labors
laborer: laborers
laborious: laborious
labyrinth: labyrinth
lacedaemonian: lacedaemonian
lack: lack,lacking,lacks
laconian: laconian
laconic: laconic
lad: lad
ladder: ladders
laden: laden
lading: lading
lady: ladies,lady
lag: lagging
lair: lair
laius: laius
lake: lake,lakes
lamb: lamb,lambs
lame: lame,lamed
lameness: lameness
lament: lament,lamented,lamenting,laments
lamentable: lamentable
lamentation: lamentation,lamentations
lamp: lamp
lampoon: lampoons
lance: lance,lances
lancer: lancers
land: land,landed,landing,lands
landing: landing
lane: lane,lanes
language: language,languages
languid: languid
languish: languish,languished
lantern: lantern
lao: laos
lap: lap
lapithae: lapithae
lapse: lapse,lapses
largeness: largeness
largess: largess,largesses
lark: lark
lars: lars
lash: lash,lashed,lashing
lasting: lasting
lastly: lastly
late: late
lateral: lateral
lathyrus: lathyrus
latin: latin,latins
latins: latins
latinus: latinus
latona: latona
laud: lauded
laudable: laudable
laugh: laugh,laughed,laughing
laughable: laughable
laughingly: laughingly
laughter: laughter
launch: launched
laurel: laurel,laurels
lavinia: lavinia
lavish: lavish,lavished,lavishing
lavishly: lavishly
law: law,laws
lawful: lawful
lawfully: lawfully
lawgiver: lawgiver,lawgivers
lawless: lawless
lawmaker: lawmaker
lawsuit: lawsuits
lawyer: lawyer
laxity: laxity
lay: laid,lay,laying,lays
lazily: lazily
laziness: laziness
lazy: lazy
lead: lead,leading,leads,led
leader: leader,leaders
leadership: leadership
leading: leading
leaf: leaves
leafless: leafless
league: league
leaguer: leaguer
lean: lean,leaned,leaner,leaning,leans
leap: leap,leaped,leaping,leaps,leapt
leapt: leapt
learn: learn,learned,learning,learnt
learning: learning
lease: leases
leather: leather
leathern: leathern
leave: leave,leaves,leaving,left
lecture: lectures
left: left
leg: leg,legs
legacy: legacies
legal: legal
legally: legally
legate: legate
legend: legends
legendary: legendary
legion: legion,legions
legislating: legislating
legislation: legislation
legislator: legislator,legislators
legitimacy: legitimacy
legitimate: legitimate
legitimately: legitimately
legs: legs
leisurable: leisurable
leisure: leisure
leisurely: leisurely
lend: lend,lends,lent
lender: lender,lenders
lengthy: lengthy
leo: leo
leos: leos
lernaean: lernaean
lesbian: lesbian
lesbians: lesbians
lesche: lesche
lessen: lessen,lessened
lessening: lessening
lesson: lesson,lessons
letter: letter,lettered,letters
lettered: lettered
letters: letters
leucadian: leucadian
leucon: leucon
leucothea: leucothea
level: level,leveled
leveret: leveret
levity: levity
levy: levied,levies,levy
lewdness: lewdness
liable: liable
liar: liar
libation: libation,libations
liberal: liberal
liberality: liberalities,liberality
liberally: liberally
liberate: liberate
liberation: liberation
liberty: liberties,liberty
libitina: libitina
library: library
libya: libya
libyan: libyan,libyans
lice: lice
license: license
licentious: licentious
licentiously: licentiously
lick: lick
lictor: lictor,lictors
lid: lid
lie: lain,lie,lies,lying
lieu: lieu
lieutenancy: lieutenancy
lieutenant: lieutenant,lieutenants
life: life,lives
lifeless: lifeless
lifetime: lifetime
lift: lift,lifted,lifting
light: light,lighted,lightest,lighting,lights,lit
lighted: lighted
lighting: lighting
lightly: lightly
lightness: lightness
lightning: lightning
likelihood: likelihood
liken: liken
likeness: likeness
liking: liking
limb: limb,limbs
limit: limit,limited,limiting,limits
limitation: limitations
lineage: lineage
lineal: lineal
linger: lingered,lingering
lion: lion,lions
lions: lions
lip: lip,lips
liquefaction: liquefaction
liquid: liquid
liquor: liquor
lisp: lisp,lisped
lisping: lisping
list: list,lists
listen: listen,listened,listening
listener: listeners
literally: literally
literature: literature
litigation: litigation
litter: litter,litters
lituus: lituus
live: live,lived,lives,living
lively: lively
liver: liver,livers
lives: lives
living: living,livings
load: load,loaded,loading,loads
loaf: loaves
loath: loath
locality: localities,locality
lock: lock,locked,locks
locrian: locrian
lodge: lodge,lodged
lodging: lodging
lodgings: lodgings
loftily: loftily
lofty: loftier,lofty
log: log
logic: logic
logical: logical
loiter: loiter
loitering: loitering
loligo: loligo
longing: longing
longish: longish
loose: loose,loosed,loosing
looseness: looseness
lop: lopped
lord: lord,lorded,lords
lordship: lordships
lose: lose,loses,losing,lost
loss: loss,losses
lost: lost
lot: lot,lots
loud: loud,louder,loudest
loudly: loudly
loudness: loudness
love: love,loved,loving
lover: lover,lovers
loving: loving
loyalty: loyalty
lozenge: lozenge
lucania: lucania
luceres: luceres
lucid: lucid
lucina: lucina
lucius: lucius
luck: luck
luckily: luckily
lucky: luckier,lucky
lucre: lucre
lucretia: lucretia
lucretius: lucretius
lucumo: lucumo
ludicrous: ludicrous
luminous: luminous
lump: lump
lunar: lunar
lupercalia: lupercalia
luperci: luperci
lure: lured
lurk: lurked,lurking,lurks
lust: lust
luster: luster
lustrate: lustrating
lustre: lustre,lustres
lute: lute
luxurious: luxurious
luxuriously: luxuriously
luxury: luxuries,luxury
lyceum: lyceum
lycus: lycus
lydia: lydia
lydian: lydian
lying: lying
lynceus: lynceus
lyre: lyre
lyric: lyric
lysander: lysander
lysimachus: lysimachus
macedon: macedon
macedonia: macedonia
macedonian: macedonian,macedonians
machine: machine,machines
machinery: machinery
mad: mad
madcap: madcaps
madly: madly
madman: madman,madmen
madness: madness
maemacterion: maemacterion
magazine: magazine
magian: magian
magic: magic
magistracy: magistracies,magistracy
magistrate: magistrate,magistrates
magnanimity: magnanimity
magnanimous: magnanimous
magnesia: magnesia
magnificence: magnificence
magnificent: magnificent
magnificently: magnificently
magnify: magnified,magnify,magnifying
magnitude: magnitude
maia: maia
maid: maid,maids
maiden: maiden,maidens
mail: mail
maim: maimed
main: main
maintain: maintain,maintained,maintaining
maintenance: maintenance
majesty: majesty
major: major
majority: majority
maker: maker,makers
malady: malady
malcontent: malcontents
male: male
malefactor: malefactors
malice: malice
malicious: malicious
malign: maligned
maltreat: maltreated
malversation: malversation
mamercus: mamercus
manage: manage,managed,managing
management: management
manager: manager,managers
mane: manes
maneuver: maneuvered,maneuvers
manful: manful
manfully: manfully
mangle: mangle
manhood: manhood
manifest: manifest,manifested,manifesting
manifestation: manifestation,manifestations
manifestly: manifestly
manius: manius
mankind: mankind
manly: manly
manned: manned
manner: manner
mannered: mannered
manners: manners
manor: manor
mantinean: mantinean
mantle: mantle
manual: manual
manufacture: manufacture
manumission: manumission
manuscript: manuscripts
map: maps
marathon: marathon
marathonian: marathonian
marble: marble
march: march,marched,marches,marching
marching: marching
mare: mare
margin: margin
marica: marica
marine: marine
mariner: mariners
maritime: maritime
mark: mark,marked,marking,marks
marked: marked
market: market
marketplace: marketplace,marketplaces
marriage: marriage,marriages
marriageable: marriageable
married: married
marry: married,marry,marrying
mars: mars
marsh: marsh,marshes
marshal: marshaled,marshaling
marshy: marshy
marsian: marsian
martha: martha
martial: martial
martially: martially
martius: martius
marvelous: marvelous
masculine: masculine
mason: masons
masonry: masonry
mass: mass,masses
massacre: massacre,massacred,massacres
massilia: massilia
massy: massy
mast: mast
master: master,mastered,masters
masterly: masterly
masterpiece: masterpieces
mastery: mastery
match: match,matched,matches,matching
material: material,materials
mathematical: mathematical
mathematician: mathematician,mathematicians
mathematics: mathematics
matricide: matricide
matrimony: matrimony
matron: matrons
matronalia: matronalia
matter: matter,matters
mattock: mattocks
mattress: mattress
mature: mature
maturity: maturity
mauritanian: mauritanian
maxim: maxim,maxims
maximus: maximus
meadow: meadow,meadows
meal: meal,meals
meaning: meaning
meanly: meanly
meanness: meanness
measure: measure,measured,measures,measuring
measurement: measurement
meat: meat,meats
mechanic: mechanic,mechanics
mechanical: mechanical
meddle: meddle,meddled,meddling
mede: mede
medea: medea
media: media
median: median
mediate: mediate,mediated
mediation: mediation
medicine: medicines
medimnus: medimnus
medusa: medusa
meet: meet,meeting,meets,met
meeting: meeting,meetings
megalopolis: megalopolis
megalopolitan: megalopolitan
megara: megara
megarian: megarian
melancholy: melancholy
melanippus: melanippus
melas: melas
meleager: meleager
melian: melian
melicerta: melicerta
mell: mell
mellow: mellow
melon: melon
melos: melos
melt: melted,melting
memoirs: memoirs
memorable: memorable
memorial: memorial,memorials
memory: memories,memory
memphis: memphis
menace: menaces
menacing: menacing
mend: mended
meninx: meninx
mental: mental
mention: mention,mentioned,mentioning,mentions
mercantile: mercantile
mercedinus: mercedinus
mercenary: mercenaries,mercenary
merchandise: merchandise
merchant: merchant,merchants
merciful: merciful
mercilessness: mercilessness
mercuries: mercuries
mercury: mercury
mercy: mercy
mere: mere
meriones: meriones
merit: merit,merited,meriting,merits
merope: merope
merrily: merrily
merriment: merriment
merry: merry
merula: merula
mesopotamia: mesopotamia
message: message,messages
messenger: messenger,messengers
metal: metal,metals
metaphor: metaphor
methinks: methinks
method: method,methods
metropolis: metropolis
mettle: mettle,mettled
midas: midas
middle: middle
midnight: midnight
midst: midst
mien: mien
mighty: mighty
migration: migration
milan: milan
mild: mild,milder,mildest
mildly: mildly
mildness: mildness
mile: miles
milesian: milesian
military: military
milk: milk
milo: milo
mime: mime,mimes
mimic: mimicked
mina: minae,minas
mind: mind,minded,minding,minds
minded: minded
mindful: mindful
miner: miners
minerva: minerva
mingle: mingle,mingled,mingles,mingling
minister: minister,ministered,ministers
ministration: ministration
minor: minor
minority: minority
minos: minos
minotaur: minotaur
mint: mint
minute: minute
miracle: miracle
miraculous: miraculous
miraculously: miraculously
mire: mire,mired
mirror: mirrors
mirth: mirth
misadventure: misadventure
misanthrope: misanthrope
misbehave: misbehaved
misbehavior: misbehavior
miscalculation: miscalculation
miscarriage: miscarriage,miscarriages
miscarry: miscarried,miscarry,miscarrying
mischance: mischance,mischances
mischief: mischief,mischiefs
misconduct: misconduct
misdeed: misdeeds
misdemeanor: misdemeanor,misdemeanors
miserable: miserable
miserably: miserably
misery: miseries,misery
misfortune: misfortune,misfortunes
misgovernment: misgovernment
misguide: misguide
mislead: misled
mispronunciation: mispronunciation
misrepresentation: misrepresentation
missile: missile,missiles
misspend: misspend,misspent
misstatement: misstatement
mist: mist
mistake: mistake,mistakes,mistaking,mistook
mistaken: mistaken
mistaking: mistaking
mistletoe: mistletoe
mistress: mistress,mistresses
mistrust: mistrusting
misunderstanding: misunderstandings
misuse: misuse
mite: mite
mithridatic: mithridatic
mitigate: mitigate,mitigating
mitigation: mitigation
mix: mix,mixed,mixing
mixed: mixed
mixture: mixture
moan: moan
moat: moats
mob: mob
mock: mock,mocked,mocking,mocks
mockery: mockery
mode: mode,modes
model: model,modeled,modeling
modeling: modeling
moderate: moderate,moderating
moderately: moderately
moderation: moderation
modern: moderns
modest: modest
modestly: modestly
modesty: modesty
modulation: modulations
moiety: moiety
moist: moist
moisten: moistening
moistness: moistness
moisture: moisture
mold: mold,molded
molder: molder,molders
molest: molest
molestation: molestation
mollify: mollify
molossian: molossian
moment: moment,moments
monarch: monarch,monarchs
monarchical: monarchical
monarchy: monarchy
money: money,moneys
monger: monger
monkey: monkeys
monster: monster
monstrous: monstrous
month: month,months
monthly: monthly
monument: monument,monuments
mood: moods
moon: moon,moons
moonlight: moonlight
moonshine: moonshine
moral: moral,morals
morality: morality
morning: morning
morose: morose
morosity: morosity
morrow: morrow
morsel: morsels
mortal: mortal,mortals
mortality: mortality
mortally: mortally
mortgage: mortgage
mortification: mortification
mortified: mortified
mother: mother,mothers
motion: motion,motions
motive: motive,motives
mound: mound
mount: mount,mounted,mounting
mountain: mountain,mountains
mourn: mourn,mourned
mourner: mourner,mourners
mournful: mournful
mourning: mourning,mournings
mouse: mice,mouse
mouth: mouth,mouths
movable: movables
movement: movement,movements
mover: movers
mud: mud
muddy: muddy
mulberry: mulberry
mulct: mulcts
mule: mule,mules
multiplication: multiplication
multiply: multiplied
multitude: multitude,multitudes
munificence: munificence
munificent: munificent
munychia: munychia
munychion: munychion
murder: murder,murdered,murdering,murders
murderer: murderer,murderers
murmur: murmur,murmuring
musaeus: musaeus
muscle: muscles
muse: muse,muses
muses: muses
museum: museum
music: music
musical: musical
musician: musician,musicians
muster: muster,mustered,mustering
mutability: mutability
mutation: mutation
mute: mute
mutilation: mutilation
mutilator: mutilators
mutinous: mutinous
mutiny: mutinied,mutiny,mutinying
mutual: mutual
mutually: mutually
myriad: myriads
myron: myron
myrrh: myrrh
myrtilus: myrtilus
myrtle: myrtle
mysteries: mysteries
mystery: mysteries,mystery
mystic: mystic
mystical: mystical
mythology: mythology
nabis: nabis
nail: nailed,nails
naked: naked
nakedness: nakedness
namesake: namesake
naples: naples
narration: narration
narrative: narrative,narratives
narrow: narrow
narrowly: narrowly
nation: nation,nations
national: national
native: native,natives
nativity: nativity
natural: natural
naturalization: naturalization
naturalize: naturalizing
naturally: naturally
nature: nature,natures
natured: natured
nauseous: nauseous
naval: naval
nave: naves
navigable: navigable
navigate: navigated
navigation: navigation
navy: navy
neapolitan: neapolitans
nearer: nearer
nearness: nearness
neatness: neatness
necessaries: necessaries
necessitate: necessitated
necessitous: necessitous
necessity: necessities,necessity
neck: neck,necks
necklace: necklaces
needful: needful
neediness: neediness
needless: needless
needy: needy
negative: negative
neglect: neglect,neglected,neglecting
negligence: negligence
negligent: negligent
negotiate: negotiate,negotiating
neigh: neighing
neighbor: neighbor,neighboring,neighbors
neighborhood: neighborhood
neighboring: neighboring
nemean: nemean
nemesis: nemesis
neon: neon
nephew: nephew,nephews
neptune: neptune
nerve: nerves
nest: nest
nestor: nestor
nettle: nettled
neuter: neuter
newly: newly
newness: newness
news: news
nice: nice
nicety: niceties,nicety
nickname: nickname,nicknames
nicodemus: nicodemus
nigh: nigh
night: night,nights
nightingale: nightingale
nighttime: nighttime
nile: nile
nimble: nimble,nimblest
ninth: ninth
nisaean: nisaean
nobility: nobility
noble: noble,nobler,nobles,noblest
nobleman: nobleman,noblemen
nobleness: nobleness
noblest: noblest
nobly: nobly
nocturnal: nocturnal
nod: nod,nodded
noise: noise,noises
noised: noised
noising: noising
noisy: noisy
nominally: nominally
nominate: nominate,nominated
nones: nones
nonius: nonius
noon: noon
noonday: noonday
north: north
northern: northern
nose: nose
nosed: nosed
note: note,notes
notice: notice,noticed
noticeable: noticeable
notion: notion
notorious: notorious
nourish: nourish,nourished
nourishment: nourishment
nous: nous
novelty: novelties,novelty
november: november
novice: novice,novices
noway: noways
noways: noways
nowise: nowise
noxious: noxious
numa: numa
numantine: numantine
numbering: numbering
numberless: numberless
numerous: numerous
numerously: numerously
numerousness: numerousness
numidian: numidian
nuptial: nuptial
nuptials: nuptials
nurse: nurse,nursed,nurses
nursing: nursing
nurture: nurture,nurtured
nymph: nymph,nymphs
nymphaeum: nymphaeum
nyssa: nyssa
oak: oak
oaken: oaken
oar: oar,oared,oars
oath: oath,oaths
obduracy: obduracy
obe: obe,obes
obedience: obedience
obedient: obedient
obediently: obediently
obeisance: obeisance
obese: obese
obey: obey,obeyed,obeying
object: object,objected,objects
objection: objections
oblation: oblation
obligation: obligation,obligations
oblige: oblige,obliged,obliges,obliging
obligingly: obligingly
obliquely: obliquely
obliterate: obliterate
oblong: oblong
obloquy: obloquy
obnoxious: obnoxious
obol: obol,obols
obolus: obolus
obscene: obscene
obscure: obscure,obscured,obscuring
obscurely: obscurely
obscurer: obscurer
obscurity: obscurity
obsequy: obsequies
observable: observable
observance: observance,observances
observant: observant
observation: observation,observations
observe: observe,observed,observes,observing
observer: observer,observers
obstacle: obstacle
obstinacy: obstinacy
obstinate: obstinate
obstinately: obstinately
obstruct: obstruct,obstructed,obstructing
obtrude: obtrude
obviate: obviate
obvious: obvious
occasion: occasion,occasioned,occasioning,occasions
occasionally: occasionally
occupation: occupation,occupations
occupy: occupied,occupy
occur: occur,occurred,occurring,occurs
occurrence: occurrence,occurrences
ocean: ocean
octavia: octavia
octavius: octavius
october: october
odd: odd
odds: odds
odeum: odeum
odious: odious
odium: odium
oedipus: oedipus
offend: offend,offended
offended: offended
offender: offender,offenders
offense: offense
offensive: offensive
offer: offer,offered,offering,offers
offering: offering,offerings
office: office,offices
officer: officer,officers
officiate: officiate,officiated
officious: officious
officiously: officiously
officiousness: officiousness
offspring: offspring
oft: oft
oftentimes: oftentimes
oil: oil
ointment: ointment,ointments
oligarchical: oligarchical
oligarchy: oligarchies,oligarchy
olive: olive,olives
olympia: olympia
olympiad: olympiad
olympian: olympian
olympic: olympic
olympus: olympus
olynthian: olynthian
omen: omen,omens
ominous: ominous
omit: omit,omitting
onion: onion,onions
onset: onset
onward: onward
onwards: onwards
openly: openly
operate: operate,operating
operation: operation,operations
operator: operator
opes: opes
opinion: opinion,opinions
opponent: opponent,opponents
opportune: opportune
opportunely: opportunely
opportunity: opportunities,opportunity
oppose: oppose,opposed,opposes,opposing
opposed: opposed
opposer: opposer,opposers
opposition: opposition
oppress: oppress,oppressed
oppressed: oppressed
oppression: oppression
oppressive: oppressive
oppressor: oppressors
opulence: opulence
opulent: opulent
opus: opus
oracle: oracle,oracles
oracular: oracular
oracularly: oracularly
oration: oration,orations
orator: orator,orators
oratorical: oratorical
oratory: oratory
ordain: ordained,ordaining
orderly: orderly
ordinance: ordinance,ordinances
ordinarily: ordinarily
ordinary: ordinary
organ: organ
organize: organized
oriental: oriental
origin: origin
original: original
originally: originally
originate: originate
origination: origination
originator: originators
ornament: ornament,ornamented,ornaments
ornamental: ornamental
ornamented: ornamented
orphan: orphan,orphans
orpheus: orpheus
oryssus: oryssus
oschophoria: oschophoria
ostentation: ostentation
ostentatiously: ostentatiously
ostia: ostia
ostracism: ostracism
ostracize: ostracize,ostracized
ostracon: ostracon
outbalance: outbalance
outbid: outbid
outcry: outcries,outcry
outdo: outdid,outdo,outdoes,outdoing,outdone
outer: outer
outgo: outgone
outgone: outgone
outlaw: outlaws
outlawry: outlawry
outlay: outlay
outlet: outlets
outline: outline
outlive: outlives
outnumber: outnumbered
outpost: outposts
outrage: outrage,outraged,outrages
outraged: outraged
outright: outright
outrun: outran
outscream: outscream
outset: outset
outstrip: outstripped
outvie: outvie
outward: outward
outwardly: outwardly
outweigh: outweigh,outweighed
outwent: outwent
outwit: outwitted
outwork: outworks
ovation: ovation
overabundance: overabundance
overbalance: overbalancing
overbear: overbear
overbearing: overbearing
overboard: overboard
overborne: overborne
overburdened: overburdened
overcome: overcame,overcome,overcoming
overflow: overflowed,overflowing,overflows
overgrown: overgrown
overhear: overhear,overheard
overjoy: overjoyed
overjoyed: overjoyed
overload: overloaded
overloaded: overloaded
overlook: overlooked,overlooking
overmuch: overmuch
overpersuade: overpersuading
overplus: overplus
overpower: overpower,overpowered,overpowering
overpowerful: overpowerful
overreach: overreached,overreaches,overreaching
overrun: overran,overrun,overrunning
oversee: oversee,overseeing
overseer: overseers
oversight: oversight
overstrained: overstrained
overtake: overtake,overtaken,overtakes,overtook
overthrow: overthrew,overthrow,overthrowing,overthrown,overthrows
overture: overture,overtures
overturn: overturned,overturning
overweening: overweening
overwhelm: overwhelm,overwhelmed,overwhelming
overwhelmed: overwhelmed
overwhelming: overwhelming
ovis: ovis
owe: owe,owed
owl: owl,owls
owner: owner,owners
ox: ox
oxen: oxen
pace: pace,paces
pacific: pacific
pacification: pacification
pacify: pacified,pacify,pacifying
pack: packing
paean: paean
paeans: paeans
paeon: paeon
pagus: pagus
pail: pail
pain: pain,pains
painful: painful
painless: painless
paint: paint,painted
painter: painter,painters
painting: painting,paintings
pair: pair
palace: palace,palaces
palaestra: palaestra
palate: palate
palatine: palatine
palatium: palatium
pale: pale
palestine: palestine
palilia: palilia
palisade: palisade,palisades
palladium: palladium
pallas: pallas
palm: palm
palpable: palpable
palpitation: palpitation
palsy: palsy
pampered: pampered
pan: pan,pans
panathenaea: panathenaea
pancratium: pancratium
pandion: pandion
panegyric: panegyrics
panel: paneled
pang: pangs
panic: panic
pans: pans
paper: paper,papers
parallel: parallel,parallels
paramount: paramount
paramour: paramour
parcel: parcel,parcels
parch: parch
parchment: parchment
pardon: pardon,pardoned
pardonable: pardonable
parent: parent,parents
parentage: parentage
paris: paris
parish: parish
park: parks
parley: parley,parleying
parma: parma
parnassus: parnassus
parricide: parricide,parricides
parsimonious: parsimonious
parsimony: parsimony
parsley: parsley
partake: partake,partaken,partaking,partook
partaker: partakers
partaking: partaking
parthenon: parthenon
parthian: parthian
partial: partial
partially: partially
participate: participate,participates
participation: participation
particle: particles
particularity: particularities
particulars: particulars
partisan: partisan,partisans
partition: partition
partly: partly
partner: partner,partners
partook: partook
partridge: partridges
party: parties,party
pasiphae: pasiphae
pass: pass,passed,passes,passing
passable: passable
passage: passage,passages
passenger: passengers
passer: passer
passion: passion,passions
passionate: passionate
passionately: passionately
passive: passive
password: password
pastime: pastimes
pasture: pasture,pastured,pastures
patch: patch
pate: pate
paternal: paternal
path: path,paths
pathetically: pathetically
patience: patience
patient: patient,patients
patiently: patiently
patrician: patrician,patricians
patrimonial: patrimonial
patrimony: patrimony
patriot: patriot
patriotic: patriotic
patroclus: patroclus
patron: patron,patrons
patronage: patronage
patroness: patroness
pattern: pattern,patterns
paulus: paulus
pause: pause,pausing
pavement: pavement
pavilion: pavilion,pavilions
pay: paid,pay,paying
paymaster: paymasters
payment: payment,payments
pea: peas
peace: peace
peaceable: peaceable
peaceably: peaceably
peaceful: peaceful
peacefully: peacefully
peaceless: peaceless
peacock: peacocks
peak: peaks
peal: peals
peck: peck,pecking
peculia: peculia
peculiar: peculiar
peculiarity: peculiarities
peculiarly: peculiarly
pecuniary: pecuniary
peda: peda
pedagogue: pedagogue
pedalium: pedalium
pedantic: pedantic
pedestal: pedestal
pedigree: pedigrees
peevishness: peevishness
peg: peg
peleus: peleus
pelias: pelias
pell: pell
pellmell: pellmell
pelopidae: pelopidae
peloponnesian: peloponnesian
pelops: pelops
pelt: pelted,pelting
pen: pent
penalty: penalties,penalty
pence: pence
penetrable: penetrable
penetralia: penetralia
peninsula: peninsula
penny: penny
pentelican: pentelican
people: peopled
peplus: peplus
pepper: pepper
perceive: perceive,perceived,perceiving
percent: percent
perceptible: perceptible
perception: perception
perchance: perchance
peremptory: peremptory
perennial: perennial
perfect: perfect,perfected
perfecter: perfecter
perfection: perfection,perfections
perfectly: perfectly
perfidious: perfidious
perfidy: perfidy
perform: perform,performed,performing
performance: performance,performances
performer: performer,performers
perfume: perfumes
perfumed: perfumed
perfumer: perfumer,perfumers
perfunctory: perfunctory
pericles: pericles
peril: peril,perils
perilous: perilous
period: period,periods
peripatetic: peripatetics
perish: perish,perished,perishing
perjury: perjury
permanence: permanence
permanent: permanent
permission: permission
permit: permit,permits,permitted,permitting
pernicious: pernicious
perpendicularly: perpendicularly
perpetual: perpetual
perpetually: perpetually
perpetuity: perpetuity
perplex: perplexed
perplexity: perplexity
persecute: persecuted
persecution: persecution
perseus: perseus
perseverance: perseverance
persevere: persevering
persia: persia
persian: persian,persians
persist: persist,persisted,persisting
person: people,person,persons
personage: personages
personal: personal
personally: personally
persuade: persuade,persuaded,persuading
persuasion: persuasion,persuasions
persuasive: persuasive
persuasiveness: persuasiveness
pertain: pertained,pertaining,pertains
pertinent: pertinent
peruse: perused
perverse: perverse
perverseness: perverseness
pervert: pervert,perverted
perverted: perverted
pest: pest
pestilence: pestilence
pestilential: pestilential
petition: petition,petitioned,petitioning,petitions
petitioner: petitioner,petitioners
pettiness: pettiness
petty: petty
petulance: petulance
phaedo: phaedo
phaedra: phaedra
phaethon: phaethon
phalanx: phalanx,phalanxes
phantasm: phantasms
pharmuthi: pharmuthi
pharsalian: pharsalian
phasis: phasis
phenomenon: phenomenon
philadelphus: philadelphus
philip: philip
philippics: philippics
philippus: philippus
philoctetes: philoctetes
philosopher: philosopher,philosophers
philosophic: philosophic
philosophical: philosophical
philosophize: philosophizing
philosophy: philosophy
phocaean: phocaean
phocian: phocian
phoebus: phoebus
phoenicia: phoenicia
phoenician: phoenician
phoenicians: phoenicians
phoenix: phoenix
phrase: phrase,phrases
phrygia: phrygia
phyle: phyle
physic: physic
physician: physician,physicians
physics: physics
picinae: picinae
pick: pick,picked,picking
picture: picture,pictures
picus: picus
piece: piece,pieces
piecemeal: piecemeal
pierce: pierced
piety: piety
pigeon: pigeon
pike: pike,pikes
pikemen: pikemen
pilchard: pilchards
pile: pile,piled,piles
pileus: pileus
pilfer: pilfered
pilgrim: pilgrim
pillage: pillage,pillaged,pillaging
pillaging: pillaging
pillar: pillar,pillars
pillars: pillars
pillow: pillow
pilot: pilot,pilots
pin: pins
pinch: pinched,pinches
pine: pine,pines
pint: pint,pints
pinus: pinus
pious: pious
pipe: pipe,pipes
piper: piper,pipers
pique: pique
piracy: piracy
pirate: pirate,pirates
piratic: piratic
pisa: pisa
pisistratidae: pisistratidae
piso: piso
pit: pit
pitch: pitch,pitched,pitching
pitched: pitched
pitcher: pitchers
pitcherful: pitcherful
pitching: pitching
pitfall: pitfalls
pitiable: pitiable
pitiful: pitiful
pity: pitied,pity,pitying
pius: pius
placing: placing
plague: plague
plain: plain,plainer,plains
plainly: plainly
plainness: plainness
plaintiff: plaintiff,plaintiffs
plan: plan,plans
plane: plane
plank: planks
plant: plant,planted,planting,plants
plantation: plantation,plantations
planter: planters
planting: planting
plaster: plastered
plataean: plataean
plate: plate,plates
plato: plato
plausible: plausible
plausibly: plausibly
play: play,played,playing,plays
player: player,players
playful: playful
playing: playing
plea: plea,pleas
plead: plead,pleaded,pleading
pleading: pleading,pleadings
pleasant: pleasant,pleasanter,pleasantest
pleasantly: pleasantly
pleasantness: pleasantness
pleasantry: pleasantry
pleased: pleased
pleasing: pleasing
pleasure: pleasure,pleasures
plebeian: plebeian,plebeians
pledge: pledge,pledges,pledging
plenipotentiary: plenipotentiaries
plentiful: plentiful
plentifully: plentifully
plenty: plenty
pleurisy: pleurisy
pliable: pliable
pliancy: pliancy
pliant: pliant
plight: plighted
plot: plot,plotted
plow: plow,plowed
plowman: plowman
plowshare: plowshare
pluck: pluck,plucked,plucking
plume: plumes
plunder: plunder,plundered,plundering
plunderer: plunderers
plunge: plunge,plunged,plunging
plutarch: plutarch
pluto: pluto
plutus: plutus
ply: ply
pnyx: pnyx
po: po
poecile: poecile
poem: poem,poems
poet: poet,poets
poetic: poetic
poetical: poetical
poetry: poetry
pointedly: pointedly
poison: poison,poisoned,poisoning
poisoner: poisoner
pole: pole,poles
polemarch: polemarch
policy: policy
polish: polished,polishing
polished: polished
politic: politic
political: political
politician: politician,politicians
politicly: politicly
politics: politics
polity: polity
poll: poll
polling: polling
pollute: polluted
polluted: polluted
pollution: pollution
pollux: pollux
pomoerium: pomoerium
pomp: pomp
pompeii: pompeii
pompey: pompey
pompous: pompous
pon: pons
pond: ponds
poniard: poniard,poniards
pontic: pontic
pontifex: pontifex
pontifical: pontifical
pontifice: pontifices
pontifices: pontifices
pontius: pontius
pontus: pontus
pool: pools
poop: poop
poor: poor,poorer,poorest
populace: populace
popular: popular
popularity: popularity
population: population
populous: populous
porch: porch,porches
port: port,ports
portable: portable
portend: portend,portended,portending
portent: portent,portents
portico: portico,porticoes
portion: portion,portions
portrait: portrait
position: position,positions
positive: positive
positively: positively
possess: possess,possessed,possesses,possessing
possessed: possessed
possession: possession,possessions
possibility: possibilities,possibility
post: post,posted,posting,posts
posterity: posterity
posthuma: posthuma
postpone: postpone,postponed,postponing
postponement: postponement
posture: posture,postures
pot: pot
potency: potency
potent: potent
potentate: potentates
potion: potion
potter: potters
pound: pound,pounds
pour: pour,poured,pouring,pours
poverty: poverty
powder: powder
power: power,powers
powerful: powerful
powers: powers
practical: practical
practice: practice,practiced,practices,practicing
practiced: practiced
practicer: practicer
praetexta: praetexta
praetor: praetor,praetors
praetorian: praetorian
praetorship: praetorship
praise: praise,praised,praises,praising
praiseworthy: praiseworthy
prance: pranced
prate: prating
pray: pray,prayed,praying,prays
prayer: prayer,prayers
preach: preach
precaution: precaution,precautions
precede: preceded,preceding
precedence: precedence
precedent: precedent
precept: precepts
preceptor: preceptor,preceptors
precinct: precinct,precincts
precious: precious
precipice: precipice,precipices
precipitate: precipitate,precipitated,precipitating
precipitately: precipitately
precipitation: precipitation
precipitous: precipitous
precise: precise
precision: precision
preclude: preclude,precluded
preconsider: preconsider
predatory: predatory
predecessor: predecessor,predecessors
predict: predicted
prediction: prediction,predictions
predispose: predisposing
predisposed: predisposed
predominance: predominance
predominate: predominating
preeminence: preeminence
prefer: prefer,preferred,preferring
preferable: preferable
preference: preference
preferment: preferment,preferments
prefix: prefixed
pregnant: pregnant
prejudice: prejudice,prejudiced
prejudiced: prejudiced
prejudicial: prejudicial
prelude: prelude,preludes
premise: premise
preoccupation: preoccupation
preparation: preparation,preparations
preparatory: preparatory
prepare: prepare,prepared,preparing
prepared: prepared
prepossess: prepossessing
prerogative: prerogative,prerogatives
presage: presaged,presages,presaging
prescribe: prescribe,prescribed,prescribes,prescribing
prescription: prescription,prescriptions
presence: presence,presences
presently: presently
preservation: preservation
preserve: preserve,preserved,preserves,preserving
preserver: preserver,preservers
preside: preside,presided,presiding
president: president
press: press,pressed,presses,pressing
pressed: pressed
pressure: pressure
presume: presume,presumed,presuming
presumption: presumption
presumptuous: presumptuous
pret: pretest
pretence: pretence,pretences
pretend: pretend,pretended,pretending
pretender: pretenders
pretense: pretense
pretension: pretension,pretensions
preternatural: preternatural
pretext: pretext
prettily: prettily
pretty: prettier,prettiest,pretty
prevail: prevail,prevailed,prevailing,prevails
prevailing: prevailing
prevalent: prevalent
prevaricator: prevaricators
prevent: prevent,prevented,preventing,prevents
previous: previous
prey: prey,preys
priapus: priapus
price: price,prices
prick: pricking
pride: pride,priding
priest: priest,priests
priestess: priestess,priestesses
priesthood: priesthood
prima: prima
primary: primary
prime: prime
primogeniture: primogeniture
prince: prince,princes
princely: princely
principal: principal
principality: principalities
principally: principally
principle: principle,principles
prison: prison,prisons
prisoner: prisoner,prisoners
privacy: privacy
private: private
privately: privately
privilege: privilege,privileges
privileged: privileged
privily: privily
privy: privy
prize: prize,prized,prizes,prizing
prized: prized
probability: probabilities,probability
probable: probable
probation: probation
probity: probity
procedure: procedure
proceed: proceed,proceeded,proceeding,proceeds
proceeding: proceeding
proceedings: proceedings
process: process,processes
procession: procession,processions
proclaim: proclaim,proclaimed,proclaiming,proclaims
proclamation: proclamation,proclamations
proconnesian: proconnesian
proconsul: proconsul,proconsuls
proconsular: proconsular
proconsulate: proconsulates
procrustes: procrustes
procure: procure,procured,procuring
procurement: procurement
prodigal: prodigal
prodigality: prodigality
prodigious: prodigious
prodigy: prodigies,prodigy
produce: produce,produced,produces,producing
product: product,products
production: production,productions
productive: productive
profanation: profanation
profane: profane,profaned
profanely: profanely
profanity: profanity
profess: profess,professed,professes,professing
professedly: professedly
profession: profession,professions
professor: professor
proffer: proffer,proffered,proffering,proffers
proficiency: proficiency
proficient: proficient
profit: profit,profited,profits
profitable: profitable
profitably: profitably
profligate: profligate
profound: profound
profuse: profuse
profuseness: profuseness
profusion: profusion
progeny: progeny
prognostic: prognostic
progress: progress
prohibit: prohibit,prohibited,prohibiting
prohibition: prohibition
project: project,projected,projecting,projects
prolong: prolonged,prolonging
promiscuous: promiscuous
promiscuously: promiscuously
promise: promise,promised,promises,promising
promiser: promiser,promisers
promising: promising
promontory: promontories,promontory
promote: promote,promoted,promoting
promoter: promoters
promotion: promotion,promotions
prompt: prompt,prompted
promptitude: promptitude
promptness: promptness
prone: prone
pronounce: pronounce,pronounced,pronounces,pronouncing
pronounced: pronounced
pronunciation: pronunciation
proof: proof,proofs
prop: prop
propel: propel
proper: proper
properly: properly
property: properties,property
prophecy: prophecies,prophecy
prophesy: prophesied,prophesying
prophet: prophet,prophets
prophetess: prophetess
prophetic: prophetic
propitiate: propitiate
propitiation: propitiation
propitiatory: propitiatory
propitious: propitious
propitiously: propitiously
propontis: propontis
proportion: proportion,proportioned,proportions
proportionable: proportionable
proportionably: proportionably
proposal: proposal,proposals
propose: propose,proposed,proposing
proposition: proposition,propositions
propound: propound,propounded
proprietor: proprietors
propriety: propriety
propylaea: propylaea
proscribe: proscribed,proscribing
proscribed: proscribed
proscription: proscription
prose: prose
prosecute: prosecute,prosecuted,prosecuting
prosecution: prosecution,prosecutions
prosecutor: prosecutors
proserpina: proserpina
prospect: prospect
prospects: prospects
prosper: prosper
prosperity: prosperity
prosperous: prosperous
prosperously: prosperously
prostrate: prostrate,prostrated
protect: protect,protected,protecting
protection: protection
protector: protector,protectors
protest: protested,protesting
protestation: protestations
protract: protract,protracted,protracting
proudly: proudly
prove: prove,proved,proves,proving
provender: provender
proverb: proverb
proverbial: proverbial
provide: provide,providing
providence: providence
provident: provident
province: province,provinces
provision: provision,provisions
proviso: proviso
provocation: provocation
provoke: provoke,provoked,provoking
prow: prow,prows
prowess: prowess
proxy: proxy
prudence: prudence
prudent: prudent
prudently: prudently
prune: pruned
prytaneum: prytaneum
prytanis: prytanis
ptolemy: ptolemy
public: public
publication: publication
publicly: publicly
publish: publish,published,publishing
puddle: puddle
puff: puff,puffed
pull: pull,pulled,pulling
pulley: pulley
pulse: pulse
punctually: punctually
punic: punic
punish: punish,punished,punishing
punishable: punishable
punisher: punisher
punishment: punishment,punishments
puny: puny
pupil: pupil,pupils
puppy: puppy
purchasable: purchasable
purchase: purchase,purchased,purchasing
pure: pure,purer,purest
purely: purely
purgation: purgation
purge: purge
purging: purging
purification: purification,purifications
purify: purified,purify
purifying: purifying
purity: purity
purloin: purloined
purple: purple
purport: purport
purpose: purpose,purposes,purposing
purposely: purposely
purposing: purposing
purse: purse,purses
pursuance: pursuance
pursuant: pursuant
pursue: pursue,pursued,pursuing
pursued: pursued
pursuer: pursuers
pursuing: pursuing
pursuit: pursuit
push: pushed,pushes,pushing
pusillanimity: pusillanimity
pusillanimous: pusillanimous
putrefied: putrefied
pylades: pylades
pyre: pyre
pyrenean: pyrenean
pyrrha: pyrrha
pyrrhus: pyrrhus
pythagoras: pythagoras
pythagorean: pythagorean
pythagoreans: pythagoreans
pythian: pythian
pythius: pythius
python: python
quaestor: quaestor,quaestors
quail: quail
qualification: qualification,qualifications
qualified: qualified
qualify: qualify,qualifying
quality: qualities,quality
quantity: quantities,quantity
quarrel: quarrel,quarreled,quarreling,quarrels
quarter: quarter,quartered,quartering,quarters
queen: queen
quell: quell,quelled
quench: quench,quenched,quenching
question: question,questioned,questioning,questions
questionless: questionless
quick: quick,quicker,quickest
quicken: quicken,quickened,quickening
quickness: quickness
quiet: quiet,quieted,quieter,quietest,quieting
quietly: quietly
quietness: quietness
quince: quince
quinquereme: quinquereme
quintilis: quintilis
quintius: quintius
quintus: quintus
quirites: quirites
quit: quit,quitted,quitting
quiver: quivers
quoit: quoit,quoits
rabble: rabble
race: race,races
racecourse: racecourse
racer: racer
rage: rage,raging
rail: railed,rails
raillery: raillery
rain: rain,rained,rains
rainy: rainy
raise: raise,raised,raising
rake: raked
rally: rallied,rallies,rallying
ram: ram
ramble: rambled,rambles,rambling
rammer: rammer
ramnenses: ramnenses
rampart: rampart,ramparts
rancor: rancor
random: random
range: range,ranged,ranges
rank: rank,ranked,ranks
ransack: ransack,ransacked
ransom: ransom,ransoming,ransoms
rapacious: rapacious
rapacity: rapacity
rape: rape,rapes
rapid: rapid
rapidity: rapidity
rapidly: rapidly
rapine: rapine
rare: rare
rarefied: rarefied
rarely: rarely
rarity: rarities,rarity
rash: rash
rashly: rashly
rashness: rashness
rate: rate,rated
ratification: ratification
ratify: ratified,ratify
ratio: ratio
rational: rational
rationally: rationally
rattle: rattling
ravage: ravage,ravaged,ravaging
ravages: ravages
ravaging: ravaging
raven: ravens
ravine: ravine,ravines
ravish: ravished
ravisher: ravishers
raw: raw
ray: rays
raze: raze,razed
reach: reach,reached,reaches,reaching
read: read,reading
reader: reader,readers
readiness: readiness
reading: reading
ready: readiest,ready
real: real
reality: reality
realm: realm,realms
reanimate: reanimated
reap: reap,reaped
rear: rear,reared,rearing,rears
rearing: rearing
reason: reason,reasoned,reasons
reasonable: reasonable
reasoning: reasoning,reasonings
reassume: reassume
rebel: rebel,rebelled,rebelling,rebels
rebellion: rebellion
rebuild: rebuild,rebuilding,rebuilt
rebuke: rebuke,rebuked,rebukes
recall: recall,recalled,recalling
recede: recede,receded,receding
receipt: receipt,receipts
receive: receive,received,receives,receiving
receiver: receivers
receiving: receiving
receptacle: receptacles
reception: reception
reciprocal: reciprocal
reciprocation: reciprocation
recital: recital
recite: recited
recklessness: recklessness
reckon: reckon,reckoned,reckoning
reckoning: reckoning
reclaim: reclaim,reclaimed
recognition: recognition
recognize: recognized,recognizing
recoil: recoil
recollect: recollect,recollecting
recommence: recommence
recommend: recommend,recommended
recommendation: recommendation,recommendations
recompense: recompense,recompensed
recompose: recompose
reconcile: reconcile,reconciled,reconciling
reconciler: reconciler
reconciliation: reconciliation
reconnoiter: reconnoiter
reconstitution: reconstitution
record: record,recorded,recording,records
recording: recording
recount: recount,recounted,recounting
recourse: recourse
recover: recover,recovered,recovering,recovers
recovery: recovery
recreate: recreate
recreation: recreation,recreations
recruit: recruit,recruits
rectangular: rectangular
rectify: rectifying
recur: recur,recurring
red: red
redeem: redeem,redeemed,redeeming
redeeming: redeeming
redemption: redemption
redetermine: redetermine
redistribute: redistribute
redouble: redoubling
redound: redounded
redress: redress
reduce: reduce,reduced,reducing
reduction: reduction
reed: reeds
reelect: reelected
reestablish: reestablished,reestablishing
refer: refer,referred,referring,refers
reference: reference
refine: refined
refined: refined
refinement: refinement
reflect: reflect,reflected,reflecting
reflection: reflection,reflections
reflex: reflex
reflux: reflux
reform: reformed,reforming
reformation: reformation
refraction: refraction
refractory: refractory
refrain: refrain
refresh: refresh,refreshed,refreshing
refreshing: refreshing
refreshment: refreshment
refuge: refuge
refugee: refugees
refusal: refusal
refuse: refuse,refused,refusing
refute: refute,refuted,refuting
regain: regain,regained
regal: regal
regality: regalities
regard: regard,regarded
regent: regent
regia: regia
regimen: regimen
region: region,regions
register: register,registered,registers
regret: regret,regretted
regular: regular
regularly: regularly
regulate: regulate,regulated,regulating
regulation: regulation,regulations
reign: reign,reigned,reigning,reigns
rein: reins
reinforce: reinforced,reinforcing
reinforcement: reinforcement,reinforcements
reinstate: reinstated
reject: reject,rejected,rejecting
rejoice: rejoice,rejoiced,rejoicing
rejoin: rejoined
rekindle: rekindled
relapse: relapse,relapsed
relate: relate,relates,relating
relater: relater
relation: relation,relations
relationship: relationship
relative: relative
relax: relaxed,relaxing
relaxation: relaxation,relaxations
release: release,released,releasing
relent: relent,relented,relenting
relentless: relentless
reliance: reliance
relic: relic,relics
relief: relief
relieve: relieve,relieved,relieving
religion: religion
religious: religious
relinquish: relinquish,relinquished,relinquishing
relish: relish
reluctance: reluctance
reluctant: reluctant
reluctantly: reluctantly
rely: rely,relying
remain: remain,remained,remaining,remains
remainder: remainder,remainders
remains: remains
remand: remanded
remark: remark,remarked,remarking,remarks
remarkable: remarkable
remedy: remedies,remedy,remedying
remember: remember,remembered,remembering
remembrance: remembrance,remembrances
remind: remind,reminded
remiss: remiss
remission: remission
remissness: remissness
remit: remit,remitted,remitting
remnant: remnant
remorse: remorse
remote: remote,remotest
remount: remount
removal: removal,removals
remove: remove,removed,removes,removing
remover: removers
remunerative: remunerative
remus: remus
rend: rending
render: render,rendered,rendering
rendering: rendering
rendezvous: rendezvous,rendezvousing
renegade: renegade,renegades
renew: renew,renewed,renewing
renounce: renounce,renounced
renown: renown
renowned: renowned
rent: rent
repair: repair,repaired,repairing
repartee: repartee,repartees
repast: repast,repasts
repay: repaid,repay,repaying
repeal: repeal,repealed,repealing
repeat: repeat,repeated,repeating
repeatedly: repeatedly
repel: repel,repelled,repelling
repent: repent,repented,repenting
repentance: repentance
repeople: repeople,repeopled
repetition: repetition
repine: repined,repining
replace: replacing
replenish: replenished
reply: replied,reply,replying
report: report,reported,reports
repose: repose,reposed
repository: repository
reprehend: reprehended,reprehends
represent: represent,represented,representing,represents
representation: representation,representations
representative: representatives
repress: repress,repressed
reprimand: reprimand,reprimanded
reproach: reproach,reproached,reproaches,reproaching
reproachful: reproachful
reproof: reproof
reprove: reprove,reproved,reproving
reproving: reproving
republic: republic
republican: republican
repudiate: repudiated,repudiating
repudiator: repudiators
repulse: repulse,repulsed,repulsing
reputation: reputation
repute: repute,reputed
reputed: reputed
request: request,requested,requesting,requests
require: require,required,requires,requiring
requisite: requisite,requisites
requital: requital
requite: requite,requited
resalute: resaluted
rescue: rescue,rescued,rescuing
resemblance: resemblance
resemble: resemble,resembled,resembles,resembling
resent: resent,resented,resenting
resentment: resentment,resentments
reserve: reserve,reserves,reserving
reservoir: reservoirs
reside: reside,resided,residing
residence: residence
resident: resident,residents
resign: resign,resigned,resigning
resist: resist,resisted,resisting
resistance: resistance
resolute: resolute
resolution: resolution,resolutions
resolve: resolve,resolved,resolves,resolving
resort: resort,resorted,resorting
resource: resource,resources
respect: respect,respected,respecting,respects
respectable: respectable
respectful: respectful
respectfully: respectfully
respective: respective
respects: respects
respire: respire
respite: respite,respited
respond: responding
rest: rest,rested,resting,rests
restitution: restitution
restive: restive
restless: restless
restoration: restoration
restore: restore,restored,restoring
restrain: restrain,restrained,restraining,restrains
restraint: restraint
result: result
resume: resume,resumed,resuming
retain: retain,retained,retaining,retains
retake: retaken
retaliate: retaliate
retaliation: retaliation
retard: retarded
retarded: retarded
retinue: retinue
retire: retire,retired,retiring
retired: retired
retirement: retirement
retort: retort,retorted,retorts
retraction: retraction
retreat: retreat,retreated,retreating
retrench: retrench,retrenching
retribution: retribution
retributive: retributive
retrieve: retrieve,retrieved
return: return,returned,returning,returns
reunite: reunite,reunited
reveal: reveal,revealed
revel: revel,reveling,revels
revelation: revelations
reveler: revelers
revelling: revelling,revellings
revenge: revenge,revenged
revengeful: revengeful
revenue: revenue,revenues
reverence: reverence,reverenced,reverencing
reverent: reverent
reverse: reverse,reverses
review: review,reviewing,reviews
revile: reviled,reviles,reviling
revilingly: revilingly
revival: revival
revive: revive,revived
revoke: revoked,revoking
revolt: revolt,revolted,revolting,revolts
revolter: revolters
revolution: revolution,revolutions
revolve: revolve,revolved,revolving
revulsion: revulsion
reward: reward,rewarded,rewards
rewarding: rewarding
rex: rex
rhadamanthus: rhadamanthus
rhea: rhea
rhenea: rhenea
rhetoric: rhetoric
rhetorical: rhetorical
rhetorician: rhetorician
rhine: rhine
rhodes: rhodes
rhodian: rhodian
rhodomontade: rhodomontade
rhus: rhus
ribaldry: ribaldry
riband: riband
ribbon: ribbons
rich: rich,richer,richest
riches: riches
richly: richly
richness: richness
rid: rid,ridding
riddle: riddle
ride: ridden,ride,riding,rode
rider: rider,riders
ridicule: ridicule,ridiculed,ridicules,ridiculing
ridiculous: ridiculous
riding: riding
rifle: rifled
rig: rigged
righteous: righteous
rightful: rightful
rightly: rightly
rigid: rigid
rigor: rigor
rigorous: rigorous
rigorously: rigorously
rim: rim
riot: riot
ripe: ripe,riper
ripeness: ripeness
rise: rise,risen,rises,rising,rose
risk: risk,risks
rite: rite,rites
ritual: ritual
rival: rival,rivals
rivalry: rivalry
river: river,rivers
rivulet: rivulet,rivulets
road: road,roads
roam: roam
roar: roar,roaring
roaring: roaring
rob: rob,robbed,robbing
robber: robber,robbers
robbery: robbery
robe: robe,robes
robust: robust
rock: rock,rocks
rocky: rocky
rod: rod,rods
roe: roe
rogue: rogues
roll: roll,rolled,rolling
roller: rollers
rolling: rolling
roman: roman,romans
romance: romance
rome: rome
romulian: romulian
romulus: romulus
roof: roof,roofed,roofs
roomy: roomier
root: root,roots
rope: rope,ropes
rostra: rostra
rotatory: rotatory
rottenness: rottenness
rough: rough,roughest
roughly: roughly
roughness: roughness
roundabout: roundabout
rouse: rouse,roused
rousing: rousing
rout: rout,routs
route: routed
rove: roved
roving: roving
row: row,rowed,rows
rower: rowers
rowing: rowing
roxana: roxana
royal: royal
royally: royally
royalty: royalty
rub: rub,rubbed
rubbish: rubbish
rubble: rubble
rudder: rudders
ruddy: ruddy
rude: rude
rudiment: rudiments
ruffian: ruffian
rugged: rugged
ruggedness: ruggedness
ruin: ruin,ruined,ruining,ruins
ruinous: ruinous
rule: rule,ruled,rules
ruler: ruler,rulers
ruling: ruling
ruminate: ruminating
rumor: rumor,rumors
rumour: rumour
runaway: runaway,runaways
runner: runner,runners
running: running
rupture: rupture
rush: rush,rushed,rushes,rushing
rust: rust
sabine: sabine,sabines
sabines: sabines
sack: sacked,sacks
sacking: sacking
sacra: sacra
sacred: sacred
sacredness: sacredness
sacrifice: sacrifice,sacrificed,sacrifices,sacrificing
sacrificer: sacrificers
sacrilege: sacrilege
sad: sad,sadder,saddest
sadness: sadness
safe: safe,safer,safest
safely: safely
safety: safety
saffron: saffron
sagacious: sagacious
sagacity: sagacity
sage: sage,sages
sagra: sagra
sail: sail,sailed,sailing,sails
sailing: sailing
sailor: sailor,sailors
saite: saite
sake: sake,sakes
salad: salads
salaminian: salaminian
salamis: salamis
salary: salaries
sale: sale,sales
sally: sallied,sallies,sally,sallying
salt: salt,salting
salubrious: salubrious
salutation: salutation
salute: salute,saluted,salutes,saluting
salvation: salvation
salve: salve
sambuca: sambuca
samian: samian
samnite: samnite
samothracian: samothracian
sanctification: sanctification
sanctify: sanctifying
sanction: sanction,sanctions
sanctity: sanctity
sanctuary: sanctuaries,sanctuary
sand: sand
sandy: sandy
sanguine: sanguine
sardinia: sardinia
satiate: satiate,satiated
satiety: satiety
satisfaction: satisfaction
satisfactory: satisfactory
satisfied: satisfied
satisfy: satisfied,satisfy
satrap: satrap,satraps
saturn: saturn
saturnalia: saturnalia
satyr: satyr,satyrs
savage: savage
savageness: savageness
save: save,saved,saves,saving
savior: savior,saviors
saviour: saviour
scabbard: scabbard
scaffold: scaffolds
scale: scaled,scales
scaling: scaling
scandal: scandal
scandalize: scandalized
scandalous: scandalous
scanty: scanty
scar: scar,scars
scarce: scarce
scarcely: scarcely
scarcity: scarcity
scarf: scarf
scarlet: scarlet
scatter: scatter,scattered,scattering
scattered: scattered
scatteringly: scatteringly
scene: scene,scenes
scent: scenting
scepsis: scepsis
scepter: scepter
scheme: schemes
schism: schism
scholar: scholar,scholars
school: school,schools
schoolboy: schoolboys
schooling: schooling
schoolmaster: schoolmaster,schoolmasters
science: science
scientific: scientific
scimitar: scimitars
scoff: scoffed,scoffing
scoffing: scoffing
scoffingly: scoffingly
scold: scold
scope: scope
scorch: scorched,scorching
score: score
scorn: scorn,scorned
scornful: scornful
scornfully: scornfully
scorpion: scorpions
scour: scour,scoured,scouring
scourge: scourge,scourged,scourges,scourging
scout: scout,scouting,scouts
scrape: scrapes
screen: screening
screw: screwed
scrivener: scrivener
scroll: scroll,scrolls
scruple: scruple,scrupled,scruples
scrupulous: scrupulous
scrutiny: scrutiny
scuffle: scuffle
sculpture: sculptures
scurf: scurf
scurrility: scurrility
scurrilous: scurrilous
scythe: scythed,scythes
scythian: scythian
sea: sea,seas
seal: seal,sealed,seals
seam: seam
seaman: seaman,seamen
seamanship: seamanship
seamen: seamen
seamstress: seamstress
seaport: seaport
search: search,searched,searching
seas: seas
seasick: seasick
seaside: seaside
season: season,seasons
seasonable: seasonable
seasonably: seasonably
seat: seat,seated,seating,seats
secession: secession,secessions
secrecy: secrecy
secret: secret,secrets
secretary: secretaries,secretary
secretly: secretly
sect: sect
secure: secure,secured,secures,securing
securely: securely
security: security
sedately: sedately
sedition: sedition,seditions
seditious: seditious
seduce: seduce,seduced
seduction: seductions
sedulously: sedulously
seed: seed,seeds
seek: seek,seeking,sought
seeking: seeking
seer: seer
seige: seige
seize: seize,seized,seizing
seizure: seizure,seizures
seldom: seldom
select: select,selected,selecting
seleucia: seleucia
selfishness: selfishness
selfsame: selfsame
sell: sell,selling,sold
seller: seller
selling: selling
semblance: semblance
senate: senate
senator: senator,senators
send: send,sending,sends
seniority: seniority
senones: senones
sensation: sensation,sensations
sense: sense
senseless: senseless
sensibly: sensibly
sensual: sensual
sentence: sentence,sentenced,sentences
sententious: sententious
sentiment: sentiments
sentinel: sentinel,sentinels
sentry: sentry
separate: separate,separated,separating
separation: separation
september: september
sepulcher: sepulchers
sepulchre: sepulchre
sequani: sequani
sequel: sequel
sequester: sequestered
serene: serene
serenity: serenity
series: series
serpent: serpent
servant: servant,servants
serve: serve,served,serves,serving
service: service,services
serviceable: serviceable
servile: servile
servility: servility
servitude: servitude
servius: servius
session: sessions
sesterce: sesterces
sestertia: sestertia
set: set,sets,setting
setting: setting
settle: settle,settled,settling
settled: settled
settlement: settlement
settler: settlers
seventeen: seventeen
seventeenth: seventeenth
seventh: seventh
sever: severed
severally: severally
severe: severe,severer,severest
severely: severely
severer: severer
severity: severity
sew: sewed,sewn
sex: sex,sexes
sextilis: sextilis
sextus: sextus
shackle: shackled,shackles
shade: shade,shaded
shades: shades
shadow: shadow,shadows
shady: shadiest,shady
shaft: shaft
shake: shake,shaken,shaking,shook
shalt: shalt
shame: shame
shameful: shameful
shamefully: shamefully
shameless: shameless
shape: shape,shaped,shapes,shaping
share: share,shared,shares,sharing
sharer: sharer
sharp: sharp,sharpest
sharpen: sharpened
sharply: sharply
sharpness: sharpness
shatter: shattered
shattered: shattered
shave: shave,shaved
sheaf: sheaves
shear: shorn
sheep: sheep
shelter: shelter,sheltered
shepherd: shepherds
sherd: sherd,sherds
shield: shield,shields
shields: shields
shift: shift,shifted,shifting,shifts
shin: shins
shine: shine,shining,shone
ship: ship,shipped,ships
shipboard: shipboard
shipload: shiploads
shipping: shipping
shipwreck: shipwreck,shipwrecks
shirt: shirts
shock: shock,shocks
shocking: shocking
shoe: shoe,shoes
shoemaker: shoemakers
shoot: shooting,shoots,shot
shooting: shooting
shop: shop,shops
shore: shore,shores
short: short,shorter
shortcoming: shortcomings
shortly: shortly
shortness: shortness
shot: shot
shoulder: shoulder,shoulders
shout: shout,shouted,shouting,shouts
shouting: shouting
shower: shower,showered,showers
shrewdness: shrewdness
shriek: shriek,shrieking
shrine: shrine,shrines
shrink: shrink,shrinking,shrunk
shrub: shrubs
shudder: shudder
shuffle: shuffle,shuffled
shun: shun,shunned
shut: shut,shutting
shyness: shyness
sibyl: sibyl,sibyls
sibylline: sibylline
sibyls: sibyls
sicilian: sicilian,sicilians
sicily: sicily
sick: sick
sickly: sickly
sickness: sickness
sicyonian: sicyonian
sidewards: sidewards
siege: siege,sieges
sigh: sigh,sighs
sight: sight,sights
sign: sign,signs
signal: signal,signals
signalize: signalize,signalized
signally: signally
signet: signet
significance: significance
signification: signification,significations
signify: signified,signifies,signify,signifying
silence: silence,silencing
silent: silent
silently: silently
silenus: silenus
silliness: silliness
silly: silly
silo: silo
silver: silver
silversmith: silversmith
silvia: silvia
similarity: similarity
similitude: similitude
simple: simple
simplicity: simplicity
simply: simply
sincerity: sincerity
sinew: sinews
sing: sang,sing,singing,sung
singer: singers
singing: singing
single: single,singled
singly: singly
singular: singular
singularly: singularly
sink: sank,sink,sinking,sinks,sunk,sunken
sinking: sinking
sir: sir
sire: sires
siren: siren
siris: siris
sister: sister,sisters
sit: sat,sit,sits,sitting
situate: situated
situation: situation
sixteen: sixteen
sixteenth: sixteenth
sixth: sixth
sixtieth: sixtieth
size: size
skewer: skewers
skiff: skiffs
skill: skill
skilled: skilled
skillful: skillful
skillfully: skillfully
skin: skin,skins
skinner: skinners
skirmish: skirmish,skirmished,skirmishes
skirmisher: skirmisher,skirmishers
skirmishing: skirmishing
skirt: skirt,skirts
skull: skull
sky: sky
slack: slacking
slacken: slacken,slackening
slain: slain
slander: slander,slandered,slanders
slanderous: slanderous
slash: slashing
slaughter: slaughter,slaughters
slave: slave,slaves
slavery: slavery
slay: slain,slay
slayer: slayer
slaying: slaying
sleek: sleek
sleep: sleep,sleeping,slept
sleeping: sleeping
slender: slender
slenderly: slenderly
slew: slew
slide: slide
slight: slight,slighted,slighting
slighter: slighter
slime: slime
sling: slinging,slings
slinger: slingers
slink: slinking,slinks
slip: slip,slipped,slipping,slips
slippery: slippery
slope: slope,slopes,sloping
sloth: sloth
slothful: slothful
slow: slow
slowly: slowly
slowness: slowness
sluggish: sluggish
sluggishness: sluggishness
slumber: slumber
smallness: smallness
smart: smart,smarting
smartly: smartly
smell: smell
smile: smile,smiled,smiles,smiling
smilingly: smilingly
smite: smite,smote
smith: smiths
smoke: smoke
smolder: smolder,smoldering
smooth: smooth,smoothed,smoother,smoothing
smoothing: smoothing
smoothly: smoothly
smother: smothered
snake: snake
snarl: snarls
snatch: snatched,snatching
sneer: sneering
sneeze: sneezed
snore: snored
snow: snow,snows
snub: snub
soak: soaked
sober: sober,sobered
soberly: soberly
sobriety: sobriety
social: social
society: societies,society
socrates: socrates
soever: soever
soft: soft,softer,softest
soften: soften,softened,softening
softly: softly
softness: softness,softnesses
soil: soil
sojourn: sojourn,sojourned
solace: solace
solar: solar
solder: solders
soldier: soldier,soldiers
soldiery: soldiery
sole: sole
solely: solely
solemn: solemn
solemnity: solemnities,solemnity
solemnize: solemnize,solemnized
solemnly: solemnly
soli: soli
solicit: solicit,solicited,soliciting
solicitation: solicitation,solicitations
solicitous: solicitous
solicitude: solicitude
solid: solid
solidity: solidity
solitary: solitary
solitude: solitude
solon: solon
solstice: solstice
solus: solus
solve: solve
son: son,sons
song: song,songs
sons: sons
soot: soot
soothe: soothe,soothing
soothsayer: soothsayer,soothsayers
sophene: sophene
sophist: sophist,sophists
sophists: sophists
sophocles: sophocles
sordid: sordid
sordidness: sordidness
sore: sore
sorely: sorely
sorex: sorex
sorrow: sorrow,sorrows
sorrowful: sorrowful
sort: sort,sorts
sot: sot
soter: soter
soul: soul,souls
sound: sound,sounded,sounding,sounds
source: source
sous: sous
south: south
southern: southern
sovereign: sovereign
sovereignty: sovereignty
sow: sow,sowed,sown
sowing: sowing
space: space,spaces
spacious: spacious
spade: spade
spain: spain
spaniards: spaniards
spanish: spanish
spare: spare,spared,sparing
sparing: sparing
sparingly: sparingly
spark: sparks
sparrow: sparrow
sparta: sparta
spartan: spartan,spartans
speak: spake,speak,speaking,speaks,spoke,spoken
speaker: speaker,speakers
speaking: speaking
spear: spear,spears
spearman: spearmen
special: special
specially: specially
species: species
specimen: specimen
specious: specious
speciously: speciously
speck: speck
spectacle: spectacle
spectacles: spectacles
spectator: spectator,spectators
specter: specters
speculation: speculation,speculations
speculative: speculative
speech: speech,speeches
speechless: speechless
speed: speed
speedily: speedily
speedy: speedy
spell: spell
spelling: spelling
spend: spend,spending,spent
sphere: sphere,spheres
spice: spices
spider: spiders
spike: spike
spilt: spilt
spin: spinning
spinning: spinning
spirit: spirit,spirited,spirits
spirited: spirited
spit: spat
spite: spite
spiteful: spiteful
spleen: spleen
splendid: splendid
splendidly: splendidly
splendor: splendor
split: split
spoil: spoil,spoiled,spoiling,spoils,spoilt
spoiled: spoiled
spokesman: spokesman,spokesmen
spolia: spolia
spontaneous: spontaneous
spontaneously: spontaneously
sport: sport,sporting,sports
sportingly: sportingly
sportive: sportive
spot: spot,spots
spread: spread,spreading,spreads
spring: sprang,spring,springs,sprung
springing: springing
springs: springs
sprinkle: sprinkled
spur: spur,spurred,spurring,spurs
spurious: spurious
spurius: spurius
spy: spied,spying
squabble: squabbling
squadron: squadron,squadrons
squall: squall
squander: squandered
square: square
squeak: squeak
squill: squill
stab: stabbed,stabbing
stability: stability
stable: stable
stack: stacks
staff: staff
stag: stag,stags
stage: stage,stages
stagnate: stagnating
staid: staid
stain: stain,stained
stair: stairs
stake: stake,stakes
stall: stalled
stamp: stamp,stamped
stand: stand,standing,stands,stood
standard: standard,standards
stander: standers
standing: standing
staple: staple
star: star,stars
start: start,started,starting
starting: starting
startle: startled
startled: startled
starve: starve,starved,starving
stateliness: stateliness
stately: statelier,stately
statement: statement,statements
stater: staters
statesman: statesman,statesmen
station: station,stationed,stations
stator: stator
statuary: statuaries
statue: statue,statues
stature: stature
statute: statute,statutes
stave: staved,staves
stay: stay,stayed,staying
stayer: stayer
staying: staying
stead: stead
steadfast: steadfast
steadfastly: steadfastly
steadiness: steadiness
steady: steadiest,steady
steal: steal,stealing,stole,stolen
stealing: stealing
stealth: stealth
steam: steaming
steed: steed
steel: steel
steep: steep,steeped,steepest
steepness: steepness
steer: steer,steering
steersman: steersman
stem: stem
step: step,stepped,stepping,steps
stepmother: stepmother
stern: stern,sterns
sternly: sternly
sternness: sternness
steward: steward
stick: stick,sticking,stuck
stiffness: stiffness
stifle: stifle,stifled,stifling
stimulate: stimulate,stimulates,stimulating
stimulus: stimulus
sting: stings,stung
stinginess: stinginess
stint: stinted
stipulate: stipulated
stir: stir,stirred,stirring,stirs
stiria: stiria
stirring: stirring
stock: stock,stocks
stoic: stoic
stomach: stomach
stone: stone,stoned,stones
stony: stony
stool: stool
stoop: stoop,stooped
stoppage: stoppage
storax: storax
store: store,stored,stores
storehouse: storehouses
stork: storks
storm: storm,stormed,storming,storms
stormy: stormy
story: stories,story
stout: stout,stouter,stoutest
stoutly: stoutly
straggle: straggling
straggler: stragglers
straight: straight
straightaway: straightaway
straighten: straighten,straightened
straightforward: straightforward
strain: strain,strained,straining
strait: strait,straits
strand: strand
strange: strange,strangest
strangely: strangely
strangeness: strangeness
stranger: stranger,strangers
strangle: strangled,strangling
stratagem: stratagem,stratagems
straw: straw
stray: strayed
stream: stream,streaming,streams
street: street,streets
strength: strength
strengthen: strengthen,strengthened,strengthening,strengthens
stress: stress
stretch: stretch,stretched,stretching
strew: strewed
strict: strict,strictest
strictly: strictly
strictness: strictness
stricture: strictures
strife: strife
strike: strike,striking,struck
string: string,strings
stringed: stringed
strip: strip,stripped,stripping
stripe: stripes
stripling: stripling
strive: strive,striven,striving,strove
stroke: stroke,stroked,strokes
strong: strong,stronger,strongest
stronghold: strongholds
structure: structure,structures
struggle: struggle,struggled,struggling
strymon: strymon
stubborn: stubborn
stud: studded,studding
studious: studious
studiously: studiously
study: studied,studies,study
stuff: stuff,stuffed
stumble: stumble,stumbled,stumbles
stumbling: stumbling
stun: stunned
stunned: stunned
stupefy: stupefied
stupid: stupid
sturdy: sturdy
style: style,styled,styles,styling
subalpine: subalpine
subdue: subdue,subdued,subduing
subdued: subdued
subject: subject,subjected,subjects
subjection: subjection
subjugate: subjugated
subjugation: subjugation
sublime: sublime
sublimity: sublimity
submission: submission
submissive: submissive
submissively: submissively
submissiveness: submissiveness
submit: submit,submitted,submitting
subordinate: subordinate
suborn: suborned,suborning
subsequent: subsequent
subsequently: subsequently
subservience: subservience
subservient: subservient
subside: subside
subsidy: subsidies
subsist: subsisting
subsistence: subsistence
substance: substance,substances
subtilty: subtilties
subtle: subtle
subtlety: subtleties,subtlety
subtraction: subtraction
suburb: suburb,suburbs
subversion: subversion
subvert: subverted,subverting
succeed: succeed,succeeded,succeeding
success: success,successes
successful: successful
succession: succession,successions
successive: successive
successively: successively
successor: successor,successors
succor: succor,succors
succumb: succumbed
suck: suck,sucked,sucking
suckle: suckle,suckled
suckling: suckling
sudden: sudden
suddenly: suddenly
suddenness: suddenness
sue: sue,sued,suing
suffer: suffer,suffered,suffering,suffers
sufferer: sufferers
suffering: suffering,sufferings
suffice: suffice,sufficed
sufficient: sufficient
suffrage: suffrage,suffrages
suggestion: suggestion,suggestions
suit: suit,suited,suiting,suits
suitable: suitable
suited: suited
suitor: suitor,suitors
sully: sully,sullying
sultry: sultry
sum: sum,sums
summary: summary
summer: summer
summertime: summertime
summit: summit
summon: summon,summoned,summoning
summons: summons
sumpter: sumpter
sumptuary: sumptuary
sumptuosity: sumptuosity
sumptuous: sumptuous
sumptuously: sumptuously
sumptuousness: sumptuousness
sun: sun
sunbeam: sunbeams
sunder: sunder
sundry: sundry
sunny: sunny
sunset: sunset
superadd: superadd
superannuated: superannuated
supercilious: supercilious
superficial: superficial
superficially: superficially
superfluity: superfluities,superfluity
superfluous: superfluous
superintend: superintended
superintendence: superintendence
superior: superior,superiors
superiority: superiority
supernatural: supernatural
superstition: superstition,superstitions
superstitious: superstitious
superstructure: superstructures
supper: supper,suppers
supplant: supplant
supplement: supplement
suppliant: suppliant,suppliants
suppliants: suppliants
supplicate: supplicate
supplication: supplication,supplications
supply: supplied,supplies,supply,supplying
support: support,supported,supporting,supports
supporter: supporter,supporters
suppose: suppose,supposed,supposing
suppress: suppress,suppressed,suppressing
supremacy: supremacy
supreme: supreme,supremest
sura: sura
surely: surely
surety: sureties
surface: surface,surfaces
surfeit: surfeited
surge: surge
surgeon: surgeon,surgeons
surgery: surgery
surmise: surmises
surmount: surmount,surmounted
surname: surname,surnamed
surpass: surpass,surpassed,surpasses,surpassing
surprisal: surprisal
surprise: surprise,surprised,surprising
surprised: surprised
surprising: surprising
surrender: surrender,surrendered,surrendering
surround: surround,surrounded,surrounding
survey: survey,surveyed,surveying
surveyor: surveyor
survive: survive,survived,survives,surviving
surviving: surviving
survivor: survivor,survivors
susceptible: susceptible
suspect: suspect,suspected,suspecting,suspects
suspend: suspend,suspended
suspense: suspense
suspension: suspension
suspicion: suspicion,suspicions
suspicious: suspicious
sustain: sustain,sustained,sustaining
sustained: sustained
sustenance: sustenance
swaddle: swaddling
swaddling: swaddling
swallow: swallow,swallowed,swallowing
swam: swam
swarm: swarm,swarming,swarms
sway: sway,swayed
swear: swear,swearing,swore,sworn
sweat: sweat,sweated
sweep: sweeping,swept
sweet: sweet,sweetest,sweets
sweetmeat: sweetmeat
sweetness: sweetness
swell: swell,swelled
swerve: swerving
swift: swift,swiftest
swiftness: swiftness
swim: swam,swim,swimming
swimming: swimming
swine: swine
swineherd: swineherd
swing: swing
swinging: swinging
swollen: swollen
swoon: swooned
sword: sword,swords
swordsman: swordsmen
sybarite: sybarite
sybarites: sybarites
sycophant: sycophant,sycophants
syllable: syllable
symmetry: symmetry
sympathize: sympathized
sympathy: sympathy
syracusan: syracusan
syracuse: syracuse
syria: syria
syrian: syrian,syrians
syrus: syrus
table: table,tables
tablet: tablet,tablets
tactic: tactics
tail: tail,tails
taint: tainted
tale: tale,tales
talent: talent,talents
talk: talk,talked,talking,talks
talkative: talkative
talkativeness: talkativeness
talker: talkers
talking: talking
tall: tall,taller
talon: talons
tame: tame,tamed,tames
tamely: tamely
tamper: tampered
tanagra: tanagra
tanagraean: tanagraean
taper: taper
tapestry: tapestries,tapestry
tardiness: tardiness
tardy: tardy
tarentine: tarentine
target: target,targets
tarpeia: tarpeia
tarpeian: tarpeian
tarquin: tarquin
tarry: tarried,tarry
tarsus: tarsus
task: task
taste: taste,tasted,tasting
tatian: tatian
taurus: taurus
tavern: tavern,taverns
tax: tax,taxed,taxes
taxation: taxation
teach: taught,teach,teaching
teacher: teacher,teachers
teaching: teaching
team: team,teams
tear: tear,tearing,tears,tore,torn
teat: teat
tectosages: tectosages
tedious: tedious
tediousness: tediousness
teian: teian
telamon: telamon
telemachus: telemachus
telephus: telephus
teles: teles
teller: teller,tellers
tellus: tellus
temerity: temerity
tempe: tempe
temper: temper,tempered,tempers
temperament: temperament,temperaments
temperance: temperance
temperate: temperate
temperately: temperately
tempered: tempered
tempest: tempest,tempests
tempestuous: tempestuous
temple: temple,temples
temporize: temporize
tempt: tempt,tempted,tempting
temptation: temptation,temptations
tenable: tenable
tend: tend,tended,tending
tendency: tendencies,tendency
tender: tender,tendered,tendering
tenderness: tenderness
tenement: tenements
tenor: tenor
tent: tent,tents
tenth: tenth,tenths
term: term,termed,terming,terms
terminate: terminated
terminus: terminus
terrestrial: terrestrial
terrible: terrible
terrified: terrified
terrify: terrified,terrifies,terrify
territory: territories,territory
terror: terror,terrors
tertia: tertia
testament: testament
testify: testified,testifies,testify,testifying
testimony: testimonies,testimony
tethys: tethys
tetrapolis: tetrapolis
teucer: teucer
thankful: thankful
thankfully: thankfully
thargelion: thargelion
thasian: thasian
theater: theater,theaters
theatrical: theatrical
theban: theban
thee: thee
theft: theft,thefts
thenceforward: thenceforward
theologian: theologian
theorem: theorems
theoretic: theoretic
thereabout: thereabout,thereabouts
thericlean: thericlean
therme: therme
theseus: theseus
thesmothetae: thesmothetae
thessalian: thessalian
thicken: thicken
thickly: thickly
thickness: thickness
thief: thief,thieves
thieve: thieving
thigh: thigh,thighed,thighs
thinking: thinking
thirdly: thirdly
thirst: thirst,thirsted
thirsty: thirsty
thirteen: thirteen
thirteenth: thirteenth
thirtieth: thirtieth
thistle: thistle
thither: thither
thong: thong,thongs
thor: thor
thorax: thorax
thorn: thorn
thoughtful: thoughtful
thoughtless: thoughtless
thracian: thracian
thread: thread,threads
threadbare: threadbare
threat: threats
threaten: threaten,threatened,threatening
threatening: threatening
threescore: threescore
threshold: threshold
thrice: thrice
thrifty: thrifty
thriving: thriving
throat: throat
throne: throne
throng: throng,thronged,throngs
throw: threw,throw,throwing,thrown,throws
thrush: thrush,thrushes
thrust: thrust,thrusting
thumb: thumb
thunder: thunder,thundered,thundering,thunders
thunderbolt: thunderbolt,thunderbolts
thunderer: thunderers
thundering: thundering
thy: thy
thyself: thyself
tiara: tiara
tiber: tiber
tiberius: tiberius
tickle: tickled,tickling
tide: tide
tiding: tidings
tie: tie,tied,ties,tying
tight: tight
tigris: tigris
tile: tile,tiles
tillage: tillage
timaeus: timaeus
timber: timber
time: time,timed,times
timely: timely
timid: timid
timidity: timidity
timon: timon
timorous: timorous
timorousness: timorousness
tincture: tincture
tint: tints
tired: tired
title: title,titles
titular: titular
titus: titus
toe: toe
toga: toga
toil: toil,toils
toiling: toiling
toilsome: toilsome
token: token,tokens
tolerable: tolerable
tolerably: tolerably
tomb: tomb,tombs
tombless: tombless
tombs: tombs
tomorrow: tomorrow
tone: tone,tones
tongue: tongue,tongues
tongued: tongued
tonight: tonight
tonsure: tonsure
tool: tool
tooth: teeth
topic: topic
topsy: topsy
torch: torch,torches
torchbearer: torchbearer
torment: torment,tormenting,torments
torn: torn
torrent: torrent,torrents
tortoise: tortoise
torture: torture,tortured,tortures,torturing
toss: toss,tossed,tossing
total: total
totally: totally
totter: tottering
touch: touch,touched,touches,touching
tow: tow
tower: tower,towers
towing: towing
town: town,towns
township: township,townships
townsman: townsman,townsmen
toy: toy
trace: trace,traces
tract: tracts
tractable: tractable
trade: trade,traded,trades
trader: traders
tradesman: tradesmen
trading: trading
tradition: tradition,traditions
traduce: traduced,traducing
traffic: traffic,trafficked
tragedian: tragedian
tragedians: tragedians
tragedy: tragedies,tragedy
tragia: tragia
tragic: tragic
tragical: tragical
trail: trail
train: train,trained
training: training
traitor: traitor,traitors
traitorously: traitorously
trample: trample,trampled,trampling
tranquil: tranquil
tranquility: tranquility
tranquiller: tranquiller
tranquillity: tranquillity
tranquilly: tranquilly
transact: transacted,transacting
transaction: transaction,transactions
transalpine: transalpine
transcend: transcending
transcendent: transcendent
transcribe: transcribe
transfer: transfer,transferred,transferring
transfix: transfixing
transform: transformed
transgress: transgressed
transgression: transgression
translate: translated
transmit: transmitted
transmute: transmuted
transplant: transplanted
transport: transport,transported,transports
transportation: transportation
transpose: transposed
trap: trap
trappings: trappings
travail: travail
travel: travel,traveled,traveling
traveler: travelers
travels: travels
traverse: traversed
treacherous: treacherous
treacherously: treacherously
treachery: treachery
tread: tread,treading,trod
treading: treading
treason: treason
treasonable: treasonable
treasonably: treasonably
treasure: treasure,treasures
treasurer: treasurer,treasurers
treasury: treasury
treat: treat,treated,treating
treatise: treatise,treatises
treatment: treatment
treaty: treaties,treaty
treble: trebled
tree: tree,trees
tremble: tremble,trembling
tremor: tremors
trench: trench,trenches
trepan: trepanned
trial: trial,trials
triangle: triangle
tribe: tribe,tribes
tribunal: tribunal,tribunals
tribune: tribune,tribunes
tribunes: tribunes
tribuneship: tribuneship
tribunician: tribunician
tributary: tributaries
tribute: tribute,tributes
trick: trick,tricks
trickery: trickery
trickle: trickling
trident: trident
trier: triers
trifle: trifle,trifles
trifler: trifler
trim: trimmed
trinket: trinkets
trip: tripping
tripod: tripod,tripods
trireme: trireme
trite: trite
triumph: triumph,triumphed,triumphing,triumphs
triumphal: triumphal
triumphant: triumphant
triumphantly: triumphantly
trivial: trivial
troad: troad
trod: trod
trodden: trodden
troezenian: troezenian
trojan: trojan
troop: troop
troops: troops
trophy: trophies,trophy
troth: troth
trouble: trouble,troubled,troubles
troubled: troubled
troublesome: troublesome
troubling: troubling
trough: trough
troy: troy
truce: truce
true: true,truest
trumpet: trumpet,trumpets
trumpeter: trumpeter,trumpeters
trunk: trunk
trust: trust,trusted,trusting
trustworthy: trustworthy
trusty: trustiest,trusty
truth: truth,truths
tuft: tufted
tuition: tuition
tumble: tumble,tumbled,tumbling
tumor: tumor,tumors
tumult: tumult,tumults
tumultuous: tumultuous
tumultuously: tumultuously
tun: tun
tune: tune
tunic: tunic
tunnel: tunnels
tunny: tunny
turner: turners
turnip: turnips
turvy: turvy
tuscan: tuscan
tuscany: tuscany
tusculan: tusculan
tusk: tusks
tutelar: tutelar
tutor: tutor,tutors
twelfth: twelfth
twentieth: twentieth
twill: twill
twin: twin,twins
twisting: twisting,twistings
tydeus: tydeus
typhon: typhons
tyrannic: tyrannic
tyrannical: tyrannical
tyrannize: tyrannize,tyrannized
tyrannized: tyrannized
tyranny: tyrannies,tyranny
tyrant: tyrant,tyrants
ugly: ugly
ulcerate: ulcerated
ulceration: ulcerations
ulysses: ulysses
umbrella: umbrella
unable: unable
unacceptable: unacceptable
unaccountable: unaccountable
unaccustomed: unaccustomed
unacquainted: unacquainted
unadulterated: unadulterated
unadvantageous: unadvantageous
unadvisedly: unadvisedly
unaffected: unaffected
unagreeable: unagreeable
unalloyed: unalloyed
unambitiously: unambitiously
unanimity: unanimity
unanimously: unanimously
unapproachable: unapproachable
unarmed: unarmed
unassailable: unassailable
unattainable: unattainable
unattended: unattended
unavailable: unavailable
unavailing: unavailing
unavenged: unavenged
unavoidable: unavoidable
unavoidably: unavoidably
unaware: unaware
unawares: unawares
unbar: unbarring
unbecoming: unbecoming
unbegotten: unbegotten
unbending: unbending
unbiased: unbiased
unblemished: unblemished
unblessed: unblessed
unbounded: unbounded
unbridle: unbridle
unbroken: unbroken
unburied: unburied
uncertain: uncertain
uncertainty: uncertainties,uncertainty
unchangeable: unchangeable
uncle: uncle
unclean: unclean
uncleared: uncleared
uncommonly: uncommonly
uncompromising: uncompromising
unconcern: unconcern
unconcerned: unconcerned
uncondemned: uncondemned
unconquerable: unconquerable
unconquered: unconquered
unconstrained: unconstrained
uncontributing: uncontributing
uncontrollable: uncontrollable
uncontrollably: uncontrollably
uncorrupted: uncorrupted
uncounterfeited: uncounterfeited
undaunted: undaunted
undeceived: undeceived
undecided: undecided
undefeated: undefeated
undefended: undefended
undefiled: undefiled
underfoot: underfoot
undergo: undergo,undergone,underwent
underground: underground
underhand: underhand
underlive: underlive
undermine: undermine,undermining
understand: understand,understanding,understood
understanding: understanding,understandings
undertake: undertake,undertaken,undertakes,undertaking,undertook
undertaking: undertaking,undertakings
undeservedly: undeservedly
undesirable: undesirable
undetermined: undetermined
undeviatingly: undeviatingly
undiminished: undiminished
undiscerned: undiscerned
undiscernible: undiscernible
undisciplined: undisciplined
undiscovered: undiscovered
undisordered: undisordered
undistinguished: undistinguished
undisturbed: undisturbed
undivided: undivided
undo: undo,undone
undoubted: undoubted
undoubtedly: undoubtedly
undug: undug
undulled: undulled
unduly: unduly
undying: undying
uneasy: uneasy
unedifying: unedifying
uneffaced: uneffaced
unembodied: unembodied
unemployed: unemployed
unenterprising: unenterprising
unenvied: unenvied
unequal: unequal
unequalness: unequalness
unequivocally: unequivocally
unerring: unerring
uneven: uneven
unexampled: unexampled
unexchanged: unexchanged
unexpected: unexpected
unexpectedly: unexpectedly
unexplored: unexplored
unextinguished: unextinguished
unfair: unfair
unfaithful: unfaithful
unfaithfulness: unfaithfulness
unfastened: unfastened
unfavorable: unfavorable
unfearful: unfearful
unfeminine: unfeminine
unfinished: unfinished
unfit: unfit
unfitness: unfitness
unfold: unfolded
unfortified: unfortified
unfortunate: unfortunate
unfounded: unfounded
unfrequented: unfrequented
unfrequently: unfrequently
unfruitful: unfruitful
unfruitfulness: unfruitfulness
ungained: ungained
ungainly: ungainly
ungarrisoned: ungarrisoned
ungentle: ungentle
ungird: ungird
ungirt: ungirt
ungovernable: ungovernable
ungovernableness: ungovernableness
ungraceful: ungraceful
ungracious: ungracious
ungraciousness: ungraciousness
ungrateful: ungrateful
ungratefully: ungratefully
ungrounded: ungrounded
unguarded: unguarded
unguent: unguent,unguents
unhandsome: unhandsome
unhandy: unhandy
unhappy: unhappy
unhealthy: unhealthy
unheard: unheard
unhesitatingly: unhesitatingly
unhoped: unhoped
unhopeful: unhopeful
unhurt: unhurt
uniformly: uniformly
unimportant: unimportant
unimproved: unimproved
uninhabitable: uninhabitable
uninitiated: uninitiated
uninterested: uninterested
unintermitted: unintermitted
union: union
unit: unit
unite: unite,united,uniting
united: united
unity: unity
universal: universal
universally: universally
universe: universe
unjust: unjust
unjustly: unjustly
unkindly: unkindly
unknowingly: unknowingly
unknown: unknown
unlabored: unlabored
unlawful: unlawful
unlimited: unlimited
unlock: unlock
unlooked: unlooked
unloving: unloving
unluckiness: unluckiness
unlucky: unlucky
unmanageable: unmanageable
unmanly: unmanly
unmanned: unmanned
unmarried: unmarried
unmerciful: unmerciful
unmilitary: unmilitary
unmindful: unmindful
unmistakable: unmistakable
unmixed: unmixed
unmolested: unmolested
unmoved: unmoved
unmuffle: unmuffling
unnatural: unnatural
unnaturally: unnaturally
unnecessarily: unnecessarily
unnecessary: unnecessary
unnerve: unnerve
unnoticed: unnoticed
unobserved: unobserved
unoccupied: unoccupied
unopposed: unopposed
unpeopled: unpeopled
unperceived: unperceived
unperforming: unperforming
unplausibly: unplausibly
unpleasant: unpleasant
unpleasantness: unpleasantness
unpleasing: unpleasing
unpliable: unpliable
unpolluted: unpolluted
unpopular: unpopular
unpopularity: unpopularity
unpracticable: unpracticable
unprepared: unprepared
unprofitable: unprofitable
unprotected: unprotected
unprovided: unprovided
unprovoked: unprovoked
unpruned: unpruned
unpunished: unpunished
unquestioned: unquestioned
unquiet: unquiet
unravel: unravel
unreasonable: unreasonable
unrefined: unrefined
unreserved: unreserved
unresisted: unresisted
unresolved: unresolved
unrevenged: unrevenged
unrighteous: unrighteous
unruly: unruly
unsafe: unsafe
unsanctify: unsanctify
unsanctioned: unsanctioned
unsated: unsated
unsatiable: unsatiable
unsatisfied: unsatisfied
unscrupulous: unscrupulous
unseasonable: unseasonable
unseasonably: unseasonably
unseemly: unseemly
unseen: unseen
unserviceable: unserviceable
unsettle: unsettled
unsettled: unsettled
unsew: unsewed
unshackle: unshackled
unsheathe: unsheathed
unshrink: unshrinking
unsightly: unsightly
unskilled: unskilled
unskillful: unskillful
unskillfulness: unskillfulness
unsociable: unsociable
unsocial: unsocial
unsound: unsound
unsown: unsown
unsparingly: unsparingly
unspeakable: unspeakable
unspotted: unspotted
unsubdued: unsubdued
unsuccessful: unsuccessful
unsuccessfully: unsuccessfully
unsuitable: unsuitable
unsuspected: unsuspected
untainted: untainted
unthought: unthought
untie: unties
untilled: untilled
untimely: untimely
untouched: untouched
untoward: untoward
untowardly: untowardly
untractable: untractable
untrained: untrained
untroubled: untroubled
untrue: untrue
untruly: untruly
unused: unused
unuseful: unuseful
unusual: unusual
unusually: unusually
unwarily: unwarily
unwarlike: unwarlike
unwearied: unwearied
unwieldy: unwieldy
unwilling: unwilling
unwillingly: unwillingly
unwillingness: unwillingness
unwisely: unwisely
unwittingly: unwittingly
unworthily: unworthily
unworthy: unworthy
unwritten: unwritten
upbraid: upbraid,upbraided,upbraiding
upbraiding: upbraiding
uphold: upheld,uphold
upper: upper
upright: upright
uprightly: uprightly
uprightness: uprightness
uproar: uproar,uproars
upset: upset
upstart: upstarts
upward: upward
urge: urge,urged,urges,urging
urgency: urgency
urgent: urgent
urn: urn
usage: usage,usages
useless: useless
usher: ushered
usual: usual
usurer: usurers
usurp: usurp,usurped,usurping
usurpation: usurpation,usurpations
usurper: usurper,usurpers
usury: usury
utensil: utensils
utility: utility
utmost: utmost
utter: utter,uttered,uttering,utters
utterly: utterly
vacancy: vacancies
vacant: vacant
vacuum: vacuum
vague: vague
vain: vain
vainglorious: vainglorious
vainglory: vainglory
vainly: vainly
valeria: valeria
valiant: valiant
valiantly: valiantly
valley: valley,valleys
valor: valor
valuable: valuable,valuables
valuation: valuation
van: van
vanguard: vanguard
vanish: vanished,vanishing
vanity: vanity
vanquish: vanquish,vanquished,vanquishing
vantage: vantage
vapor: vapor,vapors
variable: variable
variance: variance
variation: variations
variety: varieties,variety
variously: variously
vary: varied,varies,vary,varying
vassalage: vassalage
vast: vast
vastness: vastness
vaunt: vaunting,vaunts
vegetable: vegetables
vehemence: vehemence
vehement: vehement
vehemently: vehemently
veil: veil
velatura: velatura
velum: velum
venerable: venerable
veneration: veneration
vengeance: vengeance
venison: venison
venomous: venomous
venous: venous
vent: vent,vented
venture: venture,ventured,ventures,venturing
venturous: venturous
venus: venus
verbal: verbal
verdict: verdict
verge: verge,verged,verges
verification: verification
verify: verified
verily: verily
verse: verse,versed,verses
verses: verses
vertebra: vertebrae
vessel: vessel,vessels
vesta: vesta
vestal: vestal,vestals
vestment: vestments
vex: vexed
vexation: vexation,vexations
vexatious: vexatious
vica: vica
vice: vice,vices
vicious: vicious
viciousness: viciousness
vicissitude: vicissitude,vicissitudes
victim: victim,victims
victor: victor,victors
victorious: victorious
victoriously: victoriously
victory: victories,victory
victuals: victuals
vie: vie,vying
view: view,viewed,viewing,views
vigilance: vigilance
vigilant: vigilant
vigor: vigor
vigorous: vigorous
vigorously: vigorously
vile: vile,vilest
vilely: vilely
villa: villa
village: village,villages
villain: villain,villains
villainous: villainous
villainy: villainies,villainy
vindicate: vindicate
vindication: vindication
vindicta: vindicta
vindictiveness: vindictiveness
vine: vine,vines
vinegar: vinegar
vineyard: vineyard,vineyards
vintner: vintner
violate: violate,violated,violating
violation: violation
violence: violence
violent: violent
violently: violently
virgin: virgin,virgins
virginity: virginity
virtue: virtue,virtues
virtuous: virtuous
virulent: virulent
visible: visible
visibly: visibly
vision: vision,visions
visit: visit,visited,visiting,visits
visitor: visitor,visitors
visor: visor
vital: vital
vitality: vitality
vivid: vivid
vividly: vividly
vocal: vocal
vocation: vocation
voice: voice,voices
void: void
volscian: volscian
volubility: volubility
volume: volumes
voluntarily: voluntarily
voluntary: voluntary
volunteer: volunteers
voluptuousness: voluptuousness
votary: votaries
vote: vote,voted,votes,voting
voting: voting
vouch: vouched
voucher: vouchers
vouchsafe: vouchsafe,vouchsafed
vow: vow,vowed,vowing,vows
voyage: voyage,voyages
vulcan: vulcan
vulgar: vulgar
vulgarly: vulgarly
vulture: vulture,vultures
wade: wading
waft: wafting
wage: wage,waged,waging
waggoner: waggoners
wagon: wagon,wagons
waist: waist
wait: wait,waited,waiting
waiter: waiter
waiting: waiting
waive: waive
wake: wake,waking
wakeful: wakeful
walk: walk,walked,walking,walks
wall: wall,walling,walls
walled: walled
wand: wand
wander: wander,wandered,wandering
wanderer: wanderer
wanderings: wanderings
wane: wane
wanton: wanton,wantoning
wantonly: wantonly
wantonness: wantonness
war: war,warring,wars
wardship: wardship
wares: wares
warfare: warfare
warily: warily
wariness: wariness
warlike: warlike
warm: warm,warmed,warmer,warmest
warmth: warmth
warn: warn,warned,warning
warning: warning
warrant: warranted
warrior: warrior,warriors
wart: wart
wary: wary
wash: wash,washed,washes,washing
waste: waste,wasted,wasting
watch: watch,watched,watches,watching
watchful: watchful
watchtower: watchtower
water: water,watered,watering,waters
watercourse: watercourse,watercourses
watering: watering
waters: waters
watery: watery
wave: waved,waves,waving
wavy: wavy
weak: weak,weaker,weakest
weaken: weaken,weakened,weakening
weakly: weakly
weakness: weakness,weaknesses
wealth: wealth
wealthy: wealthier,wealthiest,wealthy
weapon: weapon,weapons
wear: wear,wearing,wears,wore,worn
wearied: wearied
weariness: weariness
wearisome: wearisome
weary: wearied,weary
weather: weather
wedding: wedding,weddings
wedge: wedged,wedges
wedlock: wedlock
wee: wee
week: week
weep: weep,weeping,wept
weigh: weigh,weighed,weighing
weight: weight,weights
weighty: weighty
welcomely: welcomely
welfare: welfare
wellnigh: wellnigh
west: west
westward: westward
wet: wet
whatsoever: whatsoever
wheat: wheat
wheel: wheel,wheeled,wheeling,wheels
whelp: whelp,whelps
whensoever: whensoever
wherefore: wherefore
whereof: whereof
wheresoever: wheresoever
whet: whetted
whetted: whetted
whip: whip,whipped,whipping,whips
whipping: whipping
whirl: whirl,whirled
whirlpool: whirlpools
whirlwind: whirlwind
whisper: whisper
white: white
wholesome: wholesome
wholly: wholly
whomsoever: whomsoever
whosoever: whosoever
wicked: wicked
wickedness: wickedness
wicker: wicker
wide: wide
widow: widow,widows
widower: widower
widowhood: widowhood
wield: wielding
wife: wife,wives
wild: wild
wilderness: wilderness
wildest: wildest
wildly: wildly
wildness: wildness
willed: willed
willful: willful
willingly: willingly
willingness: willingness
win: win,winning
wind: wind,winding,winds
winding: windings
window: window
windy: windy
wine: wine
wing: wing,wings
wink: winked
winter: winter,wintered,wintering,winters
wintertime: wintertime
wipe: wipe,wiped
wisdom: wisdom
wise: wise,wiser,wisest
wisely: wisely
wisher: wishers
wistfully: wistfully
wit: wit,wits
withal: withal
withdraw: withdraw,withdrawing,withdrawn,withdrew
wither: wither,withered
withered: withered
withhold: withheld,withhold,withholding
withstand: withstand,withstanding,withstood
witness: witness,witnessed,witnesses,witnessing
witted: witted
witty: witty
woe: woe
wolf: wolf,wolves
woman: woman,women
womanish: womanish
womanishness: womanishness
womb: womb
women: women
wonderful: wonderful
wonderfully: wonderfully
wondrously: wondrously
wood: wood,woods
wooded: wooded
wooden: wooden
woodpecker: woodpecker
woody: woody
wool: wool
woolen: woolen
word: word
wording: wording
worker: workers
workhouse: workhouse
workman: workman,workmen
workmanship: workmanship
workpeople: workpeople
workshop: workshops
worldly: worldly
worn: worn
worry: worry
worship: worship,worshiped,worshiping,worshipped
worshiper: worshiper,worshipers
worshipper: worshippers
worst: worsted
worth: worth
worthily: worthily
worthwhile: worthwhile
worthy: worthier,worthiest,worthy
wound: wound,wounded,wounding,wounds
wounded: wounded
wrap: wrapped,wrapping
wrapt: wrapt
wrath: wrath
wreak: wreaked,wreaking
wreath: wreath,wreaths
wreck: wreck,wrecked
wrest: wrested,wresting
wrestle: wrestle,wrestled
wrestler: wrestler,wrestlers
wrestling: wrestling,wrestlings
wretch: wretch,wretches
wretched: wretched
wretchedly: wretchedly
wretchedness: wretchedness
writ: writ
write: write,writes,writing,written,wrote
writer: writer,writers
writing: writing
writings: writings
wrong: wrong,wronged,wronging,wrongs
wrongdoer: wrongdoer
yearly: yearly
yellow: yellow
yesterday: yesterday
yield: yield,yielded,yielding
yoke: yoke,yoking
yore: yore
youngster: youngster
youth: youth,youths
youthful: youthful
youthfully: youthfully
zeal: zeal
zealous: zealous
zealously: zealously
zenith: zenith
zone: zone
zoroaster: zoroaster
