aback: aback
abash: abash
abate: abate,abated
abbey: abbey
abernethy: abernethy
aberration: aberrations
abettor: abettors
abeyance: abeyance
abhor: abhor
abhorrence: abhorrence
abide: abide
ability: ability
abjure: abjure
ablutions: ablutions
abode: abode,abodes
abolish: abolish
abolition: abolition
abominable: abominable
abortion: abortions
abound: abound,abounded,abounds
abreast: abreast
absence: absence,absences
absent: absent
absentee: absentees
absolute: absolute
absolution: absolution
absorb: absorb
abstain: abstain
abstract: abstract
abstraction: abstraction
abstruse: abstruse
absurd: absurd
absurdity: absurdity
abuse: abuse,abused,abuses
abyss: abyss
academic: academic
academician: academicians
accent: accent,accents
accept: accept
acceptation: acceptation
accessary: accessaries
accessory: accessory
accident: accident
acclamation: acclamation
accompany: accompanied,accompany
accomplish: accomplish
accomplishment: accomplishment,accomplishments
accord: accord,accorded,accords
account: account,accounts
accredit: accredited
accurate: accurate
accurately: accurately
accurse: accursed
accusal: accusals
accuse: accuse,accused
accustom: accustom
achates: achates
ache: ache,aches
achieve: achieved
achilles: achilles
achitophel: achitophel
acid: acids
acknowledge: acknowledge,acknowledged
acorn: acorn
acquaint: acquainted
acquaintance: acquaintance
acquiesce: acquiesced
acquire: acquire,acquired
acquit: acquitted
acres: acres
acropolis: acropolis
action: action,actions
actium: actium
active: active
activity: activity
actor: actor,actors
actual: actual
acute: acute,acutest
adam: adam
adamant: adamant
adams: adams
adapt: adapted
add: add,adding,adds
addio: addio
addison: addison
addition: addition,additions
additional: additional
address: address,addresses,addressing
adeline: adeline
adept: adept
adieu: adieu
admirable: admirable
admiral: admiral
admiration: admiration,admirations
admire: admire,admired,admires,admiring
admired: admired
admit: admit,admits,admitted
admonition: admonition
adoration: adoration
adore: adore,adored,adores
adorn: adorn,adorning
adrian: adrian
adulate: adulate
adulteration: adulteration
adultery: adultery
advance: advance,advanced,advances,advancing
advanced: advanced
advantage: advantage,advantages
adventure: adventures
adventurous: adventurous
adversity: adversity
advertise: advertise
advertisement: advertisement
advice: advice
advise: advise,advised
advocate: advocates
aeolian: aeolian
aerial: aerial
afar: afar
affair: affair,affairs
affect: affect
affectation: affectation
affection: affection
affidavit: affidavit
afflict: afflicting
afford: afford,affording,affords
affright: affright
affront: affront,affronting
afloat: afloat
aforesaid: aforesaid
afraid: afraid
afric: afric
africa: africa
aft: aft
afternoon: afternoon,afternoons
aftertime: aftertimes
afterward: afterward
agacerie: agacerie
agamemnon: agamemnon
age: age,ages
aged: aged
agent: agent
ages: ages
aggravate: aggravate
aggregate: aggregate
aghast: aghast
agitate: agitated
agitated: agitated
agonise: agonised
agonising: agonising
agony: agonies,agony
agrarian: agrarian
agree: agree,agreed,agreeing
agreeable: agreeable
aground: aground
ague: ague
aguish: aguish
aid: aid,aided,aids
aigrette: aigrette
ail: ails
aim: aim
air: air,airs
airy: airiest,airy
aisle: aisle
ajar: ajar
ajax: ajax
alabaster: alabaster
alack: alack
alacrity: alacrity
aladdin: aladdin
alarm: alarm
alarming: alarming
alas: alas
albeit: albeit
albion: albion
alchymy: alchymy
alcibiades: alcibiades
alderman: alderman
ale: ale
alert: alert
alexander: alexander
alfonso: alfonso
algiers: algiers
alicant: alicant
alight: alight,alighting
alike: alike
aliquid: aliquid
alive: alive
alkali: alkali
allah: allah
allay: allay
allegory: allegory
aller: aller
alley: alley
alliance: alliance,alliances
allotment: allotment
allowance: allowance,allowances
alloy: alloy
allude: alluded
allure: allure,allured,allures
allusion: allusions
ally: allied,allies,ally
alma: alma
almighty: almighty
aloft: aloft
aloof: aloof
aloud: aloud
alpha: alpha
alphabet: alphabet
alpine: alpine
altar: altar,altars
alter: alter,altering
alteration: alterations
altogether: altogether
amateur: amateur
amatory: amatory
amazing: amazing
amazon: amazon
ambassador: ambassadors
amber: amber
ambiguous: ambiguous
ambition: ambition
amble: amble
ambo: ambo
ambrosial: ambrosial
ambush: ambush
amen: amen
amend: amend,amends
america: america
amiable: amiable
amiably: amiably
amiss: amiss
amor: amor
amorous: amorous
amort: amort
amphibious: amphibious
amphitheatre: amphitheatre
ample: ample
amplify: amplify
amuse: amuse,amused
amusement: amusement
anacreon: anacreon
analogy: analogies,analogy
analyse: analyse
anatomical: anatomical
anatomy: anatomy
ancestor: ancestors
anchor: anchor
anchorite: anchorite
ancient: ancient
ancona: ancona
andalusian: andalusian
anecdote: anecdote
anent: anent
angel: angel,angels
anger: anger
angle: angle,angles
angles: angles
anglice: anglice
angling: angling
angry: angry
anguish: anguish
animal: animal,animals
animate: animated
animation: animation
animosity: animosity
animus: animus
ankle: ankle,ankles
annalist: annalists
annals: annals
annex: annex
annihilate: annihilated,annihilates
annoy: annoy
annuity: annuities
annul: annul
anomaly: anomaly
anon: anon
anonymous: anonymous
answer: answer,answering,answers
answerless: answerless
antechamber: antechamber
antelope: antelope
anthem: anthem
anthony: anthony
anthropophagi: anthropophagi
antic: antic
anticipate: anticipate,anticipated,anticipating
antipathy: antipathy
antipode: antipodes
antiquarian: antiquarians
antique: antique
antithesis: antithesis
antonia: antonia
antony: antony
antre: antres
anvil: anvil
anxiety: anxiety
anxious: anxious
anywise: anywise
apace: apace
apartment: apartment,apartments
apathy: apathy
ape: ape,apes
apiece: apiece
apollo: apollo
apologue: apologue
apology: apologies,apology
apoplectic: apoplectic
apostasy: apostasy
apostle: apostle
apostles: apostles
apostrophe: apostrophe
apothecary: apothecary
appal: appal,appals
apparatus: apparatus
apparel: apparel
apparent: apparent
appeal: appeal,appealed,appeals
appearance: appearance,appearances
appellant: appellants
appendage: appendage
appendix: appendix
appetite: appetite,appetites
applaud: applauds
applause: applause
apple: apple,apples
application: application
apply: applied,apply
appointment: appointment
apprehension: apprehensions
apprehensive: apprehensive
approach: approach,approaching
approbation: approbation
appropriately: appropriately
approve: approve,approved
approver: approver
apropos: apropos
apt: apt
aqua: aqua
arab: arab,arabs
arabia: arabia
arable: arable
araminta: araminta
arcade: arcades
arcadian: arcadians
arcanum: arcanum
arch: arch,arches
archdeacon: archdeacon
archer: archer
archimedes: archimedes
architect: architect
architecture: architecture
ardent: ardent
ardour: ardour
argo: argo
argument: argument,arguments
argus: argus
ariel: ariel
aristippus: aristippus
aristocracy: aristocracy
aristocratic: aristocratic
aristotle: aristotle
arithmetic: arithmetic
arithmetician: arithmetician
ark: ark
arm: arm,arms
armenian: armenian
armida: armida
armistice: armistice
armour: armour
army: armies,army
aroint: aroint
aroynt: aroynt
arrange: arrange,arranging
arras: arras
array: array,arrays
arrest: arrest
arrival: arrival,arrivals
arrive: arrive,arrived,arrives,arriving
arrow: arrow,arrows
art: art,arts
artery: artery
article: article,articles
artificial: artificial
artillery: artillery
artist: artists
artless: artless
artlessly: artlessly
ascendance: ascendance
ascertain: ascertain
ascetic: ascetic
ash: ashes
ashamed: ashamed
ashore: ashore
asia: asia
asian: asian
asiatic: asiatic
askance: askance
asleep: asleep
asp: asp
aspect: aspect,aspects
aspirant: aspirant
aspiration: aspirations
ass: ass,asses
assail: assail
assailant: assailant
assault: assault,assaults
assemble: assembled
assembly: assemblies
assert: assert
assertion: assertion
asset: assets
assist: assist,assisted
assistance: assistance
assuage: assuage
assuaging: assuaging
assume: assume,assumed
assurance: assurance
assure: assure,assured
assured: assured
astonish: astonish
astray: astray
astringent: astringent
astronomer: astronomer
astronomy: astronomy
asunder: asunder
atalantis: atalantis
athens: athens
athwart: athwart
atlantic: atlantic
atlas: atlas
atmosphere: atmosphere
atmospheric: atmospheric
atom: atoms
atrocious: atrocious
atropos: atropos
attach: attach,attaches
attack: attack,attacking
attain: attain,attaining
attempt: attempt,attempting
attend: attend,attends
attendance: attendance
attendant: attendant,attendants
attention: attention,attentions
attest: attests
attic: attic
attitude: attitude
attorney: attorney
attorneys: attorneys
attract: attract,attracts
attraction: attraction,attractions
attractive: attractive
attune: attuned
auburn: auburn
auction: auction,auctions
auctioneer: auctioneer
aught: aught
augur: augur
augury: augury
august: august
augustine: augustine
augustus: augustus
auld: auld
aunt: aunt,aunts
aurora: aurora
austere: austere
austerity: austerities,austerity
author: author,authors
authority: authority
autocrat: autocrat
autocratic: autocratic
autumn: autumn
avail: avail
avant: avant
avarice: avarice
ave: ave
avenge: avenge,avenged,avenges
avenger: avenger
aver: aver
average: average,averaged
averse: averse
aversion: aversion,aversions
avoid: avoided
avouch: avouch
avow: avow
await: await,awaits
awake: awake,awakes,awoke
awaken: awaken
award: award
aware: aware
awe: awe
awed: awed
awful: awful
awkward: awkward
awry: awry
axiom: axiom
axis: axis
ay: ay
azure: azure
baba: baba
babe: babe,babes
babel: babel
baby: babies,baby
babylon: babylon
babylonian: babylonian
bacchanal: bacchanal
bacchant: bacchant
bacchante: bacchante
bacchus: bacchus
bachelor: bachelor
backgammon: backgammon
background: background
bacon: bacon
bad: bad,worse,worst
badly: badly,worse
baffle: baffled
bag: bag,bags
baggage: baggage
bah: bah
bail: bail
baillie: baillie
bait: bait,baiting,baits
bake: baked,baking
balaam: balaam
balance: balance,balancing
bald: bald
baldness: baldness
bale: bale,bales
balk: balk
ball: ball,balls
ballad: ballad,ballads
ballast: ballast
ballet: ballet
balloon: balloon,balloons
balm: balm
baltic: baltic
bamboo: bamboo
ban: ban,bans
band: band,bands
bandage: bandage,bandages
banish: banish
banishment: banishment
bank: bank,banks
banker: banker
banner: banner,banners
banquet: banquet,banquets
banquo: banquo
baptize: baptize,baptized
bar: bar,bars
barb: barb
barbadoes: barbadoes
barbarian: barbarian
barbaric: barbaric
barbarous: barbarous
barber: barbers
barbette: barbette
bard: bard,bards
bare: bare,bared
bargain: bargain,bargains
barge: barge
baring: baring
baritone: baritone
bark: bark
barometer: barometer
baron: baron,barons
barouche: barouche
barrack: barrack
barracks: barracks
barrel: barrel,barrels
barren: barren
barrow: barrow,barrows
barter: barters
bartholomew: bartholomew
bas: bas
base: base,based
baser: baser
bashaw: bashaw
bashfully: bashfully
basin: basin,basins
basis: basis
bask: bask,basking
basket: basket
bass: bass
bastion: bastion,bastions
batch: batch,batches
bate: bate
bath: bath,bathing,baths
bather: bathers
bathing: bathing
bathos: bathos
battalion: battalion
batter: batter,battering,batters
battery: batteries,battery
battle: battle,battled,battles,battling
bauble: baubles
bawler: bawlers
bay: bay,bays
baying: baying
bayonet: bayonet,bayonets
beach: beach
beacon: beacons
bead: beads
beak: beak
beaker: beakers
beam: beam,beams
bear: bear,bearing,bears,bore,born,borne
bearable: bearable
beard: beard,bearded,beards
beardless: beardless
bears: bears
beast: beast,beasts
beat: beat,beaten,beating,beats
beatrice: beatrice
beatus: beatus
beau: beau
beauteous: beauteous
beautiful: beautiful
beautifully: beautifully
beauty: beauties,beauty
becalm: becalm
becasse: becasse
becket: becket
beckon: beckon
bed: bed,beds
bedding: bedding
bedew: bedew
bedlam: bedlam
bedral: bedral
bee: bee,bees
beef: beef
beer: beer
befall: befall,befallen,befell
befringe: befringe
beg: beg,begging
beget: begot,begotten
beggar: beggar
beginner: beginner,beginners
begone: begone
begot: begot
begotten: begotten
beguile: beguiled
behalf: behalf
behave: behave,behaved
behaviour: behaviour
beheld: beheld
behold: beheld,behold,beholding,beholds
beholder: beholder,beholders
beleaguer: beleaguer
belie: belie
belief: belief
believer: believer,believers
bell: bell,bells
bella: bella
belle: belle
belli: belli
bellona: bellona
bellow: bellow
belong: belong,belongs
belove: beloved
beloved: beloved
belshazzar: belshazzar
belt: belt
bench: bench,benches
bend: bend,bended,bending,bent
bender: bender
bene: bene
beneath: beneath
benefactress: benefactress
benefit: benefit
benevolent: benevolent
benign: benign
benison: benison
bent: bent
benumb: benumb
bereft: bereft
berkeley: berkeley
berlin: berlin
berry: berry
berth: berth,berths
beseech: beseech,beseeching
beseem: beseem
beset: beset
besiege: besiege,besieging
besmear: besmear
besom: besom
bespeak: bespeak,bespoke
bespoke: bespoke
besprent: besprent
bestow: bestow,bestows
bet: bet,bets
beta: beta
betake: betake
bete: bete
bethought: bethought
betide: betide
betime: betimes
betoken: betoken
betray: betray,betraying,betrays
betters: betters
betwixt: betwixt
beverage: beverage
bevy: bevy
bewail: bewail
beware: beware
bewilder: bewilder
bewildering: bewildering
bewitch: bewitch
bewitching: bewitching
bey: bey
bezonian: bezonian
bias: bias
bible: bible
bid: bade,bid,bidding,bids
bidder: bidder
bidding: bidding
bienseance: bienseance
bigamy: bigamy
bigot: bigots
bile: bile
bilious: bilious
billet: billets
billiards: billiards
billingsgate: billingsgate
billow: billow,billows
billows: billows
bills: bills
billy: billy
bin: bin
bind: bind,bound
biography: biography
bird: bird,birds
biron: biron
birth: birth,births
birthday: birthday,birthdays
birthright: birthright
bis: bis
biscuit: biscuit
bishop: bishop,bishops
bit: bit,bits
bitch: bitches
bite: bite,bites
bitter: bitter,bitterest
bitters: bitters
bl: blest
black: black,blackest,blacks
blackbird: blackbird,blackbirds
blackguard: blackguards
blackguards: blackguards
blacking: blacking
blackleg: blackleg
blackly: blackly
blacksmith: blacksmith
blade: blade,blades
blair: blair
blamable: blamable
blame: blame,blamed
bland: bland
blank: blank
blanket: blanket,blankets
blase: blase
blaspheme: blaspheme,blasphemed
blasphemy: blasphemies,blasphemy
blast: blast,blasted
blaze: blaze,blazed
blazon: blazon
bleak: bleak
bleakness: bleakness
bleed: bled,bleed
bleeding: bleeding
blend: blend,blended,blending
bless: bless,blessed,blesses,blest
blessed: blessed
blessedness: blessedness
blessing: blessing
blest: blest
blight: blight,blighted
blind: blind
blindly: blindly
blindness: blindness
bliss: bliss,blisses
blister: blister
bloated: bloated
block: blocks
blockhead: blockhead
blonde: blonde
blood: blood
blooded: blooded
bloodless: bloodless
bloodshot: bloodshot
bloody: bloodier,bloody
bloom: bloom,blooming
blossom: blossom,blossoms
blow: blew,blow,blowing,blown,blows
blowing: blowing
blown: blown
blucher: blucher
blue: blue,bluer
bluely: bluely
blues: blues
blunder: blunder,blundering,blunders
blunt: blunt
blush: blush,blushes,blushing
boa: boa
boar: boars
board: board,boards
boast: boast,boasts
boat: boat,boats
boatman: boatman
bob: bob
boccaccio: boccaccio
bode: bode,boded
bodice: bodices
boding: boding
body: bodies,body
boeotian: boeotian
bog: bog
boggy: boggy
bogle: bogle
bohea: bohea
boil: boil,boiling,boils
bold: bold
boldly: boldly
bolero: bolero
bologna: bologna
bolt: bolt,bolted,bolts
bolus: bolus
bomb: bomb,bombs
bombard: bombard
bombazeen: bombazeen
bon: bon
bond: bond,bonds
bondage: bondage
bone: bone,bones
bonfire: bonfires
bonne: bonne
bonnet: bonnet,bonnets
bonos: bonos
bony: bony
booby: boobies,booby
book: book,books
bookish: bookish
boom: booms
booming: booming
boon: boon
boor: boors
boot: boot
booty: booties,booty
booze: booze
border: border
bore: bore,bores
borealis: borealis
bored: bored
bores: bores
borough: borough,boroughs
borrow: borrow,borrowing
bos: bos
bosom: bosom,bosoms
botany: botany
botch: botching
bother: bothers
bottle: bottle,bottles
boudoir: boudoir
bough: bough,boughs
bound: bound,bounded,bounding,bounds
boundary: boundary
boundless: boundless
bounty: bounties,bounty
bourn: bourn
bout: bout,bouts
bow: bow,bows
bowels: bowels
bower: bower,bowers
bowl: bowl
bowsprit: bowsprit
bowstring: bowstring
bowstrung: bowstrung
box: box,boxes
boxer: boxer
boxing: boxing
boy: boy,boys
boyhood: boyhood
boyish: boyish
brace: brace
bracelet: bracelet
brahmins: brahmins
braid: braids
brain: brain,brains
brake: brake
branch: branch,branches
branching: branching
branchless: branchless
brand: brands
brandy: brandy
bras: bras
brass: brass
brat: brats
brave: brave,bravest
bravely: bravely
bravura: bravuras
brazen: brazen
brazils: brazils
breach: breach
bread: bread
breadth: breadth
break: break,breaking,breaks,broke,broken
breaker: breaker,breakers
breakfast: breakfast
breaking: breaking
breast: breast,breasts
breath: breath
breathe: breathe,breathed,breathes,breathing
breathing: breathing
breathless: breathless
breech: breech
breeches: breeches
breed: bred,breed,breeding,breeds
breeding: breeding
breeze: breeze
brethren: brethren
brevity: brevity
brew: brew
brewing: brewing
briareus: briareus
bribe: bribe,bribed,bribes,bribing
brick: brick,bricks
bricklayer: bricklayer
bridal: bridal
bride: bride,brides
bridegroom: bridegrooms
bridge: bridge,bridges
bridle: bridled
brig: brig
brigadier: brigadier,brigadiers
brigantine: brigantine
bright: bright,brighter,brightest
brighten: brighten
brightly: brightly
brightness: brightness
brilliant: brilliant
brim: brim
brimstone: brimstone
bring: bring,bringing,brings,brought
brink: brink
brisk: brisk
briskly: briskly
bristle: bristling
britain: britain
britannia: britannia
british: british
briton: briton
britons: britons
brittle: brittle
broad: broad
broadcloth: broadcloth
broaden: broadening
broadly: broadly
broadside: broadside
broil: broiling
broke: broke
broken: broken
bronze: bronze,bronzed
brood: brooded,brooding,broods
brooding: brooding
brook: brook,brooked,brooks
broom: broom
broth: broth
brother: brother,brothers
brotherly: brotherly
brow: brow,brows
brown: brown
browse: browses
brunette: brunette
brush: brush,brushes
brussels: brussels
brutal: brutal
brute: brute,brutes
brutus: brutus
bubble: bubble,bubbles,bubbling
buck: buck
bud: bud
budding: budding
buff: buff
buffo: buffo
buffoon: buffoon,buffoons
bugle: bugle
build: build,builds,built
building: building,buildings
bulk: bulk
bulky: bulky
bull: bull
bullet: bullet,bullets
bulletin: bulletin,bulletins
bullfinch: bullfinch
bully: bullied,bully
bumper: bumper,bumpers
bungler: bungler
buoy: buoy
buoyant: buoyant
burden: burden,burdens
burgage: burgage
burglariously: burglariously
burgoyne: burgoyne
burgundy: burgundy
burial: burial
burlesque: burlesque
burn: burn,burned,burning,burnt
burning: burning
burns: burns
burnt: burnt
burrow: burrowing
burst: burst,bursting,bursts
burthen: burthen,burthens
bury: buried,bury
bush: bushes
business: business
bust: bust
bustle: bustle,bustled
busy: busy
butcher: butcher
butchery: butchery
butler: butler
butt: butt
butter: butter
butterfly: butterflies,butterfly
button: buttons
buxom: buxom
buyer: buyer
buzz: buzz
byron: byron
cabin: cabin
cabinet: cabinet
cable: cable
cades: cades
cadmus: cadmus
caesar: caesar
caesarean: caesarean
cage: cage,caged,cages
cain: cain
caique: caique
cairn: cairn
caitiff: caitiff
cal: cal
calculate: calculate,calculated,calculating
calculation: calculation
calculator: calculators
calderon: calderon
callous: callous
callow: callow
calm: calm,calmer,calmest,calms
calmly: calmly
calumniate: calumniated
calumny: calumny
camel: camel
camilla: camilla
camp: camp,camps
campaign: campaign
campbell: campbell
canal: canals
cancer: cancer
candidate: candidate,candidates
candide: candide
candle: candle,candles
candlestick: candlesticks
candy: candy
canker: canker
cannibal: cannibal
cannon: cannon
cannonade: cannonade
canonical: canonical
canonization: canonization
canopy: canopy
canst: canst
canter: canter
canterbury: canterbury
canto: canto,cantos
cantos: cantos
canvas: canvas
canvass: canvass
cap: cap,caps
capability: capabilities
capable: capable
capacity: capacity
cape: cape
caper: caper
capital: capital
capitulation: capitulation
capo: capo
capon: capon
caprice: caprice,caprices
capricious: capricious
capsize: capsize
captain: captain,captains
captive: captive,captives
capture: capture,captures
car: car,cars
caractacus: caractacus
caravan: caravan
carcass: carcasses
card: card,cards
care: care,cared,cares
careen: careen
career: career
careful: careful
careless: careless
carelessly: carelessly
caress: caress,caresses
cargo: cargo,cargoes
carlo: carlo
carnage: carnage
carnation: carnation
carnival: carnival
carnivorous: carnivorous
carolines: carolines
carotid: carotid
carouse: carouse
carp: carp
carpe: carpe
carpenter: carpenter
carpet: carpet,carpeted,carpets
carriage: carriage,carriages
carrion: carrion
carry: carried,carry,carrying
carte: carte
cartridge: cartridges
carve: carved
carving: carving,carvings
cascade: cascade
casement: casement
cash: cash
casimere: casimere
cask: cask,casks
casque: casque
cassandra: cassandra
cast: cast,casts
castalian: castalian
castanets: castanets
caste: caste
castellated: castellated
castile: castile
castilian: castilian
casting: casting
casually: casually
casuist: casuist,casuists
cat: cat,cats
catalogue: catalogue
catch: catch,catches,caught
catechism: catechism
cater: catering
cathay: cathay
cathedral: cathedral
catherine: catherine
catholic: catholic
catholics: catholics
catiline: catiline
cattle: cattle
caucasus: caucasus
caulking: caulking
causa: causa
causeless: causeless
cautious: cautious
cavalier: cavalier,cavaliers
cave: cave,caves
cavern: cavern,caverns
cavil: cavil
caw: caw
cayenne: cayenne
cease: cease,ceased
ceaseless: ceaseless
cedar: cedar,cedars
celebrate: celebrated
celebrated: celebrated
celebrity: celebrity
celestial: celestial
cell: cell,cells
cellar: cellar,cellars
cement: cemented
censorious: censorious
cent: cents
centage: centage
centaur: centaur
central: central
centre: centre,centred
centurion: centurion
century: centuries,century
ceremony: ceremonies,ceremony
ceres: ceres
certainty: certainty
certes: certes
ceruleans: ceruleans
ceruse: ceruse
cervantes: cervantes
cesare: cesare
cetera: cetera
ceylon: ceylon
chafe: chafe,chafed,chafing
chaff: chaff
chain: chain,chains
chair: chair,chairs
chaise: chaise
chalk: chalk
chalky: chalky
chamber: chamber,chambers
chamberlain: chamberlain
chambre: chambre
chameleon: chameleon,chameleons
champagne: champagne
champion: champion
chance: chance,chanced,chances
chancellor: chancellors
chancery: chancery
change: change,changed,changing
changeable: changeable
changeless: changeless
channel: channels
chanson: chanson
chant: chant
chaos: chaos
chapeau: chapeau
chapel: chapel
chapter: chapters
character: character,characters
charge: charge,charged
charger: charger
charing: charing
chariot: chariot,chariots
charitable: charitable
charity: charity
charlatan: charlatan
charlemagne: charlemagne
charles: charles
charm: charm,charms
charmer: charmer,charmers
charming: charming
charms: charms
charon: charon
chart: chart,charts
chase: chase,chased
chasseurs: chasseurs
chaste: chaste,chastest
chastely: chastely
chasten: chasten
chaster: chaster
chastest: chastest
chastity: chastity
chat: chat,chatted
chatter: chatter
che: che
cheapen: cheapen,cheapening
cheat: cheated,cheating
check: check,checks
checker: checker
checkered: checkered
cheek: cheek,cheeks
cheer: cheer
cheerful: cheerful
cheerfulness: cheerfulness
cheery: cheery
cheese: cheese
chemise: chemise
chequer: chequer
cherish: cherish
chersonese: chersonese
cherub: cherub,cherubs
cherubim: cherubim
chess: chess
chessman: chessman
chest: chest,chests
chesterfield: chesterfield
chevalier: chevalier,chevaliers
chew: chewing
chian: chian
chick: chicks
chief: chief,chiefs
chiefly: chiefly
chieftain: chieftain
child: child,children
childhood: childhood
childishness: childishness
chill: chill,chilling
chiller: chiller
chilly: chilliest,chilly
chime: chime,chimes
chimera: chimera
chimney: chimney
chin: chin,chins
china: china
chinese: chinese
chisel: chisel
chivalry: chivalry
chocolate: chocolate
choice: choice,choicest
choir: choir
choke: choked
choleric: choleric
choose: choose,chooses,choosing,chose,chosen
choral: choral
chord: chords
chorus: chorus
christ: christ
christen: christen
christian: christian,christians
christianity: christianity
chronicle: chronicle
chronicler: chroniclers
chronological: chronological
chronology: chronology
church: church,churches
churchman: churchman
chymic: chymic
cicada: cicadas
ciceronian: ciceronian
cinder: cinders
cinnamon: cinnamon
circassian: circassian
circle: circle,circles,circling
circling: circling
circular: circular
circulate: circulating
circulation: circulation
circumcise: circumcise
circumcision: circumcision
circumspect: circumspect
circumspection: circumspection
circumstance: circumstance,circumstances
cirque: cirque
cite: cite,cited
city: cities,city
civic: civic
civil: civil
civilisation: civilisation
civilised: civilised
civility: civility
clad: clad
claim: claim,claiming,claims
claimant: claimant
clamour: clamour
clan: clan
clank: clank,clanking
clap: clap
clapping: clapping
clarence: clarence
claret: claret
clash: clash
clasp: clasp,clasps
class: class,classes
classic: classic
classical: classical
clatter: clatter
claudius: claudius
clause: clause
claw: claw,claws
clay: clay
clean: clean
cleave: cleaves
cleft: cleft
cleopatra: cleopatra
clepe: yclept
clergy: clergy
clergyman: clergyman,clergymen
clerk: clerks
clever: clever,cleverest
client: clients
cliff: cliff,cliffs
climacteric: climacteric
climate: climate
climax: climax
climb: climb,climbing
clime: clime,climes
clinch: clinch
cling: cling,clinging,clings,clung
clip: clip
clipt: clipt
cloak: cloak
clog: clog
cloister: cloisters
close: close,closed,closer,closing
closet: closet
closing: closing
cloth: cloth
clothe: clad,clothe,clothed
clothes: clothes
clothing: clothing
cloud: cloud,clouds
clouded: clouded
cloudless: cloudless
clouds: clouds
cloudy: cloudy
cloves: cloves
clownish: clownish
cloy: cloy,cloying,cloys
club: clubs
clue: clue
clung: clung
cluster: cluster
clustering: clustering
clytemnestra: clytemnestra
coach: coach,coaches
coal: coal,coals
coarse: coarse,coarser
coast: coast
coat: coat
coax: coax
cobble: cobbling
cochineal: cochineal
cock: cock,cocks
cocker: cocker
cocking: cocking
cockney: cockney,cockneys
code: code
coerce: coerced
coffee: coffee
coffeehouse: coffeehouse
coffin: coffin
cohorn: cohorn
coil: coil
coin: coin,coins
coincidence: coincidence
coke: coke
colchian: colchian
cold: cold,colder
coldly: coldly
coldness: coldness
collar: collar,collars
collect: collect
collection: collection
collective: collective
college: college
colloquy: colloquy
cologne: cologne
colonel: colonel
colonial: colonial
colossus: colossus
colour: colour,colours
colouring: colouring
columbia: columbia
columbus: columbus
column: column,columns
comb: comb,combs
combat: combat
combination: combination
combine: combine,combined
comedy: comedies,comedy
comer: comer,comers
comet: comet
comfort: comfort,comforts
comfortable: comfortable
comforter: comforter
coming: coming
comitatus: comitatus
command: command,commanded,commanding,commands
commandant: commandant
commander: commander
commandment: commandment,commandments
commemoration: commemoration
commence: commence,commenced
comment: comment,comments
commentary: commentaries
commentator: commentator
commercial: commercial
commiseration: commiseration
commission: commission
commit: commit
commodious: commodious
commodity: commodities
common: common,commonest,commons
commoner: commoners
commonplace: commonplace
commons: commons
commotion: commotion
communion: communion
compact: compact
companion: companion
company: company
comparative: comparative
compare: compare,compared
comparison: comparison
compass: compass
compassion: compassion
compeer: compeers
compete: compete
competent: competent
competition: competition
complacency: complacency
complain: complain,complaining
complaining: complaining
complaint: complaint,complaints
complete: complete
completely: completely
complexion: complexion
compliment: compliment,complimented,compliments
compose: compose,composed
composition: composition,compositions
comprehend: comprehend,comprehends
comprehension: comprehension
compress: compress
compression: compression
comprise: comprise,comprised
compromise: compromise,compromised
compunction: compunction
comrade: comrade,comrades
concatenation: concatenation
conceal: conceal
concede: concede,conceded
conceit: conceit,conceits
conceive: conceive,conceived
concentrate: concentrating
concentrated: concentrated
concentre: concentre
concern: concern
concert: concert
concision: concision
conclude: concluded
conclusion: conclusion,conclusions
concoction: concoction
concord: concord
concubine: concubine
concur: concur
concussion: concussion
condemn: condemn
condemnation: condemnation
condense: condensed
condescend: condescend,condescended,condescends
condescending: condescending
condescension: condescension
condition: condition,conditions
condolence: condolence
conducive: conducive
conduct: conduct,conducted,conducts
conductor: conductor
conf: confest
conference: conference
confess: confess
confession: confession,confessions
confessor: confessor
confidence: confidence
confidential: confidential
confine: confine,confined
confines: confines
confirm: confirm
confiscate: confiscated
conflict: conflict,conflicts
conformation: conformation
confound: confound,confounded,confounds
confuse: confused
confused: confused
confusion: confusion
congeal: congeal,congealing
congratulation: congratulations
congress: congress,congresses
congreve: congreve
conjecture: conjectures
conjecturing: conjecturing
conjugal: conjugal
conjurer: conjurer
conn: conn
connect: connect,connected,connects
connection: connection,connections
connoisseur: connoisseur
connubial: connubial
conquer: conquer
conqueror: conqueror,conquerors
conquest: conquest,conquests
conscience: conscience
conscious: conscious
consent: consent,consented
consequence: consequence,consequences
consequential: consequential
considerable: considerable
consideration: consideration
consign: consign
consist: consist,consisted
consistent: consistent
consistory: consistory
consolation: consolation
console: console,consoled,consoling
consomme: consomme
consonant: consonants
consort: consort,consorts
conspicuous: conspicuous
conspiracy: conspiracy
constable: constable
constancy: constancy
constant: constant
constantine: constantine
constantinople: constantinople
consternation: consternation
constitute: constitute
constitution: constitution,constitutions
constitutional: constitutional
constrain: constrain
construct: constructed
construction: construction
constructive: constructive
consulting: consulting
consume: consuming
consumer: consumers
consumptive: consumptive
contact: contact
contagious: contagious
contemn: contemn
contemplation: contemplation
contemplative: contemplative
contempt: contempt
contend: contend,contended
content: content
contented: contented
contentedly: contentedly
contents: contents
contest: contests
context: context
continence: continence
continent: continent,continents
continental: continental
continuance: continuance
continuation: continuation
continue: continue,continued
contract: contracted
contraction: contractions
contractor: contractor
contradict: contradict,contradicted,contradicting
contradiction: contradiction
contrary: contrary
contrast: contrast
contribute: contribute
contrivance: contrivances
contrive: contrive
contrived: contrived
control: control
conundrum: conundrum
convalescence: convalescence
convenience: convenience
convenient: convenient
convent: convent
conversation: conversation,conversations
conversational: conversational
conversationist: conversationist
conversazione: conversazione
converse: converse
conversion: conversion
convert: converted
convey: convey,conveying
conveyance: conveyance
convict: convict,convicted
convince: convinced,convinces
convulsion: convulsion,convulsions
convulsive: convulsive
cook: cook,cooks
cookery: cookery
cool: cool,cooling
cooling: cooling
coolly: coolly
coot: coot
cope: cope
copious: copious
copper: copper
copying: copying
coquetry: coquetry
coquette: coquette
coral: coral
cordage: cordage
cordial: cordial,cordials
core: core
corinthian: corinthian
cork: cork
corn: corn
cornelian: cornelian
corner: corner,corners
cornish: cornish
coronal: coronals
coronet: coronet,coronets
corporal: corporal
corporation: corporation
corps: corps
corpse: corpse,corpses
corpus: corpus
correct: correct
correctest: correctest
corrector: corrector
correspond: correspond
correspondent: correspondent,correspondents
corrode: corroding
corruption: corruption
corse: corses
coruscation: coruscation
corydon: corydon
cosmogony: cosmogony
cost: cost,costs
costive: costive
costly: costly
costume: costume
cot: cots
coterie: coterie,coteries
cott: cotted
cottage: cottages
couch: couch,couches
cough: cough,coughs
couldst: couldst
couleur: couleur
council: council,councils
counsel: counsel
counsellor: counsellors
count: count,counted,counting
countenance: countenance
counter: counter
counterbalance: counterbalance
countess: countess,countesses
country: countries,country
countryman: countryman,countrymen
county: counties,county
couple: couple,coupled
couplet: couplet
courage: courage
courier: courier
courser: courser,coursers
court: court,courted,courting,courts
courteous: courteous
courteously: courteously
courtesy: courtesies,courtesy
courtier: courtier,courtiers
courtly: courtly
cousin: cousin,cousins
cover: cover,covers
covet: covet,coveted
cow: cow
cower: cowers
cowl: cowl
cowper: cowper
coxcomb: coxcomb,coxcombs
coxcombry: coxcombry
crabby: crabby
crack: crack,cracks
cradle: cradled
craggy: craggy
cram: cram
crane: craned
crash: crash
cravat: cravat
crave: crave
craving: craving
craw: craw
crawl: crawls
craze: crazed
crazy: crazy
creak: creak
cream: cream
create: create
creation: creation
creative: creative
creature: creature,creatures
credential: credential
credit: credit,credited
creditor: creditor,creditors
credulous: credulous
creed: creed,creeds
creek: creek
creep: creep,creeping,creeps,crept
creeper: creeper
crescent: crescent,crescents
crest: crest,crests
crew: crew,crews
cricket: crickets
crim: crim
crime: crime,crimes
criminal: criminal
crimson: crimson
crisis: crisis
crisp: crisp
crisper: crisper
critic: critic,critics
critically: critically
criticise: criticise,criticised
criticism: criticism
critique: critique
crockery: crockery
crocodile: crocodiles
cromwell: cromwell
crop: crop
cross: cross,crosses
crost: crost
crotchet: crotchet
crow: crow
crowd: crowd,crowded,crowding,crowds
crowded: crowded
crown: crown,crowned,crowns
crowner: crowner
crowning: crowning
crucifix: crucifix
cruel: cruel
cruelty: cruelty
cruise: cruised,cruising
cruiser: cruisers
crumble: crumbled
crupper: crupper
crush: crushing
crutch: crutch
crystal: crystal
cub: cubs
cuckold: cuckolds
cud: cud
cue: cue
cuff: cuffs
cull: cull
culotte: culotte
culprit: culprit
cultivate: cultivated
cumberland: cumberland
cunning: cunning
cup: cup,cups
cupboard: cupboard
cupid: cupid
cupidity: cupidity
cupidon: cupidon
cupola: cupola
curate: curate
curb: curb,curbed
curdle: curdle
cure: cure,cured,cures
curiosity: curiosity
curious: curious
curiously: curiously
curl: curl,curling,curls
curly: curly
curran: curran
currency: currency
current: current,currents
currie: currie
curry: curry
curse: curse,cursed,curses
cursed: cursed
curst: curst
curtain: curtain,curtains
curtis: curtis
curtsy: curtsied,curtsies,curtsy,curtsying
cushion: cushion,cushions
custom: custom,customs
cut: cut,cuts,cutting
cutlass: cutlass
cutter: cutter
cyclades: cyclades
cyclops: cyclops
cygnet: cygnet
cynic: cynic
cynthia: cynthia
cypress: cypress,cypresses
cyprus: cyprus
cyrus: cyrus
cytherea: cytherea
czarina: czarina
dabble: dabble,dabbled,dabbling
dad: dad
dagger: dagger
daily: daily
dainty: dainty
dale: dales
dam: dam
damage: damage,damaged
damages: damages
damas: damas
damask: damask
dame: dame,dames
damme: damme
damn: damn
damnable: damnable
damnably: damnably
damning: damning
damp: damp
damsel: damsel,damsels
dan: dan
dance: dance,danced,dances,dancing
dancer: dancer,dancers
dancing: dancing
dandy: dandies,dandiest,dandy
dang: dang
danger: danger
dangerous: dangerous
dangle: dangled
daniel: daniel
danish: danish
dank: dank
dante: dante
danton: danton
danube: danube
daphne: daphne
dappled: dappled
dardan: dardan
daring: daring
dark: dark
darken: darken,darkening
darkle: darkle,darkled
darkly: darkly
darkness: darkness
darling: darling
dart: dart,darting
darted: darted
darts: darts
dash: dash,dashes,dashing
dastardly: dastardly
daughter: daughter,daughters
daunt: daunted
david: david
davy: davy
dawn: dawn
day: day,days
daybreak: daybreak
daylight: daylight
dazzle: dazzled
dazzling: dazzling
dead: dead
deadly: deadlier,deadly
deaf: deaf
deafen: deafen
deal: deal,deals,dealt
dealer: dealer
dean: dean
dearly: dearly
dearth: dearth
death: death,deaths
deathless: deathless
debar: debarred
debate: debate,debates
debater: debater
debauchee: debauchee
debonnaire: debonnaire
debt: debt,debts
debtor: debtor
debut: debut
decant: decanted
decay: decay,decaying
deceased: deceased
deceit: deceit
deceitful: deceitful
deceive: deceive
december: december
decency: decencies,decency
decent: decent
decide: decide,decided
decimate: decimate
deck: deck,decks
declaim: declaiming
declaration: declaration
declare: declare,declared,declares
decline: decline,declined
declivity: declivity
decompose: decompose
decorate: decorate,decorated,decorates
decorous: decorous
decorum: decorum
decrease: decreased
decree: decree
dedicate: dedicate
dedication: dedication
deduce: deduce
deduct: deducted
dee: dee
deed: deed,deeds
deem: deem,deemed,deeming,deems
deep: deep,deeper,deepest,deeps
deepen: deepen
deepest: deepest
deeply: deeply
deer: deer
deface: deface,defaced
defeat: defeat,defeated
defect: defect
defective: defective
defence: defence,defences
defend: defend,defended
defender: defender
defensible: defensible
deference: deference
defiance: defiance
defile: defiled
deflower: deflower
deform: deform
defy: defied,defies,defy,defying
degenerate: degenerate
degradation: degradation
degree: degree,degrees
deign: deign,deigned,deigning,deigns
dejected: dejected
dejection: dejection
delay: delay
deleterious: deleterious
deliberation: deliberation
delicacy: delicacies,delicacy
delicate: delicate
delicately: delicately
delight: delight,delights
delighted: delighted
delightful: delightful
delighting: delighting
delirious: delirious
deliver: deliver
deliverance: deliverance
deluge: deluge
delusion: delusion
demagogue: demagogues
demand: demand,demanded,demands
demeanour: demeanour
demigod: demigods
democracy: democracy
democrat: democrats
democratic: democratic
demoiselle: demoiselle
demolish: demolish
demon: demon,demons
den: den
denial: denial
denmark: denmark
denounce: denounce
deny: denied,deny,denying
depart: depart,departed
departure: departure
depend: depend,depending,depends
dependent: dependent
deplore: deplore,deplored
deposit: deposit,deposited
deposition: deposition,depositions
depravity: depravity
deprecate: deprecated
depreciate: depreciated
depth: depth
depths: depths
deride: deride,derides
derive: derived,derives
des: des
descend: descend,descending,descends
descent: descent
descried: descried
description: description,descriptions
descriptive: descriptive
descry: descried
desert: desert,deserted,deserts
desertion: desertion
deserve: deserve,deserved,deserves,deserving
deserved: deserved
deserving: deserving
desideratum: desideratum
design: design,designs
desirable: desirable
desire: desire,desired,desires
desk: desk
desolate: desolate,desolating
desolation: desolation
despair: despair
despairing: despairing
despatch: despatch,despatches,despatching
desperate: desperate
desperation: desperation
despise: despise,despises,despising
despond: despond,desponds
despot: despot,despots
despotic: despotic
despotism: despotism
dessert: dessert
destine: destined
destiny: destiny
destroy: destroy,destroying,destroys
destroyer: destroyer
destruction: destruction
destructive: destructive
desultory: desultory
detachment: detachment
detain: detain
detect: detect,detected
determination: determination
determine: determine,determined
determined: determined
detest: detest
detestation: detestation
detraction: detraction
deuce: deuce
deuced: deuced
devant: devant
deviate: deviate
deviation: deviation
device: device
devil: devil,devils
devilish: devilish
devilism: devilism
devotee: devotee
devotion: devotion
devour: devour,devours
devout: devout
devoutly: devoutly
dew: dew,dews
dewy: dewy
dey: dey
di: di
diadem: diadem
dialogue: dialogue,dialogues
diamond: diamond,diamonds
dian: dian
diana: diana
diapason: diapasons
dice: dice
dick: dick
dickey: dickey
diction: diction
dictionary: dictionaries
diddle: diddled
dido: dido
die: die,died,dies,dying
diem: diem
diet: diet
difference: difference
difficult: difficult
difficultly: difficultly
difficulty: difficulties,difficulty
diffident: diffident
dig: dig,digging,dug
digest: digest
digestion: digestion
dignify: dignify
dignity: dignity
digress: digress,digressing
digression: digression,digressions
dilate: dilate,dilated
dilettante: dilettanti
dilettanti: dilettanti
diligence: diligence
dim: dim
dimity: dimity
dimpled: dimpled
din: din
dindon: dindon
dine: dine,dined
diner: diner,diners
dining: dining
dinner: dinner,dinners
dint: dint
diogenes: diogenes
diplomatic: diplomatic
diplomatical: diplomatical
diplomatist: diplomatist,diplomatists
diplomatists: diplomatists
dipt: dipt
dire: dire
direct: direct
direction: direction
director: director
dirge: dirge,dirges
dirk: dirk,dirks
dirt: dirt
dirty: dirty
disagreeable: disagreeable
disappear: disappear,disappearing
disappoint: disappointed
disappointed: disappointed
disappointment: disappointment
disarm: disarm
disarray: disarray
disaster: disaster,disasters
disbursement: disbursements
discern: discern
discernment: discernment
discipline: discipline
disciplined: disciplined
disclose: disclose,disclosed
disclosure: disclosure
discord: discord,discords
discordant: discordant
discount: discount,discounted
discourage: discouraged
discover: discover,discovering,discovers
discovery: discoveries,discovery
discreet: discreet
discreetly: discreetly
discrepancy: discrepancies
discretion: discretion
discuss: discuss
discussion: discussion
disdain: disdain,disdaining
disease: disease,diseases
diseased: diseased
disembark: disembark
disembodied: disembodied
disfigure: disfigure
disgorge: disgorging
disgrace: disgrace
disguise: disguise
disgust: disgust
disgusting: disgusting
dish: dish,dishes
disinterestedness: disinterestedness
dislike: dislike,dislikes
dismay: dismay
dismiss: dismiss
disorder: disorders
disorderly: disorderly
disparage: disparage
disparity: disparity
dispell: dispell
dispense: dispense,dispensed
display: display,displays
displease: displease,displeasing
dispose: dispose,disposed
disposed: disposed
disposition: disposition
dispute: dispute,disputed,disputes,disputing
dissatisfy: dissatisfied
dissect: dissected,dissecting
dissection: dissection
dissemble: dissembles
dissent: dissent,dissenting
dissert: dissert
dissimulation: dissimulation
dissipate: dissipate,dissipated
dissipation: dissipation
dissolve: dissolved,dissolves,dissolving
distaff: distaff
distance: distance
distant: distant
distill: distill
distinct: distinct
distinction: distinction
distinguish: distinguish
distortion: distortion,distortions
distraction: distraction
distrait: distrait
distress: distress,distresses
distressing: distressing
distribution: distribution
disturb: disturb,disturbing
ditch: ditch,ditches
ditcher: ditcher
diuretic: diuretic
divan: divan
diver: divers
diversion: diversion
diversity: diversity
divert: divert,diverted
divest: divested
divide: divide,divided,divides,dividing
divine: divine
diviner: diviner
diving: diving
divinity: divinities,divinity
divorce: divorce,divorced,divorces,divorcing
divulge: divulged
dizziness: dizziness
dizzy: dizzy
docile: docile
docility: docility
doctor: doctor,doctors
doctrine: doctrine,doctrines
dodge: dodging
dog: dog,dogs
dogma: dogma
doings: doings
dolce: dolce
dollar: dollar,dollars
dolour: dolour
dolphin: dolphin
dome: dome,domes
domestic: domestic,domestics
dominion: dominion
donna: donna
donor: donor
doom: doom,doomed
doomsday: doomsday
door: door,doors
doors: doors
doorway: doorway
doric: doric
dormant: dormant
dory: dory
dose: dose
dost: dost
dot: dotted
dote: dote,doted,doting
doth: doth
doting: doting
double: double,doubled,doubles
doubly: doubly
doubt: doubt,doubted,doubting,doubts
doubter: doubters
doubtless: doubtless
dove: dove,doves
dover: dover
dowager: dowager,dowagers
dower: dower
downcast: downcast
downright: downright
downward: downward
dowry: dowry
doze: doze,dozed
dozen: dozen
dr: drest
draft: draft
drag: drag,drags
dragon: dragon
drain: drain,drains
drainer: drainer
dram: drams
drama: drama
dramatic: dramatic
drapery: draperied,draperies,drapery
draught: draught
draw: draw,drawing,drawn,draws,drew
drawcansir: drawcansir
drawing: drawing
drawl: drawling
dray: drays
dread: dread,dreaded,dreading
dreadful: dreadful
dream: dream,dreaming,dreams,dreamt
dreamer: dreamer
dreamless: dreamless
drear: drear
dreary: dreary
drench: drench
dresden: dresden
dress: dress,dresses,dressing
dressing: dressing
drest: drest
drew: drew
drift: drift
drill: drill
drilling: drilling
drink: drank,drink,drinking,drinks,drunk
drinker: drinker
drinking: drinking
drip: dripping
dripping: dripping
drive: drive,driven,drives,driving,drove
drivel: drivels
droop: droop,drooping,droops
drooping: drooping
drop: drop,dropped,dropping,drops
dropsy: dropsies
dross: dross
drouth: drouth
drouthy: drouthy
drown: drown,drowning
drowning: drownings
drowsy: drowsy
druggist: druggists
druid: druid
druids: druids
drum: drum,drums
drunk: drunk
drunkenness: drunkenness
dry: dried,dry,drying
dryness: dryness
duan: duan
dub: dub
dubious: dubious
dublin: dublin
duchess: duchess
duck: duck,ducks
duckling: duckling,ducklings
dudgeon: dudgeon
duet: duet,duets
duke: duke,dukes
dull: dull,dullest
dully: dully
duly: duly
dumb: dumb,dumber
dumpy: dumpy
dun: dun,dunnest,duns
duncan: duncan
dunce: dunce,dunces
dunces: dunces
dungeon: dungeon
dunghill: dunghill
duomo: duomo
dura: dura
duration: duration
dusk: dusk
dusky: dusky
dust: dust
dutch: dutch
dutchmen: dutchmen
duty: duties,duty
dwarf: dwarf,dwarfs
dwarfing: dwarfing
dwell: dwell,dwelling,dwells,dwelt
dweller: dwellers
dwelling: dwellings
dwelt: dwelt
dwindle: dwindle,dwindled
dye: dye,dyed,dyes
dyed: dyed
dyer: dyer,dyers
dyke: dyke
eager: eager
eagerly: eagerly
eagerness: eagerness
eagle: eagle
ear: ear,ears
earl: earl,earls
earliest: earliest
earn: earn
earnest: earnest
earnestness: earnestness
earshot: earshot
earth: earth
earthly: earthly
earthquake: earthquake,earthquakes
ease: ease,eased
easily: easily
east: east
eastern: eastern
easy: easier,easy
eat: ate,eat,eating,eats
eating: eating
ebb: ebb
ebony: ebony
ecclesiastes: ecclesiastes
echo: echo,echoed,echoes,echoing
eclat: eclat
eclectic: eclectic
economic: economic
economy: economy
ecstatic: ecstatics
eddy: eddies
eden: eden
edge: edge,edged
edict: edicts
edifice: edifice
edifying: edifying
edinburgh: edinburgh
edition: edition
editor: editor
educate: educate,educated
education: education,educations
edward: edward
eel: eels
effeminate: effeminate
effort: effort,efforts
effrontery: effrontery
egad: egad
egg: eggs
eggs: eggs
ego: ego
egotism: egotism
egypt: egypt
egyptian: egyptian
eighteen: eighteen
eighth: eighth
ejection: ejection
eke: eke,eking
elapse: elapsed
elate: elate
elbow: elbow
eld: eldest
elder: elder
elderly: elderly
elect: elect,elected
election: election
electioneerer: electioneerer
elegance: elegance
elegant: elegant
elegy: elegy
element: element,elements
elevation: elevation
eleventh: eleventh
elf: elf
eligible: eligible
elite: elite
elizabeth: elizabeth
ell: ell
elle: elle
elopement: elopement
eloquence: eloquence
eloquent: eloquent
elysium: elysium
emaciated: emaciated
emasculate: emasculated
embargo: embargo,embargoed
embark: embark
embarrass: embarrass
embarrassment: embarrassment
embellish: embellish
ember: embers
emblem: emblem,emblems
embody: embodied
embosom: embosom
emboss: emboss
embrace: embrace,embraced,embraces
embroider: embroider
embroidery: embroidery
emerald: emerald
emerge: emerge
emetic: emetic
emigration: emigration,emigrations
eminent: eminent
emotion: emotion,emotions
emperor: emperors
emphasis: emphasis
emphatic: emphatic
empire: empire,empires
employ: employ,employing
employment: employment
empress: empress
empressement: empressement
emulation: emulation
en: en
enable: enables
enamour: enamoured
enchant: enchants
enchanted: enchanted
enchanter: enchanter
enclose: enclosed
encounter: encounter
encourage: encourage,encourages
encouragement: encouragement
encroach: encroach,encroaching
encumber: encumber,encumbered,encumbers
encyclopedize: encyclopedize
endanger: endangers
endear: endear,endears
endearment: endearment
endeavour: endeavour,endeavouring
endless: endless
endurance: endurance
endure: endure,endured,enduring
enemy: enemies,enemy
energetic: energetic
energy: energies,energy
engage: engage,engaged
engender: engender
engine: engines
engineer: engineer
engineering: engineering
england: england
english: english
englishman: englishman,englishmen
englishmen: englishmen
englishwoman: englishwoman
engrave: engrave
engross: engross
enhance: enhance
enjoin: enjoining
enjoy: enjoy,enjoying
enjoyment: enjoyment
enlargement: enlargement
enlighten: enlighten
enlist: enlist
ennoble: ennoble
ennui: ennui
enormous: enormous
enquire: enquire,enquired
enquired: enquired
enrich: enrich
ensemble: ensemble
enslave: enslaved
enslaver: enslaver
ensue: ensue,ensued,ensuing
ensure: ensure,ensured,ensures
entail: entail
entangle: entangle,entangled
enter: enter,entering
entertain: entertain
entertaining: entertaining
enthusiasm: enthusiasm
entire: entire
entomb: entomb,entombing
entrail: entrail
entrails: entrails
entrance: entrance
entre: entre
entreat: entreating
entreating: entreating
entrenchment: entrenchment
entwine: entwine,entwined,entwines
enumeration: enumeration
enviable: enviable
envied: envied
environ: environ
envoy: envoy,envoys
envy: envy
ephesian: ephesian
ephesians: ephesians
epic: epic
epical: epical
epicene: epicene
epigram: epigram,epigrams
epileptical: epileptical
episode: episode,episodes
epistle: epistle
epitaph: epitaphs
epitome: epitome
epoch: epoch
epopee: epopee
equal: equal,equals
equally: equally
equanimity: equanimity
equinoctial: equinoctial
equinox: equinox
equipage: equipage
era: era
ere: ere
erect: erect,erected
erection: erection
erin: erin
ermine: ermine
eros: eros
err: err,erring,errs
erroneous: erroneous
error: error,errors
erse: erse
erst: erst
esau: esau
escalade: escalade
escapade: escapade
escape: escape,escaped,escapes,escaping
eschew: eschew
especial: especial
espiegle: espiegle
espouse: espoused
esquire: esquire,esquired,esquires
essay: essay,essaying
essence: essence
essential: essential
est: est
establish: establish
establishment: establishment
estate: estate
esteem: esteem,esteeming
estimation: estimation
estrange: estrange,estranged
eternal: eternal
eternally: eternally
eternity: eternity
ether: ether
ethereal: ethereal
etiquette: etiquette
etna: etna
eulogy: eulogy
eunuch: eunuch,eunuchs
euphony: euphony
eureka: eureka
europe: europe
european: european
euxine: euxine
evade: evades
evaporate: evaporate
evaporation: evaporation
eve: eve
evening: evening,evenings
event: event,events
eventide: eventide
everblooming: everblooming
evergreen: evergreen
everyday: everyday
evidence: evidences
evidently: evidently
evil: evil
evince: evince
evolution: evolution,evolutions
ewer: ewer
exact: exact,exacted,exacts
exaggeration: exaggeration,exaggerations
exalt: exalt,exalted
examination: examination
examine: examine,examined
exasperated: exasperated
exceed: exceed,exceeded,exceeding
exceedingly: exceedingly
excel: excel
excellency: excellency
excellent: excellent
exception: exception,exceptions
excess: excess,excesses
exchange: exchange,exchanged,exchanging
exchequer: exchequer
excise: excise
excite: excite
excited: excited
exciting: exciting
exclaim: exclaim,exclaiming
exclude: excluded
excommunication: excommunication
excursion: excursion
excursive: excursive
excuse: excuse,excuses
execrate: execrates
execute: executes
execution: execution
exemplary: exemplary
exempt: exempt
exert: exert
exertion: exertion
exhale: exhales
exhaustion: exhaustion
exhortation: exhortation
exile: exiled,exiles
exiled: exiled
exist: exist,existed,exists
existence: existence
existent: existent
exit: exit
exordium: exordium
exotic: exotic
expand: expanded,expanding
expansion: expansion
expatiate: expatiate
expect: expect,expected,expecting,expects
expectant: expectant
expedient: expedient,expedients
expedition: expedition
expend: expended
expense: expense,expenses
experience: experience
experienced: experienced
experiment: experiment
expire: expire,expired,expires
explain: explain,explaining,explains
explanation: explanation
explicitly: explicitly
exploit: exploits
explore: explore,explored
explosion: explosion
expose: exposed
exposure: exposure
expound: expound,expounding,expounds
expounder: expounder
express: express,expresses
expression: expression
expurgate: expurgated
exquisite: exquisite
exquisitely: exquisitely
extend: extends
extension: extension
extensive: extensive
extent: extent
external: external
extinguish: extinguish
extra: extras
extract: extract,extracts
extraneous: extraneous
extreme: extreme,extremes,extremest
extremely: extremely
extremity: extremity
exuberant: exuberant
exult: exulting
exultation: exultation
eye: eye,eyes
eyeball: eyeballs
eyebrow: eyebrow
eyed: eyed
eyelash: eyelash,eyelashes
eyelid: eyelid,eyelids
eyesight: eyesight
fable: fable,fables
faced: faced
facetious: facetious
facility: facility
facing: facings
factious: factious
factitious: factitious
faculty: faculties,faculty
fade: fade,faded,fades,fading
fail: fail
fain: fain
faint: faint,fainter,faintest,faints
fainting: fainting
faintly: faintly
faintness: faintness
fair: fair,fairer,fairest
fairy: fairy
faith: faith
faithful: faithful
faithless: faithless
falchion: falchions
fall: fall,fallen,falling,falls,fell
fallow: fallow
false: false
falsehood: falsehood
fame: fame
famed: famed
familiar: familiar
familiarly: familiarly
family: families,family
famine: famine,famines
famish: famish
famous: famous
fan: fan,fans
fancied: fancied
fanciful: fanciful
fancy: fancied,fancies,fancy
fang: fangs
fanny: fanny
fantastic: fantastic
fantasy: fantasies,fantasy
farce: farce
fare: fare
farewell: farewell
farm: farm
farmer: farmer,farmers
farrow: farrow
fascinate: fascinate
fascinating: fascinating
fascination: fascination
fascine: fascines
fashion: fashion
fashionable: fashionable
fast: fast,faster
fasten: fasten
fasting: fasting
fat: fat,fattest
fatal: fatal
fate: fate,fates
fates: fates
father: father,fathers
fathom: fathom
fatigue: fatigue,fatigued
fatten: fatten
fatuus: fatuus
fault: fault,faults
faux: faux
favor: favor
favorite: favorite
favour: favour,favours
favourite: favourite
favouritism: favouritism
fawn: fawn
fear: fear,fears
fearful: fearful
fearless: fearless
feasible: feasible
feast: feast,feasts
feat: feat,feats
feather: feather,feathers
feature: feature,features
fed: fed
fee: fee,fees
feeble: feeble
feed: fed,feed,feeding,feeds
feel: feel,feeling,feels
feeling: feeling,feelings
feign: feigns
felicity: felicity
fell: fells
fellow: fellow,fellows
felon: felon
female: female,females
feminine: feminine
femininely: femininely
femme: femme
fen: fen,fens
fence: fence,fenced
fencing: fencing
ferment: ferment
fermentation: fermentation
ferocious: ferocious
ferocity: ferocities,ferocity
fertile: fertile
fertility: fertility
fervent: fervent
fervently: fervently
fervour: fervour
festal: festal
festivity: festivity
festoon: festoon,festoons
fete: fetes
fetter: fetter,fetters
feud: feud,feuds
feudal: feudal
fever: fever
feverish: feverish
fez: fez
fiat: fiat
fickle: fickle
fiction: fiction
fiddle: fiddle,fiddled,fiddling
fie: fie
field: field,fields
fielding: fielding
fiend: fiends
fierce: fierce
fiery: fiery
fifteenth: fifteenth
fig: fig
fight: fight,fighting,fights,fought
fighter: fighter,fighters
fighting: fighting
figurative: figurative
figure: figure,figures
filch: filch
file: file
filial: filial
filigree: filigree
fillet: fillet,fillets
film: film
filter: filter
filth: filth
filthy: filthy
fin: fin
financier: financiers
fine: fine,fined,finer,finest
finely: finely
finger: finger,fingers
finish: finish
firing: firing
firm: firm,firmer
firman: firman
firmness: firmness
firstly: firstly
fish: fish,fishes
fisher: fisher,fishers
fisherman: fisherman
fishery: fishery
fist: fist
fisty: fisty
fit: fit,fits,fitted,fitter,fittest,fitting
fitted: fitted
fitting: fitting
fitz: fitz
flag: flag,flags
flail: flail
flake: flake
flame: flame,flames
flank: flank,flanks
flash: flash,flashes,flashing
flashes: flashes
flashing: flashing
flask: flask,flasks
flat: flat,flatter
flatter: flatters
flatterer: flatterer,flatterers
flattering: flattering
flattery: flattery
flavour: flavour
flaw: flaw,flaws
flay: flay
fledged: fledged
flee: fled,flee
fleece: fleece,fleeced
fleecy: fleecy
fleet: fleet
fleeting: fleeting
flesh: flesh
fleshy: fleshy
flicker: flicker
flight: flight,flights
flighty: flighty
flinch: flinch
fling: fling,flings,flung
flint: flint,flints
flirt: flirted
flirtation: flirtation
flit: flits,flitted
float: float,floating,floats
flock: flock
flog: flog
flood: flood
floor: floor,floors
florentine: florentine
florid: florid
flotilla: flotilla
flounce: flounced
flourish: flourish,flourishes,flourishing
flow: flow,flowing,flows
flower: flower,flowers
fluent: fluent
flung: flung
flurry: flurry
flush: flush
flutter: flutter,fluttering
fly: flew,flies,fly,flying
foam: foam,foaming
focus: focus
foe: foe,foes
fog: fog
foible: foible,foibles
fold: fold,folded,folds
folk: folks
follies: follies
follow: follow
follower: follower,followers
folly: follies,folly
fond: fond
fondly: fondly
font: font,fonts
food: food
fool: fool,fooling,fools
foolish: foolish
foolscap: foolscap
foot: feet,foot,footing
footman: footmen
footmark: footmarks
footstep: footstep,footsteps
fop: fop
forbear: forbear,forbears,forbore
forbearance: forbearance
forbid: forbade,forbid,forbidding,forbids
forbidden: forbidden
force: force,forced,forces
fore: fore
forego: forego
forehead: forehead
foreign: foreign
foreigner: foreigner,foreigners
foremast: foremast
foremost: foremost
forerunner: forerunners
foresee: foresaw,foreseen
forest: forest,forests
forestall: forestalled
forester: foresters
forestry: forestry
foretell: foretells
forget: forget,forgetting,forgot,forgotten
forgive: forgive,forgiven
forgiveness: forgiveness
forgotten: forgotten
fork: forks
forlorn: forlorn
form: form,forms
formal: formal
formality: formality
formidable: formidable
forms: forms
forsake: forsook
forsooth: forsooth
fort: forts
fortalice: fortalice
forte: forte
fortification: fortification
fortnight: fortnight
fortress: fortress,fortresses
fortunate: fortunate
fortune: fortune,fortunes
foster: foster
foul: foul
foundation: foundation
founder: founder
fount: fount
fountain: fountain,fountains
fourscore: fourscore
fourteenth: fourteenth
fourth: fourth
fourthly: fourthly
fowl: fowl
fowls: fowls
fox: fox,foxes
fraction: fraction
fragile: fragile
fragility: fragility
fragrant: fragrant
frail: frail,frailer
frailty: frailties,frailty
frame: frame,framed,frames
franc: francs
france: france
francis: francis
frank: frank
frankincense: frankincense
franks: franks
frantic: frantic
fraud: fraud
fraught: fraught
fray: fray
freak: freak
fred: fred
frederic: frederic
frederick: frederick
freeborn: freeborn
freedom: freedom,freedoms
freehold: freeholds
freeholder: freeholders
freely: freely
freemason: freemasons
freemasonry: freemasonry
freethinker: freethinker
freeze: freeze,froze,frozen
freezing: freezing
freight: freight
french: french
frenchman: frenchman
frenchmen: frenchmen
frequent: frequent
frequently: frequently
fresco: fresco
fresh: fresh,fresher,freshest
freshly: freshly
freshness: freshness
fret: fret,fretted
fretted: fretted
fretwork: fretwork
friar: friar,friars
friday: friday
friend: friend,friends
friendless: friendless
friendship: friendship,friendships
fright: fright,frights
frighten: frighten
fringe: fringe,fringed,fringes
frisk: frisks
frisky: frisky
fro: fro
frock: frock
frolic: frolic
frontier: frontier
frost: frost,frosts
frosty: frosty
froth: froth
frown: frown,frowns
frowzy: frowzy
frozen: frozen
frugal: frugal
fruit: fruit,fruits
fruitful: fruitful
fry: fried,fry,frying
fuddle: fuddle
fuel: fuel
fulfil: fulfil
fulfill: fulfill
fum: fum
fume: fumes
function: function
fund: fund,funds
funeral: funeral
fur: furs
furious: furious
furiously: furiously
furl: furl
furnace: furnace
furnish: furnish
furnishing: furnishing
furniture: furniture
furrow: furrow
furry: furry
fury: furies,fury
fusion: fusion
fuss: fuss
future: future
futurity: futurity
fy: fy
gad: gads
gage: gage
gaiety: gaieties,gaiety
gaily: gaily
gain: gain,gaining,gains
gainsay: gainsay
gainst: gainst
gale: gale,gales
galileo: galileo
gall: gall
gallant: gallant,gallanted
gallantly: gallantly
gallantry: gallantry
gallery: galleries,gallery
gallic: gallic
galliot: galliots
gallon: gallon,gallons
gallop: gallop
galvanism: galvanism
game: game,gamed
gamester: gamester
gaming: gaming
gan: gan
gander: gander
gang: gang,gangs
gaol: gaol
gaoler: gaoler,gaolers
gape: gape,gaped,gaping
garb: garb,garbs
garble: garble
garden: garden,gardens
garlic: garlic
garment: garment,garments
garrison: garrison
garter: garter,garters
gas: gas
gash: gashes
gasp: gasping,gasps
gastric: gastric
gate: gate
gather: gather,gathering,gathers
gaudy: gaudy
gauls: gauls
gaunt: gaunt
gauze: gauze
gay: gay
gaze: gaze,gazed,gazes,gazing
gazelle: gazelle,gazelles
gazette: gazette,gazettes
gear: gear
gem: gem,gems
gender: gender
gene: gene
generality: generalities
generals: generals
generation: generation,generations
generous: generous
generously: generously
genetrix: genetrix
genial: genial
genitor: genitors
genius: genius
gent: gent
genteelly: genteelly
gentle: gentle
gentleman: gentleman,gentlemen
gentlemanly: gentlemanly
gentlemen: gentlemen
gentler: gentler
gentlewoman: gentlewoman
gently: gently
geography: geography
george: george
georgian: georgian,georgians
germ: germ
german: german
germany: germany
gesture: gesture
ghastly: ghastly
ghost: ghost,ghosts
giant: giant,giants
giaour: giaour,giaours
giaours: giaours
gibber: gibber
gibier: gibier
gibing: gibing
gibraltar: gibraltar
gift: gift,gifts
gifted: gifted
gigantic: gigantic
giggle: giggle,giggling
gild: gild,gilding,gilds
gilded: gilded
giles: giles
gills: gills
gilt: gilt
gin: gins
gird: gird,girds,girt
girdle: girdle
girl: girl,girls
girlish: girlish
girt: girt
girth: girth
glacier: glaciers
glacis: glacis
glad: glad
gladiator: gladiator
gladly: gladly
glance: glance,glanced,glances,glancing
glare: glare,glared
glass: glass,glasses
glassful: glassful
glassy: glassy
glaze: glazed
glazed: glazed
gleam: gleam,gleamed,gleaming,gleams
glean: glean,gleaning
gleaner: gleaners
gleaning: gleaning
gleanings: gleanings
glee: glee
glib: glibber
glibly: glibly
glide: glide,glided,glides,gliding
glimmer: glimmer,glimmering
glimpse: glimpse
glisten: glistening
glister: glisters
glitter: glitter,glittering
globe: globe
gloom: gloom,glooms
gloomy: gloomier,gloomiest,gloomy
glorious: glorious
gloriously: gloriously
glory: gloried,glories,glory
gloss: gloss
glossy: glossy
glove: glove,gloves
glow: glow,glowing,glows
glowing: glowing
glue: glue
glut: glut
glutton: glutton
gnash: gnash
gnaw: gnaw,gnawing,gnaws
goad: goaded
goal: goal
goat: goat
goblet: goblet
goblin: goblins
god: god,gods
goddess: goddess,goddesses
godfather: godfather
godly: godly
godship: godship
goethe: goethe
gold: gold
golden: golden
gondolier: gondolier
goodliness: goodliness
goodly: goodliest,goodly
goodness: goodness
goose: goose
gordian: gordian
gore: gore
gorge: gorge,gorged
gormandize: gormandize
gory: gory
gospel: gospel
goth: goth
gothic: gothic
gourmand: gourmand
gout: gout
govern: govern
government: government
gown: gown
grace: grace,graced,graces
graceful: graceful
gracefully: gracefully
graceless: graceless
gracious: gracious
graciously: graciously
gradually: gradually
graft: grafted
grain: grain
grammar: grammar
granada: granada
grand: grand
grande: grande
grandfather: grandfather
grandmamma: grandmamma
grandmother: grandmother
granite: granite
grant: grant,granted,granting,grants
grantor: grantors
grape: grape,grapes
grapple: grapple,grappled,grapples
grasp: grasp,grasps
grass: grass
grate: grate
grateful: grateful
gratify: gratify
gratifying: gratifying
gratis: gratis
grave: grave,graves
gravel: gravel
graven: graven
gravitation: gravitation
gravity: gravity
gray: gray
grazing: grazing
greatly: greatly
grecian: grecian
greece: greece
greek: greek,greeks
green: green,greener,greenest
greensward: greensward
grenadier: grenadier,grenadiers
grew: grew
grey: grey
greyhound: greyhounds
grief: grief,griefs
grieve: grieve,grieved,grieves
grievous: grievous
grim: grim
grimace: grimace
grimly: grimly
grin: grin,grinning,grins
grind: grind
grindstone: grindstone
grisly: grisly
grist: grist
grizzle: grizzled
groan: groan,groaning,groans
grog: grog
groom: groom
gross: gross,grosser,grossest
grossly: grossly
grot: grot
grotesque: grotesques
ground: ground
grounds: grounds
grouse: grouse
grove: grove,groves
groves: groves
grow: grew,grow,growing,grown,grows
growling: growling
grown: grown
growth: growth
grudge: grudges
gruel: gruel
grumble: grumble,grumbled,grumbles,grumbling
guard: guard,guarded,guards
guardian: guardian,guardians
guardsman: guardsman
guelf: guelf
guerdon: guerdon
guess: guess,guessing
guest: guest,guests
guide: guide,guided,guides
guido: guido
guile: guile
guileless: guileless
guillotine: guillotine
guilt: guilt
guinea: guinea
guise: guise
guitar: guitars
gulf: gulf
gull: gull,gulls
gullet: gullet,gullets
gun: gun,guns
gunnery: gunnery
gunpowder: gunpowder
gurney: gurney
gush: gush,gushing
gushing: gushing
gust: gust,gusts
gut: guts
gynocracy: gynocracy
ha: ha
habeas: habeas
habit: habit,habits
habitant: habitant
habitual: habitual
habitude: habitude
hack: hack,hacks
hackney: hackney
hadst: hadst
haggard: haggard
haggle: haggled
hague: hague
haidee: haidee
hail: hail
hair: hair
haired: haired
hairy: hairy
hal: hal
hale: hale
halifax: halifax
hall: hall,halls
hallelujah: hallelujahs
hallow: hallow,hallowing
hallucination: hallucination
halo: halos
halt: halt,halts
ham: ham,hams
hamlet: hamlet,hamlets
hammer: hammer
hammock: hammock,hammocks
hamper: hamper
hand: hand,handed,hands
handed: handed
handkerchief: handkerchief
handle: handle
handmaid: handmaid,handmaids
handsome: handsome
handsomely: handsomely
handy: handy
hang: hang,hung
hanging: hangings
hanker: hanker
hankering: hankering
hannibal: hannibal
hap: hap
hapless: hapless
happen: happen
happily: happily
happiness: happiness
happy: happier,happiest,happy
haram: haram
harbour: harbour,harbouring
hard: hard,harder
harden: harden
hardness: hardness
hardship: hardship,hardships
hardy: hardiest,hardy
hare: hares
harem: harem
hark: hark
harlequin: harlequin
harlot: harlot
harlotry: harlotry
harm: harm
harmless: harmless
harmonious: harmonious
harmonise: harmonised
harmonist: harmonist
harmony: harmony
harness: harness
harp: harp
harper: harper
harpsichord: harpsichord,harpsichords
harpy: harpy
harrison: harrison
harrow: harrow
harsh: harsh
harvest: harvest,harvests
hast: hast
haste: haste
hasten: hastening,hastens
hastily: hastily
hasty: hasty
hat: hat
hatch: hatch,hatches,hatching
hatchway: hatchway
hate: hate,hated,hates,hating
hateful: hateful
hater: hater
hath: hath
hatred: hatred
haughtily: haughtily
haughty: haughty
haunch: haunch
haunt: haunt,haunted,haunting,haunts
haunted: haunted
haustus: haustus
hauteur: hauteur
hawk: hawk,hawks
hay: hay
hazard: hazard,hazards
hazy: hazy
head: head,headed,heads
headache: headache
headlong: headlong
headstrong: headstrong
heady: heady
health: health
heap: heap,heaps
hear: hear,heard,hears
hearer: hearer,hearers
hearken: hearken
hearsay: hearsay
heart: heart,hearts
heartache: heartache
hearted: hearted
heartfelt: heartfelt
hearth: hearth
hearthstone: hearthstone
heartless: heartless
hearty: hearty
heat: heat,heated
heathen: heathen
heathenish: heathenish
heave: heave,heaved,heaves,heaving,hove
heaven: heaven,heavens
heavenliest: heavenliest
heavenly: heavenly
heaviness: heaviness
heaving: heaving
heavy: heaviest,heavy
hebe: hebe
hebrew: hebrew
hecatomb: hecatomb
hectic: hectic
hector: hector
hedge: hedge
heed: heed,heeded
heedless: heedless
heel: heel
height: height
heighten: heighten,heightening
heir: heir,heirs
heiress: heiress,heiresses
helen: helen
hellespont: hellespont
hells: hells
helm: helm
helpless: helpless
hem: hem
hen: hen,hens
henceforth: henceforth
henchman: henchman
hencoop: hencoops
henge: henge
henna: henna
henry: henry
heracleidan: heracleidan
herald: herald
herb: herbs
herculean: herculean
hercules: hercules
herd: herd
hereditary: hereditary
heresy: heresy
heretofore: heretofore
hermit: hermit
hero: hero,heroes
heroes: heroes
heroic: heroic
heroically: heroically
heroine: heroine,heroines
heroism: heroism
hesitate: hesitate
hesitation: hesitation
hesperus: hesperus
heterogeneous: heterogeneous
hew: hew,hewn
hexameter: hexameters
hiatus: hiatus
hiccup: hiccup,hiccups
hidalgo: hidalgo
hidden: hidden
hide: hidden,hide,hides,hiding
hideous: hideous
hideousness: hideousness
hieroglyphic: hieroglyphic,hieroglyphics
highland: highland,highlands
highlands: highlands
highness: highness
highway: highway,highways
hill: hill,hills
hilt: hilts
hinder: hinder
hinge: hinge,hinges
hint: hint,hinted,hinting,hints
hinter: hinters
hip: hip
hippocrene: hippocrene
hire: hired
hireling: hireling
hirsute: hirsute
hiss: hiss,hisses
hist: hist
historian: historian,historians
historical: historical
history: histories,history
hit: hit,hits
hitherto: hitherto
hived: hived
ho: ho
hoar: hoar
hoard: hoard,hoards
hoarded: hoarded
hoarder: hoarder
hoarding: hoarding
hoarse: hoarse
hoarser: hoarser
hoarsest: hoarsest
hoary: hoary
hoax: hoax
hobgoblin: hobgoblin
hoc: hoc
hock: hock
hog: hogs
hoist: hoist,hoisted
hold: held,hold,holding,holds
holder: holder,holders
hole: hole
holiday: holiday
holland: holland
hollow: hollow
holy: holier,holy
homage: homage,homages
homeless: homeless
homely: homely
homer: homer
homestead: homestead
homicide: homicide
homily: homilies,homily
honest: honest
honester: honester
honestly: honestly
honey: honey
honour: honour,honours
honourable: honourable
hood: hood
hook: hook,hooks
hop: hops
hope: hope,hoped,hopes,hoping
hopeful: hopeful
hopeless: hopeless
horace: horace
horatian: horatian
horde: horde,hordes
horizon: horizon
horn: horn,horns
horner: horner
hornet: hornet
horrible: horrible
horrid: horrid
horror: horror,horrors
horse: horse,horses
horseback: horseback
horseman: horsemen
hospitable: hospitable
hospitably: hospitably
hospital: hospital
hospitality: hospitality
host: host,hosts
hostess: hostess
hot: hot,hottest
hotbed: hotbeds
hotel: hotel,hotels
hotspur: hotspur
hound: hounds
hounds: hounds
hour: hour,hours
houri: houri,houris
houris: houris
hourly: hourly
house: house,houses
household: household
housekeeper: housekeeper,housekeepers
houseless: houseless
housemaid: housemaid
hovel: hovel
hover: hover,hovering,hovers
howe: howe
howl: howl,howling
howsoever: howsoever
hoyle: hoyle
hue: hue,hues
huge: huge,huger
hum: hum,humming
human: human
humane: humane
humanity: humanity
humble: humble,humbled,humbler,humblest
humdrum: humdrum
humiliation: humiliation
humility: humility
humour: humour,humouring,humours
hump: hump
hundredth: hundredth
hunger: hunger
hungry: hungry
hunt: hunt,hunted,hunting
hunter: hunter,hunters
hunting: hunting
huntsman: huntsman
hurl: hurl,hurling,hurls
hurrah: hurrah
hurried: hurried
hurry: hurried,hurry
hurrying: hurrying
hurt: hurt,hurts
husband: husband,husbands
hush: hush
hussar: hussar
hustings: hustings
hustle: hustle
hut: hut
huzza: huzzas
hyaena: hyaena
hydra: hydra
hymen: hymen
hymeneal: hymeneal
hymn: hymn
hypocrisy: hypocrisy
hypocrite: hypocrite
hypocritical: hypocritical
hysteric: hysteric,hysterics
hysterical: hysterical
ibis: ibis
ice: ice,ices
iceberg: iceberg,icebergs
iceland: iceland
icicle: icicles
icy: icy
ida: ida
idea: idea
ideal: ideal
idem: idem
identify: identify
identity: identity
idle: idle,idling
idleness: idleness
idly: idly
idol: idol
idolatry: idolatry
ignis: ignis
ignoble: ignoble
ignorance: ignorance
ignorant: ignorant
ignorantly: ignorantly
ilia: ilia
iliad: iliad,iliads
ilion: ilion
illicit: illicit
illness: illness,illnesses
illuminate: illuminate
illumination: illumination
illumine: illumine,illumined
illusion: illusion,illusions
illustrate: illustrating
illustration: illustration,illustrations
image: image,imaged,images
imaginary: imaginary
imagination: imagination
imagine: imagine,imagined
imbibe: imbibed
imitate: imitate,imitating
immaculate: immaculate
immaterialism: immaterialism
immemorial: immemorial
immense: immense
immersion: immersion
immoral: immoral
immorality: immorality
immortal: immortal
immortality: immortality
immovable: immovable
imp: imp,imps
impale: impaled
impart: impart
impartial: impartial
impatience: impatience
impatient: impatient
impatiently: impatiently
impede: impede
imperative: imperative
imperial: imperial
imperious: imperious
imperturbable: imperturbable
implore: implored
import: import
importune: importune
importunity: importunity
impose: impose
imposed: imposed
imposing: imposing
impossible: impossible
impostor: impostors
imposture: imposture
impracticable: impracticable
impresario: impresario
impress: impress
impression: impression,impressions
imprimatur: imprimatur
imprint: imprint
improbable: improbable
improper: improper
improve: improve,improved,improving
improvement: improvement,improvements
improvvisatore: improvvisatore
imprudent: imprudent
impulse: impulse
impute: imputes
imputed: imputed
inanition: inanition
inanity: inanity
inarticulate: inarticulate
incarnate: incarnate
incense: incense
incessant: incessant
inch: inch
incident: incidents
incision: incision
inclination: inclination
incline: inclines
inclined: inclined
include: included
income: income,incomes
incomparable: incomparable
incomplete: incomplete
inconstancy: inconstancy
incontinent: incontinent
inconvenience: inconvenience
inconvenient: inconvenient
incorrect: incorrect
incorrigible: incorrigible
increase: increase,increased,increases,increasing
increment: increment
incubus: incubi
incumbrance: incumbrance
inde: inde
indecent: indecent
indecision: indecision
indemnification: indemnification
indemnify: indemnifies
indenture: indentures
independence: independence
independent: independent
india: india
indian: indian
indication: indications
indicative: indicative
indifference: indifference
indifferent: indifferent
indigestion: indigestion
indignant: indignant
indispensable: indispensable
indispose: indisposed
indistinct: indistinct
indite: inditing
inditer: inditers
individual: individual
induce: induced
indue: indues
indulge: indulge
indulgence: indulgence
inebriety: inebriety
ineffably: ineffably
inert: inert
inexperience: inexperience
inexplicable: inexplicable
inez: inez
infallible: infallible
infallibly: infallibly
infancy: infancy
infant: infant,infants
infantine: infantine
infect: infected
infected: infected
infer: infer
inferior: inferior
infernal: infernal
infidel: infidel,infidels
infinite: infinite
infinity: infinities
inflammation: inflammation,inflammations
inflict: inflict,inflicted
infliction: infliction
influence: influence
inform: inform
infusion: infusion
ing: ing
ingenuous: ingenuous
inglorious: inglorious
ingot: ingots
ingratitude: ingratitude
ingredient: ingredient,ingredients
inherent: inherent
inherit: inherits
initiation: initiation
injure: injured
injured: injured
injury: injury
ink: ink
inky: inky
inlaid: inlaid
inlay: inlaid
inly: inly
innate: innate
innkeeper: innkeepers
innocence: innocence
innocent: innocent
innocently: innocently
innovation: innovation
inoculation: inoculation
inoffensive: inoffensive
inquire: inquire,inquired
inquiries: inquiries
inquiry: inquiry
inquisition: inquisition,inquisitions
inquisitor: inquisitors
insanity: insanity
insatiate: insatiate
inscribe: inscribe
inscrutable: inscrutable
insect: insects
insecure: insecure
insensible: insensible
insert: insert,inserted
insinuate: insinuating
insinuation: insinuation
insipid: insipid
insist: insist,insisting,insists
insolence: insolence
insolent: insolent
inspect: inspect
inspector: inspector
inspiration: inspiration
inspire: inspired,inspires,inspiring
inspirer: inspirers
instance: instance,instances
instant: instant
instantly: instantly
instep: instep
instil: instilling
instinct: instinct
instruct: instructing,instructs
instruction: instructions
instructor: instructor
instrument: instrument,instruments
insular: insular
insult: insult,insults
insure: insure
integrity: integrity
intellect: intellect,intellects
intellectual: intellectual
intelligence: intelligence
intelligible: intelligible
intend: intended,intends
intense: intense
intensity: intensity
intent: intent
intention: intention,intentions
inter: inter
interfere: interfered
interim: interim
interior: interior
interjection: interjection,interjections
interminable: interminable
intermission: intermission,intermissions
internal: internal
interpose: interposed
interpret: interpreted
interpretation: interpretation
interpreter: interpreter
interrupt: interrupt,interrupted
intertwist: intertwisted
interval: intervals
intervene: intervene,intervenes,intervening
interview: interview
intestate: intestate
intoxicate: intoxicates
intoxication: intoxication
intrigante: intrigante
intrigue: intrigues
introduce: introduce
introduction: introduction
intrude: intrude
intrusive: intrusive
inundation: inundations
inurbanity: inurbanity
inure: inured
inurn: inurn
invade: invaded
invalid: invalid
invasion: invasion
invent: invent,invented
investigate: investigating
investigation: investigation
inveterate: inveterate
invincible: invincible
inviolate: inviolate
invitation: invitation
invite: invite,invited,inviting
involve: involve,involved
inwardly: inwardly
ionian: ionian
ira: ira
ire: ire
ireland: ireland
irish: irish
irishman: irishman
iron: iron
irregular: irregular,irregulars
irregularity: irregularity
irregularly: irregularly
irreligion: irreligion
irrevocable: irrevocable
irrigate: irrigate
isaac: isaac
island: island,islands
islander: islander
islands: islands
isle: isle,isles
isles: isles
israelites: israelites
issue: issue,issuing
isthmus: isthmus
italian: italian,italians
italy: italy
itch: itch
item: items
ithaca: ithaca
ivory: ivory
ivresse: ivresse
ivy: ivy
ixion: ixion
jack: jack
jackal: jackal,jackals
jacket: jacket,jackets
jacks: jacks
jacob: jacob
jacobin: jacobins
jade: jade,jaded
jailor: jailor
james: james
janizaries: janizaries
jar: jar
jargon: jargon
jasmine: jasmine
jason: jason
jaunt: jaunt
jaw: jaws
jealous: jealous
jealousy: jealousies,jealousy
jean: jean
jeer: jeer
jefferson: jefferson
jeffrey: jeffrey
jelick: jelick
jelly: jelly
jemmy: jemmy
jeopardy: jeopardy
jerome: jerome
jest: jest
jesting: jesting
jet: jet
jetty: jetty
jew: jew
jews: jews
jingle: jingled
joanna: joanna
job: job
jocund: jocund
john: john
johnson: johnson
joint: joint
joke: joke,jokes,joking
joker: jokers
jolly: jolly
jolt: jolt
jones: jones
jose: jose
joseph: joseph
jostle: jostle
jot: jot
joubert: joubert
journal: journal,journals
journey: journey
jove: jove
joy: joy,joys
joyous: joyous
juan: juan
judge: judge,judged,judges,judging
judgment: judgment,judgments
judiciously: judiciously
jugular: jugular
juice: juice
juicy: juicy
julia: julia
july: july
jumbling: jumbling
jump: jump
junction: junction
juncture: juncture
june: june
jungle: jungle
junior: junior
juniper: juniper
jupiter: jupiter
jury: juries,jury
justice: justice,justices
justify: justify
justly: justly
juvenal: juvenal
juvenile: juvenile
kaleidoscope: kaleidoscope
kalends: kalends
kant: kant
katinka: katinka
keats: keats
keel: keel
keen: keen
keg: keg
kelp: kelp
ken: ken
kentucky: kentucky
kerchief: kerchief
ketch: ketch
kettle: kettle
key: key
khan: khan
kibe: kibes
kibitka: kibitka
kick: kick,kicks
kid: kid
kiddy: kiddy
kill: kill,killing
killing: killing
kin: kin
kindle: kindle,kindled,kindling
kindling: kindling
kindly: kindly
kindness: kindness
king: king,kings
kingdom: kingdom,kingdoms
kingly: kingly
kiss: kiss,kisses,kissing
kist: kist
kit: kit
kite: kite
kith: kith
kitten: kittens
knead: knead
knee: knee,knees
kneed: kneed
kneel: kneel,kneeling,knelt
knell: knell
knife: knife,knives
knight: knight,knighted,knights
knit: knit
knock: knock,knocking,knocks
knocker: knockers
knocking: knockings
knoll: knoll
knot: knot,knots
knowledge: knowledge
koran: koran
label: label
laborious: laborious
labour: labour,labouring
labyrinth: labyrinth
lace: lace,laces
lack: lack
lackey: lackeys
lad: lad,lads
ladder: ladder,ladders
laden: laden
lady: ladies,lady
laissez: laissez
lake: lake,lakes
laker: lakers
lamb: lamb
lame: lame,lamed
lament: lamented
lamentation: lamentation
lamp: lamp,lamps
lamplighter: lamplighter
lance: lance
land: land,landed,landing,lands
landholders: landholders
landing: landing
landlord: landlord,landlords
landscape: landscape
landsman: landsmen
landsmen: landsmen
lane: lane
lang: lang
language: language,languages
languid: languid
languish: languish,languishing
languor: languor
lantern: lantern,lanterns
laocoon: laocoon
lap: lap,laps
lapse: lapse,lapsed
lapsus: lapsus
lark: lark
lash: lash,lashes
lassitude: lassitude
lasting: lasting
late: late
latin: latin
latitude: latitude
lattice: lattice
laud: laud
laudanum: laudanum
laugh: laugh,laughing,laughs
laughter: laughter
laura: laura
laureate: laureate
laurel: laurel,laurels
lava: lava
lave: lave,laves
lavish: lavish
law: law,laws
lawful: lawful
lawsuit: lawsuit,lawsuits
lawyer: lawyer,lawyers
lay: laid,lay,laying,lays
lazaret: lazaret
lazy: lazy
le: le
lead: lead,leading,leads,led
leaden: leaden
leader: leader
leaf: leaf,leaves
leafy: leafy
leagued: leagued
leaguer: leaguer
leak: leak
lean: lean,leaning,leans,leant
leander: leander
leaning: leaning
leap: leap,leaping,leaps
lear: lear
learn: learn,learned,learning,learns,learnt
learnedly: learnedly
learning: learning
lease: lease,leases
leather: leathers
leathern: leathern
leave: leave,leaves,leaving,left
leaven: leaven,leavening
leaves: leaves
lecture: lecture,lectures,lecturing
lee: lee
leer: leers
left: left
leg: leg,legs
legacy: legacy
legal: legal
legend: legend
leghorn: leghorn
legitimacy: legitimacy
legitimate: legitimate
legitimately: legitimately
leila: leila
leisure: leisure
leman: leman
lend: lend,lends,lent
lengthen: lengthen,lengthening
lengthy: lengthy
lenient: lenient
lessen: lessen
lesson: lesson,lessons
lethe: lethe
letter: letter,letters
levant: levant
levee: levee
level: level,levels
lexicon: lexicon
liaison: liaison
liar: liar,liars
libation: libations
libel: libel,libels
liberal: liberal
liberate: liberate
liberated: liberated
liberator: liberator
liberty: liberty
library: library
licence: licence,licences
license: license
licentiate: licentiate
lid: lid,lids
lie: lain,lie,lied,lies,lying
liege: liege
lieu: lieu
lieutenant: lieutenant
life: life,lives
lifeless: lifeless
lifetime: lifetime
lift: lift,lifted,lifting
light: light,lighted,lighter,lightest,lights,lit
lighted: lighted
lighten: lighten
lighting: lighting
lightly: lightly
lightning: lightning
ligne: ligne
liken: liken
likeness: likeness
liking: liking,likings
lilac: lilac
lilliput: lilliput
lily: lilies,lily
limb: limb,limbs
lime: lime
limit: limit,limited,limits
lincoln: lincoln
lineage: lineage
lineal: lineal
linen: linen
linger: linger,lingering,lingers
link: link
linnet: linnet
lint: lint
lion: lion,lions
lioness: lioness
lions: lions
lip: lip,lips
lipless: lipless
liquid: liquid
liquor: liquor,liquors
lisp: lisp
lisper: lisper
list: list,lists
listen: listen,listening,listens
listener: listener
literary: literary
literature: literature
litigious: litigious
litter: litter
live: live,lived,lives,living
lively: livelier,lively
liver: liver
livid: livid
living: living
livonian: livonian
lo: lo
load: load,loaded
loaf: loaves
loam: loam
loan: loan
loath: loath
loathe: loathe,loathes
loathing: loathing
loathsome: loathsome
lobster: lobster
lochaber: lochaber
lock: lock,locks
lockless: lockless
locust: locust
lodge: lodge,lodged
lodgment: lodgment
lofty: loftier,loftiest,lofty
log: log
logical: logical
loiter: loiter
london: london
lone: lone
loneliness: loneliness
lonely: lonely
longbow: longbow
longevity: longevity
longing: longing,longings
longings: longings
longueur: longueurs
loophole: loophole
loose: loose
loosely: loosely
lop: lopping
lope: lope
lord: lord,lords
lordlings: lordlings
lords: lords
lordship: lordships
lore: lore
lorraine: lorraine
lose: lose,loses,losing,lost
loss: loss
lost: lost
lot: lot,lots
loth: loth
lottery: lottery
loud: loud,louder,loudest
loudly: loudly
louis: louis
lounging: lounging
love: love,loved,loves,loving
lovely: loveliest,lovely
lover: lover,lovers
loving: loving
lowe: lowe
loyal: loyal
loyalty: loyalty
lubberly: lubberly
lucid: lucid
lucifer: lucifer
luck: luck
luckily: luckily
luckless: luckless
lucklessly: lucklessly
lucky: luckier,luckiest,lucky
lucretius: lucretius
lucubration: lucubration,lucubrations
lue: lues
luggage: luggage
lull: lull
luminous: luminous
lunatic: lunatic
luncheon: luncheon,luncheons
lune: lunes
lurch: lurch
lure: lure,lures
lurk: lurk,lurked,lurking,lurks
lust: lust
lustily: lustily
lustre: lustre
lute: lute,lutes
luther: luther
luxuriant: luxuriant
luxurious: luxurious
lynx: lynx
lyre: lyre
lyric: lyric
macassar: macassar
machiavel: machiavel
machiavellian: machiavellian
machine: machines
machinery: machinery
mad: mad
madam: madam
madden: madden
maddening: maddening
madeira: madeira
madly: madly
madman: madmen
madmen: madmen
madness: madness
madrid: madrid
magazine: magazine,magazines
maggot: maggots
magic: magic
magician: magician,magicians
magisterial: magisterial
magnanimity: magnanimity
magnanimous: magnanimous
magnesia: magnesias
magnetic: magnetic
magnetism: magnetism
magnificent: magnificent
magnificently: magnificently
magnifique: magnifique
mahogany: mahogany
mahomet: mahomet
maid: maid,maids
maiden: maiden
maidenhead: maidenheads
maidenly: maidenly
maids: maids
mail: mail,mails
maim: maim
main: main
maintain: maintain
maintenance: maintenance
majestic: majestic
majestically: majestically
majesty: majesty
major: major
majora: majora
maker: maker,makers
mal: mal
malady: maladies
male: male
malgre: malgre
malice: malice
malicious: malicious
mall: mall
malmsey: malmsey
malt: malt
malthus: malthus
malus: malus
mamma: mamma
mammoth: mammoth,mammoths
manacle: manacles
manage: managed
mandarin: mandarin
mandate: mandate
manger: manger
manhood: manhood
mania: mania
manifest: manifested
manifold: manifold
mankind: mankind
manly: manlier,manly
mann: mann
manner: manner
manners: manners
mannish: mannish
manor: manor,manors
mansion: mansion
mantilla: mantilla
mantle: mantle,mantles
manure: manure,manured
mar: mar
marathon: marathon
marble: marble,marbled
march: march
marchioness: marchioness
margin: margin
maria: maria
marine: marine
mariner: mariners
mario: mario
mark: mark
market: market
marketable: marketable
marquess: marquess
marriage: marriage,marriages
married: married
marrow: marrow
marry: married,marry,marrying
mars: mars
marsh: marsh
marshal: marshal,marshals
marshall: marshall
mart: mart,marts
martial: martial
martyr: martyr,martyrs
martyrly: martyrly
marvel: marvel,marvelling
marvellous: marvellous
mary: mary
marys: marys
mas: mas
masculine: masculine
mask: mask,masks
masonic: masonic
masque: masque
masquerade: masquerade,masquerades,masquerading
mass: mass,masses
massy: massy
mast: mast,masts
master: master,masters
mastiff: mastiff
mat: mats
matapan: matapan
match: match,matches
matchless: matchless
mate: mate,mated,mates
material: material,materials
materialise: materialised
maternal: maternal
mathematical: mathematical
mathematician: mathematician
mathematics: mathematics
matrimonial: matrimonial
matrimony: matrimony
matron: matron,matrons
matter: matter,matters
matthew: matthew
mattock: mattock
mature: mature
maturer: maturer
maudlin: maudlin
maw: maws
max: max
maxim: maxim,maxims
mayor: mayor
maze: maze
meadow: meadows
meagre: meagre
meal: meal,meals
meander: meander
meaning: meaning
meant: meant
measure: measure,measured,measures,measuring
meat: meat,meats
mechanic: mechanics
mecum: mecum
medal: medals
medea: medea
media: medias
mediation: mediation
medicine: medicine,medicines
medio: medio
meditate: meditate,meditated
meditative: meditative
medium: medium
meed: meed
meek: meek,meekest
meet: meet,meets,met
meeting: meeting,meetings
melancholy: melancholy
mell: mell
mellifluously: mellifluously
mellow: mellow
melodrame: melodrame
melody: melodies,melody
melt: melt,melted,melts
melton: melton
memnon: memnon
memoirs: memoirs
memorandum: memorandum
memory: memory
memphian: memphian
menace: menaced
menacing: menacing
menagerie: menagerie
mend: mend,mended,mends
mene: mene
menelaus: menelaus
mental: mental
mention: mention,mentions
mephistopheles: mephistopheles
mercenary: mercenary
merchandise: merchandise
merchant: merchant
merchantman: merchantmen
mercurial: mercurial
mercury: mercury
mercy: mercies,mercy
mere: mere
meridian: meridian
merit: merit,merited,merits
meritorious: meritorious
mermaid: mermaid,mermaids
merriment: merriment
merry: merry
mesh: mesh
mess: mess
message: message
messenger: messenger
messmate: messmate
messuage: messuages
met: met
metal: metal,metals
metamorphosis: metamorphosis
metaphor: metaphor
metaphysical: metaphysical
metaphysician: metaphysician
metaphysics: metaphysics
meteor: meteor,meteors
methinks: methinks
method: method,methods
methodistic: methodistic
metropolis: metropolis
mi: mi
mia: mia
microcosm: microcosm
middle: middle
middling: middling
midnight: midnight
midst: midst
mien: mien,miens
mighty: mightier,mightiest,mighty
milan: milan
mild: mild,milder,mildest
mildly: mildly
mile: mile,miles
military: military
milk: milk
milky: milky
millennium: millennium
milliard: milliards
milliner: milliners
millinery: millinery
millpond: millpond
milor: milor
milton: milton
miltonic: miltonic
mimic: mimic,mimics
minaret: minaret
mind: mind,minds
minded: minded
mindful: mindful
minerva: minerva
mingle: mingle,mingled,mingling
miniature: miniature
minion: minion
minister: minister,ministers
ministerial: ministerial
minority: minority
minotaur: minotaur
minstrel: minstrel
mint: mint
mintage: mintage
minute: minute,minutes,minutest
miracle: miracle
mire: mire
mirk: mirk
mirror: mirror,mirrors
mirth: mirth
mis: mis
misanthrope: misanthrope
misanthropy: misanthropy
misapply: misapplied
miscalculation: miscalculation
miscarriage: miscarriage
miscarry: miscarried,miscarry
mischance: mischance
mischief: mischief,mischiefs
mischievous: mischievous
miscreant: miscreant
miser: miser,misers
miserable: miserable
misery: miseries,misery
misfortune: misfortune
mishap: mishap
misnomer: misnomer
missal: missal
missing: missing
mission: mission
mist: mist,mists
mistake: mistake,mistakes,mistook
mistaken: mistaken
mistaking: mistaking
mister: misters
misters: misters
mistook: mistook
mistress: mistress,mistresses
misty: misty
mite: mite
mitigate: mitigated
mix: mix,mixed,mixes
mixture: mixture
mizen: mizen
moan: moans
mob: mob,mobs
mobility: mobility
mocha: mocha
mock: mock
mockery: mockeries,mockery
mode: mode
model: model
moderate: moderate
moderately: moderately
moderation: moderation
modern: modern,moderns
modest: modest
modestly: modestly
modesty: modesty
modify: modify
mogul: mogul
moisture: moisture
mole: mole
moliere: moliere
molten: molten
moment: moment,moments
momentary: momentary
momently: momently
momus: momus
monarch: monarch,monarchs
monarchs: monarchs
monastery: monastery
monastic: monastic
monde: monde
money: money
mongst: mongst
monied: monied
monitor: monitors
monk: monk,monks
monkey: monkey
monmouth: monmouth
monopoly: monopoly
monosyllable: monosyllable
monotony: monotony
monsoon: monsoon
monster: monster,monsters
monstrous: monstrous
month: month,months
monthly: monthly
monument: monument,monuments
mood: mood
moon: moon,moons
moonbeam: moonbeams
moonlight: moonlight
moonlit: moonlit
moonshine: moonshine
moor: moor
moore: moore
moorish: moorish
moral: moral,morals
moralist: moralist,moralists
morality: moralities,morality
morally: morally
mores: mores
morn: morn,morns
morning: morning
morocco: morocco
morrow: morrow
morsel: morsel,morsels
mortal: mortal,mortals
mortality: mortality
mortar: mortars
mortgage: mortgage
mortified: mortified
moscow: moscow
moses: moses
moslem: moslem,moslems
mosque: mosque,mosques
mot: mot
moth: moth,moths
mother: mother,mothers
motion: motion,motions
motionless: motionless
motive: motive,motives
motley: motley
mots: mots
motto: motto
mould: mould,moulded
mouldy: mouldy
mount: mount,mounted,mounting,mounts
mountain: mountain,mountains
mountaineer: mountaineers
mourn: mourn,mourning,mourns
mourner: mourner
mournful: mournful
mourning: mourning
mouse: mouse
mouth: mouth,mouths
mouthy: mouthy
movable: movables
movement: movement,movements
mow: mowing,mows
mower: mower
mozart: mozart
muck: mucks
mud: mud
muddle: muddle
muddy: muddy
muezzin: muezzin
muffin: muffin
muffle: muffle,muffles
muffled: muffled
mufti: mufti
mulct: mulct
mule: mule
multifarious: multifarious
multiplication: multiplication
multiply: multiplied,multiply
multitude: multitude,multitudes
mummy: mummy
murder: murder
murderer: murderer
murmur: murmur,murmuring,murmurs
murray: murray
muscle: muscle
muscovite: muscovite
muse: muse,mused,muses,musing
muses: muses
museum: museum
music: music
musical: musical
musico: musico
musk: musk
musket: muskets
musketry: musketry
muslin: muslin
mussulman: mussulman
mustachio: mustachios
muster: muster
mutability: mutability
mute: mute,mutes
mutilate: mutilated
mutter: mutter,mutters
muttering: muttering
mutton: mutton
mutual: mutual
mutually: mutually
muzzle: muzzle
myriad: myriads
myrmidon: myrmidons
myrtle: myrtle
mysterious: mysterious
mystery: mysteries,mystery
mystic: mystic
mystical: mystical
mystify: mystified
mythological: mythological
mythology: mythology
nadir: nadir
nag: nag
naiad: naiad
nail: nail,nails
naked: naked
nameless: nameless
names: names
nap: naps
napoleon: napoleon
narrate: narrate,narrating
narration: narration
narrative: narrative
narrow: narrow
narrowness: narrowness
natal: natal
nathless: nathless
nation: nation,nations
national: national
nations: nations
native: native
natural: natural
naturally: naturally
nature: nature,natures
naught: naught
naughty: naughty
nausea: nausea
nauseous: nauseous
nautical: nautical
naval: naval
navigate: navigate
navigation: navigation
navigator: navigators
nazarene: nazarene
nazarenes: nazarenes
nearer: nearer
neat: neat
neath: neath
neck: neck,necks
neckcloth: neckcloth
nectar: nectar
needle: needle,needles
needy: needy
negative: negatives
neglect: neglect,neglected
negligently: negligently
negotiation: negotiation
negro: negro,negroes
negroes: negroes
neighbour: neighbour,neighbouring,neighbours
nelson: nelson
neptune: neptune
nerve: nerve,nerves
nervous: nervous
nessus: nessus
nest: nest
nestle: nestle,nestled
nestor: nestors
netherlands: netherlands
neuter: neuter
neutral: neutral
neutrality: neutrality
neutralize: neutralize
newgate: newgate
newly: newly
news: news
newspaper: newspaper,newspapers
newton: newton
nibble: nibble,nibbling
nice: nice
nicety: nicety
niche: niche
nickname: nickname,nicknamed
niece: nieces
nigh: nigh,nighest
nigher: nigher
night: night,nights
nightingale: nightingale,nightingales
nightly: nightly
nil: nil
nile: nile
nill: nill
nimrod: nimrod,nimrods
nineteen: nineteen
nineteenth: nineteenth
ninon: ninon
ninth: ninth
noah: noah
noble: noble,nobler,noblest
noblest: noblest
nobly: nobly
nod: nod,nodded,nodding,nods
noddy: noddy
noise: noise,noises
nomenclature: nomenclature
nominal: nominal
nominate: nominated
nonce: nonce
nondescript: nondescript
nonentity: nonentity
nonsense: nonsense
nonsuit: nonsuit
nook: nook,nooks
noon: noon
noontide: noontide
norman: norman
north: north
northern: northern
nose: nose,noses
note: note,notes
noteless: noteless
nothingness: nothingness
notice: notice
notion: notion,notions
notoriety: notoriety
notorious: notorious
nought: nought
noun: noun
nourish: nourish,nourishes
nous: nous
novelty: novelties,novelty
november: november
novice: novice
nubia: nubia
nugae: nugae
numa: numa
numb: numb
numeral: numeral
numerous: numerous
numidian: numidian
nun: nun,nuns
nunnery: nunnery
nuptial: nuptial
nuptials: nuptials
nurse: nursed,nurses,nursing
nursery: nursery
nursing: nursing
nurture: nurtured
nut: nut,nuts
nutritious: nutritious
nutty: nutty
nymph: nymph,nymphs
oak: oak,oaks
oar: oar,oars
oath: oath,oaths
oats: oats
obdurate: obdurate
obedience: obedience
obeisance: obeisance
obey: obey,obeys
object: object,objects
objection: objection,objections
oblige: oblige,obliged,obliges,obliging
oblivion: oblivion
oblivious: oblivious
obscure: obscure
obscurity: obscurity
obsequious: obsequious
observant: observant
observation: observation
observe: observe,observed,observing
observer: observer
obsolete: obsolete
obstinacy: obstinacy
obstinate: obstinate
obtuse: obtuse
obvious: obvious
occasion: occasion,occasions
occasionally: occasionally
occupant: occupants
occupation: occupation
occupy: occupied,occupies
occur: occur,occurs
ocean: ocean
octave: octave,octaves
oda: oda
odd: odd,oddest
oddity: oddities
oddly: oddly
odds: odds
ode: ode,odes
odour: odours
odysseys: odysseys
oedipus: oedipus
offence: offence,offences
offend: offend,offending
offer: offer
offering: offering
office: office,offices
officer: officer,officers
official: official
offspring: offspring
oft: oft
oftener: oftener
oftentimes: oftentimes
ogle: ogle,ogled,ogling
oil: oil
olden: olden
oligarch: oligarchs
olive: olive,olives
olympus: olympus
omen: omen
ominous: ominous
omission: omission
omit: omit,omitting
onward: onward
onwards: onwards
ooze: oozed,oozing
ope: ope
opener: opener
opera: opera,operas
operation: operations
ophelia: ophelia
opiate: opiate
opine: opine
opinion: opinion,opinions
opium: opium
opportune: opportune
opportunity: opportunities,opportunity
oppose: oppose,opposed,opposing
opposition: opposition
oppress: oppress
oppression: oppression
oppressive: oppressive
optics: optics
oracle: oracle
orange: orange,oranges
oration: oration
orator: orator,orators
oratory: oratory
orb: orb,orbs
orbit: orbit
ordain: ordain
ordeal: ordeal
orderly: orderly
ordination: ordination
ordure: ordure
ore: ore
organ: organ
orient: orient
oriental: oriental
origin: origin
original: original
ornament: ornament,ornamented,ornaments
orphan: orphan,orphans
orpheus: orpheus
orthodox: orthodox
orthography: orthography
ossian: ossian
ostentation: ostentation
ostler: ostler
ottoman: ottoman
outbalances: outbalances
outcry: outcry
outlet: outlet
outline: outline,outlines
outrage: outrage
outrageous: outrageous
outrun: outran,outrun
outstretch: outstretch
outward: outward
outwork: outwork
oven: ovens
overboard: overboard
overcharge: overcharge
overcome: overcome,overcoming
overdo: overdid
overhang: overhung
overhead: overhead
overjoy: overjoy
overlay: overlay
overlook: overlook,overlooks
overpower: overpowering,overpowers
overpowering: overpowering
overset: overset
overstrain: overstrain
overthrow: overthrown
overture: overture
overturn: overturns
overwork: overworking
overworn: overworn
overwrought: overwrought
ovid: ovid
ow: ow
owe: owe,owed,owes
owl: owl
owner: owner,owners
ox: ox
oyster: oyster,oysters
pace: pace,paced,paces
pacha: pacha,pachas
pack: pack
packet: packet,packets
pad: pad,pads
padlock: padlock
pagan: pagan
pagans: pagans
pageant: pageant
paid: paid
pail: pail
pain: pain,paining,pains
painful: painful
paint: paint,painted,paints
painter: painter,painters
painting: painting
pair: pair,pairs
palace: palace,palaces
palate: palates
pale: pale,pales
palely: palely
paler: paler
palisade: palisade,palisades
palisado: palisado
pall: pall,palls
pallas: pallas
pallid: pallid
palm: palm,palms
palpable: palpable
palpably: palpably
palpitating: palpitating
palpitation: palpitation
palsied: palsied
paltry: paltry
pamper: pamper
pamphlet: pamphlets
pan: pan
pander: pandering
panel: panels
pang: pang,pangs
panoramic: panoramic
pant: pant,panted
pantaloons: pantaloons
pantisocracy: pantisocracy
pantomime: pantomime,pantomimes
pants: pants
papa: papa
paper: paper,papers
paphian: paphian
paphians: paphians
par: pars
parable: parable
parade: parade,parades,parading
paradise: paradise
paradox: paradox
paragon: paragon,paragons
paragraph: paragraph
parallel: parallel
paramour: paramour
parapet: parapet
paras: paras
parasite: parasites
parcae: parcae
parchment: parchment
pardon: pardon
pare: pare,paring
parent: parent,parents
parental: parental
parenthesis: parenthesis
parentless: parentless
paris: paris
parish: parish
parisian: parisian
parks: parks
parliament: parliament
parliamentary: parliamentary
parnassian: parnassian
paroxysm: paroxysm
parrot: parrots
parry: parries,parry
parson: parson
partake: partake,partakes
partial: partial
participate: participated
particle: particle
partly: partly
partner: partner,partners
partridge: partridge,partridges
parturition: parturition
party: parties,party
pas: pas
pasiphae: pasiphae
pass: pass,passes,passing
passage: passage
passee: passee
passenger: passenger,passengers
passim: passim
passion: passion,passions
passionate: passionate
passionless: passionless
passive: passive
passport: passport
pastime: pastime,pastimes
pastor: pastor
pastoral: pastoral
pasture: pasture
pat: pat
patagonian: patagonian
patch: patch,patching
patent: patent
paternal: paternal
path: path,paths
pathetic: pathetic
pathetically: pathetically
pathos: pathos
pathway: pathway
patience: patience
patient: patient,patients
patriarch: patriarch
patrician: patrician
patriot: patriot,patriots
patriotic: patriotic
patriotism: patriotism
patroclus: patroclus
patron: patron,patrons
patronage: patronage
pattern: pattern
paul: paul
pause: pause,paused,pausing
pave: pave,paved
paved: paved
pavement: pavement
pavilion: pavilion
paviour: paviour
paw: paws
pawn: pawns
pay: paid,pay,paying,pays
payment: payment
pea: peas
peace: peace
peaceable: peaceable
peaceful: peaceful
peacock: peacock
peak: peaks
peal: peal,peals
pearl: pearl,pearls
peasant: peasant,peasants
pebble: pebble,pebbles
peccadillo: peccadillos
peccant: peccant
peck: peck,pecking
peculiar: peculiar
peculiarly: peculiarly
pedantic: pedantic
pedestrian: pedestrian
pedigree: pedigree,pedigrees
pedlar: pedlar,pedlars
pedro: pedro
peep: peep,peeped,peeping
peeping: peeping
peer: peer,peering,peers
peerage: peerage
peeress: peeresses
peg: pegs
pegasus: pegasus
peleus: peleus
pelf: pelf
pelides: pelides
pelisse: pelisse
pell: pell
pen: pen,pens
penalty: penalty
pence: pence
penchant: penchant,penchants
pencil: pencil
penetrate: penetrate
penitence: penitence
pension: pension,pensions
pensive: pensive
people: peopled,peoples,peopling
peopled: peopled
perceive: perceive,perceived,perceives,perceiving
perceptibly: perceptibly
perception: perception
perch: perch
perchance: perchance
perdition: perdition
perennial: perennial
perfect: perfect
perfection: perfection
perfectly: perfectly
perforce: perforce
perform: perform,performed
performance: performance,performances
performer: performer
perfume: perfume
peril: peril,perils
period: period
perish: perish
periwig: periwigs
perjure: perjured
permanent: permanent
permission: permission
permit: permit,permits,permitted
peroration: peroration
perpend: perpend
perpendicular: perpendicular
perpetrate: perpetrate,perpetrated,perpetrates
perpetual: perpetual
perplex: perplex,perplexes
perplexing: perplexing
perplexity: perplexity
persecute: persecuted
persecution: persecution
persian: persian,persians
persiflage: persiflage
person: people,person,persons
personage: personage
personal: personal
personification: personification
personify: personified,personify
perspective: perspective
perspicuous: perspicuous
persuade: persuade,persuaded
persuasion: persuasion
pert: pert
pertinacious: pertinacious
pertinacity: pertinacity
peru: peru
peruke: peruke
perusal: perusals
peruse: peruse
pervade: pervaded,pervades
pervenche: pervenche
perversely: perversely
pestilence: pestilence
peter: peter
peters: peters
petit: petits
petition: petition
petrified: petrified
petticoat: petticoat,petticoats
petty: petty
phaedra: phaedra
phaeton: phaeton
phalanx: phalanx
phantasy: phantasies,phantasy
phantom: phantom,phantoms
pharisaic: pharisaic
pheasant: pheasants
phenomenon: phenomenon
phidian: phidian
philanthropic: philanthropic
philanthropy: philanthropy
philip: philip
philosopher: philosopher,philosophers
philosophic: philosophic
philosophical: philosophical
philosophise: philosophise,philosophised
philosophy: philosophy
phlegethontic: phlegethontic
phoebus: phoebus
phosphorus: phosphorus
phrase: phrase,phrases
phraseology: phraseology
phrensy: phrensy
phrygian: phrygian
phthisic: phthisics
phthisical: phthisical
physic: physic
physical: physical
physician: physician,physicians
physics: physics
piastre: piastres
piccadilly: piccadilly
pick: pick,picking
pickings: pickings
pickle: pickle
picture: picture,pictured,pictures
picturesque: picturesque
piddle: piddle
piece: piece,pieced,pieces
pierce: pierce,pierced,pierces,piercing
piety: piety
pig: pig
pigmy: pigmies
pike: pike,pikes
pilaus: pilaus
pile: pile,piled
pilgrim: pilgrim
pill: pill,pills
pillage: pillage
pillar: pillar,pillars
pillow: pillow,pillowing,pillows
pilot: pilots
pimp: pimp
pin: pin,pins
pinch: pinch
pinchbeck: pinchbeck
pincushion: pincushion
pine: pine
pinion: pinion,pinions
pink: pink
pinnace: pinnace
pinnacle: pinnacle
pint: pint
pious: pious
pipe: pipe,pipes
pipkin: pipkins
pippin: pippin
pique: pique,piques
piracy: piracy
pirate: pirate,pirates
piratical: piratical
pistachio: pistachio
pistol: pistol,pistols
pit: pit,pits
pitch: pitch,pitches
pitcher: pitcher
piteous: piteous
piteously: piteously
pith: pith
pithy: pithy
pitied: pitied
pitiless: pitiless
pittance: pittance
pity: pitied,pities,pity,pitying
pivot: pivot
placeman: placeman,placemen
placid: placid
plague: plague,plagued,plagues
plaid: plaids
plain: plain,plains
plainly: plainly
plaintively: plaintively
plan: plan,plans
planet: planet,planets
plank: planks
plant: plant,planted,plants
plantagenet: plantagenet
plat: plat
plate: plate,plates
plato: plato
platonic: platonic
platonical: platonical
platonism: platonism
play: play,playing,plays
player: player
playful: playful
plead: plead,pleaded,pleads
pleader: pleaders
pleading: pleading,pleadings
pleasant: pleasant,pleasanter
pleased: pleased
pleasing: pleasing
pleasure: pleasure,pleasures
pledge: pledged
plenipo: plenipo
plentiful: plentiful
plenty: plenty
pliable: pliable
pliant: pliant
plight: plight,plighted
plighted: plighted
plod: plodding
plottery: plottery
plough: plough,ploughing,ploughs
ploughman: ploughman
pluck: pluck,plucking,plucks
plumage: plumage
plume: plume,plumed,plumes
plumpness: plumpness
plunder: plunder,plundering
plunderer: plunderers
plunge: plunge,plunged
plural: plural
plutarch: plutarch
ply: plied,ply
poacher: poacher,poachers
pocket: pocket,pockets
poem: poem,poems
poesy: poesy
poet: poet,poets
poetess: poetess
poetic: poetic
poetical: poetical
poetry: poetry
pointer: pointer
poison: poison
poke: poke
poland: poland
polar: polar
pole: pole
poles: poles
policy: policy
polish: polish
polite: polite
politely: politely
politeness: politeness
politesse: politesse
political: political
politician: politician,politicians
politics: politics
pollution: pollution
polygamy: polygamy
pomegranate: pomegranate,pomegranates
pomp: pomp
pompey: pompey
ponder: ponder,pondering
poniard: poniard
pooh: pooh
poor: poor
pop: popping
pope: pope
poplar: poplar,poplars
poppy: poppies
popular: popular
popularity: popularity
population: population
porcelain: porcelain
porch: porch
porcupine: porcupine
pore: pored
pork: pork
porous: porous
porphyry: porphyry
port: port
portal: portal
portentous: portentous
porter: porter
portion: portion,portions
portmanteau: portmanteau
portmanteaus: portmanteaus
portrait: portrait,portraits
portugal: portugal
pose: pose,posed
position: position,positions
positive: positive
positively: positively
posse: posse
possess: possess
possession: possession
possessor: possessor,possessors
post: post,posted,posting,posts
postboy: postboys
posterity: posterity
postilion: postilion,postilions
postpone: postpone,postponed
posture: posture
pot: pot
potation: potations
potato: potato,potatoes
potential: potential
potion: potion
pottery: pottery
pounce: pounce
pound: pounds
pour: pour,pours
pout: pouting
pouting: pouting
power: power,powers
powerful: powerful
powerless: powerless
powers: powers
pox: pox
practicable: practicable
practice: practice
practise: practise,practised,practising
praetorian: praetorian
praise: praise,praised,praises
prance: prance,prancing
prank: prank,pranks
prate: prate,prated
prattle: prattle
pray: pray,praying
prayer: prayer,prayers
preach: preach
preacher: preacher,preachers
precarious: precarious
precaution: precaution,precautions
precautionary: precautionary
precautious: precautious
precede: precedes
precedence: precedence
precedent: precedent
precept: precept
precinct: precincts
precious: precious
precipice: precipice,precipices
precipitate: precipitate
precipitation: precipitation
precise: precise
precisian: precisian
precision: precision
precocious: precocious
predecessor: predecessors
predicament: predicament
predicate: predicate
prediction: predictions
predilection: predilection
predominance: predominance
preface: preface
prefer: prefer,preferring,prefers
preference: preference
preferment: preferment
prejudice: prejudice
prelude: preludes
premature: premature
premise: premises,premising
preparation: preparation,preparations
preparative: preparatives
prepare: prepared
prepared: prepared
prepossession: prepossession,prepossessions
presage: presage,presaged,presaging
presbyterian: presbyterian
prescience: prescience
prescribe: prescribed
prescription: prescription
presence: presence
preservation: preservation
preserve: preserve,preserved,preserving
preside: preside
press: press,pressed,pressing
pressure: pressure
presume: presume,presumed,presumes
pretence: pretence,pretences
pretend: pretend,pretended
pretender: pretenders
pretension: pretension,pretensions
prettily: prettily
pretty: prettiest,pretty
preux: preux
prevail: prevail,prevailing
prevarication: prevarication
prevent: prevented,prevents
preventative: preventative
previous: previous
prey: prey
priam: priam
price: price,prices
prick: prick,pricking,pricks
pride: pride,prided
priest: priest,priests
prim: prim
prima: prima
primate: primate
prime: prime
primly: primly
primrose: primrose
prince: prince,princes
princely: princely
princess: princess,princesses
principal: principal
principle: principle,principles
print: print,printed,printing
prior: prior
priority: priority
priscian: priscian
prism: prism
prison: prison,prisons
prisoner: prisoner,prisoners
prithee: prithee
private: private
privateer: privateer
privilege: privilege,privileges
privy: privy
prize: prize,prizes
proceed: proceed,proceeded,proceeding,proceeds
proceeding: proceeding
proceedings: proceedings
process: process
proclaim: proclaim
procreation: procreation
procreative: procreative
prodigally: prodigally
prodigious: prodigious
prodigy: prodigy
produce: produce,produced,produces
production: production
proem: proem
profanely: profanely
profess: profess
profession: profession,professions
professional: professional
professor: professor
professors: professors
proffer: proffer
profile: profiles
profit: profit,profits
profound: profound,profounder
profuse: profuse
profusely: profusely
profusion: profusion
progeny: progenies,progeny
progress: progress
progression: progression
prohibit: prohibited
project: project,projects
prolific: prolific
prologue: prologue
prolong: prolong,prolongs
promethean: promethean
prometheus: prometheus
prominent: prominent
promise: promise,promised,promises
promontory: promontory
promote: promoted,promoting
prompt: prompts
prompter: prompter
prone: prone
pronounce: pronounce,pronounced,pronounces
pronounced: pronounced
pronunciation: pronunciation
proof: proof,proofs
prop: prop
propagate: propagate,propagated
propagation: propagation
propensity: propensities,propensity
proper: proper,properest
properly: properly
property: properties,property
prophecy: prophecies,prophecy
prophesy: prophesy
prophet: prophet,prophets
prophetic: prophetic
prophetically: prophetically
proportion: proportion,proportions
proportionate: proportionate
proposal: proposal
propose: propose,proposed
proposition: proposition,propositions
propriety: propriety
proscribe: proscribed
prose: prose
prosecute: prosecuted
prosecution: prosecutions
proser: prosers
prosody: prosody
prospect: prospect
prospects: prospects
prosperity: prosperity
prosperous: prosperous
protect: protect,protected,protects
protection: protection
protector: protector,protectors
protege: protege
protest: protest,protested
proudly: proudly
prove: prove,proved,proves,proving
proverb: proverb
providence: providence
providentially: providentially
provider: providers
province: province
provision: provision
provocation: provocations
provoke: provoked,provoking
provoking: provoking
prow: prows
prowl: prowl
prude: prude,prudes
prudence: prudence
prudent: prudent
prudently: prudently
prudish: prudish
prussia: prussia
prussian: prussians
pry: prying
psalm: psalm,psalms
psalmist: psalmist
psalmodic: psalmodic
psyche: psyche
puberty: puberty
public: public
publicly: publicly
publish: publish
publisher: publisher
pudding: pudding
puddle: puddle
puff: puff
puke: pukes
pull: pull,pulling
pulse: pulse
pulv: pulv
pump: pump,pumps
pun: pun
punch: punch
puncheon: puncheon,puncheons
punctuation: punctuation
punctum: punctum
puncture: puncture
punic: punic
punish: punish
puny: puny
pup: pup
puppet: puppet,puppets
purblind: purblind
purchase: purchase,purchased,purchasing
purchaser: purchaser
pure: pure,purer,purest
puree: puree
purely: purely
purgative: purgatives
purgatorial: purgatorial
purgatory: purgatory
purge: purged
purity: purity
purl: purl
purple: purple
purpose: purpose,purposed,purposes
purse: purse,purses
pursue: pursue,pursued,pursues
pursued: pursued
pursuer: pursuer
pursuit: pursuits
purveyor: purveyor,purveyors
push: push
puzzle: puzzle,puzzled,puzzles,puzzling
puzzled: puzzled
puzzling: puzzling
pye: pye
pygmalion: pygmalion
pyramid: pyramid
pyramidic: pyramidic
pyramus: pyramus
pyrrhic: pyrrhic
pythagoras: pythagoras
pythoness: pythoness
qua: qua
quack: quacks
quadrille: quadrille
quadruple: quadruple
quae: quae
quaff: quaff
quaint: quaint
quake: quake
quaking: quaking
qualified: qualified
qualify: qualified
quality: qualities,quality
qualm: qualm,qualms
quantity: quantity
quarantine: quarantine
quarrel: quarrel,quarrelling,quarrels
quarter: quarter,quarters
quarterly: quarterly
quarto: quarto
quaver: quavering
quean: quean,queans
queen: queen,queens
queenly: queenly
queens: queens
queer: queer
quell: quell
quench: quench
quenchless: quenchless
quest: quest
question: question,questions
questioner: questioner
qui: qui
quia: quia
quibble: quibble
quick: quick,quicker
quicken: quickening
quickness: quickness
quicksilver: quicksilver
quiescent: quiescent
quiet: quiet,quietest,quiets
quietly: quietly
quill: quill
quincy: quincy
quintessence: quintessence
quintessential: quintessential
quire: quire
quit: quit,quitting
quiver: quiver,quivering
quixote: quixote
quixotic: quixotic
quiz: quiz
quizzical: quizzical
quotation: quotation
quote: quote,quoted,quotes,quoting
quoth: quoth
rabbi: rabbi
rabbit: rabbit
rabble: rabble
race: race,races
racer: racer
rack: rack
racks: racks
radiant: radiant
radical: radicals
raft: raft
rag: rag,rags
ragamuffin: ragamuffins
rage: rage,raged,rages,raging
ragged: ragged
ragout: ragout,ragouts
rail: rail,railing
raiment: raiment
rain: rain,raining,rains
rainbow: rainbow,rainbows
rainy: rainy
raise: raise,raised,raising
raisin: raisin
raising: raising
rake: rake,rakes
rally: rally
ram: ram
ramble: ramble
rampart: rampart
rang: rang
range: range,ranged,ranges
ranger: ranger
rank: rank,ranks
rankle: rankle
ransack: ransack
ransom: ransom
rap: rap
rape: rape
raphael: raphael
rapid: rapid
rapidly: rapidly
rapture: rapture,raptures
rare: rare
rarely: rarely
rarity: rarity
rascal: rascal,rascals
rash: rash
rashly: rashly
rat: rat
rate: rate,rated
ration: ration
rational: rational
rattle: rattle,rattles,rattling
ravage: ravage
rave: rave,raving
raven: raven
ravenous: ravenous
ravenously: ravenously
ravish: ravish
ravishing: ravishing
raw: raw
ray: ray,rays
reach: reach,reached,reaches,reaching
reacher: reachers
read: read,reading
reader: reader,readers
readiness: readiness
reading: reading,readings
ready: readiest,ready
real: real
reality: realities,reality
realm: realm,realms
reap: reap,reaping
reaper: reapers
rear: rear,reared,rears
reason: reason,reasons
reasonable: reasonable
reasoning: reasoning
rebel: rebel,rebels
rebuild: rebuilt
rebuke: rebuke,rebuked,rebukes
rebus: rebus
recall: recall
recede: receding
receipt: receipt
receipts: receipts
receive: receive,received,receives,receiving
receptacle: receptacles
reception: reception
recess: recess,recesses
recherche: recherche
recital: recital
recitative: recitative
recite: recite,recited
reck: reck
reckon: reckon,reckoning
reclaim: reclaim
recline: reclined
recognise: recognise,recognised
recognize: recognized
recollect: recollect,recollecting,recollects
recollection: recollection
recommence: recommence
recommend: recommend,recommended
recommendation: recommendation
recompense: recompenses
reconcile: reconcile,reconciled
reconciliation: reconciliation
reconnoitre: reconnoitre
record: record,recorded
records: records
recourse: recourse
recover: recover
recovery: recovery
recreation: recreations
recruit: recruited,recruits
red: red
redden: redden
redeem: redeem
redeeming: redeeming
redly: redly
redouble: redoubled
redoubted: redoubted
redress: redress,redressing
reduce: reduce,reduced,reduces
redundancy: redundancy
reed: reed
reef: reef,reefs
reek: reeking
reel: reel,reels
refection: refection
refectory: refectory
refer: refer,referring
reference: reference
refine: refined,refines
refined: refined
refinement: refinement
reflect: reflect,reflected
reflection: reflection
reform: reform
reformation: reformation
reformer: reformer
refreshing: refreshing
refreshment: refreshment
refuge: refuge
refusal: refusal,refusals
refuse: refuse,refused,refusing
regale: regale,regaled
regard: regard
regent: regent
regiment: regiment
regimental: regimental
region: region
regret: regret,regretted,regretting
regular: regular
regularity: regularity
regularly: regularly
regulate: regulated
rehearse: rehearsed
reign: reign,reigning
reject: reject,rejected,rejects
rejoice: rejoice
rejoin: rejoin
relapse: relapsing
relate: relate
relation: relation,relations
relative: relatives
relax: relax
release: released
relent: relent,relented
relic: relics
relief: relief
relieve: relieve,relieved
religion: religion
religious: religious
relinquish: relinquish
reluctance: reluctance
reluctant: reluctant
reluctantly: reluctantly
rely: relies,relying
remain: remain,remained,remains
remainder: remainder
remains: remains
remark: remark,remarks
remarkable: remarkable
remarkably: remarkably
remarry: remarried
rembrandt: rembrandt
remedy: remedies,remedy
remember: remember,remembering
reminiscence: reminiscence
remit: remits
remnant: remnant,remnants
remonstrance: remonstrance,remonstrances
remorse: remorse
remorseless: remorseless
remote: remote
removal: removal
remove: remove
rend: rend,rends
render: render,rendering,renders
rendezvous: rendezvous
renegade: renegade
renegado: renegado,renegadoes
renew: renew
renovate: renovate
renown: renown
rent: rent,rents
rental: rental
repair: repair,repairs
repartee: repartee,repartees
repass: repass
repast: repast
repay: repay
repeat: repeat,repeated
repeater: repeaters
repent: repent,repented,repents
repentance: repentance
repertory: repertory
repetition: repetition
replace: replaced
replenish: replenish
repletion: repletion
reply: replied,replies,reply
report: report,reported
repose: repose,reposed,reposes,reposing
representative: representative
reproach: reproach
reproof: reproof
reprove: reprove,reproved
reprover: reprover
republic: republics
repulse: repulsed
reputation: reputation,reputations
request: request,requested,requesting
require: require,required,requires
requisite: requisite
requisition: requisition
requite: requites
rescue: rescue
resemblance: resemblance
resemble: resembling
resentfully: resentfully
resentment: resentments
reserve: reserve,reserves
reset: reset
resident: resident
resign: resign,resigns
resist: resist,resisted
resistance: resistance
resolution: resolution,resolutions
resolve: resolve,resolved,resolves
resort: resort
resound: resounded
resource: resource,resources
respect: respect
respectable: respectable
respectably: respectably
respects: respects
respiration: respiration
rest: rest,rested,resting,rests
resting: resting
restive: restive
restless: restless
restlessness: restlessness
restoration: restoration
restore: restore,restored
restrain: restrain
restraint: restraints
restriction: restriction
result: result
resume: resume,resumed
resurrection: resurrection
retain: retain,retains
retch: retching
reticular: reticular
retire: retire,retired,retiring
retirement: retirement
retort: retort
retrace: retrace
retreat: retreat,retreated,retreating,retreats
retrograde: retrograde
retrospection: retrospection
return: return,returning,returns
reveal: revealed
revel: revel,revels
revelation: revelations
revelry: revelry
revenge: revenge,revenged
revere: revered
reverence: reverence
reverend: reverend
reverie: reverie,reveries
reverse: reverse,reversing
reversion: reversion
review: review
revisit: revisit
revive: revive,reviving
revoke: revoke
revolution: revolution
revolve: revolved
revolving: revolving
reward: reward,rewarded,rewards
rhenish: rhenish
rhetoric: rhetoric
rhine: rhine
rhodes: rhodes
rhyme: rhyme,rhymed,rhymes,rhyming
rib: rib
riband: riband,ribands
rice: rice
rich: rich,richer,richest
richard: richard
riches: riches
richly: richly
rid: rid
ridden: ridden
riddle: riddle,riddles
riddled: riddled
ride: ride,riding,rode
rider: rider
ridge: ridge
ridicule: ridicule,ridicules
ridiculous: ridiculous
riding: riding
rife: rife
rifle: rifles
rift: rift
righteousness: righteousness
rightly: rightly
rigid: rigid
rigmarole: rigmarole
rigour: rigour,rigours
rill: rill,rills
rime: rimes
rind: rind
ringlet: ringlets
rings: rings
riot: riot
riotous: riotous
rip: rip
ripe: ripe
ripen: ripen
ripeness: ripeness
riper: riper
ripple: ripple,ripples,rippling
rise: rise,risen,rises,rising,rose
riser: risers
risk: risk,risks
rite: rite
ritual: ritual
rival: rival
rivalship: rivalship
riven: riven
river: river
rivulet: rivulet
roach: roach
road: road,roads
roam: roam,roams
roar: roar,roaring,roars
roaring: roaring
roast: roast,roasts
rob: rob,robbing
robe: robe,robes
robust: robust
rock: rock,rocking,rocks
rocket: rockets
rocky: rocky
rod: rod
rode: rode
rodomont: rodomont
rogers: rogers
rogue: rogue,rogues
roland: roland
role: role
roll: roll,rolling,rolls
rolling: rolling
romagnole: romagnole
romaic: romaic
roman: roman,romans
romance: romance,romances
romancer: romancers
romances: romances
romantic: romantic
rome: rome
roof: roof,roofs
rook: rooks
roost: roosting
root: root,rooted,roots
rooted: rooted
rose: rose,roses
rosin: rosin
ross: ross
rosy: rosy
rote: rote
rotten: rotten
rouge: rouge,rouged
rough: rough,roughest
roughly: roughly
rouleaus: rouleaus
rounded: rounded
rous: rouses
rouse: rouse,roused
rousseau: rousseau
rout: rout,routs
route: route
rove: roves
row: row,rows
rowley: rowley
rows: rows
royal: royal
royalist: royalist
royalty: royalty
rub: rub,rubs
ruble: rubles
ruby: ruby
rudder: rudder
ruddy: ruddy
rude: rude,rudest
rudeness: rudeness
rudiment: rudiments
rue: rue
rueful: rueful
rues: rues
ruffle: ruffled,ruffles
rugged: rugged
ruin: ruin,ruining,ruins
rule: rule,ruled,rules
ruler: ruler
ruling: ruling
rum: rum
rummage: rummaged,rummaging
rumour: rumour,rumours
runic: runic
rupture: rupture
rural: rural
ruse: ruse
rush: rush,rushes,rushing
russ: russ
russet: russet
russia: russia
russian: russian,russians
rust: rust,rusts
rustle: rustle,rustled
rusty: rusty
rut: ruts
ruth: ruth
sabine: sabine
sable: sable,sables
sabre: sabre,sabres
sack: sack,sacks
sacking: sacking
sacrament: sacraments
sacred: sacred
sacrifice: sacrifice
sacrum: sacrum
sad: sad,sadder,saddest
sadden: saddens
sadly: sadly
sadness: sadness
safe: safe,safest
safeguard: safeguard
safely: safely
safety: safety
saffron: saffron
sagacity: sagacity
sage: sage,sages,sagest
sagely: sagely
sail: sail,sailing,sails
sailing: sailing
sailor: sailor,sailors
sain: sain
saint: saint,saints
sainted: sainted
saintly: saintly
saith: saith
sake: sake,sakes
sal: sal
salad: salad
salamander: salamander
salamis: salamis
salary: salary
sale: sale
sally: sallied,sallies,sally
salmi: salmi
salmon: salmon
saloon: saloon
salpicon: salpicon
salt: salt
salute: saluted
salvation: salvation
samaritan: samaritans
sameness: sameness
samian: samian
samphire: samphire
sample: sample,samples
samuel: samuel
san: sans
sancho: sancho
sanctify: sanctified,sanctify
sanction: sanction,sanctions
sanctity: sanctity
sanctuary: sanctuary
sand: sand,sands
sandwich: sandwich
sandy: sandy
sanguinary: sanguinary
sap: sap,sapping
sapless: sapless
sappho: sappho
saracen: saracen
sardanapalus: sardanapalus
sash: sash
sat: sat
satan: satan
sate: sate,sated
satiety: satiety
satin: satin
satire: satire
satirize: satirize
satisfaction: satisfaction
satisfactory: satisfactory
satisfied: satisfied
satisfy: satisfy
saturn: saturn
sauce: sauce,sauces
saunter: saunter
savage: savage,savages
savagely: savagely
save: save,saved,saves,saving
saving: saving
saviour: saviour
savour: savour
sawney: sawney
saxons: saxons
scabbard: scabbard
scald: scalding
scale: scale,scaled
scamander: scamander
scamper: scamper
scan: scan
scandal: scandal,scandals
scant: scant
scanty: scanty
scap: scaped
scar: scar,scars
scarce: scarce
scarcely: scarcely
scare: scared
scarless: scarless
scarlet: scarlet
scatter: scatter,scattering,scatters
scene: scene,scenes
scenery: scenery
scent: scent,scenting
sceptic: sceptics
scepticism: scepticism
schism: schism
schismatic: schismatic
schnapps: schnapps
scholar: scholar,scholars
school: school,schools
schoolboy: schoolboy
schooner: schooner
scian: scian
science: science,sciences
scientific: scientific
scimitar: scimitar,scimitars
scion: scions
scissors: scissors
scoff: scoff
scoffing: scoffing
scold: scold,scolding
scolding: scolding
scope: scope
scorch: scorch,scorches,scorching
score: score
scorn: scorn,scorning,scorns
scorner: scorner,scorners
scornfully: scornfully
scot: scot
scotch: scotch
scotchman: scotchman
scotland: scotland
scots: scots
scott: scott
scoundrel: scoundrel,scoundrels
scour: scour
scourge: scourge
scout: scout
scowl: scowl
scramble: scrambling
scrape: scrape
scratch: scratch
scratching: scratching
scrawl: scrawl
scream: scream
screech: screeching
screen: screen
scribble: scribble,scribbling
scribbler: scribblers
scribe: scribe,scribes
scripture: scripture,scriptures
scroll: scroll
scruple: scruples
scrupulosity: scrupulosity
scud: scuds
scudo: scudo
scuffle: scuffle
scum: scum
scumlike: scumlike
scuttle: scuttled
scythe: scythe,scythes
sea: sea,seas
seal: seal,seals
seaman: seaman,seamen
sear: sears
search: search,searching
seas: seas
season: season,seasons
seasoning: seasoning
seat: seat,seated,seats
seclusion: seclusion
secret: secret,secrets
secretary: secretaries
sect: sect,sects
secundum: secundum
secure: secure,secured
security: security
sedate: sedate
sedge: sedges
sediment: sediment
seduce: seduce,seduced
seductive: seductive
seed: seed
seek: seek,seeking,sought
seeker: seekers
seizable: seizable
seize: seize,seized,seizes
seldom: seldom
select: select,selected
selfish: selfish
selfishness: selfishness
sell: sell,sells,sold
seller: seller
semiramis: semiramis
semper: semper
sempstress: sempstress
senate: senate,senates
senator: senators
send: send,sends
senegal: senegal
senhor: senhor
sensation: sensation,sensations
sense: sense
senseless: senseless
sensibility: sensibilities,sensibility
sensitive: sensitive
sensual: sensual
sentence: sentence,sentences
sententious: sententious
sentiment: sentiment,sentiments
sentimental: sentimental
sentinel: sentinel
separate: separate,separated
separately: separately
september: september
sepulchral: sepulchral
sequel: sequel
sequin: sequins
seraglio: seraglio
seraph: seraph,seraphs
seraphic: seraphic
seraphim: seraphim
seraskier: seraskier
sere: sere
serene: serene
serenely: serenely
serenity: serenity
serf: serf
serge: serge
sermon: sermon,sermons
serpent: serpent
servant: servant,servants
serve: serve,served,serves
servente: servente
service: service,services
servile: servile
servility: servility
session: session,sessions
set: set,sets,setting
setting: setting
settle: settle,settled,settles,settling
settlement: settlement
seventeen: seventeen
seventeenth: seventeenth
seventh: seventh
sever: sever
severe: severe,severest
severely: severely
severity: severity
seville: seville
sex: sex,sexes
sha: sha
shabby: shabby
shade: shade
shades: shades
shadow: shadow,shadows
shadows: shadows
shadowy: shadowy
shaft: shafts
shah: shah
shake: shake,shaken,shakes,shaking,shook
shallow: shallow
shalt: shalt
shame: shame
shamrock: shamrock
shape: shape,shaped,shapes
shapen: shapen
share: share,shared,shares
shark: shark,sharks
sharp: sharp
sharpen: sharpen
sharper: sharpers
sharply: sharply
shatter: shatter
shave: shave,shaved
shaving: shaving
shawl: shawl
sheaf: sheaf
shear: shorn
shears: shears
sheath: sheath
sheen: sheen
sheep: sheep
sheet: sheet,sheets
shelf: shelf
shelter: shelter
shelve: shelve
shepherd: shepherd,shepherds
sherbet: sherbet,sherbets
shibboleth: shibboleth
shield: shield
shift: shift,shifts
shill: shilling
shilling: shilling
shiloh: shiloh
shine: shine,shines,shining,shone
shingle: shingles
ship: ship,ships
shipping: shipping
shipwreck: shipwreck
shirt: shirt,shirts
shirtless: shirtless
shiver: shiver,shivered,shivering
shoal: shoal,shoals
shock: shock,shocks
shocking: shocking
shoe: shod,shoe,shoes
shoestring: shoestring
shoot: shoot,shooting,shot
shooter: shooter
shooting: shooting
shop: shop
shopkeeper: shopkeepers
shore: shore,shores
short: short,shorter,shortest
shorten: shorten
shortly: shortly
shot: shot,shots
shoulder: shoulder,shoulders
shout: shout,shouted,shouts
shower: shower,showering,showers
showman: showman
shriek: shriek,shrieking,shrieks
shrill: shrill,shriller
shrine: shrine,shrines
shrink: shrank,shrink,shrinking,shrinks,shrunk
shroud: shroud,shrouds
shrunk: shrunk
shudder: shudder,shuddered,shuddering
shuffling: shuffling
shun: shun,shuns
shut: shut
shutter: shutters
shy: shy
shyer: shyer
shyly: shyly
siberia: siberia
sibyl: sibyl
sicily: sicily
sick: sick
sicker: sicker
sickle: sickle
sickness: sickness
sideboard: sideboard
sidelong: sidelong
siege: siege,sieges
siesta: siesta
sieve: sieve
sigh: sigh,sighing,sighs
sighing: sighing
sight: sight,sights
sighted: sighted
sign: sign,signing,signs
signal: signal
signalise: signalise
signify: signifies,signify
signs: signs
silence: silence,silenced
silent: silent
silk: silk,silks
silken: silken
silly: silly
silver: silver,silvers
silvery: silvery
simile: simile,similes
simoom: simoom,simooms
simple: simple,simpler
simplicity: simplicity
simply: simply
sin: sin,sinning,sins
sincerity: sincerity
sine: sine
sinecure: sinecure,sinecures
sinew: sinews
sing: sang,sing,singing,sings,sung
singe: singed
singeing: singeing
singer: singer,singers
singing: singing
single: single
singly: singly
singular: singular
singularity: singularity
singultus: singultus
sinister: sinister
sink: sank,sink,sinking,sinks,sunk
sinker: sinkers
sinking: sinking
sinless: sinless
sinner: sinner,sinners
sinning: sinning
sion: sion
sir: sir,sirs
sire: sire,sires
siren: siren,sirens
sirocco: sirocco
sister: sister,sisters
sisyphus: sisyphus
sit: sat,sit,sits,sitting
situation: situation
sixteen: sixteen
sixteenth: sixteenth
sixth: sixth
size: size
skater: skater
skating: skating
skeleton: skeleton,skeletons
sketch: sketch,sketches
skewer: skewer
skiff: skiff,skiffs
skill: skill
skim: skim,skims
skin: skin,skins
skip: skipping
skirmish: skirmish
skirt: skirted
skittish: skittish
skull: skull,skulls
sky: skies,sky
slack: slack
slacken: slacken,slackening
slang: slang
slap: slap
slash: slash,slashing
slaughter: slaughter
slave: slave,slaves
slavery: slavery
slay: slain,slay,slays
slayer: slayer
slaying: slaying
sleek: sleek
sleep: sleep,sleeping,sleeps,slept
sleeper: sleepers
sleeping: sleeping
sleepy: sleepy
sleet: sleet
sleeve: sleeve
slender: slender
slenderer: slenderer
slew: slew
slice: slice,slices
slide: sliding
slight: slight,slightest
slim: slim
slime: slime
slip: slip,slips
slipper: slippers
slipslop: slipslop
slit: slitting
slope: sloped
sloth: sloth
slow: slow,slower
slowly: slowly
slug: slugs
slumber: slumber,slumbering,slumbers
slumbering: slumbering
slut: slut
sly: sly
smart: smart
smear: smear
smell: smelt
smile: smile,smiled,smiles,smiling
smilingly: smilingly
smite: smite,smitten,smote
smith: smith
smithfield: smithfield
smiths: smiths
smoke: smoke,smoked,smoking
smoker: smokers
smoking: smoking
smooth: smooth
smoothly: smoothly
smother: smother,smothers
smuggling: smuggling
snake: snake,snakes
snarl: snarling
snatch: snatch
sneer: sneer,sneers
sneeze: sneeze
snood: snoods
snore: snores
snow: snow,snows
snowball: snowball
snowdrop: snowdrops
snowy: snowy
snub: snub
snuff: snuff
snug: snug
snugly: snugly
soar: soar,soars
soaring: soarings
sob: sob,sobbing,sobs
sober: sober
soberly: soberly
social: social
society: society
socket: socket,sockets
socrates: socrates
socratic: socratic
soda: soda,sodas
sodden: sodden
sofa: sofa,sofas
sofas: sofas
soft: soft,softer,softest
soften: soften
softening: softening
softly: softly
softness: softness
soho: soho
soil: soil
soiree: soiree
sol: sol
solace: solace
solar: solar
solder: solder
soldier: soldiers
soldiery: soldiery
sole: sole
solely: solely
solemn: solemn
solicit: solicit
solicitor: solicitor
solid: solid
solidity: solidity
soliloquize: soliloquize
solitary: solitary
solitude: solitude,solitudes
solomon: solomon
solution: solution
solve: solve,solved,solving
solvent: solvent
sombre: sombre
son: son,sons
song: song,songs
songster: songster
songstress: songstress
sonnet: sonnets
sooner: sooner
soot: soot
sooth: sooth
soothe: soothe,soothes
soother: soothers
soothing: soothing
sooty: sooty
sophia: sophia
sophy: sophy
soporific: soporific
soprano: soprano
sore: sore
sorrow: sorrow,sorrows
sorrowing: sorrowing
sort: sort,sorted,sorts
sot: sot
sou: sou
soul: soul,souls
sound: sound,sounded,sounding,sounds
soundly: soundly
soup: soup,soups
sour: sour
source: source,sources
south: south
southern: southern
sovereign: sovereign,sovereigns
sow: sow,sown
space: space
spacious: spacious
spade: spade
spain: spain
span: span,spanning
spangle: spangled
spaniard: spaniard
spaniel: spaniel
spanish: spanish
spar: spars
spare: spare,spared,spares,sparing
sparingly: sparingly
spark: spark
sparkle: sparkle,sparkled,sparkles,sparkling
sparkling: sparkling
sparrow: sparrow
sparry: sparry
spartan: spartan
spattering: spattering
spawn: spawn,spawns
speak: spake,speak,speaking,speaks,spoke,spoken
speaker: speakers
speaking: speaking
spear: spear,spears
special: special
specie: specie
species: species
specimen: specimen,specimens
specious: specious
speck: speck,specks
spectacle: spectacle
spectacles: spectacles
spectator: spectator
spectral: spectral
spectre: spectre,spectres
speculate: speculate,speculating
speculation: speculation,speculations
speculative: speculative
speech: speech,speeches
speechless: speechless
speed: speed,speeds
speedily: speedily
speedy: speedier
spell: spell,spells
spellken: spellken
spelt: spelt
spend: spends,spent
spending: spending
spendthrift: spendthrifts
speranza: speranza
sphere: sphere,spheres
sphinx: sphinx
spice: spice
spider: spiders
spill: spilt
spilt: spilt
spin: spin,spinning,spun
spinning: spinning
spirit: spirit,spirits
spiritual: spiritual
spit: spits
spite: spite
splash: splash
spleen: spleen
splendid: splendid
splendour: splendour
splinter: splinters
split: split
spoil: spoil,spoils,spoilt
spoilt: spoilt
spongy: spongy
spoon: spoon,spoons
spoonful: spoonfuls
sport: sport,sported,sports
sporting: sporting
sportsman: sportsman
spot: spot,spots,spotted
spouse: spouse,spouses
spouseless: spouseless
spout: spout
sprain: sprains
sprawl: sprawling
spray: spray
spread: spread,spreading,spreads
sprightliest: sprightliest
sprightly: sprightly
spring: sprang,spring,springs,sprung
springald: springald
sprinkle: sprinkled
sprinkling: sprinkling
sprite: sprites
sprung: sprung
spur: spur
spurn: spurn
spy: spies
squabble: squabble
squad: squad
squadron: squadron
squall: squall,squalls
squander: squander
square: square,squares
squat: squatted
squaw: squaw
squeak: squeak
squeaker: squeakers
squeamish: squeamish
squeeze: squeeze,squeezed
squire: squire,squires
stab: stab
stable: stable
stag: stag
stage: stage
staggering: staggering
stagnant: stagnant
stagnate: stagnate,stagnates
stagyrite: stagyrite
staid: staid
stain: stain,stains
staining: staining
stair: stair,stairs
staircase: staircase
stake: stake
stale: stale
stalk: stalk,stalks
stall: stall
stamina: stamina
stammer: stammer
stamp: stamp
stanch: stanch
stand: stand,standing,stands,stood
stanza: stanza,stanzas
star: star,stars
starch: starch
stare: stare,stared,staring
stark: stark
starlight: starlight
starling: starling
starr: starr
starry: starry
stars: stars
start: start,started,starting,starts
starting: starting
startle: startle
starvation: starvation
starve: starve,starved
stately: stately
statement: statement
statesman: statesman,statesmen
station: station,stations
statistics: statistics
statuary: statuary
statue: statue,statues
stature: stature
statute: statutes
stave: stave,staves
stay: stay,stays
stead: stead
steadfastly: steadfastly
steadily: steadily
steady: steady
steak: steak
steal: steal,stealing,stole,stolen
stealing: stealing
stealth: stealth
stealthy: stealthy
steam: steam
steed: steed
steel: steel
steep: steep
steeple: steeple,steeples
steer: steer,steers
steering: steering
stem: stem
step: step,stepping,steps
stept: stept
sterile: sterile
sterling: sterling
stern: stern,sternest
sterner: sterner
sternly: sternly
stew: stews
stick: stick,sticks,stuck
stickle: stickle
stiff: stiff,stiffer
stiffen: stiffen
stiffly: stiffly
stillness: stillness
stilt: stilts
sting: sting,stinging,stings,stung
stinginess: stinginess
stint: stint
stir: stir,stirring
stirless: stirless
stirring: stirring
stitch: stitch,stitches
stock: stock,stocking,stocks
stocking: stocking,stockings
stoic: stoic,stoics
stoicism: stoicism
stomach: stomach,stomachs
stone: stone,stones
stones: stones
stony: stony
stool: stool
stoop: stoop,stooping,stoops
stopper: stopper
stopt: stopt
store: store,stored
storm: storm,storms
stormy: stormy
story: stories,story
stout: stout,stouter
stove: stove
stow: stow
straggle: straggling
straggling: straggling
straightway: straightway
strain: strain,straining,strains
strait: straits
strand: stranded
strange: strange,strangest
strangely: strangely
stranger: stranger,strangers
strangle: strangle
straw: straw
stray: stray
streak: streak
stream: stream,streaming,streams
streaming: streaming
street: street,streets
strength: strength
strengthen: strengthening
stress: stress
stretch: stretch,stretches
strew: strew
strict: strict,stricter,strictest
strictly: strictly
stricture: strictures
stride: stride
strife: strife
strike: strike,strikes,struck
striking: striking
string: string,strings,strung
strip: strip,stripped,strips
striped: striped
stripling: stripling
stript: stript
strive: strive,strives,strove
stroke: stroke,strokes,stroking
strong: strong,stronger,strongest
struck: struck
structure: structure
struggle: struggle,struggled,struggles,struggling
struis: struis
strumpet: strumpet
strut: strut,strutted
stubble: stubble
stubborn: stubborn
stud: studded
study: studied,studies,study
stuff: stuff,stuffs
stumble: stumble,stumbled,stumbling
stun: stun
stupid: stupid,stupider
stupidity: stupidity
sty: sty
stygian: stygian
style: style,styled
styx: styx
suavity: suavity
subdue: subdued
subject: subject,subjects
sublime: sublime,sublimed,sublimes,sublimest
sublimer: sublimer
sublimest: sublimest
sublimity: sublimity
submission: submission
submit: submitted
subscription: subscription
subservient: subservient
subside: subside,subsiding
substance: substance
substantial: substantial
substitute: substitute
substratum: substratum
subterraqueous: subterraqueous
subtle: subtle,subtler
succeed: succeed,succeeded,succeeding
success: success
successful: successful
successor: successor
succulent: succulent
suck: suck,sucking
suckle: suckle
suckling: sucklings
suction: suction
sudden: sudden
suddenly: suddenly
sue: sued
suffer: suffer,suffering,suffers
sufferance: sufferance
sufferer: sufferer,sufferers
suffering: suffering,sufferings
suffice: suffice,suffices
sufficient: sufficient
suffocation: suffocation
suffuse: suffuse
suicide: suicide
suit: suit,suited,suits
suitable: suitable
suite: suite
suitor: suitor,suitors
sulkily: sulkily
sullen: sullen
sullenly: sullenly
sulphuret: sulphuret
sulphury: sulphury
sultan: sultan,sultans
sultana: sultana,sultanas
sultans: sultans
sultanship: sultanship
sultry: sultry
sum: sum
summer: summer,summers
summit: summit
summon: summon
summons: summons
sun: sun,suns
sunday: sunday
sung: sung
sunk: sunk
sunless: sunless
sunny: sunny
sunrise: sunrise
suns: suns
sunset: sunset
sunshine: sunshine
superb: superb
superbly: superbly
supercargo: supercargo
superficial: superficial
superfine: superfine
superfluous: superfluous
superior: superior
superiority: superiority
superlative: superlative
supernatural: supernatural
supernumerary: supernumerary
supersede: supersede
superstition: superstition
superstratum: superstratum
supp: supp
supper: supper
supplicate: supplicate
supplicator: supplicator
supply: supplied,supply
support: support
supporter: supporters
suppose: suppose,supposed
supposition: supposition
suppress: suppress,suppressing
suppression: suppression
supt: supt
surely: surely
surf: surf
surface: surface
surge: surge
surgeon: surgeon
surly: surly
surmise: surmise,surmises
surmount: surmounted
surpass: surpass
surprise: surprise,surprised
surprised: surprised
surrender: surrender,surrenders
surround: surrounded,surrounding
survey: survey
surveying: surveying
survive: survive,survived,survives,surviving
survivor: survivors
suspect: suspect,suspects
suspend: suspended
suspense: suspense
suspicion: suspicion
suspicious: suspicious
sustain: sustain
swain: swain
swallow: swallow,swallowing
swam: swam
swamp: swamp,swamping
swan: swan
swarm: swarming
swathe: swathed
sway: sway,sways
swear: swear,swearing,swears,swore,sworn
swearing: swearing
sweat: sweat,sweating
sweaty: sweaty
swedish: swedish
sweep: sweep,sweeps,swept
sweeper: sweeper
sweeping: sweeping
sweepstakes: sweepstakes
sweet: sweet,sweeter,sweetest,sweets
sweetbread: sweetbreads
sweetly: sweetly
sweetness: sweetness
swell: swell,swelling,swells
swift: swift,swiftest
swiftly: swiftly
swim: swam,swim,swimming
swimmer: swimmer,swimmers
swimming: swimming
swine: swine
swing: swing,swung
swiss: swiss
swoln: swoln
swoon: swoon
swoop: swoop
sword: sword,swords
sworder: sworder
swordsman: swordsman
swore: swore
sybarite: sybarite
sycophant: sycophants
syllable: syllable,syllables
sylph: sylph
sylvan: sylvan
symmetrical: symmetrical
symmetry: symmetry
sympathetic: sympathetic
sympathise: sympathised
sympathy: sympathies,sympathy
symplegades: symplegades
symptom: symptom,symptoms
syncope: syncope
syne: syne
synonym: synonym
synonymous: synonymous
tabby: tabby
table: table,tables
taciturn: taciturn
tack: tack
tackle: tackle
tact: tact
tactic: tactics
tactician: tactician
tail: tail,tails
tailor: tailor
taint: tainted
taker: takers
tale: tale,tales
talent: talent,talents
talisman: talisman
talk: talk,talking,talks
talker: talker
talking: talking
tall: tall,tallest
tallow: tallow
tally: tally
talus: talus
tame: tame,tamed,taming
tameless: tameless
tan: tan
tangier: tangier
tangle: tangles
tank: tank
tanner: tanners
tantalisation: tantalisation
tanti: tanti
tap: tap,tapping
taper: taper,tapers
tapestry: tapestry
tar: tars
tarantula: tarantulas
tardy: tardy
tare: tares
tarquin: tarquin
tarry: tarried,tarrying
tartar: tartar
tartars: tartars
task: task
taste: taste,tastes,tasting
tatter: tatter
tattle: tattle
taught: taught
tavern: tavern,taverns
tax: tax,taxes
taxation: taxation
taxing: taxing
te: te
tea: tea
teach: taught,teach,teaches,teaching
teacher: teacher,teachers
teapot: teapot
tear: tear,tears,tore,torn
tearing: tearing
tease: tease,teased
teat: teat
tediousness: tediousness
tedium: tedium
teens: teens
teian: teian
telescope: telescope
temp: tempest
temper: temper
temperament: temperament
temperance: temperance
temperate: temperate
tempest: tempest,tempests
temple: temple,temples
temporary: temporary
tempt: tempt
temptation: temptation
tempter: tempter
tenant: tenant,tenants
tend: tend,tended,tending
tendency: tendency
tender: tender
tenderly: tenderly
tenderness: tenderness
tendon: tendon
tenor: tenor
tense: tense
tent: tent
tenter: tenter
tenth: tenth,tenths
tenure: tenures
ter: ter
term: term,terms
terrestrial: terrestrial
terrible: terrible
terrier: terrier,terriers
terrific: terrific
terror: terror,terrors
terse: terse
tertian: tertian,tertians
tete: tete
thames: thames
thankless: thankless
thatch: thatch
thaw: thaw
theatre: theatre
theatrical: theatrical
thee: thee
theft: theft
theme: theme,themes
theogony: theogony
theologian: theologian
theology: theology
theorem: theorems
theoric: theoric
theory: theories
thereanent: thereanent
thereon: thereon
thermometer: thermometer,thermometers
thetis: thetis
thew: thews
thicket: thicket
thief: thieves
thigh: thigh
thine: thine
thinker: thinkers
thinking: thinking
thirdly: thirdly
thirst: thirst
thirsty: thirstiest,thirsty
thirteen: thirteen
thirteenth: thirteenth
thisbe: thisbe
thorn: thorn
thoroughfare: thoroughfare
thoughtlessly: thoughtlessly
thousandth: thousandth
thrall: thrall
thrash: thrash
thread: thread,threading
threat: threat,threats
threaten: threaten,threatening,threatens
threescore: threescore
thresh: thresh
threw: threw
thrice: thrice
thrill: thrill
thrilling: thrilling
thrive: thrives
throat: throat,throats
throb: throb,throbbing,throbs
throbbing: throbbing
throe: throes
throne: throne,thrones
throng: throng
throttle: throttle,throttled
throw: threw,throw,throwing,thrown,throws
thrust: thrust,thrusting
thunder: thunder,thunders
thunderbolt: thunderbolt
thunderer: thunderer
thunderstroke: thunderstroke
thursday: thursday
thy: thy
tiberius: tiberius
tick: tick
ticket: ticket
ticklish: ticklish
tide: tide,tides
tiding: tidings
tie: tie,tied,ties
tier: tier
tierce: tierce
tiger: tiger,tigers
tight: tight,tightest
tigress: tigress,tigresses
tigris: tigris
tilt: tilts
time: time,timed,times
timeless: timeless
timely: timely
timid: timid
timidly: timidly
timon: timon
tinct: tinct
tinder: tinder
tinge: tinge,tinged,tinges
tingle: tingled,tingling
tinker: tinkering
tinkle: tinkling
tint: tint,tints
tinter: tinters
tiptoe: tiptoe
tirade: tirade
tire: tire,tires
tired: tired
tiresias: tiresias
tiresome: tiresome
tiring: tiring
tissue: tissue
titan: titan
titans: titans
tithe: tithe,tithes
titian: titian
title: title,titles
tittle: tittle
titus: titus
toad: toad
toast: toast
tobacco: tobacco
toby: toby
tocsin: tocsin
toe: toe
toil: toil,toils
toilet: toilet,toilets
token: token,tokens
tolerable: tolerable
tolerably: tolerably
tolerance: tolerance
toll: toll
tom: tom
tomb: tomb,tombs
ton: ton,tons
tone: tone,tones
tongue: tongue,tongues
tonnage: tonnage
tool: tool,tools
tooth: teeth
toothpick: toothpicks
topic: topic,topics
topography: topography
topsy: topsy
torch: torch,torches
torment: tormented,torments
tornado: tornado
torrent: torrent,torrents
tortoise: tortoise
tortuosity: tortuosity
torture: torture,tortured,torturing
tory: tory
toss: toss
tost: tost
totality: totality
touch: touch,touched,touching
touching: touching
tough: tough,tougher
tour: tour,tours
tout: tout
towel: towels
tower: tower,towering,towers
towers: towers
town: town,towns
tracasserie: tracasserie
trace: trace,traced,traces
tracery: tracery
track: track
trade: trade
tradesman: tradesman,tradesmen
tradition: tradition
traditional: traditional
tragedy: tragedies
trail: trail
train: train
training: training
trait: trait,traits
traitor: traitors
tramp: tramp
trample: trample,trampled,tramples,trampling
trance: trance
tranquil: tranquil
tranquilly: tranquilly
transaction: transaction,transactions
transcend: transcends
transcendent: transcendent
transfer: transfer,transferred,transfers
transfigure: transfigure
transfix: transfix
transform: transform
transformation: transformation
transgress: transgresses
transgression: transgression,transgressions
transient: transient
transitory: transitory
translate: translate,translated
translation: translation
transmission: transmission
transmit: transmitted
transparent: transparent
transpire: transpire
transplant: transplanted
transport: transport
transportation: transportation
trap: trap,traps
trash: trash
travel: travel,travelling
traveller: traveller,travellers
travelling: travelling
travels: travels
traverse: traverses
travesty: travesty
tray: tray,trays
treachery: treachery
tread: tread,treading,trod
treason: treason
treasure: treasure,treasures
treat: treat,treated,treating,treats
treatment: treatment
treaty: treaty
treble: treble
tree: tree,trees
tremble: trembled,trembles,trembling
tremendous: tremendous
tremor: tremor,tremors
tremulously: tremulously
tress: tresses
trial: trial,trials
tribe: tribe,tribes
tribulation: tribulation
tribunal: tribunals
tribunes: tribunes
trice: trice
trick: trick,tricking,tricks
tricky: tricky
trifle: trifle,trifles,trifling
trifling: trifling
trigger: trigger
trim: trim
trimmer: trimmer
trinity: trinity
trios: trios
trip: trip
triple: triple
tripod: tripod
tripoli: tripoli
trite: trite
triumph: triumph,triumphed
triumphal: triumphal
triumphant: triumphant
triumphs: triumphs
trod: trod
trodden: trodden
trode: trode
trojan: trojan
troop: troop
troops: troops
trophy: trophies,trophy
trot: trotted
trouble: trouble,troubled,troubles
troubled: troubled
troublesome: troublesome
trough: trough
trousers: trousers
trout: trout
trow: trow
troy: troy
truant: truant
truce: truce
truckle: truckle
truculent: truculent
true: true,truer
truffle: truffles
truism: truism
trump: trump,trumps
trumpet: trumpet
trunk: trunk,trunks
trust: trust,trusted,trusting,trusts
trusty: trusty
truth: truth,truths
tu: tu
tug: tug,tugging
tuism: tuism
tumble: tumble,tumbled,tumbles,tumbling
tumour: tumours
tumult: tumult
tumulus: tumulus
tune: tune,tuned
tuneful: tuneful
tuneless: tuneless
tunic: tunic
tunis: tunis
turban: turban,turbans
turbot: turbot
turbulently: turbulently
turk: turk
turkey: turkey
turkish: turkish
turks: turks
turmoil: turmoil
turncoat: turncoat
turnkey: turnkey
turnpike: turnpike,turnpikes
turtle: turtle,turtles
turvy: turvy
tusk: tusk
tussle: tussle
tutor: tutor,tutors
tweed: tweed
tweezers: tweezers
twelfth: twelfth
twelvemonth: twelvemonth
twentieth: twentieth
twere: twere
twig: twig,twigs
twilight: twilight
twill: twill
twin: twin
twine: twine,twining
twinge: twinges
twining: twining
twinkle: twinkle
twirl: twirl
twist: twisted
twisted: twisted
twitch: twitch
twixt: twixt
tympanum: tympanum
type: type
typhoon: typhoon
typography: typography
tyranny: tyranny
tyrant: tyrant,tyrants
tyre: tyre
tyrian: tyrian
ugliness: ugliness
ugly: ugliest,ugly
ukraine: ukraine
ultimate: ultimate
ulysses: ulysses
umbrage: umbrage
unanimity: unanimity
unawares: unawares
unbeliever: unbelievers
unblest: unblest
unblunted: unblunted
unborn: unborn
unbounded: unbounded
uncertain: uncertain
uncertainty: uncertainty
unchain: unchain
unchanged: unchanged
unchased: unchased
uncivil: uncivil
unclosed: unclosed
uncommon: uncommon
unconscious: unconscious
unconsciously: unconsciously
uncontrovertible: uncontrovertible
uncorrupted: uncorrupted
uncouth: uncouth
uncouthly: uncouthly
uncurdled: uncurdled
undecided: undecided
undefiled: undefiled
undefinable: undefinable
undergo: undergo,undergoes,underwent
underground: underground
underling: underlings
understand: understand,understands,understood
understanding: understanding
undertake: undertake
undertaking: undertaking
undescribed: undescribed
undismay: undismay
undo: undo,undone
undress: undress
undressing: undressing
undrest: undrest
unearthly: unearthly
uneasy: uneasy
unebbing: unebbing
unequal: unequal
unexcised: unexcised
unexpected: unexpected
unfashionable: unfashionable
unfathomable: unfathomable
unfit: unfit
unflattering: unflattering
unfold: unfold
unforgiven: unforgiven
ungentle: ungentle
ungrateful: ungrateful
unhallow: unhallow
unhandsome: unhandsome
unhappy: unhappy
unheard: unheard
unheeded: unheeded
unhired: unhired
unholy: unholy
unhurt: unhurt
uniform: uniform,uniforms
unimpair: unimpair
unimpeded: unimpeded
uninitiated: uninitiated
uninstructed: uninstructed
unintelligible: unintelligible
uninterested: uninterested
uninvited: uninvited
union: union,unions
unite: united
united: united
unity: unities,unity
universal: universal
universe: universe
unjust: unjust
unkind: unkind
unknown: unknown
unlawful: unlawful
unliquidating: unliquidating
unload: unloads
unlock: unlocking
unluckily: unluckily
unmake: unmade
unman: unmans
unmarried: unmarried
unmingled: unmingled
unmix: unmix
unmoisten: unmoisten
unmoved: unmoved
unnatural: unnatural
unobjectionable: unobjectionable
unopposed: unopposed
unoriental: unoriental
unpaid: unpaid
unpaved: unpaved
unpleasant: unpleasant
unpleasantly: unpleasantly
unpleasing: unpleasing
unprepared: unprepared
unquiet: unquiet
unread: unread
unriddle: unriddle,unriddled,unriddling
unriddled: unriddled
unsaleable: unsaleable
unseemly: unseemly
unseen: unseen
unsex: unsex
unshaken: unshaken
unsighing: unsighing
unsought: unsought
unsuffocated: unsuffocated
unsunk: unsunk
untended: untended
untie: untied,untying
untill: untill
untold: untold
untoward: untoward
untrue: untrue
untumbled: untumbled
unusual: unusual
unutterable: unutterable
unveil: unveil
unwed: unwed
unwelcome: unwelcome
unwell: unwell
unwilling: unwilling
unwind: unwound
unwise: unwise
unwonted: unwonted
unworthy: unworthy
unwrinkled: unwrinkled
upbraid: upbraid
upharsin: upharsin
upo: upo
upper: upper
uppermost: uppermost
uprear: uprears
upright: upright
upset: upset,upsets
upstart: upstarted
upthrown: upthrown
urbanity: urbanity
urchin: urchin
urge: urge,urged
urgent: urgent
urn: urn,urns
usage: usage,usages
useless: useless
usher: usher
usual: usual
usurer: usurer
usurper: usurper
uti: uti
utile: utile
utmost: utmost
utter: utter
uxorious: uxorious
vacancy: vacancies
vacant: vacant
vaccination: vaccination
vade: vade
vain: vain
vainer: vainer
vainly: vainly
vale: vale,vales
vales: vales
valet: valet,valets
valiant: valiant
valid: valid
valley: valley
valorous: valorous
valour: valour
vampire: vampire
van: van
vandals: vandals
vanish: vanish,vanishing
vanity: vanity
vanquish: vanquish
vapour: vapour
vapours: vapours
variably: variably
variety: variety
varlet: varlet
varmint: varmint
varnish: varnish
vary: varied,varies,vary,varying
vase: vase
vassal: vassal
vast: vast
vasty: vasty
vates: vates
vault: vault
vaunt: vaunt
vaunted: vaunted
veal: veal
veer: veer,veering
vegetable: vegetable,vegetables
vehicle: vehicles
veil: veil
vein: vein,veins
veins: veins
velvet: velvet
venerable: venerable
venerably: venerably
venerate: venerate
veneration: veneration
venetian: venetian
vengeance: vengeance
venison: venison
venom: venom
vent: vent,vented
venture: venture,ventured,ventures
venus: venus
veracious: veracious
verbum: verbum
verdant: verdant
verdict: verdict
verdure: verdure
verge: verge
verily: verily
verity: verity
vermicelli: vermicelli
vermilion: vermilion
vermin: vermin
vernon: vernon
versatility: versatility
verse: verse,versed,verses
verses: verses
versify: versified,versify
version: version
verst: versts
vesper: vesper
vessel: vessel,vessels
vest: vest
vestal: vestal,vestals
vestals: vestals
vesture: vesture
vesuvius: vesuvius
veteran: veteran
vex: vex,vexes
vexation: vexation
viand: viands
vibrate: vibrate,vibrates
vicarage: vicarage
vice: vice,vices
vicious: vicious
vicissitude: vicissitudes
victim: victim
victor: victor,victors
victorious: victorious
victory: victories,victory
victual: victual
vie: vie,vied
view: view,views
vigil: vigil
vigorous: vigorous
vigour: vigour
vile: vile
vilely: vilely
villa: villa
village: village
villain: villain,villains
villainous: villainous
vindicate: vindicates
vine: vine,vines
vinegar: vinegar
vineyard: vineyard,vineyards
vinous: vinous
vintage: vintage
violation: violation
violence: violence
violent: violent
violently: violently
violin: violin
viper: vipers
virgil: virgil
virgin: virgin,virgins
virginity: virginities,virginity
virtue: virtue,virtues
virtuous: virtuous
visage: visage
vision: vision,visions
visionary: visionary
visit: visit,visits
visitant: visitant
visitation: visitations
vita: vita
vitiate: vitiated
vivacious: vivacious
vivacity: vivacity
vivify: vivifying
vizier: vizier
vladimir: vladimir
vocabulary: vocabulary
vocation: vocation
vogue: vogue
voice: voice,voices
voiceless: voiceless
void: void
voila: voila
volcano: volcano,volcanos
volley: volley,volleys
volleying: volleying
voltaire: voltaire
volume: volume,volumes
voluminous: voluminous
volunteer: volunteers
voluptuous: voluptuous
voluptuousness: voluptuousness
votary: votaries
vote: vote,voted,votes
vouch: vouches
vow: vow,vows
voyage: voyage,voyaged,voyages
vulgar: vulgar,vulgarest
vulture: vulture
wade: waded,wading
waft: waft,wafted
wag: wags
wage: wage,waged,waging
waggish: waggish
waggon: waggon,waggons
waggoners: waggoners
wail: wail,wailing
wain: wain
waist: waist
waistcoat: waistcoat
wait: wait,waited,waits
waiter: waiters
waiting: waiting
wake: wake,wakes,waking,woke
waken: waken
waking: waking
walk: walk,walking,walks
walking: walking
wall: wall,walls
wallow: wallow
walter: walter
waltz: waltz
waltzing: waltzing
wan: wan
wand: wand
wander: wander,wandering
wanderer: wanderer
wane: wane,waned,waning
war: war,warring,wars
warb: warb
warble: warble
warbler: warblers
ward: ward,wards
warden: warden
ware: ware
warfare: warfare
warison: warison
warlike: warlike
warm: warm,warms
warmth: warmth
warn: warn,warning
warning: warning,warnings
warp: warp
warrant: warrant
warranted: warranted
warrior: warrior,warriors
warsaw: warsaw
wary: wary
wash: wash,washing
washington: washington
wassail: wassail
waste: waste,wasted
watch: watch,watches,watching
watcher: watcher
watchful: watchful
watchman: watchman,watchmen
watchword: watchword
water: water,waters
waterfall: waterfall
waterloo: waterloo
watery: watery
wave: wave,waved,waves,waving
waver: wavering
waving: waving
wax: wax,waxing
waxen: waxen
weak: weak,weaker,weakest
weakly: weaklier
weakness: weakness
weal: weal
wealth: wealth
wealthy: wealthier,wealthiest,wealthy
wean: wean,weaning,weans
weapon: weapon,weapons
wear: wear,wearing,wears,wore,worn
weariness: weariness
weary: wearied,wearier,wearies,weary
weather: weather
weatherology: weatherology
webfooted: webfooted
wedding: wedding,weddings
wedlock: wedlock
weed: weeds
week: week,weeks
weekly: weekly
ween: ween
weep: weep,weeping,wept
weigh: weigh,weighing,weighs
weight: weight
weighty: weighty
weird: weird
wellington: wellington
welsh: welsh
wench: wenches
wesley: wesley
west: west
western: western
westerns: westerns
westminster: westminster
westphalian: westphalian
wet: wet
wether: wether
wh: wh
whatsoever: whatsoever
wheat: wheat
wheedle: wheedle
wheel: wheeling,wheels
wheels: wheels
whelm: whelm
whelp: whelp
wherefore: wherefore
whereof: whereof
whereon: whereon
wherewith: wherewith
wherewithal: wherewithal
whet: whets
whigs: whigs
whilk: whilk
whimper: whimper
whine: whine
whip: whip
whipper: whipper
whipt: whipt
whirl: whirl,whirling,whirls
whirling: whirling
whirlpool: whirlpool
whirlwind: whirlwind
whisk: whisk
whisker: whisker,whiskers
whisper: whisper,whispering,whispers
whist: whist
whistle: whistle
whit: whit
white: white,whitest
whites: whites
wholesome: wholesome
wholly: wholly
whoop: whoop
whore: whored
wick: wicks
wicked: wicked
wickedly: wickedly
wickedness: wickedness
wicket: wicket
wide: wide,wider
widen: widens
widow: widow,widows
widower: widower
wield: wield,wielding
wife: wife,wives
wig: wigs
wild: wild,wilder,wilds
wilderness: wilderness
wildfowl: wildfowl
wile: wile
wiles: wiles
william: william
willingly: willingly
willingness: willingness
willow: willow,willows
wills: wills
win: win,winning,wins
wince: wince
wind: wind,winding,winds,wound
winding: windings
window: window,windows
windpipe: windpipe
wine: wine,wines
wing: wing,winged,wings
winged: winged
winner: winner
winter: winter,winters
wintry: wintry
wipe: wiped
wire: wire,wires
wisdom: wisdom
wise: wise,wiser,wisest
wisely: wisely
wisp: wisp
wistfully: wistfully
wit: wit,wits
witch: witch,witches
witching: witching
withal: withal
withdraw: withdraw,withdrawn,withdrew
wither: wither,withering
withhold: withheld
withstand: withstand,withstands,withstood
witless: witless
witlings: witlings
witness: witness,witnesses
witty: witty
wive: wive,wived
woe: woe,woes
wolf: wolf,wolves
wolfish: wolfish
woman: woman,women
womanhood: womanhood
womankind: womankind
wonderful: wonderful
wondrous: wondrous
woo: woo,wooing,woos
wood: wood,woods
woodcock: woodcocks
wooden: wooden
woodland: woodland,woodlands
woodsman: woodsman
woof: woof
word: word
wording: wording
wordless: wordless
wordy: wordy
workings: workings
workman: workmen
workmanship: workmanship
worldling: worldling,worldlings
worm: worm,worms
worn: worn
worship: worship
worth: worth
worthlessness: worthlessness
worthy: worthies,worthiest,worthy
wound: wound,wounded,wounds
wounded: wounded
wrangle: wrangle,wrangled
wrapt: wrapt
wrath: wrath
wreak: wreak
wreath: wreath,wreaths
wreathe: wreathe,wreathed,wreathing
wreck: wreck,wrecks
wrench: wrench
wrestle: wrestling
wretch: wretch
wretched: wretched
wriggle: wriggle
wring: wring,wrings,wrung
wrinkle: wrinkle,wrinkled,wrinkles
wrinkling: wrinkling
wrist: wrist
writ: writ
write: write,writes,writing,written,wrote
writer: writer,writers
writhe: writhe,writhed,writhing
writing: writing
writings: writings
wrong: wrong,wrongs
wroth: wroth
wrought: wrought
yankees: yankees
yard: yard,yards
yawl: yawl
yawn: yawn,yawning,yawns
yclept: yclept
yearly: yearly
yeasty: yeasty
yell: yell,yells
yellow: yellow
yesterday: yesterday
yield: yield,yielded,yielding,yields
yoke: yoke,yoked,yokes
yon: yon
yonder: yonder
yore: yore
york: york
youngling: youngling
youngster: youngster,youngsters
youth: youth
youthful: youthful
zany: zany
zealous: zealous
zephyr: zephyr
zest: zest
zodiac: zodiac
zone: zone
