ab: ab
abandon: abandon,abandoned,abandons
abase: abase
abasement: abasement
abate: abated
abbot: abbot
abide: abide,abides
abides: abides
abject: abject
ablaze: ablaze
abode: abode
absolution: absolution
absorb: absorbed
abstract: abstracted
abundant: abundant
abyss: abyss
accept: accept,accepted,accepting,accepts
access: access,accessed
accessible: accessible
accidia: accidia
accompany: accompanied,accompanying
accomplish: accomplished
accord: accord,accords
accost: accost
account: account
accursed: accursed
accusation: accusation
accuse: accuse
accustomed: accustomed
acestes: acestes
acheron: acheron
achilleid: achilleid
achilles: achilles
acorn: acorns
acquaint: acquainted
acquaintance: acquaintance
acquire: acquire,acquired
action: action,actions
active: active
activity: activity
acts: acts
actual: actual
acute: acute
adam: adam
adamant: adamant
adapt: adapted
add: adds
addition: addition,additions
additional: additional
address: address,addressed,addresses
administer: administers
admirable: admirable
admiral: admiral,admirals
admit: admit,admits
admonition: admonition
adorn: adorn,adorned
adrian: adrian
adriatic: adriatic
advance: advance,advanced,advancing
advanced: advanced
advantage: advantage,advantages
adversary: adversaries,adversary
adversity: adversities
aegisthus: aegisthus
aeneid: aeneid
aeolus: aeolus
afar: afar
affair: affairs
affection: affection,affections
affectionate: affectionate
affirm: affirmed,affirming
affirmation: affirmation
afflict: afflicted
affliction: affliction
afford: afford,afforded,affords
afield: afield
aflame: aflame
aforesaid: aforesaid
afraid: afraid
africa: africa
age: age,ages
aged: aged
agent: agent
ages: ages
agile: agile
aglauros: aglauros
agnus: agnus
agree: agree,agreed
agreement: agreement
aid: aid,aids
ail: ails
aim: aim
air: air
ak: ak
albeit: albeit
albert: albert
alberto: alberto
alike: alike
alive: alive
alle: alle
allegoric: allegoric
allegorically: allegorically
allegory: allegory
alleluia: alleluia
allot: allotted
allure: allures
allusion: allusion
aloft: aloft
alp: alp,alps
alphonso: alphonso
alter: altered,alters
alteration: alteration
alternate: alternate,alternating
alto: alto
amazement: amazement
ambrosia: ambrosia
amend: amended,amends
ample: ample
amply: amply
ancestor: ancestors
anchises: anchises
ancient: ancient
ancilla: ancilla
ancona: ancona
andes: andes
anew: anew
angel: angel,angels
angelic: angelic
angels: angels
anger: anger
angle: angle
anguish: anguish
anima: anima
animal: animal
anjou: anjou
announcement: announcement
annoy: annoys
answer: answer,answered,answers
ant: ant
ante: ante
antenor: antenor
antigone: antigone
antiphon: antiphon
antipodal: antipodal
antique: antique
antiquity: antiquity
apace: apace
apennine: apennine
apennines: apennines
apocalypse: apocalypse
apollo: apollo
apostrophe: apostrophe
apparent: apparent
appeal: appeal
appearance: appearance
appease: appease
appetite: appetite
apple: apple,apples
applicable: applicable
apply: applied,apply,applying
apportion: apportioning
apprehend: apprehends
apprehension: apprehension
approach: approach,approached,approaches,approaching
appropriation: appropriation
approve: approve
april: april
apt: apt
aquarius: aquarius
aquinas: aquinas
arachne: arachne
arbitrarily: arbitrarily
arc: arc
arch: arch
archbishop: archbishop
archive: archive
ardor: ardor
argument: argument
argus: argus
aries: aries
aright: aright
aristotle: aristotle
ark: ark
arm: arm,arms
armed: armed
army: army
arnaut: arnaut
arnold: arnold
arouse: aroused,arouses
arrange: arranged
array: array
arrest: arrested
arrive: arrive,arrived,arrives
arrogant: arrogant
arrow: arrow,arrows
art: art
articulation: articulation
ascend: ascend,ascended,ascending,ascends
ascent: ascent,ascents
ascertain: ascertain
ascii: ascii
ash: ashes
ashamed: ashamed
asia: asia
asleep: asleep
aspect: aspect
asperge: asperges
aspire: aspire
asquint: asquint
assail: assail,assailed
assassinate: assassinated
assault: assault
assemble: assemble,assembled
assembly: assembly
assent: assent
assert: asserted
assign: assigned,assigns
assist: assist,assisting,assists
assistance: assistance
assuage: assuaged
assume: assumed,assuming
assurance: assurance
assure: assured,assures
assyrians: assyrians
astonished: astonished
astonishment: astonishment
astray: astray
astronomy: astronomy
astute: astute
athena: athena
athens: athens
athwart: athwart
attach: attached
attack: attack
attain: attain,attained
attempt: attempt
attend: attend,attending
attent: attent
attention: attention
attentive: attentive
attitude: attitude
attribute: attributes
audacious: audacious
aught: aught
august: august
augustine: augustine
augustus: augustus
aurora: aurora
auster: auster
austria: austria
autem: autem
author: author
authority: authority
autumnal: autumnal
avail: avail,avails
avarice: avarice
avaricious: avaricious
ave: ave
avenge: avenge,avenged
aver: aver
avoid: avoid
await: await,awaited,awaits
awake: awaking,awoke
awaken: awakened
aware: aware
awry: awry
axle: axle
ay: ay
azure: azure
bacchus: bacchus
bad: bad,worse,worst
bait: bait
balance: balanced
balcony: balcony
bald: bald
ball: ball
ban: ban,banned
band: band,bands
banish: banished
bank: bank,banks
banner: banner,banners
baptism: baptism
baptist: baptist
barbarian: barbarian
barbarous: barbarous
bare: bare
bargaining: bargaining
bark: bark
barren: barren
barrier: barrier
base: base,based
bastard: bastards
bath: bath,bathed
bathe: bathes
battle: battle,battles
battlements: battlements
bead: bead
beak: beak
beam: beam,beamed
bean: bean
bear: bear,bearing,bears,bore,born,borne
beard: beard
bearded: bearded
bearing: bearing
bears: bears
beast: beast,beasts
beat: beaten,beats
beati: beati
beatitude: beatitude
beatitudes: beatitudes
beatrice: beatrice
beautiful: beautiful
beauty: beauties,beauty
bed: bed
bee: bee
befall: befallen,befalls,befell
befit: befits
befitting: befitting
beg: beg,begging
beget: beget,begetting
begetter: begetter
beggar: beggars
behead: beheaded
behold: beheld,behold,beholding
behove: behoved,behoves
belated: belated
belief: belief
bell: bell
bello: bello
bellow: bellows
belly: belly
belong: belonged
beloved: beloved
belt: belt
bend: bend,bending,bends,bent
beneath: beneath
benedictus: benedictus
benefit: benefit
benign: benign
benignant: benignant
benignantly: benignantly
benincasa: benincasa
bent: bent
benvenuto: benvenuto
bequeath: bequeathed
beseech: beseech,besought
besetting: besetting
besought: besought
bestialize: bestialized
bestow: bestowed
bestride: bestride,bestrides
bethink: bethink
betray: betrayed
betroth: betrothed
betters: betters
bewail: bewailing
beware: beware
bewilder: bewildered
bewilderment: bewilderment
bewitch: bewitch
bible: bible
biblical: biblical
bid: bids
bide: bide
biform: biform
binary: binary
bind: bind,binds,bound
bird: bird,birds
birth: birth
birthplace: birthplace
bishop: bishop
bite: bite,biting,bitten
bitter: bitter
bitterly: bitterly
bitterness: bitterness
black: black
blackbird: blackbird
blame: blame,blamed
blameless: blameless
blasphemy: blasphemy
blast: blast
blaze: blazing
blended: blended
bless: bless,blessed
blessed: blessed
blest: blest
blind: blind,blinded
blond: blond
blood: blood
bloody: bloody,bloodying
blow: blow,blowing,blown,blows
blue: blue
boast: boast,boasts
boat: boat
boccaccio: boccaccio
bodily: bodily
body: bodies,body
bohemia: bohemia
boil: boiling
bold: bold
bologna: bologna
bolt: bolt
bone: bones
boniface: boniface
book: book,books
border: border,borders
bosom: bosom
bough: bough,boughs
bound: bound
bounty: bounty
bow: bow,bowed,bows
boxy: boxy
boyhood: boyhood
brabant: brabant
brain: brain
branch: branch,branches
brand: brand
brazen: brazen
breach: breach
bread: bread
break: break,breaking,breaks,broke,broken
breast: breast,breasts
breath: breath
breathe: breathe,breathed,breathes
breathing: breathing
breeze: breeze,breezes
brethren: brethren
briareus: briareus
bribe: bribed,bribes
bridal: bridal
bride: bride,brides
bridge: bridge
bridle: bridle
bright: bright,brighter
brightness: brightness
brilliant: brilliant
bring: bring,bringing,brings,brought
broken: broken
brosse: brosse
brothel: brothel
brother: brother,brothers
brow: brow,brows
brown: brown
bruges: bruges
bubble: bubble
bucket: bucket,buckets
bucolic: bucolic
build: built
bull: bull
buoyant: buoyant
burden: burden,burdened,burdens
burial: burial
burn: burned,burning,burns,burnt
burning: burning
burst: burst,bursting,bursts
bury: buried
business: business
butcher: butcher
butt: butt
butterfly: butterfly
caesar: caesar
cage: cage
cain: cain
cairn: cairn
calamity: calamity
calculate: calculate,calculated
calends: calends
calliope: calliope
callisto: callisto
camino: camino
campo: campo
cana: cana
canal: canals
cancel: cancels
candle: candle,candles
candlestick: candlesticks
canine: canine
canonical: canonical
canst: canst
canticle: canticle
canto: canto
canzone: canzone
capacity: capacity
cappelletti: cappelletti
capricorn: capricorn
captain: captain
captive: captive
captivity: captivity
car: car
card: card
cardinal: cardinal
care: care,cares
carp: carp
carry: carried,carries,carry
cart: cart
carve: carved
carving: carvings
cast: cast,casts
castor: castor
catch: caught
cavalier: cavalier,cavaliers
cave: cave
cavern: caverns
cease: cease,ceased,ceases
cecrops: cecrops
ceiling: ceiling
celebrate: celebrate,celebrated
celestial: celestial
centaur: centaur,centaurs
centre: centre
century: centuries,century
ceremony: ceremony
ceres: ceres
certainty: certainty
chain: chain,chains
challenge: challenged
chamberlain: chamberlain
chance: chance
change: change,changed,changing
chant: chants
chapel: chapel
chapter: chapter
character: character
charge: charge,charged,charges
chariot: chariot
charitable: charitable
charity: charities,charity
charles: charles
chary: chary
chase: chased
chaste: chaste
chastisement: chastisement
check: check,checks
cheek: cheek,cheeks
cheerful: cheerful
cherubim: cherubim
chest: chest
chewing: chewing
chief: chief
chiefly: chiefly
child: child,children
childish: childish
childishly: childishly
chill: chill
chilled: chilled
chin: chin
chink: chink
chiron: chiron
choice: choice
choir: choir,choirs
choose: choose,chosen
christ: christ
christian: christian,christians
christianity: christianity
christmas: christmas
church: church,churches
churl: churl
churlishness: churlishness
circe: circe
circle: circle,circled,circles,circling
circling: circling
circuit: circuit
circumscribe: circumscribed,circumscribes
circumstance: circumstances
cistern: cistern
cite: cited
cithern: citherns
citizen: citizen,citizens
city: cities,city
civil: civil
civilized: civilized
claim: claim
clasp: clasping
clasped: clasped
classic: classic
classical: classical
claudius: claudius
clay: clay
clean: clean
cleanse: cleanse,cleansed
cleansing: cleansing
cleave: cleave,cleaves,cleaving
cleft: cleft
clemency: clemency
clement: clement
clergy: clergy
cli: cli
cliff: cliff
climber: climbers
clio: clio
cloak: cloaks
cloister: cloister
close: close,closed,closer,closes,closing
closed: closed
clothe: clad,clothed
clothes: clothes
clotho: clotho
cloud: cloud,clouds
cloven: cloven
coagulate: coagulating
coarse: coarse
coast: coast
cock: cock
code: codes
cognizance: cognizance
cognizant: cognizant
coin: coin
coining: coining
cold: cold
coldness: coldness
collect: collected
collection: collection
college: college
color: color,colored,colors
colored: colored
colossians: colossians
comb: comb
combine: combining
comedy: comedy
cometh: cometh
comfort: comfort,comforts
comforter: comforter
command: command,commanded,commands
comment: comment,comments
commentator: commentators
commercial: commercial
commit: commit,committed
common: common
commonly: commonly
communicate: communicated
compact: compacts
companion: companion,companions
companionship: companionship
company: company
compare: compared
compassion: compassion
compassionate: compassionate
compel: compel,compelled
compilation: compilation
complaint: complaint
complete: complete,completing
compliance: compliance
complines: complines
comply: comply,complying
compose: composed
comprehend: comprehend,comprehended
compress: compressed
conceal: conceal,concealed,conceals
conceive: conceived,conceives
concentrated: concentrated
concept: concept
conception: conception
concord: concord
concubine: concubine
condemn: condemned
condense: condensed,condenses
condition: condition,conditions
conduct: conduct,conducted
conductress: conductress
confess: confess
confession: confession
confidant: confidant
confidence: confidence
confident: confident
confidently: confidently
confirm: confirm,confirmed
confirmation: confirmation
conform: conform
conformity: conformity
confound: confound,confounded,confounding
confused: confused
confusedly: confusedly
confusion: confusion
congeal: congealed
conjecture: conjecture
conjoin: conjoined
conjure: conjures
conquer: conquered,conquers
conscience: conscience,consciences
consciousness: consciousness
consecrated: consecrated
consecration: consecration
consequence: consequences
consequential: consequential
considerable: considerable
consist: consists
consistency: consistency
consistory: consistory
consolation: consolation
console: console,consoled
constance: constance
constant: constant
constantine: constantine
constituent: constituent
constrain: constrained,constrains
consul: consul
consume: consumed,consuming
contact: contact
contemplation: contemplation
contemplative: contemplative
contend: contend,contending,contends
content: content
contented: contented
contention: contention
contents: contents
continue: continued,continuing
contract: contract,contracted
contrary: contrary
contrast: contrast,contrasting
contribution: contributions
contrite: contrite
contrition: contrition
contrive: contrive
contumacy: contumacy
convent: convent
conversion: conversion
convert: convert,converted
convito: convito
cool: cool
copying: copying
copyright: copyright
corbel: corbel
cord: cord,cords
corner: corner
cornice: cornice
corollary: corollary
coronation: coronation
corporation: corporation
corporeal: corporeal
correct: corrected
correspond: corresponds
corrupt: corrupt,corrupted
corruption: corruption
corsair: corsairs
corso: corso
coruscant: coruscant
cosmography: cosmography
cost: cost,costs
costly: costly
couch: couches
couldst: couldst
council: council
counsel: counsel,counsels
counsellor: counsellor
count: count,counted,counts
countenance: countenance,countenances
counter: counter
country: countries,country
counts: counts
couple: couple,coupled
courser: coursers
court: court
courteous: courteous
courtesy: courtesy
covenant: covenant
cover: covered,covering,covers
covered: covered
covetous: covetous
cow: cow
crack: cracked
crane: cranes
crash: crash
craving: craving
create: created,creates,creating
creation: creation
creator: creator
creature: creature,creatures
credit: credit
crime: crime,crimes
critical: critical
crook: crook
crooked: crooked
crop: cropped
cross: cross,crosses
crowd: crowd,crowding
crown: crown,crowned
crozier: crozier
crucify: crucified
cruel: cruel
cruelly: cruelly
cud: cud
cull: culling
cultivation: cultivation
cum: cum
cumaean: cumaean
cur: curs
curb: curb
cure: cure
current: current
cursed: cursed
curve: curve
custodia: custodia
custom: custom,customs
customary: customary
cut: cut
cyrus: cyrus
cytherea: cytherea
da: da
daily: daily
dale: dale
damage: damage
damaged: damaged
damages: damages
dame: dames
damned: damned
damsel: damsels
dance: dance,danced,dancing
dancing: dancing
danger: danger
daniel: daniel
dante: dante
daring: daring
dark: dark
darken: darkened,darkening
darkly: darkly
darkness: darkness
darts: darts
datum: data
daughter: daughter,daughters
david: david
dawn: dawn,dawns
day: day,days
dazzle: dazzle,dazzled,dazzles
dazzling: dazzling
dead: dead
deadly: deadly
deaf: deaf
deal: dealing
dealer: dealer
dealings: dealings
death: death,deaths
debate: debate
debt: debt
deceitful: deceitful
deceive: deceive,deceived,deceives
december: december
decide: decide
declare: declare,declared
decline: declined,declines
decree: decree,decrees
decretal: decretal
dedicate: dedicated
deductible: deductible
deed: deed,deeds
deem: deem
deep: deep,deeper
default: default
defeat: defeat,defeated
defect: defect,defects
defective: defective
defence: defence
defend: defends
defer: deferred
deficient: deficient
defile: defiled,defiles
deform: deformed
degenerate: degenerate,degenerating
degree: degrees
dei: dei
deign: deign,deigned,deigns
del: del
delay: delay,delayed
deletion: deletions
delia: delia
deliberation: deliberation
delight: delight,delighting,delights
delightful: delightful
delinquent: delinquent
deliver: deliver,delivered
della: della
demand: demand
demon: demon
demonstrate: demonstrate
demonstration: demonstrations
denial: denial
denote: denotes
dense: dense
denude: denudes
deny: denied
depart: depart,departed,departing,departs
departure: departure
depend: depends
dependent: dependent
depict: depict,depicted,depicts
deplore: deplore
depraved: depraved
depress: depressed
deprive: deprived,deprives
depths: depths
derision: derision
derivative: derivative
derive: derive,derived
descend: descend,descended,descending,descends
descendant: descendants
descent: descent
desert: desert,deserted,deserts
deserted: deserted
deserve: deserve,deserved,deserves
design: design
desirable: desirable
desire: desire,desired,desires,desiring
desirous: desirous
desolation: desolation
despair: despaired
despise: despised
despoil: despoil,despoiled,despoils
destine: destined
destroy: destroy,destroyed
destruction: destruction
detach: detach
determine: determine,determined
deus: deus
deuteronomy: deuteronomy
development: development
devout: devout
devoutly: devoutly
dew: dew
di: di
diana: diana
dice: dice
dicta: dicta
dictate: dictates
dictator: dictator
dido: dido
didst: didst
die: die,died,dies,dying
diet: diet
difficult: difficult
difficulty: difficulty
diffuse: diffuse,diffused
dig: dug
digest: digested
dignified: dignified
dignity: dignity
digression: digression
diligence: diligence
dim: dim
diminish: diminished
dimly: dimly
dine: dine
dip: dipped
direct: direct,directed,directing,directs
direction: direction,directions
disappear: disappeared
disapproval: disapproval
discern: discern,discerned,discerns
discharge: discharge
discipline: discipline
disclaim: disclaim,disclaimed
disclaimer: disclaimer,disclaimers
disclose: disclose,disclosed,discloses,disclosing
discolor: discolors
discontinue: discontinue
discordant: discordant
discourse: discourse,discoursed,discoursing
discover: discover,discovered
disculpation: disculpation
disdain: disdains
disdainfully: disdainfully
diseased: diseased
disengage: disengaged
disentangle: disentangle,disentangles
disfigured: disfigured
dishonor: dishonor
disjoin: disjoined
disk: disk
dismal: dismal
dismay: dismayed
dismiss: dismiss
disobedience: disobedience
dispensation: dispensations
disperse: dispersed
display: display,displayed,displaying,displays
displeasing: displeasing
disposal: disposal
dispose: disposed
disposed: disposed
disposition: disposition,dispositions
disregard: disregard
dissipate: dissipate,dissipated
dissolve: dissolve
distaff: distaff
distance: distance
distant: distant
distil: distils
distinct: distinct
distinction: distinction,distinctions
distinctly: distinctly
distinguish: distinguish,distinguished,distinguishing
distress: distress
distribute: distribute,distributed,distributing
distribution: distribution
distributor: distributor
district: district,districts
distrust: distrust
disturb: disturbed
disturbance: disturbance
disturbed: disturbed
disuse: disuses
ditch: ditch
ditty: ditties
diurnal: diurnal
diver: divers
diverse: diverse
divest: divest
divide: divide,divided,divides
divided: divided
divination: divination
divine: divine
divinity: divinities
division: divisions
doctrine: doctrine
dog: dogs
domain: domain
dominate: dominates
domine: domine
dominion: dominion
domitian: domitian
donate: donate
donation: donation,donations
donne: donne
donor: donors
door: door,doors
dost: dost
doth: doth
double: double
doubly: doubly
doubt: doubt
doubtless: doubtless
dove: doves
downcast: downcast
download: downloading
downward: downward
downwardly: downwardly
dowry: dowry
drachm: drachm
drag: drag,dragged,dragging
dragging: dragging
dragon: dragon
draught: draught
drave: drave
draw: draw,drawing,drawn,draws,drew
drawing: drawing
dread: dread
dream: dream,dreamed,dreams
dress: dress
drink: drink,drinking,drinks,drunk
drinking: drinking
drive: drive,driven,drives,drove
drop: drop,drops
drown: drowned
drowsiness: drowsiness
drowsy: drowsy
drunk: drunk
dry: dried,dries,dry
duke: duke
dull: dull
dumb: dumb
dusky: dusky
dust: dust
duty: duties,duty
dux: dux
dwell: dwell,dwells,dwelt
dye: dyed
eager: eager
eagle: eagle,eagles
ear: ear,ears
earnest: earnest
earnestly: earnestly
earth: earth,earths
earthly: earthly
earthquake: earthquake
ease: ease
easily: easily
east: east
easter: easter
eastern: eastern
easy: easier,easy
eat: eat,eaten
ecce: ecce
ecstatic: ecstatic
edge: edge
edict: edicts
edition: edition,editions
educational: educational
edward: edward
eel: eels
effective: effective
efficacy: efficacy
effluence: effluence
effort: effort,efforts
ego: ego
egypt: egypt
eighth: eighth
elder: elder,elders
elect: elect,elected
electronic: electronic
electronically: electronically
eli: eli
elias: elias
eliot: eliot
elsa: elsa
elysium: elysium
email: email
embrace: embrace,embraced
emerald: emerald,emeralds
eminent: eminent
emissary: emissaries
emotion: emotion
emperor: emperor,emperors
emperors: emperors
empire: empire
employee: employee,employees
empress: empress
emptiness: emptiness
empyrean: empyrean
enamel: enamelled
enamelled: enamelled
enamored: enamored
encircle: encircled
enclose: enclosed
enclosure: enclosure
encode: encoding
encounter: encounter
encourage: encourage,encourages
encumber: encumbered
endowment: endowment,endowments
endure: endure,endured,enduring
enemy: enemies,enemy
enforce: enforce
england: england
english: english
engrave: engraved
enigma: enigma,enigmas
enjoin: enjoin
enjoy: enjoys
enjoyment: enjoyment
enkindle: enkindled
enlarge: enlarge,enlarging
enlighten: enlightened
enmity: enmity
enquire: enquire,enquiring
enrage: enraged
enrapt: enrapt
ensign: ensigns
ensure: ensuring
enter: enter,entered,entering,enters
enticement: enticements
entire: entire
entity: entity
entrance: entrance
entrap: entrap
entrust: entrusted
envious: envious
envy: envy
ephesians: ephesians
ephod: ephod
epipsychidion: epipsychidion
epistles: epistles
epithet: epithet
equal: equal,equals
equator: equator
equinox: equinox
equipment: equipment
erase: erased
ere: ere
eriphyle: eriphyle
err: err
error: error,errors
erst: erst
escape: escape,escaped
escort: escort
escorts: escorts
essay: essay
essence: essence
est: est
esther: esther
estrange: estranged
eternal: eternal
eternally: eternally
ether: ether
ethiop: ethiop
eulogy: eulogy
euphrates: euphrates
euripides: euripides
europe: europe
evangelic: evangelic
eve: eve
evening: evening
evil: evil,evils
exalt: exalt,exalted
exceed: exceeds
excel: excel,excelled,excelling
excess: excess
excited: excited
exclaim: exclaim,exclaimed
exclude: excluded
exclusion: exclusion
exclusively: exclusively
excommunicate: excommunicated
excuse: excuse
exempt: exempt
exert: exert
exhalation: exhalations
exhausted: exhausted
exile: exile
exist: exist,exists
existence: existence
exordium: exordiums
expect: expect
expectant: expectant
expectation: expectation
expend: expend
expense: expense,expenses
experience: experience,experienced
experiment: experiment
expiate: expiated
expiation: expiation
explain: explain,explained,explains
explanation: explanation
export: exporting
expose: exposed
expound: expounds
express: express
expression: expression
expressly: expressly
extend: extends
extent: extent
external: external
extinct: extinct
extinguish: extinguished
extol: extols
extreme: extreme
extricate: extricate
eye: eye,eyes
eyebrow: eyebrows
eyelid: eyelids
ezekiel: ezekiel
faced: faced
facility: facility
faculty: faculties,faculty
fail: failed,fails
fain: fain
fair: fair
faith: faith
faithful: faithful
falcon: falcon,falcons
fall: fall,fallen,falling,falls,fell
fallacious: fallacious
false: false
falsehood: falsehood
falsely: falsely
fame: fame,famed,fames
famed: famed
familiar: familiar,familiars
family: families,family
famish: famished
famous: famous
fan: fanned,fanning
fano: fano
fantasy: fantasy
farewell: farewell
farm: farm
fashion: fashion,fashioned
fast: fast,faster,fasting
fasting: fasting
fatal: fatal
fate: fate
fated: fated
father: father,fathers
fatigue: fatigue
fatling: fatlings
fatuous: fatuous
fault: fault
faulty: faulty
favor: favor
favorably: favorably
fear: fear,feared,fears
feast: feast,feasts
feather: feather,feathered,feathering,feathers
feathering: feathering
federal: federal
fee: fee,fees
feebly: feebly
feed: fed,feed
feeding: feeding
feel: feel,feels
feeling: feeling
fellow: fellow
female: female
fervor: fervor
festival: festival
feud: feud
fictitious: fictitious
field: field,fields
fields: fields
fierce: fierce
fiery: fiery
fight: fight,fights,fought
figure: figure,figured,figures
file: file,files
filii: filii
finally: finally
financial: financial
fine: fine
finespun: finespun
finger: finger,fingers
finish: finished
fir: fir
firm: firm
fish: fish
fisherman: fisherman
fishes: fishes
fit: fit,fitted
fitness: fitness
fixedly: fixedly
flame: flame,flames,flaming
flamelet: flamelet
flames: flames
flanders: flanders
flank: flank
flash: flash
flattery: flattery
fledged: fledged
flee: fled,flee
flentes: flentes
flesh: flesh
fleshless: fleshless
fleur: fleur
flight: flight,flights
float: float
flock: flock,flocks
floor: floor
florence: florence
florentine: florentine
florentines: florentines
florin: florins
flow: flow,flows
flower: flower,flowers
floweret: flowerets
fly: flies,fly,flying
foe: foes
fold: fold
foliage: foliage
folk: folk
follow: follow
follower: followers
followeth: followeth
folly: folly
fond: fond
food: food
foolish: foolish
foot: feet,foot
foothold: foothold
footprint: footprints
footstep: footsteps
forbear: forbear
forbearance: forbearance
forbid: forbidden
force: force,forced
ford: ford
forehead: forehead
foresee: foreseeing
foresight: foresight
forest: forest
forester: forester
forethought: forethought
forget: forget,forgetting,forgotten
forgive: forgiven
forkful: forkful
form: form,formed,forming,forms
formally: formally
format: format,formats
formation: formation
formative: formative
forsake: forsaken
forsooth: forsooth
fortitude: fortitude
fortress: fortress
fortunate: fortunate
fortune: fortune,fortunes
forum: forum
foul: foul
foundation: foundation
fount: fount
fountain: fountain
fourth: fourth
fox: fox,foxes
fra: fra
fragrance: fragrance
france: france
francis: francis
franco: franco
frate: frate
fraud: fraud
fraudulent: fraudulent
frederick: frederick
freebooter: freebooter
freedom: freedom
freely: freely
french: french
frequent: frequented
fresh: fresh
friend: friend,friends
friendly: friendly
frighten: frightened
frightened: frightened
frigid: frigid
frost: frost
frozen: frozen
fruit: fruit,fruits
fruition: fruition
fruitlessly: fruitlessly
fulfil: fulfil,fulfilled
fulfilment: fulfilment
funeral: funeral
fungus: fungus
fur: fur
furnace: furnace
future: future
gaia: gaia
gain: gain,gained,gains
gait: gait
gall: gall
gallant: gallant
gallop: gallop
game: game
gange: ganges
ganymede: ganymede
gap: gap
garb: garb
garden: garden
garland: garland
garment: garment,garments
gate: gate,gates
gatekeeper: gatekeeper
gather: gather,gathered,gathering,gathers
gathering: gathering
gaze: gaze,gazed,gazes,gazing
gem: gem,gems
gemini: gemini
gemma: gemma
generation: generation,generations
genesis: genesis
genius: genius
genoa: genoa
genoese: genoese
gentle: gentle
gently: gently
geographer: geographers
geography: geography
geomancy: geomancy
georgics: georgics
germ: germ
german: german
geryon: geryon
ghent: ghent
ghibelline: ghibelline
giant: giant,giants
gibbous: gibbous
gideon: gideon
gift: gift,gifts
gird: gird,girded,girds,girt
girdle: girdle
girl: girl
girt: girt
glad: glad
gladden: gladdened
gladly: gladly
gladness: gladness
glass: glass
gleam: gleaming
glimmer: glimmering
gloom: gloom
gloria: gloria
glorious: glorious
glory: glory
gloss: gloss
glow: glows
glut: glutted
gluttonous: gluttonous
gluttony: gluttony
gnaw: gnaw
goad: goad,goading
goal: goals
goat: goat,goats
god: god,gods
goddess: goddesses
gold: gold
golden: golden
gomorrah: gomorrah
goodness: goodness
gospel: gospel
gospels: gospels
govern: govern,governed
government: government
grace: grace,graces
gracious: gracious
graciously: graciously
grain: grain
grandchild: grandchild
grandson: grandson
grant: grant,granted
grape: grape
grasp: grasp
grass: grass,grasses
grateful: grateful
gratefully: gratefully
gratia: gratia
gratify: gratifying
gratitude: gratitude
grave: grave
graven: graven
graze: grazes
grazie: grazie
greatness: greatness
greed: greed
greedy: greedy
greek: greek,greeks
green: green
greeting: greeting
gregory: gregory
grey: grey
grief: grief
grieve: grieve,grieved
grieving: grieving
grievous: grievous
griffon: griffon
gross: gross
grot: grots
ground: ground
grow: grew,grow,growing,grows
guard: guard,guarded,guards
guardian: guardian
guelph: guelph
guest: guest
guidance: guidance
guide: guide,guided,guides,guiding
guido: guido
guilty: guilty
gulf: gulf,gulfs
gully: gullies
habit: habit,habits
hadst: hadst
hail: hail
hair: hair
haircloth: haircloth
hallelujah: hallelujah
halo: halo
halt: halt
haman: haman
hamper: hampered,hampers
hand: hand,hands
handmaid: handmaid,handmaids
hang: hanged,hung
happiness: happiness
happy: happy
hapsburg: hapsburg
harbinger: harbinger
harbor: harbor
hard: hard,hardest
hardihood: hardihood
harlot: harlot
harm: harm
harmful: harmful
harmless: harmless
harmony: harmony
harsh: harsh
hart: hart
harvest: harvest,harvested
hast: hast
haste: haste
hasten: hasten,hastening,hastens
hasting: hasting
hasty: hasty
hate: hated,hating
hateful: hateful
hatred: hatred
haughty: haughty
hawk: hawk
hay: hay
head: head,heads
headquarters: headquarters
heal: healed
healer: healer
healing: healing
heap: heap,heaps
hear: hear,heard,hearing,hears
hearing: hearing
heart: heart,hearts
hearted: hearted
heat: heat,heats
heathen: heathen
heave: heaves
heaven: heaven,heavens
heavenly: heavenly
heavens: heavens
heaving: heaving
heavy: heavier,heavy
hebrews: hebrews
hedge: hedges
heed: heed,heeds
heel: heels
height: height
heir: heir,heirs
heiress: heiress
helicon: helicon
hellespont: hellespont
helm: helm
hem: hem,hemmed
hemisphere: hemisphere,hemispheres
henceforth: henceforth
henry: henry
herb: herb
herbage: herbage
herdsman: herdsman
hereditary: hereditary
heresy: heresies
heritage: heritage
hermaphrodite: hermaphrodite
hermitage: hermitage
hidden: hidden
hide: hidden,hide,hides,hiding
hiding: hiding
highland: highlands
hike: hike
hill: hill,hills
hillside: hillside
hinder: hinder,hindered,hinders
hindrance: hindrance
hinge: hinges
hint: hints
hippocrates: hippocrates
historical: historical
hit: hits
hitherward: hitherward
hitter: hitter
ho: ho
hoarse: hoarse
hog: hogs
hohenstaufen: hohenstaufen
hoist: hoists
hold: held,hold,holding,holds
holder: holder
hollow: hollow,hollowed
holofernes: holofernes
holy: holy
honest: honest
honey: honey
honor: honor,honored,honors
honorable: honorable
hoof: hoof,hoofs
hook: hook
hope: hope,hopes
horizon: horizon
horn: horn,horned
horrible: horrible
horse: horse
hosanna: hosanna
hospitality: hospitality
hostel: hostel
hostile: hostile
hostility: hostility
hot: hot,hotter
hotly: hotly
hour: hour,hours
house: house
household: household
howl: howl,howling
howsoever: howsoever
huddle: huddling
hue: hue
hugh: hugh
hum: hum
human: human
humble: humble,humblest
humbly: humbly
humid: humid
humiliate: humiliated
humiliating: humiliating
humility: humilities,humility
hunger: hunger,hungering
hungering: hungering
hunt: hunt
hunter: hunter
hurry: hurries
hurt: hurt,hurts
husband: husband,husbands
husk: husk
hut: hut
hymn: hymn
hypsipyle: hypsipyle
hyssop: hyssop
ice: ice
ida: ida
identification: identification
identify: identify
ideo: ideo
idleness: idleness
ignorance: ignorance
iii: iii
ilion: ilion
illegitimate: illegitimate
illuminate: illuminated,illuminating
illumination: illumination
illumine: illumines
image: image,imaged,images
imagery: imagery
imagination: imagination
imaginative: imaginative
imagine: imagine,imagined,imagining
immense: immense
immortal: immortal
immortality: immortality
immovable: immovable
impel: impel
imperfect: imperfect
imperial: imperial
impersonal: impersonal
impiety: impiety
implore: implore,implores
imply: implied,imply
import: imports
impose: impose,imposed
impossible: impossible
impotence: impotence
impotency: impotency
impregnate: impregnate,impregnates
impress: impress
impressed: impressed
impression: impression
imprint: imprinted
impugn: impugn
inaccurate: inaccurate
inaction: inaction
inanimate: inanimate
inaudible: inaudible
incense: incense
incidence: incidence
incidental: incidental
incise: incised
incite: incited,incites
inclination: inclination
incline: incline
include: include,included,includes,including
including: including
incomplete: incomplete
incorrect: incorrect
incorruptible: incorruptible
increase: increase,increased,increasing
indemnify: indemnify
indemnity: indemnity
independent: independent
india: india
indian: indian,indians
indication: indication
indignant: indignant
indigo: indigo
indirect: indirect
indirectly: indirectly
individual: individual
indolence: indolence
indolent: indolent
indulgence: indulgences
ineffable: ineffable
infamy: infamy
infant: infant
infer: inferred
inferior: inferior
infernal: infernal
infinite: infinite
inflame: inflames
inflamed: inflamed
influence: influence,influences
informant: informant
informative: informative
infringement: infringement
infuse: infused
infusion: infusion
inhabit: inhabited
inhabitant: inhabitants
inheritance: inheritance
iniquity: iniquity
initiate: initiate
injunction: injunction
injure: injured
injury: injury
ink: ink
inn: inn
innate: innate
innocent: innocent,innocents
inordinate: inordinate
insatiable: insatiable
inscribe: inscribed
insect: insects
inspiration: inspirations
inspire: inspired,inspires
instance: instance
instant: instant
instantly: instantly
instructor: instructor
instrument: instruments
instrumentally: instrumentally
intellect: intellect
intellective: intellective
intellectual: intellectual
intelligence: intelligence
intend: intend,intended
intense: intense
intent: intent
intention: intention
intently: intently
intercede: interceded
intercession: intercession
interdict: interdict,interdicted
interior: interior
internal: internal
international: international
interpret: interpreted
interpretation: interpretation
interrupt: interrupted
invade: invaded
invalidity: invalidity
invert: inverted
invisible: invisible
invitation: invitation,invitations
invite: invite
invocation: invocation
inwardly: inwardly
iris: iris
iron: iron
ironical: ironical
irony: irony
irs: irs
island: island,islands
israel: israel
issue: issue,issued,issues,issuing
italian: italian,italians
italy: italy
iterum: iterum
iv: iv
ix: ix
jam: jam
james: james
jealousy: jealousy
jerusalem: jerusalem
jesus: jesus
joan: joan
jocasta: jocasta
john: john
joint: joints
jordan: jordan
joshua: joshua
journey: journey
joust: jousted,jousts
jove: jove
joy: joy,joys
joyful: joyful
joyous: joyous
jubilee: jubilee
judas: judas
judge: judge,judges
judges: judges
judgment: judgment
judicature: judicature
judith: judith
juice: juice
july: july
junction: junction
june: june
juno: juno
jupiter: jupiter
jura: jura
justice: justice
justification: justification
justify: justify
justinian: justinian
justly: justly
jut: juts
juvenal: juvenal
keen: keen
key: key
kick: kicks
kill: kill,killed,killing
kindle: kindle,kindled,kindles
kindness: kindness
kindred: kindred
king: king,kings
kingdom: kingdom,kingdoms
kino: kino
kinsfolk: kinsfolk
kiss: kissed,kissing
knee: knees
kneel: knelt
knight: knights
knot: knot
knowledge: knowledge
labia: labia
labor: labor
lachesis: lachesis
lack: lack
lackland: lackland
laden: laden
lady: ladies,lady
laggard: laggard
lake: lake
lamb: lamb
lament: lament,lamented,lamenting
lamentation: lamentations
lamp: lamp,lamps
lance: lance
land: land,lands
landing: landing
language: language
lap: lap
larboard: larboard
largess: largess
late: late
latin: latin
latins: latins
latona: latona
laudable: laudable
laugh: laugh
laughter: laughter
laurel: laurel
lavinia: lavinia
law: law,laws
lawful: lawful
lawgiver: lawgiver
lay: laid,lay,laying,lays
lead: lead,leading,leads,led
leader: leader,leaders
leadeth: leadeth
leaf: leaf,leaves
leafage: leafage
leaflet: leaflets
league: league
leah: leah
lean: lean,leaning
leander: leander
leanness: leanness
leap: leap,leaping,leaps
learn: learn,learned,learns
leave: leave,leaves,leaving,left
lebanon: lebanon
ledge: ledge
left: left
leg: legs
legal: legal
legally: legally
legend: legend
leisure: leisure
lengthwise: lengthwise
lessen: lessened,lessens
lessening: lessening
lethe: lethe
letter: letters
level: level
levi: levi
leviticus: leviticus
liability: liability
liable: liable
liberal: liberal
liberate: liberate
liberty: liberty
libra: libra
library: library
license: license
licensed: licensed
licking: licking
lid: lids
lie: lain,lie,lies,lying
lieu: lieu
life: life,lives
lift: lift,lifted,lifting,lifts
light: light,lighter,lighting,lights
lightning: lightning
likeness: likeness
lily: lilies,lily
limb: limbs
limbed: limbed
limbo: limbo
limit: limited,limits
limitation: limitation
limited: limited
linda: linda
linen: linen
linger: linger
link: linked,links
lion: lion
lip: lips
lisp: lisped
list: list
listen: listen,listened,listening,listens
listening: listening
literary: literary
live: live,lived,lives,living
lively: lively
livid: livid
living: living
lo: lo
load: load,loads
loading: loading
loca: loca
local: local
locate: located
location: locations
lock: lock,locked,locks
locust: locusts
lodge: lodge,lodges
lofty: loftier,loftiest,lofty
lombard: lombard
lonely: lonely
longing: longing,longings
loom: loom
loose: loose,loosed,looses,loosing
loosen: loosening
lop: lopped
lord: lord,lords
lose: lose,loses,lost
loss: loss
lost: lost
lot: lot
loud: loud
loudly: loudly
louis: louis
love: love,loved,loves,loving
lucent: lucent
lucia: lucia
lucid: lucid
lucifer: lucifer
luke: luke
lukewarmness: lukewarmness
lullaby: lullaby
luminous: luminous
lunar: lunar
lure: lure
lust: lust
lustful: lustful
lustre: lustre
lusty: lusty
luxury: luxury
lyre: lyre
machine: machine
mad: mad
magnificent: magnificent
magnus: magnus
magpie: magpies
maid: maid
maiden: maiden,maidens
main: main
maintain: maintaining
major: major
maker: maker
malediction: malediction
malign: malign
malignly: malignly
manager: manager
manfred: manfred
manhood: manhood
manifest: manifest
mankind: mankind
manna: manna
manner: manner
mantle: mantle
manto: manto
mantua: mantua
mantuan: mantuan
marble: marble
march: march
marchese: marchese
marcia: marcia
marco: marco
maremma: maremma
margaret: margaret
mariner: mariners
mark: mark,marked,marks
marketplace: marketplace
marquis: marquis
marriage: marriage
married: married
marry: married,marry
mars: mars
marseilles: marseilles
marsh: marsh
marshal: marshal,marshals
martin: martin
martyrdom: martyrdom
marvel: marvel,marvelled,marvelling,marvels
marvelling: marvelling
marvelously: marvelously
mary: mary
masculine: masculine
mask: masks
mass: masses
massy: massy
master: master
masters: masters
mastery: mastery
match: matching
mater: mater
material: material
maternal: maternal
matilda: matilda
matin: matin
matins: matins
matter: matter,matters
matthew: matthew
mature: mature,matures
maximum: maximum
maximus: maximus
mayst: mayst
mea: mea
meadow: meadow
meagreness: meagreness
meaning: meaning
measure: measure,measured
mediaeval: mediaeval
meditation: meditation
medium: medium
meed: meed
meet: meet,meeting,meets,met
meeting: meeting
meleager: meleager
melody: melody
melt: melt,melting,melts
memory: memories,memory
mend: mend
mention: mention,mentioned,mentioning,mentions
merchantability: merchantability
merciful: merciful
mercury: mercury
mercy: mercy
mere: mere
meridian: meridian
merit: merit
messenger: messenger,messengers
messer: messer
met: met
metal: metal,metals
metamorphoses: metamorphoses
metaphysics: metaphysics
method: method,methods
michael: michael
mid: mid
midas: midas
midday: midday
middle: middle
midheaven: midheaven
midmost: midmost
midnight: midnight
mien: mien
milan: milan
milanese: milanese
mild: mild,milder
mile: mile,miles
milk: milked
milton: milton
mime: mime
mind: mind
mindful: mindful
mindless: mindless
minerva: minerva
mingle: mingled
minion: minions
minister: minister,ministers
minor: minor
minos: minos
mira: mira
mire: mire
mirror: mirror,mirrored
miscreant: miscreants
miserere: miserere
misfortune: misfortune
misreading: misreading
mission: mission
mississippi: mississippi
mist: mist,mists
mistress: mistresses
mitre: mitre
mix: mixed
mixture: mixture
moat: moat
mobile: mobile
mock: mocked
mode: mode,modes
model: model
moderate: moderates
modern: modern
modest: modest
modesty: modesty
modicum: modicum
modification: modification
modify: modified
moist: moist
mole: mole
molten: molten
moment: moment
monaco: monaco
monastery: monastery
monday: monday
money: money
monk: monk
monster: monster
month: month,months
mood: mood
moon: moon
moonrise: moonrise
moore: moore
moral: moral,morals
morality: morality
morally: morally
mordecai: mordecai
morning: morning
morocco: morocco
mortal: mortal,mortals
mortification: mortification
moses: moses
mother: mother
motion: motion,motions
motionless: motionless
motive: motive
motor: motor
mount: mount,mounted,mounting,mounts
mountain: mountain,mountains
mountaineer: mountaineer
mountainous: mountainous
mourn: mourn,mourning,mourns
mouth: mouth,mouths
movement: movement,movements
mulberry: mulberry
multum: multum
murder: murder,murdered
murderer: murderer
murmur: murmured,murmuring
murmuring: murmuring
muse: muses
muses: muses
music: music
musical: musical
mute: mute
mutual: mutual
mutually: mutually
muzzle: muzzle
myrtle: myrtle
mystery: mysteries
mystic: mystic
mystical: mystical
myth: myth
mythology: mythology
naiad: naiades
naiades: naiades
nail: nailed,nails
naked: naked
naples: naples
narration: narration
narrative: narrative
narrow: narrow
narrowness: narrowness
native: native
natural: natural
naturally: naturally
nature: nature,natures
naught: naught
navigate: navigate
nearer: nearer
necessity: necessity
neck: neck,necks
necklace: necklace
nectar: nectar
needful: needful
needle: needle
neglect: neglect,neglected
negligence: negligence
negligent: negligent
neighbor: neighbor,neighbors
neighboring: neighboring
nephew: nephew
nest: nest
nettle: nettle
network: network
news: news
newsletter: newsletter
nicholas: nicholas
nickname: nickname
night: night,nights
nightfall: nightfall
nightingale: nightingale
nil: nil
nile: nile
nimble: nimble
nimrod: nimrod
nineteenth: nineteenth
ninth: ninth
niobe: niobe
nobility: nobility
noble: noble,nobles
nocturnal: nocturnal
nod: nodded
nonproprietary: nonproprietary
noon: noon
normandy: normandy
north: north
northern: northern
nose: nose
nosed: nosed
notary: notary
note: note,notes
notice: notice,noticed
notify: notifies
nourish: nourished
nourishment: nourishment
nova: nova
novelty: novelties
november: november
numeral: numerals
nunc: nunc
nurse: nurse,nurses
nurture: nurtured
nymph: nymph,nymphs
nymphs: nymphs
oak: oak
oar: oar,oars
obduracy: obduracy
obdurate: obdurate
obedience: obedience
obedient: obedient
object: object,objected,objects
objection: objection
obligation: obligation
oblige: obliged
obliterate: obliterate,obliterated
oblivion: oblivion
obscure: obscure,obscured
obscurely: obscurely
observe: observed,observes
obsolete: obsolete
obstacle: obstacle
occasion: occasion,occasioned
occult: occult
occur: occur
ocean: ocean
octavian: octavian
october: october
odor: odor,odors
odour: odour
offence: offence,offences
offend: offended,offends
offended: offended
offer: offered,offers
office: office
officer: officer
official: official,officials
oft: oft
oftentimes: oftentimes
ofttimes: ofttimes
olive: olive
olympus: olympus
omit: omits
online: online
onward: onward
ooze: ooze
operate: operate
opinion: opinion
opponent: opponent
opportunity: opportunities,opportunity
opposition: opposition
opprobrium: opprobrium
oracle: oracles
orange: orange
orbit: orbit
ordain: ordained,ordains
ordo: ordo
orestes: orestes
organ: organ,organs
organize: organize,organized
orient: orient
oriental: oriental
origin: origin
original: original
originally: originally
originator: originator
orison: orison,orisons
ornament: ornament
orvieto: orvieto
outcry: outcry
outdated: outdated
outer: outer
outermost: outermost
outlet: outlet
outrage: outrage
outraged: outraged
outset: outset
outspread: outspread
outstretched: outstretched
outstrip: outstripped
outward: outward
outwardly: outwardly
overcast: overcast
overcome: overcame,overcome,overcomes
overshadow: overshadows
overspread: overspread
overtake: overtaken,overtaking
ovid: ovid
owe: owe,owed,owes
owner: owner
oxen: oxen
pace: pace,paces
pack: packed
paganism: paganism
pain: pain,pains
painful: painful
paint: painted,paints
painter: painter
painting: painting
pair: pairs
palace: palace,palaces
palazzo: palazzo
pale: pale
palinurus: palinurus
pallas: pallas
pallid: pallid
palm: palm,palms
pan: pan
pang: pang
panting: panting
pap: pap,paps
papacy: papacy
papal: papal
paper: paper
paperwork: paperwork
paradise: paradise
paragraph: paragraph,paragraphs
paramour: paramour
parcel: parcelled
pardon: pardon,pardoning,pardons
paris: paris
parnassus: parnassus
parricide: parricide
partisan: partisan
partly: partly
party: party
pasiphae: pasiphae
pass: pass,passed,passes,passing
passage: passage,passages
passer: passers
passive: passive
pastor: pastor
paternoster: paternoster
path: path,paths
pathway: pathway
patience: patience
pauline: pauline
paunch: paunch
pause: pause
pavement: pavement
pay: paid,pay,paying
payment: payments
peace: peace
peacemaker: peacemaker,peacemakers
peak: peak,peaks
pebble: pebbles
peculiar: peculiar
pedagogue: pedagogue
pelorus: pelorus
pen: pens
penalty: penalty
penance: penance
pencil: pencil,pencils
penetrate: penetrate
penitence: penitence
penitent: penitent
pennon: pennons
peradventure: peradventure
perceive: perceive,perceived,perceiving
perception: perception
perchance: perchance
perfect: perfect
perfection: perfection
perforce: perforce
perform: perform,performed,performing,performs
performance: performances
period: period
periodic: periodic
perish: perish,perishing
permanent: permanent
permission: permission
permit: permitted
perpendicular: perpendicular
perpetual: perpetual
perplexity: perplexity
perse: perse
persecute: persecuted
persecution: persecution
persecutor: persecutors
person: people,person,persons
personage: personage
personal: personal
personification: personifications
persuade: persuades
persuasion: persuasions
pertain: pertain
pervert: perverted
peter: peter
petition: petition
petri: petri
petrifying: petrifying
phaethon: phaethon
philip: philip
phillip: phillip
philomela: philomela
philosophy: philosophy
phrase: phrase
physical: physical
physician: physician
pia: pia
picae: picae
picture: picture,picturing
piedmontese: piedmontese
pier: pier
pierce: pierced,pierces
pierre: pierre
piety: piety
pilate: pilate
pilgrim: pilgrim,pilgrims
pilot: pilot
pine: pine
pinion: pinions
pious: pious
pisa: pisa
pisan: pisan
pisces: pisces
pit: pit,pits
piteous: piteous
piteously: piteously
pitiable: pitiable
pitiful: pitiful
pitiless: pitiless
pity: pity
pivot: pivots
plain: plain
plaint: plaint
planet: planet
plank: planks
plant: plant,planted,plants
plato: plato
plautus: plautus
play: play,played,playing
playful: playful
pleasant: pleasant
pleasantness: pleasantness
pleased: pleased
pleasing: pleasing
pleasure: pleasure,pleasures
pledge: pledge
pluck: plucked,plucks
plumage: plumage
plume: plumes
plunder: plunder,plundered
plunge: plunged
ply: plied
po: po
podesta: podesta
poem: poems
poesy: poesy
poet: poet,poets
poetic: poetic
poise: poised
poison: poison,poisoned
poisonous: poisonous
pole: pole
polished: polished
pollock: pollock
pollux: pollux
polymnestor: polymnestor
poop: poop
poor: poor
pope: pope,popes
popular: popular
porphyry: porphyry
port: port
portal: portal
portion: portion
portray: portray,portrayed
position: position
possess: possess,possessed,possesses
possession: possession,possessions
possessor: possessors
possibility: possibility
post: post,posted
postpone: postponed
potency: potency
potential: potential
pour: pour,poured,pouring,pours
poverty: poverty
power: power,powers
powerful: powerful
practically: practically
practice: practice,practiced
practise: practised
praise: praise,praised,praises
pray: pray,prayed,praying,prays
prayer: prayer,prayers
preacher: preachers
precede: precede,precedes,preceding
precious: precious
prefer: preferring
pregnant: pregnant
premature: premature
preparation: preparation
prepare: prepare,preparing
presence: presence
preserve: preserve,preserved
press: press,pressed,presses,pressing
presul: presul
presumption: presumption
presumptuous: presumptuous
prevail: prevailed
prevalence: prevalence
prevent: prevent,prevents
previous: previous
prevision: prevision
prey: prey
priam: priam
prick: prick,pricked
pricking: pricking
pride: pride
priest: priest
prima: prima
primal: primal
primeval: primeval
prince: prince
princes: princes
principle: principle
print: print,printed
prison: prison
prisoner: prisoner
private: private
privilege: privilege
privily: privily
prize: prize
pro: pro
proceed: proceeded,proceeding,proceeds
proceeding: proceeding
proceeds: proceeds
processing: processing
procession: procession
proclaim: proclaimed,proclaims
prodigal: prodigals
prodigality: prodigality
prodigy: prodigy
produce: produce,produced,produces
production: production
professor: professor
profit: profit,profits
profound: profound
progeny: progenies,progeny
progne: progne
progress: progress
prohibition: prohibition
project: project
projection: projection
prominently: prominently
promise: promise,promised,promising
promontory: promontory
promote: promoted,promoting
promotion: promotion
prompt: prompt
proof: proof
proofread: proofread
proper: proper
property: properties,property
prophecy: prophecy
prophesy: prophesied
prophetic: prophetic
proportion: proportion
propose: proposes
proposition: proposition
proprietary: proprietary
propter: propter
prose: prose
prostitute: prostitute
prostrate: prostrate
protect: protect,protected
prove: proved,proves
provencal: provencal
provence: provence
provide: provide,providing
province: provinces
provision: provision,provisions
prow: prow
prudence: prudence
psalm: psalm
psalmist: psalmist
psalmody: psalmody
public: public
pull: pull
pulpit: pulpit
punish: punished
punishment: punishment
punitive: punitive
purchase: purchased
pure: pure,purest
purgation: purgation
purgatory: purgatory
purge: purge,purged,purges,purging
purification: purification
purify: purified,purify
purity: purity
purple: purple
purpose: purpose
purse: purse
pursue: pursues,pursuing
pursuer: pursuers
pursuit: pursuit
push: pushed
pygmalion: pygmalion
pylades: pylades
pyramus: pyramus
pyrrhus: pyrrhus
quadrant: quadrant
quae: quae
quality: qualities,quality
quarrel: quarrel
quarter: quarter,quarters
queen: queen
quench: quenched
question: question,questioning,questions
questioning: questioning
qui: qui
quia: quia
quicken: quickened,quickening
quid: quid
quiet: quiet,quieted
quiver: quivering,quivers
quod: quod
quorum: quorum
race: race
rachel: rachel
rack: racked
radiance: radiance
rafter: rafters
rage: rage
raiment: raiment
rain: rain,rained,raining
rainbow: rainbow
raise: raised,raising
ram: ram
ramble: rambles
ransom: ransom
rapine: rapine
rapt: rapt
rarely: rarely
ravage: ravage
ray: ray,raying,rays
reach: reach,reached,reaches,reaching
read: read,reading,reads
readable: readable
reader: reader
ready: ready
reaffirm: reaffirmed
real: real
realm: realm,realms
reap: reap
rear: rear
reason: reason,reasons
reasonable: reasonable
reasoning: reasoning
reassure: reassured
rebuke: rebuke,rebukes,rebuking
rebut: rebuts
recall: recall,recalls
recapture: recaptured
recede: receded,recedes
receipt: receipt
receive: receive,received,receives,receiving
recite: recited
reckon: reckoned,reckons
recline: reclined
recluse: recluse
recognition: recognition
recognize: recognize,recognized,recognizing
record: record
recover: recovered
red: red
redeem: redeem,redeemed,redeems
redemption: redemption
redistribute: redistribute,redistributing
redistributing: redistributing
redistribution: redistribution
reed: reeds
reel: reeled
reenforce: reenforce
reestablish: reestablish
refer: refer,referred,refers
reference: reference,references
refine: refined,refines
reflect: reflected,reflects
reflection: reflection
refreshen: refreshen
refund: refund
refuse: refused,refuses
regain: regained,regains
regard: regard,regarded
regina: regina
region: region,regions
register: registered
regna: regna
regulate: regulating
rehearse: rehearse
rehoboam: rehoboam
reign: reign,reigned
rein: rein
reiterate: reiterating
reject: reject,rejects
rejection: rejection
rejoice: rejoice,rejoicing
rekindle: rekindle,rekindled
relate: relates
relative: relative,relatives
release: release,released,releases
relegate: relegates
relief: relief
relieve: relieve
religion: religion
relucent: relucent
remain: remain,remained,remaining,remains
remainder: remainder
remedy: remedies
remember: remember,remembered
remembrance: remembrance
remission: remission
remorseful: remorseful
remote: remote
removal: removal
remove: remove,removed,removes,removing
rename: renamed
rend: rending
render: render,rendered
renew: renew,renewed
renewal: renewal
reno: reno
renovate: renovated
renown: renown
renowned: renowned
rent: rent
repair: repaired
repeat: repeat,repeated,repeating,repeats
repent: repent,repented,repents
repentance: repentance
repentant: repentant
replace: replace
replacement: replacement
replete: replete
reply: replied,replies,reply
report: report,reported,reports
repose: repose
represent: represent,represented,represents
representation: representations
repress: represses
reproach: reproach
reproachful: reproachful
reproof: reproof
reprove: reprove,reproving
reputation: reputation
repute: repute,reputed
request: request
require: require,required,requires
requirement: requirements
requisite: requisite
rescue: rescue,rescued
resemble: resembled,resembling
reshape: reshaped
reside: residing
resist: resist,resisted
resistance: resistance
resound: resound,resounded
resounding: resounding
respect: respect
respective: respective
resplendent: resplendent
rest: rest,rested,resting,rests
restoration: restoration
restore: restore,restored,restores
restrain: restrain,restrained
restrained: restrained
restriction: restrictions
result: result
retain: retain,retained
retract: retracts
retreat: retreat,retreats
return: return,returned,returning,returns
reveal: reveal,revealed,revealing
revelation: revelation
revenue: revenue
reverence: reverence
reverent: reverent
revive: revive,revived
revolt: revolt
revolution: revolution
revolve: revolves,revolving
reward: reward
rewed: reweds
rho: rho
rhyme: rhyme,rhymes
rich: rich,richer,richest
riches: riches
ridden: ridden
riddle: riddles
ride: rides
rift: rift
righteous: righteous
righteousness: righteousness
rightly: rightly
rim: rim
rind: rind
ripen: ripen
rise: rise,risen,rises,rising,rose
risk: risk
rite: rites
rival: rivals
river: river,rivers
riviera: riviera
road: road,roads
roar: roared
roaring: roaring
rob: rob,robs
robe: robed
robust: robust
rock: rock,rocks
roll: rolled,rolling,rolls
rolled: rolled
roman: roman,romans
romance: romances
rome: rome
roof: roof
root: root
rose: roses
rosy: rosy
rough: rough
rouse: roused
rout: rout
route: routed
rove: roving
royal: royal
royally: royally
royalty: royalties,royalty
ruddy: ruddy
rude: rude
rudolph: rudolph
rue: rue
rugged: rugged
ruin: ruin
rule: rule,ruled,rules,ruling
ruler: ruler
ruminate: ruminate,ruminating
rumor: rumor
running: running
rush: rush,rushed,rushes
sacra: sacra
sacrament: sacrament
sacred: sacred
sacrifice: sacrifice,sacrificed
sacrilege: sacrilege
sacrosanct: sacrosanct
sad: sad
sadden: saddened
saddened: saddened
saddle: saddle
safe: safe
safely: safely
sage: sage,sages
sail: sail,sails
saint: saints
saints: saints
sake: sake
salt: salt
salutation: salutation,salutations
salvation: salvation
salve: salve
samaria: samaria
sample: sample
samuel: samuel
san: san
sand: sands
sane: sane
sanguine: sanguine
santa: santa
sapient: sapient
sapphira: sapphira
sapphire: sapphire
saracen: saracen
sardinia: sardinia
sate: sate,sated,sating
satisfaction: satisfaction
satisfied: satisfied
satisfy: satisfies,satisfy
saturn: saturn
saturnia: saturnia
saul: saul
savage: savage
save: save,saved
saviour: saviour
savor: savor,savors
savory: savory
sayest: sayest
scab: scab
scala: scala
scales: scales
scanty: scanty
scarce: scarce
scarlet: scarlet
scatter: scatter,scattered,scattering,scatters
scene: scenes
scent: scent
schism: schism
scholastic: scholastic
school: school
schoolman: schoolmen
science: science
scion: scion
sclavonian: sclavonian
scorch: scorched
scorched: scorched
scorn: scorn,scorns
scornful: scornful
scorpio: scorpio
scorpion: scorpion
scot: scot
scourge: scourge,scourged,scourges
scramble: scrambling
screen: screen
sculpture: sculptured
scum: scum
sea: sea
seaboard: seaboard
seal: seal,sealed
search: search
seashore: seashore
seat: seat,seated,seats
secluded: secluded
secrecy: secrecy
secret: secret
secretly: secretly
sect: sects
secure: secure,secured,secures
securely: securely
sed: sed
seduce: seduced
seed: seed
seek: seek,seeking,seeks,sought
seemliness: seemliness
seize: seize,seized,seizes
seizure: seizure
seldom: seldom
sell: selling,sells,sold
semblance: semblance
send: send,sending
sense: sense
sensitive: sensitive
sensual: sensual
sentence: sentence
senza: senza
separate: separate,separated,separating
september: september
septentrion: septentrion
sepulchral: sepulchral
sepulture: sepulture
sequester: sequesters
serene: serene
serpent: serpent
servant: servant
serve: serving
service: service
servile: servile
set: set,sets,setting
setting: setting
settlement: settlement
sevenfold: sevenfold
seventh: seventh
severally: severally
sew: sews
shade: shade,shaded
shades: shades
shadow: shadow,shadows
shaft: shaft
shake: shook
shalt: shalt
shame: shame,shamed
shameless: shameless
shape: shape,shaped,shapes
share: share,shared,sharing
sharp: sharp
sharpen: sharpen
sharpened: sharpened
sheep: sheep
shelf: shelf
shelley: shelley
shelter: shelter
shepherd: shepherd,shepherded,shepherds
shield: shield,shields
shift: shifts
shine: shine,shines,shining,shone
ship: ship,ships
shock: shocks
shoot: shoot,shooting,shoots,shot
shore: shore,shores
short: short,shorter,shortest
shorten: shortening
shortly: shortly
shot: shot
shoulder: shoulder,shoulders
shouldst: shouldst
shout: shouting
shred: shreds
shrub: shrubs
shun: shunning
shut: shut,shuts
shuttle: shuttle
shy: shy
sibyl: sibyl
sicilian: sicilian
sicily: sicily
sick: sick
siege: siege
siena: siena
sienese: sienese
sigh: sigh,sighing,sighs
sight: sight
sign: sign,signs
signal: signals
signify: signifies,signify,signifying
silence: silence
silent: silent
silently: silently
silly: silly
silver: silver
simple: simple
sin: sin,sinning,sins
sinful: sinful
sing: sang,sing,singing,sung
singer: singer
singing: singing
single: single
singular: singular
sink: sank,sinks
sinner: sinner,sinners
siren: siren
sirens: sirens
sirocco: sirocco
sis: sis
sister: sister,sisters
sit: sat,sit,sits,sitting
sixth: sixth
sketch: sketch
skill: skill
skin: skin
sky: sky
slack: slack
slacken: slackened
slackened: slackened
slaughter: slaughter
slave: slaves
slay: slain,slay,slays
sleek: sleeks
sleep: sleep,sleeping,sleeps
slew: slew
slip: slip
slope: slope,slopes
sloth: sloth
slothful: slothful
slough: slough
slow: slow,slower,slowest
slowly: slowly
sluggard: sluggards
slumber: slumber,slumbers
smell: smell,smells
smile: smile,smiled,smiles,smiling
smite: smitten,smote
smith: smith
smitten: smitten
smoke: smoke
smooth: smooth
smote: smote
snake: snake
snare: snares
snarling: snarling
snatch: snatched
snow: snow
socket: sockets
sodom: sodom
soft: soft
soften: softened,softens
softly: softly
soil: soil
sojourn: sojourn
solace: solace
soldiery: soldiery
sole: sole
solicit: solicit
solicitation: solicitation
solicitude: solicitude
solid: solid
solitary: solitary
solomon: solomon
solve: solve,solved
son: son,sons
song: song,songs
sonnet: sonnet
sonorous: sonorous
sooth: sooth
soothsayer: soothsayer
sop: sop,sops
sorceress: sorceress
sordello: sordello
sorrow: sorrow
sorrowful: sorrowful
sorrowing: sorrowing
soul: soul,souls
sound: sound,sounded,sounds
source: source
south: south
southern: southern
sow: sown
sowing: sowing
space: space
spain: spain
spare: sparest
spark: spark,sparks
sparkle: sparkles
sparrow: sparrow
speak: spake,speak,speaking,speaks,spoke,spoken
speaker: speaker
speaking: speaking
special: special
specific: specific
speck: speck
speech: speech
speed: speed,speeded
speedily: speedily
speedy: speediest,speedy
spend: spent
spending: spending
sphere: sphere
sphinx: sphinx
spider: spider
spirit: spirit,spirits
spiritual: spiritual
spirt: spirts
spite: spite
splendor: splendor,splendors
splinter: splinters
split: split
spoil: spoil,spoiled,spoils
sponge: sponge
sport: sporting
sportive: sportive
spouse: spouse
spray: spray
spread: spread,spreads
spring: sprang,spring,springs
spur: spur,spurred,spurs
sqq: sqq
square: square
stab: stabs
staff: staff
stage: stage
stagger: staggering
staid: staid
stain: stain,stained,stains
stainless: stainless
stair: stair,stairs
stairway: stairway
stake: stake
stammer: stammering
stamp: stamp,stamped
stand: stand,standing,stands,stood
standing: standing
star: star,stars
starboard: starboard
starry: starry
stars: stars
start: start,started
statement: statements
station: stationed,stations
status: status
stave: stave
stay: stay,stayed,staying,stays
staying: staying
stead: stead
steadfast: steadfast
steadily: steadily
steal: steal,stole,stolen
steep: steep,steeper
steeply: steeply
stench: stench
step: step,steps
stern: stern
sternly: sternly
sting: sting,stung
stir: stirred,stirs
stitch: stitches
stock: stocks
stone: stone,stones
stony: stony
stoop: stoop,stooping
stooping: stooping
store: stored
storied: storied
stork: stork
story: stories,story
straight: straight
straighten: straighten
straightness: straightness
straightway: straightway
strain: straining
strait: strait
straiten: straitened
strand: strand
strange: strange
stranger: stranger
straw: straw
stray: stray,strayed
stream: stream,streams
streaming: streaming
streamlet: streamlet
strength: strength
strengthen: strengthening
stretch: stretch,stretched,stretches
strewing: strewing
stricken: stricken
strict: strict
stride: strides
strife: strife
strike: strike,strikes,striking,struck
striking: striking
strip: strip,stripped,strips
stripe: stripe,stripes
strive: strive,strives,striving,strove
stroke: stroke,stroking
strong: strong,stronger
stronghold: stronghold
structure: structure
stupefied: stupefied
sturdy: sturdy
style: style
styx: styx
subdue: subdue
subject: subject,subjected
subjection: subjection
subscribe: subscribe
subsistence: subsistence
substance: substance
substantia: substantia
substantial: substantial
subterranean: subterranean
subtile: subtile
succeed: succeeded
succession: succession
successor: successor
succor: succor
suckle: suckled
sudden: sudden
suddenly: suddenly
suffer: suffer,suffered
suffering: suffering,sufferings
suffice: suffice,sufficed,suffices
sufficient: sufficient
suicide: suicide,suicides
sully: sully
sum: sum
summa: summa
summae: summae
summit: summit
sun: sun,suns
sunbeam: sunbeam,sunbeams
sunrise: sunrise
suns: suns
sunset: sunset
sunt: sunt
superior: superior,superiors
supernal: supernal
supervene: supervened
supper: supper
supply: supplied,supplies
support: support,supported
supporter: supporters
suppose: suppose,supposed,supposing
suppress: suppressed
supreme: supreme
surely: surely
surmount: surmount
surpass: surpass,surpassed,surpasses
surprise: surprised,surprises
surround: surrounded,surrounds
survive: survive
suspect: suspect
suspend: suspend
suspense: suspense
suspicion: suspicion
sustain: sustain,sustained
swaddle: swaddling
swallow: swallow,swallowed
swamp: swamp
swan: swan
swathing: swathing
swear: swear,swearing,sworn
sweet: sweet,sweeter,sweetest
sweetly: sweetly
sweetness: sweetness
swell: swelling,swells
swelling: swelling
swift: swift
swiftly: swiftly
swollen: swollen
sword: sword,swords
sylvan: sylvan
symbol: symbol,symbols
symbolic: symbolic
symbolize: symbolize,symbolizes,symbolizing
synonymous: synonymous
syrinx: syrinx
table: table
tail: tail
taketh: taketh
tale: tale
talk: talk,talking
tame: tames
tanti: tanti
taper: tapers
tardy: tardy
tare: tare
tarpeia: tarpeia
tarpeian: tarpeian
tarry: tarry,tarrying
taste: taste,tasted,tastes,tasting
taurus: taurus
tax: tax,taxes
te: te
teacher: teacher,teachers
teaching: teaching
tear: tear,tears,tore,torn
tecta: tecta
teem: teeming
temerity: temerity
temper: tempered
temperance: temperance
temperate: temperate
tempering: tempering
tempest: tempest
temple: temple,temples
temporal: temporal
tempt: tempted
temptation: temptation
tension: tension
tenth: tenth
terence: terence
tereus: tereus
term: term,termed,terms
terminate: terminated
terra: terra
terrestrial: terrestrial
terrible: terrible
terrified: terrified
terrify: terrifies
territory: territory
testament: testament
thebaid: thebaid
theban: theban
thee: thee
theme: theme
themis: themis
theological: theological
theology: theology
thereat: thereat
therefor: therefor
therefrom: therefrom
thereon: thereon
therewith: therewith
therewithin: therewithin
theseus: theseus
thetis: thetis
thicket: thicket
thief: thief,thieves
thievish: thievish
thigh: thigh
thine: thine
thirst: thirst,thirsted
thirsty: thirsty
thirteenth: thirteenth
thirtyfold: thirtyfold
thisbe: thisbe
thither: thither
thitherward: thitherward
thomas: thomas
thorn: thorns
thoughtful: thoughtful
thread: thread
threaten: threaten
threshing: threshing
threshold: threshold
thrice: thrice
throat: throat
throne: throne
throng: throng
throw: threw,thrown,throws
thrower: thrower
thrust: thrust,thrusts
thunder: thunder
thunderbolt: thunderbolt
thy: thy
thyself: thyself
tiber: tiber
tight: tight
tigris: tigris
time: time,times
timid: timid
tiresias: tiresias
tissue: tissue
tithonus: tithonus
title: title
titus: titus
toil: toil,toils
tomb: tomb,tombs
tone: tone
tongue: tongue
tooth: teeth
topmost: topmost
torch: torches
torment: torment,tormenting,torments
tossing: tossing
touch: touch,touched,touches
tours: tours
tower: tower
town: town,towns
trace: trace,traces
track: track
tract: tract
trademark: trademark
tradition: tradition
tragic: tragic
trail: trail,trailed
train: train
traitor: traitor
tranquil: tranquil
transaction: transaction
transcribe: transcribe
transcription: transcription
transfer: transferred
transfiguration: transfiguration
transfix: transfixed
transform: transformed
transformation: transformation
transgression: transgressions
translate: translated
translator: translator
transmute: transmuted,transmuting
transposition: transposition
travail: travail
traverse: traverse
treacherous: treacherous
treachery: treachery
tread: tread,trod
treasure: treasure
treasury: treasury
treat: treating
treatment: treatment
tree: tree,trees
tremble: tremble,trembles,trembling
tremulous: tremulous
trench: trenches
trial: trial
tribe: tribe
tribunal: tribunal
tribune: tribune
trickle: trickles
triform: triform
tripartite: tripartite
triumph: triumph,triumphs
triumphal: triumphal
trivial: trivial
troop: troop
troubadour: troubadour
trouble: trouble
troubled: troubled
troy: troy
truce: truce
true: true
trump: trump
trumpet: trumpet,trumpets
truncate: truncated
trunk: trunk
trust: trust,trusted,trusts
trusty: trusty
truth: truth
truthful: truthful
tua: tua
tuscan: tuscan
tuscany: tuscany
twist: twisted,twists
twofold: twofold
type: type,types
typical: typical
typify: typified,typify,typifying
tyrant: tyrant,tyrants
ubi: ubi
ulysses: ulysses
unable: unable
unbent: unbent
unbind: unbinds
unbound: unbound
unburden: unburden,unburdened
unburied: unburied
uncertain: uncertain
unclean: unclean
uncloud: uncloud
unconcerned: unconcerned
uncover: uncover,uncovered
undeceived: undeceived
undergo: undergo
underlie: underlies
understand: understand,understanding,understood
understanding: understanding
undivided: undivided
undo: undo,undone
unenclosed: unenclosed
unenforceability: unenforceability
unequally: unequally
unfold: unfolded
unharmed: unharmed
uniform: uniform
union: union
unite: united
united: united
unknown: unknown
unlink: unlink
unlock: unlocks
unloosed: unloosed
unmake: unmade
unmatched: unmatched
unprotected: unprotected
unreality: unreality
unripe: unripe
unseen: unseen
unsolicited: unsolicited
untame: untamed
untilled: untilled
untrue: untrue
unveil: unveil
unveiling: unveiling
update: updated
upper: upper
upright: upright
uprisen: uprisen
uproot: uprooted
upward: upward
urania: urania
urban: urban
urge: urge,urged
usage: usage
user: user
ut: ut
utter: utter,uttered,uttering
utterly: utterly
vacant: vacant
vaguely: vaguely
vail: vails
vain: vain
vainglory: vainglory
valiant: valiant
valley: valley,valleys
valois: valois
valor: valor
valve: valve
vanilla: vanilla
vanish: vanishing
vanity: vanities,vanity
vanquish: vanquished,vanquishing
vapor: vapor,vapors
variance: variance
variation: variation
variety: variety
variously: variously
vary: varying
vase: vase
vast: vast
vegetative: vegetative
vehicle: vehicle
veil: veil,veiling,veils
veiled: veiled
vein: vein,veins
venerable: venerable
vengeance: vengeance
venite: venite
venom: venom
vent: vents
venture: venture
venus: venus
vera: vera
verde: verde
verdure: verdure
verge: verge
vermilion: vermilion
vernaccia: vernaccia
verona: verona
versa: versa
verse: verse,verses
version: version
vesper: vesper
vespers: vespers
vessel: vessel
vest: vested
vestigia: vestigia
vestment: vestment
viand: viands
vicar: vicar
vice: vice,vices
vicious: vicious
victim: victim
victory: victory
view: view,viewed,viewing
vigil: vigils
vigor: vigor
vii: vii
viii: viii
vilely: vilely
vine: vine
vinegar: vinegar
violate: violated,violates
violence: violence
violent: violent
violently: violently
violet: violets
viper: viper
virgil: virgil
virgin: virgin,virgins
virgo: virgo
virtually: virtually
virtue: virtue,virtues
virtues: virtues
virtuous: virtuous
virtus: virtus
virus: virus
visage: visage
visible: visible
vision: vision,visions
visit: visit,visited,visiting
visor: visor
vita: vita
vivid: vivid
vividly: vividly
vivify: vivified
vocal: vocal
vogue: vogue
voice: voice,voices
void: void
volition: volition
volunteer: volunteer,volunteers
vulgate: vulgate
wag: wags
wain: wain
wait: wait,waited,waiting,waits
wake: waked,waking
wakefulness: wakefulness
walk: walk,walking,walks
wall: wall,walls
wander: wandering,wanders
wanderer: wanderer
wane: waning
wanton: wantons
war: war
ward: ward
warden: warden
warm: warm,warmed,warmest,warms
warmth: warmth
warn: warn,warning
warning: warning
warrant: warrants
warranty: warranties,warranty
wash: wash,washes
wasp: wasp
wast: wast
waste: waste,wasted,wastes
watch: watch,watches,watching
water: water,waters
wave: wave,waves
wax: wax
wayward: wayward
weaken: weakens
wealth: wealth
wear: wears,wore,worn
wearied: wearied
weariness: weariness
weary: weary
weather: weather
wedding: wedding
weep: weep,weeping,weeps,wept
weigh: weighed,weighing,weighs
weight: weight,weights
welfare: welfare
wellborn: wellborn
west: west
westward: westward
whatso: whatso
whatsoever: whatsoever
wheel: wheel,wheeled,wheels
whereat: whereat
wherefore: wherefore
wherefrom: wherefrom
whereof: whereof
whereon: whereon
whereto: whereto
wherewith: wherewith
whirl: whirling,whirls
whisper: whispered
white: white,whiter
whites: whites
wholly: wholly
whoso: whoso
wicked: wicked
wide: wide,wider,widest
widespread: widespread
widow: widow,widowed,widows
wife: wife,wives
wild: wild
willed: willed
william: william
willingly: willingly
wimple: wimple,wimples
win: win
wind: wind,winding,winds
window: window
wine: wine
wing: wing,wings
winnow: winnows
winter: winter
wire: wire
wisdom: wisdom
wise: wise,wiser
wishful: wishful
wit: wit
withdraw: withdraw,withdrawn,withdraws,withdrew
witness: witnesses
woe: woe,woes
wolf: wolf,wolves
woman: woman,women
wonderstruck: wonderstruck
wonted: wonted
woo: woo
wood: wood,woods
word: word
worldly: worldly
worm: worm,worms
wormwood: wormwood
worship: worship
worth: worth
worthless: worthless
worthy: worthy
wouldst: wouldst
wound: wound,wounds
wrath: wrath
wrathful: wrathful
wreath: wreath
wreathe: wreathed
wrest: wrest
wretched: wretched
wretchedness: wretchedness
wring: wrung
write: write,writes,writing,written,wrote
writer: writer,writers
writing: writing
wrong: wrong
xi: xi
xii: xii
xiii: xiii
xiv: xiv
xix: xix
xvi: xvi
xvii: xvii
xviii: xviii
xx: xx
xxi: xxi
xxii: xxii
xxiii: xxiii
xxiv: xxiv
xxv: xxv
xxx: xxx
yellow: yellow
yield: yields
yogis: yogis
yoke: yoke,yoked
yond: yonder
yonder: yonder
youth: youth
youthful: youthful
zeal: zeal
zenith: zenith
zigzag: zigzag
zion: zion
zodiac: zodiac
zone: zone
