abandon: abandoned
abbreviation: abbreviation
abjectly: abjectly
aboard: aboard
aborigine: aborigine,aborigines
abruptly: abruptly
absently: absently
abstract: abstract
accident: accident
accidentally: accidentally
acclaimed: acclaimed
accommodate: accommodated
accommodation: accommodation
accompany: accompanied
accordion: accordion
account: account,accounted,accounts
accuse: accuse
ache: ache
acquaint: acquainted
acre: acre,acres
actor: actor
adam: adam
add: adding
addition: addition
address: address,addresses
adjacent: adjacent
adjoin: adjoined
admire: admire,admired
admirer: admirer,admirers
admit: admit
adultery: adultery
advance: advance
advantage: advantage
advent: advent
adventure: adventures
advertise: advertised
advertiser: advertiser
advice: advice
advise: advise,advised
adze: adze
aeolian: aeolian
affair: affair
affectionate: affectionate
afford: afford
aforesaid: aforesaid
afraid: afraid
afresh: afresh
aft: aft
afternoon: afternoon,afternoons
afterthought: afterthought
age: age,ages
agen: agen
agent: agent,agents
aggravate: aggravated,aggravating
aggressively: aggressively
agin: agin
agitation: agitation
agone: agone
agree: agree,agreed
agricultural: agricultural
ailment: ailments
aim: aim
aimlessly: aimlessly
air: air
ajar: ajar
alan: alan
alarm: alarm,alarmed
alas: alas
alderman: alderman,aldermen
aldermanic: aldermanic
alight: alight
alike: alike
alive: alive
allege: alleged,alleging
alleged: alleged
alluvial: alluvial
aloud: aloud
alright: alright
alter: alter,altered
altogether: altogether
ambition: ambition
amendment: amendment
america: america
american: american,americans
amiability: amiability
amuse: amuse
amusement: amusement
amusing: amusing
anderson: anderson
andy: andy
angel: angel,angels
anger: angered
angle: angle,angles
angry: angry
animal: animal
ankle: ankle
annie: annie
anniversary: anniversary
annoyed: annoyed
anon: anon
answer: answer,answered
ant: ants
antique: antique
anxiety: anxiety
anxious: anxious
anxiously: anxiously
ape: aped
apologise: apologise,apologised,apologising
appealing: appealing
appearance: appearances
appertain: appertaining
applause: applause
apple: apple,apples
apply: applied,applies
appreciation: appreciation
apprehensively: apprehensively
approach: approached
apt: apt
arab: arab,arabs
argue: argue,argued,arguing
argument: argument
aright: aright
aristocracy: aristocracy
aristocrat: aristocrats
aristocratic: aristocratic
arithmetic: arithmetic
arm: arm,arms
arrange: arrange,arranged
arrangement: arrangement,arrangements
arrest: arrest
arrival: arrival
arrive: arrive,arrived
artist: artist
ash: ashes
ashamed: ashamed
ashen: ashen
ashore: ashore
ashtray: ashtray
asiatic: asiatic
asleep: asleep
ass: ass
assistance: assistance
assistant: assistant
assure: assure,assures
astern: astern
astonished: astonished
astonishment: astonishment
astride: astride
asylum: asylum
atmosphere: atmosphere
attach: attached
attack: attack
attempt: attempt
attendance: attendance
attendant: attendants
attention: attention
attraction: attractions
auctioneer: auctioneer
audience: audience
auger: auger
aunt: aunt
auntie: auntie
australia: australia
australian: australian,australians
author: author
autobiography: autobiography
av: av
average: average,averaged
awake: awake
aware: aware
awful: awful
awkward: awkward
awkwardly: awkwardly
axe: axe
axle: axle
babble: babble
babies: babies
baby: babies,baby
babyishly: babyishly
bachelor: bachelor
backer: backers
background: background
bacon: bacon
bad: bad,worse,worst
badly: badly
bag: bag,bags
bail: bail,bailing
bait: bait,baits
bake: bake,baked
baker: baker
balcony: balconies
bald: bald
bale: baled,baling
baling: baling
band: band
bandage: bandages
bandaged: bandaged
bandicoot: bandicoot
bang: bang,banged,banging
bank: bank,banks
banquet: banquet
bar: bar,barred,bars
bare: bare
bargain: bargain
bark: bark,barked
barked: barked
barkless: barkless
barmaid: barmaid,barmaids
barrack: barracked
barracking: barracking
barrel: barrel
barrelled: barrelled
barren: barren
barrow: barrow
base: base
basic: basic
basin: basin,basins
basket: basket
bath: bath
batten: batten,battens
batter: battered
battered: battered
battle: battle
bazaar: bazaar
beak: beak
beam: beam
bear: bear,bearing,bore,born
beard: beard
bearded: bearded
bearing: bearing
beast: beast
beastly: beastly
beat: beat,beaten,beating
beating: beating
beautiful: beautiful
beauty: beauties,beauty
bed: bed,beds
bedding: bedding
bedroom: bedroom
bedstead: bedstead
bee: bees
beef: beef
beer: beer,beers
befitting: befitting
beg: beg,begged,begging
begrudge: begrudged
bein: bein
belle: belle
bellyful: bellyful
belong: belong,belonged,belonging
belongings: belongings
belt: belt
bend: bend,bent
beneath: beneath
bent: bent
bet: bet,betted
beware: beware
bib: bib
bible: bible
billet: billet
bills: bills
billy: billies,billy
bin: bin
bind: bound
bird: bird
birthday: birthday,birthdays
bit: bit,bits
bitch: bitch
bite: bite
bitter: bitter
black: black,blackest,blacks
blackboard: blackboards
blacken: blackened
blackguard: blackguard,blackguards
blackness: blackness
blacks: blacks
blacksmith: blacksmith
blade: blade,blades
bladed: bladed
blame: blame
bland: bland
blank: blank,blanked,blanks
blanket: blanket,blankets
blankly: blankly
blankness: blankness
blanky: blanky
blasting: blasting
blaze: blaze,blazes,blazing
blazed: blazed
bleed: bled
bleeding: bleeding
bless: bless
blessed: blessed
blight: blight,blighted
blind: blind
blindly: blindly
blink: blinked,blinking
blister: blister
block: block,blocks
blood: blood
blooded: blooded
bloodshot: bloodshot
bloody: bloody
bloom: blooming
blotch: blotched,blotches
blow: blow,blowing,blows
blown: blown
blucher: blucher
blue: blue,blued
bluff: bluff
bluish: bluish
blunder: blundered,blundering
blurt: blurted
board: board,boarded,boards
boast: boast
bob: bob,bobs
bobbery: bobbery
bobby: bobby
body: bodies,body
bog: bogs
bogan: bogan
boggy: boggy
boil: boil,boiled,boiling,boils
boiler: boiler,boilers
boiling: boiling
bole: bole
bolt: bolt,bolted,bolting
bomb: bomb
bone: bone,bones
bony: bony
book: book,books
boom: boom
boose: boose
boot: boot,boots
boozer: boozers
border: border
bore: bore,bored,boring
borrow: borrowed
bosom: bosom
boss: boss,bossed,bosses
bother: bother,bothered,bothering
bottle: bottle,bottles
bough: bough,boughs
boulder: boulders
bound: bound,bounded
boundary: boundaries,boundary
bow: bow,bowed
box: box,boxes
boxed: boxed
boy: boy,boys
boyhood: boyhood
brace: brace,braced
braid: braid
brain: brain,brains
brake: brake
branch: branch,branched,branches
brand: brand,brands
brandy: brandy
brass: brass
brassy: brassy
brave: brave,bravest
bread: bread
break: break,breaking,breaks,broke,broken
breaker: breaker
breakfast: breakfast
breaking: breaking
bream: bream
breath: breath,breaths
breathe: breathe,breathing
breathing: breathing
breathless: breathless
breeches: breeches
breed: bred,breed,breeding
breeding: breeding
breeze: breeze
briar: briar
brick: brick,bricks
bridge: bridge
bridle: bridle,bridled,bridles
bright: bright,brighter,brightest
brighten: brighten,brightened,brightening
brightly: brightly
brilliant: brilliant
brim: brim,brimmed
bring: bring,bringing,brings,brought
brisbane: brisbane
briskly: briskly
british: british
broad: broad,broadest
brogue: brogue
broil: broiling
broiling: broiling
broken: broken
brood: brood,brooded,brooding
brooding: brooding
broom: broom
brother: brother,brothers
brotherly: brotherly
brow: brows
brown: brown,browned
brownie: brownie
brownish: brownish
bruise: bruised
brumby: brumbies
brush: brush
brutal: brutal
brutally: brutally
brute: brute
buck: buck
bucket: bucket,buckets
bucketful: bucketfuls
buffer: buffer
bug: bug
buggy: buggies,buggy
build: build,built
builder: builder
building: building,buildings
bull: bull
bullet: bullet
bulletin: bulletin
bullock: bullock,bullocks
bullocks: bullocks
bump: bumped
bunch: bunch,bunched
bundle: bundled
bung: bung
bunk: bunk,bunks
burden: burden
burglar: burglar
burke: burke
burn: burned,burning,burns,burnt
burning: burning
burred: burred
burst: burst,bursting
bury: buried,buries,bury
bush: bush,bushes
bushcraft: bushcraft
bushel: bushel
bushman: bushman,bushmen
bushmen: bushmen
bushranging: bushranging
bushwoman: bushwoman
bushy: bushy
business: business
bustle: bustle,bustled,bustling
bustling: bustling
busy: busy
butcher: butcher
butchery: butchery
butt: butt,butts
butter: butter
buttercup: buttercups
butterfly: butterflies
button: buttoned,buttons
bye: bye
bygone: bygones
bygones: bygones
cabbage: cabbage
cabin: cabins
cable: cable
caddie: caddies
cake: cake,caked
calf: calf,calves
calico: calico
californian: californian
calm: calm
calmly: calmly
camel: camel
camp: camp,camped,camping,camps
camping: camping
canary: canary
candle: candle,candles
canine: canine
cannibal: cannibal
canter: canter,cantered
canvas: canvas
cap: cap,caps
caper: capered
capital: capital
capitalize: capitalized
carcass: carcass
card: card,cards
care: care,cared,cares
career: career
careful: careful
carefully: carefully
careless: careless
carelessly: carelessly
carelessness: carelessness
carnal: carnal
carolina: carolina
carpenter: carpenters
carpentering: carpentering
carpentry: carpentry
carriage: carriage
carrier: carriers
carrion: carrion
carry: carried,carries,carry,carrying
carrying: carrying
cart: cart,carted,carts
cartridge: cartridge
cash: cash
cask: cask
cast: cast
caste: caste,castes
castrate: castrated
casual: casual
casually: casually
cat: cat,cats
catch: catch,catching,caught
cattle: cattle
cautious: cautious
cautiously: cautiously
cave: caved
cedar: cedar
ceiling: ceiling,ceilings
cell: cell
cellar: cellars
cemetery: cemetery
centre: centre
century: centuries
chaff: chaff
chaffing: chaffing
chain: chain,chained,chains
chair: chair,chairs
chairman: chairman
chalk: chalk
chamber: chambers
chamois: chamois
champion: champion
chance: chance,chances
chancery: chancery
change: change,changed
changeless: changeless
chap: chap,chaps
character: character,characters
characteristic: characteristic
charge: charge
chase: chase,chased
chat: chatted,chatting
chattel: chattels
cheap: cheap
cheat: cheated
check: check
cheek: cheek,cheeks
cheer: cheer,cheered
cheerful: cheerful
cheerfully: cheerfully
cheerily: cheerily
cheque: cheque,cheques
chest: chest
chested: chested
chestnut: chestnut
chew: chewing
chicken: chickens
chief: chief
child: child,children
childhood: childhood
childish: childish
chilly: chilly
chimney: chimney,chimneys
chin: chin
china: china
chinaman: chinaman
chinamen: chinamen
chinese: chinese
chip: chip
chisel: chisel
choke: choke,choked
choose: choose,chose
chop: chop,chops
chow: chow
christ: christ
christen: christened
christian: christians
christmas: christmas
chuck: chuck,chucked,chucking
chuckle: chuckled
chum: chum,chummed,chumming,chums
chummy: chummy
church: church
chute: chute
chyack: chyack
cigar: cigar
circle: circle,circled,circling
circling: circling
city: cities,city
civil: civil
civilisation: civilisation
civilised: civilised
clack: clack
claim: claim,claims
clang: clang
clannish: clannish
clasp: clasp,clasping
clasped: clasped
class: class
classical: classical
clatter: clatter,clattering
clay: clay
clayey: clayey
clean: clean,cleaned,cleaning
cleanness: cleanness
clearing: clearing,clearings
clench: clenched
clerk: clerk
clever: cleverest
cliff: cliff
climate: climate
climax: climax
climb: climb,climbed,climbing
climbing: climbing
cling: clung
clique: cliques
clock: clock
clockwork: clockwork
close: close,closed,closer,closing
closed: closed
closely: closely
cloth: cloth,cloths
clothes: clothes
cloud: clouds
cloudless: cloudless
cloudy: cloudy
club: club
clump: clump
cluster: cluster,clustered
clutch: clutched,clutching
coach: coach,coaches
coal: coal,coals
coarse: coarse,coarser
coast: coast
coat: coat,coats
coax: coaxing
cob: cob
cock: cock
cockatoo: cockatoo,cockatoos
cocky: cocky
cod: cod
coffee: coffee
coffin: coffin,coffins
cold: cold
collar: collar,collars
collect: collecting
college: college
collins: collins
colonial: colonial
colony: colonies
colour: colour,coloured,colours
coloured: coloured
colt: colt
combination: combination
comfort: comfort,comforted,comforting
comfortable: comfortable
comfortably: comfortably
comic: comic
commemorate: commemorates
commence: commenced
comment: comment,commented,comments
commissioner: commissioner
commit: commit,committing
committee: committee
common: common
communism: communism
company: company
comparatively: comparatively
compare: compared
compass: compass
complain: complained
complete: complete
completely: completely
complexion: complexion
complexioned: complexioned
compliment: compliment
compose: composed
comprise: comprising
concentrate: concentrated
concept: concepts
concern: concerned
concerned: concerned
concertina: concertina
conclude: conclude,concluded
conclusion: conclusion
condition: condition
condole: condole
conduct: conduct,conducted
confidential: confidential
confidentially: confidentially
confinement: confinements
confused: confused
confusing: confusing
connect: connected
connection: connection
conscientious: conscientious
consequence: consequences
considerably: considerably
consideration: consideration
constable: constable
constitution: constitutions
construct: constructed
consult: consulted
consultation: consultation
contemplate: contemplated
contemporary: contemporary
contemptuously: contemptuously
content: content
contented: contented
contention: contention
contents: contents
continually: continually
continuation: continuation
continue: continue,continued
contract: contract,contracts
contractor: contractors
contrary: contrary
contrast: contrast
convenience: convenience
convenient: convenient
conversation: conversation
convict: convict
convince: convinced
convulsion: convulsions
convulsively: convulsively
cooee: cooeeing
cook: cook,cooked,cooking,cooks
cooking: cooking
cool: cool,cooled,cooler,coolest
cope: cope
cord: cords
cork: cork
corn: corn,corned
corned: corned
corner: corner,corners
cornstalk: cornstalk
corny: corny
corpse: corpse,corpses
correct: corrected
correspond: correspond
correspondence: correspondence
corroborate: corroborate
corrugated: corrugated
cost: cost
cottage: cottage,cottages
cotton: cotton
couch: couch
cough: cough,coughed,coughing
council: council
count: count,counting
counter: counter
country: country
countrywoman: countrywoman
county: county
couple: couple,couples
courage: courage
court: court,courted,courting
courting: courting
courtship: courtship
cousin: cousin
cove: cove
cover: cover,covered,covers
covering: covering
cow: cow,cows
coward: coward
cowardice: cowardice
crack: crack,cracked,cracks
cracker: crackers
cradle: cradle,cradled
crank: crank
cranky: cranky
crave: craved
craving: craving
craw: craw
crawl: crawled
crawler: crawler
creak: creak
credit: credit
creek: creek,creeks
creepy: creepy
crick: crick
crime: crime
crimean: crimean
criminal: criminal
crimson: crimson
crinoline: crinoline
crisis: crisis
critical: critical
criticise: criticised
croak: croaking,croaks
crocheted: crocheted
crockery: crockery
crooked: crooked
crop: crop,crops
cross: cross,crossed
crossing: crossing
crotchety: crotchety
crouch: crouched
crow: crows
crowd: crowd,crowded
crown: crown
cruel: cruel
cruelly: cruelly
crumple: crumpled
crush: crushing
crust: crust
cucumber: cucumber
cud: cud
cultivation: cultivation
cunning: cunning
cup: cup,cups
cur: cur
cure: cure,cured,cures
curiosity: curiosity
curious: curious
curl: curled
curly: curly
curse: cursed,curses
cursed: cursed
cursing: cursing
cushion: cushion,cushions
customer: customer,customers
cut: cut,cutting
cynical: cynical
da: da
dad: dad
daddy: daddy
dagger: daggers
dairy: dairy
dam: dam
damage: damaged
damn: damn
damnably: damnably
damned: damned
damp: damp
damper: damper
dance: dance,danced,dances,dancing
dancing: dancing
dandy: dandy
danger: danger
dangerous: dangerous
dangerously: dangerously
daniel: daniel
dar: dar
dark: dark,darker
darkly: darkly
darkness: darkness
darling: darling
darn: darned
dart: darted
dash: dashed,dashing
dashed: dashed
daughter: daughter
dave: dave
dawn: dawned
day: day,days
daybreak: daybreak
daylight: daylight
days: days
dazzle: dazzled
dead: dead
deadly: deadly
deadwood: deadwood
deaf: deaf
deal: deal
death: death
debt: debt
deceive: deceiving
december: december
decent: decent
decently: decently
decide: decided,deciding
decline: declined
decorate: decorated
deener: deener
deep: deep,deeper,deepest
deepen: deepened
deeply: deeply
definite: definite
deftly: deftly
deliberately: deliberately
delicacy: delicacies
delicate: delicate
delighted: delighted
deliver: delivered
demand: demanded
deny: denied
depart: depart,departed
depend: depend,depended,depends
depress: depress
depressingly: depressingly
depth: depth
depths: depths
dern: derned
derogatory: derogatory
descendant: descendants
descent: descent
description: descriptions
desert: desert,deserted,deserts
deserted: deserted
deserve: deserve,deserved
desk: desks
desolation: desolation
despair: despair
desperate: desperate
desperately: desperately
desperation: desperation
detach: detached
detect: detect,detected
detection: detection
deuce: deuce
develop: developed
devil: devil,devils
devoted: devoted
dew: dew
dick: dick
die: die,died,dies,dying
difference: difference,differences
difficulty: difficulty
dig: dig,digging,dug
digger: digger,diggers
digging: digging,diggings
dignity: dignity
dim: dim
dingo: dingo,dingoes
dingy: dingy
dining: dining
dinner: dinner,dinners
dint: dinted
dip: dip,dipped
diploma: diploma
dipper: dipper
direct: direct,directed
direction: direction,directions
dirt: dirt
dirty: dirty
disadvantage: disadvantage
disappear: disappeared
disappointed: disappointed
disc: disc
discontent: discontent
discover: discover,discovered
discoverer: discoverer
disease: disease,diseases
disembowelled: disembowelled
disgrace: disgrace
disguise: disguise
disgust: disgust,disgusted
disgusted: disgusted
dish: dish,dished,dishes
dishful: dishfuls
disillusion: disillusioned
disjointed: disjointed
dislike: dislike
dismal: dismal,dismals
dismember: dismembered
dismount: dismounted
dispense: dispensed
disreputable: disreputable
dissipate: dissipated
dissolve: dissolves
distance: distance
distant: distant
distort: distorted
distress: distress
district: district,districts
disturb: disturb
disturbance: disturbances
dive: dive,dived
diver: divers
doc: doc
doctor: doctor,doctors
dodge: dodged,dodges,dodging
dog: dog,dogs
dogcart: dogcart
doll: doll
dome: dome
donkey: donkey
door: door
doorway: doorway
double: double,doubled
doubt: doubt
doze: doze,dozing
dozen: dozen
dr: dr
draft: draft
drag: drag,dragged,dragging
drape: draped
draught: draught,draughts
draughty: draughty
draw: draw,drawing,drawn,drew
drawl: drawl,drawled
dray: dray,drays
dread: dread
dreadful: dreadful
dream: dream,dreamed,dreaming,dreams
dreamy: dreamy
drearily: drearily
dreary: dreary
dress: dress,dressed,dresses,dressing
dressed: dressed
dressing: dressing
dribble: dribbling
drift: drift,drifted,drifting
drill: drill
drink: drank,drink,drinking,drinks,drunk
drinking: drinking
drip: dripping
dripping: dripping
drive: drive,driven,drives,driving,drove
driver: driver
driving: driving
drone: droning
drop: drop,dropped,dropping,drops
dropping: droppings
drought: drought,droughts
drove: droving
drover: drover,drovers
droving: droving
drown: drown,drowned
drowsy: drowsy
drum: drum
drunk: drunk
drunkard: drunkard
drunken: drunken
dry: dried,drier,dry
du: du
duchy: duchy
duck: duck
dude: dude
duffer: duffers
dull: dull,dulled,dullest
dulness: dulness
dumb: dumb
dummy: dummies,dummy
dump: dumped
dumpling: dumpling,dumplings
duncan: duncan
dung: dung
dusk: dusk
dusky: dusky
dust: dust,dusted
dustbin: dustbin
dusty: dusty
duty: duty
dysentery: dysentery
eager: eager
eagerly: eagerly
eagerness: eagerness
eagle: eagle
ear: ear,ears
earshot: earshot
earth: earth
ease: ease,easing
easily: easily
eastern: eastern
easy: easier,easiest,easy
eat: ate,eat,eating,eats
eaves: eaves
eccentric: eccentric
eccentricity: eccentricities
echo: echo
edge: edge,edged,edges
edification: edification
edison: edison
editor: editor
educate: educated
education: education
egg: egg,eggs
eighteen: eighteen
el: el
elaborate: elaborate
elastic: elastic
elbow: elbow,elbows
eld: elder,eldest
elder: elder
electronically: electronically
elizabeth: elizabeth
elm: elms
embarrass: embarrassed
embarrassing: embarrassing
embrace: embraces
emma: emma
emotion: emotion
emotional: emotional
employ: employ
encourage: encourage,encouraged,encouraging
encouraging: encouraging
endless: endless
endurance: endurance
energetic: energetic
energy: energy
engage: engaged
england: england
english: english
englishman: englishman
englishwoman: englishwoman
enjoy: enjoy,enjoyed
enjoyable: enjoyable
enlighten: enlightened
enlightened: enlightened
enormous: enormous
enter: entered
entice: entice
equally: equally
ere: ere
error: errors
escape: escape,escaped
essential: essential
establishment: establishment
eternal: eternal
eternity: eternity
eve: eve
evening: evening,evenings
event: event
everlasting: everlasting
everlastingly: everlastingly
everyday: everyday
evidence: evidence
evident: evident
evidently: evidently
ewe: ewe,ewes
examination: examination
exasperate: exasperate
exasperatingly: exasperatingly
excellent: excellent
excellently: excellently
exception: exception
exchange: exchange
excitable: excitable
excited: excited
excitedly: excitedly
exclaim: exclaimed
excuse: excuse,excused
exertion: exertion
exist: exist
existence: existence
expand: expand
expect: expect,expected,expecting
expense: expense
experience: experience,experienced,experiences
experienced: experienced
experiment: experimenting
expert: expert
explain: explain,explained,explaining
explanation: explanation,explanations
explore: explore
explorer: explorers
explosion: explosion
expose: exposing
exposure: exposure
expression: expression
expressionless: expressionless
expressive: expressive
extra: extra
extraordinary: extraordinary
eye: eye,eyes
eyeball: eyeballs
eyebrow: eyebrows
eyed: eyed
faced: faced
facer: facer
fade: faded,fades,fading
fail: failed,failing
failure: failure,failures
faint: faint,fainted,fainting
fair: fair,fairer,fairest
fairies: fairies
fairy: fairies,fairy
faith: faith
faithful: faithful
falconer: falconer
fall: fall,fallen,falling,falls,fell
false: false
fame: fame
family: families,family
fan: fan
fancy: fancied,fancies,fancy
fanlike: fanlike
fare: fare
farewell: farewell
farm: farm,farming,farms
farmer: farmer,farmers
farming: farming
farth: farthest
fascinated: fascinated
fashion: fashion
fashioned: fashioned
fast: fast,faster
fasten: fastened
fat: fat
fate: fate
father: father,fathers
fatherly: fatherly
fathom: fathom
fault: fault
favour: favoured
favourite: favourite
fear: fear,feared
fearfully: fearfully
fearsome: fearsome
feast: feast
feather: feathers
feeble: feeble
feebly: feebly
feed: fed,feed,feeding
feeding: feeding
feel: feel,feeling,feels
feeling: feeling,feelings
feint: feint
feller: feller,fellers
fellow: fellow,fellows
female: female
fence: fence,fenced,fences
fencer: fencer,fencers
fencing: fencing
fermented: fermented
fetch: fetch,fetched
feud: feud
fever: fever
feverish: feverish
fibre: fibre
fiddle: fiddle
field: field,fields
fiend: fiend
fierce: fierce
fiercely: fiercely
fight: fight,fighting,fights,fought
fighting: fighting
figure: figure,figures
file: file
filly: filly
film: film
filth: filth
final: final
finally: finally
finding: finding
fine: fine,fined,finer,finest
finger: finger,fingering,fingers
finish: finish,finished,finishes
finn: finn
firelight: firelight
fireplace: fireplace
firewood: firewood
firework: fireworks
firing: firing
firm: firmer
firmly: firmly
fish: fish
fisher: fisher
fishing: fishing
fist: fist,fists
fit: fit,fitted
fiver: fiver
flake: flaked
flame: flame,flaming
flannel: flannels
flap: flap,flapped,flaps
flare: flare
flash: flash,flashed,flashes,flashing
flask: flask
flat: flat,flats
flax: flax
flea: flea
flesh: flesh
flick: flick
fling: fling,flinging,flung
float: float
flock: flock
flood: flood,floods
floor: floor,floored
flooring: flooring
flopping: flopping
flour: flour
floury: floury
flower: flower,flowers
flush: flushed
flutter: fluttered
fly: flew,fly,flying
fold: fold,folded
foller: foller
follow: follow
fond: fond
food: food
fool: fool,fools
foolish: foolish
foolishness: foolishness
foot: feet,foot
football: football
footed: footed
footnote: footnoted
footprint: footprints
footstep: footsteps
force: force,forces
forcibly: forcibly
fore: fore
forefinger: forefinger
forehead: forehead
foreign: foreign
forenoon: forenoon
forget: forget,forgot,forgotten
forgive: forgave
fork: fork,forks
form: formed
formidable: formidable
forsake: forsaken
fortnight: fortnight
fortune: fortune
fossick: fossicked,fossicking
fossicking: fossicking
foundation: foundations
fourteen: fourteen
fowl: fowls
fragment: fragments
frame: frame
franca: franca
frank: frank
freckle: freckles
freckled: freckled
fred: fred
freehold: freehold,freeholds
freely: freely
freight: freight
fresh: fresh,freshest
freshly: freshly
freshness: freshness
fret: fret,fretted
friend: friend,friends
friendly: friendly
fright: fright
frighten: frighten,frightened
frightened: frightened
frill: frill,frills
fro: fro
frock: frock,frocks
frog: frogs
frolic: frolic
frontage: frontage
frost: frost
frown: frowned
fruit: fruit
fry: fried,fry,frying
frying: frying
fume: fumes
fun: fun
funeral: funeral
funk: funk
funny: funny
fur: fur
furnish: furnished
furniture: furniture
furrow: furrow,furrows
furtive: furtive
fuse: fuse
fuss: fussed
future: future
gable: gable
gain: gain,gained
gal: gal,gals
gale: gale,gales
gallon: gallon
gallop: gallop,galloping
gallows: gallows
galvanise: galvanised
gamble: gamble,gambled,gambling
gambler: gambler
gambling: gambling
game: game,games
gang: gang
gap: gap
gape: gaping
garden: garden
gardener: gardener
gary: gary
gasp: gasp,gasped,gasping
gate: gate,gates
gateward: gatewards
gather: gather,gathered,gathering
gathering: gathering
gaunt: gaunt
generation: generations
generosity: generosity
generous: generous
gentle: gentle
gentleman: gentleman
gently: gently
george: george
geranium: geraniums
geraniums: geraniums
german: german,germans
germany: germany
gertrude: gertrude
gesture: gesture
getter: getters
ghastly: ghastly
ghost: ghost,ghosts
ghostly: ghostlier,ghostly
ghoul: ghoul
ghoulish: ghoulish
giant: giant
giddy: giddy
giggle: giggle
gim: gim
gin: gin
ginger: ginger
gingerly: gingerly
gipsy: gipsy
girl: girl,girls
girlhood: girlhood
girlie: girlie
girth: girth
git: git
glad: glad
glance: glance,glanced,glancing
glare: glare,glared
glaring: glaring
glass: glass,glasses
glide: gliding
glimpse: glimpse
glisten: glisten,glistened,glistening
glistening: glistening
gloat: gloat
gloom: gloom
gloomy: gloomy
glorious: glorious
glory: glory
glossary: glossary
glossy: glossy
glow: glows
glue: glue
gnarl: gnarled
god: god,gods
godfather: godfather
gold: gold
golden: golden
goldfield: goldfield,goldfields
goodness: goodness
goodwill: goodwill
gordon: gordon
gory: gory
govern: governed
government: government
governor: governor
grab: grab,grabbed,grabs
grace: grace
graceful: graceful
gradually: gradually
graft: graft
grain: grains
grand: grand
grandfather: grandfather
grandmother: grandmother
granite: granite
grant: grant,granted
grape: grape
grapple: grappled
grass: grass
grassy: grassy
grave: grave,graves
gravedigger: gravediggers
gravel: gravel
graveyard: graveyard
grease: greasing
greased: greased
greasy: greasy
greatly: greatly
green: green
greener: greener
greenhide: greenhide
greeting: greeting
grenadier: grenadier
grey: grey
grief: grief
grim: grim
grimly: grimly
grin: grin,grinned,grinning,grins
grind: grinding
grindstone: grindstone
grip: grip,gripped
grisly: grisly
grit: grit
groan: groaning,groans
grog: grog
groove: groove,grooved
grope: grope,groping
ground: ground
grow: grew,grow,growing,grown,grows
growl: growl,growled,growling
grown: grown
grub: grub,grubbing
grumble: grumble,grumbled
grumpy: grumpy
grunt: grunting
guard: guard
guess: guess,guessed
guffaw: guffaw,guffawed
guide: guide
gulch: gulch
gulf: gulf
gully: gullies,gully
gum: gum,gums
gums: gums
gun: gun
gunsmith: gunsmith
gush: gush
gusher: gusher
gust: gust,gusts
gutter: gutter
guttural: guttural
ha: ha
habit: habit
hack: hack,hacks
hag: hag,hags
haggard: haggard
haggish: haggish
hail: hail,hailed
hair: hair,hairs
haired: haired
hairy: hairy
ham: ham
hammer: hammer,hammering
hand: hand,handed,handing,hands
handcuff: handcuffed
handed: handed
handful: handful
handicap: handicap
handkerchief: handkerchief,handkerchiefs
handle: handle,handled,handles
handsome: handsome
handy: handiest,handy
hang: hang,hanged,hanging,hung
happen: happen,happened,happening
happily: happily
happiness: happiness
happy: happier,happiest,happy
harbour: harbour
hard: hard,harder,hardest
hardship: hardship,hardships
hardwood: hardwood
harm: harm
harness: harness,harnessed
harp: harp,harps
harrow: harrow
harry: harry
harsh: harsh
hastily: hastily
hat: hat,hats
hatch: hatch
hate: hate,hated
hatter: hatter
haul: hauled,hauling
haunt: haunt,haunted,haunts
haunted: haunted
hawk: hawk
hay: hay
haze: haze
hazel: hazel
head: head,headed,heads
headache: headache
headed: headed
heads: heads
heal: healed
health: health
healthier: healthier
healthy: healthy
heap: heap,heaped,heaps
hear: hear,heard,hearing,hears
hearing: hearing
heart: heart,hearts
hearted: hearted
heartedness: heartedness
hearty: hearty
heat: heat
heave: heaved
heaven: heaven,heavens
heavy: heaviest,heavy
heel: heel,heels
heft: heft
heifer: heifer,heifers
helpful: helpful
helpless: helpless
hemisphere: hemisphere
hen: hen,hens
henry: henry
herbage: herbage
herd: herd
hero: hero
hesitate: hesitate
hickory: hickory
hide: hidden,hide,hides,hiding
hiding: hiding
hill: hill,hilled,hills
hind: hind
hinder: hindered
hinge: hinged
hint: hint,hinting,hints
hip: hip
hiss: hissing
hit: hit,hitting
hitch: hitched,hitching
hitherto: hitherto
hoary: hoariest
hoe: hoe
hold: held,hold,holding,holds
hole: hole,holes
holiday: holiday,holidays
holland: holland
holler: holler
hollow: hollow,hollows
holt: holt
holy: holy
homestead: homestead
honest: honest
honey: honey
honour: honour
hood: hood
hoof: hoof,hoofs
hook: hook,hooked,hooks
hooked: hooked
hoop: hoop,hoops
hop: hopping
hope: hope,hoped,hopes
hopeless: hopeless
hopelessly: hopelessly
hopelessness: hopelessness
horizon: horizon
horizontally: horizontally
horn: horns
horned: horned
horrible: horrible
horribly: horribly
horror: horror,horrors
horse: horse,horses
horseback: horseback
horseman: horseman
horsemen: horsemen
horseshoe: horseshoe
horsey: horsey
hospital: hospital
host: host
hostess: hostess
hostler: hostler
hot: hot,hotter
hotel: hotel,hotels
hour: hour,hours
house: house,houses
housekeeping: housekeeping
housewife: housewife
housework: housework
hove: hove
howl: howl,howled,howling
huddle: huddle
huff: huff
hug: hug,hugged
huge: huge
hum: hum
human: human
humbug: humbugged
humorous: humorous
humour: humour
hump: humping
humpy: humpy
hundredweight: hundredweight
hunger: hunger
hungry: hungry
hunk: hunk
hunting: hunting
hurried: hurried
hurriedly: hurriedly
hurry: hurried,hurry
hurrying: hurrying
hurt: hurt,hurting,hurts
husband: husband,husbands
hush: hush,hushed
hustling: hustling
hut: hut,huts
hysteric: hysterics
hysterical: hysterical
hysterically: hysterically
idea: idea,ideas
identical: identical
idiot: idiot
idiotic: idiotic
idle: idle
ignorant: ignorant
iguana: iguana
iii: iii
illness: illness
illustrate: illustrated
illustrated: illustrated
illustration: illustrations
imaginary: imaginary
imagination: imagination,imaginations
immigrant: immigrant
impatient: impatient
impatiently: impatiently
impossible: impossible
impounding: impounding
impress: impressed
impressed: impressed
impression: impression
improbable: improbable
improve: improved
impulsive: impulsive
impulsiveness: impulsiveness
incapable: incapable
inch: inch,inches
incident: incident
incline: inclined
inclined: inclined
include: included,including
incoherent: incoherent
incomplete: incomplete
increase: increase,increased
independent: independent
indescribable: indescribable
indian: indian
indication: indications
indifferent: indifferent
indifferently: indifferently
individually: individually
inevitable: inevitable
infernal: infernal
influence: influence,influenced
inherit: inherited
injured: injured
injury: injuries
injustice: injustice
ink: inked
inn: inn
innocence: innocence
innocent: innocent
inquire: inquired,inquiring
inquiry: inquiries
insane: insane
insect: insects
insist: insist,insisted
inspiration: inspiration,inspirations
instance: instance
instinct: instinct
instinctively: instinctively
institution: institution
instruction: instructions
instrument: instruments
insult: insulted
intellect: intellect
intelligent: intelligent
intend: intended
inter: inter
internal: internal
interrogatory: interrogatory
interrupt: interrupted
interval: interval
interview: interview,interviews
introduce: introduced
invent: invent
invisible: invisible
inwards: inwards
ireland: ireland
irish: irish
irishman: irishman
iron: iron,ironed,irons
ironing: ironing
ironwork: ironwork
irrespective: irrespective
irritate: irritate
irritated: irritated
island: island
italian: italian
italicized: italicized
itch: itched
itching: itching
iv: iv
ivy: ivy
jack: jack
jackaroo: jackaroo
jackeroo: jackeroo
jacket: jacket,jackets
jackson: jackson
jail: jail
jam: jam,jammed,jams
james: james
january: january
jar: jar,jarred
jaw: jaw
jealousy: jealousy
jerk: jerk,jerked,jerking
jessie: jessie
jest: jest
jig: jig
jillaroo: jillaroo
jim: jim
jimmy: jimmy
job: job
jockey: jockey
joe: joe
jog: jogged,jogging
john: john
johnny: johnny
johnson: johnson
joint: joints
joke: joke,jokes
joker: joker,jokers
jolly: jolly
jolt: jolt,jolted,jolting
jones: jones
joneses: joneses
journal: journal,journals
journalism: journalism
joy: joy
joyful: joyful
joyously: joyously
judge: judge,judged
judgment: judgment
july: july
jump: jump,jumped,jumps
jumper: jumper
junction: junction
june: june
jury: jury
justice: justice
kangaroo: kangaroo,kangaroos
keen: keen
keeping: keeping
kep: kep
kerosene: kerosene
ketch: ketch
kettle: kettles
key: key
kick: kick,kicked,kicking
kicker: kicker
kid: kids
kill: kill,killed,killing,kills
kin: kin
kindness: kindness
king: king
kiss: kiss,kissed,kissing
kit: kit
kitchen: kitchen
kitten: kitten
knee: knee,knees
kneel: knelt
knickerbockers: knickerbockers
knife: knife,knives
knit: knit,knitted
knob: knob
knock: knock,knocked,knocking
knot: knot
knowledge: knowledge
labour: labour
lace: laces
lad: lads
ladder: ladder
lady: ladies
lake: lake,lakes
lam: lam
lamb: lamb
lambert: lambert
lament: lamented
lamp: lamp,lamps
lancashire: lancashire
lance: lance,lanced,lancing
land: land,landing,lands
landlady: landlady
landlord: landlord
landslip: landslip
language: language
languid: languid
lanky: lanky
lap: lap
lar: lars
lark: lark
larrikin: larrikins
lash: lashed,lashing
latch: latch
late: late
lather: lather,lathered
latitude: latitude
laugh: laugh,laughed,laughing
laundry: laundry
law: law
lawful: lawful
lawson: lawson
lay: laid,lay
layer: layer,layers
lazily: lazily
lazy: lazy
lead: lead,leading,leads,led
leaden: leaden
leader: leader
leadin: leadin
leaf: leaf,leaves
leafless: leafless
leak: leak,leaked,leaks
lean: lean,leaned,leaning,leant
leap: leaped
leapt: leapt
learn: learn,learned,learning,learns,learnt
lease: lease,leases
leather: leather
leave: leave,leaving,left
ledge: ledge,ledges
lee: lee
left: left,lefts
leg: leg,legs
legally: legally
legend: legend
legged: legged
leggings: leggings
leisurely: leisurely
lemonade: lemonade
lend: lend,lent
lengthen: lengthened
lengthy: lengthy
les: les
lesson: lesson,lessons
letter: letter,letters
level: level
liar: liar,liars
libel: libel
licence: licence
license: licensed
lid: lid
lie: lain,lie,lied,lies,lying
life: life,lives
lifetime: lifetime
lift: lift,lifted
light: light,lighted,lighter,lights,lit
lighting: lighting
lightly: lightly
lightning: lightning
limb: limbs
limbed: limbed
limit: limited
limp: limp,limped
lindsay: lindsay
linen: linen
lingo: lingo
link: link,links
lip: lips
lipped: lipped
liquid: liquid
liquor: liquor,liquors
list: listed
listen: listen,listened,listening
listening: listening
listless: listless
live: live,lived,living
lively: lively
liza: liza
lo: lo
load: load,loaded
loaded: loaded
loader: loader
loaf: loaf,loaves
local: local
locate: located
lock: lock,locked
locked: locked
lodging: lodging
lodgings: lodgings
log: log,logged,logs
lolly: lollies
london: london
lone: lone
loneliness: loneliness
lonely: lonelier,lonely
longing: longing
longish: longish
longway: longways
loom: loom,loomed,looming
loose: loose
loosely: loosely
lop: lopping
lord: lord
lorelei: lorelei
lose: lose,losing,lost
lot: lot,lots
lottery: lottery
loud: loud,louder,loudest
loudly: loudly
love: love,loved,loves
lovely: lovely
lucern: lucern
luck: luck
luckily: luckily
lucky: lucky
lug: lug
lumber: lumbering
luminous: luminous
lump: lump
lumpy: lumpy
lunacy: lunacy
lunatic: lunatic,lunatics
lung: lungs
lunge: lunge,lunged
lurch: lurched,lurching
lurid: lurid
luxury: luxuries
lying: lying
mac: mac
machine: machine
machinery: machinery
mad: mad
madden: maddened
madness: madness
maggie: maggie
magistrate: magistrate
mail: mail
main: main
maintain: maintain
maintenance: maintenance
maize: maize
major: major
majority: majority
maker: maker
makeshift: makeshift,makeshifts
manage: manage,managed,managing
manager: manager,managers
mane: mane
manfully: manfully
manifest: manifest
manner: manner
manners: manners
mantel: mantel
manually: manually
manuka: manuka
maori: maori
maoriland: maoriland
map: maps
march: march,marched
mare: mare
margaret: margaret
mark: mark,marked,marking,marks
market: market
married: married
marry: married,marry
marsh: marshes
marshy: marshy
marsupial: marsupials
marvel: marvels
mary: mary
maryland: maryland
masculine: masculine
mash: mash
master: master
match: match,matches
mate: mate,mates
mateship: mateship
matron: matron
matter: matter,mattered,matters
mattress: mattress,mattresses
maudlin: maudlin
meal: meal,meals
meaning: meaning
measles: measles
measure: measured,measures
meat: meat
mechanical: mechanical
mechanically: mechanically
medicine: medicine
meet: meet,met
meeting: meeting
melancholy: melancholy
melbourne: melbourne
melt: melted,melting
memory: memories,memory
mend: mend,mended,mending
mentally: mentally
mention: mention,mentioned
meow: meowed,meowing
mess: mess,messes
message: message,messages
method: method
middle: middle
midnight: midnight
midst: midst
mighty: mighty
mild: mild
mildly: mildly
mile: mile,miles
milk: milk,milking
milker: milker,milkers
mind: mind,minds
minded: minded
mining: mining
minute: minute,minutes
mischief: mischief
miser: miser
miserable: miserable
misery: misery
misjudge: misjudged
missing: missing
missus: missus
mistake: mistake,mistakes,mistook
mistaken: mistaken
mister: mister
mistress: mistress
mite: mite
mix: mixed
mixed: mixed
moan: moaned
mob: mob
model: model
modern: modern
modest: modest
moleskin: moleskin,moleskins
moment: moment,moments
monday: monday
money: money
mongrel: mongrel
monkey: monkey,monkeys
monotonous: monotonous
monotony: monotony
monroe: monroe
month: month,months
mooch: mooched,mooching
mood: moods
moody: moody
moon: moon
moonless: moonless
moonlight: moonlight
moonlit: moonlit
moral: moral
morally: morally
morning: morning,mornings
morrow: morrow
mother: mother,mothers
motion: motion
moulder: mouldering
mound: mound
mount: mount,mounted,mounts
mountain: mountain
mountains: mountains
mournfully: mournfully
moustache: moustache
mouth: mouth
mouthful: mouthful
movement: movement,movements
mow: mow
muck: muck
mud: mud
muddy: muddy,muddying
muffer: muffer
mulga: mulga
mullock: mullock
multitude: multitude
mum: mum
munch: munching
murder: murder,murdered
murderer: murderer
murmur: murmur
murphy: murphy
muscular: muscular
mushroom: mushroom
music: music
mustard: mustard
muster: muster,mustering
mutter: muttered,muttering
muttering: muttering
mutton: mutton
muzzle: muzzle
mysterious: mysterious
mystery: mysteries,mystery
mystic: mystic
nag: nagged,nagging
nagging: nagging
nail: nail,nailed,nails
naked: naked
napkin: napkins
nark: narked
narrow: narrow
nasal: nasal
nastiness: nastiness
nasty: nastiest,nasty
nation: nation
native: native,natives
natural: natural
nature: nature,natures
natured: natured
navvy: navvy
nearer: nearer
neath: neath
neatly: neatly
necessaries: necessaries
necessity: necessity
neck: neck
neckerchief: neckerchief
necktie: necktie
ned: ned
needle: needles
needlewoman: needlewoman
neighborhood: neighborhood
neighbour: neighbour,neighbours
neighbourhood: neighbourhood
neighbourly: neighbourly
nelson: nelson
nerve: nerve,nerves
nervously: nervously
nettle: nettle
newcomer: newcomer
newly: newly
newness: newness
news: news
newspaper: newspaper,newspapers
nibble: nibble
nice: nice
nicely: nicely
nick: nick,nicked
nickname: nicknamed,nicknames
nigger: nigger
night: night,nights
nip: nip,nipped
nipper: nipper
noble: noble
noise: noise
nonsense: nonsense
noon: noon
north: north
northern: northern
nose: nose,nosing
nosed: nosed
nosing: nosing
nostril: nostrils
note: note,notes
notice: notice,noticed,noticing
notion: notion,notions
novelty: novelty
nowadays: nowadays
nudge: nudged
nugget: nuggets
nuggety: nuggety
nuisance: nuisance
nurse: nurse,nursing
oak: oak,oaks
oath: oath
object: object,objected,objects
oblige: obliged,obliging
oblong: oblong
obstinacy: obstinacy
obstinate: obstinate
obstinately: obstinately
obvious: obvious
occasion: occasion,occasions
occurrence: occurrence
ocean: ocean
odd: odd
odds: odds
odour: odour
offend: offended
offended: offended
offensive: offensive
offer: offer,offered,offers
offhand: offhand
office: office
oftener: oftener
oil: oil,oiling
ole: ole
operation: operation
opinion: opinion
opportunity: opportunity
opposition: opposition
ordinary: ordinary
original: original
originally: originally
ornament: ornament,ornaments
orphan: orphan
ounce: ounce
outcasts: outcasts
outer: outer
outlaw: outlaw
outline: outline,outlined
outright: outright
outskirts: outskirts
oven: oven
overgrown: overgrown
overhear: overheard
overland: overland
overloaded: overloaded
overnight: overnight
oversentimental: oversentimental
overtake: overtook
owe: owed
owl: owl
owner: owner,owners
pace: pace
pack: pack,packed
packet: packet
packing: packing
pad: pad
paddle: paddle
paddock: paddock
padlock: padlocked
pain: pain,pains
painful: painful
painfully: painfully
painstaking: painstaking
paint: paint,painted,painting
painter: painter,painters
pair: pair,pairs
pale: pale
paling: paling
palm: palm,palms
palmy: palmy
paltriness: paltriness
paltry: paltry
pan: pan,panned,pans
pane: pane,panes
panel: panels
panful: panful
pannikin: pannikin
paper: paper,papers
parallel: parallel
parcel: parcel
parched: parched
pardon: pardon
parent: parent,parents
park: park
parlour: parlour
parson: parson
partition: partition,partitioned
partly: partly
partner: partners
partnership: partnership
party: parties,party
pass: pass,passed,passing
passage: passage
passenger: passenger,passengers
passing: passing
paste: pasted
pastoral: pastoral
pat: pat,patted
patch: patch,patched,patches,patching
patched: patched
patchwork: patchwork
patchy: patchy
pathetic: pathetic
patience: patience
patient: patient,patients
patron: patrons
pause: pause,paused
paw: paws
pay: paid,pay,paying
payable: payable
pea: pea
peace: peace
peacefully: peacefully
peak: peak
pebble: pebbles
peculiar: peculiar
peep: peep,peeped
peer: peered,peering
peered: peered
peg: peg,pegged,pegs
pen: pen,penning
penetration: penetration
penny: penny
peppermint: peppermint
perch: perched
perfect: perfected
perfectly: perfectly
perforated: perforated
perform: performing
periodical: periodical,periodicals
perish: perished,perishing
permanent: permanent
permanently: permanently
permutation: permutations
persecution: persecution
persist: persisted
person: people,person
persuade: persuade,persuaded
perusal: perusal
pest: pest
pet: pet
peter: peter,petering
petticoat: petticoat
pewter: pewter,pewters
phantom: phantom
phenomenal: phenomenal
phil: phil
phonograph: phonograph
photographer: photographer
phrase: phrases
physic: physicked
physically: physically
piccaninny: piccaninnies
pick: pick,picked,picking,picks
picture: picture,pictures
piece: piece,pieces
pierce: piercing
pig: pig,pigs
pigeon: pigeon
pigskin: pigskin
pile: piled,piles
pillar: pillar
pillow: pillow,pillows
pilot: pilot
pin: pin
pinafore: pinafore,pinafores
pinch: pinch
pine: pine,pines
pink: pink
pint: pint
pipe: pipe,pipes
pipeclay: pipeclay
pistol: pistol
pitch: pitch
pitchfork: pitchfork
pitiful: pitiful
pity: pitied,pity
placid: placid
plague: plague
plain: plain,plains
plainly: plainly
plan: plan
plant: plant
plate: plate,plates
platform: platform,platforms
play: play,played,playing,plays
player: player
plead: plead
pleasant: pleasant,pleasantest
pleased: pleased
pleasure: pleasure
plenty: plenty
plough: plough,ploughed,ploughing
pluck: pluck
plucky: plucky
plumb: plumb
plump: plump
plunge: plunge
pneumonia: pneumonia
pocket: pocket,pockets
poddy: poddies
poem: poem,poems
poet: poet,poets
poetic: poetic
poetry: poetry
poison: poison
poisoning: poisoning
poisonous: poisonous
poke: poke,poked,poking
pole: pole,poles
police: police
policeman: policeman,policemen
polish: polishing
polished: polished
politely: politely
politics: politics
pommel: pommel
pool: pool
poor: poor
popular: popular
port: port
portion: portion
portmanteaus: portmanteaus
portrait: portrait,portraits
pose: pose
position: position
possibility: possibility
possum: possum,possums
post: post,posted,posts
poster: poster
postpone: postponed
pot: pot,pots
potato: potato,potatoes
potatoes: potatoes
potted: potted
potter: pottering
pound: pound,pounds
pour: pour,pouring
poverty: poverty
powder: powder
power: power
practicable: practicable
practical: practical
practically: practically
practice: practice
practised: practised
practitioner: practitioner
prattle: prattle
prattling: prattling
pray: pray,prayed,praying
precious: precious
precocious: precocious
prefer: preferred
prefix: prefix
premise: premises
preparation: preparation,preparations
prepare: prepared,preparing
presence: presence
presently: presently
preserve: preserved
press: pressed
pressure: pressure
pretence: pretence
pretend: pretend,pretended,pretending
pretty: prettier,prettiest,pretty
prevent: prevent
price: price
prick: pricked
pride: pride
print: print,prints
prison: prison
private: private
privately: privately
privileged: privileged
prize: prizing
probable: probable
proceed: proceeded
process: process
procure: procuring
profession: professions
professional: professional
project: project,projected
promise: promise,promised,promising
prompt: prompt
pronounce: pronounced
prop: prop,propped,props
proper: proper
properly: properly
proportion: proportion
propose: proposed,proposing
prospect: prospected,prospecting
prospecting: prospecting
protection: protection
prove: prove,proved
provision: provisions
pub: pub,pubs
public: public
publican: publican,publicans
publication: publications
publish: published
pudding: pudding
puddle: puddled,puddles,puddling
puff: puff,puffed,puffs
pull: pull,pulled,pulling
pump: pump
pumpkin: pumpkins
punch: punch
pup: pup
pupil: pupils
pure: pure
purgatory: purgatory
purpose: purpose
purse: purse
push: pushed
puss: puss
puzzle: puzzle,puzzled
puzzled: puzzled
quack: quack
quaking: quaking
quality: quality
quantity: quantities
quarrel: quarrel,quarrelled,quarrels
quart: quarts
quarter: quarter,quarters
quartz: quartz
queen: queen
queer: queer
question: question,questions
quick: quick,quicker,quickest
quid: quid,quids
quiet: quiet,quieter
quieten: quietened
quietly: quietly
quietness: quietness
quilt: quilt
quote: quote
rabbit: rabbit
race: race,raced,races,racing
racecourse: racecourse
racehorse: racehorse
racer: racer
racing: racing
radius: radius
raffle: raffle
rafter: rafters
rag: rag,rags
rage: raging
ragged: ragged
rail: rail,rails
railroad: railroad
railway: railway,railways
rain: rain,rained,raining,rains
rainless: rainless
rainy: rainy
raise: raise,raised,raising
ram: ram,rammed
ramrod: ramrod
ranch: ranch
range: range,ranges,ranging
rank: rank
rapidly: rapidly
rate: rate,rates
ratepayer: ratepayer
ration: ration,rations
rattle: rattle
ratty: ratty
rave: raved,raving
raving: raving
reach: reach,reached
reaction: reaction
read: read,reading
reader: reader,readers
reading: reading
ready: ready
real: real
realise: realise
reality: reality
reap: reap
rear: rear,reared
rearing: rearing
reason: reason,reasoned
reasonable: reasonable
rebel: rebels
recall: recalled
receive: received
reception: reception
reckless: reckless
reckon: reckon,reckoned,reckons
reclaim: reclaimed
recognise: recognise,recognised
record: record
recover: recover,recovering
recovery: recovery
recross: recrossed
red: red,redder,reddest
reedy: reedy
reef: reef
refer: refer,referred,referring,refers
reference: reference,references
reflect: reflected
reflection: reflection
reflective: reflective
reflectively: reflectively
regard: regard,regarded
regret: regret
regular: regular
regularly: regularly
rein: rein,reins
reject: rejected
relation: relation,relations
relative: relatives
relaxed: relaxed
release: released
relic: relic,relics
relief: relief
relieve: relieved,relieves
relieved: relieved
religion: religion
religious: religious
reluctant: reluctant
remains: remains
remark: remark,remarked,remarks
remarkable: remarkable
remember: remember,remembered
remind: reminded
remittance: remittance
remnant: remnant
remove: removed
repair: repairing
repeat: repeated,repeating
reply: replied,reply
reprint: reprinted
reptile: reptiles
require: requires
rescue: rescue
resemble: resembled
resent: resented
reserve: reserves
residence: residence
resist: resist
respect: respect,respected
respectable: respectable
respectably: respectably
respects: respects
rest: rest,rested,resting
restaurant: restaurant
resting: resting
restless: restless
restlessly: restlessly
result: result
retail: retail
retainer: retainer
retort: retort,retorted
retouch: retouching
retrieve: retrieve,retrieved
retriever: retriever
return: return,returned
reverence: reverence
reverse: reverse,reversed
revisit: revisited
revolver: revolver,revolvers
rhyme: rhymes
ribbon: ribbon
rich: rich,richer,richest
rickety: rickety
rid: rid
ridden: ridden
ride: ridden,ride,rides,riding,rode
rider: rider,riders
riderless: riderless
riders: riders
ridge: ridge,ridges
ridiculous: ridiculous
riding: riding
rifle: rifle,rifled
rig: rig,rigged
rigid: rigid
rimmed: rimmed
rinse: rinsed
rip: ripped
ripe: ripe
ripple: rippling
rise: rise,risen,rising,rose
rising: rising
risk: risk
risky: risky
rival: rival
river: river,rivers
road: road,roads
roadside: roadside
roar: roar,roared,roaring
roaring: roaring
roast: roast,roasting
roasted: roasted
robert: robert
roberts: roberts
rock: rock,rocked,rocking
rocker: rockers
rocket: rocket
rocking: rocking
roll: roll,rolled,rolling
roman: roman
romance: romance
romantic: romantic
romany: romany
roof: roof,roofed,roofs
roomy: roomy
roost: roost
rooster: rooster
root: root,rooted,rooting,roots
rope: rope,roping
rose: rose,roses
rosy: rosy
rot: rot,rotted,rotting
rotten: rotten
rough: rough
roughly: roughly
rounded: rounded
rouse: roused
rouseabout: rouseabout
rousing: rousing
route: route,routes
routes: routes
rover: rover
row: row,rows
royal: royal
rub: rub,rubbed,rubbing
rubbish: rubbish
rude: rude
ruffle: ruffle
rug: rug,rugs
rugged: rugged
ruin: ruined
rule: rule
rum: rum
rump: rump,rumps
rumple: rumpling
runner: runners
rush: rush,rushed,rushes,rushing
rust: rust
sac: sac
sack: sack,sacked
sacrifice: sacrifice,sacrificed
sad: sad,saddest
saddle: saddle,saddled,saddles
saddler: saddler
safe: safe,safer
safely: safely
sag: sag
sail: sail
sailor: sailor
saint: saint
sake: sake
sale: sale
saliva: saliva
salmon: salmon
saloon: saloon
salt: salt,salts
salvation: salvation
sameness: sameness
sand: sand
sandwich: sandwiched,sandwiches
sandy: sandy
sane: sane,saner
sap: sap,sapped
saple: sapling
sapling: sapling,saplings
sarah: sarah
sarcastic: sarcastic
sardonically: sardonically
sash: sash
satisfaction: satisfaction
satisfactorily: satisfactorily
satisfied: satisfied
saturday: saturday
saucepan: saucepan,saucepans
saucer: saucer,saucers
sausage: sausage
savage: savage
save: save,saved,saving
sawmill: sawmill
sawney: sawney
sawny: sawny
scale: scales
scamp: scamp,scamps
scarce: scarce
scarcely: scarcely
scare: scare,scared
scared: scared
scarlet: scarlet
scene: scene
scenery: scenery
scent: scent,scented
scheme: schemes
school: school
schoolhouse: schoolhouse
schoolmaster: schoolmaster
schoolmate: schoolmates
schoolmistress: schoolmistress
schoolroom: schoolroom
scientific: scientific
scoff: scoff
scoop: scooped
scorch: scorching
score: scored,scores
scotsman: scotsman
scotty: scotty
scowl: scowled,scowling
scramble: scrambled
scrap: scraps
scrape: scraped,scraping
scratch: scratch,scratched,scratching
scream: scream,screamed,screaming,screams
screech: screech
screen: screen
screw: screwed,screwing
scrub: scrub,scrubbed,scrubs
scrubs: scrubs
scuffle: scuffling
scuttle: scuttled
sea: sea
seal: seal
search: search,searching
season: season,seasons
seat: seat,seated,seats
secret: secret
secretary: secretary
securely: securely
seed: seed
seek: seek,sought
seemingly: seemingly
seize: seizing
seldom: seldom
select: select,selected
selection: selection,selections
selector: selector,selectors
selfish: selfish
selfishness: selfishness
sell: sell,sells,sold
selling: selling
send: send,sending,sends
sense: sense
sensibly: sensibly
sensitive: sensitive
sentence: sentence
sentiment: sentiment
sentimental: sentimental
separate: separate,separated
september: september
series: series
servant: servant,servants
serve: serve,served
service: service
serviceable: serviceable
set: set,setting
settle: settle,settled
settled: settled
settlement: settlement
settler: settler,settlers
severe: severe
sew: sewed,sewn
sewing: sewing
sex: sex
sexton: sextons
shade: shade,shaded,shading
shadow: shadow,shadows
shady: shady
shaft: shaft,shafts
shake: shake,shaking,shook
shaky: shaky
shallow: shallow
sham: shamming
shame: shame
shank: shanks
shanty: shanties,shanty
shape: shape,shaped
shapeless: shapeless
share: shared
sharp: sharp
sharply: sharply
shave: shave,shaved
shaven: shaven
shaving: shaving
shawl: shawl
shear: shear,shearing,shorn
shearer: shearer,shearers
shearing: shearing
sheath: sheath
sheep: sheep
sheepish: sheepish
sheepishly: sheepishly
sheer: sheer
sheet: sheet,sheets
shelf: shelf
shelter: shelter
sheltered: sheltered
shelve: shelving
sheol: sheol
shepherd: shepherd,shepherds
shift: shift,shifted,shifts
shilling: shilling,shillings
shin: shin
shine: shining,shone
shingle: shingle,shingles
ship: ship
shirt: shirt,shirts
shirty: shirty
shiver: shivered
shock: shock
shod: shod
shoe: shoe
shoemaker: shoemaker
shoot: shoot,shot
shooting: shooting
shop: shop,shops
shore: shores
short: short,shortest
shorten: shortened
shortly: shortly
shot: shot
shoulder: shoulder,shouldered,shoulders
shout: shout,shouted,shouting
shove: shoved,shoving
shovel: shovel
shower: shower,showers
shred: shreds
shriek: shriek,shrieking
shrill: shrill
shrinkage: shrinkage
shrivel: shrivelled
shrivelled: shrivelled
shroud: shroud
shuddering: shuddering
shuffle: shuffled
shut: shut,shutting
shutter: shutters
shy: shied,shy
shylock: shylock
shyness: shyness
sich: sich
sick: sick
sickly: sickly
sickness: sickness
sided: sided
sideways: sideways
siding: siding,sidings
sidle: sidle,sidled,sidling
sieve: sieve
sigh: sigh,sighing
sight: sight
sighted: sighted
sign: sign,signing,signs
signal: signal,signals
silence: silence
silent: silent
silently: silently
silk: silk
sill: sills
silliness: silliness
silly: silliest,silly
simple: simple
simply: simply
simulate: simulated
sin: sin
sinew: sinews
sing: sang,sing,singing,sung
singe: singed
singing: singing
single: single
singly: singly
singular: singular
sinister: sinister
sink: sink,sinking,sunk
sinker: sinkers
sinking: sinking
sinner: sinner
sip: sip
sister: sister,sisters
sit: sat,sit,sitting
situate: situated
sixpenny: sixpenny
sizable: sizable
size: size
sketch: sketch,sketches
skillion: skillion
skim: skimmed
skin: skin,skinned
skip: skipped
skirt: skirt,skirted,skirts
skull: skull
sky: skies,sky
skyline: skyline
slab: slab,slabs
slack: slack
slacken: slackened
slant: slant,slanting
slap: slapped
slave: slave,slaves,slaving
sleep: sleep,sleeping,slept
sleepy: sleepy
sleeve: sleeves
slice: slice,sliced,slices
slide: sliding
slight: slightest
slim: slim
sling: slung
slip: slip,slipped
slipper: slippers
slit: slit
slither: slithering
slobber: slobbering
slobbering: slobbering
slope: slope,sloped,slopes,sloping
slouch: slouched
slow: slow
slowly: slowly
slumber: slumber
slush: slush
slut: slut
sly: sly
smart: smart
smartly: smartly
smash: smashed
smell: smell,smelt
smile: smile,smiled,smiling
smirk: smirk
smithereens: smithereens
smoke: smoke,smoked,smokes,smoking
smoking: smoking
smooth: smooth,smoothed
smother: smothered,smothering
smothering: smothering
smotheringly: smotheringly
smut: smut
snack: snack
snake: snake,snakes
snap: snap,snapped
snapped: snapped
snapper: snapper
snarl: snarled
snatch: snatched
sneak: sneak,sneaked,sneaking
sneer: sneer,sneered
sniff: sniff,sniffed
snooze: snooze
snore: snore
snort: snorted,snorting
snow: snow
soak: soak
sob: sob,sobbed,sobbing
sober: sober,sobered
sociable: sociable
society: society
sock: socks
socket: socket
sodden: sodden
sofa: sofa
soft: soft,softer
softly: softly
softness: softness
soil: soil
solder: soldered
solemn: solemn
solemnly: solemnly
solid: solid
soliloquise: soliloquising
solitary: solitary
solvent: solvent
son: son,sons
song: song
sonny: sonny
sooty: sooty
sorrow: sorrows
sorrowfully: sorrowfully
sort: sort,sorted,sorter,sorting,sorts
sorter: sorter
sough: sough
soul: soul
sound: sound,sounded,sounding,sounds
sour: sour
south: south
southern: southern
sovereign: sovereign
sow: sow,sown
space: space
spade: spade
spank: spank,spanked
spanking: spanking
spare: spare
sparkle: sparkling
sparkling: sparkling
sparring: sparring
speak: speak,speaking,speaks,spoke,spoken
special: special
specimen: specimen
speck: speck
speculate: speculating
speechless: speechless
spell: spell
spencer: spencer
spencers: spencers
spend: spend,spent
spicer: spicer
spicers: spicers
spidery: spidery
spieler: spielers
spike: spike,spikes
spiked: spiked
spill: spill,spilt
spin: spin
spindle: spindle
spirit: spirit,spirits
spiritless: spiritless
spirituous: spirituous
spit: spat,spit,spitting
spite: spite
splash: splashed,splashes,splashing
splendid: splendid
splice: spliced
splint: splints
split: split
splitting: splitting
splosh: splosh
splutter: spluttering
spluttering: spluttering
spoil: spoil,spoiling,spoilt
spoiler: spoilers
sponge: sponge
sport: sporting,sports
sporting: sporting
spot: spot
spotted: spotted
spout: spout,spouting
sprat: sprat
spread: spread,spreads
spree: spree,sprees
spring: sprang,spring,springs
sprout: sprouts
spruce: spruced
spud: spuds
spuds: spuds
spur: spur
square: square,squared
squat: squat
squatter: squatter,squatters
squawk: squawk,squawks
squeeze: squeeze,squeezed
squint: squinted,squinting
squire: squire
squirmy: squirmy
stab: stabbed
stable: stable
stablemen: stablemen
stabling: stabling
stack: stacked
staff: staff
stage: stage,stages
stagger: staggered
stain: stain,stained
stake: stakes
stammer: stammered
stamp: stamped
stand: stand,standing,stood
standard: standard,standards
standeth: standeth
standish: standish
star: stars
starch: starched
stare: stare,stared,staring
stark: stark
starlight: starlight
starlit: starlit
starry: starry
start: start,started,starting,starts
startle: startled
startled: startled
starve: starved,starving
statement: statements
station: station,stationed,stations
statue: statue
stave: staves
stay: stay,stayed,staying
steady: steady
steak: steak
steal: stealing,stole,stolen
stealing: stealing
steel: steel
steep: steep
steer: steer,steered,steers
stem: stem
step: step,stepped
stern: stern
sternly: sternly
stick: stick,sticking,sticks,stuck
stiff: stiff
stiffen: stiffened
stimulate: stimulated
sting: stung
stinging: stinging
stink: stinking
stir: stir,stirred,stirring
stirrup: stirrup
stitch: stitch
stock: stock
stocking: stocking
stockyard: stockyard
stolid: stolid
stomach: stomach
stone: stone,stones
stony: stony
stool: stool,stools
stoop: stoop,stooped,stooping
store: store,stores
storekeeper: storekeeper
storey: storey
story: stories,story
stout: stout
stove: stove
stow: stowed
straight: straight,straighter,straightest
straighten: straighten,straightened
strain: strain
strained: strained
strange: strange
stranger: stranger,strangers
strap: strapped,straps
strapping: strapping
straw: straw
stray: stray
streak: streak,streaks
stream: streams
street: street
strength: strength,strengths
stretch: stretch,stretched
stretcher: stretcher,stretchers
stricken: stricken
strict: strict
strictly: strictly
stride: stride
strike: strike,struck
striking: striking
string: string,strings,strung
stringy: stringy
strip: strip,stripped,strips
striped: striped
stroke: stroke,stroked,stroking
stroll: stroll
strong: strong,stronger,strongest
struggle: struggle,struggled,struggling
stubble: stubble
study: study
stuff: stuff,stuffed,stuffing
stumble: stumbled,stumbling
stumbling: stumbling
stump: stump,stumps
stumped: stumped
stumpy: stumpy
stun: stun
stunt: stunted
stupid: stupid
style: style
subject: subject
subscriber: subscriber
subsequent: subsequent
success: success
successful: successful
suck: suck,sucked
sudden: sudden
suddenly: suddenly
sue: sued
suffer: suffer,suffered,suffering,suffers
suffering: suffering
suffocate: suffocated
sugar: sugar
suggestion: suggestion
suggestive: suggestive
suicide: suicide
suit: suit,suited,suits
suitor: suitors
sulk: sulking,sulks
sulking: sulking
sulky: sulky
sullenly: sullenly
summer: summer,summers
summons: summons
sun: sun
sunday: sunday
sundowner: sundowner
sunlight: sunlight
sunny: sunny
sunrise: sunrise
sunset: sunset,sunsets
sunstroke: sunstroke
superintend: superintend,superintending
supernatural: supernatural
superstition: superstition
supper: supper
supply: supply
support: supported
suppose: suppose,supposed,supposing
surely: surely
surface: surface
surgical: surgical
surplus: surplus
surprise: surprise,surprised
surprised: surprised
surround: surrounded,surrounding
surveyor: surveyor,surveyors
survive: survived
suspect: suspected
suspicion: suspicion
suspicious: suspicious
suspiciously: suspiciously
sustained: sustained
swag: swag,swags
swagman: swagman
swallow: swallow,swallowed
swampy: swampy
swarm: swarm
swear: swear,swearing,swore,sworn
swearing: swearing
sweat: sweat,sweated,sweating
sweep: sweep,sweeps,swept
sweeping: sweeping
sweet: sweet,sweetest,sweets
sweetheart: sweetheart,sweethearts
swell: swell,swelled,swells
swelling: swelling
swelter: sweltering
swim: swim
swimming: swimming
swimmy: swimmy
swindle: swindle
swing: swing,swung
swinging: swinging
swish: swishing
switch: switching
swoop: swooped
sydney: sydney
sympathetic: sympathetic
sympathy: sympathy
symptom: symptoms
systematic: systematic
table: table
tablecloth: tablecloths
tack: tacked,tacking,tacks
tackle: tackle,tackled
tail: tail,tailed,tailing,tails
tailer: tailers
tailing: tailings
takin: takin
tale: tale
talk: talk,talked,talking
talking: talking
tall: tall,taller
tallow: tallow
tan: tan
tangle: tangles
tank: tank
tanner: tanner
tap: tap,tapped,tapping
tar: tar,tarred
target: target
tarnal: tarnal
tarpaulin: tarpaulin
tartar: tartar
taste: taste,tasted
tastefully: tastefully
tea: tea
teach: taught,teach,teaching
teacher: teacher
team: team,teams
teamster: teamster
tear: tear,tearing,tears,tore,torn
teeth: teeth
teethe: teething
teetotaller: teetotaller
telegraph: telegraph
telephone: telephoned
telescope: telescoped
telling: telling
temper: temper,tempered
temperament: temperament
tempered: tempered
temple: temples
temptation: temptation
tender: tender
tent: tent,tents
ter: ter
term: term,terms
terminus: terminus
terrible: terrible
terribly: terribly
terrified: terrified
terror: terror
thatch: thatch
theer: theer
theory: theories,theory
thereon: thereon
thickness: thicknesses
thieve: thieving
thievish: thievish
thinking: thinking
thirst: thirst
thirsty: thirsty
thirteen: thirteen
thoughtful: thoughtful
thoughtfully: thoughtfully
thrash: thrashing
thread: thread,threaded
threadbare: threadbare
threaten: threaten,threatened,threatening
thresh: thresh
thrill: thrill,thrilled
throat: throat
throb: throbbed
throw: threw,throw,thrown
thud: thud,thuds
thumb: thumb
thump: thump,thumps
thunder: thunder
thunderstorm: thunderstorm
tick: tick
ticklish: ticklish
tidily: tidily
tidy: tidied,tidy,tidying
tie: tie,tied
tight: tight,tighter
tightly: tightly
tilt: tilt,tilted
timber: timber,timbered,timbering
timbering: timbering
time: time,times
timid: timid
tin: tin,tinned,tins
tinge: tinged
tinker: tinkered
tinned: tinned
tiptoe: tiptoe
tired: tired
tobacco: tobacco
toddle: toddled
toe: toe,toes
toiling: toiling
tom: tom
tomahawk: tomahawk
tomboy: tomboy
tommy: tommy
ton: ton
tone: tone,tones
tong: tong
tongue: tongue,tongues
tony: tony
tool: tools
tooth: teeth,tooth
toothache: toothache
toothless: toothless
torn: torn
torture: tortured
toss: tossing
touch: touch,touched
tough: tough
tow: tow
towel: towel
town: town,towns
township: township
townsmen: townsmen
toy: toy,toys
trace: trace
track: track,tracked,tracks
tracker: trackers
tradesman: tradesmen
traditional: traditional
traffic: traffic
trail: trailed
train: train,trained
tram: tram
tramp: tramp,tramped,tramping
tramps: tramps
transcriber: transcriber
transparency: transparency
transport: transported
trap: trap,traps
travel: travel,travelling
travelling: travelling
tray: tray
treacle: treacle
tread: trod
treat: treated
tree: tree,trees
tremble: tremble,trembling
tremendous: tremendous
trespass: trespass
trespassing: trespassing
trestle: trestles
tribe: tribe
trick: trick,tricks
trigger: triggers
trim: trim
trip: trip,trips
triumph: triumph
trod: trod
trooper: trooper,troopers
trot: trotted,trotting
trotter: trotter
trouble: trouble,troubled,troubles
trouser: trouser
trousers: trousers
truck: truck,trucks
trudge: trudging
true: true
trunk: trunk,trunks
trust: trust,trusting
truth: truth
truthful: truthful
tub: tub,tubs
tuck: tuck,tucked
tucker: tucker
tuesday: tuesday
tuft: tuft,tufts
tumble: tumble,tumbled
tune: tune
tunnel: tunnel,tunnelled
turkish: turkish
turks: turks
tussock: tussock
twain: twain
twang: twang
tweed: tweed
twig: twig
twilight: twilight
twine: twine
twinkle: twinkled
twist: twist,twisted
twisted: twisted
twitching: twitching
type: type
tyre: tyres
ud: ud
ugly: ugly
umber: umber
unawares: unawares
unbearable: unbearable
unchanged: unchanged
uncle: uncle
uncomfortable: uncomfortable
uncomfortably: uncomfortably
unconscious: unconscious
unconsciously: unconsciously
undergrowth: undergrowth
understand: understand,understanding,understood
understood: understood
unearth: unearthed
uneasily: uneasily
uneasiness: uneasiness
uneasy: uneasy
uneven: uneven
unfair: unfair
unfinished: unfinished
unfortunate: unfortunate
ungreased: ungreased
ungroomed: ungroomed
unharness: unharness
united: united
universally: universally
university: university
unjust: unjust
unkindly: unkindly
unlicensed: unlicensed
unlock: unlocked
unlovely: unlovely
unlucky: unlucky
unnaturally: unnaturally
unnoticed: unnoticed
unoccupied: unoccupied
unpacked: unpacked
unpleasant: unpleasant
unreliable: unreliable
unroll: unrolled
unsociable: unsociable
unstrung: unstrung
unusual: unusual
unwind: unwound
upper: upper
upright: upright,uprights
upset: upset,upsets
upsetting: upsetting
upside: upside
upward: upward
urge: urged
urgently: urgently
usenet: usenet
uster: uster
usual: usual
utterance: utterances
vacantly: vacantly
vagabond: vagabonds
vague: vague
vain: vain
vainly: vainly
valley: valley
valuable: valuable
van: van,vans
vandyke: vandyked
vanish: vanish
vanity: vanity
variant: variant
variation: variations
varied: varied
varnish: varnish,varnishing
vegetable: vegetables
veil: veil
ventilate: ventilated
verandah: verandah,verandahs
verdict: verdict
versa: versa
verse: verses
verses: verses
vice: vice
vicinity: vicinity
vicious: vicious
victoria: victoria
victorian: victorian
view: view
vine: vine,vines
vinegar: vinegar
violently: violently
violin: violin
visible: visible
visit: visit,visited,visiting,visits
visitor: visitor,visitors
voice: voice,voiced,voices
voiced: voiced
voices: voices
volcanic: volcanic
volume: volume,volumes
volunteer: volunteered
voyage: voyage
vulgar: vulgar
wad: wad
wages: wages
waggle: waggled
waggon: waggon
waggonette: waggonette
waist: waist
waistband: waistband
waistcoat: waistcoat
wait: wait,waited,waiting
waiting: waiting
wake: wake,waking,woke
wales: wales
walk: walk,walked,walking
wall: wall,walls
wallaby: wallaby
wally: wally
walter: walter
wan: wan
wander: wander,wandered,wandering
wanderings: wanderings
wanter: wanter
war: war
wardrobe: wardrobe
warm: warm
warn: warn,warning
warning: warning
warrior: warrior
wash: wash,washed,washing
washerwoman: washerwoman
washing: washing
waste: waste,wasted,wastes,wasting
watch: watch,watched,watches,watching
watching: watching
watchmaker: watchmaker
watchmen: watchmen
water: water
watercourse: watercourse
waterloo: waterloo
waterproof: waterproof
wave: wave,waving
wax: wax
wayside: wayside
weak: weak
weaken: weakening
weakness: weakness
wealth: wealth
wear: wear,wearing,wore,worn
wearily: wearily
weariness: weariness
weary: weary
weather: weather,weathers
weatherboard: weatherboard
wedge: wedged,wedging
week: week,weeks
weigh: weigh,weighed,weighs
weight: weight
weird: weird
wellington: wellington
west: west
western: western
wet: wet
wether: wethers
wethers: wethers
wh: wh
whacker: whacker
whare: whare
wheat: wheat
wheaten: wheaten
wheel: wheel,wheeled,wheeling,wheels
whereat: whereat
whereof: whereof
whereon: whereon
whiff: whiff
whimper: whimpered,whimpering
whip: whip,whipped
whipcord: whipcord
whipper: whipper
whirl: whirling,whirls
whisker: whiskers
whiskered: whiskered
whisky: whisky
whisper: whisper,whispered,whispering
whispering: whispering
whistle: whistle,whistled
white: white
whiten: whiten
whitened: whitened
whites: whites
whoa: whoa
whoop: whooped
whoosh: whoosh
whopper: whopper
wid: wid
wide: wide
widow: widow
widower: widower
wife: wife,wives
wild: wild,wilder
wilder: wilder
wilderness: wilderness
wildly: wildly
william: william
willow: willows
wills: wills
wilson: wilson
win: win
wind: wind,wound
winded: winded
winder: winder
windlass: windlass,windlasses
windmill: windmills
window: window,windows
windy: windy
wine: wine
wink: winked,winking
winner: winner
winter: winter,winters
wire: wire,wired,wires
wiry: wiry
wise: wise
wit: wits
withdraw: withdrawn
witherly: witherly
witness: witness
wobble: wobble
woman: woman,women
womanish: womanish
womanly: womanly
wonderful: wonderful
wonderfully: wonderfully
wood: wood
wooden: wooden
wooing: wooing
wool: wool
word: word
workings: workings
worm: worms
worn: worn
worried: worried
worry: worried,worry,worrying
worrying: worrying
worship: worship
worth: worth
worthy: worthy
wound: wound
wrap: wrapped
wrapper: wrapper
wreck: wreck,wrecks
wrench: wrenched
wretched: wretched
wrinkle: wrinkled
wrist: wrist,wrists
write: write,writes,writing,written,wrote
writer: writer
writing: writing
wrong: wrong
yankee: yankee
yap: yapping
yard: yard,yards
yarn: yarn,yarned,yarning,yarns
yawn: yawn,yawned
yearly: yearly
yell: yell,yelled,yelling,yells
yellow: yellow
yelp: yelping
yelping: yelping
yer: yer
yesterday: yesterday
yield: yielded
yoke: yoke
youngster: youngster,youngsters
youth: youth
zealand: zealand
