aback: aback
abaft: abaft
abandon: abandon,abandoned
abasement: abasement
abate: abated,abating
abbey: abbey
abe: abed
abhor: abhorred
abide: abide
ability: ability
ablaze: ablaze
abnormal: abnormal
abnormally: abnormally
aboard: aboard
aboon: aboon
abraham: abraham
abreast: abreast
absence: absence
absent: absent
absolute: absolute
absolutely: absolutely
absolve: absolved
absorb: absorb,absorbed,absorbing
abstract: abstract
abut: abut
abyss: abyss
accentuate: accentuated
accept: accept,accepted,accepting,accepts
acceptance: acceptance
access: access,accessed
accessible: accessible
accident: accident,accidents
accidental: accidental
accomplish: accomplished
accord: accord
account: account,accounts
accumulation: accumulation
accuracy: accuracy
accurate: accurate
accurately: accurately
accurse: accursed
accuse: accused
accustom: accustomed
accustomed: accustomed
ache: aching
achieve: achieve,achieved
acknowledge: acknowledge
acquaint: acquainted
acquaintanceship: acquaintanceship
acquiesce: acquiesce,acquiesced
acquiescence: acquiescence
acquire: acquire,acquired,acquiring
acre: acres
acrid: acrid
action: action,actions
active: active
actual: actual
acumen: acumen
acute: acute
acutely: acutely
adamantine: adamantine
adapt: adapted
add: add,adding
addendum: addendum
addition: addition,additions
additional: additional
addle: addle
address: address,addressed,addresses,addressing
adduce: adduce,adduced
adelphi: adelphi
adequately: adequately
adhere: adhered
adjacent: adjacent
adjust: adjusted
admirable: admirable
admiralty: admiralty
admire: admire
admission: admission
admit: admit,admitted
adopt: adopt
adornment: adornments
advance: advance,advanced,advancing
advanced: advanced
advancement: advancement
advantage: advantage
adventure: adventure,adventures
adventurous: adventurous
advertise: advertise
advice: advice
advisable: advisable
advise: advise
afar: afar
afeard: afeard
afeared: afeared
affair: affair,affairs
affect: affect
affection: affection
affectionate: affectionate
afflict: afflict,afflicted
affliction: affliction
afford: afford,afforded,affording
affright: affright
affront: affront
afield: afield
afoot: afoot
afore: afore
afraid: afraid
afresh: afresh
africa: africa
aft: aft
afternoon: afternoon
agatha: agatha
age: age,ages
aged: aged
agency: agency
agent: agent,agents
agglomeration: agglomeration
aggressive: aggressive
aghast: aghast
agin: agin
agitated: agitated
agitation: agitation
aglow: aglow
agone: agone
agonise: agonised
agonised: agonised
agonising: agonising
agony: agony
agree: agree,agreed,agreeing
agreement: agreement
ague: ague
aha: aha
ahint: ahint
aid: aid,aided,aiding,aids
aim: aiming
ain: ain
air: air,airs
airt: airt
ajar: ajar
akin: akin
alacrity: alacrity
alarm: alarm,alarmed,alarming,alarms
alarmed: alarmed
alas: alas
alchemist: alchemist
alder: alder
alert: alert
alight: alight
alike: alike
alive: alive
allay: allay,allayed
allaying: allaying
alley: alley
alliance: alliance
allowable: allowable
allusion: allusion
ally: allied,allies
almanac: almanac
almighty: almighty
aloft: aloft
aloof: aloof
aloud: aloud
alphabetical: alphabetical
alter: alter
alteration: alteration
alternate: alternate
alternative: alternative
altogether: altogether
amalgamation: amalgamation
amateur: amateur
amaze: amaze,amazed
amazed: amazed
amazement: amazement
amen: amen
amenable: amenable
america: america
american: american
americanism: americanism
amsterdam: amsterdam
amuse: amuse,amused
amused: amused
analogy: analogy
analyse: analysed
analysis: analysis
anatomy: anatomy
anchor: anchor
ancient: ancient,ancients
andrew: andrew
anent: anent
anew: anew
angel: angel,angels
angelic: angelic
angels: angels
anger: anger
angle: angle
angrily: angrily
angry: angrier,angry
anguish: anguish
animal: animal,animals
animate: animate
animation: animation
annexation: annexation
annoying: annoying
annual: annual
answer: answer,answered,answering,answers
antagonism: antagonism
anticipation: anticipation
antidote: antidote
antique: antique
antwerp: antwerp
anxiety: anxiety
anxious: anxious
anxiously: anxiously
apathy: apathy
aperture: aperture
apiece: apiece
apologetic: apologetic
apologetically: apologetically
apologise: apologised
apology: apology
appal: appalled
appalled: appalled
appalling: appalling
apparent: apparent
appeal: appeal,appealing
appealing: appealing
appealingly: appealingly
appearance: appearance,appearances
appease: appeased
appetite: appetite,appetites
apple: apple
appliance: appliances
applicable: applicable
application: application
apply: applied,apply
appoint: appointed
appositeness: appositeness
appraise: appraise
appreciation: appreciation
appreciative: appreciative
apprehend: apprehend
apprehension: apprehension
apprentice: apprenticed
approach: approach,approached,approaches,approaching
approval: approval
approve: approve,approved,approving
april: april
apron: apron
apt: apt
aquiline: aquiline
arabian: arabian
arbitrary: arbitrary
arch: arched,arches
arched: arched
archibald: archibald
archimedes: archimedes
archipelago: archipelago
archive: archive
archway: archway
ardour: ardour
arf: arf
argue: argue,argued,argues,arguing
argument: argument,arguments
argumentative: argumentative
argumentativeness: argumentativeness
aright: aright
ark: ark
arlington: arlington
arm: arm,armed,arms
armament: armament,armaments
armed: armed
armour: armour
army: army
arouse: arouse,aroused
arrange: arrange,arranged,arranging
arrangement: arrangement,arrangements
array: array,arrayed
arrear: arrear
arrears: arrears
arrest: arrest,arrested
arrival: arrival
arrive: arrive,arrived,arrives,arriving
arrogate: arrogate
arrow: arrow
arsenal: arsenal
art: art
arter: arter
artfully: artfully
arthur: arthur
article: article
articulate: articulated
artificial: artificial
ascend: ascend,ascended,ascending
ascertain: ascertain,ascertained,ascertaining
ascii: ascii
ash: ash,ashes
ashamed: ashamed
ashen: ashen
ashy: ashy
asia: asia
asinine: asinine
asleep: asleep
aspect: aspect
aspen: aspen
assail: assail
assemblage: assemblage
assemble: assembled
assent: assent,assented
assert: assert,asserted,asserting
assertion: assertion
assiduously: assiduously
assign: assigned
assimilating: assimilating
assimilation: assimilation
assist: assist,assisted
assistance: assistance
assistant: assistant
assume: assume,assumed
assumption: assumption
assurance: assurance
assure: assure,assured,assures
astonish: astonished
astonished: astonished
astonishing: astonishing
astonishment: astonishment
astral: astral
astray: astray
asylum: asylum
athwart: athwart
atlas: atlas
atmosphere: atmosphere,atmospheres
atom: atoms
atonement: atonement
attach: attach,attached
attack: attack,attacked
attempt: attempt,attempted,attempting,attempts
attend: attend,attended,attending
attendant: attendant,attendants
attention: attention
attentively: attentively
attic: attic
attila: attila
attire: attire
attitude: attitude
attract: attract,attracted,attracting
attractive: attractive
attribute: attributed,attributes
attuned: attuned
auction: auction
auctioneer: auctioneer
aud: aud
audibly: audibly
auditor: auditors
aught: aught
august: august
aurora: aurora
auspices: auspices
austrian: austrian
authentic: authentic
author: author
authorisation: authorisation
authority: authorities,authority
authors: authors
autopsy: autopsy
autumn: autumn
avail: avail
avalanche: avalanches
avar: avar
avarice: avarice
ave: ave
avenge: avenged
avenue: avenue
average: average
avert: averted
avoid: avoid,avoided
await: await
awake: awake,awaked,awakes,awoke
awaken: awaken,awakened
aware: aware
awe: awe
awed: awed
awestruck: awestruck
awful: awful
awhile: awhile
awkward: awkward
awkwardly: awkwardly
axe: axe
ay: ay
babby: babby
baby: baby
bacca: bacca
background: background
backsheesh: backsheesh
bacon: bacon
bad: bad,worse,worst
bade: bade
badinage: badinage
badly: badly
baffle: baffle,baffled
bag: bag,bags
bagful: bagful
baggage: baggage
baggy: baggy
bah: bah
bairn: bairns
balance: balance,balanced
balcony: balcony
baleful: baleful
ballast: ballast
ballet: ballet
balm: balm
ban: bans
band: band,bands
bandage: bandage
baneful: baneful
banish: banished
bank: bank,banks
banker: bankers
banking: banking
banquet: banquet,banqueted
baptism: baptism
bar: bar,barred,bars
barbarian: barbarian
barbican: barbican
bare: bare,bared
barely: barely
bargaining: bargaining
barguest: barguests
bark: bark,barked,barking
barometrical: barometrical
barrel: barrel
barren: barren
base: base,based
basely: basely
basement: basement
basilisk: basilisk
basin: basin
basis: basis
basket: basket
bat: bat,bats
batch: batch,batches
bath: bath,bathed
bathe: bathe
batten: batten
battle: battle,battles
battlements: battlements
bauble: bauble
bay: bay
baying: baying
bea: bea
beach: beach
beacon: beacon
bead: beads
beaky: beaky
beam: beam,beamed,beams
bear: bear,bearing,bore,born,borne
bearable: bearable
beard: beard
bearer: bearer
bearing: bearing,bearings
beast: beast,beasts
beat: beat,beaten,beating,beats
beating: beating
beautiful: beautiful
beautifully: beautifully
beauty: beauties,beauty
beckon: beckoned
bed: bed,beds
bedroom: bedroom
bedside: bedside
bee: bee,bees
beech: beech
beef: beef
beer: beer
beetle: beetle
beetling: beetling
befall: befall,befallen
befool: befooling
befriend: befriend,befriended
beg: beg
beggar: beggar
begone: begone
begotten: begotten
behalf: behalf
behave: behave,behaved
behold: behold
bein: bein
belie: belied
belief: belief,beliefs
bell: bell,bells
bellow: bellow
belly: belly
belong: belong,belonging,belongs
belongings: belongings
beloved: beloved
belt: belt,belts
bench: bench
bend: bending,bent
bene: bene
beneath: beneath
beneficent: beneficent
beneficial: beneficial
benefit: benefited
benign: benign
benignly: benignly
bent: bent
berkeley: berkeley
berserker: berserker
beseech: beseech
beset: beset
bestow: bestow
bestrew: bestrewed
bethink: bethink,bethought
betray: betray,betrayed,betraying
beware: beware
bewilder: bewildered
bewildering: bewildering
bicyclist: bicyclists
bid: bade,bid,bidden
bidding: bidding
bier: bier
bigamist: bigamist
bilder: bilder
billow: billows
binary: binary
bind: binding,bound
binding: binding
birch: birch
bird: bird,birds
birth: birth
birthday: birthday
biscuit: biscuit
bishop: bishops
bit: bit,bits
bite: bite,biting,bitten
bitter: bitter
bitterly: bitterly
bitterness: bitterness
bizarre: bizarre
bl: blest
black: black,blackest
blackness: blackness
blacksmith: blacksmith
blade: blade
blame: blame,blamed
blandly: blandly
blank: blank
blanket: blanket
blast: blast,blasts
blaze: blaze,blazed,blazing
bleat: bleating
bleb: blebs
bleed: bled,bleed
bleeding: bleeding
bless: bless,blessed
blessed: blessed
blessing: blessing,blessings
blind: blind,blinded,blinding,blinds
blindfold: blindfold
blink: blinked
blissful: blissful
bloated: bloated
bloke: bloke
blood: blood
bloodedness: bloodedness
bloodless: bloodless
bloodstained: bloodstained
bloody: bloody
bloom: bloom
blossom: blossom,blossoms
blot: blot,blots,blotted
blotch: blotch
blow: blew,blow,blowing,blown,blows
blown: blown
blue: blue
bluff: bluff
blunt: blunt
blurt: blurted
blush: blush,blushes,blushing
board: board,boarded,boards
boast: boast
boat: boat,boats
boatman: boatman
bob: bobbing
body: bodies,body
bog: bog
bogle: bogles
boh: boh
boil: boiling
boiler: boiler
bold: bold,bolder
boldly: boldly
bolt: bolt,bolted,bolting,bolts
bond: bonds
bone: bone,bones
book: book,books
boom: boomed
booming: booming
boon: boon
boot: boot,boots
booze: booze
border: borders
bore: bore
borealis: borealis
borrow: borrowed
bosom: bosom
botany: botany
bother: bother,bothered
bottle: bottle,bottles
boudoir: boudoir
bough: bough,boughs
boulder: boulder,boulders
bound: bounded,bounds
bountiful: bountiful
bow: bow,bowed,bows
bowie: bowie
bowl: bowl
box: box,boxed,boxes
boxful: boxful
boy: boy,boys
boyar: boyar,boyars
brace: brace,braced,bracing
bracket: bracket
bradshaw: bradshaw
brain: brain,brains
bram: bram
branch: branch,branches
brandy: brandy
brass: brass
brave: brave,bravest
bravely: bravely
braver: braver
bravery: bravery
braw: braw
breach: breach
bread: bread
breadth: breadth
break: break,breaking,broke,broken
breakable: breakable
breakfast: breakfast,breakfasted
breaking: breaking
breast: breast,breasts
breath: breath
breathe: breathe,breathed,breathes,breathing
breathing: breathing
breathless: breathless
breathlessly: breathlessly
breed: bred,breed,breeding
breeze: breeze
brethren: brethren
bribery: bribery
bride: bride
bridge: bridge,bridges
brigand: brigands
bright: bright,brighter,brightest
brighten: brighten,brightened,brightening
brightly: brightly
brilliant: brilliant
brilliantly: brilliantly
bring: bring,bringing,brings,brought
briskly: briskly
bristle: bristles,bristling
british: british
broach: broaching
broad: broad
broaden: broaden,broadens
broads: broads
broke: broke
broken: broken
brood: brooding
brooding: brooding
brook: brook,brooked
brool: brool
brother: brother
brow: brow,brows
brown: brown,browns
bruise: bruised
brush: brush,brushed,brushing
brusquely: brusquely
brutally: brutally
brute: brute,brutes
bubble: bubbling
bucharest: bucharest
buckle: buckle,buckled
buda: buda
budget: budget
buffet: buffeting
build: build,built
builder: builder
building: building
bulgar: bulgar
bulge: bulging
bulky: bulky
bull: bulls
bullet: bullet
bully: bullies
bullying: bullying
bulwark: bulwark
bump: bumps
bunch: bunch
bundle: bundle
bunk: bunk
buoy: buoy
buoyancy: buoyancy
burden: burden,burdened
burdon: burdon
burger: burger
burglar: burglar
burglary: burglary
burial: burial
burly: burly
burn: burn,burned,burning,burnt
burning: burning
burst: burst,bursting,bursts
bury: buried,bury
bus: bus
bush: bush
bushy: bushy
business: business
businesslike: businesslike
bust: bust
bustle: bustled
bustling: bustling
busy: busy
butcher: butcher
butchery: butchery
butt: butt
butterfly: butterfly
buzz: buzz,buzzed,buzzing
bye: bye
bygone: bygone
byron: byron
byway: byway
cab: cab,cabs
cabin: cabin
cabman: cabman,cabmen
cackle: cackled
cage: cage,caged
cake: cake
calculate: calculate,calculated
calculation: calculations
calf: calf
callous: callous
calm: calm,calmed,calmer,calms
calmly: calmly
calmness: calmness
camera: camera
camp: camp
campaign: campaign
candle: candle,candles
candy: candy
canine: canine
canniness: canniness
canny: canny
canon: canon
canvas: canvas
cap: cap
cape: cape
capital: capital
capstan: capstan
captain: captain,captains
capture: capture
carafe: carafe
card: card
cardinal: cardinal
care: care,cared,cares
career: career
careful: careful
carefully: carefully
careless: careless
caress: caresses
carfax: carfax
cargo: cargo
caricaturist: caricaturists
carnal: carnal
carnival: carnival
carnivora: carnivora
carpathian: carpathian
carpenter: carpenter
carpet: carpet
carriage: carriage,carriages
carrier: carrier,carriers
carrion: carrion
carry: carried,carries,carry,carrying
cart: cart
carter: carter
cartload: cartload
carve: carved
carving: carving
casement: casement,casements
cash: cashed
casing: casing
casino: casino
cast: cast,casting
castle: castle,castles
casually: casually
casualty: casualties
cat: cat,cats
catalog: catalog
catch: catch,catching,caught
category: category
cathedral: cathedral
catherine: catherine
cattle: cattle
causa: causa
caution: caution,cautioned
cautiously: cautiously
cavern: caverns
caw: cawing
cease: cease,ceased,ceases
ceaselessly: ceaselessly
ceasing: ceasing
celebrate: celebrate
celerity: celerity
cell: cell
cellar: cellar
census: census
centaur: centaur
central: central
centre: centre,centred,centres
centred: centred
centrifugal: centrifugal
centripetal: centripetal
century: centuries,century
cerebral: cerebral
cerebration: cerebration
cerement: cerements
ceremony: ceremony
certainty: certainty
certificate: certificate
certify: certify
cessation: cessation
chafe: chafing
chaff: chaff
chagrin: chagrin
chain: chain,chained,chains
chair: chair,chairs
chamber: chamber,chambers
champ: champ,champed,champing
champion: championing
chance: chance,chances
change: change,changed,changing
channel: channel
chap: chap
chapel: chapel
chaplain: chaplain
chaplet: chaplet
chapter: chapter
char: charring
character: character
characteristic: characteristic,characteristics
charge: charge,charges
charing: charing
charitable: charitable
charity: charities
charm: charm
charming: charming
charter: charter
chase: chase,chasing
chasm: chasm
chat: chat,chatted,chatting
chatter: chattering
cheap: cheap
check: check,checked,checks
cheek: cheek,cheeks
cheer: cheer,cheered,cheering
cheerful: cheerful
cheerfully: cheerfully
cheerfulness: cheerfulness
cheerily: cheerily
cheerless: cheerless
cheery: cheery
cheese: cheese
chemical: chemical
cheque: cheque,cheques
cherry: cherry
chess: chess
chest: chest,chests
chew: chew
chick: chick
chicken: chicken
chief: chief,chiefest
chiefly: chiefly
child: child,children
childish: childish
chill: chill,chilling
chilled: chilled
chimney: chimney
chin: chin
china: china
chink: chink,chinks
chirp: chirping
chivalrous: chivalrous
chloral: chloral
choice: choice
choke: choke,choked,choking
choky: choky
choose: choose,chooses,choosing,chose,chosen
chop: chop
choppy: choppy
chord: chord
chorus: chorus
christian: christian
chronological: chronological
chuck: chuck,chucks
chunk: chunk
church: church
churchman: churchman
churchyard: churchyard
churn: churning
cicatrise: cicatrised
cigar: cigar,cigars
cigarette: cigarette
circle: circle,circled,circles,circling
circular: circular
circumstance: circumstance,circumstances
circus: circus
city: city
civilian: civilian
civility: civility
civilly: civilly
clad: clad
claim: claim,claimed,claims
clammy: clammy
clamp: clamps
clang: clang,clanged
clanging: clanging
clank: clanking
clap: clap
clarion: clarion
clasp: clasp
clasped: clasped
class: class,classes
classification: classification
classify: classify
clatter: clatter
claw: claw,clawed
clay: clay
clean: clean
cleanse: cleanse
cleave: cleave
cleft: cleft
clerk: clerk
clever: clever,cleverest
client: client,clients
cliff: cliff,cliffs
climb: climb,climbed,climbing
cling: cling,clinging,clung
cloak: cloak
clock: clock
clog: clog
close: close,closed,closer,closes,closing
closed: closed
closely: closely
closing: closing
clot: clot
cloth: cloth
clothe: clad
clothes: clothes
clothing: clothing
cloud: cloud,clouded,clouds
cloudiness: cloudiness
cloudy: cloudy
clue: clue,clues
clump: clump,clumps
clumsiness: clumsiness
clumsy: clumsy
clung: clung
cluster: cluster,clustered,clusters
clutch: clutch,clutched,clutching
coach: coach
coachman: coachman
coal: coal
coarse: coarse
coast: coast,coasting
coastguard: coastguard
coat: coat,coats
coax: coax
cobble: cobble
cock: cock
cockcrow: cockcrow
code: codes
coeval: coevals
coffee: coffee
coffin: coffin,coffins
coherent: coherent
coherently: coherently
coil: coils
coin: coin
coincidence: coincidence
cold: cold,colder
collapse: collapse
collar: collar
collate: collating
collection: collection
collision: collision
colony: colony
colossal: colossal
colour: colour,coloured,colours
coloured: coloured
column: column,columns
coma: coma
comatose: comatose
comb: comb
combination: combination,combinations
comedy: comedy
comer: comers
comfort: comfort,comforted,comforting,comforts
comfortable: comfortable
comfortably: comfortably
comforting: comforting
comic: comic
comically: comically
coming: coming
command: command,commanded,commanding,commands
commence: commence,commenced
comment: comment
commercial: commercial
commit: commit,committed
committee: committee
common: common
commonly: commonly
communicate: communicate
communication: communication
communicative: communicative
community: community
compact: compact
companion: companion,companions
companionship: companionship
company: company
comparative: comparative
comparatively: comparatively
compare: compare,compared,comparing
compass: compass
compel: compel,compelled,compels
compilation: compilation
complain: complained,complains
complaint: complaint
complete: complete,completed
completely: completely
completest: completest
completion: completion
complexion: complexion
compliance: compliance
complication: complications
compliment: compliment
comply: comply,complying
compose: composed
composed: composed
comprehend: comprehend
comprehensive: comprehensive
compress: compressed
compunction: compunction
conceal: conceal,concealed
concealment: concealment
conceivable: conceivable
conceive: conceive
concentrate: concentrated
concentrated: concentrated
concentration: concentration
concept: concept
concern: concern,concerned,concerns
concerned: concerned
concession: concession
conclude: concluded
conclusion: conclusion,conclusions
concrete: concrete
concussion: concussion
condemn: condemn
condescend: condescend
condition: condition,conditions
conduct: conduct
conductor: conductor
confer: confer
conference: conferences
confess: confess,confessed
confide: confide,confided
confidence: confidence
confident: confident
confidential: confidential
confidently: confidently
confine: confine,confined
confines: confines
confirm: confirmed
confirmation: confirmation
confuse: confuse
confused: confused
confusion: confusion
congeal: congealed
congenitally: congenitally
congress: congress
conjecture: conjecture
conjointly: conjointly
conjunction: conjunction
connect: connected
connected: connected
connection: connection
conquer: conquered
conquering: conquering
conqueror: conqueror
conquistadores: conquistadores
conscience: conscience
conscious: conscious
consciousness: consciousness
consensus: consensus
consent: consent,consented
consequence: consequence,consequences
consequent: consequent
consequential: consequential
considerable: considerable
considerably: considerably
considerate: considerate
consideration: considerations
consign: consigned
consignee: consignee
consigning: consigning
consignment: consignment,consignments
consolation: consolation
conspicuously: conspicuously
constant: constant
constantly: constantly
consternation: consternation
constitutional: constitutional
constrained: constrained
constraint: constraint
consul: consul
consulate: consulate
consult: consult,consulted,consulting
consultation: consultation
consume: consume,consumed,consuming
contact: contact
contemplate: contemplate
contemporary: contemporary
contempt: contempt
contemptuous: contemptuous
contend: contend
content: content
contented: contented
contents: contents
contingency: contingencies
contingent: contingent
continue: continue,continued
continuity: continuity
continuous: continuous
contortion: contortions
contract: contract,contracted
contradict: contradict
contrary: contrary
contrast: contrast,contrasted
contravention: contravention
contribution: contributions
control: control,controlled,controlling
convenient: convenient
conveniently: conveniently
conventional: conventional
converge: converge,converged,converging
conversation: conversation,conversations
convert: convert
convey: convey,conveyed,conveying
conveyance: conveyance
conviction: conviction
convince: convince,convinced
convulse: convulsed
convulsively: convulsively
cook: cook
cool: cool
cope: cope
copper: copper
copying: copying
copyright: copyright
copyrighted: copyrighted
coquetry: coquetry
coquettishly: coquettishly
cord: cord,cords
cordage: cordage
core: core
cork: corked
cormorant: cormorant
corn: corn
corner: corner,corners
coroner: coroner
corporation: corporation
corporeal: corporeal
corpse: corpse
correct: correct
correspondence: correspondence
correspondent: correspondent
corridor: corridor
corroborate: corroborated
corrupt: corrupt
corruption: corruption
cort: cort
cost: cost,costs
costly: costliest
cottage: cottages
couch: couch
cough: coughed
council: council
counsel: counsel,counsels
count: count,counting
countenance: countenance
counter: counter
counteractant: counteractant
countermand: countermand
countermine: countermining
counterpane: counterpane
countless: countless
country: countries,country
county: county
coup: coup
couple: couple
courage: courage
court: court
courteous: courteous
courteously: courteously
courtesy: courtesy
courtliness: courtliness
courtly: courtly
courtyard: courtyard
cover: cover,covered,covering,covers
coverlet: coverlet
cow: cow,cows
coward: coward,cowards
cower: cower,cowered,cowering
cozy: cozy
crack: crack,cracked,cracking,cracks
crackle: crackle
craft: craft
crag: crags
crane: craning
cranny: crannies,cranny
crash: crash,crashed,crashing
crave: crave
craving: craving
crawl: crawl,crawled
crazy: crazy
creak: creak,creaked,creaking
creaky: creaky
create: create,created,creating
creation: creation
creature: creature,creatures
credentials: credentials
credit: credit
creed: creed
creep: creep,creeping,crept
crescent: crescent
crest: crest,crested
crevice: crevices
crew: crew
cricketing: cricketing
crime: crime
criminal: criminal,criminals
crimson: crimson
cringe: cringing
cringing: cringing
crisis: crisis
crisp: crisp
critical: critical
critically: critically
criticism: criticism
crony: cronies
crooked: crooked
crop: crop
cross: cross,crossed,crosses,crossing
crossing: crossing
crouch: crouched
crow: crow,crows
crowd: crowd,crowded,crowding,crowds
crowded: crowded
crown: crown,crowned
crucifix: crucifix,crucifixes
cruel: cruel
cruelly: cruelly
cruelty: cruelty
crumb: crumbs
crumble: crumble,crumbled
crush: crush,crushed
crushable: crushable
crux: crux
crystal: crystal
cudgel: cudgelling
culverin: culverin
cum: cum
cumbrous: cumbrous
cumulative: cumulative
cunning: cunning
cup: cup
cupboard: cupboard
curate: curate,curates
curdle: curdling
cure: cure,cured,cures
curiosity: curiosity
curious: curious
curl: curl,curls
curly: curly
currency: currency
current: current,currents
curse: curse,cursed,curses
cursed: cursed
cursory: cursory
curtain: curtains
curtainless: curtainless
curve: curve,curves
curved: curved
custom: custom,customs
customary: customary
customs: customs
cut: cut,cuts,cutting
cutting: cuttings
cylinder: cylinder,cylinders
cypress: cypress
czarina: czarina
dad: dad
daffle: daffled
daily: daily
dainty: dainty
dam: dam
damage: damage
damaged: damaged
damages: damages
dame: dame
damn: damn
damned: damned
damp: damp
damply: damply
dance: dance,danced
danes: danes
danger: danger,dangers
dangerous: dangerous
dangerously: dangerously
dank: dank
danube: danube
daresay: daresay
daring: daring
dark: dark
darken: darken
darkly: darkly
darkness: darkness,darknesses
darling: darling
darts: darts
dash: dash,dashed,dashing
dashed: dashed
datum: data
daub: daubed
daughter: daughter
dawdle: dawdle
dawn: dawn,dawned
day: day,days
daylight: daylight
daytime: daytime
daze: daze,dazed
dazed: dazed
dazzle: dazzle
dead: dead
deadening: deadening
deadly: deadly
deal: deal,dealing,dealt
dealings: dealings
dearest: dearest
dearly: dearly
deary: deary
death: death
deathly: deathly
debased: debased
debauch: debauch
decanter: decanter
decay: decay
decease: decease
deceive: deceive,deceived
decent: decent
decently: decently
decide: decide,decided
decision: decision
deck: deck
declare: declared
decoction: decoction
decorum: decorum
decoy: decoyed
deductible: deductible
deed: deed,deeds
deem: deem,deemed
deep: deep,deeper,deepest
deepen: deepened
deeply: deeply
deer: deer
defame: defame
default: default
defeat: defeat
defect: defect,defects
defective: defective
deference: deference
defibrinate: defibrinate
deficiency: deficiencies
define: defined
definite: definite
deftly: deftly
defy: defy
degree: degree,degrees
deign: deign
deil: deil
deity: deity
delay: delay,delayed,delays
delegate: delegated
deletion: deletions
deliberate: deliberate
deliberately: deliberately
deliberation: deliberations
delicacy: delicacy
delicate: delicate
delicious: delicious
delight: delight
delighted: delighted
delightful: delightful
delirium: delirium
deliver: delivered
delivery: delivery
delusion: delusion
demand: demand
demeanour: demeanour
demeter: demeter
demon: demon,demons
demoniac: demoniac
demonstrative: demonstrative
demoralise: demoralise,demoralised
demur: demurred
demurely: demurely
den: den
denial: denial
dense: dense
dent: dents
deny: denied,deny
depart: depart,departed
department: department,departments
departure: departure
depend: depend,depended,depends
deplore: deplored
deposit: deposit,deposited
depressed: depressed
depression: depression
deprive: depriving
depth: depth
depths: depths
deputy: deputy
derby: derby
derelict: derelict
derivative: derivative
derive: derive,derived
derogatory: derogatory
descend: descend,descended,descending,descends
descendant: descendants
descent: descent
description: description,descriptions
descriptive: descriptive
desdemona: desdemona
desecrate: desecrate
desecration: desecration
desert: desert,deserted,deserts
deserted: deserted
deserve: deserve
design: design,designs
designate: designate
desire: desire,desired,desires
desolate: desolate
desolation: desolation
despair: despair
despairing: despairing
despairingly: despairingly
despatch: despatch,despatched
desperate: desperate
desperately: desperately
despicable: despicable
despise: despise,despises
despondently: despondently
destination: destination,destinations
destine: destined
destiny: destiny
destroy: destroy,destroyed,destroying
destruction: destruction
detach: detach
detain: detain,detained
detect: detect
detective: detective
determination: determination
determine: determine,determined
determined: determined
detrimentally: detrimentally
deux: deux
develop: developed
development: development
deviate: deviate
device: device
devil: devil,devils
devilish: devilish
devote: devoted
devoted: devoted
devotedly: devotedly
devotion: devotion
devour: devouring
devoutly: devoutly
dexterity: dexterity
diabolic: diabolic
diabolical: diabolical
diabolically: diabolically
diagnose: diagnosed
diagnosis: diagnosis
diagram: diagram
dialect: dialect
diamond: diamond
diary: diaries,diary
dictation: dictation
dictatorial: dictatorial
dictionary: dictionary
die: die,died,dies,dying
diet: diet
difference: difference
differentiate: differentiate
difficult: difficult
difficulty: difficulties,difficulty
diffuse: diffuse
dig: dig,dug
digital: digital
dignity: dignity
digression: digression
dilapidated: dilapidated
dilemma: dilemma
diligence: diligence
dim: dim
diminish: diminished
dimly: dimly
dimness: dimness
dine: dine,dined
dining: dining
dinner: dinner
dint: dint
diorama: diorama
dip: dip,dipped,dipping
dire: dire,direst
direct: direct,directed,directing
direction: direction,directions
directory: directory
dirty: dirty
disagree: disagrees
disagreeable: disagreeable
disappear: disappear,disappeared,disappearing,disappears
disappearance: disappearance
disappointed: disappointed
disappointment: disappointment
disarray: disarray
disastrous: disastrous
disbelief: disbelief
disbelieve: disbelieve
disc: disc
discharge: discharge,discharged
disclaim: disclaim
disclaimer: disclaimer,disclaimers
disclose: disclose
discolour: discoloured
disconcert: disconcert
discontent: discontent
discontinue: discontinue
discord: discord
discourse: discourse
discover: discover,discovered,discovering
discovery: discoveries,discovery
discreet: discreet
discreetly: discreetly
discretion: discretion
discuss: discuss,discussed,discussing
discussion: discussion
disdain: disdain
disease: disease,diseases
disfavour: disfavour
disgorge: disgorged
disguise: disguise,disguised
disgust: disgust,disgusted
disgusting: disgusting
dish: dish
dishevelled: dishevelled
dishonour: dishonour
dishonourable: dishonourable
disk: disk
dismay: dismay
dismiss: dismiss
disobey: disobeying
disorder: disorder
disordered: disordered
dispel: dispelled
dispirited: dispirited
display: display,displayed,displaying
displeased: displeased
disposal: disposal
disposition: disposition
disraeli: disraeli
dissatisfied: dissatisfied
dissipate: dissipated
dissociate: dissociated
dissolution: dissolution
dissolve: dissolved
distance: distance
distant: distant
distil: distils
distinct: distinct
distinction: distinction,distinctions
distinctly: distinctly
distinguish: distinguish
distort: distort,distorted
distorted: distorted
distract: distract,distracted
distraction: distraction
distress: distress,distressed
distressed: distressed
distressing: distressing
distribute: distribute,distributed,distributing
distribution: distribution
distributor: distributor
district: district
distrust: distrust
distrustful: distrustful
disturb: disturb,disturbed,disturbs
disturbance: disturbance
disturbing: disturbing
disuse: disuse
dive: dive
diver: diver
divert: divert
divide: divided,dividing
divination: divination
division: division
dizzy: dizzy
doctor: doctor,doctors
doctrine: doctrine
document: document,documents
doer: doer
dog: dog,dogs
dogged: dogged
doggedly: doggedly
doings: doings
domain: domain
domed: domed
dominance: dominance
dominant: dominant
domine: domine
donate: donate
donation: donation,donations
donkey: donkey
donor: donors
doom: doom,doomed
door: door,doors
doorway: doorway
dos: dos
dose: dose
dot: dots
double: double,doubled
doubly: doubly
doubt: doubt,doubted,doubting,doubts
doubting: doubting
doubtless: doubtless
dough: dough
dove: dove
dover: dover
downcast: downcast
downhill: downhill
download: downloading
downstairs: downstairs
downward: downward
doze: doze,dozed,dozing
dozen: dozen
drag: drag,dragged
drain: drain,drained,draining
draught: draught
draw: draw,drawing,drawn,draws,drew
drawbridge: drawbridge
drawer: drawer,drawers
drawing: drawing
dray: dray
dread: dread,dreaded,dreads
dreaded: dreaded
dreadful: dreadful
dreadfully: dreadfully
dream: dream,dreamed,dreaming,dreams,dreamt
dreamily: dreamily
dreaminess: dreaminess
dreamless: dreamless
dreamy: dreamy
dreary: dreary
drench: drenched
dress: dress,dressed,dresses,dressing
dressing: dressing
drift: drift,drifted,drifting
drink: drink,drunk
drinking: drinking
drip: drip,dripping
drive: drive,driven,drives,driving,drove
driver: driver
droop: drooped
drooping: drooping
drop: drop,dropped,dropping,drops
drouth: drouth
drown: drowned,drowning
drowse: drowse
drug: drug,drugged,drugs
drunk: drunk
dry: dried,dry
dual: dual
duck: duck
dull: dull,dulling
duly: duly
dun: dun
dunlap: dunlap
duplicate: duplicate,duplicates
durability: durability
durham: durham
dusk: dusk
dust: dust
dustiness: dustiness
dusty: dusty
dutchman: dutchman,dutchmen
dutiful: dutiful
duty: duties,duty
dwell: dwell
dweller: dwellers
dynasty: dynasties
ead: ead
eager: eager
eagerly: eagerly
eagerness: eagerness
eagle: eagle
ear: ear,ears
eared: eared
earn: earn
earnest: earnest
earnestly: earnestly
earnestness: earnestness
earth: earth,earths
earthly: earthly
earthquake: earthquake
earthy: earthy
ease: ease,eased
easily: easily
easiness: easiness
east: east
eastern: eastern
eastward: eastward
easy: easier,easiest,easy
eat: ate,eat,eaten,eating,eats
eater: eater
eating: eating
ebb: ebb
eccentricity: eccentricities
echo: echo,echoed,echoes
economy: economy
ecstasy: ecstasy
eddy: eddies
edge: edge,edges
edition: edition,editions
educate: educated
educational: educational
edward: edward
effacing: effacing
effective: effective
effort: effort,efforts
egg: egg
egoism: egoism
egoist: egoist
egotist: egotist
egotistical: egotistical
ejaculation: ejaculation
elaborate: elaborate
elapse: elapsed
elbow: elbow,elbows
elderly: elderly
elect: elect
electric: electric
electrical: electrical
electricity: electricity
electronic: electronic
electronically: electronically
element: element,elements
elemental: elemental
elementary: elementary
elenchus: elenchi
elephant: elephant
eleventh: eleventh
eliminate: eliminated
ell: ell
ellen: ellen
elliot: elliot
elm: elms
eloquent: eloquent
elude: elude
emaciated: emaciated
email: email
emanate: emanate
embark: embarked
embarrass: embarrass
embarrassed: embarrassed
embarrassment: embarrassment
emblem: emblem
embodiment: embodiment
embolden: emboldened
embrace: embrace,embracing
embrasure: embrasure
embryo: embryo
emerald: emerald
emerge: emerge,emerged
emergency: emergency
eminence: eminence
eminently: eminently
emma: emma
emotion: emotion,emotions
emotional: emotional
emphasise: emphasised
emphatic: emphatic
empiric: empiric
empirically: empirically
employ: employed
employee: employee,employees
employer: employer,employers
employment: employment
empower: empowered
emptiness: emptiness
en: en
enable: enabled,enables
encamp: encamped
enclose: enclose,enclosed
enclosure: enclosure
encompass: encompassed
encounter: encounter,encountered
encourage: encourage,encouraged,encourages
encouragement: encouragement
encrust: encrusted
endeavour: endeavour
endless: endless
endlessly: endlessly
endorse: endorse,endorsed
endorsement: endorsement
endurance: endurance
endure: endure,endured,enduring
enemy: enemies,enemy
energetically: energetically
energy: energies,energy
eneuch: eneuch
enforcement: enforcement
engage: engage,engaged
engaged: engaged
engender: engendered
engine: engine,engines
england: england
english: english
englishman: englishman
engross: engrossed
engulf: engulf
enhance: enhancing
enigmatical: enigmatical
enigmatically: enigmatically
enjoy: enjoy,enjoyed,enjoying,enjoys
enjoyment: enjoyment
enlargement: enlargement
enlighten: enlighten
enlightened: enlightened
enliven: enlivened
enoch: enoch
enormous: enormous
enrich: enriched
ensure: ensure,ensuring
entail: entailed
entente: entente
enter: enter,entered,entering
enterprise: enterprise
entertainment: entertainment
enthrall: enthrall
enthusiasm: enthusiasm
enthusiastically: enthusiastically
entire: entire
entitle: entitled
entity: entity
entrance: entrance,entrances
entreat: entreat
entreaty: entreaty
entrust: entrusted
entry: entries,entry
envelop: enveloped,enveloping
envelope: envelope,envelopes
environment: environment
episode: episode
equal: equal
equality: equality
equally: equally
equilibrium: equilibrium
equip: equipped
equipment: equipment
ere: ere
erect: erected
err: err,erred
errand: errand
errant: errant
error: error,errors
escapade: escapade
escape: escape,escaped,escaping
especial: especial
essay: essay
essence: essence
establishment: establishment
estate: estate
esteem: esteem
estimate: estimate
eternal: eternal
eternity: eternity
etiquette: etiquette
etymology: etymology
europe: europe
european: european
euthanasia: euthanasia
eve: eve
evening: evening,evenings
event: events
eventually: eventually
everlasting: everlasting
evidence: evidence,evidences
evident: evident
evidently: evidently
evil: evil,evils
evolution: evolution
exact: exact
exacting: exacting
exactness: exactness
exalt: exalted
examination: examination
examine: examine,examined,examines,examining
exceed: exceeded,exceeding
excellent: excellent
excellently: excellently
exception: exception
exceptional: exceptional
excess: excess
excessive: excessive
exchange: exchange
excitable: excitable
excite: excite
excited: excited
excitement: excitement
exciting: exciting
exclamation: exclamation
exclusion: exclusion,exclusions
exclusive: exclusive
excuse: excuse,excused,excuses,excusing
executor: executors
exempt: exempt
exercise: exercise,exercised
exert: exerted
exertion: exertion,exertions
exhale: exhale,exhaled
exhaust: exhausted
exhausted: exhausted
exhaustion: exhaustion
exhibit: exhibit
exigency: exigency
exist: exist,existing,exists
existence: existence
existent: existent
exit: exit
exodus: exodus
expanse: expanse
expect: expect,expected,expecting
expectation: expectation,expectations
expedition: expedition
expel: expelled
expend: expend
expense: expense,expenses
experience: experience,experienced,experiences,experiencing
experienced: experienced
experiment: experiment,experimenting,experiments
experimental: experimental
experimentally: experimentally
explain: explain,explained,explaining
explanation: explanation
explicit: explicit
explore: explore,explored
exploring: exploring
export: exporting
expose: expose,exposed
expostulate: expostulate
exposure: exposure
express: express,expressed
expression: expression,expressions
expressive: expressive
exquisite: exquisite
exquisitely: exquisitely
extend: extend,extending
extent: extent
external: external
extra: extra
extraordinary: extraordinary
extravagant: extravagant
extreme: extreme
extremely: extremely
exult: exulted
exultantly: exultantly
exultation: exultation
eye: eye,eyes
eyebrow: eyebrows
eyed: eyed
eyelash: eyelashes
eyelid: eyelids
eyesight: eyesight
fable: fable
fabric: fabrics
fabulous: fabulous
faced: faced
facility: facility
facto: facto
factor: factor
faculty: faculties,faculty
fad: fads
fade: fade,faded,fading
fail: fail,failed,fails
failure: failure
fain: fain
faint: faint,fainted,fainter,fainting
fainting: fainting
faintly: faintly
fair: fair
faith: faith
faithful: faithful
faithfully: faithfully
fakir: fakir
fall: fall,fallen,falling,falls,fell
false: false
falter: falter,faltered
familiar: familiar
family: family
famine: famine
famish: famished
fancy: fancied,fancies,fancy
fangled: fangled
farewell: farewell
farley: farley
farmer: farmers
farmhouse: farmhouse,farmhouses
farth: farthest
fascinating: fascinating
fascination: fascination
fash: fash
fashion: fashion,fashioned,fashions
fashionable: fashionable
fashioned: fashioned
fast: fast,faster
fasten: fasten,fastened,fastening
fastening: fastening
fasting: fasting
fastness: fastnesses
fat: fat,fatted
fatal: fatal
fatality: fatalities
fate: fate
fateful: fateful
father: father
fatherland: fatherland
fathom: fathom
fatigue: fatigues
fatten: fatten
faugh: faugh
fault: fault,faults
favour: favour,favoured,favouring
favourable: favourable
favourite: favourite
fawn: fawned
fear: fear,feared,fearing,fears
fearful: fearful
fearfully: fearfully
fearless: fearless
feather: feathers
feature: feature,features
federal: federal
fee: fee,fees
feeble: feeble
feebly: feebly
feed: fed,feed,feeding
feel: feel,feeling,feels
feeling: feeling,feelings
feller: feller
fellow: fellow,fellows
ferrier: ferrier
fervour: fervour
fetch: fetch
fever: fever
feverish: feverish
fez: fez
fiction: fiction
field: field,fields
fiend: fiend,fiends
fierce: fierce,fiercer
fiercely: fiercely
fierceness: fierceness
fight: fight,fighting,fights,fought
fighting: fighting
figure: figure,figures
file: file,filed,files
film: film
filthy: filthy
final: final
finality: finality
finally: finally
finance: finance
financial: financial
fine: fine
finger: finger,fingers
finis: finis
finish: finish,finished,finishing
finite: finite
finland: finland
fir: firs
firefly: fireflies
firelight: firelight
fireplace: fireplace
firewood: firewood
firm: firm
firmly: firmly
firstly: firstly
fish: fish,fishes,fishing
fisherman: fisherman,fishermen
fishing: fishing
fissure: fissures
fit: fit,fits,fitted,fitter,fitting
fitfully: fitfully
fitness: fitness
fixed: fixed
fixedly: fixedly
flag: flag,flagged,flagging,flags
flagboat: flagboat
flake: flakes
flame: flame,flamed,flames
flange: flange
flannel: flannels
flap: flap,flapping
flare: flared
flash: flash,flashed,flashing
flask: flask
flat: flat,flats,flatter
flattering: flattering
flee: fled
fleet: fleet
fleeting: fleeting
flesh: flesh
fletcher: fletcher
flick: flick
flicker: flicker,flickered,flickering
flinch: flinch
fling: fling,flung
flirt: flirt
flit: flit,flitted
float: float,floating
flock: flocked
flog: flogging
flood: flood,flooded,floods
flooding: flooding
floor: floor
flour: flour
flourish: flourish
flow: flow,flowing,flows
flower: flower,flowers
fluffy: fluffy
flurry: flurries
flush: flush,flushed
flutter: fluttering
fly: flew,flies,flown,fly,flying
foam: foam
focus: focus,focussing
foe: foes
fog: fog,fogs
foil: foiled
fold: fold,folded,folding,folds
foliage: foliage
folk: folk,folks
follow: follow
follower: followers
folly: folly
fond: fond
fondly: fondly
food: food
fool: fool,fooled,fools
foolhardiness: foolhardiness
foolish: foolish
foot: feet,foot
footstep: footsteps
forbid: forbade,forbid,forbidden,forbids
force: force,forced,forces,forcing
forceful: forceful
forcemeat: forcemeat
forcibly: forcibly
fore: fore
forego: forego
forehead: forehead,foreheads
foreign: foreign
foreigner: foreigner,foreigners
foreknowledge: foreknowledge
foreland: foreland
foreman: foreman
foremost: foremost
forenoon: forenoon
foresee: foresee
foresight: foresight
forest: forest,forests
forestall: forestall,forestalling
foretell: foretold
forethought: forethought
forget: forget,forgetting,forgot,forgotten
forgetful: forgetful
forgetfulness: forgetfulness
forgive: forgive,forgiven
fork: forked
form: form,formed,forming,forms
formal: formal
formality: formalities
formally: formally
format: format,formats
forthwith: forthwith
fortify: fortified
fortitude: fortitude
fortunately: fortunately
fortune: fortune
forwards: forwards
foul: foul,fouled,fouler
foulness: foulness
foundation: foundation
fountain: fountain
fourth: fourth
fox: fox
fra: frae
fracture: fracture
fragment: fragments
frame: frame
framework: framework
france: france
frank: frank
frankly: frankly
frantic: frantic
frantically: frantically
fray: frayed
freedom: freedom
freely: freely
freeze: froze
freight: freight
french: french
frenchman: frenchmen
frenzied: frenzied
frequent: frequent,frequented
frequently: frequently
fresco: fresco
fresh: fresh,fresher
freshen: freshen
freshly: freshly
fret: fret,frets,fretted,fretting
friday: friday
friend: friend,friends
friendly: friendly
friendship: friendship,friendships
fright: fright
frighten: frighten,frightened,frightens
frightened: frightened
frightful: frightful
frisk: frisked
fro: fro
frock: frock
frontier: frontier,frontiers
frown: frown,frowning
fruit: fruit
frustrate: frustrate
fulcrum: fulcrum
fulfil: fulfilled
fulfilment: fulfilment
fumble: fumbled,fumbling
fume: fume
fun: fun
functional: functional
funeral: funeral
funereal: funereal
funny: funny
fur: fur,furs
furious: furious
furiously: furiously
furnace: furnace
furnish: furnished
furniture: furniture
furtherer: furtherer
furtively: furtively
fury: fury
furze: furze
fuse: fused
fust: fust
future: future
gable: gable
gabriel: gabriel
gaiety: gaiety
gaily: gaily
gain: gain,gained,gaining
gal: gals
gala: gala
gale: gale
gallant: gallant
gallery: galleries
galley: galley
gallop: gallop,galloping
gambolling: gambolling
game: game
gang: gang
gangrene: gangrene
gaol: gaol
gap: gap,gaps
garb: garb
garden: garden
gardens: gardens
garland: garlanded
garlic: garlic
garment: garment,garments
garth: garth
gas: gas,gases
gash: gash
gaslight: gaslight
gasp: gasp,gasped,gasping,gasps
gate: gate,gates
gatekeeper: gatekeeper
gateway: gateway
gather: gather,gathered,gathering,gathers
gathering: gathering
gaunt: gaunt
gawm: gawm
gay: gay
gaze: gazed,gazing
gazette: gazette
gear: gear
generate: generated
generation: generations
genial: genial
geniality: geniality
genially: genially
gent: gent,gents
gentle: gentle
gentleman: gentleman,gentlemen
gentleness: gentleness
gently: gently
genuine: genuine
genuinely: genuinely
geography: geography
geologic: geologic
geology: geology
geordie: geordie
george: george
german: german
germany: germany
gesture: gesture
ghastly: ghastly
ghost: ghost,ghosts
ghostly: ghostly
giant: giant
gibraltar: gibraltar
gift: gift,gifted,gifts
gin: gin
gipsy: gipsies,gipsy
girl: girl,girls
git: git
giveth: giveth
glad: glad,gladder
gladden: gladdened
gladly: gladly
gladness: gladness
gladsome: gladsome
glance: glance,glanced,glances
glare: glare,glared
glass: glass,glasses
glassiness: glassiness
glassy: glassy
gleam: gleam,gleamed,gleaming,gleams
glean: glean
glee: glee
glimmer: glimmer
glimpse: glimpse
glint: glinted
glisten: glistened
glitter: glitter,glittering
gloat: gloated,gloating
globe: globe
gloom: gloom
gloomy: gloomy
glorious: glorious
glory: glories,glory
glove: gloves
glow: glow,glowed
gnarl: gnarled
gnaw: gnawing
goal: goals
god: god
gog: gog
goitre: goitre
gold: gold
golden: golden
goodly: goodly
goodness: goodness
gorge: gorge,gorged,gorges
gossip: gossiping,gossips
gout: gout,gouts
govern: govern
government: government
gown: gown
grab: grab,grabbed
grace: grace
graceful: graceful
gracefulness: gracefulness
gradually: gradually
grain: grains
grammar: grammar
grand: grand
grandeur: grandeur
grandfather: grandfather
grandly: grandly
granite: granite
grano: grano
grant: grant,granted
grapple: grapple
grasp: grasp,grasped,grasping
grass: grass
grassy: grassy
grate: grating
grateful: grateful
gratefully: gratefully
gratitude: gratitude
grave: grave,graves
gravedigger: gravediggers
gravel: gravel
gravely: gravely
graveyard: graveyard
gravity: gravity
greatly: greatly
gree: grees
greece: greece
greek: greek,greeks
green: green,greens
greenish: greenish
greenland: greenland
greet: greet,greeted
greeting: greeting
grey: grey
greyness: greyness
grief: grief
grieve: grieve,grieved
grievously: grievously
grim: grim,grimmer
grimace: grimaced
grimly: grimly
grin: grin,grinning
grind: grinding,ground
grip: grip,gripped
grisly: grisly
grit: grit
groan: groan,groaned,groaning
grog: grog
groom: grooms
groove: groove
grope: groping
gross: gross
grotesque: grotesque
ground: ground
groundless: groundless
grounds: grounds
grow: grew,grow,growing,grown,grows
growl: growl,growling,growls
growth: growth,growths
grubby: grubby
gruesome: gruesome
grumble: grumble
grumpy: grumpy
guarantee: guarantee
guard: guard,guarded,guarding,guards
guardian: guardian
guess: guess,guessed,guesses
guest: guest
guidance: guidance
guide: guide,guided,guiding
guilt: guilt
gulf: gulf
gulp: gulped
gum: gums
gun: gun,guns
gunwale: gunwale
gurgle: gurgling
gush: gushed
gusto: gusto
gypsy: gypsies,gypsy
ha: ha
habit: habit
habitable: habitable
habitation: habitation
haggard: haggard
hail: hail,hailed
hair: hair,hairs
hairbreadth: hairbreadth
haired: haired
hall: hall
hallucination: hallucination
halt: halt,halted
hamburg: hamburg
hamlet: hamlet
hammer: hammer,hammered,hammering
hand: hand,handed,handing,hands
handful: handful
handkerchief: handkerchief
handle: handle,handled,handles
handshake: handshake
handsome: handsome
handspike: handspike
handy: handy
hang: hang,hanging,hangs,hung
hanging: hangings
hans: hans
hansom: hansom
hap: hap,happed
happen: happen,happened,happening
happily: happily
happiness: happiness
happy: happier,happiest,happy
harbour: harbour
hard: hard,harder
harden: hardened,hardening
hardy: hardy
hark: hark,harked
harm: harm,harmed,harming
harmless: harmless
harmony: harmony
harness: harness,harnessed
harris: harris
harrowing: harrowing
harsh: harsh
harshly: harshly
harshness: harshness
hart: hart
harvest: harvest
haste: haste
hasten: hasten,hastened,hastening
hasty: hasty
hat: hat,hats
hatchway: hatchway,hatchways
hate: hate,hated
hateful: hateful
haughty: haughty
haunt: haunted,haunts
haunting: haunting
havoc: havoc
hawkins: hawkins
hawser: hawser
hay: hay
hazard: hazard
hazardous: hazardous
head: head,headed,heads
headache: headache
headland: headland
headline: headlines
headlong: headlong
headpiece: headpiece
headstone: headstones
headstrong: headstrong
heal: heal,healed
healing: healing
health: health,healths
healthy: healthy
heap: heap
hear: hear,heard,hearing,hears
hearing: hearing
heart: heart,hearts
hearted: hearted
hearth: hearth
heartily: heartily
heartless: heartless
hearty: hearty
heat: heat,heated
heath: heath
heave: heave,heaved
heaven: heaven,heavens
heavens: heavens
heavily: heavily
heaviness: heaviness
heaving: heaving
heavy: heavier,heavy
hebrew: hebrew
hedge: hedged
heed: heed
heel: heel
height: height,heights
heir: heir
hellish: hellish
helm: helm
helper: helper,helpers
helpful: helpful
helpless: helpless
helplessly: helplessly
helplessness: helplessness
hem: hemmed
henceforth: henceforth
henceforward: henceforward
heraldic: heraldic
herb: herb
heredity: heredity
heresy: heresy
herewith: herewith
hero: hero
heroic: heroic
herr: herr
hesitancy: hesitancy
hesitate: hesitate,hesitated
hesitatingly: hesitatingly
hesitation: hesitation
hetman: hetman
hidden: hidden
hide: hidden,hide,hiding
hideous: hideous
hiding: hiding
hieroglyphical: hieroglyphical
hill: hill,hills
hillside: hillsides
hilt: hilt
hinder: hinder
hindrance: hindrance
hinge: hinges
hint: hint,hints
hire: hired
hiss: hiss,hissing
hisself: hisself
historical: historical
history: history
hit: hit
hitch: hitch
hitching: hitching
hitherto: hitherto
ho: ho
hoarse: hoarse
hoarsely: hoarsely
hoast: hoast
hobble: hobbled
hobby: hobby
hobnail: hobnails
hold: held,hold,holding,holds
holder: holder
hole: hole,holes
holiday: holiday
holily: holily
holland: holland
hollow: hollow
holy: holiest,holy
homeward: homeward
homicidal: homicidal
honest: honest
honestly: honestly
honesty: honesty
honey: honey
honour: honour,honoured
honourable: honourable
hood: hood
hoodwink: hoodwink
hoof: hoofs
hope: hope,hoped,hopes,hoping
hopeful: hopeful
hopeless: hopeless
hopelessly: hopelessly
horde: hordes
horizon: horizon
horn: horn,horns
horrible: horrible
horribly: horribly
horrid: horrid
horrified: horrified
horrify: horrify
horror: horror,horrors
horse: horse,horses
horseman: horsemen
horseshoe: horseshoe
hospitable: hospitable
hospital: hospital
hospitality: hospitality
host: host
hostile: hostile
hostility: hostility
hot: hot
hotch: hotch
hotel: hotel
hotly: hotly
hour: hour,hours
hourly: hourly
house: house,houses
housebreaker: housebreaker
household: household,households
housekeeper: housekeeper
housekeeping: housekeeping
hout: hout
howl: howl,howled,howling
hue: hue
hug: hug
huge: huge
hull: hull
hum: humming
human: human,humans
humanising: humanising
humanitarian: humanitarian
humanity: humanity
humble: humble
humbly: humbly
humorous: humorous
humour: humour
humoured: humoured
hump: hump
hun: hun
hungarian: hungarian
hungary: hungary
hunger: hunger
hungry: hungry
huns: huns
hunt: hunt,hunted
hunter: hunter,hunters
hunting: hunting
hup: hup
hurl: hurled
hurried: hurried
hurriedly: hurriedly
hurry: hurried,hurry,hurrying
hurt: hurt,hurting
husband: husband
husbandman: husbandman
husbandry: husbandry
hush: hush
huskily: huskily
hyde: hyde
hyena: hyenas
hypnotic: hypnotic
hypnotise: hypnotise,hypnotised
hypnotism: hypnotism
hypodermic: hypodermic
hysteric: hysterics
hysterical: hysterical
ice: ice
iceland: iceland
icelander: icelander
icy: icy
idea: idea,ideas
identification: identification
identify: identified,identify
idiotic: idiotic
idle: idle
idly: idly
idolatrous: idolatrous
ignorance: ignorance
ignorant: ignorant
iii: iii
illness: illness
illumine: illumine
illusion: illusion
illustrate: illustrate
image: image
imaginable: imaginable
imagination: imagination
imaginative: imaginative
imagine: imagine,imagined,imagining
imagining: imaginings
imitate: imitate
imitation: imitation
immanuel: immanuel
immeasurable: immeasurable
immense: immense
immensely: immensely
immortal: immortal
immortality: immortality
impalpable: impalpable
impartiality: impartiality
impassiveness: impassiveness
impatient: impatient
impatiently: impatiently
imperative: imperative
imperceptible: imperceptible
imperfect: imperfect
imperfectly: imperfectly
imperious: imperious
imperturbable: imperturbable
impetuosity: impetuosity
implacable: implacable
implication: implication
implicitly: implicitly
implore: implore,implored,imploring
imploringly: imploringly
imply: implied,imply
import: import,imported
importunate: importunate
impose: impose,imposed
impossibility: impossibilities,impossibility
impossible: impossible
impotent: impotent
impregnable: impregnable
impress: impress
impressed: impressed
impression: impression
impressiveness: impressiveness
impressment: impressment
imprison: imprisoned
improper: improper
improve: improve,improved,improves,improving
impulse: impulse
impulsively: impulsively
inaccessible: inaccessible
inaccurate: inaccurate
inch: inch,inches
incident: incident,incidents
incidental: incidental
incision: incision
incite: inciting
inclination: inclination
incline: incline,inclined
inclined: inclined
inclining: inclining
include: include,included,includes,including
including: including
incoherent: incoherent
incomer: incomer
incoming: incoming
incomplete: incomplete
incorporated: incorporated
increase: increase,increased,increasing
incredible: incredible
incur: incurred,incurring
indefinitely: indefinitely
indemnify: indemnify
indemnity: indemnity
india: india
indian: indian
indicative: indicative
indifferent: indifferent
indignation: indignation
indirect: indirect
indirectly: indirectly
individual: individual,individuals
individually: individually
indomitable: indomitable
indrawn: indrawn
induce: induce
indulgence: indulgence
ineffably: ineffably
inequality: inequalities,inequality
inert: inert
inexpressible: inexpressible
infallibly: infallibly
infamy: infamy
infect: infect,infected
infer: infer
inference: inference
infinite: infinite
infinitely: infinitely
infinitesimal: infinitesimal
inflict: inflict,inflicts
influence: influence,influences
inform: informed
informant: informant
infringement: infringement
ingress: ingress
inhabit: inhabit
inheritor: inheritors
injection: injection
injunction: injunctions
injure: injure,injured
injured: injured
injury: injuries,injury
ink: ink
inky: inky
inland: inland
inmate: inmate,inmates
inn: inn
inquest: inquest
inquietude: inquietude
inquire: inquire
inquiry: inquiries,inquiry
inquisition: inquisition
inquisitive: inquisitive
inrushing: inrushing
insane: insane
insanity: insanity
inscribe: inscribe
insensibility: insensibility
insensibly: insensibly
insensitive: insensitive
insert: inserted
insist: insist,insisted,insists
insolent: insolent
inspect: inspect
inspector: inspector
inspiration: inspiration
inspire: inspired
install: installed
instance: instance,instances
instant: instant
instantly: instantly
instigation: instigation
instinct: instinct,instincts
instinctive: instinctive
instinctively: instinctively
instruct: instructed
instruction: instruction,instructions
instrument: instruments
insurance: insurance
intact: intact
intellect: intellect
intellectual: intellectual
intelligence: intelligence
intelligent: intelligent
intelligible: intelligible
intend: intend,intended,intending,intends
intense: intense
intensify: intensified
intensity: intensity
intent: intent,intents
intention: intention,intentions
intently: intently
intercede: intercede
interfere: interfere
interference: interference
interminable: interminable
internal: internal
international: international
interpret: interpreted,interpreting
interrogatively: interrogatively
interrupt: interrupt,interrupted
interruption: interruption
interstice: interstice
interval: interval
intervene: intervening
interview: interview,interviewing
interviewer: interviewer
intestacy: intestacy
intolerable: intolerable
intonation: intonation
intrigue: intrigued
introduce: introduced,introducing
introduction: introduction
intrude: intrude
intuition: intuition
inure: inured
invade: invade
invader: invader,invaders
invalidity: invalidity
invent: invent,invented
inventor: inventor
inversely: inversely
investigate: investigate
investigation: investigation,investigations
invoice: invoice,invoiced,invoices
invoke: invoked
involuntarily: involuntarily
involuntary: involuntary
involve: involved
inwardly: inwardly
ireful: ireful
irksome: irksome
iron: iron,ironed
ironbound: ironbound
irony: irony
irresistible: irresistible
irresistibly: irresistibly
irritable: irritable
irs: irs
island: islands
isolation: isolation
issue: issue
item: item
ither: ither
iv: iv
ivory: ivory
ix: ix
jack: jack
jackal: jackals
jacket: jackets
jagged: jagged
jamaica: jamaica
jamb: jamb
japanese: japanese
jaw: jaw,jaws
jealous: jealous
jealousy: jealousy
jerusalem: jerusalem
jest: jest
jesting: jesting
jet: jet
jewel: jewelled
job: job,jobs
jog: jog
john: john
joining: joinings
joint: joint
joke: joke
jolly: jolly
jonathan: jonathan
joseph: joseph
jot: jotting
journal: journal
journalist: journalists
journey: journey,journeying,journeys
joy: joy
joyously: joyously
jubilant: jubilant
judas: judas
judge: judge
judging: judging
judgment: judgment
jug: jug
juggle: juggle
jugular: jugular
july: july
jump: jump,jumped,jumping
junction: junction
june: june
junior: junior
juniper: juniper
jurist: jurist
justice: justice
justify: justified
jut: jutting
keckle: keckle
keen: keen
keenly: keenly
keeper: keeper,keepers
kensington: kensington
kep: kep
ketch: ketch
key: key
keyhole: keyhole
kick: kick,kicked
kid: kid
kill: kill,killed,killing
killing: killing
kin: kin
kindliest: kindliest
kindly: kindly
kindness: kindness
king: king
kingdom: kingdom
kink: kink,kinks
kirk: kirk
kiss: kiss,kissed,kisses,kissing
kitchen: kitchen
kitten: kitten,kittens
knee: knee,knees
kneel: kneeling,knelt
knell: knell
knife: knife,knives
knight: knights
knit: knit,knitting
knock: knock,knocked,knocking
knocker: knocker
knot: knot,knots
knowledge: knowledge
knuckle: knuckles
kodak: kodak
korea: korea
krone: krone
kukri: kukri
label: label,labelled
labour: labour,laboured,labours
lack: lack
laconic: laconic
laconically: laconically
lad: lad
ladder: ladder
laden: laden
lady: ladies,lady
lag: lag
lair: lair,lairs
lake: lake
lamb: lamb,lambs
lamiter: lamiter
lamp: lamp,lamps
lamplight: lamplight
lance: lance
lancet: lancet
land: land,landed,lands
landing: landing
landlady: landlady
landlord: landlord
landscape: landscape
lane: lane
laneway: laneway
language: language,languages
languid: languid
languidly: languidly
languorous: languorous
lank: lank
lantern: lantern,lanterns
lanthorn: lanthorns
lap: lap,lapped,lapping
lapping: lapping
lapse: lapse,lapsing
lapsing: lapsing
larboard: larboard
larder: larder
lash: lashed,lashes
lass: lass
latch: latch,latched
late: late
latitude: latitude
laudanum: laudanum
laugh: laugh,laughed,laughing
laughter: laughter
launch: launch
law: law,laws
lawn: lawn
lawyer: lawyer
lay: laid,lay,laying
lazily: lazily
laziness: laziness
lead: lead,leading,leads,led
leaden: leaden
leader: leader,leaders
leaf: leaves
league: leagued,leagues
leak: leak
lean: lean,leaned,leaning,leant
leap: leap,leaped,leaping
leapt: leapt
learn: learn,learned,learning,learnt
learning: learning
leather: leather
leave: leave,leaves,leaving,left
lecture: lectures
ledge: ledge
ledger: ledger
leech: leech
leeds: leeds
leer: leer
left: left
leg: leg,legs
legal: legal
legally: legally
legend: legend,legends
legion: legions
leisure: leisure
leisurely: leisurely
leper: leper
lessen: lessen,lessened
lesson: lesson,lessons
lethal: lethal
lethargic: lethargic
lethargy: lethargy
lethe: lethe
letter: letter,letters
letters: letters
level: level,levelled
liability: liability
liable: liable
liberated: liberated
liberty: liberties,liberty
library: library
license: license
licensed: licensed
lick: licked,licking
licking: licking
lid: lid,lids
lie: lain,lie,lies,lying
lieu: lieu
life: life,lives
lift: lift,lifted,lifting,lifts
lifting: lifting
light: light,lighted,lighter,lighting,lights,lit
lighted: lighted
lighthouse: lighthouse,lighthouses
lighting: lighting
lightly: lightly
lightning: lightning
lily: lily
limb: limbs
limit: limit,limited
limitation: limitation,limitations
limited: limited
lincoln: lincoln
linen: linen
link: link,linked,links
lintel: lintels
lion: lion,lions
lip: lip,lips
liquid: liquid
list: list,lists
listen: listen,listened,listening,listens
literally: literally
literary: literary
litter: litter,littered
live: live,lived,lives,living
lively: lively
liverpool: liverpool
livid: livid
living: living
lizard: lizard
lloyd: lloyd
load: load
loading: loading
loaf: loaves
loafer: loafers
loath: loath
loathe: loathe
loathing: loathing
loathsome: loathsome
loathsomeness: loathsomeness
local: local
locality: locality
locally: locally
locate: located
location: locations
lock: lock,locked,locking,locks
locked: locked
locksmith: locksmith
lodging: lodging
lofty: lofty
log: log,logs
logic: logic
logical: logical
logically: logically
loin: loins
loll: lolling
lombard: lombard
london: london
loneliness: loneliness
lonely: lonely
longing: longing
lookout: lookout
loom: looming
loop: loop
loophole: loopholes
loose: loose
loosen: loosened
lor: lor
lord: lord
lordly: lordly
lordship: lordship
lore: lore
lose: lose,losing,lost
loss: loss
lost: lost
lot: lot,lots
lotus: lotus
loud: loud,louder
loudly: loudly
love: love,loved,loves,loving
loved: loved
loveliness: loveliness
lovely: lovelier,lovely
lover: lover
loving: loving
lovingly: lovingly
luck: luck
lucy: lucy
luggage: luggage
lugubrious: lugubrious
lull: lull
lumber: lumbering
lump: lumps
lunatic: lunatic,lunatics
lunch: lunch,lunched,lunching
lung: lungs
lure: lured,luring
lurid: lurid
lurk: lurk
lust: lust
lustre: lustre
machine: machine
mad: mad
madam: madam
madame: madame
madden: maddening
madhouse: madhouse
madly: madly
madman: madman,madmen
madness: madness
maelstrom: maelstrom
magazine: magazines
magnetic: magnetic
magnificent: magnificent
magnifico: magnifico
magyar: magyar
magyars: magyars
maid: maid,maids
maiden: maiden,maidens
mail: mail
main: main,mains
maintain: maintaining
maize: maize
majority: majority
maker: makers
malady: malady
malice: malice
malign: malign
malignant: malignant
malignity: malignity
mall: mall
malodorous: malodorous
mamma: mamma
manacle: manacled
manage: managed
manageable: manageable
manager: manager
mangled: mangled
manhood: manhood
mania: mania,manias
maniac: maniac
manifest: manifest,manifested
manifestation: manifestations
manifestly: manifestly
manifold: manifold
mankind: mankind
manlike: manlike
manly: manly
manner: manner
manners: manners
mansion: mansion
mantle: mantle
manus: manus
manuscript: manuscript
map: map,mapped,maps
marble: marble
march: march
mare: mare,mares
margin: margin
mariner: mariner,mariners
mark: mark,marked,marks
marked: marked
market: market
marmion: marmion
marriage: marriage
married: married
marry: married,marry
martyr: martyr
marvel: marvel
marvellous: marvellous
mary: mary
mask: mask,masks
masonry: masonry
masquerade: masquerade
mass: mass,masses
massive: massive
massively: massively
mast: masts
master: master,mastered
mastery: mastery
mastiff: mastiff
matapan: matapan
match: match,matches,matching
matchbox: matchbox
mate: mate,mated,mates
material: material,materials
materialisation: materialisation
materialise: materialise,materialised
matrimonial: matrimonial
matter: matter,matters
mattock: mattock
mattress: mattress
mature: matured
maw: maw
maximum: maximum
mayhap: mayhap
meagre: meagre
meal: meal,meals
meaning: meaning
meaningly: meaningly
measure: measure,measures
meat: meat
mechanical: mechanical
meddle: meddle
medical: medical
medicinal: medicinal
medicine: medicine,medicines
medico: medico
medium: medium
medusa: medusa
meekly: meekly
meekness: meekness
meet: meet,meeting,met
meeting: meeting
mein: mein
melancholy: melancholy
mell: mell
melt: melt,melted,melting,melts
memorandum: memoranda,memorandum
memory: memories,memory
menace: menace
mend: mend
menfolk: menfolk
menial: menial
mental: mental
mentally: mentally
mention: mention,mentioned
merchant: merchant
merchantability: merchantability
merciful: merciful
mercifully: mercifully
mercy: mercy
mere: mere
merge: merge,merged
merged: merged
merrily: merrily
merry: merry
message: message,messages
messenger: messenger
metal: metal
metallic: metallic
metaphor: metaphor
metaphysician: metaphysician
method: method,methods
methodicalness: methodicalness
methuselah: methuselah
mew: mews
miasma: miasma
michael: michael
middle: middle
midnight: midnight
midst: midst
mighty: mighty
mild: mild
mile: mile,miles
militate: militate,militating
milk: milk
miller: miller
mina: mina
mind: mind,minding,minds
minded: minded
mingle: mingle,mingled
miniature: miniature
minister: minister,ministers
minute: minute,minutes
minutely: minutely
mirabile: mirabile
miracle: miracle
miraculously: miraculously
mirror: mirror
mirth: mirth
mirthless: mirthless
misadventure: misadventure
mischief: mischief
mischievous: mischievous
miscredit: miscredit
miserable: miserable
miserably: miserably
misery: miseries,misery
misjudge: misjudge
mislead: mislead,misled
mislike: mislike
missal: missal,missals
missing: missing
mission: mission
missis: missis
mississippi: mississippi
mist: mist,mists
mistake: mistake,mistaking
mistaken: mistaken
mistiness: mistiness
mistress: mistress
mistrust: mistrust,mistrusted
misty: misty
mitchell: mitchell
mite: mite
mix: mixed,mixes,mixing
mixed: mixed
mixture: mixture
mixup: mixup
moan: moan,moaned,moaning
mobile: mobile
mock: mock,mocking
mockery: mockery
mockingly: mockingly
modern: modern
modernity: modernity
modest: modest
modesty: modesty
modification: modification
modify: modified
moisten: moistened,moistening
moisture: moisture
molecule: molecules
molest: molested
moment: moment,moments
momentarily: momentarily
momentary: momentary
momentous: momentous
mon: mon
money: money
moneybag: moneybag
monkey: monkey
monroe: monroe
monster: monster,monsters
monstrous: monstrous
month: month,months
mood: mood,moods
moon: moon
moonbeam: moonbeams
moonlight: moonlight
moonlit: moonlit
moonrise: moonrise
moonshine: moonshine
moor: moors
moral: moral
morbid: morbid
morbidly: morbidly
morning: morning
morpheus: morpheus
morphia: morphia
morris: morris
morrow: morrow
mortal: mortal,mortals
mortality: mortality
mortar: mortar
mortmain: mortmain
mortuary: mortuary
mote: motes
moth: moth,moths
mother: mother
motion: motion,motioned,motioning,motions
motionless: motionless
motive: motive,motives
motor: motor
motto: motto
mould: mould
mount: mount,mounted
mountain: mountain,mountains
mourn: mourn
mourner: mourner,mourners
mournful: mournful
mourning: mourning
mouse: mice
moustache: moustache,moustaches
mouth: mouth,mouths
mouthed: mouthed
movable: movable
movement: movement,movements
moving: moving
mud: mud
muffle: muffled
muffled: muffled
mule: mule
mullion: mullioned
multiply: multiplying
multitude: multitude
mumble: mumbled
mundane: mundane
munich: munich
murder: murder,murdered,murdering,murders
murmur: murmur,murmured,murmuring
murray: murray
museum: museum
mushroom: mushroom
music: music
musical: musical
musket: musket
muster: muster
musty: musty
mute: mute
mutilate: mutilate,mutilating
mutilation: mutilation
myriad: myriad,myriads
mysterious: mysterious
mysteriously: mysteriously
mystery: mysteries,mystery
mystify: mystifying
nail: nail,nailed,nails
naked: naked
nane: nane
nap: napped
napkin: napkin
narcotic: narcotic
narration: narration
narrative: narrative
narrow: narrow
nasty: nasty
nation: nation,nations
national: national
nationality: nationalities,nationality
nations: nations
native: native
natural: natural
naturally: naturally
nature: nature,natures
nausea: nausea
nauseous: nauseous
navigate: navigated
navy: navy
nearer: nearer
nebulous: nebulous
necessity: necessity
neck: neck,necks
necromancy: necromancy
needful: needful
needless: needless
negative: negative
neglect: neglect,neglected,neglecting
negligence: negligence
neigh: neigh
neighbour: neighbours
neighbourhood: neighbourhood
nerve: nerve,nerved,nerves
nervous: nervous
nervousness: nervousness
nest: nest
nether: nether
nethermost: nethermost
network: network
neutral: neutral
newcastle: newcastle
newly: newly
news: news
newsletter: newsletter
newspaper: newspaper,newspapers
nice: nice,nicest
nicely: nicely
nicht: nicht
nick: nick
nigh: nigh
night: night,nights
nightdress: nightdress
nightfall: nightfall
nightingale: nightingale
nightly: nightly
nightmare: nightmare
nights: nights
nimbleness: nimbleness
nineteenth: nineteenth
nobility: nobility
noble: noble,nobles,noblest
nobleman: nobleman
nobly: nobly
nocturnal: nocturnal
nod: nodded,nodding
noise: noise,noises
noisy: noisy
nonproprietary: nonproprietary
nonsense: nonsense
noon: noon
norfolk: norfolk
normal: normal
north: north
northern: northern
northward: northward
northwards: northwards
norway: norway
nose: nose,noses,nosing
nostril: nostril,nostrils
nostrum: nostrum
nota: nota
note: note,notes
notebook: notebook
notice: notice,noticed,noticing
noticeable: noticeable
notify: notifies,notify
nought: nought
nourishment: nourishment
november: november
novice: novice
nowt: nowt
nudge: nudged
nuisance: nuisance
numbness: numbness
numerous: numerous
nurse: nurse,nurses
nursemaid: nursemaid
nursing: nursing
nut: nut,nuts
oak: oak
oaken: oaken
oar: oars
oath: oath
obedience: obedience
obedient: obedient
obeisance: obeisance
obey: obey
object: object,objected
objection: objection
objective: objective
obligation: obligation
oblige: oblige,obliged,obliging
obliquity: obliquity
obliterate: obliterated
oblivion: oblivion
oblivious: oblivious
oblong: oblongs
obscene: obscene
obscure: obscure,obscured
obsequious: obsequious
observant: observant
observation: observation
observe: observe,observes,observing
obsolete: obsolete
obstacle: obstacle
obstinacy: obstinacy
obstinately: obstinately
obstruct: obstruct,obstructing
obstruction: obstruction
obviate: obviate
occasion: occasion,occasions
occasional: occasional
occasionally: occasionally
occult: occult
occupation: occupation
occupy: occupied,occupy
occur: occur,occurred,occurring
ocean: ocean,oceans
octagonal: octagonal
october: october
octroi: octroi
odd: odd
oddness: oddness
odium: odium
odorous: odorous
odour: odour
offence: offence
offend: offend
offensively: offensively
offensiveness: offensiveness
offer: offer,offered,offers
office: office,offices
officer: officers
official: official,officials
officially: officially
oil: oil
ole: ole
oleander: oleander
ominous: ominous
ominously: ominously
omit: omitting
omnipotent: omnipotent
onion: onion
online: online
onlooker: onlookers
onwards: onwards
opacity: opacity
oped: oped
openly: openly
opera: opera
operate: operate,operating
operation: operation,operations
operator: operators
ophelia: ophelia
opiate: opiate
opinion: opinion
opponent: opponent
opportunity: opportunities,opportunity
oppose: oppose
oppress: oppresses
oppression: oppression
oppressive: oppressive
optical: optical
oracle: oracle
orange: orange
orb: orbs
orchestra: orchestra
ordain: ordained
ordeal: ordeal
orderly: orderly
ordinarily: ordinarily
ordinary: ordinary
ordnance: ordnance
orf: orf
organ: organ
organise: organised
organize: organize,organized
orient: orient
oriental: oriental
origin: origin
original: original
originally: originally
originate: originated
originator: originator
ornament: ornaments
orthodox: orthodox
ounds: ounds
oust: ousted
outbreak: outbreak,outbreaks
outburst: outburst,outbursts
outcast: outcast
outcry: outcry
outdated: outdated
outer: outer
outlet: outlet
outline: outlined
outrage: outrage,outrages
outrageous: outrageous
outrider: outrider
outset: outset
outstretched: outstretched
outward: outward
outwardly: outwardly
outwards: outwards
overawe: overawe
overboard: overboard
overcast: overcast
overcoat: overcoat
overcome: overcame,overcome,overcoming
overhead: overhead
overland: overland
overmaster: overmastered,overmastering
overmuch: overmuch
overplus: overplus
overpower: overpower,overpowered,overpowering
overpowering: overpowering
overslept: overslept
overspread: overspread
overtake: overtaken,overtook
overtop: overtopping
overwhelm: overwhelm,overwhelmed
overwhelmed: overwhelmed
overwhelming: overwhelming
overwork: overwork
overwrought: overwrought
ow: ow
owe: owe,owed,owes
owl: owl
owling: owling
owner: owner,owners
ownership: ownership
pabulum: pabulum
pace: pace
pacify: pacify
pack: pack,packed,packs
package: package
packet: packet
padded: padded
padding: padding
pagan: pagan
pain: pain,pains
pained: pained
painful: painful
painfully: painfully
paint: paint,painted
painter: painters
pair: pair
pajamas: pajamas
pal: pal
pale: pale
paleness: paleness
paler: paler
pall: pall
pallid: pallid
pallor: pallor
palm: palm,palms
palpitating: palpitating
palsy: palsy
paltry: paltry
pampas: pampas
pane: panes
pang: pang
panic: panic
panther: panther
panting: panting
paper: paper,papers
paperwork: paperwork
paprika: paprika
paragraph: paragraph,paragraphs
parallel: parallel
paralyse: paralyse
paralysed: paralysed
paralysis: paralysis
paramount: paramount
paraphernalia: paraphernalia
parcel: parcel
parched: parched
pardon: pardon
parent: parents
paris: paris
parish: parish
park: park
paroxysm: paroxysm,paroxysms
parr: parr
parrot: parrot
parry: parried
parson: parsons
parti: parti
partial: partial
partially: partially
particulars: particulars
partly: partly
partner: partner
party: parties,party
pass: pass,passed,passes,passing
passage: passage,passages
passenger: passenger,passengers
passing: passing
passion: passion
passionate: passionate
paste: pasted
pat: pat,patted
patch: patch,patches
path: path,paths
pathetic: pathetic
pathology: pathology
pathos: pathos
pathway: pathway
patience: patience
patient: patient,patients
patiently: patiently
patrick: patrick
patriot: patriots
patrol: patrol,patrolled,patrolling
patronise: patronised
patronymic: patronymic
patter: pattering
paucity: paucity
pause: pause,paused,pauses,pausing
paved: paved
pay: paid,pay,paying,pays
payment: payment,payments
peace: peace
peaceful: peaceful
peacefully: peacefully
peak: peak,peaks
peal: peal,peals
pear: pear
pearl: pearl,pearls
peasant: peasant,peasants
peasantry: peasantry
peculiar: peculiar
peculiarity: peculiarity
peculiarly: peculiarly
pedantry: pedantry
peep: peeped
peer: peered,peering
pell: pell
pen: pen,pens,pent
penalty: penalties
pencil: pencil
pendulum: pendulum
penetrate: penetrate
penitent: penitent
penniless: penniless
penny: penny
people: peoples
pepper: pepper
perambulator: perambulator
perceptible: perceptible
perch: perched
perchance: perchance
perfect: perfect
perfection: perfection
perfectly: perfectly
perforce: perforce
perform: perform,performed,performing
performance: performances
perfunctory: perfunctory
peril: peril,perils
perilous: perilous
period: period,periods
periodic: periodic
perish: perish
perlite: perlite
permanence: permanence
permanent: permanent
permission: permission
permit: permit,permitted
perpetual: perpetual
perpetually: perpetually
perplexity: perplexity
persistence: persistence
persistently: persistently
person: people,person,persons
personal: personal
personally: personally
perspective: perspective
perspiration: perspiration
perturbation: perturbation
perversely: perversely
pet: pet,pets,petted
petal: petals
peter: peter
petition: petition
petticoat: petticoats
phantom: phantom,phantoms
phase: phase,phases
phenomenally: phenomenally
philosopher: philosopher
philosophically: philosophically
philosophy: philosophy
phlegmatic: phlegmatic
phonetic: phonetic
phonograph: phonograph,phonographs
phosphorescence: phosphorescence
phrase: phrase,phrases
physical: physical
physically: physically
physician: physician,physicians
physiognomist: physiognomist
physiognomy: physiognomy
physiology: physiology
piccadilly: piccadilly
pick: pick,picked
picture: picture,pictures
picturesque: picturesque
picturesqueness: picturesqueness
piece: piece,pieces
pier: pier,piers
pierce: pierce,pierced,piercing
piercingly: piercingly
pig: pig
pile: pile,piled,piles
pill: pill
pillar: pillar
pillow: pillow,pillows
pin: pin
pinch: pinch,pinched,pinching
pincher: pincher
pine: pine
pink: pink
pious: pious
pipe: pipe
pique: pique
pirate: pirates
pistol: pistol
pit: pit
pitch: pitch,pitched
piteous: piteous
piteously: piteously
pitiable: pitiable
pitiful: pitiful
pity: pitied,pity
pityingly: pityingly
placid: placid
placidity: placidity
placidly: placidly
placing: placing
plague: plague
plain: plain
plainly: plainly
plaintive: plaintive
plan: plan,planning,plans
plane: plane
plank: plank
plant: plant,planted
plaster: plaster
plate: plates
platform: platform,platforms
plating: plating
play: play,played,playing,plays
playful: playful
playfully: playfully
playing: playing
plead: pleaded
pleading: pleading
pleasant: pleasant,pleasanter
pleasantly: pleasantly
pleasantry: pleasantry
pleased: pleased
pleasing: pleasing
pleasure: pleasure
pledge: pledge,pledged
plenty: plenty
plight: plight
ploughshare: ploughshare
pluck: pluck,plucked
plug: plug
plum: plum
plumbing: plumbing
plunge: plunge,plunged
plunging: plunging
plural: plural
pocket: pocket,pockets
pod: pods
poignant: poignant
poise: poise
poison: poison
poke: poke
pole: pole,poles
police: police
policeman: policeman,policemen
polished: polished
politely: politely
politeness: politeness
politic: politic
political: political
politics: politics
polluted: polluted
pollution: pollution
polyandrist: polyandrist
polyglot: polyglot
pond: pond
ponder: ponder,pondered
ponderous: ponderous
pooh: pooh,poohed
pool: pool
poor: poor,poorer
poorish: poorish
pop: pop
poplar: poplar
popular: popular
population: population
porch: porch
pore: poring
porridge: porridge
port: port,ports
porter: porter
porterage: porterage
portion: portion,portions
portmanteau: portmanteau
pose: pose
poser: poser
position: position
positive: positive
positively: positively
possess: possessed
possession: possession
possibility: possibilities,possibility
post: post,posted,posting,posts
postman: postman
postponement: postponement
posture: posture
pot: pot,pots
potency: potency
potent: potent
poter: poter
potter: potter
pouch: pouches
pouf: pouf
pound: pounding,pounds
pour: poured,pouring,pours
pourparler: pourparlers
powdery: powdery
power: power,powers
powerful: powerful
powerfully: powerfully
powerless: powerless
practical: practical
practically: practically
practice: practice
practise: practise,practising
practitioner: practitioner
prairie: prairies
praise: praise,praised,praising
pray: pray,prayed,praying
prayer: prayer,prayers
precaution: precaution,precautions
precede: precede,preceded,preceding
precedent: precedent
precious: precious
preciously: preciously
precipice: precipice,precipices
precision: precision
predecease: predeceasing
predestinate: predestinate
predominate: predominated
preference: preference
prefix: prefix
prejudge: prejudge
prejudice: prejudice
prejudiced: prejudiced
preliminary: preliminary
prelude: prelude
premise: premise
premonitory: premonitory
preparation: preparation,preparations
preparatory: preparatory
prepare: prepare,prepared,preparing
prepared: prepared
prepossessing: prepossessing
presage: presage
prescribe: prescribe,prescribed
presence: presence
presently: presently
preserve: preserve
president: president
press: press,pressed,presses,pressing
pressure: pressure
presume: presume
pretend: pretend,pretended,pretending
pretense: pretense
preternatural: preternatural
prettily: prettily
pretty: pretty
prevail: prevail,prevailed,prevailing
prevalent: prevalent
prevent: prevent
previous: previous
prey: prey,preying
preying: preying
price: price
prick: prick,pricked,pricks
pride: pride
prig: prig
principle: principle,principles
print: print,printed
prison: prison
prisoner: prisoner
private: private
privilege: privilege
prize: prize
pro: pro
probability: probability
probable: probable
probe: probe
proceed: proceed,proceeded,proceeding
proceeding: proceeding
process: process
processing: processing
procession: procession
procure: procured,procuring
prodigal: prodigal
prodigious: prodigious
produce: produce,produced,produces,producing
production: production
profanation: profanation
professional: professional
professionally: professionally
professor: professor
profit: profit,profits
profound: profound
profuse: profuse
profusely: profusely
profusion: profusion
progress: progress,progressing
prohibition: prohibition
project: project,projected,projecting
projection: projection
prolific: prolific
prolong: prolong,prolonged,prolonging
prolonged: prolonged
prominence: prominence
prominently: prominently
promise: promise,promised,promises,promising
promote: promoting
promotion: promotion
prompt: prompt,prompted
pronounced: pronounced
proof: proof,proofs
proofread: proofread
proofreading: proofreading
prop: propped
propel: propelled
proper: proper
properly: properly
property: properties,property
proportion: proportion,proportioned,proportions
proposal: proposal,proposals
propose: propose,proposed,proposing
proprietary: proprietary
proprietor: proprietor
prosaic: prosaic
prosecute: prosecuting
prospect: prospect
prosperity: prosperity
prostrate: prostrate
prostration: prostration
protect: protect,protected,protecting
protectingly: protectingly
protection: protection,protections
protective: protective
protest: protest,protested
protrude: protruded
protuberant: protuberant
proudly: proudly
prove: prove,proved,proves,proving
proverb: proverb,proverbs
provide: provide,providing
providence: providence
provision: provision,provisions
prowl: prowl
proximity: proximity
psalmist: psalmist
psychic: psychic
psychological: psychological
ptomaine: ptomaines
public: public
publisher: publishers
publishers: publishers
pucker: puckered
puddle: puddle
puff: puff
pull: pull,pulled,pulling
pulpit: pulpits
pulse: pulse
puma: puma
punch: punch
punctuation: punctuation
puncture: punctured,punctures
pungent: pungent
punish: punish,punished
punishment: punishment
punitive: punitive
pupil: pupil
purchase: purchase,purchased
purchaser: purchaser
pure: pure
purely: purely
purify: purify
purifying: purifying
purity: purity
purple: purple
purpose: purpose,purposes
purse: purse
pursue: pursue,pursued,pursuing
pursuer: pursuers
pursuit: pursuit
push: push,pushed,pushing
puss: puss
putty: putty
puzzle: puzzle,puzzled,puzzles
puzzled: puzzled
quaint: quaint
qualitative: qualitative
quality: qualities,quality
quantity: quantity
quare: quare
quarrel: quarrel
quarter: quarter,quartered,quarters
quatre: quatre
quay: quay
queer: queer,queerest
query: queried,query
quest: quest
question: question,questioned,questioning,questions
questioning: questioning
questioningly: questioningly
quick: quick,quicker,quickest
quicken: quicken,quickening
quickness: quickness
quicksand: quicksand
quid: quid
quiet: quiet,quieted,quieter
quietly: quietly
quietness: quietness
quietude: quietude
quit: quit
quiver: quiver,quivered,quivering
quondam: quondam
rabbit: rabbit
race: race,races,racing
rachet: rachet
racking: racking
radiant: radiant
radiantly: radiantly
radius: radius
rag: rag,rags
rage: rage,raging
ragged: ragged
rail: rail,railed,rails
railway: railway,railways
rain: rain,rained,rains
raise: raise,raised,raising
rally: rallied,rally,rallying
range: range,ranged
rank: rank,ranked,ranks
rapid: rapid,rapids
rapidity: rapidity
rapidly: rapidly
rapture: rapture
rare: rare,rarer
rarity: rarity
rat: rat,rats
rate: rate
rational: rational
rattle: rattle,rattled,rattling
rattling: rattling
ravages: ravages
rave: raved,raving
ravings: ravings
raw: raw
ray: ray,rays
razor: razor
reach: reach,reached,reaching
reaction: reaction
read: read,reading,reads
readable: readable
readiness: readiness
reading: reading
ready: ready
real: real
realisation: realisation
realise: realise,realised,realising
reality: realities,reality
realize: realize,realized
realm: realm
reap: reaped,reaping
rear: rear,reared
reason: reason,reasoned,reasons
reasonable: reasonable
reasonableness: reasonableness
reasoning: reasoning
reassure: reassured,reassuring
rebel: rebelled
rebuff: rebuff
recall: recall,recalled,recalls
receipt: receipt
receipted: receipted
receive: receive,received,receiving
receptacle: receptacle
reception: reception
receptivity: receptivity
recipe: recipe
recklessly: recklessly
reckon: reckoned
recline: reclining
recognise: recognise,recognised
recognize: recognize
recoil: recoil,recoiled
recollect: recollect
recollection: recollection
reconcile: reconciled
record: record,recorded,records
recorder: recorder
recording: recording
recover: recover,recovered,recovers
recovery: recovery
recruit: recruited
recruiting: recruiting
recuperate: recuperate
recuperative: recuperative
red: red,redder
redden: redden,reddened,reddening
reddish: reddish
redeem: redeem,redeemed
redeeming: redeeming
redirect: redirect
redistribute: redistribute,redistributing
redistributing: redistributing
redistribution: redistribution
redouble: redoubled
redress: redress
reduce: reduce,reduced
reduction: reduction
reef: reef
reek: reeked,reeking
reel: reeled
reet: reet
refer: refer,referring
reference: reference,references
refine: refine
reflect: reflect,reflected
reflection: reflection
reflectively: reflectively
reflex: reflex
refraction: refraction
refresh: refresh,refreshed
refreshing: refreshing
refreshment: refreshment
refuge: refuge,refuges
refund: refund
refusal: refusal,refusals
refuse: refuse,refused
regain: regaining
regard: regard
region: region
register: registered,registers
registrar: registrar
registration: registration
regret: regret
regular: regular
regularity: regularity
regulate: regulate,regulating
regulation: regulations
reign: reign
rein: rein,reined,reins
reject: reject
rejoice: rejoice,rejoiced,rejoicing
relapse: relapse,relapsed,relapses
relate: relating
relation: relations
relative: relatives
relaxed: relaxed
release: release,released
relentlessly: relentlessly
reliable: reliable
reliant: reliant
relief: relief
relieve: relieve,relieved
relieved: relieved
religion: religion
religious: religious
rely: relying
remain: remain,remained,remaining,remains
remainder: remainder
remains: remains
remark: remark,remarked
remarkable: remarkable
remedy: remedies
remember: remember,remembered,remembering
remembrance: remembrance
remind: remind,reminded
reminding: reminding
remiss: remiss
remissness: remissness
remnant: remnant
remonstrance: remonstrance
remonstrate: remonstrated
remorse: remorse
remorseless: remorseless
remote: remote
removal: removals
remove: remove,removed
rename: renamed
render: render,rendered
renew: renewed,renewing
renewed: renewed
rent: rent,renting,rents
reopen: reopened
reopening: reopening
repair: repair,repaired
repeat: repeated,repeating
repeater: repeater
repel: repelled
repetition: repetition
replace: replace,replaced
replacement: replacement
replenish: replenish,replenished
repletion: repletion
reply: replied,reply,replying
report: report,reported,reports
repose: repose
reprehensible: reprehensible
represent: representing,represents
representation: representations
repress: repress
reproach: reproach
repudiate: repudiated
repugnant: repugnant
repulse: repulse
repulsion: repulsion
repulsive: repulsive
reputation: reputation
request: request
require: require,required
required: required
requirement: requirements
requisition: requisitions
rescript: rescript
resemblance: resemblance
reservation: reservations
residence: residence
resident: resident
resignation: resignation
resignedly: resignedly
resilience: resilience
resist: resist,resisting
resistance: resistance
resistless: resistless
resolute: resolute
resolutely: resolutely
resolution: resolution
resolve: resolve,resolved
resonance: resonance
resonant: resonant
resource: resource
resourceful: resourceful
respect: respect
respectable: respectable
respectful: respectful
respectfully: respectfully
respective: respective
respects: respects
respiration: respiration
respond: respond
response: response
responsibility: responsibilities,responsibility
responsible: responsible
rest: rest,rested,resting,rests
restful: restful
restless: restless
restlessly: restlessly
restlessness: restlessness
restore: restore,restored,restoring
restrain: restraining
restrained: restrained
restraint: restraint
restrict: restrict
restriction: restrictions
result: result
resume: resume,resumed
resumption: resumption
resurrection: resurrection
retain: retain
reticence: reticence
reticent: reticent
retire: retire,retired
retrograde: retrograde
return: return,returned,returning,returns
reveal: reveal,revealed
revenge: revenge
revenue: revenue
reverence: reverence
reverently: reverently
reverse: reverse
revive: revived
revolt: revolted
revolutionise: revolutionised
revolve: revolving
revolver: revolver
reward: reward,rewards
rib: ribbed
ribald: ribald
ribbon: ribbon
rich: rich
rick: ricks
ricochet: ricochetting
rid: rid
ride: ride,rides,riding,rode
rider: rider
ridge: ridge,ridges
ridiculous: ridiculous
ridiculously: ridiculously
riding: riding
rifle: rifle,rifles
rift: rift,rifts
rig: rig
righteousness: righteousness
rightly: rightly
rigid: rigid
rigidly: rigidly
rigorously: rigorously
rinse: rinsed
riot: riot
ripen: ripened
ripple: ripple,ripples
rise: rise,risen,rises,rising,rose
riser: riser
risk: risk
rival: rival
river: river,rivers
road: road,roads
roadside: roadside
roadway: roadway
roam: roaming
roar: roar,roared,roaring
roaring: roaring
roast: roast
roasted: roasted
rob: rob,robbed,robbing
robber: robber
robe: robe
robin: robin
rock: rock,rocked,rocks
rocky: rocky
roll: roll,rolled,rolling
rolling: rolling
roman: roman
romance: romance
romantic: romantic
romany: romany
rome: rome
roof: roof,roofed,roofs
rook: rooks
root: root,rooted,roots
rope: rope,ropes
rosary: rosary
rose: rose,roses
rosy: rosy
rough: rough
roughly: roughly
roumanian: roumanian
route: route
routine: routine
roved: roved
row: row,rows
rowing: rowing
rowlock: rowlocks
royal: royal
royale: royale
royalty: royalties,royalty
rub: rub,rubbed
rubbish: rubbish
ruby: ruby
rudder: rudder
ruddiness: ruddiness
ruddy: ruddy
rude: rude
rudiment: rudiment
rudimentary: rudimentary
ruffle: ruffled
rufus: rufus
rug: rug,rugs
rugged: rugged
ruin: ruin,ruined,ruins
rule: rule,rules
rum: rum
rummy: rummiest
rumour: rumours
runaway: runaway
runner: runner
running: running
rush: rush,rushed,rushing
russian: russian
rust: rust
rustle: rustle
rusty: rusty
ruthless: ruthless
sack: sacked
sacred: sacred
sacrifice: sacrifice,sacrificed
sad: sad,saddest
saddle: saddles
sadly: sadly
sadness: sadness
safe: safe,safer,safest
safely: safely
safety: safety
sail: sail,sailed,sailing,sails
sailing: sailing
sailor: sailor,sailors
saint: saints
sairly: sairly
sake: sake
salad: salad
sale: sale
salient: salient
salt: salt
salutation: salutation
salute: saluted
salvage: salvage
salvation: salvation
sam: sam
samuel: samuel
sanatorium: sanatorium
sanctify: sanctified,sanctify
sanction: sanction
sanctuary: sanctuary
sand: sand,sands
sandy: sandy
sane: sane,sanest
sanguine: sanguine
sanity: sanity
sap: sap
sapphire: sapphire,sapphires
sarcastic: sarcastic
sark: sarks
sash: sash,sashes
satan: satan
satiate: satiate
satisfaction: satisfaction
satisfactorily: satisfactorily
satisfactory: satisfactory
satisfied: satisfied
satisfy: satisfied,satisfy
saturday: saturday
saturnine: saturnine
saucer: saucer
saunter: sauntered
savage: savage
savagely: savagely
save: save,saved
savin: savin
saxon: saxon,saxons
scale: scale,scaled
scandal: scandal
scantily: scantily
scar: scar
scarborough: scarborough
scarce: scarce
scarcely: scarcely
scare: scare,scared
scared: scared
scarlet: scarlet
scart: scart
scatter: scatter,scattered,scattering
scattered: scattered
scene: scene,scenes
sceptic: sceptic
sceptical: sceptical
scheme: scheme
schnell: schnell
scholar: scholar
school: school,schooling
schoolboy: schoolboy
schoolmistress: schoolmistress
schoolroom: schoolroom
schooner: schooner
science: science
scientific: scientific
scientist: scientist,scientists
scion: scions
scold: scolded
scope: scope
score: score,scores
scorn: scorn
scotland: scotland
scott: scott
scour: scouring
scout: scouted
scowl: scowled
scramble: scrambled
scrap: scrap
scrape: scraping
scratch: scratch
scratching: scratching
scream: scream,screamed,screaming,screams
screech: screech,screeching
screw: screw,screwed,screwing,screws
screwdriver: screwdriver
scribe: scribe
script: script
scriptural: scriptural
scruff: scruff
scrutinise: scrutinised
scrutiny: scrutiny
scud: scudded,scudding
scunner: scunner
scupper: scuppers
scythe: scythe
scytheman: scytheman
sea: sea,seas
seaboard: seaboards
seal: seal,sealed
sealing: sealing
seaman: seaman,seamen
seamanship: seamanship
sear: seared
search: search,searched,searching
searchlight: searchlight
season: seasoned
seat: seat,seated,seats
seaward: seaward
seaweed: seaweed
secrecy: secrecy
secret: secret,secrets
secretary: secretary
secure: secure,secured
securely: securely
seek: seek,seeking,sought
seemingly: seemingly
seize: seize,seized,seizing
seldom: seldom
select: selected,selecting
selection: selection
selfish: selfish
selfishness: selfishness
sell: sell,sold
semblance: semblance
sence: sence
send: send,sending,sends
sensation: sensation,sensations
sense: sense
sensibility: sensibilities
sensibly: sensibly
sensitive: sensitive
sensual: sensual
sentence: sentence
sentience: sentience
sentiment: sentiments
sentimental: sentimental
separate: separate,separated,separates
september: september
sequel: sequel
sequence: sequence
sergeant: sergeant
series: series
seriousness: seriousness
sermon: sermon
serpentine: serpentine
servant: servant,servants
serve: serve,served
servian: servian
service: service,services
servile: servile
set: set,sets,setting
setting: setting
settle: settle,settled,settling
settled: settled
seventeenth: seventeenth
seventh: seventh
sever: severed
severe: severe
severely: severely
sex: sex
sexton: sexton
sha: sha
shade: shade
shadow: shadow,shadows
shadowy: shadowy
shady: shady
shaggy: shaggy
shake: shake,shaken,shakes,shaking,shook
shakespeare: shakespeare
shallows: shallows
shame: shame
shape: shape,shapes
share: share,shared,sharing
sharp: sharp,sharper
sharpen: sharpen,sharpened
sharply: sharply
shatter: shattered
shave: shave
shaven: shaven
shaving: shaving
shawl: shawl
shear: shear
sheath: sheath
sheep: sheep
sheepskin: sheepskin,sheepskins
sheer: sheer,sheered
sheet: sheet,sheets
shelf: shelves
shelter: shelter,sheltered,sheltering
shelving: shelving
sherry: sherry
shield: shield
shift: shift,shifted,shifting
shifty: shifty
shine: shine,shining,shone
ship: ship,shipped,ships
shipment: shipment
shipper: shippers
shipping: shipping
shirt: shirt,shirts
shiver: shiver,shivered,shivering
shoal: shoals
shock: shock,shocked,shocks
shocked: shocked
shoe: shoes
shoot: shot
shooter: shooter
shop: shop,shopping
shore: shore
short: short,shorter
shorten: shortened
shorthand: shorthand
shortly: shortly
shot: shot
shoulder: shoulder,shouldering,shoulders
shout: shout,shouted,shouting
shove: shove
shovel: shovel
shriek: shrieked
shrill: shrill
shrillness: shrillness
shrine: shrine
shrink: shrank,shrink,shrinking,shrunk,shrunken
shrivel: shrivelling
shroud: shrouded,shrouds
shrubbery: shrubbery
shrug: shrugged
shudder: shudder,shuddered,shudders
shun: shun,shuns
shut: shut,shuts,shutting
shutter: shutters
sick: sick
sicken: sickened,sickens
sickly: sickly
sickness: sickness
sideboard: sideboard
sidelong: sidelong
siege: siege
sigh: sigh,sighed,sighing
sight: sight,sighted,sights
sign: sign,signed,signs
signal: signal,signalled
signature: signature
significance: significance
silence: silence,silences
silent: silent
silently: silently
silhouette: silhouettes
silk: silk
sill: sill
silly: silly
silver: silver
silvery: silvery
similarity: similarity
simile: simile
simmons: simmons
simoon: simoon
simple: simple,simplest
simplicity: simplicity
simplify: simplify
simply: simply
simultaneously: simultaneously
sin: sin
sincerely: sincerely
sincerity: sincerity
sinewy: sinewy
sing: sang,sung
singing: singing
single: single
singleness: singleness
singly: singly
sink: sank,sink,sinking,sunk
sinking: sinking
sinuous: sinuous
sir: sir,sirs
sissing: sissing
sister: sister,sisters
sit: sat,sit,sits,sitting
sitting: sitting
situate: situated
situation: situation
size: size,sizes
sized: sized
skeer: skeer
skeleton: skeleton
sketch: sketches
skill: skill
skin: skin
skipper: skipper
skull: skull
sky: sky
skywards: skywards
slab: slab
slack: slack
slacken: slacken
slade: slade
slam: slammed
slang: slang
slap: slapped
slate: slate
slaughter: slaughtered
slav: slav
slave: slave
slavery: slavery
slay: slay
sledge: sledge
sleek: sleek
sleep: sleep,sleeping,sleeps,slept
sleeping: sleeping
sleepless: sleepless
sleeplessness: sleeplessness
sleepy: sleepy
sleeve: sleeve,sleeves
slender: slender
slew: slewed
slide: slid,slide
slight: slight,slighted,slightest
sling: sling,slung
slip: slip,slipped
slipper: slippers
slippy: slippy
slit: slit
slivovitz: slivovitz
slope: slope,slopes,sloping
sloppy: sloppy
slovak: slovak
slovaks: slovaks
slow: slow
slowly: slowly
slowness: slowness
slumber: slumber
smart: smart,smarts
smattering: smattering
smear: smeared
smell: smell,smelled,smelling,smells,smelt
smile: smile,smiled,smiling
smileless: smileless
smite: smote
smith: smith
smoke: smoke,smoked
smoky: smoky
smooth: smooth,smoothest
smoothing: smoothing
smoothness: smoothness
smother: smothered
smut: smuts
snake: snake,snakes
snap: snap,snapped
snappy: snappy
snare: snare
snarl: snarl,snarled
snatch: snatch,snatched
snatcher: snatcher
sneer: sneer,sneered
sneering: sneering
sniff: sniff
snod: snod
snog: snog
snort: snort
snow: snow,snows
snowfall: snowfall
snowy: snowy
snub: snub
snuff: snuff
snug: snug
snuggle: snuggled
soap: soaped
sob: sob,sobbed,sobbing,sobs
sober: sober,sobered
soberly: soberly
social: social
society: society
sofa: sofa,sofas
soft: soft,softer
soften: soften,softened
softly: softly
softness: softness
soh: soh
soho: soho
soil: soil
sojourn: sojourn
solder: solder,soldered
soldering: soldering
soldier: soldier,soldiers
sole: sole
solely: solely
solemn: solemn
solemnest: solemnest
solemnity: solemnity
solemnly: solemnly
solicit: solicit
solicitation: solicitation
solicitor: solicitor,solicitors
solicitude: solicitude
solid: solid
solution: solution
solve: solve,solved
son: son,sons
song: song
sons: sons
soothe: soothe,soothed,soothes,soothing
soothing: soothing
soothingly: soothingly
sophistic: sophistic
sordid: sordid
sore: sore
sorely: sorely
sorrow: sorrow,sorrows
sorrowful: sorrowful
sorrowfully: sorrowfully
sorrowing: sorrowing
sort: sort,sorting,sorts
soul: soul,souls
soulless: soulless
sound: sound,sounded,sounding,sounds
soundly: soundly
soup: soup
source: source,sources
south: south
southern: southern
sovereign: sovereign,sovereigns
sow: sowed,sown
space: space
spade: spade
span: span
spangle: spangled
spaniards: spaniards
spanish: spanish
spar: spar
spare: spare,spared
spark: spark,sparks
sparkle: sparkled,sparkling
sparrow: sparrow,sparrows
spasm: spasm
speak: speak,speaking,speaks,spoke,spoken
speaking: speaking
special: special
specialist: specialist
specialty: specialty
specie: specie
species: species
specific: specific
specimen: specimen
speck: speck,specks
speech: speech
speechless: speechless
speed: sped,speed
speer: speer
spell: spell,spells
spelling: spelling
spelt: spelt
spend: spend,spent
sperm: sperm
sphinges: sphinges
spider: spider,spiders
spike: spikes
spilt: spilt
spin: spin
spirit: spirit,spirits
spirited: spirited
spiritless: spiritless
spiritual: spiritual
spiritually: spiritually
spit: spitting
splendid: splendid
splendidly: splendidly
splendour: splendour
splintered: splintered
spoke: spoke
spoken: spoken
spontaneous: spontaneous
spontaneously: spontaneously
spot: spot
sprawl: sprawling
spread: spread,spreading
spring: sprang,spring,springing,springs
sprout: sprout
spruce: spruce
spume: spume
spur: spur,spurs
spurt: spurt,spurted,spurting
spy: spy
squadron: squadron
squall: squalls
square: square
squat: squat
squeeze: squeezed
squire: squire
stab: stab
stabbing: stabbing
stable: stable
staff: staff
stage: stage,stages
stagger: staggered
stagnant: stagnant
stain: stain,stained
stainless: stainless
stair: stair,stairs
stairway: stairway
stake: stake
stalwart: stalwart
stammer: stammered
stamp: stamp,stamped,stamping
stanchion: stanchions
stand: stand,standing,stood
standard: standard
standpoint: standpoints
standstill: standstill
star: star,stars
stare: stare,stared,staring
stark: stark
stars: stars
start: start,started,starting,starts
startle: startled
startled: startled
startling: startling
startlingly: startlingly
stately: stately
statement: statement,statements
statesman: statesman
station: station
statue: statue
stature: stature
status: status
statute: statutes
stave: staves
stay: stay,stayed,staying
stead: stead
steadfastness: steadfastness
steadily: steadily
steady: steadier,steady
steadying: steadying
steak: steak
steal: steal,stealing,stole,stolen
steam: steam,steaming
steamboat: steamboat
steamer: steamers
stean: stean
steel: steel
steep: steep,steeps
steeply: steeply
steer: steer,steered
steering: steering
steersman: steersman
stem: stem,stems
stench: stench
stenograph: stenograph
stenographic: stenographic
stenography: stenography
step: step,stepped,stepping,steps
sterilise: sterilise
stern: stern,sterner,sternest
sternly: sternly
sternness: sternness
stertorous: stertorous
stertorously: stertorously
stethoscope: stethoscope
stick: stick,sticks,stuck
sticking: sticking
stiff: stiff
stillness: stillness
stimulant: stimulant
stimulate: stimulating
sting: sting
stint: stinted
stir: stir,stirred,stirring
stirring: stirring
stock: stock
stoker: stoker
stolidly: stolidly
stone: stone,stones
stonework: stonework
stony: stony
stool: stool
stoop: stooped,stooping
stoppage: stoppages
storage: storage
store: store,stored,stores
storey: storey
storm: storm,storms
stormy: stormy
story: stories,story
storybook: storybook
stout: stouter
stow: stowed
straggler: stragglers
straggling: straggling
straight: straight
straightforwardly: straightforwardly
straightway: straightway
strain: strain,strained,straining
strained: strained
strait: strait,straits
straits: straits
strand: strand
strange: strange,strangest
strangely: strangely
strangeness: strangeness
stranger: stranger,strangers
strategic: strategic
straw: straw
stray: stray,straying
streak: streak
stream: stream,streamed,streaming,streams
streaming: streaming
street: street,streets
strength: strength
strengthen: strengthen,strengthened,strengthening
strenuous: strenuous
strenuously: strenuously
stress: stress
stretch: stretch,stretched,stretches,stretching
strew: strewn
stricken: stricken
strict: strict
stride: strode
strike: strike,strikes,striking,struck
striking: striking
string: string,strings,strung
strip: strip,stripped,strips
stripe: stripes
stripes: stripes
strive: strive,striving
stroke: stroke,stroked
stroll: stroll,strolled
strong: strong,stronger,strongest
structure: structure
struggle: struggle,struggled,struggles,struggling
stubble: stubble
stud: studded
student: student
study: studied,studies,study,studying
stuff: stuff,stuffed
stuffy: stuffy
stumble: stumbled
stunned: stunned
stupendous: stupendous
stupid: stupid
stupidity: stupidity
stupidly: stupidly
stupor: stupor
sturdy: sturdy
style: style
suave: suave,suavest
suavely: suavely
suavity: suavity
subcutaneous: subcutaneous
subdue: subdued,subduing
subject: subject,subjects
subjective: subjective
subjectively: subjectively
sublime: sublime
submit: submit
subscribe: subscribe
substitute: substitute
subtle: subtle
subtly: subtly
suburban: suburban
succeed: succeed,succeeded,succeeding
success: success
successful: successful
succumb: succumbed
suck: suck,sucked
sudden: sudden
suddenly: suddenly
suffer: suffer,suffered,suffering,suffers
sufferer: sufferer,sufferers
suffering: suffering
suffice: suffice
sufficient: sufficient
suffocate: suffocate
suffuse: suffused
suffusion: suffusion
sugar: sugar
suggestion: suggestion
suicide: suicide
suit: suit,suited
suitability: suitability
suitable: suitable
suite: suite
sulky: sulky
sullen: sullen
sullenness: sullenness
sulphurous: sulphurous
sultry: sultry
sum: sum,summed,sums
summer: summer
summertime: summertime
summit: summit
summon: summon,summoned
summons: summons
summut: summut
sun: sun
sunburst: sunburst
sunday: sunday
sundown: sundown
sunlight: sunlight
sunny: sunny
sunrise: sunrise
sunset: sunset
sunshine: sunshine
sunt: sunt
supercargo: supercargo
superficial: superficial
superintendent: superintendent
superior: superior
superiority: superiority
superstition: superstition,superstitions
superstitious: superstitious
supper: supper
supplement: supplement
supplication: supplication
supply: supplied,supply
support: support,supported
suppose: suppose,supposed
supposition: supposition
suppress: suppress,suppressed
supremely: supremely
surely: surely
surface: surface
surge: surging
surgeon: surgeon
surgical: surgical
surly: surlier,surly
surmise: surmise,surmises
surprise: surprise,surprised
surprised: surprised
surrender: surrender
surround: surround,surrounded
surroundings: surroundings
survey: survey
survive: survive,survived
suspect: suspect,suspected
suspense: suspense
suspicion: suspicion,suspicions
suspicious: suspicious
suspiciously: suspiciously
sussex: sussex
sustaining: sustaining
swales: swales
swallow: swallow,swallowed
swamp: swamp
swan: swan
swarm: swarm
sway: sway,swayed,swaying
swear: swear,swears,swore,sworn
sweat: sweat,sweated
sweep: sweep,sweeps,swept
sweeping: sweeping
sweet: sweet,sweeter
sweetly: sweetly
sweetness: sweetness
swell: swell,swelled
swelling: swelling
swift: swift
swiftly: swiftly
swiftness: swiftness
swing: swing,swings,swung
swirl: swirl,swirled,swirling
swirling: swirling
switzerland: switzerland
swollen: swollen
swoon: swoon,swooned
swoop: swooped
sword: sword,swords
symbol: symbol,symbols
symbolic: symbolic
sympathetic: sympathetic
sympathise: sympathise
sympathy: sympathy
symptom: symptom,symptoms
synonymous: synonymous
systematic: systematic
systematically: systematically
table: table,tables
tablet: tablets
tacit: tacit
tackle: tackled
tail: tail,tails
taint: taint,tainted
taketh: taketh
tale: tale,tales
talent: talent
talisman: talisman
talk: talk,talked,talking,talks
talkative: talkative
tall: tall
tally: tally
tame: tame,tamed,taming
tamer: tamers
tangible: tangible
tap: tap,tapped,tapping
tarnished: tarnished
task: task,tasks
taste: taste,tasted,tastes
tate: tate
tattered: tattered
tax: tax,taxes
tea: tea
teach: taught,teach,teaching
teacher: teacher
teaching: teaching,teachings
team: team,teaming,teams
teapot: teapot
tear: tear,tearing,tears,tore,torn
technical: technical
teem: teeming,teems
telegram: telegram,telegrams
telegraph: telegraph,telegraphed
telephone: telephoned
tellin: tellin
telling: telling
temper: temper,tempered
temperament: temperament
tempest: tempest
temple: temple,temples
tempt: tempt,tempted,tempting
temptation: temptation
tend: tend
tendency: tendencies
tender: tender
tenderly: tenderly
tenderness: tenderness
tennis: tennis
tense: tenses
tension: tension
tenth: tenth
term: term,terms
terrace: terrace
terrestrial: terrestrial
terrible: terrible
terribly: terribly
terrier: terriers
terrific: terrific
terrified: terrified
terrify: terrified
terror: terror,terrors
terry: terry
testamentary: testamentary
testily: testily
tether: tethered,tethers
texas: texas
thames: thames
thankful: thankful
thankfully: thankfully
thankfulness: thankfulness
theatre: theatre
theer: theer
theme: theme,themes
theory: theories,theory
therapeutics: therapeutics
thereinto: thereinto
thereon: thereon
thesis: thesis
thinking: thinking
thirst: thirst
thirsty: thirsty
thither: thither
thocht: thocht
thomas: thomas
thor: thor
thorn: thorn
thorny: thorny
thort: thort
thoughtful: thoughtful
thoughtfully: thoughtfully
thoughtlessness: thoughtlessness
thrall: thrall
thread: thread,threads
threat: threats
threaten: threaten,threatened
threatening: threatening
threshold: threshold
thrill: thrill,thrilled
thrilling: thrilling
thrive: thrive
throat: throat,throats
throb: throbbing
throw: threw,throw,throwing,thrown,throws
thrust: thrust
thud: thud
thumb: thumb
thunder: thunder
thunderous: thunderous
thunderstruck: thunderstruck
thursday: thursday
thwart: thwart,thwarted,thwarting
ticket: ticket,tickets
tickle: tickle
tide: tide,tides
tiding: tidings
tidy: tidied,tidy,tidying
tie: tie,tied
tiger: tiger,tigers
tight: tight
tighten: tightened,tightens
tightening: tightening
tightly: tightly
tiller: tiller
timber: timber
time: time,times
times: times
ting: ting
tinge: tinge,tinged,tinges
tingle: tingle,tingling
tinkle: tinkle
tint: tints
tiny: tiniest,tiny
tiptoe: tiptoe
tire: tired
tired: tired
tireless: tireless
tissue: tissue
title: title,titles
toad: toads
tobacco: tobacco
toe: toe,toes
toil: toil,toiled,toils
toilet: toilet
tokay: tokay
token: token
tolerably: tolerably
tolerant: tolerant
tolerate: tolerate
toleration: toleration
toll: toll
tolling: tolling
tom: tom
tomb: tomb,tombs
tombstone: tombstone,tombstones
tone: tone,tones
tongue: tongue,tongues
tool: tool,tools
toom: toom
tooth: teeth
topic: topic
torn: torn
torrent: torrent
tortoise: tortoise
torture: torture,torturing
tortured: tortured
toss: tossed,tossing
tot: tots
total: totals
touch: touch,touched,touches,touching
touching: touching
tough: tough
tour: tour
touter: touters
towel: towel
tower: tower,towered
town: town,towns
trace: trace,traced,traces
track: track
trade: trade,traded,trades
trademark: trademark
tradition: tradition,traditions
traffic: traffic
tragedy: tragedy
trail: trail,trailed,trailing
train: train,trained,trains
tramp: tramp,tramping
trance: trance
tranquil: tranquil
transaction: transaction
transcendentalism: transcendentalism
transcribe: transcribe,transcribing
transcript: transcript
transcription: transcription
transfer: transfer
transference: transference
transfix: transfixed
transform: transform,transformed
transfuse: transfused
transfusion: transfusion
translate: translated
transparent: transparent
transylvanian: transylvanian
trap: trap,traps
travel: travel,travelled,travelling
traveller: traveller,travellers
travels: travels
travesty: travesty
tread: tread,trod
treasure: treasure,treasured
treat: treat,treated
treatment: treatment
treaty: treaty
tree: tree,trees
tremble: tremble,trembled,trembling
tremor: tremor
tremulous: tremulous
trenchant: trenchant
trephine: trephine
trephining: trephining
trial: trial
tribe: tribe
trick: trick,tricks
trickle: trickled,trickling
trifle: trifle,trifling
trim: trim
trip: trip,tripped,tripping,trips
tripper: trippers
trituration: trituration
triumph: triumph
triumphant: triumphant
triumphantly: triumphantly
trivial: trivial
troops: troops
tropics: tropics
trouble: trouble,troubled,troubles,troubling
troubled: troubled
trough: troughs
trousers: trousers
truck: truck
true: true,truest
truism: truism
trumpet: trumpet
trunk: trunk
trust: trust,trusted,trusting,trusts
truth: truth,truths
tub: tubs
tuck: tucked
tumble: tumble,tumbled,tumbling
tumult: tumult
tumultuous: tumultuous
tune: tune,tuned
tunnel: tunnel
turk: turk
turkey: turkey
turkish: turkish
turks: turks
turnscrew: turnscrew
tussock: tussock
twa: twa
twilight: twilight
twine: twined
twinkle: twinkled
twist: twisted
twitch: twitched
twitter: twittering
tyke: tyke,tyking
type: type,typed,types
typescript: typescript
typewrite: typewrite,typewriting,typewritten
typewriter: typewriter
typewritten: typewritten
typical: typical
typify: typified
ud: ud
ugly: ugly
ugric: ugric
ultimate: ultimate
ultimately: ultimately
unable: unable
unasked: unasked
unattended: unattended
unavailing: unavailing
unavailingness: unavailingness
unaware: unaware
unawares: unawares
unbroken: unbroken
uncanny: uncanny
unceasing: unceasing
uncertain: uncertain
unchanged: unchanged
unchecked: unchecked
unclad: unclad
unclean: unclean
uncommon: uncommon
uncommonly: uncommonly
uncommunicative: uncommunicative
unconcern: unconcern
unconscious: unconscious
unconsciously: unconsciously
undergarment: undergarment
undergo: undergoing,undergone,underwent
underground: underground
underlie: underlying
underlip: underlip
understand: understand,understood
understanding: understanding
undertake: undertake
undertaker: undertaker
undeveloped: undeveloped
undisciplined: undisciplined
undiscovered: undiscovered
undo: undo,undone
undoubtedly: undoubtedly
undress: undress,undressed,undressing
undulating: undulating
unduly: unduly
uneasily: uneasily
uneasiness: uneasiness
uneasy: uneasy
unenforceability: unenforceability
unequalled: unequalled
unexpected: unexpected
unexpectedly: unexpectedly
unfairly: unfairly
unfettered: unfettered
unfitting: unfitting
unfold: unfold
unfriendly: unfriendly
ungracious: ungracious
ungrateful: ungrateful
unhallow: unhallowed
unhallowed: unhallowed
unhappily: unhappily
unhappy: unhappy
unharmed: unharmed
unheard: unheard
unhesitatingly: unhesitatingly
unhinge: unhinged
unholy: unholy
unhook: unhook,unhooked
unhuman: unhuman
unhurt: unhurt
uniform: uniform
union: union
unique: unique
unison: unison
unite: united
united: united
unity: unity
universal: universal
universally: universally
universe: universe
university: university
unknowing: unknowing
unknowingly: unknowingly
unknown: unknown
unlink: unlink
unload: unloaded
unlock: unlocked
unlucky: unlucky
unmask: unmask
unmercifully: unmercifully
unmistakable: unmistakable
unmounted: unmounted
unmoved: unmoved
unmoving: unmoving
unnatural: unnatural
unnecessary: unnecessary
unnerve: unnerve
unnerved: unnerved
unobserved: unobserved
unopened: unopened
unpleasantness: unpleasantness
unprepared: unprepared
unprotected: unprotected
unpunctual: unpunctual
unquestionable: unquestionable
unreal: unreal
unreality: unreality
unrecorded: unrecorded
unrest: unrest
unscrew: unscrew
unseal: unsealed
unsearched: unsearched
unseat: unseat
unseen: unseen
unselfish: unselfish
unselfishness: unselfishness
unshed: unshed
unsolicited: unsolicited
unspeakable: unspeakable
unspiritual: unspiritual
unstained: unstained
unsteered: unsteered
untellable: untellable
untenanted: untenanted
unthinking: unthinking
unthinkingly: unthinkingly
untouched: untouched
untrembling: untrembling
untrue: untrue
unturned: unturned
unusual: unusual
unusually: unusually
unutterable: unutterable
unutterably: unutterably
unvaried: unvaried
unwisely: unwisely
unwonted: unwonted
unworthy: unworthy
unwound: unwound
update: updated
upholstery: upholstery
upright: uprights
upset: upset
upside: upside
upstairs: upstairs
urbane: urbane
urge: urged,urging
urgent: urgent
useless: useless
user: user
usual: usual
ut: ut
utmost: utmost
utter: utter
utterance: utterance
utterly: utterly
vague: vague
vain: vain
valley: valley,valleys
valuable: valuable
vampire: vampire,vampires
van: van
vanilla: vanilla
vanish: vanish,vanished
vanity: vanity
vaporous: vaporous
vapour: vapour
variance: variance
varied: varied
variety: varieties,variety
varna: varna
vast: vast
vastly: vastly
vastness: vastness
vault: vault,vaulted,vaults
vehicle: vehicle
veil: veil
vein: vein,veins
veins: veins
velvet: velvet
velvety: velvety
vendor: vendor,vendors
vengeance: vengeance
vent: vent
venture: ventured
verb: verb
verbatim: verbatim
verdict: verdict
verge: verge
verify: verified
veritable: veritable
vernacular: vernacular
version: version
vertebra: vertebra
vessel: vessel
viaduct: viaduct
vibrate: vibrate
vice: vice
vicious: vicious
victim: victim,victims
victoria: victoria
victorious: victorious
victory: victory
vienna: vienna
view: view,viewed,viewing,views
vigil: vigil
vigorous: vigorous
vigour: vigour
vii: vii
viii: viii
viking: viking
vile: vile
vilely: vilely
village: village,villages
villainy: villainy
ville: ville
vincent: vincent
vindictive: vindictive
violate: violate,violates
violence: violence,violences
violent: violent
violet: violet
viper: vipers
virgin: virgin
virtue: virtue,virtues
virus: virus
visible: visible
visit: visit,visited,visiting,visits
vital: vital
vitality: vitality
vitally: vitally
vivacity: vivacity
vivid: vivid
vivify: vivify
vivisection: vivisection
vocation: vocation
voice: voice,voices
void: void
voivode: voivode
volcanic: volcanic
volcano: volcanoes
volition: volition
volume: volumes
voluntarily: voluntarily
volunteer: volunteer,volunteered,volunteers
voluptuous: voluptuous
voluptuousness: voluptuousness
vote: vote
vouch: vouched
voyage: voyage
vulgar: vulgar
vulgarise: vulgarised
vulpine: vulpine
wad: wad
wafer: wafer
waft: wafts
wag: wag,wagging
wages: wages
wagon: wagon,wagons
wail: wail,wailed,wailing
waist: waist
waistcoat: waistcoat,waistcoats
wait: wait,waited,waiting,waits
waiter: waiter
waiting: waiting
wake: wake,waked,wakes,waking,woke
wakeful: wakeful
waken: waken,wakened
walk: walk,walked,walking,walks
walker: walkers
walking: walking
wall: wall,walls
wallach: wallach
walled: walled
waltz: waltz
wan: wan
wander: wander,wandering
wanton: wanton
wantonness: wantonness
war: war,wars
ward: ward,wards
wardrobe: wardrobe
warlike: warlike
warm: warm,warmed
warmly: warmly
warmth: warmth
warn: warn,warned,warning
warning: warning,warnings
warningly: warningly
warrant: warrant
warranty: warranties,warranty
wary: wary
wash: washed,washing
waste: waste,wasted,wasting
watch: watch,watched,watches,watching
watcher: watchers
watching: watching
watchman: watchman
water: water,watered,waters
waterloo: waterloo
waterway: waterway
wave: wave,waved,waves,waving
wavy: wavy
wax: wax
waxen: waxen
weak: weak,weaker,weakest
weaken: weaken,weakened,weakening
weakly: weakly
weakness: weakness,weaknesses
wealth: wealth
weapon: weapon,weapons
wear: wear,wearing,wore,worn
wearied: wearied
wearily: wearily
weary: weary
weather: weather
weatherworn: weatherworn
weave: woven
wedding: wedding
wednesday: wednesday
wee: wee
week: week,weeks
weep: weep,weeping,weeps,wept
weepy: weepy
weigh: weighed,weighing,weighs
weight: weight,weighted,weights
weird: weird
west: west
western: western
westminster: westminster
westward: westward
westwards: westwards
wet: wet,wetted
whale: whale
wharf: wharf
whatsoever: whatsoever
wheel: wheel,wheeled,wheeling,wheels
wheeler: wheeler
whereat: whereat
wherefore: wherefore
whereon: whereon
whet: whet,whetting
whiff: whiff
whinny: whinnied
whip: whip,whips
whirl: whirl,whirled,whirling,whirls
whirling: whirling
whirlpool: whirlpool
whisper: whisper,whispered,whispering,whispers
whistle: whistle,whistled,whistles
whit: whit
white: white,whiter
whiten: whitening
whiteness: whiteness
whites: whites
whithersoever: whithersoever
whitish: whitish
wholesome: wholesome
wi: wi
wicked: wicked
wickedly: wickedly
wickedness: wickedness
wide: wide,wider,widest
widen: widening,widens
widespread: widespread
widow: widow
wife: wife,wives
wild: wild,wilder
wilder: wilder
wilderness: wilderness
wildest: wildest
wildly: wildly
wile: wile
wiles: wiles
wilhelmina: wilhelmina
willingly: willingly
wily: wily
win: win,winning
wince: wince
winchester: winchester
wind: wind,winding,winds,wound
window: window,windows
windows: windows
windpipe: windpipes
wine: wine
wing: wing,wings
wink: wink,winked
winning: winning
winningly: winningly
winter: winter
wipe: wipe,wiped,wiping
wire: wire,wires
wisdom: wisdom
wise: wise,wiser,wisest
wisely: wisely
wishful: wishful
wisp: wisp
wit: wit,wits
witch: witch,witches
withal: withal
withdraw: withdraw,withdrawn,withdrew
withered: withered
witness: witness
wizard: wizards
woe: woe,woes
woeful: woeful
woefully: woefully
wold: wolds
wolf: wolf,wolfs,wolves
woman: woman,women
women: women
womenkind: womenkind
wonderful: wonderful
wonderfully: wonderfully
wondrous: wondrous
wood: wood,woods
wooden: wooden
woodhouse: woodhouse
woods: woods
woodwork: woodwork
word: word
workbasket: workbasket
workman: workman,workmen
worn: worn
worried: worried
worry: worried,worry
worship: worship,worshipped
worth: worth
worthless: worthless
worthy: worthy
wot: wot
wound: wound,wounded,wounds
wounded: wounded
wrap: wrap,wrapped,wraps
wrapper: wrapper
wrapping: wrapping
wrath: wrath
wreath: wreath,wreaths
wreathe: wreathed
wreck: wreck,wrecked
wrench: wrench,wrenched,wrenching
wretch: wretch
wretched: wretched
wring: wring,wrung
wringing: wringing
wrinkle: wrinkled,wrinkles
wrist: wrist,wrists
write: write,writes,writing,written,wrote
writer: writers
writhe: writhed,writhing
writing: writing
wrong: wrong,wronged,wrongs
wry: wry
wynd: wynds
xi: xi
xii: xii
xiii: xiii
xiv: xiv
xix: xix
xvi: xvi
xvii: xvii
xviii: xviii
xx: xx
xxi: xxi
xxii: xxii
xxiii: xxiii
xxiv: xxiv
xxv: xxv
yard: yard,yards
yarn: yarns
yawing: yawing
yearn: yearn
yearning: yearning
yell: yell,yelling
yellow: yellow,yellowed
yelping: yelping
yer: yer
yesterday: yesterday
yew: yew,yews
yield: yield,yielded,yielding,yields
yoke: yoke
york: york
yorkshire: yorkshire
youth: youth
youthful: youthful
yus: yus
zeal: zeal
zealous: zealous
zoo: zoo
