aback: aback
abandon: abandon,abandoned
abe: abe
abeam: abeam
ablaze: ablaze
aboard: aboard
abominable: abominable
abraham: abraham
absence: absence,absences
absent: absent
absolute: absolute
absurd: absurd
absurdly: absurdly
accent: accent
accident: accident,accidents
accidental: accidental
accompany: accompanied
accomplice: accomplices
accomplish: accomplish
accomplishment: accomplishment
account: account,accounts
accoutrement: accoutrement
accuracy: accuracy
accurate: accurate
accursed: accursed
accuse: accused
accustom: accustomed
ace: ace
ache: ache,ached
achievement: achievements
acknowledge: acknowledging
acquaintance: acquaintance
acquiescence: acquiescence
acre: acre
action: action
active: active
actual: actual
add: add,adding
addition: addition,additions
address: addressed,addressing
adjoin: adjoining
admirable: admirable
admirably: admirably
admiral: admiral
admiration: admiration
admire: admire
admiringly: admiringly
admit: admitted
admixture: admixture
adopt: adopt
adrift: adrift
advance: advance,advanced,advancing
advantage: advantage
adventure: adventure,adventures
adversary: adversary
advice: advice
affair: affair,affairs
affect: affect
affectionate: affectionate
afford: afford
affy: affy
afire: afire
afloat: afloat
afoot: afoot
afraid: afraid
afresh: afresh
aft: aft
afternoon: afternoon
age: age
agile: agile
agin: agin
agitated: agitated
agone: agone
agony: agony
agree: agreed
agreeable: agreeable
ague: ague
ahoy: ahoy
aid: aid
aim: aim,aimed,aiming,aims
air: air,airs
airily: airily
airy: airy
alan: alan
alarm: alarm,alarmed,alarms
alarmed: alarmed
alarming: alarming
ale: ale
alert: alert
alexander: alexander
alight: alighted
alike: alike
alive: alive
allowance: allowance
ally: allies,ally
aloft: aloft
aloud: aloud
alow: alow
alteration: alteration
altogether: altogether
amassing: amassing
ambiguity: ambiguity
ambush: ambush,ambushed,ambushes
amen: amen
america: america
american: american
amidship: amidships
amiss: amiss
ammunition: ammunition
amphitheatre: amphitheatre
ample: ample
amuck: amuck
anchor: anchor,anchored
anchorage: anchorage
ancient: ancient
anderson: anderson
anecdote: anecdote
anger: anger
angle: angle,angles
angrily: angrily
angry: angry
animal: animals
ankle: ankle
annoy: annoyed
annoyance: annoyance
annoyingly: annoyingly
answer: answer,answered,answers
antelope: antelopes
anticipation: anticipations
anxiety: anxiety
anxious: anxious
anxiously: anxiously
aperture: aperture
apiece: apiece
apologetically: apologetically
apology: apology
apoplectic: apoplectic
apoplexy: apoplexy
apparition: apparition
appeal: appeal
appearance: appearance
appears: appears
append: appended
appetite: appetite,appetites
apple: apple,apples
apply: applied
apprehension: apprehension,apprehensions
apprentice: apprentice
approach: approach,approached,approaching
approval: approval
arch: arch
archbishop: archbishops
argue: argued,arguing
argument: argument
arm: arm,arms
armchair: armchair
armed: armed
armpit: armpit
aroma: aroma
arouse: aroused
arrange: arrange,arranging
arrangement: arrangement,arrangements
arrant: arrant
arrival: arrival
arrive: arrive,arrived
arrow: arrow
art: art
article: articles
artificial: artificial
artly: artly
ascend: ascend
ascent: ascent
ascertain: ascertain
ash: ash,ashes
ashamed: ashamed
ashen: ashen
ashore: ashore
asleep: asleep
ass: ass,asses
assailant: assailant,assailants
assault: assault
assistance: assistance
assizes: assizes
assurance: assurance
assure: assure,assured
astern: astern
astonishment: astonishment
athwart: athwart
atmosphere: atmosphere
atrocious: atrocious
attack: attack,attacked,attacking
attempt: attempt,attempting,attempts
attend: attend
attention: attention
attitude: attitude
attract: attracted
audible: audible
august: august
author: author
autumn: autumn
avast: avast
avenue: avenue
avoid: avoid,avoided
avow: avowed
await: await,awaited
awake: awake,awaking,awoke
awaken: awakened
aware: aware
awful: awful
awhile: awhile
awkward: awkward
ax: ax,axing
axe: axe
axis: axes
aye: aye
azalea: azalea
babble: babbling
babby: babby
baccy: baccy
bachelor: bachelors
backstay: backstay
bacon: bacon
bad: bad,worse,worst
badly: badly
baffle: baffling
bag: bag,bags
bail: bail
bailey: bailey
bake: baked,baking
balance: balance,balanced,balancing
bald: bald
bale: baled,bales
ball: ball,balls
ballad: ballad
bandage: bandage,bandages
bandaged: bandaged
bandoleer: bandoleer
bang: banged,banging
bank: bank,banks
banker: banker
banner: banner
bar: bar,barring,bars
barbecue: barbecue
bare: bare
bargain: bargain,bargained,bargains
bark: bark,barked
barn: barn
barrel: barrel,barrels
barrelled: barrelled
barrow: barrow
basin: basin
basket: basket
bated: bated
bathe: bathe
batten: batten
battle: battle
bay: bay,bays
beach: beach,beached,beaches
bead: beaded
beam: beam,beaming
bear: bear,bearing,bore,born
bearer: bearer
bearing: bearing,bearings
beat: beat,beaten,beating,beats
beautiful: beautiful
becalm: becalmed
bed: bed,beds
beetle: beetling
befall: befall
beg: begged,begging
beggar: beggar
behave: behaved
behaviour: behaviour
behold: beheld,behold
belay: belay
belief: belief
bell: bell,bells
bellow: bellowed
belly: belly
belong: belonged
belt: belt
ben: ben
bench: bench
bend: bend,bending,bent
beneath: beneath
benefit: benefit
benjamin: benjamin
bent: bent
berry: berries
berth: berth,berthed,berths
besieger: besiegers
bestow: bestowed
betray: betrayed
bewilder: bewildered
bible: bible,bibles
bid: bade,bid,bidden,bidding
bidding: bidding
bigness: bigness
bilge: bilge
billow: billows
billy: billy
bind: bind,bound
bird: bird,birds
birthday: birthday
biscuit: biscuit,biscuits
bishop: bishop
bit: bit,bits
bite: bite,biting,bitten
bitter: bitter
bitterly: bitterly
blabbed: blabbed
blabbing: blabbing
black: black,blacks
blackbeard: blackbeard
blacken: blackened
blacker: blacker
blackness: blackness
blade: blade,blades
blame: blame,blamed
bland: bland
blandly: blandly
blank: blank
blast: blasts
blaze: blaze,blazed,blazes
bleared: bleared
bleed: bled,bleeding
bleeding: bleeding
bless: bless,blessed
blessed: blessed
blind: blind
blindfold: blindfold
blindness: blindness
blink: blinking
block: block,blocks
blond: blond
blood: blood,bloods
bloodthirsty: bloodthirstiest
bloody: bloody
blot: blot
blow: blew,blow,blowing,blown,blows
blue: blue
blues: blues
bluff: bluff
blunder: blundered
blunt: blunt
blur: blur
board: board,boarded,boards
boarder: boarder,boarders
boarding: boarding
boast: boast,boasting
boat: boat,boats
boatswain: boatswain
bodily: bodily
body: bodies,body
bog: bog
boil: boil,boiling
bold: bold,bolder
bolt: bolt,bolted
bolus: bolus
bombardment: bombardment
bone: bones
bones: bones
bonfire: bonfire
book: book,books
bookcase: bookcases
boom: boom,booming,booms
boot: boots
booty: booty
boozy: boozy
border: borders
bore: bore,bored
bosom: bosom
bottle: bottle,bottles
bough: bough,boughs
bounce: bounce,bouncing
bound: bound,bounded,bounding
bout: bout
bow: bow,bows
bowl: bowls
bowling: bowling
bowsprit: bowsprit
bowstring: bowstring
box: box,boxed
boy: boy,boys
brace: brace
brain: brain,brains
bramble: brambles
bran: bran
branch: branch,branches
brand: brand,branded
brandy: brandy
brass: brass
brave: brave,bravest
bravo: bravo
bread: bread
break: break,breaking,broke,broken
breaker: breaker,breakers
breakfast: breakfast,breakfasted,breakfasting
breast: breast
breasted: breasted
breath: breath
breathe: breathe,breathed,breathing
breathlessly: breathlessly
breeches: breeches
breeze: breeze
brew: brewed
bribe: bribe
bridge: bridge
brier: briers
bright: bright
brighten: brightened
brightness: brightness
bring: bring,bringing,brings,brought
brisk: brisk,brisker
briskly: briskly
bristle: bristling
bristol: bristol
british: british
britons: britons
broach: broached
broad: broad
broadcloth: broadcloth
broadside: broadside
broken: broken
brood: brooded
broom: broom
brow: brow,brows
brown: brown
brush: brush,brushed
brute: brutes
bubble: bubbled,bubbling
buccaneer: buccaneer,buccaneering,buccaneers
buck: bucking
bucket: bucket
buckle: buckled
budge: budge
build: build,built
building: building,buildings
bulk: bulk
bulkhead: bulkhead,bulkheads
bull: bull
bullet: bullet,bullets
bully: bully,bullying
bulrush: bulrushes
bulwark: bulwark,bulwarks
bumboat: bumboat
bunch: bunch
bundle: bundle
bungle: bungled
bungling: bungling
bunk: bunk
buoy: buoy
buoyant: buoyant
burly: burly
burn: burn,burned,burning,burnt
burnish: burnished
burst: burst
burthen: burthened
bury: buried
bush: bush,bushes
business: business
bust: busts
bustle: bustle,bustling
busy: busiest,busy
butcher: butcher
butt: butt
button: buttons
bye: bye
bygones: bygones
cabin: cabin,cabins
cable: cable,cables
cache: cache
cage: cage
cain: cain
cake: caking
calculate: calculate
calf: calf
callous: callous
calm: calm
calmly: calmly
calumny: calumnies
camp: camp,camped
campaign: campaign
candle: candle
canikin: canikin
cannibal: cannibals
cannikin: cannikin
cannon: cannon
cannonade: cannonade
cannonball: cannonball
canting: canting
canvas: canvas
cap: cap
capable: capable
cape: cape
capital: capital
capsize: capsized
capstan: capstan
captain: captain
captor: captors
capture: capture
carcass: carcass,carcasses
card: card
care: care
careen: careen
careful: careful
carefully: carefully
careless: careless
carelessly: carelessly
cargo: cargo
carouse: carousing
carpenter: carpenter
carpet: carpet
carriage: carriages
carry: carried,carry,carrying
cart: carts
cask: cask
cassandra: cassandra
cast: cast,casting
castle: castle
cat: cat,cats
catch: catch,caught
catechism: catechism
caulker: caulker
caution: caution
cavalier: cavalier
cave: cave
cease: cease,ceased,ceasing
cellar: cellar
cemetery: cemetery
centre: centre
certainty: certainty
cession: cession
chain: chains
chair: chair
chance: chance,chances
change: change,changed,changing
changed: changed
chapel: chapel
chaplain: chaplain
character: character,characters
charge: charge,charged,charging
charity: charity
charming: charming
chart: chart
chase: chase
chat: chatting
chatter: chattered
cheaply: cheaply
cheat: cheated
cheek: cheek,cheeks
cheer: cheer,cheered,cheers
cheerful: cheerful
cheerily: cheerily
cheery: cheeriest
cheese: cheese
chequer: chequered
chest: chest
chicken: chicken
chief: chief,chiefs
chieftain: chieftain
child: child,children
childish: childish
chill: chill
chilled: chilled
chimney: chimney
chin: chin
chine: chine
chink: chink
chirp: chirp
choice: choice,choicest
choke: choked
choose: choose,chose,chosen
choosing: choosing
chorus: chorus
christen: christened
christian: christian
chuck: chuck,chucked
chuckle: chuckle
church: church
circle: circling
circuit: circuit
circumspectly: circumspectly
circumstance: circumstance,circumstances
city: city
civil: civil
civility: civility
clacking: clacking
claim: claim
clamber: clambered,clambering
clap: clap,clapped
clapping: clapping
clash: clash
clasp: clasp
clasped: clasped
class: class
classic: classic
clatter: clattering
clause: clause
claw: clawed
clay: clay
clean: clean,cleaned
cleaning: cleaning
cleanly: cleanly
cleanse: cleansing
clearing: clearing
cleft: cleft,clefts
clench: clenching
clever: clever
cleverness: cleverness
cliff: cliffs
cliffy: cliffy
climate: climate
climb: climb,climbed,climbing
cling: cling,clung
clink: clinked
clip: clipping
cloak: cloak
clock: clock
close: close,closed,closer
closed: closed
closely: closely
cloth: cloth
clothe: clothed
clothes: clothes
clothing: clothing
cloud: cloud,clouds
cloudless: cloudless
clove: clove
clue: clue
clump: clump,clumps
clumsy: clumsy
clustering: clustering
coach: coach
coal: coals
coarsely: coarsely
coast: coast,coasts
coat: coat,coats
cock: cock,cocks
cocked: cocked
cockerel: cockerel
cockroach: cockroach
cognac: cognac
coil: coil
coin: coin,coins
coinage: coinage
cold: cold,coldest
collapse: collapsed
collect: collected,collecting
collection: collection
college: college
colour: colour,coloured,colours
colouring: colouring
coltish: coltish
column: column,columns
comb: combing
combine: combined
comeliness: comeliness
comfort: comfort,comforted
comical: comical
command: command,commanded,commands
commander: commander
commentary: commentary
common: common
communicate: communicated
compact: compact
companion: companion,companions
company: company
comparative: comparative
compass: compass,compasses
competent: competent
complain: complained
complaint: complaint
complete: complete,completed
completely: completely
compliment: complimented
composure: composure
comprehend: comprehend
computation: computation
comrade: comrade,comrades
conceal: conceal,concealed,concealing
conceited: conceited
concern: concern
concession: concession
conclusion: conclusion
condescending: condescending
condition: condition
conduct: conduct
confess: confess,confessed
confession: confession,confessions
confidant: confidant
confidence: confidence,confidences
confidential: confidential
configuration: configuration
confound: confound,confounded
confoundedly: confoundedly
confront: confront
confusion: confusion
congregate: congregated
conical: conical
connive: connived
connoisseur: connoisseur
conquest: conquest
conscience: conscience
conscious: conscious
consciousness: consciousness
consent: consent
consequence: consequence
considerable: considerable
consort: consort
conspicuous: conspicuous
conspirator: conspirators
constant: constant
consult: consult,consulting
consultation: consultation
contemptuously: contemptuously
contend: contend
content: content
continual: continual
continually: continually
continue: continued
continuous: continuous
continuously: continuously
contorted: contorted
contortion: contortions
contrariety: contrariety
contrary: contrary
contrast: contrast,contrasted
contribute: contributed
contrived: contrived
convenient: convenient
conversation: conversation
convince: convinced
convinced: convinced
cook: cook,cooked,cooking
cooking: cooking
cool: cool,coolest,cooling
coolly: coolly
coolness: coolness
cooper: cooper
copper: copper,coppers
coracle: coracle
coral: coral
cord: cord,cords
cordage: cordage
cordial: cordial
corn: corns
corner: corner,corners
corpse: corpse
corruption: corruption
corso: corso
cost: cost
cottage: cottage
cough: coughing
council: council,councils
count: count,counting
countenance: countenance
counter: counter
countless: countless
country: countries,country
couple: couple
courage: courage
court: court
cove: cove
cover: cover,covered
covered: covered
covering: covering
cow: cowed
coward: coward,cowards
cowardice: cowardice
cowardly: cowardly
coxswain: coxswain
crack: crack,cracked,cracking
craft: craft
craftily: craftily
crag: crag,crags
craggy: craggy
crane: craning
crash: crashing
crave: crave
crawl: crawl,crawled,crawling
crazy: crazy
creak: creak,creaking
creation: creations
creature: creature
credit: credit
creep: creeping,crept
creeper: creeper
crew: crew,crews
cricket: cricket
crime: crime,crimes
cripple: cripple
crippled: crippled
crisis: crisis
croak: croaking
crooked: crooked
crop: cropped
cross: cross,crossed,crosses,crossing
crossley: crossley
crouching: crouching
crow: crow
crowd: crowd
crown: crown
crucifix: crucifix
cruel: cruel
cruelly: cruelly
cruelty: cruelty
cruise: cruise,cruising
crumb: crumb
crush: crushed
crutch: crutch
cub: cub
cumberland: cumberland
cunning: cunning
cure: cure,cured
curiosity: curiosity
curious: curious
curiously: curiously
curl: curled
current: current
curse: curse,cursed,curses,cursing
cursed: cursed
curtain: curtains
curtained: curtained
custom: custom
customer: customer,customers
cut: cut
cutlass: cutlass,cutlasses
cutter: cutter
cutwater: cutwater
daddle: daddle
dagger: dagger
daily: daily
dainty: dainty
dale: dale
dally: dally
damage: damage
damp: damp,damping
dance: dance
dancing: dancing
danger: danger,dangers
dangerous: dangerous
darby: darby
daring: daring
dark: dark
darken: darkened,darkening
darkness: darkness
dart: darting
dash: dash,dashed,dashes
daub: daubed
david: david
davis: davis
davy: davy
dawn: dawn
day: day,days
daybreak: daybreak
daylight: daylight
daze: dazed
dead: dead
deadly: deadly
deal: deal
deary: deary
death: death
debt: debts
deceive: deceived
deception: deception
decide: decide,decided
deck: deck,decks
declare: declare,declared,declaring
decline: decline
dedicate: dedicated
deed: deed,deeds
deep: deep
deeply: deeply
deer: deer
defeat: defeated
defence: defence,defences
defenceless: defenceless
defend: defend
defender: defenders
deform: deformed
defy: defies
degree: degrees
delay: delay,delayed,delaying
deliberately: deliberately
delicacy: delicacies
delicate: delicate
delight: delight
delighted: delighted
delightful: delightful
dell: dell
demolish: demolished,demolishing
demon: demons
dense: dense
densely: densely
deny: denied,deny
depart: departed
departure: departure
depend: depended
dependent: dependent
deplore: deplore
depose: deposed
deposed: deposed
dereliction: dereliction
derision: derision
derisively: derisively
descend: descend,descended
description: description
desert: desert,deserted
deserted: deserted
desertion: desertion
deserve: deserve
design: design,designed
desire: desire,desired,desires
desirous: desirous
desisted: desisted
desolate: desolate
despair: despair
desperado: desperadoes
desperate: desperate
despise: despised
destination: destination
destine: destined
destroy: destroy,destroyed
determine: determined
detestable: detestable
detour: detour
deuce: deuce
develop: developed
devil: devil,devils
devoutly: devoutly
dexterity: dexterity
diabolical: diabolical
diagonal: diagonal
dice: dice
dick: dick
die: die,died
diet: diet
difficult: difficult
difficulty: difficulty
dig: dig,digging,dug
dignity: dignity
dilapidation: dilapidation
dilly: dilly
dimension: dimensions
diminished: diminished
dimly: dimly
dine: dine
dingle: dingle
dinner: dinner
dip: dip,dipping
direct: direct
direction: direction,directions
dirk: dirk
dirty: dirty
disaffect: disaffected
disappear: disappeared,disappears
disappears: disappears
disappointment: disappointment
disapproval: disapproval
disarray: disarray
disaster: disaster
disbelieve: disbelieved
discharge: discharged,discharging
discipline: discipline
disclose: disclosed,disclosing
discolour: discoloured
discomfort: discomfort
discontent: discontent
discover: discovered
discovery: discoveries
discuss: discuss,discussing
discussion: discussion
disgrace: disgrace
disgust: disgust
dish: dishes
dislodge: dislodged
dismiss: dismissed
dismount: dismount,dismounted
dispatch: dispatch,dispatched
disperse: dispersing
displace: displaced
displease: displeased
dispose: disposed
disposition: disposition
disquietude: disquietude
dissatisfied: dissatisfied
distance: distance
distant: distant
distinct: distinct
distinguish: distinguish
distress: distress,distressed
distressed: distressed
district: district,districts
disturb: disturb,disturbed
ditch: ditch
ditty: ditty
dive: dive,dived
diver: diver
diversity: diversity
divide: divide,divided,divides
divine: divined
divinity: divinity
dock: dock,docks
doctor: doctor,doctors
dodge: dodge,dodged,dodging
dog: dog,dogs
doggedly: doggedly
dogger: dogger
doit: doit
doldrums: doldrums
dolefully: dolefully
dollar: dollars
dolt: dolts
doo: doo
doom: doomed
door: door,doors
doorway: doorway
dose: dosed
dot: dot,dotted
double: double,doubled
doubloon: doubloons
doubly: doubly
doubt: doubt,doubted
douse: doused
downhearted: downhearted
downhill: downhill
downright: downright
downstairs: downstairs
doze: dozed
dozen: dozen,dozens
drag: drag,dragged
dragon: dragon
drain: drain
drake: drake
dram: dram
draught: draught,draughts
draw: draw,drawing,drawn,drew
dreadful: dreadful
dreadfully: dreadfully
dream: dream,dreamed,dreams
dreary: dreary
drench: drenched
dress: dress,dressed
drift: drift
drink: drank,drink,drinking,drinks,drunk
drinking: drinking
drip: dripping
drive: driven,drove
drone: drone
droning: droning
droop: droop
drooped: drooped
drop: drop,dropped,dropping
dropping: dropping
drown: drowned
drub: drub
drug: drugs
drunk: drunk
drunkard: drunkards
drunken: drunken
drunkenness: drunkenness
dry: dried,dry,drying
duck: duck,ducking
duff: duff
duke: duke
dull: dull
duly: duly
dumb: dumb
duplicity: duplicity
dusk: dusk
duskily: duskily
dust: dust
dutchman: dutchman,dutchmen
duty: duty
dwarf: dwarf
dwindle: dwindled
dysentery: dysentery
eagerness: eagerness
ear: ear,ears
earn: earned,earning
earnest: earnest
earnestly: earnestly
earring: earrings
earshot: earshot
earthquake: earthquakes
ease: ease
easily: easily
east: east,easting
easterly: easterly
eastern: eastern
eastward: eastward
eastwards: eastwards
easy: easier,easy
eat: ate,eat,eaten,eating
eatables: eatables
ebb: ebb
echo: echo,echoed,echoes
eddy: eddied
edge: edge,edges
eel: eel
effectual: effectual
effort: effort,efforts
egg: egg,eggs
eighth: eighth
elaborate: elaborate
elated: elated
elbow: elbow,elbows
elderly: elderly
elect: elect
embark: embark
embarrassed: embarrassed
embarrassment: embarrassment
embassy: embassy
ember: embers
emboldener: emboldener
eminence: eminence
emissary: emissary
emphasis: emphasis
empire: empire
employer: employer
employment: employment
enchantment: enchantment
enclose: encloses,enclosing
enclosure: enclosure
encounter: encountered
encourage: encourage,encouraged
encouraged: encouraged
encouragement: encouragement
endless: endless
enemy: enemies,enemy
engage: engage,engaged
england: england
english: english
englishman: englishman,englishmen
enjoy: enjoy,enjoyed
enjoyment: enjoyment
enlarge: enlarged
enow: enow
ensign: ensign
ensure: ensure
enter: enter,entered
entertainment: entertainment
entire: entire
entrance: entrance
entry: entries,entry
envelop: enveloped
environ: environed
envy: envy
equal: equal,equalled,equals
equally: equally
equip: equipped
ere: ere
error: error
escapade: escapade
escape: escape,escaped
estuary: estuary
eternal: eternal
eternity: eternity
europe: europe
evening: evening,evenings
event: events
evergreen: evergreen
evidence: evidence
evidently: evidently
evil: evil
exact: exact
examination: examination
examine: examining
excavation: excavation
exceedingly: exceedingly
excellent: excellent
exception: exception
exchange: exchanged
excited: excited
excitement: excitement
exciting: exciting
exclaim: exclaimed
exclamatory: exclamatory
excuse: excuse,excused
execute: executed
execution: execution
exhausted: exhausted
exhaustion: exhaustion
exist: existed
expect: expect,expected,expecting
experience: experience
experienced: experienced
experiment: experiment
explain: explain,explaining
explanation: explanation
explanatory: explanatory
explode: explode
exploration: exploration
explore: explored,exploring
explosion: explosion
expose: expose,exposed
exposed: exposed
express: express,expressed
expression: expression,expressions
extent: extent
external: external
extra: extra
extraordinary: extraordinary
extravagance: extravagance
extreme: extreme
extremely: extremely
extremest: extremest
extricate: extricate
eye: eye,eyes
eyebrow: eyebrows
eyed: eyed
eyeless: eyeless
eyelid: eyelids
fable: fable
fail: fail,failed
failure: failures
faint: faint,fainter,fainting
fainting: fainting
faintly: faintly
faintness: faintness
fair: fair,fairer
fairway: fairway
faith: faith
faithful: faithful
fake: faked
fall: fall,fallen,falling,fell
fallen: fallen
familiar: familiar
family: family
famous: famous
fan: fan
fancy: fancied,fancies,fancy
faraway: faraway
farth: farthest
farthing: farthing,farthings
fashion: fashion
fast: fast,faster
fastening: fastenings
fat: fat
fatal: fatal
fatally: fatally
fate: fate
father: father
fatherless: fatherless
fathom: fathom,fathoms
fatigue: fatigue
fault: fault
favour: favour,favoured
favourable: favourable
favourably: favourably
favoured: favoured
favourite: favourite
fawn: fawning
fear: fear,feared,fears
fearful: fearful
feasible: feasible
feature: features
feeble: feeble
feebly: feebly
feed: fed,feed
feel: feel,feeling
feeling: feeling,feelings
feint: feints
fell: felled
fellow: fellow,fellows
fen: fen
fence: fence
fern: ferns
fetch: fetch,fetched
fever: fever
feverish: feverish
fibre: fibres
fiddle: fiddle
fidge: fidges
field: field
fiend: fiend,fiends
fierce: fierce
fiercely: fiercely
fight: fight,fought
fighter: fighter
fighting: fighting
figure: figure
figurehead: figurehead,figureheads
filthy: filthy
finally: finally
fine: fine,finer
finely: finely
finger: finger,fingering,fingers
finish: finish,finished,finishing
fir: fir
firelight: firelight
firewood: firewood
firm: firm
fish: fish,fishes,fishing
fishing: fishing
fishy: fishier,fishiest
fist: fist
fit: fit,fits,fitted,fitting
flag: flag
flap: flapped,flapping
flash: flash,flashed,flashes,flashing
flat: flat
flatter: flattered
flattering: flattering
flattery: flattery
flea: flea
flee: fled
fleeing: fleeing
fleet: fleet
fleeting: fleeting
flesh: flesh
flicker: flickered,flickering
flight: flight
flighty: flighty
fling: fling,flung
flint: flint
flit: flit,flitted,flitting
float: floated,floating
flock: flock
flood: flood
floor: floor
flourish: flourished
flow: flowed
flower: flower,flowering,flowers
flowering: flowering
flowery: flowery
flush: flush,flushed
flutter: flutter,fluttered,fluttering
fly: flew,flies,flown,fly,flying
flying: flying
foam: foam,foaming
foe: foe,foes
fog: fog
foggy: foggy
fold: folded
foliage: foliage
folk: folk
follow: follow
follower: followers
folly: folly
fond: fond
food: food
fool: fool,fools
foolery: foolery
foolhardiness: foolhardiness
foolhardy: foolhardy
foolish: foolish
foolishly: foolishly
foot: feet,foot
footfall: footfalls
footing: footing
footstep: footsteps
forage: foraging
forbear: forbear
force: force,forced
fore: fore
forearm: forearm
forecastle: forecastle
forefinger: forefinger
forefoot: forefoot
foreign: foreign
forelock: forelock
foremast: foremast
foremost: foremost
forest: forest
forfeit: forfeit
forget: forget,forgot,forgotten
forgive: forgive
form: forms
formidable: formidable
fort: fort
fortunate: fortunate
fortune: fortune
foul: foul,fouled,foulest
fouled: fouled
fourpenny: fourpenny
fours: fours
fourteen: fourteen
fourth: fourth
fowl: fowls
fraction: fraction
fracture: fractured
frame: frame
framework: framework
fray: frayed
freedom: freedom
freely: freely
french: french
frenzy: frenzy
frequent: frequent
fresh: fresh
freshly: freshly
friend: friend,friends
friendly: friendliest,friendly
frigate: frigate
frighten: frighten,frightened
frightened: frightened
fringe: fringed
fro: fro
frost: frost,frosts
frosty: frosty
frown: frown
frozen: frozen
fruit: fruits
fry: fried
fuel: fuel
fugitive: fugitive
fulfil: fulfilled
fun: fun
funeral: funeral
funny: funny
furious: furious
furiously: furiously
furniture: furniture
furtively: furtively
fury: fury
gabble: gabbling
gain: gain,gained,gaining
gale: gales
gall: gall
gallery: gallery
galley: galley
gallipot: gallipot
gallop: gallop,galloping
gallows: gallows
game: game
gamekeeper: gamekeeper,gamekeepers
gammon: gammon
gape: gaping
garden: gardens
gardener: gardener
garrison: garrison
gaskin: gaskin
gasp: gasp,gasped
gate: gate,gates
gather: gather,gathered
gathering: gathering
gauge: gauge
gay: gay
gayer: gayer
genteel: genteel
gentle: gentle
gentleman: gentleman,gentlemen
gently: gently
george: george
ghastly: ghastly
ghost: ghost
giant: giant
gibbet: gibbet
giddily: giddily
giddy: giddy
gift: gifts
gig: gig,gigs
gill: gill
gilt: gilt
gipsy: gipsies
girdle: girdle
girl: girl
girt: girt
glad: glad
glade: glade
gladly: gladly
gladness: gladness
glance: glance,glanced,glances
glare: glare,glared
glass: glass,glasses
gleam: gleam,gleaming
glee: glee
glide: gliding
glim: glim
glimmer: glimmer
glint: glint
glisten: glisten
gloomy: gloomy
glory: glory
glossy: glossy
glove: glove
glow: glow,glowed,glowing
goa: goa
goal: goal
goat: goat,goats
goatskin: goatskins
god: god
gold: gold
golden: golden
goodish: goodish
goodness: goodness
goodwill: goodwill
goose: geese
grace: grace
gracious: gracious
gradually: gradually
grain: grain
grand: grand
grandly: grandly
grant: grant
grapple: grapple
grasp: grasp,grasped,grasping
grass: grass
grate: grate,grated
grateful: grateful
gratitude: gratitude
grave: grave
gravel: gravel
gravely: gravely
gray: gray
greatly: greatly
greed: greed
greedily: greedily
green: green
greet: greeted
grey: grey
grievance: grievances
grievous: grievous
grilling: grilling
grim: grim
grin: grin
grind: grinding,ground
grip: grip,gripped
grizzled: grizzled
groan: groan,groaned,groaning,groans
grog: grog
grope: grope,groped,groping
gross: gross
ground: ground
grove: grove
grovel: grovelled
grow: grew,grow,growing,grown
growl: growl,growled,growling
grown: grown
growth: growth
grudgingly: grudgingly
gruffly: gruffly
grumble: grumble,grumbled,grumbling
grunt: grunted,grunting
guard: guard,guarding
guess: guess,guessed,guessing
guest: guest,guests
guide: guide,guided
guilty: guilty
guinea: guinea,guineas
gulf: gulf
gully: gully
gum: gum
gun: gun,guns
gunner: gunner
gunnery: gunnery
gunshot: gunshot
gunwale: gunwale
gut: gutted
gymnast: gymnast
habit: habit
haft: haft
haggard: haggard
hail: hail,hailed,hailing,hails
hailstone: hailstones
hair: hair
haired: haired
hall: hall
halloa: halloaing
halloo: halloo
halt: halt,halting
halyard: halyards
ham: ham
hamlet: hamlet
hammer: hammer
hammock: hammocks
hand: hand,handed,hands
handed: handed
handkerchief: handkerchief
handle: handle,handled
hands: hands
handsome: handsome,handsomest
handsomer: handsomer
handspike: handspike
handy: handier,handy
hang: hang,hanged,hanging,hung
hanger: hanger
happen: happen,happened
happy: happier,happy
harbour: harbour,harbours
hard: hard,harder
hark: hark
harm: harm
harmless: harmless
harry: harry
hash: hash
haste: haste
hasten: hastened
hastily: hastily
hat: hat
hatch: hatches
hate: hated
haul: haul,hauled
hauling: hauling
haunt: haunted
hawk: hawk
hawker: hawker
hawkins: hawkins
hawse: hawse
hawser: hawser
haze: haze,hazed
hazing: hazing
hazy: hazy
head: head,headed,heading,heads
header: headers
headforemost: headforemost
headlong: headlong
headpiece: headpiece
headway: headway
health: health
heap: heap,heaps
hear: hear,heard,hearing
hearing: hearing
hearken: hearken,hearkening
heart: heart,hearts
hearted: hearted
heartedly: heartedly
hearth: hearth
heartily: heartily
hearty: hearty
heat: heat
heated: heated
heath: heath
heave: heave
heaven: heaven
heavily: heavily
heaving: heaving
heavy: heavier,heaviest,heavy
hedge: hedge,hedges
heed: heed
heel: heel,heels
height: height,heights
helm: helm
helpless: helpless
helplessness: helplessness
hen: hen
hero: hero
hesitate: hesitate,hesitated,hesitating
hesitation: hesitation
hide: hidden,hide
hiding: hiding
highness: highness
hill: hill,hills
hillo: hillo
hillside: hillside
hilltop: hilltop,hilltops
hilt: hilt
hinder: hinder
hint: hint
hip: hip
hispaniola: hispaniola
hiss: hiss,hissed
hisself: hisself
hit: hit
hitch: hitch
hitherto: hitherto
ho: ho
hoar: hoar
hoard: hoard
hoarse: hoarse
hoarsely: hoarsely
hobble: hobble,hobbled
hoist: hoist,hoisted
hold: held,hold,holding
hole: hole,holes
holler: hollered
hollow: hollow
homeward: homeward
honest: honest
honesty: honesty
honour: honour
hood: hood
hoof: hoofs
hop: hopping
hope: hope,hoped,hopes
hopeless: hopeless
horizon: horizon
horn: horn
hornet: hornet
hornpipe: hornpipe
horrible: horrible
horribly: horribly
horrid: horrid
horrify: horrified
horror: horror,horrors
horse: horse,horses
hostage: hostage
hostility: hostilities
hot: hot
hotly: hotly
hound: hound
hour: hour,hours
house: house,houses
housekeeper: housekeeper
hover: hovering
howsoever: howsoever
howsomever: howsomever
huddle: huddled
huge: huge
hulk: hulk
hulking: hulking
hull: hull
hullo: hullo
hum: humming
human: human
humane: humane
humbly: humbly
humbug: humbug
humility: humility
hummock: hummock
humour: humour
humoured: humoured
hunch: hunched
hungry: hungry
hunt: hunt,hunted,hunting
hunter: hunter,hunters
hunting: hunting
hurly: hurly
hurried: hurried
hurry: hurry,hurrying
hurt: hurt
hurtle: hurtling
husband: husband
husky: husky
huzza: huzza
idea: idea
identical: identical
idiot: idiot
idle: idle
idleness: idleness
idly: idly
ignorant: ignorant
iii: iii
ile: ile
illustrated: illustrated
imaginable: imaginable
imagine: imagine,imagined
imitation: imitation
immense: immense
immensely: immensely
immortal: immortal
impatience: impatience
impatiently: impatiently
impending: impending
impossible: impossible
imposter: imposter
imprecation: imprecations
impress: impressed
impulse: impulse
impulsion: impulsion
inboard: inboard
incense: incensed
incessant: incessant
inch: inches
incivility: incivility
inclination: inclination
incline: incline,inclined
include: included,including
incomprehensible: incomprehensible
incongruous: incongruous
increase: increase,increased
incredible: incredible
indescribable: indescribable
indian: indian,indians
indies: indies
indignation: indignation
indomitable: indomitable
indoor: indoors
inexplicable: inexplicable
inexpressible: inexpressible
infallibly: infallibly
infamous: infamous
infection: infection
infectious: infectious
infernal: infernal
infinite: infinite
influence: influence
inform: inform
ing: ing
ingratiate: ingratiate
initial: initial
injure: injured
injury: injuries
ink: ink
inkling: inkling
inlet: inlet,inlets
inmate: inmates
inn: inn,inns
innocence: innocence
innocent: innocent
innumerable: innumerable
inquire: inquired
insect: insects
insist: insist
insolence: insolence
inspection: inspection
inspiration: inspiration
inspire: inspired
instance: instance
instant: instant
instantly: instantly
instinct: instinct
instinctively: instinctively
instruction: instruction
instrument: instrument
insubordinate: insubordinate
intelligence: intelligence
intelligent: intelligent
intend: intended
intention: intention
intercept: intercepted
interfere: interfered
interference: interference
interior: interior
intermittent: intermittent
interrupt: interrupt,interrupted,interrupting
interval: interval,intervals
intolerable: intolerable
intruder: intruders
invaluable: invaluable
invisible: invisible
involve: involved
irelander: irelander
iron: iron,irons
ironical: ironical
ironically: ironically
irresolute: irresolute
irreverence: irreverence
island: island,islands
isle: isle
islet: islet
isolated: isolated
israel: israel
issue: issued,issuing
italy: italy
itching: itching
iv: iv
ix: ix
jack: jack
jacket: jacket,jackets
james: james
january: january
jaw: jaw,jawing,jaws
jealousy: jealousy
jerk: jerk,jerking
jewel: jewels
jib: jib,jibs
jiffy: jiffy
jim: jim
jingle: jingle
job: job
john: john
johnny: johnny
johnson: johnson
joke: joke,joked,jokes
jolly: jolly
jones: jones
journey: journey,journeys
joy: joy
joyce: joyce
judge: judge,judged
jump: jump,jumped,jumping
jumping: jumping
june: june
junk: junk
jupiter: jupiter
justice: justice
justify: justified
keel: keel
keen: keenest
keenly: keenly
keg: keg,kegs
kelson: kelson
kettle: kettle
key: key
keyhole: keyholes
kick: kicked,kicking
kill: kill,killed,killing
kindly: kindlier,kindly
kindness: kindness
king: king,kings
kingston: kingston
kiss: kiss,kissed
kitchen: kitchen
knee: knee,knees
kneel: kneeling
knife: knife,knives
knit: knit
knock: knock,knocked
knoll: knoll,knolls
knowledge: knowledge
knuckle: knuckled,knuckles
laborious: laborious
labour: labour
laced: laced
lad: lad,lads
ladder: ladder
laden: laden
lads: lads
lady: lady
lamb: lambs
lament: lament
lamp: lamp
lancet: lancet
land: land,landed,lands
landing: landing
landlord: landlord
landsman: landsman
landsmen: landsmen
language: language
languor: languor
lantern: lantern,lanterns
lanyard: lanyard
lap: lap,lapping
larboard: larboard
largeness: largeness
lash: lashed
lasses: lasses
late: late
lather: lather
latin: latin
latitude: latitude
laugh: laugh,laughed,laughing
laughable: laughable
laughter: laughter
launch: launched
law: law
lawful: lawful
lawyer: lawyers
lay: laid,lay,laying
lead: lead,leading,leads,led
leaden: leaden
leadin: leadin
leaf: leaf,leaves
leafless: leafless
lean: leaned,leaning,leant
leap: leap,leaped,leaping,leapt
leapt: leapt
learn: learn,learned
lease: lease
leastways: leastways
leather: leather
leave: leave,leaves,leaving,left
lection: lection
ledge: ledge
lee: lee
leer: leer
leeward: leeward
leeway: leeway
left: left
leg: leg,legs
legged: legged
leisurely: leisurely
lemon: lemon
lend: lend,lending,lent
lesson: lesson
letter: letter
level: level
liberal: liberal
liberty: liberty
library: library
lick: lick
lid: lid
lie: lain,lie,lies,lying
lieutenant: lieutenant
life: life,lives
lifetime: lifetime
lift: lifted
light: light,lighted,lighter,lighting,lights,lit
lighted: lighted
lighten: lightened
lightly: lightly
liker: liker
likes: likes
liking: liking
lillibullero: lillibullero
limb: limbs
limit: limits
linger: lingered,lingering
link: link
lion: lion,lions
lip: lipping,lips
listen: listen,listening
listening: listening
literally: literally
live: live,lived,lives,living
lived: lived
lively: livelier,lively
liver: liver
livery: livery
livid: livid
load: load,loaded,loading
loaded: loaded
loan: loan
lock: lock,locked
locker: locker
lockfast: lockfast
lodge: lodge,lodged
lodger: lodger
lodging: lodging
lofty: lofty
log: log,logs
london: london
lonely: lonely
longing: longing
longish: longish
longitude: longitude
lookout: lookout
loom: loomed
loop: loops
loophole: loophole,loopholed,loopholes
loose: loose,loosed
loosen: loosened
lop: lop
lord: lord
lose: lose,lost
loss: losses
lot: lot,lots
loud: loud,louder
loudly: loudly
louis: louis
love: love,loves
lowland: lowlands
lubber: lubber,lubbers
luck: luck
lucky: lucky
luff: luff
lugger: lugger
lumber: lumber
lump: lump
lung: lung
lurch: lurch,lurched
lurk: lurking
mad: mad
madagascar: madagascar
madman: madman
magazine: magazine
magistrate: magistrate,magistrates
magnificent: magnificent
mahogany: mahogany
maid: maid
mail: mail
main: main
mainland: mainland
mainsail: mainsail
mainstay: mainstay
majesty: majesty
maker: maker
malabar: malabar
malaria: malaria
manage: manage,managed
management: management
manlike: manlike
manned: manned
manner: manner
manners: manners
manoeuvre: manoeuvre,manoeuvred
mantle: mantle
manufactory: manufactory
map: map
march: march,marched
margin: margin
mariner: mariner
marish: marish
mark: mark,marked,marks
marksman: marksmen
marlin: marlin
maroon: maroon,marooned,maroons
marooned: marooned
married: married
marrow: marrow
marsh: marsh,marshes
marshy: marshy
mass: mass,masses
mast: mast,masts
master: master
masthead: mastheaded
match: match
mate: mate,mates
material: material
matey: matey
matted: matted
matter: matter,matters
mattress: mattress
mayhap: mayhap
meal: meal,meals
meaning: meaning
meat: meat
mechanically: mechanically
meddle: meddle
meddling: meddling
medical: medical
medicine: medicine,medicines
meditate: meditating
meet: meet,met
melancholy: melancholy
mellow: mellow
melt: melted
melting: melting
memory: memory
mend: mend
mention: mention,mentioned
merciful: merciful
mercilessly: mercilessly
mercy: mercy
mere: mere,merest
merit: merits
merry: merry
mess: mess
message: message
messenger: messenger
messmate: messmate,messmates
method: method
mexican: mexican
midday: midday
middle: middle
midst: midst
mightily: mightily
mighty: mighty
mild: mild
mile: mile,miles
mind: mind,minded,minding,minds
minded: minded
mingle: mingled
mint: minted
minute: minute,minutes
mirror: mirror
mirth: mirth
miry: miry
miscalculation: miscalculations
miscellany: miscellany
mischief: mischief
miscreant: miscreant
miserable: miserable
misgive: misgave
missile: missile,missiles
mission: mission
missis: missis
mist: mist
mistake: mistake
mistaken: mistaken
mistily: mistily
mistook: mistook
mix: mixed
mizzen: mizzen
mizzenmast: mizzenmast
moan: moan,moaned
modulate: modulated
moidore: moidores
molestation: molestation
moment: moment,moments
money: money,moneys
monkey: monkey,monkeys
monster: monster,monsters
monstrous: monstrous
monstrously: monstrously
month: month,months
monthly: monthly
moon: moon
moonbeam: moonbeams
moonlight: moonlight
moonlit: moonlit
moonshine: moonshine
mop: mopping
morally: morally
morass: morass
morgan: morgan
morning: morning
morrow: morrow
mortal: mortal
moss: moss
mother: mother,mothers
motion: motion,motioned
motionless: motionless
mought: mought
mound: mound,mounds
mount: mount,mounted,mounting
mountain: mountain
mounting: mountings
mourning: mourning
mouse: mouse
mouth: mouth
mouthful: mouthful
movement: movement,movements
moving: moving
muck: mucked
mud: mud
muddy: muddy
multitude: multitude
murder: murder
murderer: murderer,murderers
murderous: murderous
murmur: murmur,murmured
muscle: muscles
music: music
musingly: musingly
musket: musket,muskets
musketeer: musketeers
musketry: musketry
mutilate: mutilated
mutineer: mutineer,mutineers
mutiny: mutiny
mutter: muttered,muttering
muzzle: muzzle
mysterious: mysterious
mystery: mystery
nail: nail,nails
naked: naked
napkin: napkin
narrative: narrative
narrow: narrow,narrower,narrows
narrowly: narrowly
nasty: nasty
nation: nations
nationality: nationality
native: native,natives
natural: natural
naturally: naturally
nature: nature,natures
nautical: nautical
navigate: navigate
navigation: navigation
nearer: nearer
nearness: nearness
neat: neat
neatly: neatly
neatness: neatness
necessaries: necessaries
neck: neck,necks
needle: needles
needlessness: needlessness
neglect: neglect,neglecting
negress: negress
negro: negroes
neighbour: neighbour,neighbouring,neighbours
neighbourhood: neighbourhood
nerve: nerve
nervous: nervous
nest: nest
nettle: nettled
newcomer: newcomers
newly: newly
news: news
nice: nice
nicely: nicely
nick: nick
niggardly: niggardly
nigh: nigh
night: night,nights
nightfall: nightfall
nightmare: nightmares
nimbleness: nimbleness
nineteen: nineteen
nip: nip,nips
noah: noah
noble: noble
nod: nod,nodded,nodding
noggin: noggin
nohow: nohow
noise: noise,noises
noiseless: noiseless
nondescript: nondescript
noo: noo
noon: noon
noonday: noonday
north: north
northern: northern
northward: northward
nose: nose
nostril: nostrils
notable: notable
notch: notch
note: note,notes
notice: notice,noticing
notion: notion,notions
numbness: numbness
numbskull: numbskull
numerous: numerous
nut: nut,nuts
nutmeg: nutmeg
nutritious: nutritious
oak: oak,oaks
oaklike: oaklike
oar: oar,oars
oath: oath,oaths
obediently: obediently
obey: obey,obeyed,obeying
objection: objections
oblige: oblige,obliged
obscure: obscure
obsequious: obsequious
observation: observation
observe: observe,observed,observing
obstinately: obstinately
obvious: obvious
occasional: occasional
occupy: occupy
occur: occurred
occurrence: occurrence
ocean: ocean
odd: odd
oddly: oddly
odds: odds
odious: odious
offence: offence
offend: offended
offender: offender
offer: offer,offered,offering
officer: officer,officers
oftenest: oftenest
oho: oho
oilcloth: oilcloth
oilskin: oilskin
onslaught: onslaught
onward: onward
openly: openly
opinion: opinion
opportunity: opportunities,opportunity
ordinary: ordinary
organ: organ
oriental: oriental
originally: originally
ornamental: ornamental
outlandish: outlandish
outline: outline
outnumber: outnumbered
outright: outright
outset: outset
outstrip: outstripped
outward: outward
overboard: overboard
overcome: overcoming
overdrawn: overdrawn
overhang: overhanging,overhung
overhaul: overhaul,overhauled
overhead: overhead
overhear: overhear,overheard
overjoy: overjoyed
overload: overloaded
overloaded: overloaded
overlook: overlooked,overlooks
overriding: overriding
overturn: overturn
owe: owe,owed,owes
owl: owls
owner: owner
ox: ox
oxen: oxen
oyster: oysters
pace: pace,paces
pack: pack,packing
packet: packet
packing: packing
paddle: paddle
paddling: paddling
pain: pain,pains
pained: pained
painfully: painfully
paint: paint,painted
painter: painter
pair: pair
pale: pale,paling
paleness: paleness
paler: paler
palisade: palisade
palm: palm,palms
pang: pang
panic: panic
pannikin: pannikin
pant: pant,panted
panting: panting
pants: pants
paper: paper,papers
papers: papers
pardon: pardon
parliament: parliament
parlour: parlour
parmesan: parmesan
parole: parole
parrot: parrot
particle: particle
particulars: particulars
partly: partly
partridge: partridges
party: parties,party
pass: pass,passed,passing
passably: passably
passage: passage
passenger: passenger
passion: passion
pat: patted
patch: patch,patched,patches
patchwork: patchwork
patience: patience
patient: patient,patients
patiently: patiently
patter: pattered
pattern: pattern,patterns
pause: pause,paused,pausing
paw: paw
pay: paid,pay,paying
payment: payment
peace: peace
peaceful: peaceful
peacefully: peacefully
peach: peach
peak: peak,peaks
peaked: peaked
peal: peal
peck: peck,pecking
peculiar: peculiar
peculiarly: peculiarly
pedestal: pedestal
peel: peel
peer: peered,peering
pen: pen
penny: penny
pension: pension
perceive: perceive,perceived
perch: perch,perched
perfect: perfect
perfectly: perfectly
peril: peril,perils
perilous: perilous
perish: perish,perished
perjury: perjury
perk: perked
permission: permission
permit: permitted
perplexity: perplexity
person: people,person
personage: personage
persuade: persuade
pestiferous: pestiferous
pet: pet
pew: pew
phosphorescent: phosphorescent
phrase: phrase,phrases
physician: physician
pick: pick,picked,picking,picks
pickle: pickled,pickles
picture: picture,pictures
pie: pie
piece: piece,pieces
pierce: pierced
piety: piety
pig: pig
pigeon: pigeon
pigtail: pigtail,pigtails
pike: pikes
pile: pile,piled,piles
pillow: pillow
pilot: pilot
pin: pin,pinned
pinch: pinch,pinched,pinching
pine: pine,pines
pinnacle: pinnacle
pious: pious
pipe: pipe,piped,pipes,piping
piping: piping
piracy: piracy
pirate: pirate,pirates
pistol: pistol,pistols
pit: pit,pits
pitch: pitch,pitched
pity: pity
placidly: placidly
plain: plain
plainly: plainly
plan: plan,plans
plank: plank,planks
plant: plants
plaster: plaster
plate: plate
plateau: plateau
play: play,played,playing
plead: pleading
pleasant: pleasant,pleasanter,pleasantest
pleased: pleased
pleasing: pleasing
pleasure: pleasure
pledge: pledge
plentifully: plentifully
plenty: plenty
plod: plodding
plot: plot,plotting
plough: ploughed,ploughing
pluck: pluck,plucked
pluckily: pluckily
plucky: plucky
plum: plum
plumage: plumage
plump: plumping
plumped: plumped
plunder: plundered
plunge: plunge,plunged,plunging
pocket: pocket,pockets
pointer: pointer
poison: poison
poisonous: poisonous
pole: pole
policy: policy
polite: polite
politeness: politeness
poll: poll
pond: pond
pool: pool
poor: poor
pop: popped
porch: porch
pork: pork
porridge: porridge
port: port,ports
portable: portable
portion: portion
portray: portrayed
portuguese: portuguese
position: position
positively: positively
possess: possessed
possession: possession
post: post
postscript: postscript
posture: posture
pound: pound,pounding,pounds
pour: poured
powder: powder
powdered: powdered
power: power,powers
powerful: powerful
practice: practice
praise: praise
pray: prayed,praying
prayer: prayer,prayers
precaution: precaution,precautions
precious: precious
precipice: precipices
precisely: precisely
predicament: predicament
predict: predicted,predicting
preening: preening
prefer: prefer,preferred,preferring
prejudice: prejudiced
prematurely: prematurely
prepare: prepared
preponderance: preponderance
prescription: prescriptions
presence: presence
presently: presently
preservation: preservation
preserve: preserve
presume: presumed
pretence: pretence
pretend: pretended
pretext: pretext
prettily: prettily
pretty: pretty
prevent: prevent
previous: previous
price: price
pride: pride
prime: primed
priming: priming
principal: principal
print: print,printed
prison: prison
prisoner: prisoner
privileged: privileged
prize: prizes
probable: probable
probation: probation
proceed: proceeded
proceeds: proceeds
process: process
prodigious: prodigious
prodigiously: prodigiously
produce: produce
profession: profession
professional: professional
profit: profit
profoundly: profoundly
progress: progress
project: project
prolong: prolonged
promise: promise,promised
promontory: promontory
promotion: promotion
prompt: prompt
prop: propped
proper: proper
prophetic: prophetic
proportion: proportion
proposal: proposal
propose: propose
propulsion: propulsion
prosecute: prosecute
prospect: prospect
prospects: prospects
prosperous: prosperous
protection: protection
protestation: protestations
prove: prove,proved
providence: providence
provision: provision,provisions
public: public
puff: puff
pull: pull,pulled,pulling
pulse: pulse,pulses
punch: punch
puncheon: puncheon
punishment: punishment
puppet: puppet
purchaser: purchaser
pure: pure
purpose: purpose
purposeless: purposeless
pursue: pursue,pursued,pursuing
pursuit: pursuit
push: push,pushed,pushing
puzzle: puzzled
quack: quack
quadrant: quadrant
quadrilateral: quadrilaterals
quaint: quaint
quality: qualities
qualm: qualm
quarrel: quarrel
quart: quart
quarter: quarter,quarters
quartermaster: quartermaster
quaver: quaver
quay: quays
queer: queer
quest: quest
question: question,questions
quick: quick
quicken: quickening
quid: quid
quiet: quiet,quieted
quietly: quietly
quire: quire
quit: quit
quiver: quivered,quivering
quote: quoted
quoth: quoth
race: raced
racer: racer
radiance: radiance
radiant: radiant
rag: rags
rage: rage,raged,raging
ragged: ragged
raggedness: raggedness
rain: rain
raise: raise,raised,raising
raisin: raisins
rammer: rammer
random: random
range: range,ranged
rank: rank
rap: rapped
rapid: rapid
rapidity: rapidity
rapidly: rapidly
rascal: rascal
rat: rats
rate: rate,rated
ration: rations
rattle: rattle,rattled,rattling
rattling: rattling
rave: raving
ray: ray,rays
reach: reach,reached,reaching
react: reacted
read: read,reading
reader: reader
readiness: readiness
reading: readings
ready: ready
real: real
realize: realize,realized
reappear: reappeared
reappearance: reappearance
rear: rear
reason: reason,reasons
reassure: reassured
reassuringly: reassuringly
reawaken: reawakened,reawakening
rebellious: rebellious
rebuff: rebuff,rebuffs
recall: recall
recapture: recapture
receive: received,receiving
recharge: recharge
recklessness: recklessness
reckon: reckon,reckoned
recognize: recognize,recognized
recoil: recoiled
recollection: recollection
recommence: recommence,recommenced
recommend: recommended
recommendation: recommendation
record: record
recover: recover,recovered
red: red
redden: reddened
redly: redly
redouble: redoubling
reduce: reduced,reducing
reedy: reedy
reef: reef
reel: reeled
reflection: reflection
refrain: refrain
refreshment: refreshment
refuse: refuse,refused
regain: regain,regained
regard: regard,regarded
regiment: regiment
regret: regret,regretted
reiterate: reiterated
rejoice: rejoice
rejoin: rejoined
rekindle: rekindling
relate: relate
relax: relaxed
release: released
relief: relief
relieve: relieve,relieved
relieved: relieved
relinquish: relinquishing
reload: reloaded,reloading
rely: rely
remain: remain,remained,remaining,remains
remainder: remainder
remains: remains
remark: remark,remarked
remarkable: remarkable
remarkably: remarkably
remedy: remedies
remember: remember,remembered
remind: remind
removal: removal
remove: removed
repaint: repainted
repair: repaired
reparation: reparation
repeat: repeat,repeated,repeating
repent: repent
repetition: repetition
reply: replied,replies,reply
report: report,reports
reprime: reprimed
repugnance: repugnance
repulse: repulse
request: request
require: require,required
reserve: reserve
residence: residence
resign: resign
resin: resin
resolutely: resolutely
resolve: resolved
respect: respect,respected
respectful: respectful
respects: respects
responsible: responsible
rest: rest,resting
restore: restored
restrain: restrained
result: result
resume: resumed
retell: retold
retire: retired
retort: retorted
retrace: retrace
retreat: retreat,retreated,retreating
return: return,returned,returning
revelation: revelation
revenge: revenge
revengeful: revengeful
revenue: revenue
reverberation: reverberation,reverberations
reverently: reverently
reverse: reverse,reversed
revive: revive,revived
revolt: revolted
revolve: revolved
reward: reward
rheumatic: rheumatics
rib: ribs
rich: rich
richard: richard
riches: riches
ricochet: ricochet
rid: rid
riddle: riddle
ride: ride,riding,rode
rider: rider,riders
ridge: ridge
riding: riding
rifle: rifle,rifled
rig: rig,rigged,rigs
rigger: riggers
rigging: rigging
rightly: rightly
ringleader: ringleader,ringleaders
ringlet: ringlet,ringlets
rip: rip,ripped
ripple: ripple,ripples,rippling
rise: rise,risen,rising,rose
risk: risk,risked,risking
river: river,rivers
road: road
roar: roar,roared,roaring
roast: roast
robert: robert
roberts: roberts
rock: rock,rocking,rocks
rocky: rocky
roger: roger
rogue: rogue,rogues
roll: roll,rolled,rolling
roller: rollers
rolling: rolling
rom: rom
romance: romance
roof: roof
root: root
rooted: rooted
rope: rope,ropes
rosily: rosily
rot: rotting
rough: rough,roughest
roughen: roughened
roughly: roughly
roundly: roundly
rout: rout
route: routed
rove: roving
row: row
rowing: rowing
royal: royal
rub: rubbing
rudder: rudder
rude: rude
rudiment: rudiments
ruffian: ruffian,ruffians
ruffle: ruffling
ruin: ruin,ruined
ruination: ruination
rule: rule,rules
rum: rum
runner: runner
running: running
rush: rush
rustle: rustle
rustling: rustling
rusty: rusty
sabre: sabre
sack: sack,sacks
sacrifice: sacrificing
sad: sad
saddle: saddle,saddled
sadly: sadly
safe: safe
safely: safely
safety: safety
sail: sail,sailed,sailing,sails
sailing: sailing
sailor: sailor,sailors
sailorly: sailorly
saint: saints
sake: sake
sally: sallied
salt: salt,salted,salts
salute: salute,saluted,saluting
sand: sand,sanded
sandy: sandy
sane: sane
sauce: sauce
savage: savages
savannah: savannah
save: save,saved,saves,saving
saving: saving
scale: scale,scaled
scamp: scamp
scarce: scarce,scarcest
scarcely: scarcely
scarecrow: scarecrow
scarf: scarf
scarred: scarred
scatter: scatter,scattered,scattering
scene: scene
scented: scented
scheme: scheme
scholar: scholar
schoolchildren: schoolchildren
schooling: schooling
schooner: schooner,schooners
scissors: scissors
scold: scolded
score: score,scores
scorn: scorn
scoundrel: scoundrel,scoundrels
scour: scour
scowl: scowling
scramble: scramble,scrambled
scrap: scraps
scratch: scratch,scratching
scream: scream,screaming
screaming: screaming
screw: screwed
scrub: scrub
scuffle: scuffle
scull: sculled
scupper: scupper,scuppers
scuttle: scuttled
sea: sea,seas
seafaring: seafaring
seal: seal,sealed,seals
seam: seams
seaman: seaman,seamen
seamanly: seamanly
seamen: seamen
search: search
seat: seat,seated
seated: seated
seaward: seaward
seaway: seaway
seaweed: seaweed
seaworthy: seaworthy
secret: secret
securely: securely
security: security
seek: seek,seeking
seemingly: seemingly
seize: seize,seized
sell: sell,selling,sold
send: send,sends
sense: sense
senseless: senseless
sentinel: sentinel
sentry: sentries,sentry
separate: separate,separated,separating
sequin: sequins
series: series
servant: servant,servants
serve: serve,served,serving
service: service
serviceable: serviceable
set: set,sets,setting
settle: settle,settled,settling
seventeen: seventeen
sever: sever
severally: severally
severely: severely
sew: sewn
shade: shade
shadow: shadow
shaft: shaft
shaggy: shaggy
shake: shake,shaken,shakes,shaking,shook
shallow: shallow
shame: shame
shameful: shameful
shape: shape,shaped
share: share
sharer: sharer
shark: shark
sharp: sharp
sharply: sharply
shave: shave
shaving: shaving
sheath: sheath
sheep: sheep
sheepishly: sheepishly
sheer: sheer
sheet: sheet,sheeted,sheets
shelter: shelter,sheltering
sheltered: sheltered
shift: shifting
shin: shins
shine: shine,shining,shone
shiny: shiny
ship: ship,shipped,ships
shipmate: shipmate,shipmates
shipping: shipping
shipshape: shipshape
shipwreck: shipwrecked
shirk: shirking
shirt: shirt,shirts
shiver: shiver,shivering
shoal: shoal
shock: shock,shocked
shocking: shocking
shockingly: shockingly
shoe: shoes
shoot: shoot,shot
shooting: shooting
shop: shop
shore: shore,shores
shoreward: shoreward
short: short
shortly: shortly
shortness: shortness
shot: shot,shots
shoulder: shoulder,shouldered,shoulders
shout: shout,shouted,shouting
shove: shove,shoved
shovel: shovels
shred: shreds
shrewdness: shrewdness
shrieking: shrieking
shrill: shrill
shroud: shrouds
shrub: shrubs
shrug: shrugging
shudder: shudder
shut: shut
shy: shy
sich: sich
sick: sick
sickening: sickening
sickness: sickness
sideways: sideways
sidle: sidled,sidling
sigh: sigh
sight: sight,sighted
sign: sign,signs
signal: signal
signboard: signboard
silence: silence,silenced
silent: silent
silently: silently
silk: silk
sill: sill
silly: silly
silver: silver,silvering
silvery: silvery
simply: simply
simultaneous: simultaneous
simultaneously: simultaneously
sin: sin
sinewy: sinewy
sing: sang,sing,singing
singer: singer
singing: singing
single: single
singly: singly
sink: sank,sink,sunk
sir: sir
sit: sat,sit,sits,sitting
situation: situation
sixth: sixth
size: size,sizes
sized: sized
skeleton: skeleton
sketch: sketch
sketched: sketched
skiff: skiff
skill: skill
skim: skimmed,skimming
skin: skin,skins
skip: skipped,skipping
skipper: skipper
skirt: skirted,skirts
skulk: skulk,skulking
skull: skull
sky: sky
skylark: skylarking
slab: slab
slack: slacked
slacken: slacken
slam: slam,slammed
slant: slant
slap: slap,slapped,slapping
slash: slash
slaughter: slaughter
slave: slave,slaved
slay: slain
sledge: sledge
sleep: sleep,sleeping,slept
sleeper: sleeper,sleepers
sleepy: sleepy
sleeve: sleeve
slewed: slewed
slice: slice
slide: sliding
slight: slight,slightest,slights
slimy: slimy
sling: slung
slink: slunk
slip: slip,slipped,slipping
slope: slope,slopes,sloping
slough: slough
slow: slow
slowly: slowly
slumber: slumber
slyly: slyly
slyness: slyness
smack: smack
smart: smart
smartly: smartly
smash: smash,smashed
smell: smell,smelt
smile: smile,smiles,smiling
smite: smit,smitten,smote
smoke: smoke,smoked,smoking
smoky: smoky
smooth: smooth,smoothing
smother: smother,smothered
smoulder: smouldering
smuggler: smugglers
snack: snack
snail: snails
snake: snake,snakes
snap: snapped
snatch: snatch,snatched,snatches,snatching
sneer: sneer,sneered
sneering: sneering
sniff: sniffing
snipe: snipe
snore: snored,snoring
snorer: snorers
snort: snort
snow: snow
snuff: snuff
soak: soaked,soaking
sob: sob
sober: sober
sodden: sodden
soft: soft
softly: softly
soil: soil
soiled: soiled
sojourn: sojourn
soldier: soldier
solemn: solemn
solemnity: solemnity
solemnly: solemnly
solid: solid
solitude: solitude
solve: solve
son: son,sons
song: song,songs
sonny: sonny
sore: sore
sorely: sorely
sorrow: sorrow
sort: sort,sorted,sorting,sorts
soul: soul,souls
sound: sound,sounded,sounding,sounds
sounding: soundings
source: source
sourly: sourly
south: south
southern: southern
southward: southward
southwest: southwest
southwestern: southwestern
sovereign: sovereign
space: space,spaces
spade: spade
spain: spain
spaniards: spaniards
spanish: spanish
spar: sparred,spars
spare: spare,spared
sparsely: sparsely
speak: speak,speaking,spoke,spoken
speaker: speaker,speakers
speaking: speaking
species: species
specimen: specimens
speech: speech,speeches
speed: speed
speedily: speedily
speedy: speedier
spend: spending,spends,spent
spice: spice
spider: spider
spike: spike
spin: spin,spinning,spun
spinning: spinning
spire: spires
spirit: spirit,spirits
spirited: spirited
spit: spat,spit,spitting
spite: spite
spitting: spitting
splash: splash,splashed,splashes
split: split
splutter: spluttering
spoil: spoil,spoiled
spoiled: spoiled
sponge: sponging
spoonful: spoonful
sport: sport
spot: spot
spout: spout,spouted
sprawl: sprawling
spray: spray,sprays
spread: spread,spreading
spring: sprang,spring,springing,springs,sprung
sprinkle: sprinkled
sprout: sprouted
spur: spur,spurs
spurn: spurned
spy: spy
squall: squalls
squalling: squalling
square: square
squat: squatted
squint: squint
squire: squire
stab: stab
stabling: stabling
stage: stage,stages
stagger: stagger,staggered
stagnant: stagnant
stain: stained
stair: stairs
stake: stake,staked
stalk: stalked
stamp: stamped,stamping
stand: stand,standing,stood
standing: standing
standstill: standstill
star: star,stars
starboard: starboard
stare: stare,stared,staring
stark: stark
start: start,started,starting
startle: startled
startled: startled
startling: startling
starvation: starvation
starve: starve,starved,starving
stately: stately
statement: statement
station: station
statue: statue
staunch: staunch
stave: stave
stay: stay,stayed,staying,stays
steadily: steadily
steady: steady
steal: stole,stolen
stealthy: stealthy
steam: steaming
steel: steel
steep: steep,steeped
steepen: steepen
steepness: steepness
steer: steer,steered
steerage: steerage
steering: steering
steersman: steersman
stem: stem
stench: stench
step: step,stepped,steps
stern: stern,sterns
sternly: sternly
stick: stick,sticks,stuck
stiff: stiff,stiffest
stiffly: stiffly
stifle: stifle
stifling: stifling
stir: stirred
stirring: stirring
stirrup: stirrup
stitch: stitches
stock: stock
stockade: stockade
stocking: stockings
stomach: stomach
stone: stone,stones
stony: stony
stoop: stooped,stooping
stooping: stooping
store: stored,stores
storm: storm,storms
stormy: stormy
story: stories,story
stout: stout
stoutish: stoutish
stove: stove
stoving: stoving
stow: stow,stowed
straggle: straggled
straight: straight,straighter
strain: strain,straining
strait: straits
strand: strand,stranded
strange: strange,strangest
strangely: strangely
stranger: stranger,strangers
strangle: strangling
streak: streaks
stream: stream
streaming: streaming
streamlet: streamlet
street: street
strength: strength
stretch: stretch,stretched,stretching
stretcher: stretcher
strew: strewn
stride: stride,striding,strode
strike: strike,strikes,striking,struck
string: string
strip: strip
stroke: stroke,strokes
stroll: stroll,strolled,strolling
strong: strong,stronger
stronghold: stronghold
struggle: struggle,struggled,struggling
studious: studious
study: studied,study
stuff: stuff
stumble: stumbled
stumblingly: stumblingly
stump: stump,stumping,stumps
stun: stunned
stunning: stunning
stupid: stupid
stupor: stupor
stutter: stuttering
style: style
subaltern: subaltern
submit: submit
subside: subside,subsided,subsiding
subsist: subsist
substance: substance
succeed: succeeded
success: success
successful: successful
suck: sucking
sudden: sudden
suddenly: suddenly
suffer: suffered
suffering: sufferings
suffice: suffice
sufficient: sufficient
sugar: sugar
suit: suit,suits
suitable: suitable
sulk: sulks
sullen: sullen
sum: sum,sums
summit: summit,summits
summon: summoning
summons: summons
sun: sun
sunbeam: sunbeams
sunday: sunday
sundays: sundays
sundown: sundown
sunlight: sunlight
sunny: sunny
sunshine: sunshine
sunshiny: sunshiny
supercargo: supercargo
superintend: superintend,superintending
superstition: superstitions
superstitious: superstitious
supervene: supervened
supervisor: supervisor
supper: supper,suppers
supplication: supplication
supply: supplied,supply
support: support,supporting
suppose: suppose,supposed,supposing
surely: surely
surf: surf
surface: surface
surge: surges
surgeon: surgeon
surinam: surinam
surmount: surmounting
surprise: surprise,surprised
surprised: surprised
surprising: surprising
surrender: surrender,surrendered
surround: surrounded
survive: surviving
survivor: survivors
suspect: suspect
suspicion: suspicion,suspicions
suspicious: suspicious
swab: swab,swabbed,swabs
swaggering: swaggering
swallow: swallow,swallowed,swallowing
swam: swam
swamp: swamp,swamped,swamping,swamps
swampy: swampy
sward: sward
swarm: swarmed,swarming
sway: swaying
swear: swear,swearing,swore
sweat: sweat
sweep: sweeping,swept
sweeping: sweeping
sweet: sweet,sweeter
sweetly: sweetly
swell: swell,swollen
swelter: sweltering
swift: swift
swiftly: swiftly
swig: swig
swing: swing,swung
swinging: swinging
swish: swish
swivel: swivel
swoon: swoon
swoop: swoops
sympathy: sympathy
table: table,tables
tack: tack,tacked
tai: tai
tail: tail,tailed,tailing,tails
tailor: tailors
tale: tale,tales
talk: talk,talked,talking,talks
talker: talker
talking: talking
tall: tall,taller,tallest
tallow: tallow
tallowy: tallowy
talon: talons
tan: tan
tap: tap,tapped,tapping
tar: tar
target: target
tarpaulin: tarpaulin,tarpaulins
tarry: tarry
task: task
taste: taste,tasted,tasting
tat: tat
tattered: tattered
tatters: tatters
tattoo: tattoo,tattooed
taut: taut
tavern: tavern
taylor: taylor
teach: teach
tear: tearing,tears,tore,torn
teeth: teeth
teetotum: teetotum
telescope: telescope
temper: temper
tempered: tempered
tend: tended
tenfold: tenfold
tent: tent
term: terms
terrible: terrible
terribly: terribly
terrified: terrified
terrify: terrified
terrifying: terrifying
terror: terror,terrors
tether: tethered
thankful: thankful
thatch: thatch
theer: theer
thicket: thicket,thickets
thickly: thickly
thief: thieves
thigh: thigh
thimble: thimble
thimbleful: thimbleful
thinking: thinking
thirst: thirst
thirteen: thirteen
thither: thither
thomas: thomas
thoughtful: thoughtful
thoughtless: thoughtless
thousandfold: thousandfold
thread: thread,threaded,threads
threat: threat
threaten: threaten,threatened,threatening
threateningly: threateningly
threshold: threshold
thrifty: thrifty
throat: throat,throats
throw: threw,throw,throwing,thrown
thrust: thrust,thrusting
thumb: thumb
thump: thumping
thunder: thunder,thundering
thwart: thwart
ticking: ticking
ticklish: ticklish
tide: tide
tie: tie,tied
tiff: tiff
tight: tight
tighten: tightened
tightly: tightly
tiller: tiller
tilt: tilted
tilted: tilted
timber: timber,timbers
time: time,times
tin: tin,tins
tinder: tinder
tint: tint
tiny: tiny
tipsy: tipsy
tired: tired
tiring: tiring
tit: tit
title: title
toast: toast,toasted
tobacco: tobacco
toe: toes
tom: tom
tomorrow: tomorrow
ton: tons
tone: tone,tones
tongue: tongue
tonight: tonight
tonnage: tonnage
tool: tools
toon: toon
tooth: teeth,tooth
topple: toppling
topsy: topsy
torch: torch
torchlight: torchlight
torture: torture,tortured
toss: toss,tossed,tossing
tossing: tossing
total: total
totter: tottering
tottery: tottery
touch: touch,touched,touching
tough: tough,toughest
tow: towed
town: town,towns
trace: trace
track: track
tract: tract,tracts
trade: trade,trades
trader: trader
tragedy: tragedy
tragic: tragic
tragical: tragical
trail: trailed,trailing
trailing: trailing
train: train,trained
traitor: traitor
tramp: tramp,tramped,tramping
trample: trampled
transparent: transparent
transportation: transportation
trap: trap,trapped
traveller: traveller
travels: travels
treacherous: treacherous
treachery: treachery
tread: treading,trod
treasure: treasure
treat: treat,treated
treaty: treaty
trebly: trebly
tree: tree,trees
trees: trees
tremble: trembled,trembling
tremendous: tremendous
tremulous: tremulous
trend: trend
trial: trial,trials
trice: trice
trick: trick,tricked
trifle: trifle
trigger: trigger
trim: trim,trimmed
trinidad: trinidad
trinket: trinkets
trio: trio
trip: trip,tripping
triumph: triumph
trojan: trojan
troop: troop,trooping
tropical: tropical
trot: trot,trotted
trouble: trouble,troubled,troubles
troubling: troubling
trough: trough
truantry: truantry
truce: truce
truck: truck
truculently: truculently
true: true
trump: trump
trumpet: trumpet
trundle: trundled,trundling
trunk: trunk,trunks
trust: trust,trusted,trusting,trusts
truth: truth
tumble: tumbled,tumbling
tune: tuned,tunes
turf: turf
turvy: turvy
twentieth: twentieth
twinkle: twinkle
twinkling: twinkling
twist: twisted
twitch: twitch
twitching: twitching
tyrannize: tyrannized
ugly: ugly
ultimate: ultimate
umber: umber
unaccounted: unaccounted
unaffected: unaffected
unarmed: unarmed
unbailed: unbailed
unbroken: unbroken
unburied: unburied
unchanged: unchanged
uncomfortable: uncomfortable
unconquered: unconquered
uncouth: uncouth
uncover: uncovered
understand: understand,understood
undertaking: undertaking
underwood: underwood
undulate: undulating
unearth: unearthed
unearthly: unearthly
uneasy: uneasy
unexplained: unexplained
unfaithful: unfaithful
unfitness: unfitness
ungainly: ungainly
ungodly: ungodly
ungrateful: ungrateful
unhappy: unhappy
unharmed: unharmed
unhealthy: unhealthy
unheeded: unheeded
uniform: uniform
uninhabited: uninhabited
unintelligible: unintelligible
unintentional: unintentional
union: union
unkind: unkind
unknown: unknown
unlooked: unlooked
unlucky: unlucky
unmanly: unmanly
unmistakable: unmistakable
unmoved: unmoved
unnatural: unnatural
unobserved: unobserved
unpleasant: unpleasant
unprotected: unprotected
unprovided: unprovided
unruly: unruly
uns: uns
unsquared: unsquared
unsteadied: unsteadied
unsteady: unsteady
unsteered: unsteered
unusual: unusual
unweariedly: unweariedly
unwearying: unwearying
unwilling: unwilling
upper: upper
uppermost: uppermost
upright: upright
upside: upside
upstairs: upstairs
upstream: upstream
upturn: upturned
upward: upward
ure: ure
usage: usage
useless: useless
usual: usual
utter: utter,uttered
utterly: utterly
vain: vain
valet: valet
valley: valleys
vanish: vanished
vapour: vapour
vapours: vapours
variable: variable
varied: varied
variety: variety
variously: variously
vary: varying
vegetable: vegetable,vegetables
vegetation: vegetation
vehemence: vehemence
veil: veil
vein: vein
vengeance: vengeance
venture: venture,ventured
verge: verge
verse: verse
vessel: vessel
viceroy: viceroy
vicious: vicious
victim: victim,victims
victory: victory
view: view,views
vigour: vigour
vii: vii
viii: viii
vile: vile
villain: villain,villains
villainous: villainous
violence: violence
violent: violent
violently: violently
virtue: virtue
vise: vise
visible: visible
visibly: visibly
visit: visit,visits
vividly: vividly
voice: voice,voices
voices: voices
volition: volition
volley: volley
volubility: volubility
volubly: volubly
volume: volume
volunteer: volunteered,volunteers
vote: vote
voyage: voyage,voyages
wade: wade,waded,wading
wage: wage
wail: wailed
wain: wain
waist: waist
wait: wait,waited,waiting
waiting: waiting
wake: wake,woke
waken: wakened
walk: walk,walked,walking
walking: walking
wall: wall,walls
walrus: walrus
wander: wandered,wandering
wanderings: wanderings
war: war
ward: warded
warily: warily
warm: warm
warmly: warmly
warn: warn,warned,warning
warning: warning
warped: warped
wary: warier
wash: wash,washed,washing
waste: waste,wasted
wasteful: wasteful
watch: watch,watched,watches,watching
watcher: watchers
watchman: watchmen
watchmen: watchmen
water: water,watered,waters
watercourse: watercourse
waterline: waterline
wave: wave,waved,waves,waving
waver: wavering
weak: weak,weaker
weaken: weakened
weakness: weakness
wealth: wealth
weapon: weapon,weapons
wear: wear,wearing,wore,worn
weariness: weariness
wearisome: wearisome
weary: weary
weather: weather
wedge: wedge,wedged
week: week,weeks
weep: weep
weevil: weevil
weigh: weighed
weight: weight
welter: weltering
west: west
western: western
westward: westward
wet: wet,wetted
wheel: wheeling
wheer: wheer
whiff: whiff
whip: whip,whipped
whirl: whirled,whirling
whirr: whirr
whisker: whisker,whiskers
whisper: whisper,whispered,whispering
whispering: whispering
whistle: whistle,whistled,whistling
whit: whit
white: white
whiten: whitened
wicked: wicked,wickedest
wickedness: wickedness
widder: widders
wide: wide,wider,widest
wife: wife
wig: wig
wild: wild
wildly: wildly
willingly: willingly
willingness: willingness
willow: willows
wily: wily
wind: wind,winds
window: window,windows
windward: windward
windy: windy
wine: wine,wines
wing: wing,wings
wink: wink,winked
winter: winter
wipe: wiping
wise: wise,wiser
wisely: wisely
wisp: wisp,wisps
wit: wits
withdraw: withdraw
witness: witness
wolf: wolf
woman: woman
wonderful: wonderful
wonderfully: wonderfully
wood: wood,wooded,woods
wooded: wooded
wooden: wooden
woods: woods
woody: woody
word: word
workman: workmen
workpeople: workpeople
worm: wormed
worry: worry
worth: worth
worthless: worthless
wot: wot
wound: wound,wounded,wounds
wounded: wounded
wrath: wrath
wreck: wreck,wrecked
wrench: wrench,wrenched
wrest: wrest
wrestle: wrestle
wretched: wretched
wretchedness: wretchedness
wriggle: wriggling
wring: wring
wringing: wringing
wrist: wrist
write: write,writing,written,wrote
writhe: writhed
writing: writing
wrong: wrong
xi: xi
xii: xii
xiii: xiii
xiv: xiv
xix: xix
xvi: xvi
xvii: xvii
xviii: xviii
xx: xx
xxi: xxi
xxii: xxii
xxiii: xxiii
xxiv: xxiv
xxv: xxv
xxx: xxx
yard: yard,yards
yarn: yarn
yaw: yaw,yawed,yawing
yell: yell
yellow: yellow
yesterday: yesterday
yield: yielding
yo: yo
youngster: youngsters
younker: younker
youth: youth
