abandon: abandoned
abide: abide
abjure: abjured
absence: absence
absorb: absorbed
abstraction: abstraction
abstruse: abstruse
absurd: absurd
absurdity: absurdities
accept: accept,accepted,accepting
acceptable: acceptable
access: access,accessed
accessible: accessible
acclamation: acclamation
accommodate: accommodating
accommodation: accommodation
accompany: accompanied,accompany,accompanying
account: account
accusatory: accusatory
accuse: accuses
ace: ace
achieve: achieved
acknowledge: acknowledge,acknowledged
acquaintance: acquaintance
acre: acre
action: action
active: active
activity: activity
actual: actual
adapt: adapt,adapted
add: add,adding,adds
addition: addition,additions
additional: additional
address: address,addressed,addresses,addressing
adjust: adjust,adjusted,adjusting
adjustment: adjustment
administer: administering
admiration: admiration
admire: admired
admirer: admirers
admiringly: admiringly
admission: admission
admit: admitted
adorn: adorned
advance: advance,advanced,advancing
advantage: advantage
advantageous: advantageous
adversary: adversary
advertise: advertised
advise: advise,advised
affect: affect
affectation: affectation
affection: affection
affectionate: affectionate
affirmative: affirmative
afflict: afflicted
affliction: affliction
afford: afford,affording
aforesaid: aforesaid
afraid: afraid
afternoon: afternoon
age: age,ages
aged: aged
agent: agent
aggravating: aggravating
agitated: agitated
agitation: agitation
agony: agony
agree: agree,agreed
agreeable: agreeable
agreeably: agreeably
agreement: agreement
aid: aid
air: air
ak: ak
alacrity: alacrity
alarm: alarm
alarmed: alarmed
alchemist: alchemist
alight: alighting
alike: alike
alive: alive
allowance: allowance
allude: allude
aloud: aloud
altar: altar
alter: altered
alteration: alteration
alternate: alternate
altogether: altogether
amalgamation: amalgamation
amazement: amazement
americas: americas
amiable: amiable
ample: ample
amply: amply
amuse: amused
amused: amused
ancient: ancient
angel: angel
angry: angry
anguish: anguish
animal: animal
animation: animation
ankle: ankles
annihilation: annihilation
announcement: announcements
answer: answer,answered
anticipate: anticipated
antiquity: antiquity
anxious: anxious
apartment: apartments
apologise: apologised
appalling: appalling
appeal: appeal
appealingly: appealingly
appearance: appearance
appendage: appendages
appetite: appetite
applause: applause
apple: apples
applicable: applicable
application: application
apply: apply
appoint: appointed
appointment: appointment
apprise: apprised
approach: approach,approached,approaching
approve: approving
apron: apron
arbitrary: arbitrary
archive: archive
ardour: ardour
ark: ark,arks
arks: arks
arm: arm,armed,arms
arrange: arranged
arrangement: arrangements
array: array
arrive: arrive,arrived,arriving
art: art,arts
artful: artful
artfully: artfully
article: article,articles
articulate: articulate
artifice: artifice
artist: artists
artless: artless
ascend: ascended
ascent: ascent
ascii: ascii
ashamed: ashamed
asleep: asleep
aspect: aspect
assemble: assembled
assent: assent
assert: asserted
assertion: assertion
assist: assisted
assistance: assistance
assistant: assistants
association: associations
assorted: assorted
assume: assuming
assumption: assumption
assurance: assurance
assure: assure
astonish: astonished
astonished: astonished
astonishing: astonishing
astonishment: astonishment
astounded: astounded
astoundingly: astoundingly
asunder: asunder
attach: attached
attachment: attachment
attain: attained
attempt: attempting,attempts
attend: attended
attendant: attendant
attention: attention,attentions
attentively: attentively
attitude: attitude
attorney: attorney
attract: attract,attracted
attraction: attraction
audible: audible
augment: augmented
author: author
autograph: autographs
avenging: avenging
average: average
avocation: avocations
awake: awake,awoke
awaken: awakened
aware: aware
awe: awe
awkward: awkward
awkwardness: awkwardness
ays: ays
babby: babby
baby: babies,baby
bacchanalian: bacchanalian
bachelor: bachelor
background: background
bad: bad,worse,worst
bah: bah
bait: bait
bald: bald
ball: balls
bar: bar,bars
bare: bare
barehead: bareheaded
barge: barges
bark: bark,barking,barks
barnacle: barnacle
barrel: barrel
base: based
basket: basket,baskets
beadle: beadle
beam: beaming,beams
bear: bear,bearing,bore,born,borne
bearing: bearing
beast: beast,beasts
beasts: beasts
beat: beat,beaten,beating,beats
beautiful: beautiful
beauty: beauty
bed: bed,beds
bedclothes: bedclothes
bedlam: bedlam
bedpost: bedpost
bedstead: bedstead,bedsteads
bee: bee,bees
beer: beer
beg: beg,begged
beggar: beggar
behold: beheld,behold
belief: belief
bell: bells
bellman: bellmen
belong: belong,belonged
beloved: beloved
bend: bending,bent
beneath: beneath
benefactor: benefactor
benevolent: benevolent
benison: benison
bent: bent
berry: berry
bertha: bertha
beset: beset
bestir: bestir
bestow: bestowed
betray: betrayed
bewail: bewailing
bewailment: bewailment
bewilder: bewildered
bewildering: bewildering
bewilderment: bewilderment
binary: binary
bind: bound
bird: bird,birds
birthday: birthday
bit: bit,bits
bitterly: bitterly
black: black
blame: blame,blaming
blameless: blameless
blank: blank
blanket: blankets
blaze: blaze,blazing
bless: bless,blessed
blessed: blessed
blessing: blessing
blight: blighted
blind: blind
blindness: blindness
bliss: bliss
blithe: blithe,blithest
blithely: blithely
block: block
blood: blood
bloom: blooming
blot: blotting
blotched: blotched
blow: blow,blowing
blue: blue
blush: blush,blushing
board: board
boarding: boarding
boat: boat
body: bodies,body
boil: boil,boiled
bold: bold
bolt: bolt,bolting
bond: bond
bone: bones
bony: bony
book: book,books
boot: boots
bottle: bottles
bottled: bottled
bounce: bouncing
bound: bounding
bountiful: bountiful
bow: bow,bowed
bowl: bowl
box: box,boxes
boxer: boxer,boxers
boxes: boxes
boy: boy,boys
brain: brain
brand: brand
brave: brave
breach: breach
bread: bread
break: break,breaking,broke,broken
breaker: breaker
breakfast: breakfast
breaking: breaking
breast: breast
breath: breath
breathe: breathe
breathless: breathless
breeches: breeches
breed: bred,breed
brick: brick,bricks
bride: bride,brides
bridegroom: bridegroom,bridegrooms
bridge: bridge
bridle: bridling
bright: bright,brightest
brighten: brightened,brightening
brightly: brightly
brilliant: brilliant
bring: bring,bringing,brought
brisk: brisk
briskly: briskly
broad: broad
broken: broken
broker: broker
brood: brooding
brother: brother
brothers: brothers
brow: brow
brown: brown
bud: bud,buds
building: building
bull: bull
bumper: bumper
bunch: bunch
bungle: bungled
burden: burden
burial: burial
burly: burly
burn: burned,burnt
burning: burning
burst: burst,bursting
bury: bury
busily: busily
business: business
bustle: bustle
busy: busy
butt: butt
butter: butter
button: buttoned,buttons
bye: bye
cake: cake,cakes
calculate: calculate,calculated
caleb: caleb
calendar: calendar
calf: calves
caller: callers
calling: calling
callous: callous
calm: calm
calmness: calmness
canal: canal
canary: canary
candle: candle
candy: candied
cannon: cannon
cap: cap,caps
capacity: capacity
cape: cape
capital: capital,capitals
card: card,cards
care: care,cared,cares
carefully: carefully
caress: caressing
carriage: carriage
carrier: carrier,carriers
carry: carried,carry,carrying
cart: cart,carts
carve: carved
cash: cash
cast: cast,casting
cat: cats
catch: caught
caution: caution
cease: cease
ceiling: ceiling,ceilings
centre: centre
ceremony: ceremony
certainty: certainty
chafing: chafing
chain: chain
chair: chair,chairs
chaise: chaise
chalk: chalk
challenge: challenge,challenging
chamber: chamber
chamberlain: chamberlain
chance: chance
change: change,changed,changing
changed: changed
chapter: chapter
character: character,characters
characteristic: characteristics
charge: charge,charges
charitable: charitable
charity: charities,charity
charles: charles
charming: charming
chat: chat
cheap: cheap
check: check,checked,checks
cheek: cheek
cheer: cheer,cheered
cheerful: cheerful
cheerfulness: cheerfulness
cheery: cheery
cherish: cherish,cherished
chest: chest
chi: chi
chief: chief
chiefly: chiefly
child: child,children
chilly: chilly
chime: chime
chimney: chimney
chin: chin
chip: chip
chirp: chirp,chirped,chirping
chirrup: chirrup,chirruped
choice: choice
choke: choked
choose: choose,chose
chorus: chorus
christen: christened
christian: christians
christmas: christmas
chubby: chubby
chuck: chuck
chuckle: chuckle
church: church
churchyard: churchyard
circle: circle
circumstance: circumstance,circumstances
city: city
claim: claim
clap: clapped
clapping: clapping
clasp: clasp,clasping
clasped: clasped
class: classes
clatter: clattered
clay: clay
clean: clean
cleaver: cleavers
clench: clenched
clerk: clerk
clever: clever
clinch: clinch
cling: clung
cloak: cloak
clock: clock,clocks
close: close,closed,closer,closest
closely: closely
clot: clots
cloth: cloth
clothes: clothes
clothing: clothing
cloud: cloud,clouds
club: club
clumsy: clumsy
cluster: cluster
clutch: clutches
coach: coach
coal: coal
coarse: coarse
coat: coat
coax: coaxing
cock: cocking
code: codes
cognizance: cognizance
cold: cold
collar: collar
collection: collection
colour: colour,coloured,colours
combination: combination
comely: comely
comfort: comfort,comforted
comfortable: comfortable
comfortably: comfortably
comical: comical
command: commanding
commend: commend,commended
commercial: commercial
commit: commit,committed
common: common
commotion: commotion
communication: communication
compact: compact
compactness: compactness
companion: companion,companions
company: company
compare: compare,compared
comparison: comparison
compass: compass
compassionate: compassionate
compassionately: compassionately
compeer: compeers
compel: compel
competition: competition
compilation: compilation
complaint: complaints
complete: complete
completely: completely
compliance: compliance
compliment: compliments
comply: comply,complying
compose: composed
composedly: composedly
comprehend: comprehend
compress: compressed
conceal: conceal,concealing
concentrate: concentrated
concentrated: concentrated
concept: concept
concern: concern
concerned: concerned
conclude: concluded
conclusion: conclusion
concussion: concussions
condition: condition
conditioned: conditioned
condolence: condolence
conduct: conduct
confess: confess
confession: confession
confidence: confidence
confident: confident
confine: confining
confirm: confirmed
confirmation: confirmation
confound: confounded
confuse: confused
confusion: confusion
congratulation: congratulations
connect: connecting
connection: connection
connive: conniving
conscience: consciences
conscious: conscious
consciously: consciously
consciousness: consciousness
consent: consent
consequence: consequence,consequences
consequential: consequential
considerable: considerable
considerate: considerate
consideration: consideration
console: console
constancy: constancy
constant: constant
consternation: consternation
contact: contact
contemplate: contemplate
contemplation: contemplation
contempt: contempt
content: content
contented: contented
contents: contents
continue: continued
contract: contract
contradict: contradict,contradicted
contrast: contrast
contribution: contribution,contributions
contrived: contrived
control: control
contumely: contumely
convenience: convenience
convenient: convenient
conversation: conversation
converse: converse
convert: convert
convey: convey
conviction: conviction
convivial: convivial
convulsion: convulsion,convulsions
convulsive: convulsive
cook: cook,cooks
cookery: cookery
copiously: copiously
copying: copying
copyright: copyright
coquettish: coquettish
cordiality: cordiality
core: core
corner: corner,corners
corporation: corporation
correct: correct,correcting
corroborate: corroborated
corrupt: corrupt
corset: corset
cosiness: cosiness
cost: cost,costs
costume: costume
cosy: cosy
cot: cot
cottage: cottages
cotton: cotton
cough: coughed
council: councils
counsel: counsel
count: count
countenance: countenance,countenances
counterfeit: counterfeited
counterpart: counterpart
counting: counting
country: countries,country
couple: couple,couples
courage: courage
courageous: courageous
court: courting
cover: covered,covering
covering: covering
cow: cow
coy: coy
crack: crack
cracked: cracked
cracker: cracker,crackers
cradle: cradle,cradles
cram: crammed
cramped: cramped
crazy: crazy
cream: cream
create: created,creating
creation: creation
creature: creature,creatures
credit: credit
creep: crept
crevice: crevices
cribbage: cribbage
cricket: cricket,crickets
crimson: crimson,crimsoned
crisis: crisis
crisp: crisp
critical: critical
crook: crook
crop: crop
cross: crossed
crouch: crouching
crowd: crowd
crown: crown
crowning: crowning
cruel: cruel
crusty: crusty
cuckoo: cuckoo
cup: cup,cups
cupboard: cupboard
curious: curious
curly: curly
current: current
curtain: curtain
customary: customary
customer: customer
cut: cut,cuts
cymbal: cymbal
da: da
daily: daily
dainty: dainties,dainty
daisy: daisy
damage: damage,damaged
damaged: damaged
damages: damages
dame: dame
dance: dance,danced,dancing
dancing: dancing
danger: danger
dangerous: dangerous
dark: dark,darker
darken: darkened
darkly: darkly
darkness: darkness
darling: darling
darn: darned
dash: dash,dashed,dashes,dashing
datum: data
daughter: daughter,daughters
david: david
day: day,days
daytime: daytime
dead: dead
deaf: deaf
deal: deal,dealt
dearest: dearest
dearly: dearly
death: death
deathless: deathless
deceit: deceit
deceive: deceive,deceived
december: december
deception: deception,deceptions
decide: decided
decidedly: decidedly
declare: declare,declared
decline: declining
decorate: decorated
deductible: deductible
deed: deed
deem: deemed
deep: deep
deer: deer
defect: defect,defects
defective: defective
defer: defer
deference: deference
defiance: defiance
define: defined
degree: degree,degrees
dejected: dejected
delectation: delectation
deletion: deletions
delf: delf
delicacy: delicacies
delicate: delicate
delicious: delicious
delight: delight
delighted: delighted
deliver: deliver,delivered,delivering
delivery: delivery
delude: deluding
delusion: delusions
demand: demand,demanded
demolition: demolition
demon: demon
demoniacal: demoniacal
demonstration: demonstration
demonstrative: demonstrative
demure: demure
denote: denoting
deny: denied
depend: depends
depict: depicted
deplorable: deplorable
deposit: deposited
deprivation: deprivation
deprive: deprived
deputy: deputy
der: der
derivative: derivative
derive: derive,derived,deriving
descent: descent
description: description
deserve: deserve,deserving
design: design,designed
desirable: desirable
desire: desire,desired
desk: desk
desolate: desolate
desperation: desperation
despise: despised
despondent: despondent
destroy: destroy,destroyed
detach: detach
determine: determine,determined
development: development
devil: devil
devote: devoted
devoted: devoted
devotedly: devotedly
devotion: devotion
devout: devout
dexterous: dexterous
dickens: dickens
dictionary: dictionary
die: die,died
difference: differences
difficult: difficult
difficulty: difficulties,difficulty
dignified: dignified
dignity: dignity
dilate: dilated
dim: dim
dimly: dimly
dimpled: dimpled
dingy: dingy
dinner: dinner
direct: direct
direction: direction,directions
director: director
disadvantage: disadvantage
disagreeably: disagreeably
discernment: discernment
disciplinarian: disciplinarian
disclaim: disclaim
disclaimer: disclaimer,disclaimers
disclose: disclosed
discolour: discoloured
discomfiture: discomfiture
discompose: discomposed
disconcerting: disconcerting
discontented: discontented
discontinue: discontinue
discouragement: discouragement
discourse: discourse
discover: discover,discovered
discovery: discoveries
discretion: discretion
discuss: discussed
disdain: disdained
disguise: disguise,disguised
disgusted: disgusted
dish: dishes
disk: disk
dismally: dismally
dismiss: dismissed
disparity: disparity
display: display,displayed,displaying
dispose: disposed
disposition: disposition
disproportionate: disproportionate
dispute: dispute,disputing
dissipation: dissipation
distance: distance
distant: distant
distaste: distaste
distended: distended
distinct: distinct
distinction: distinction,distinctions
distraught: distraught
distress: distress
distressed: distressed
distribute: distribute,distributed,distributing
distribution: distribution
distributor: distributor
distrust: distrust
disturb: disturb,disturbed
disturbed: disturbed
dive: dived
divert: diverted
diviner: diviner
diving: diving
doctor: doctor
dog: dog,dogs
doleful: doleful
doll: doll,dolls
dolls: dolls
domain: domain
domestic: domestic
donate: donate
donation: donation,donations
donor: donors
door: door,doors
doorway: doorway,doorways
dot: dot,dots
dote: dote,doted
doth: doth
double: doubled
doubt: doubt
doubtless: doubtless
dove: dove
downcast: downcast
download: downloading
downward: downward
doze: dozed,dozing
dozen: dozen,dozens
drag: drag
draw: draw,drawing,drawn,drew
dread: dread
dreadful: dreadful
dreadnought: dreadnought
dream: dream,dreamed,dreams
dreamy: dreamy
dress: dress,dressed
dresser: dressers
dressing: dressing
dressmaker: dressmaker
dribble: dribble
drift: drift
drink: drank,drink,drinking
drive: drive,drove
driver: drivers
droop: drooped
drop: dropped
drown: drown
drowsily: drowsily
drum: drum,drums
drunk: drunk
drunken: drunken
dry: dried,dry,drying
dull: dull
dumb: dumb
dumpling: dumpling
dunce: dunce
dusk: dusk
dust: dust,dusted
dutch: dutch
dutchmen: dutchmen
dutiful: dutiful
duty: duty
dwell: dwelling
dwelling: dwelling
eager: eager
eagerly: eagerly
ear: ear,ears
eared: eared
earnest: earnest
earnestness: earnestness
earth: earth
earthenware: earthenware
earthly: earthly
easily: easily
east: east
easy: easy
eat: ate,eat,eating
eccentric: eccentric
echo: echoed
ecstasy: ecstasy
edition: edition,editions
educational: educational
edward: edward
effectual: effectual
effort: effort,efforts
elbow: elbow,elbows
elder: elder
elect: elect
electronic: electronic
electronically: electronically
element: element
elephant: elephants
elicit: eliciting
eligible: eligible
elm: elms
email: email
embarrassed: embarrassed
embrace: embrace,embraced
emotion: emotion,emotions
emphasise: emphasised
emphatic: emphatic
empire: empire
employ: employed
employee: employee,employees
employer: employer
emulation: emulation
enchanted: enchanted
encircle: encircled,encircling
encode: encoding
encounter: encountered
encouragement: encouragement
endearing: endearing
endearment: endearment
endeavour: endeavouring
endurance: endurance
endure: endure
enemy: enemy
energy: energy
engage: engage,engaged
engagement: engagement
english: english
enjoy: enjoy,enjoying
enjoyment: enjoyment
enlighten: enlighten
enshrine: enshrined
ensue: ensued
ensure: ensuring
entangle: entangled
enter: entered,entering
entertain: entertained
entertainment: entertainment
enthusiasm: enthusiasm
entitle: entitled
entity: entity
entwine: entwined
equal: equal
equally: equally
equipment: equipment
equivalent: equivalent
erect: erect
errand: errand
error: errors
escape: escapes
escort: escorting
especial: especial
essence: essence
establish: established
established: established
establishment: establishment,establishments
estate: estate
estimate: estimate
eternal: eternal
euclid: euclid
eve: eve
evening: evening,evenings
event: events
evident: evident
evidently: evidently
exacting: exacting
exaggerated: exaggerated
excellent: excellent
exchange: exchanged
excited: excited
excitement: excitement
exclaim: exclaimed
exclusion: exclusion
excuse: excuse
executive: executive
exempt: exempt
exertion: exertions
exhibit: exhibited,exhibiting
exist: exist,exists
existence: existence
expand: expanding
expect: expect,expected,expecting
expectancy: expectancy
expectation: expectation
expedition: expedition
expend: expend
expense: expense,expenses
expensive: expensive
experience: experience,experienced
experienced: experienced
explanation: explanation
explanatory: explanatory
export: exporting
expose: exposed
express: express,expressed,expresses
expression: expression,expressions
expressive: expressive
expressly: expressly
exquisite: exquisite
extent: extent
extinguish: extinguished
extraordinary: extraordinary
exultation: exultation
exulting: exulting
exultingly: exultingly
eye: eye,eyes
eyed: eyed
eyelash: eyelashes
faced: faced
facetiously: facetiously
facility: facility
fade: faded
fag: fag
fail: failed,failing
fain: fain
faint: faint
faintheartedness: faintheartedness
fair: fair,fairest
fairbanks: fairbanks
fairies: fairies
fairy: fairies,fairy
faithful: faithful
faithfully: faithfully
fall: fall,fallen,falling,fell
false: false
falsehood: falsehood
falter: faltered,faltering
fame: fame
familiar: familiar
family: family
fancy: fancied,fancies,fancy
fantastic: fantastic
farmer: farmers
fashion: fashion
fashionable: fashionable
fast: fast
fat: fat,fatter
fatal: fatal
fatality: fatality
fate: fate
father: father,fathers
fault: faults
favour: favour,favours
favourable: favourable
favourite: favourite
fear: fear,fears
feast: feast
feather: feather
feature: feature,features
federal: federal
fee: fee,fees
feel: feel,feeling,feels
feeling: feelings
feign: feigning
fellow: fellow
ferocity: ferocity
fervency: fervency
fervent: fervent
festival: festival
fickleness: fickleness
fictitious: fictitious
fiddle: fiddle,fiddles
fidelity: fidelity
field: fields
fielding: fielding
fiendish: fiendish
fierce: fiercer
fight: fighting
figure: figure,figures
file: file,files
filler: filler
filling: filling
finally: finally
financial: financial
fine: fine
finger: finger,fingers
finish: finish,finished
firebox: firebox
fireside: fireside
firm: firm,firmer
firmly: firmly
fish: fish
fit: fit,fits,fitted
fitness: fitness
flame: flame
flank: flanked
flannel: flannel
flare: flaring
flash: flash,flashing
flatly: flatly
fling: flinging,flings
floor: floor
flour: flour
flow: flow
flower: flower,flowers
flush: flushed
flustered: flustered
flutter: flutter,fluttering
fluttered: fluttered
fly: flies,fly,flying
flying: flying
fog: fog
foggy: foggy
fold: folds
follow: follow
folly: folly
fond: fond
fonder: fonder
fondle: fondled,fondling
foolery: foolery
foolish: foolish
foot: feet,foot,footing
footfall: footfall
force: force,forced
forefinger: forefinger
forehead: forehead
foreign: foreign
foremost: foremost
foresee: foreseen
forge: forged
forget: forget,forgets,forgot,forgotten
forgive: forgive,forgiving
forgiveness: forgiveness
fork: fork
forlorn: forlorn
form: form,formed,forms
format: format,formats
forsake: forsaken
forthwith: forthwith
fortnight: fortnight
fortune: fortune
foundation: foundation
foundling: foundling
fowl: fowls
fragment: fragment
fragrance: fragrance
frame: framed
frank: frank
frantic: frantic
fraught: fraught
freely: freely
freeze: freeze,frozen
frequently: frequently
fresh: fresh,fresher
freshly: freshly
freshness: freshness
friction: friction
friend: friend,friends
friendly: friendly
frighten: frighten,frightened
frightened: frightened
frightful: frightful
frivolity: frivolity
fro: fro
frost: frost
froward: froward
fulness: fulness
furnish: furnished
furnishing: furnishing
furniture: furniture
furrow: furrow
furtive: furtive
fury: fury
future: future
gaiety: gaiety
gain: gained
gaiter: gaiters
gallant: gallant
gallery: gallery
gambol: gambols
game: game
gape: gaping
garb: garb
garden: garden
garland: garlands
garment: garment,garments
garret: garret
gash: gashed
gasp: gasping
gather: gathered,gathering
gaudy: gaudy
gay: gay
gaze: gazed
generation: generation,generations
generous: generous
genius: genius
genteel: genteel
gentility: gentility
gentle: gentle,gentlest
gentleman: gentleman,gentlemen
gentleness: gentleness
gentlewoman: gentlewoman
gently: gently
gentry: gentry
george: george
germ: germ
giant: giant
giants: giants
giddiness: giddiness
giddy: giddy
gigantic: gigantic
girl: girl,girls
glad: glad
gladly: gladly
glance: glance,glanced,glancing
glare: glare
glass: glass
glaze: glazing
gleam: gleam,gleamed,gleaming
glee: glee
glide: glided
glimpse: glimpse,glimpses
globe: globe
gloom: gloom
glorious: glorious
glove: gloves
glow: glow
goad: goading
goal: goals
goblin: goblin
god: god
gods: gods
gold: gold
golden: golden
goodness: goodness
goose: geese,goose
gossip: gossiping
govern: govern
governor: governor
gown: gown
grace: grace
gracefully: gracefully
gracing: gracing
gracious: gracious
grade: grade
gradual: gradual
gradually: gradually
grandchild: grandchildren
grant: granted
grapple: grapple
grasp: grasp
grass: grass
grate: grate
grateful: grateful
gratefully: gratefully
gratify: gratify
gratitude: gratitude
grave: grave,graves
gravely: gravely
graze: grazed
greatly: greatly
green: green,greener,greens
gregory: gregory
grey: grey,greyer
grief: grief
grim: grim
grind: grinding
grip: grip
grope: groping
gross: gross
grotesque: grotesque
ground: ground
grow: grew,grow,growing
growl: growl
grown: grown
grudging: grudging
gruff: gruff
gruffs: gruffs
grumble: grumble,grumbled
guard: guard
guardian: guardian
guardians: guardians
guest: guest
guide: guide
guilty: guilty
gun: gun,guns
gush: gushing
ha: ha
hah: hah
hair: hair,hairs
haired: haired
hairy: hairy
hal: hal
halfpence: halfpence
halloa: halloa
halt: halting
ham: ham
hammer: hammer,hammered
hams: hams
hand: hand,hands
handed: handed
handicraft: handicraft
handle: handle,handles
handsome: handsome
handsomer: handsomer
hang: hanging,hung
happen: happen,happened,happening
happily: happily
happiness: happiness
happy: happier,happiest,happy
hard: hard,harder
hardship: hardships
hark: hark
harm: harm
harmless: harmless
harness: harness
harp: harp
harsh: harsh
hart: hart
hastily: hastily
hasty: hasty
hat: hat
hate: hate
haunted: haunted
hay: hay
haymaker: haymaker
head: head,headed
healthy: healthy
heap: heaped
hear: hear,heard,hearing
heart: heart,hearts
hearted: hearted
hearth: hearth
hearthstone: hearthstone
heartily: heartily
heartiness: heartiness
hearty: hearty
heaven: heaven
heavily: heavily
heavy: heaviest,heavy
hedge: hedges
heed: heed
heedless: heedless
heel: heel,heels
helpless: helpless
hesitate: hesitated,hesitating
heyday: heyday
hiccough: hiccoughing
hide: hide
hideous: hideous
hie: hie
hilarious: hilarious
hint: hint
hiss: hissed
hoar: hoar
hoarse: hoarse
hob: hob
hold: held,hold,holding
holden: holden
holder: holder
holiday: holiday
hollow: hollow
homage: homage
homely: homely
honest: honest
honour: honour,honouring,honours
hook: hook
hooked: hooked
hope: hope,hoped,hopes,hoping
hopeful: hopeful
hopeless: hopeless
horizontal: horizontal
horrified: horrified
horse: horse,horses
horseback: horseback
hospitality: hospitality
hotly: hotly
hour: hour,hours
house: house,houses
household: household
hover: hovering
howl: howl
hue: hue
hug: hugged
huge: huge
hull: hull
hum: hum,hummed,hums
human: human
humble: humble,humbled
humbug: humbug
humdrum: humdrum
humility: humility
humour: humour
humourist: humourist
humph: humph
hundredweight: hundredweights
hurried: hurried
hurriedly: hurriedly
hurry: hurried,hurry
husband: husband,husbands
hush: hush,hushing
hustle: hustled
ice: ice
idea: idea
identification: identification
identify: identify
identity: identity
idiot: idiot
idle: idle
idol: idol
ignorant: ignorant
iii: iii
illumine: illumined
illustrate: illustrated
illustration: illustration,illustrations
image: image,imaged,images
imaginary: imaginary
imagination: imagination
imagine: imagine,imagined
imitation: imitation
immensely: immensely
impart: imparted
impartially: impartially
impassioned: impassioned
impatient: impatient
imperfect: imperfect
imperil: imperilled
imperturbably: imperturbably
implacable: implacable
implement: implements
implicitly: implicitly
imply: implied,imply
impose: imposed
impossible: impossible
impression: impression,impressions
imprint: imprinted
improve: improve,improved
improvement: improvement
inaccurate: inaccurate
inaction: inaction
inappropriate: inappropriate
incense: incense
incessantly: incessantly
incident: incident,incidents
incidental: incidental
incite: incite
incline: inclined,inclining
include: include,included,includes,including
including: including
inclusive: inclusive
incoherently: incoherently
income: income
incomplete: incomplete
inconceivable: inconceivable
inconsistent: inconsistent
inconstancy: inconstancy
incontrovertible: incontrovertible
increase: increase,increasing
incredulity: incredulity
indefinite: indefinite
indemnify: indemnify
indemnity: indemnity
independent: independent
indescribable: indescribable
indifference: indifference
indifferent: indifferent
indignation: indignation
indigo: indigo
indirect: indirect
indirectly: indirectly
indispensable: indispensable
indistinct: indistinct
individual: individual
induce: induce
indulge: indulge
inevitable: inevitable
inexhaustible: inexhaustible
infallible: infallible
infallibly: infallibly
infant: infant,infants
infer: infer
infinite: infinite
infirmity: infirmity
influence: influence,influences
inform: informing
infringement: infringement
ingenious: ingenious
innocent: innocent
innumerable: innumerable
inquire: inquire,inquired,inquiring
inquisitively: inquisitively
inroad: inroad
insanely: insanely
inscribe: inscribed
inscription: inscription
insert: inserted
insinuate: insinuate,insinuated
insinuation: insinuations
insomuch: insomuch
inspire: inspire,inspired
inspiring: inspiring
install: installed
instance: instance
instant: instant
instantly: instantly
instinctively: instinctively
institution: institution
instruction: instruction
instrument: instrument,instruments
insult: insult
intellectual: intellectual
intend: intended,intending
intense: intense
intensify: intensifying
intent: intent
intention: intention
intently: intently
interchange: interchange
interfere: interfered
internal: internal
international: international
interpose: interposed
interpret: interpreted
interrupt: interrupt,interrupted
interval: interval,intervals
interview: interview
invalidity: invalidity
invariably: invariably
invent: invent,invented
invest: invested
invitation: invitation
invocation: invocation
involuntary: involuntary
iron: iron
irrepressible: irrepressible
irresistible: irresistible
irs: irs
iso: iso
isolate: isolated
jacks: jacks
january: january
jaw: jaw
jeffrey: jeffrey
jerk: jerked,jerking
jest: jest
jewel: jewels
jig: jig
jog: jog,jogged,jogging
john: john
joke: joke,joking
jolly: jolly
journey: journey
jovial: jovial
joy: joy,joys
joyful: joyful
judge: judge,judged,judging
judgment: judgment
juggling: juggling
jumble: jumbled
jump: jump
juncture: juncture
justice: justice
keel: keel
keen: keen
keener: keener
keg: keg
kettle: kettle
keyhole: keyhole
kick: kick,kicked,kicks
kill: kill
kindly: kindly
kindness: kindness
king: king
kiss: kiss,kissed,kissing
kitchen: kitchen,kitchens
kites: kites
knee: knees
knife: knife
knob: knob,knobs
knock: knock,knocked,knocking
knocker: knockers
knot: knot
knotty: knotty
knowledge: knowledge
knuckle: knuckle
labour: laboured,labouring
lack: lack
lady: ladies,lady
lake: lake
lamb: lamb
lamentably: lamentably
lamp: lamps
lane: lane
language: language
lank: lank
lantern: lantern,lanterns
lap: lap
lapse: lapsed
latch: latch
late: late
laugh: laugh,laughed,laughing
laughter: laughter
lavish: lavished
law: law,laws
lawyer: lawyer,lawyers
lay: laid,lay,laying
lazy: lazy
lead: lead,leading,led
leader: leader
leaf: leaf,leaves
lean: lean,leaned,leaning
leaning: leaning
leap: leap,leaping
learn: learn,learnt
leather: leather
leave: leave,leaves,leaving,left
leer: leer
left: left
leg: leg,legs
legal: legal
legally: legally
leisurely: leisurely
lender: lender
lesson: lesson
level: level
liability: liability
liable: liable
liberty: liberties,liberty
library: library
licence: licence
license: license
licensed: licensed
lid: lid
lie: lie,lies,lying
lieu: lieu
life: life,lives
lift: lift,lifted
light: light,lighted
lighting: lighting
lightly: lightly
liking: liking
limb: limbs
limit: limited
limitation: limitation
limited: limited
linen: linen
linger: linger,lingering
link: linked,linking,links
lion: lion
lip: lips
list: listed
listen: listen,listened,listening
listener: listener
literally: literally
literary: literary
live: live,lived,living
lively: liveliest,lively
living: living
loa: loa
load: loaded
loaf: loaf
locate: located
location: locations
lock: locked
lodging: lodging
lonely: lonely
loose: loose
loosely: loosely
lor: lor
lord: lord
lose: lost
loss: loss
lot: lot
loud: loud,louder,loudest
love: love,loved,loving
lovely: lovely
lover: lover,lovers
loving: loving
loyal: loyal
lucky: luckiest,lucky
lumbago: lumbago
lumber: lumbering
lung: lungs
machine: machine
mad: mad
magic: magic
magnify: magnifying
magnitude: magnitude
mahogany: mahogany
main: main
maintain: maintaining
majestic: majestic
maker: makers
malice: malice
maliciously: maliciously
manage: managed
management: management
mane: mane
manger: manger
manly: manly
manner: manner
mansion: mansion
mantel: mantel
mantle: mantle
mark: mark,marked,marks
market: market
marriage: marriage,marriages
married: married
marrow: marrow
marry: married,marry
marvel: marvels
mary: mary
mask: masks
master: master
mastiff: mastiff
match: match,matches
maternal: maternal
matron: matron,matrons
matronly: matronly
matter: matter,mattered,matters
maudlin: maudlin
maximum: maximum
meadow: meadow
meagre: meagre
meal: meal
meaning: meaning
measure: measure
mechanical: mechanical
meditate: meditating
meditation: meditation
medium: medium
meet: meet,meeting,met
melancholy: melancholy
mellow: mellow
melodious: melodious
mentally: mentally
mention: mention
merchant: merchant
merchantability: merchantability
mercy: mercy
mere: mere
merit: merit,merits
merrily: merrily
merry: merrier,merry
messenger: messenger
method: method,methods
mettle: mettle
mexican: mexicans
michael: michael
middle: middle
midst: midst
midsummer: midsummer
mild: milder
mildly: mildly
mile: mile,miles
milestone: milestone
mince: mincing
mind: mind,minding
mindful: mindful
mineral: mineral
mingle: mingled
minute: minute,minutes
mire: mire
mirror: mirror
miserable: miserable
miserably: miserably
misery: misery
misgiving: misgivings
mislay: mislaid
mission: mission
mississippi: mississippi
mist: mist,mists
mistake: mistake
mistress: mistress
misunderstand: misunderstood
mitre: mitre
mockingly: mockingly
model: model
moderate: moderate
modification: modification
modify: modified
moist: moist
moment: moment,moments
money: money
monosyllable: monosyllable
monster: monster,monsters
monstrous: monstrous
month: month,months
mood: mood
moon: moon
moorish: moorish
moral: moral
morally: morally
morning: morning,mornings
morosely: morosely
moroseness: moroseness
morrow: morrow
moss: moss
mother: mother,mothers
motherless: motherless
motherly: motherly
motion: motion
motionless: motionless
motive: motives
moulder: mouldering
mound: mound
mount: mount
mourn: mourning
mournful: mournful
mouth: mouth
mouthful: mouthful
movable: movable
mow: mowed
mower: mower
muffled: muffled
muffler: mufflers
multitude: multitude
mum: mum
murder: murder
murky: murky
murmur: murmured
muse: mused,musing
music: music
musical: musical
musing: musing
muslin: muslin
mutinous: mutinous
mutter: muttered
mutton: mutton
mysterious: mysterious
mystify: mystified
nail: nailing
nankeen: nankeen
narrate: narrate
narrative: narrative
narrow: narrow
narrowly: narrowly
natural: natural
naturally: naturally
nature: nature
natured: natured
nearer: nearer
neat: neat
neatness: neatness
neck: neck
needful: needful
needle: needle
needlework: needlework
negligence: negligence
neighbour: neighbouring,neighbours
neighbourhood: neighbourhood
nerve: nerved
nervous: nervous
nestle: nestled,nestling
network: network
newly: newly
newsletter: newsletter
nice: nice
niece: niece
nigh: nigh
night: night
nightingale: nightingale
nightly: nightly
nightmare: nightmare
nimble: nimble
noah: noah
nobility: nobility
noble: noble
nod: nod,nodded,nodding
noise: noise,noises
noisy: noisy
nonce: nonce
nonproprietary: nonproprietary
noon: noon
north: north
nose: nose
nostril: nostrils
notch: notch
note: note
notice: notice,noticed
notify: notifies
notion: notion
noun: nouns
novelty: novelty
november: november
nudge: nudge
nudging: nudging
numerous: numerous
nuptials: nuptials
nurse: nurse,nurses
nursing: nursing
nut: nut,nuts
nuts: nuts
nutshell: nutshell
oats: oats
obdurate: obdurate
obedient: obedient
obey: obeys
object: object,objects
objectionable: objectionable
oblige: obliged
observation: observation
observe: observe,observed,observing
obsolete: obsolete
obstacle: obstacles
obstinate: obstinate
obstruction: obstruction
obtrusive: obtrusive
occasion: occasion,occasions
occasional: occasional
occasionally: occasionally
occupation: occupation
occupy: occupied
occur: occur,occurred
occurrence: occurrence
odd: odd
offensive: offensive
offer: offered,offers
office: office,offices
officer: officer
official: official
officious: officious
ogre: ogre
omnipotence: omnipotence
online: online
operation: operation,operations
opinion: opinion
opportunely: opportunely
opportunity: opportunities,opportunity
orange: oranges
ordinary: ordinary
organize: organized
origin: origin
original: original
originate: originated
originator: originator
ornament: ornament
outdated: outdated
outer: outer
outpost: outposts
outraged: outraged
overawe: overawed
overcharge: overcharged
overflow: overflow,overflowing
overflowing: overflowing
overrule: overruled
ow: ow
owe: owed
owl: owl
owner: owner
oy: oy
pace: pace
pacing: pacing
pack: pack,packed
package: packages
paid: paid
pain: pain
painful: painful
paint: painted
painter: painter
painting: painting
pair: pair
palace: palace
pale: pale
palpitating: palpitating
panel: panels
pang: pang
pant: panted
paper: paper
paperwork: paperwork
paragraph: paragraph,paragraphs
parcel: parcel,parcels
pardon: pardon
parent: parents
parliament: parliament
parliamentary: parliamentary
parrot: parrots
parson: parson
partake: partake
partial: partial
partner: partners
party: party
pass: pass,passed
passage: passage
passenger: passengers
passion: passion
pastry: pastry
pat: patted
patch: patches
paternal: paternal
pathetic: pathetic
patient: patient
patronise: patronising
patten: patten,pattens
pause: pause,paused,pausing
pavement: pavement
paw: paw
pay: paid,pay,paying,pays
payment: payments
peace: peace
peaceable: peaceable
peculiarly: peculiarly
peel: peeled,peeling
peep: peep,peeped
peer: peering
peevish: peevish
peg: pegging,pegs
penetrate: penetrate,penetrating
penitence: penitence
penitent: penitent
pensively: pensively
perceive: perceived,perceiving
perception: perception
perfect: perfect
perfection: perfections
perfectly: perfectly
perfidious: perfidious
perform: perform,performed,performing
performance: performance,performances
peril: perils
periodic: periodic
permanent: permanent
permission: permission
permit: permit,permitted
perpetual: perpetual
perpetually: perpetually
perplex: perplexed
perplexity: perplexity
persevere: persevered
person: people,person,persons
personal: personal
perspective: perspective
persuade: persuade
pertinacity: pertinacity
pertly: pertly
perverse: perverse
pets: pets
petty: petty
philanthropic: philanthropic
philosopher: philosopher
phrase: phrase
physical: physical
pic: pic
pickle: pickled
picture: picture
pie: pie,pies
piece: piece,pieces
pierce: piercing
pig: pig,pigs
pigeon: pigeons
pillow: pillow
pimple: pimple
pinch: pinch,pinched
pine: pined
pipe: pipe,pipes
pitch: pitch
pitcher: pitcher
piteously: piteously
pitfall: pitfall
pitiable: pitiable
pity: pity,pitying
plain: plain
plainly: plainly
plan: plan,plans
plaster: plaster
plate: plates
play: play,played,plays
playful: playful
plead: plead,pleaded,pleading,pleads
pleading: pleading
pleasant: pleasant
pleasantly: pleasantly
pleased: pleased
pleasure: pleasure
plenty: plenty
plod: plodded
plodding: plodding
pluck: plucking
plume: plume
plummer: plummer
plunge: plunged,plunging
plural: plural
ply: plied,plying
pocket: pocket,pockets
poetical: poetical
poetry: poetry
poison: poisoned
poke: poking
ponder: pondering
pony: pony
poor: poor
poplar: poplar
popular: popular
portal: portal
portrait: portrait
portraiture: portraiture
position: position,positions
positive: positive
possess: possessed
possession: possession
possibility: possibility
post: post,posted,posting,posts
postman: postman
postpone: postponing
pot: pot,pots
potato: potatoes
potent: potent
pouch: pouch
pour: pouring
pout: pouting
power: power
powers: powers
practical: practical
practically: practically
practice: practice
pray: pray,prayed
prayer: prayers
precaution: precaution
precept: precepts
precious: precious
precisely: precisely
preferred: preferred
prematurely: prematurely
premise: premises
prepare: prepare,prepared
prepared: prepared
presence: presence
presently: presently
preserve: preserve,preserved
press: press,pressed,pressing
pressure: pressure
presumptuous: presumptuous
pretend: pretend,pretending
pretension: pretensions
pretty: pretty
prevent: prevent,prevented
previous: previous
price: price
prick: pricked
pride: pride
primitive: primitive
principal: principal
principle: principle
print: print,printed
private: private
privilege: privileges
proceed: proceeded,proceeding
proceedings: proceedings
process: process
processing: processing
prodigious: prodigious
prodigiously: prodigiously
produce: produce,produced,producing
production: production
professional: professional
professor: professor
profit: profit,profits
prohibit: prohibited
prohibition: prohibition
project: project,projecting
prominent: prominent
prominently: prominently
promise: promise
promote: promoting
promotion: promotion
proofread: proofread
property: property
proportion: proportion
propose: propose,proposed
proposition: proposition
proprietary: proprietary
propriety: proprieties
prose: prose
protect: protect
protection: protection
proudly: proudly
prove: prove,proved,proving
provide: provide,providing
provision: provision,provisions
provocation: provocation
provoking: provoking
proxy: proxy
public: public
puff: puffed
pull: pull,pulling
punitive: punitive
pure: pure
purpose: purpose
purse: purse
pursuance: pursuance
pursue: pursued,pursuing
pursuit: pursuit
push: pushing
puzzled: puzzled
pyramid: pyramid
quaint: quaint
quality: qualities
quarrelsome: quarrelsome
quarter: quarter,quarters
querulous: querulous
question: question,questions
quick: quick
quiet: quiet
quietly: quietly
race: race
rack: rack
radiant: radiant
rag: rag
rail: rails
rain: rain
rainbow: rainbows
raise: raised
rambling: rambling
rap: rapped,rapping,raps
rapidity: rapidity
rapture: rapture
rapturous: rapturous
rare: rare
rash: rash
rationally: rationally
rattle: rattled,rattling
raven: ravens
raw: raw
ray: ray
reach: reach,reached,reaching
read: read,reading
readable: readable
readiness: readiness
reading: reading
ready: readiest,ready
real: real
reality: reality
reason: reason
reasonable: reasonable
rebellious: rebellious
recall: recalled,recalling
receipt: receipt
receive: receive,received,receiving
recipe: recipes
recognition: recognition,recognitions
recoil: recoiled,recoiling
recollect: recollect
recollection: recollection
recommend: recommend
reconcile: reconciled
record: record,recording
recover: recovering
recovery: recovery
recreation: recreation
red: red
redeem: redeem
redistribute: redistribute,redistributing
redistributing: redistributing
redistribution: redistribution
reduce: reduced
reed: reed
refer: refer
reference: reference,references
reflect: reflect
reflection: reflection,reflections
refreshment: refreshment
refund: refund
regard: regard
region: region
register: registered
regret: regret
regular: regular
regularly: regularly
regulate: regulating
rein: reins
reject: rejected,rejecting
rejoicing: rejoicing
rejoin: rejoined
relate: relate
release: release,released,releasing
relief: relief
relieve: relieve
religious: religious
reluctantly: reluctantly
rely: relied
remain: remain,remained,remaining,remains
remark: remark,remarked,remarks
remarkable: remarkable
remarkably: remarkably
remedy: remedies
remember: remember,remembered
remembrance: remembrance
remind: reminding
remorseful: remorseful
remote: remote
remove: remove,removed,removing
rename: renamed
render: render,rendered,renders
renew: renew,renewed
rent: rent
reparation: reparation
repast: repast
repeat: repeated,repeating
replace: replace
replacement: replacement
reply: replied,reply
report: reported,reports
represent: represented
representation: representations
reproach: reproach
reproduce: reproducing
request: request
require: require,required
requirement: requirements
resemblance: resemblance
reserve: reserve
residence: residences
resist: resist,resisted,resisting
resistance: resistance
resistless: resistless
resound: resounded
resource: resource,resources
respect: respect
respectable: respectable
respective: respective
respects: respects
rest: rest,rested,resting
restless: restless
restlessness: restlessness
restorative: restorative
restore: restored,restoring
restriction: restrictions
result: result
resume: resumed,resuming
retire: retired,retiring
retreat: retreated
return: return,returned,returning,returns
reveal: reveal,revealed
revel: revelled
revenge: revenge
revenue: revenue
reverence: reverence
reverse: reversed
review: review
rheumatic: rheumatics
rib: ribs
rich: richer,richest
rigid: rigid
rise: rise,risen,rising,rose
river: river
rivet: riveted
road: road
roadside: roadside
roar: roared,roaring
robinson: robinson
rock: rocking
rocker: rocker
rocking: rocking
romantically: romantically
roof: roof
rope: ropes
rose: rose
rosy: rosy
rot: rotting
rote: rote
rotten: rotten
rough: rough
roughly: roughly
roughness: roughness
rouse: rouse
royal: royal
royalty: royalties,royalty
rub: rub,rubbed
ruddy: ruddy
rude: rude
rugged: rugged
ruin: ruined
rule: rules
rummage: rummaged
running: running
rush: rush,rushed,rushes
rustic: rustic
rusting: rusting
rusty: rusty
sack: sack
sacred: sacred
sacrifice: sacrifice,sacrificed
sad: sad
sadly: sadly
safe: safe
safely: safely
safety: safety
sagacity: sagacity
sage: sage,sages
sailor: sailor
saint: saint
sake: sake
salmon: salmon
salt: salt
salute: saluted
sample: samples
samson: samson
sanctuary: sanctuary
sarcastic: sarcastic
satin: satin
satisfaction: satisfaction
satisfactory: satisfactory
satisfied: satisfied
saucer: saucers
savage: savage
save: save
scale: scale
scanty: scanty
scarcely: scarcely
scarcity: scarcity
scare: scare,scared
scatter: scattered
scene: scenes
school: school
schoolfellow: schoolfellow
schools: schools
scorch: scorching
score: score,scores
scorn: scorned
scourge: scourges
scout: scouted
scrap: scraps
scratching: scratching
screw: screw,screwed,screwing
scrunch: scrunch
scrupulous: scrupulous
scrutinise: scrutinising
scuffle: scuffle
scythe: scythe,scythes
search: search
season: season
seat: seat
secret: secret,secrets
secretly: secretly
secure: secure
seek: seek,sought
seize: seize,seized
seldom: seldom
select: selecting
selfishness: selfishness
seminary: seminary
send: send,sending
sender: senders
sensation: sensation
sense: sense
sentence: sentence,sentences
sentiment: sentiment,sentiments
september: september
serve: served
service: service
set: set,sets,setting
settle: settle,settled
settlement: settlements
shabbiness: shabbiness
shade: shade,shaded
shadow: shadow,shadows
shadowy: shadowy
shake: shake,shaken,shaking,shook
shape: shape,shapes
share: share,shared,sharing
sharp: sharp,sharpest
sharply: sharply
shaver: shaver
shawl: shawl
shelf: shelf,shelves
shelter: shelter
sheriff: sheriff
shield: shield,shielded,shields
shine: shining,shone
ship: ship
shirt: shirt
shock: shock
shoe: shoe
shoot: shoot
short: short
shortly: shortly
shoulder: shoulder,shouldered,shoulders
shout: shouted
shriek: shriek,shrieked,shrieking
shrill: shrill
shrine: shrines
shrink: shrinking
shrug: shrug
shrunken: shrunken
shut: shut
sick: sick
sickness: sickness
sideways: sideways
sigh: sigh,sighed
sight: sight
sightless: sightless
sign: sign,signed
signify: signify
silence: silence
silent: silent
sillily: sillily
silly: silly
silver: silver
simmer: simmered
simple: simple
sing: sang,sing,sings
singing: singing
single: single
singly: singly
singular: singular
singularly: singularly
sink: sinking,sunk
sir: sir
sister: sister,sisters
sit: sat,sit,sitting
sixpence: sixpence
size: size,sizes
skate: skating
skeleton: skeletons
skelter: skelter
skill: skill
skim: skims
skirt: skirt,skirts
skurry: skurry
sky: sky
slap: slapped
sleep: sleep
sleeper: sleeper
sleety: sleety
slide: slides,sliding
slight: slight,slighted
slippy: slippy
slow: slow
slowly: slowly
slushy: slushy
sly: sly
smart: smart
smile: smile,smiled,smiling
smite: smitten
smoke: smoke,smoking
smooth: smooth,smoothing
smother: smother
snail: snail
snare: snare
snatch: snatch
sneer: sneer
sneeze: sneeze
snort: snorts
snug: snug
sob: sobbed,sobbing
sober: sober
soberly: soberly
sociability: sociability
sociable: sociable
social: social
society: society
sofa: sofas
soft: soft,softer
soften: softened
softly: softly
solemn: solemn
solicit: solicit
solicitation: solicitation
solid: solid
solitary: solitary
solo: solo
son: son,sons
song: song
soothing: soothing
sorcerer: sorcerer
sordid: sordid
sorrow: sorrow
sorrowful: sorrowful
sorrowfully: sorrowfully
sorrowing: sorrowing
sort: sort,sorts
soul: soul
sound: sound,sounded,sounding,sounds
sour: sour
south: south
sow: sown
space: space
spare: spare,spared
sparingly: sparingly
sparkling: sparkling
spasm: spasms
speak: speak,speaking,speaks,spoke,spoken
speaker: speaker
spear: spears
special: special
species: species
specific: specific
spectacle: spectacle
spectacles: spectacles
spectatress: spectatress
spectral: spectral
speculator: speculator
speech: speech
speedily: speedily
spell: spelling
spencer: spencer
spend: spend
sphere: sphere
spin: spun
spirit: spirit,spirits
spirits: spirits
spite: spite
splash: splashed
splutter: spluttered
spoil: spoil,spoilt
spoilt: spoilt
spot: spot
spotted: spotted
spout: spout
spread: spread
sprightly: sprightly
spring: sprung
sprucely: sprucely
squeeze: squeeze
stable: stable
staff: staff
stage: stage,stages
stagger: staggering
staid: staid
stair: stair,stairs
staircase: staircase
stand: stand,standing,stands,stood
star: star,stars
starch: starch
stare: stare,stared,staring
start: start,started,starting,starts
startle: startle,startled
statement: statements
station: stations
status: status
staunch: staunch
stay: stay,staying,stays
steadfast: steadfast
steady: steadier,steady
steal: steal,stealing
stem: stem
step: step,steps
stern: stern
sternness: sternness
stick: stick,sticking,sticks,stuck
stiff: stiff
stiffly: stiffly
stifle: stifle
stimulus: stimulus
stir: stirred
stock: stock
stocking: stockings
stolid: stolid
stone: stone,stones
stool: stool
stoop: stoop
stoppage: stoppages
store: stored
stormy: stormy
story: story
stout: stout
straight: straight
strait: strait
strange: strange
strangely: strangely
stranger: stranger
straw: straw
streak: streak
stream: stream
streaming: streaming
street: street
strenuous: strenuous
stretch: stretched,stretching
strew: strew
stricken: stricken
strict: strict
stride: stride,strode
strike: strike,strikes,striking,struck
striking: striking
strive: striving
stroke: stroke
stroll: strolling
strong: strong,stronger
structure: structure
struggle: struggle,struggling
stubble: stubble
stubborn: stubborn
student: student
study: studied,study
stuff: stuff
stumbling: stumbling
stupendously: stupendously
stupid: stupid
sturdy: sturdy
subject: subject,subjects
subscribe: subscribe
subside: subsided
substance: substance,substances
substitute: substituted
suburban: suburban
succession: succession
sudden: sudden
suddenly: suddenly
suffer: suffer,suffered,suffering
suffering: suffering,sufferings
suggestive: suggestive
suit: suit
suited: suited
sullen: sullen
sum: sum
summary: summary
summer: summer
summing: summing
summon: summon,summoned
sun: sun
sunburnt: sunburnt
superiority: superiority
supernatural: supernatural
supplication: supplication
support: support,supporting
suppose: suppose,supposed
suppression: suppression
surely: surely
surface: surface
surgical: surgical
surprise: surprise,surprised
surprising: surprising
surround: surrounded
survey: surveyed
survive: survive
suspect: suspected,suspecting
suspend: suspended
suspicion: suspicion,suspicions
swamp: swamp
swan: swans
swarm: swarming
swear: swear,sworn
sweep: sweeping,swept
sweet: sweet
sweeten: sweetened
sweetheart: sweetheart
swell: swell
swindle: swindling
sword: swords
symmetrically: symmetrically
symmetry: symmetry
sympathy: sympathy
synonymous: synonymous
table: table,tables
tail: tail,tails
tailor: tailor
tale: tale
talent: talent
talk: talk,talked,talking
talker: talker
tall: tall,taller
tangle: tangled
tap: tap,tapping
tape: tape
tart: tart
task: task,tasks
taste: taste,tasted,tastes
tax: tax,taxes
tea: tea
teaboard: teaboard
teach: teach
teaching: teaching
team: team
teapot: teapot
tear: tear,tearing,tears,torn
tearful: tearful
tedious: tedious
teens: teens
telescope: telescope
temper: temper,tempered
temple: temples
tempt: tempting
tend: tend,tended,tending
tender: tender,tenderest
tenderly: tenderly
tenderness: tenderness
tenement: tenements
term: term,termed,terms
terribly: terribly
terrified: terrified
terror: terror
thankfulness: thankfulness
thaw: thaw
thee: thee
theme: theme
thinking: thinking
thirsty: thirsty
thoroughbred: thoroughbred
thoughtful: thoughtful
thoughtfully: thoughtfully
thoughtfulness: thoughtfulness
thoughtless: thoughtless
thread: thread,threads
threshold: threshold
thrice: thrice
thrill: thrilled
thrive: thriving
thriving: thriving
throat: throat
throw: threw,throw,throwing
thrust: thrust
thursday: thursday
thy: thy
tick: ticked
tie: tied
tight: tight
tilly: tilly
tilt: tilt
time: time,timed,times
timid: timid
tinder: tinder
tiny: tiny
tippet: tippet
tire: tire
tired: tired
title: title
toadstool: toadstools
toast: toast
tobacco: tobacco
toe: toe,toes
tolerable: tolerable
toll: toll
tom: tom
tone: tone
tongue: tongue,tongues
topsy: topsy
torpid: torpid
torture: torture,tortured
totter: tottered
touch: touch,touched,touching
touchstone: touchstone
town: town
toy: toy,toys
toymaker: toymaker
track: track
trade: trade
trademark: trademark
trail: trailed
train: train
tramp: tramp
tranquil: tranquil
tranquillity: tranquillity
transaction: transactions
transcendent: transcendent
transcribe: transcribe,transcribed
transcription: transcription
transfix: transfixed
transform: transformed,transforming
transport: transports
trap: trap
traveller: travellers
treachery: treachery
tread: tread
treasure: treasure
treat: treated
treatment: treatment
tree: tree,trees
tremble: tremble,trembled,trembling
tremendous: tremendous
trial: trial
tribe: tribe
trick: trick
trifle: trifle,trifles
trigger: trigger
trill: trill
trim: trimmed
trip: trip
triumphant: triumphant
triumphantly: triumphantly
trivial: trivial
triviality: trivialities
trodden: trodden
troll: trolled
troop: trooping
troops: troops
trot: trot,trotting
trouble: trouble,troubled
troubled: troubled
truce: truce
true: true
trumpet: trumpet
trunk: trunk
trust: trust,trusted,trusting
truth: truth
truthful: truthful
tube: tube
tuck: tucked
tug: tugging
tumble: tumbled
tumbler: tumblers
tumult: tumult
tune: tune
turnip: turnips
turnpike: turnpike
turvy: turvy
twilight: twilight
twin: twin
twinkle: twinkle,twinkled
twinkling: twinkling
twist: twist,twisted
twisting: twisting
type: type,types
ubiquity: ubiquity
ugly: ugly
unaccountable: unaccountable
unanswerable: unanswerable
unbeknown: unbeknown
uncertain: uncertain
uncomfortable: uncomfortable
uncomfortably: uncomfortably
uncommon: uncommon
uncommonly: uncommonly
unconnected: unconnected
unconscious: unconscious
uncontrollable: uncontrollable
undeceived: undeceived
undeniable: undeniable
undeniably: undeniably
understand: understand,understood
undertake: undertake
undiminished: undiminished
undivided: undivided
undying: undying
uneasiness: uneasiness
uneasy: uneasy
unenforceability: unenforceability
unequal: unequal
unexpected: unexpected
unexpectedly: unexpectedly
unfinished: unfinished
unfortunate: unfortunate
ungenteel: ungenteel
unhappy: unhappy
unheard: unheard
unheeded: unheeded
uniform: uniform
unimpeachable: unimpeachable
uninterested: uninterested
united: united
universe: universe
unknown: unknown
unlink: unlink
unlooked: unlooked
unmitigated: unmitigated
unpolished: unpolished
unprotected: unprotected
unquestionably: unquestionably
unroll: unrolled
unscrew: unscrew
unseen: unseen
unsolicited: unsolicited
unspeakable: unspeakable
unstopped: unstopped
unsuspicious: unsuspicious
unusual: unusual
unwilling: unwilling
unwillingness: unwillingness
unwonted: unwonted
update: updated
upholstery: upholstery
upright: upright
uprose: uprose
upset: upset
upturn: upturning
upward: upward
urge: urged
user: user
usual: usual
ut: ut
utter: uttered
utterly: utterly
vacant: vacant
vacantly: vacantly
vacation: vacation
vaccinate: vaccinated
vagabond: vagabond
vague: vague
vain: vain
vainly: vainly
valve: valve
vampire: vampire
vanilla: vanilla
vanish: vanished
vanity: vanities
variety: variety
vast: vast
veal: veal
vegetable: vegetable
vehemently: vehemently
venerable: venerable
vent: vent
venture: venture
verily: verily
verse: verse
version: version
vessel: vessel
vestment: vestment
vex: vexed
viand: viands
vice: vice
victim: victim
view: view,viewed,viewing,views
vigilance: vigilance
vigour: vigour
vilely: vilely
villain: villain
vindicate: vindicate
violate: violates
violence: violence
violent: violent
violently: violently
virus: virus
visibly: visibly
vision: visions
visit: visit,visited,visiting
visitor: visitor
vital: vital
vivacity: vivacity
vocal: vocal
vocation: vocation
voice: voice,voices
voices: voices
void: void
volunteer: volunteer,volunteers
vowel: vowel
waggon: waggon
waist: waist
waistcoat: waistcoat
wait: wait,waited,waiting
wake: woke
walk: walk,walked,walking,walks
walker: walker
walking: walking
wall: wall,walls
wander: wandered,wandering
ware: ware
warm: warm,warmed,warmer
warning: warning
warranty: warranties,warranty
wary: wary
wash: washed,washing
watch: watch,watched,watching
water: water
wave: wave,waved,waving
wax: wax
waxy: waxy
weak: weak
weakness: weakness
wealth: wealth
weapon: weapon
wear: wear,wearing,wears,wore,worn
weariness: weariness
wearisome: wearisome
weather: weather
wedding: wedding
weed: weeds
week: weeks
weep: wept
weigh: weigh,weighs
weight: weight,weights
weird: weird
welsh: welsh
west: west
wet: wet
wharf: wharf
whatsoever: whatsoever
wheedle: wheedling
wheel: wheels
wheels: wheels
whereon: whereon
wheresoever: wheresoever
whimsical: whimsical
whir: whirring
whisk: whisks
whisker: whiskers
whisper: whisper,whispered,whispering
whispering: whisperings
whit: whit
white: white
whiten: whitening
wholesome: wholesome
wholly: wholly
wicked: wicked
wide: wide,widest
widen: widening
wield: wield
wife: wife,wifes,wives
wild: wild
wildly: wildly
win: winning
wind: wind
winded: winded
window: window,windows
wink: winking
winter: winter
wiry: wiry
wisp: wisp
wistful: wistful
wistfully: wistfully
wit: wit
withal: withal
withdraw: withdrew
wither: withering
withered: withered
withstand: withstood
witness: witness,witnessed
woeful: woeful
woman: woman,women
wonderful: wonderful
wonderfully: wonderfully
wondrous: wondrous
wood: wood
wooden: wooden
word: word
workaday: workaday
workbox: workbox
worm: worm
worn: worn
worry: worrying
worth: worth
worthy: worthy
wound: wounded
wrap: wrapped
wrapper: wrappers
wrath: wrath
wretched: wretched
wring: wring,wrung
write: writing,written
writing: writing
wrong: wrong
wry: wry
yard: yard
yawn: yawning
yesterday: yesterday
yield: yielded,yielding
yoke: yoking
yonder: yonder
youth: youth
zeal: zeal
zealous: zealous
