abe: abed
abide: abide
abject: abject
abode: abode
abstinence: abstinence
absurd: absurd
abundance: abundance
abyss: abyss
accept: accept,accepted,accepting
access: access,accessed
accessible: accessible
accommodate: accommodate
accompany: accompanied
account: account
accuracy: accuracy
accusatory: accusatory
accustomed: accustomed
ache: ache
achieve: achieved
acquaint: acquainted
acquaintance: acquaintance
action: action,actions
active: active
actual: actual
adamant: adamant
adapt: adapted
add: add
addition: addition,additions
additional: additional
address: address,addressed,addresses,addressing
adjoining: adjoining
adjust: adjusted
adjustment: adjustment
administer: administered
administrator: administrator
admiration: admiration
admit: admit,admitted
advance: advance,advanced
advantage: advantage
adventure: adventure
adversary: adversary
affability: affability
affair: affairs
affection: affection
affectionate: affectionate
afford: afford,afforded
affront: affront
afraid: afraid
afternoon: afternoon
age: age,ages
aged: aged
agent: agent
agility: agility
agitated: agitated
agitation: agitation
agonised: agonised
agony: agony
agree: agree,agreed
agreeable: agreeable
agreement: agreement
aid: aid
aim: aim
air: air
ak: ak
alarm: alarm
alarming: alarming
alas: alas
alderman: aldermen
alfred: alfred
alike: alike
alive: alive
alley: alleys
almond: almonds
almshouse: almshouse
alphabet: alphabet
altar: altar
alteration: alteration
altered: altered
alternate: alternate
altogether: altogether
amazed: amazed
amend: amends
american: americans
ample: ample
ancestor: ancestors
ancient: ancient
angel: angel,angels
angelic: angelic
angry: angry
animal: animal
ankle: ankle
announcement: announcement
anonymous: anonymous
answer: answer,answered,answering
antique: antique
anxious: anxious
anxiously: anxiously
apoplectic: apoplectic
apostles: apostles
appal: appalled
appalling: appalling
apparel: apparel
apparition: apparition
appeal: appealing
appearance: appearance,appearances
appetite: appetite
applaud: applauded
apple: apple,apples
applicable: applicable
apply: applied,apply
appraise: appraised
apprehensive: apprehensive
apprentice: apprentice,apprenticed,apprentices
approach: approach,approached
approve: approving
apron: aprons
archive: archive
archway: archways
arm: arm,arms
aromatic: aromatic
array: array
arrival: arrival
arrive: arrived
artful: artful
arthur: arthur
artifice: artifice
artificial: artificial
artist: artist
ascii: ascii
ashamed: ashamed
asleep: asleep
aspiration: aspirations
ass: ass
assemble: assembled,assembling
assign: assign,assigned
assist: assist,assisted
assistance: assistance
assure: assure,assured
astonish: astonish,astonished
astonishment: astonishment
atmosphere: atmosphere
atom: atom,atoms
attach: attach,attached
attend: attended
attendant: attendant
attention: attention
attentively: attentively
attire: attire,attired
attitude: attitude
attract: attract
attractive: attractive
aught: aught
aunt: aunts
author: author
authority: authority
avarice: avarice
avoid: avoid
awake: awake,awaking,awoke
awful: awful
awhile: awhile
awkwardly: awkwardly
axe: axe
baba: baba
baby: baby
bachelor: bachelor
bad: bad,worse
badly: badly
bag: bag,bags
bah: bah
bake: baking
baker: baker,bakers
balance: balancing
baleful: baleful
ball: ball
balustrade: balustrades
bandage: bandage
bang: bang
banker: banker
bar: bar,barred
bare: bare,bared
barely: barely
bareness: bareness
barer: barer
bargain: bargain
barrel: barrels
barren: barren
base: base,based
basin: basin
bask: basking
basket: baskets
bass: bass
battle: battle,battled
beam: beaming
bear: bear,bore,born,borne
bearer: bearers
bearing: bearing
beat: beat,beaten,beating
beautiful: beautiful
beckon: beckoned
bed: bed,beds
bedight: bedight
bedlam: bedlam
bedpost: bedpost
bedroom: bedroom
beef: beef
beer: beer
beetle: beetling
beg: begged
beggar: beggars
beguile: beguiled
behave: behave
behindhand: behindhand
behold: beheld,behold
belief: belief
belinda: belinda
bell: bell,bells
belle: belle
belly: bellied
belong: belonged,belonging
belt: belt
bend: bending,bent
beneath: beneath
benefit: benefit
benevolence: benevolence
bereft: bereft
berry: berries
beseech: beseech,beseeching,besought
bestow: bestow,bestowed
beware: beware
bewildering: bewildering
bid: bade
bide: bide
biffins: biffins
bigotry: bigotry
bilious: bilious
binary: binary
bind: bound
bird: bird,birds
bishop: bishop
bit: bit
bite: biting
bitter: bitter,bitterer
black: black
blacker: blacker
blame: blame
blank: blank
blanket: blankets
blaze: blaze,blazing
bleak: bleak
blended: blended
bless: bless,blessed
blessed: blessed
blessing: blessing,blessings
blind: blind,blinds
blindfold: blindfold
blindman: blindman
blithe: blithe
blithest: blithest
block: block
blood: blood
blooded: blooded
bloom: bloom,blooming
blot: blot
blotch: blotch
blow: blew
blue: blue
blunt: blunt
blush: blush,blushed
board: board
boarding: boarding
boast: boast,boasted
boat: boats
bob: bob
body: body
boil: boiled
boisterous: boisterous
bold: bold
boldly: boldly
bolt: bolts
bone: bone,bones
bonnet: bonnet,bonneted
book: book,books
books: books
booming: booming
boot: booted,boots
border: bordered
borough: borough
bother: bothered
bottle: bottle,bottles
bough: boughs
bound: bound,bounds
bow: bow,bowed
bowels: bowels
bowl: bowl,bowls
box: box,boxes
boy: boy,boys
boyhood: boyhood
braided: braided
bran: bran
branch: branch,branched
brandy: brandy
brave: brave
brawn: brawn
brazier: brazier
breach: breach
breadth: breadth
break: break,broke,broken
breast: breast,breasts
breath: breath
breathless: breathless
breeches: breeches
breed: bred
breezy: breezy
brew: brewing
brick: brick,bricks
bridge: bridge
bridle: bridle
brigand: brigands
bright: bright,brighter,brightest
brightness: brightness
brilliant: brilliant
brimful: brimful
bring: bring,brings,brought
brisk: brisk
briskly: briskly
bristle: bristling
britain: britain
broad: broad
broadwise: broadwise
broken: broken
broker: broker
brooch: brooch
brood: brood
brother: brother,brothers
brow: brow
browed: browed
brown: brown
brush: brushed
bubble: bubbling
buck: buck
buff: buff
build: building,built
building: building
bull: bull
bump: bumping
bunch: bunches
bundle: bundle
burdensome: burdensome
burial: burial
burn: burning,burnt
burst: burst
bury: buried,burying
business: business
bustle: bustle
busy: busy
butler: butlers
butter: butter
button: button,buttoning,buttons
bye: bye
bygone: bygone
cab: cab
cable: cable
cains: cains
cake: cake,caked,cakes
calculate: calculate,calculated
caleb: caleb
calendar: calendar
calf: calves
calico: calico
calling: calling
calm: calm
calmly: calmly
camden: camden
candle: candle,candles
candy: candied
canister: canisters
cannon: cannon
canst: canst
cap: cap
capable: capable
capacious: capacious
capacity: capacity
capital: capital
captive: captive
card: card
care: care,cared,cares,caring
carefully: carefully
carelessly: carelessly
careworn: careworn
caricature: caricature,caricatures
carol: carol
caroline: caroline
carriage: carriages
carrier: carrier,carriers
carry: carried,carry,carrying
cart: carts
carving: carving
cash: cash
cask: cask,casks
cast: cast
cat: cat
catch: catch,catching,caught
caustic: caustic
cautiously: cautiously
cavern: caverns
cease: cease,ceased
ceiling: ceiling
celebrated: celebrated
celestial: celestial
cell: cell
cellar: cellar,cellars
centre: centre
cesspool: cesspools
chafe: chafed
chain: chain,chains
chair: chair,chairs
chaise: chaise
chalk: chalked
challenge: challenge
chamber: chamber,chambers
chance: chance
change: change,changed,changing
changed: changed
channel: channels
chapel: chapel
character: character,characters
characterisation: characterisation
characteristic: characteristics
characterization: characterization
charcoal: charcoal
charge: charge,charged,charges
charitable: charitable
charity: charities,charity
charles: charles
charm: charm
charmingly: charmingly
charwoman: charwoman
chatter: chattering
cheap: cheap
cheapness: cheapness
cheat: cheats
check: check,checked,checks
cheek: cheek,cheeked
cheer: cheer
cheerful: cheerful
cheerfully: cheerfully
cheerfulness: cheerfulness
cheery: cheery
cheese: cheese
cherry: cherry
chestnut: chestnuts
chief: chief
child: child,children
childish: childish
chill: chill
chilling: chilling
chilly: chilly
chime: chime,chimes
chimes: chimes
chimney: chimney,chimneys
chin: chin
chink: chink,chinked
chirp: chirping
chirrup: chirrup
choice: choice
choke: choked
choose: choose,choosing,chose,chosen
chorus: chorus
christian: christian
christmas: christmas
chrysolite: chrysolite
chuckle: chuckle,chuckled
church: church,churches
churchyard: churchyard
cinnamon: cinnamon
circle: circle
city: city
claim: claim
clang: clang
clank: clanked,clanking
clap: clap,clapped
clapping: clapping
clash: clash
clasp: clasping
clasped: clasped
claw: claw
clergyman: clergyman
clerk: clerk
clever: clever
climate: climate
cling: cling,clung
clock: clock,clocks
close: close,closed
closely: closely
closet: closet
cloth: cloth
clothe: clad,clothed
clothes: clothes
cloud: cloud,clouds
cluck: clucked
clue: clue
clung: clung
cluster: clustered
clustered: clustered
clutch: clutching
coach: coach,coaches
coal: coal
coarse: coarse
coat: coat,coats
cock: cock
code: codes
coffee: coffee
coffin: coffin
coil: coil
cold: cold,colder,coldest
collapse: collapsed
collar: collar,collars
collection: collection
color: color
colour: colour
combined: combined
combustion: combustion
comedy: comedy
comely: comely
comfort: comfort,comforts
comfortable: comfortable
comforter: comforter
comic: comic
comical: comical
coming: coming
command: command
commercial: commercial
commit: committed
common: common
communicate: communicated
compactness: compactness
companion: companion,companions
company: company
competent: competent
compilation: compilation
compliance: compliance
comply: comply,complying
compose: composed
compound: compound,compounded
comprehensive: comprehensive
compress: compressed
compulsion: compulsion
conceal: concealed
concept: concept
condemn: condemn,condemned
condense: condensed
condescension: condescension
condition: condition
conducive: conducive
conduct: conduct,conducted,conducting
confer: conferred
conference: conference
confess: confess
confidence: confidence
confidential: confidential
confirm: confirmed
confirmation: confirmation
conflict: conflict
confront: confronting
confused: confused
congeal: congealed
congenial: congenial
connect: connected,connecting
conscious: conscious
consciousness: consciousness
consent: consent
consequence: consequence,consequences
consequential: consequential
considerable: considerable
consistent: consistent
consolation: consolation
conspicuous: conspicuous
constant: constant
constantly: constantly
contact: contact
contagious: contagious
content: content
contented: contented
contents: contents
continue: continued
contortion: contortions
contract: contract,contracted
contradiction: contradiction
contrary: contrary
contrast: contrasting
contribution: contributions
control: control
convenience: convenience
convenient: convenient
conversation: conversation,conversations
converse: conversed
convert: convert
convey: conveyed
convince: convinced
convinced: convinced
cook: cook,cooked,cooking,cooks
cooking: cooking
coolly: coolly
copper: copper
copying: copying
copyright: copyright
cordially: cordially
core: core
cork: cork
corner: corner,corners
corporation: corporation
corpse: corpse
correct: correct
corroborate: corroborated
corrupt: corrupt,corrupted
cost: cost,costs
cosy: cosy
couch: couch
count: count,counting
countenance: countenance
counter: counter
countess: countess
counting: counting
country: countries,country
couple: couple,couples
courage: courage
court: court,courts
cousin: cousin,cousins
cover: cover,covered,covers
covering: covering
covetous: covetous
cow: cow
crack: cracked,cracking
crackle: crackled
cram: crammed
cramp: cramp
crash: crashing
cravat: cravat
create: created,creating
creation: creation
creature: creature,creatures
credentials: credentials
credit: credit
creditor: creditor
credulity: credulity
creek: creek
creep: crept
cricket: cricket
crime: crime
cripple: cripple
crisis: crisis
crisp: crisp
critical: critical
cross: cross,crossed,crossing
crowd: crowds
crowded: crowded
crown: crown
crumb: crumb
crush: crushed
crutch: crutch
cuff: cuff,cuffs
cultivate: cultivate,cultivated
cup: cup
cupola: cupola
curiosity: curiosity
curiously: curiously
curl: curls
current: current
curtain: curtains
curtaining: curtaining
curtsy: curtsy
custard: custard
custom: custom
customer: customers
cut: cut
dainty: dainties
damage: damage,damaged
damaged: damaged
damages: damages
damascus: damascus
damp: damp
dance: dance,danced,dances
dancer: dancers
dangle: dangle,dangling
dark: dark,darker,darkest
darkness: darkness
darn: darned
dart: darting
dash: dash,dashed,dashing
datum: data
daughter: daughter,daughters
daw: daws
day: day,days
daylight: daylight
dead: dead,deadest
deafen: deafened
deal: deal,dealt
dealing: dealing
dealings: dealings
dearly: dearly
death: death
debt: debt
decanter: decanter
decay: decayed
deceased: deceased
december: december
decide: decide,decides
deck: decked
declension: declension
decorate: decorated
decrease: decrease
deductible: deductible
deed: deeds
deep: deep
defect: defect,defects
defective: defective
defenceless: defenceless
deference: deference
defiance: defiance
deftly: deftly
defy: defy
degradation: degradation
degree: degree,degrees
delay: delay
deletion: deletions
deliberate: deliberating
delicate: delicate
delicately: delicately
delicious: delicious
delight: delight,delighted
delighted: delighted
delightful: delightful
demand: demand,demanded
demeanour: demeanour
demon: demons
demurely: demurely
den: den
dense: dense
deny: deny
depart: departed
depend: depend,depends
deposit: deposit
depressed: depressed
deprive: deprive
depths: depths
der: der
derivative: derivative
derive: derive,derived
descend: descended,descending
desert: desert
deserted: deserted
deserve: deserves
design: designed
desirable: desirable
desire: desire,desired
desk: desk,desks
desolation: desolation
despairingly: despairingly
desperate: desperate
despoil: despoil
despondent: despondent
dessert: dessert
destitute: destitute
destroy: destroy
detach: detach
detain: detained
determine: determine
detestation: detestation
deuce: deuce
develop: developed
development: development
devil: devils
devote: devote
dialogue: dialogue
dick: dick
dickens: dickens
die: die,died,dies,dying
difficult: difficult
diffuse: diffuse
dig: dig
dim: dim
diminish: diminished
dimly: dimly
dimpled: dimpled
dine: dine
ding: ding
dingy: dingy
dining: dining
dinner: dinner,dinners
dip: dip
direct: direct
direction: direction,directions
director: director
dirge: dirge
dirt: dirt
dirty: dirtier,dirty
disagreeable: disagreeable
disappointed: disappointed
disclaim: disclaim,disclaimed
disclaimer: disclaimer,disclaimers
disclose: disclosed
discontinue: discontinue
discover: discover,discovered
discuss: discuss
disdain: disdaining
disease: disease
disgorge: disgorged
disgust: disgust
dish: dish,dishes
disinterested: disinterested
disjointed: disjointed
disk: disk
dislike: dislike
dismal: dismal
dismay: dismay,dismayed
dismiss: dismiss,dismissed
dismount: dismounted
disorder: disorder
dispatch: dispatched
dispel: dispelled
displace: displaced
display: display,displayed,displaying
dispose: disposed
dissolve: dissolving
distance: distance
distinct: distinct
distinctly: distinctly
distinctness: distinctness
distinguish: distinguish
distract: distracting
distress: distress
distribute: distribute,distributed,distributing
distribution: distribution
distributor: distributor
disturb: disturb,disturbed
disturbed: disturbed
disused: disused
dive: dive
divert: divert,diverted
dog: dog,dogs
dogged: dogged
doings: doings
doll: doll
domain: domain
domestic: domestic
dominion: dominion
donate: donate
donation: donation,donations
dong: dong
donor: donors
doom: doom,doomed
door: door,doors
doorstep: doorstep
doorway: doorway,doorways
dot: dot,dots,dotting
double: double
doubt: doubt,doubting,doubts
doubtfully: doubtfully
doubtless: doubtless
dowerless: dowerless
downcast: downcast
download: downloading
downward: downward
doyle: doyle
doze: doze
dozen: dozen
drag: drag,dragged,dragging
drape: draped
draw: draw,drawing,drawn,drew
drawer: drawers
drawing: drawings
dread: dread,dreaded
dreadful: dreadful
dreadfully: dreadfully
dream: dream,dreamed,dreaming
dreary: dreary
dress: dress,dressed,dressing
dressed: dressed
dressing: dressing
drink: drank,drink,drinks
drip: drip
drive: driven,driving,drove
droop: drooping
drop: drop,dropped,drops
drowsiness: drowsiness
drunk: drunk
drunken: drunken
dry: dry,drying
dull: dull,duller
dumb: dumb
dusky: dusky
dust: dust,dusted
dusty: dusty
dutch: dutch
dwarfish: dwarfish
dwell: dwelling
dwelling: dwellings
dwindle: dwindled
eager: eager
eagerness: eagerness
ear: ear,ears
earnest: earnest
earnestness: earnestness
earth: earth
earthly: earthly
ease: ease
easily: easily
easterly: easterly
easy: easy
eat: ate,eat,eaten
eating: eating
ebenezer: ebenezer
echo: echo,echoed,echoes
ecstasy: ecstasy
edge: edge
edition: edition,editions
educational: educational
effort: effort,efforts
eighteen: eighteen
eke: eked
elbow: elbow,elbows
elder: elder
elect: elect
electronic: electronic
electronically: electronically
elicit: elicited
eliminate: eliminate
email: email
embarrassed: embarrassed
embarrassing: embarrassing
emblem: emblem
embrace: embrace
emerge: emerged
emotion: emotion,emotions
emphatically: emphatically
employ: employed
employee: employee,employees
encode: encoding
encompass: encompass
encourage: encouraged
endeavour: endeavour,endeavoured,endeavouring
energy: energy
engage: engaged
english: english
engross: engrosses
enjoy: enjoyed
enjoyment: enjoyment
enormous: enormous
enshroud: enshrouded
ensue: ensued
ensure: ensuring
enter: enter,entered,entering
enthrone: enthroned
entity: entity
entreat: entreating
entreaty: entreaty
entry: entry
envy: envy
equal: equal
equipment: equipment
erase: erased
erect: erect
error: errors
escape: escape,escaping
escort: escorted
especial: especial
essence: essence
establish: established
establishment: establishments
esteem: esteem
eternity: eternity
eve: eve,eves
evening: evening,evenings
event: event
evergreen: evergreens
evidence: evidence
evil: evil
exaggerate: exaggerated
exaggeration: exaggeration
exalt: exalted
examine: examined
exceed: exceeded
exceedingly: exceedingly
excellent: excellent
exchange: exchange,exchanging
excite: excited
excited: excited
excitement: excitement
exclaim: exclaimed
exclusion: exclusion
exclusive: exclusive
excrescence: excrescence
excuse: excuse
execrable: execrable
executive: executive
executor: executor
exempt: exempt
exhausted: exhausted
exist: exists
expect: expect,expected,expecting
expectant: expectant
expectation: expectation
expected: expected
expend: expend,expending
expense: expense,expenses
experience: experience
explain: explain
explanation: explanation
export: exporting
expose: exposed
express: express,expressed
expression: expression
extensive: extensive
extent: extent
external: external
extinguish: extinguished
extinguisher: extinguisher
extract: extract
extraordinary: extraordinary
extravagance: extravagance
extravagant: extravagant
extreme: extremes
extremely: extremely
extremity: extremity
exult: exulted
eye: eye,eyes
eyebrow: eyebrows
faced: faced
facetious: facetious
facility: facility
factious: factious
fade: faded
fail: failed
fain: fain
faint: faint
faintly: faintly
fair: fair
fairbanks: fairbanks
faith: faith
fall: fall,fallen,falling,fell
false: false
falter: faltered,faltering
familiar: familiar
family: family
famous: famous
fan: fan
fancy: fancied,fancy,fancying
farmer: farmers
farthing: farthing
fashionable: fashionable
fashioned: fashioned
fast: fast
fasten: fastened
fat: fat
fate: fate
father: father,fathers
fathom: fathoms
fatigue: fatigues
fatness: fatness
favour: favour
fear: fear,feared
fearful: fearful
feast: feast
feather: feather
feathered: feathered
feature: feature,features
federal: federal
fee: fee,fees
feeble: feeble
feebly: feebly
feed: fed
feel: feel,feeling,feels
feeling: feeling,feelings
feign: feign
feint: feint
fellow: fellow,fellows
ferocious: ferocious
ferret: ferret
fervour: fervour
festive: festive
festivity: festivities
fetch: fetch,fetched
fetter: fettered
fezziwig: fezziwig
fictitious: fictitious
fiddler: fiddler
field: field,fields
fiercely: fiercely
fiery: fiery
fig: figs
fight: fought
figure: figure,figures
filbert: filberts
file: file,files
filth: filth
financial: financial
fine: fine,fined
finger: finger
finish: finish,finishes
fireside: fireside
firm: firm
fish: fish
fisted: fisted
fit: fit
fitness: fitness
fixedly: fixedly
flame: flame
flannel: flannel
flare: flaring
flash: flashed
flat: flat
flaunt: flaunting
flavour: flavour
flee: fled
flesh: flesh
flicker: flickering
flight: flight
fling: flung
flint: flint
float: floated,floating
flock: flocking
flood: flood
floor: floor,floors
flour: flour
flower: flowers
flowery: flowery
fluctuate: fluctuated
flush: flushed
fluttered: fluttered
fly: flew
fog: fog
foggy: foggier,foggy
fold: folded,folding,folds
folk: folks
follow: follow
follower: followers
fond: fond
fondly: fondly
fool: fool,fools
foot: feet,foot
footstool: footstool
forbear: forbear
forbearance: forbearance
forbid: forbid
force: force,forced
forehead: forehead
foreign: foreign
foremost: foremost
foreshadow: foreshadow
foretell: foretold
forfeit: forfeits
forge: forged
forget: forget,forgetting,forgotten
forgive: forgive,forgiving
forgiveness: forgiveness
fork: fork
form: form,formed,forms
formal: formal
format: format,formats
fortune: fortune,fortunes
foul: foul
foundation: foundation
founder: founder
fowls: fowls
fragment: fragment,fragments
fragrance: fragrance
frail: frail
frame: frame
frank: frank
fraught: fraught
fred: fred
freely: freely
freeze: froze,frozen
freezing: freezing
french: french
fresh: fresh,freshest
friars: friars
friday: friday
friend: friend,friends
friendly: friendly
frighten: frightened
frightful: frightful
fringe: fringe
frisk: frisked
fro: fro
frontispiece: frontispiece
frost: frost
frosty: frosty
frouzy: frouzy
frown: frowned,frowning
frozen: frozen
fruit: fruit,fruits
fruiterer: fruiterers
frying: frying
fuel: fuel
fund: fund
funeral: funeral
fur: fur
furnish: furnish,furnished
furniture: furniture
furrow: furrows
furze: furze
future: future
gaily: gaily
gain: gain,gains
gainsay: gainsay
gait: gait
gale: gale
gallantly: gallantly
gallantry: gallantry
game: game,games
gaol: gaol
gap: gaps
garden: garden
garment: garment,garments
garret: garret
gas: gas
gasp: gasping
gate: gate,gates
gateway: gateway
gather: gathered
gathering: gatherings
gay: gay,gayest
gaze: gaze,gazed
generation: generation,generations
generous: generous
genial: genial
genii: genii
genius: genius
gentle: gentle
gentleman: gentleman,gentlemen
gently: gently
george: george
ghost: ghost,ghosts
ghostly: ghostly
giant: giant,giants
giddy: giddy
gift: gift
gig: gigs
gigantic: gigantic
gill: gills
gin: gin
gird: girded
girl: girl,girls
girthed: girthed
glad: glad
gladly: gladly
gladness: gladness
gladsome: gladsome
glance: glance,glanced,glancing
glare: glared
glass: glass
glazed: glazed
gleam: gleaming
glee: glee
glide: glided
glimpse: glimpse,glimpses
glisten: glisten,glistened
glitter: glittered
globe: globe,globes
gloom: gloom
gloomy: gloomy
glorious: glorious
glory: glory
glove: gloves
glow: glow,glowing
glowing: glowing
glue: glued
gnaw: gnawed,gnawing
goal: goals
goblet: goblets
goblin: goblins
god: god
gold: gold
golden: golden
goodly: goodly
goodness: goodness
goose: geese,goose
gothic: gothic
govern: govern
government: governments
gown: gown
grace: grace
graceful: graceful
gracefully: gracefully
grade: grade
grant: granted
grape: grapes
grasp: grasp,grasping
grass: grass
grate: grate,grating
grateful: grateful
gratefully: gratefully
gratis: gratis
gratitude: gratitude
grave: grave,graves
gravely: gravely
gravy: gravy
greasy: greasy
greatly: greatly
greedy: greedy
green: green
greet: greet
gregory: gregory
grey: grey
grief: grief
grieve: grieve,grieved
grin: grinning,grins
grindstone: grindstone
gripe: griping
grocer: grocer,grocers
grocers: grocers
grog: grog
groom: groom
grope: grope,groped
gross: gross,grosser
grotesque: grotesque
ground: ground
grove: grove
grow: grew,growing,grown,grows
growl: growl,growled
growth: growth
gruel: gruel
gruff: gruff
grunt: grunted
guard: guard
guess: guess,guessed
guest: guests
guide: guiding
guilty: guilty
gush: gush
ha: ha
habit: habit
haggard: haggard
hail: hail
hair: hair
haired: haired
hall: hall
hallo: hallo
halloa: halloa
halloo: halloo
hamlet: hamlet
hammer: hammer
hand: hand,handed,hands
handful: handful
handle: handle
handsome: handsome
handsomely: handsomely
hang: hanging,hung
happen: happen,happened
happiness: happiness
happy: happier,happiest,happy
hard: hard
hardily: hardily
hardship: hardships
hark: hark
harm: harm
harmless: harmless
harp: harp
harsh: harsh
hart: hart
hast: hast
haste: haste
hasten: hastened
hat: hat,hats
hatred: hatred
haunt: haunt,haunted
haunted: haunted
head: head
health: health
heap: heap,heaped,heaps
hear: hear,heard,hearing
hearse: hearse
heart: heart,hearts
hearth: hearth
heartily: heartily
heartiness: heartiness
hearty: heartier,hearty
heat: heat,heated
heated: heated
heaven: heaven
heavenly: heavenly
heavily: heavily
heaving: heaving
heavy: heavier,heaviest,heavy
heed: heed,heeded
heighten: heightened
heir: heir
helmsman: helmsman
herd: herd
heresy: heresy
hey: hey
hidden: hidden
hide: hidden,hide
hideous: hideous
hideously: hideously
highly: highly
hinge: hinges
hint: hint,hinted
hiss: hissing
ho: ho
hoar: hoar
hoarding: hoarding
hob: hob
hold: held,hold,holding
holder: holder
hole: hole,holes
holiday: holiday,holidays
hollow: hollow
holly: holly
homage: homage
homeward: homeward
honest: honest
honour: honour,honoured
hood: hood
hooded: hooded
hook: hooks
hoop: hoop
hope: hope,hoped,hopes
hopeful: hopeful
horn: horn
horny: horny
horrible: horrible
horror: horror,horrors
horse: horse,horses
hospital: hospital
host: host
hot: hot
hour: hour,hours
house: house,houses
household: household
housekeeper: housekeepers
housemaid: housemaid
housetops: housetops
howl: howling
hug: hug,hugged
hum: hummed
human: human
humanity: humanity
humbug: humbug
humility: humility
humour: humour
humoured: humoured
hung: hung
hungry: hungry
hurrah: hurrah
hurried: hurried
hurry: hurried,hurry,hurrying
hurt: hurts
husband: husband
hush: hushed
hustle: hustled
hut: hut
ice: ice,iced
icicle: icicle,icicles
icy: icy
idea: idea
idealist: idealist
identification: identification
identify: identify
identity: identity
idiot: idiot
idle: idle
idol: idol
ignite: ignited
ignorance: ignorance
iii: iii
illustrate: illustrate,illustrated
illustration: illustrations
illustrations: illustrations
illustrator: illustrator
illustrious: illustrious
image: image
imagination: imagination
immense: immense
immortal: immortal
immovable: immovable
impatiently: impatiently
impenetrable: impenetrable
imperceptibly: imperceptibly
implore: implored
imploringly: imploringly
imply: implied
impose: imposed
impossible: impossible
impression: impression
impropriety: impropriety
improve: improve
improved: improved
improvement: improvement
impulse: impulse
inaccurate: inaccurate
inaudible: inaudible
incense: incense
incessant: incessant
inch: inch,inches
incidental: incidental
incline: inclined
inclined: inclined
include: include,included,includes,including
including: including
incoherent: incoherent
income: income
incomplete: incomplete
increase: increasing
incredible: incredible
incredulous: incredulous
indemnify: indemnify
indemnity: indemnity
indescribable: indescribable
indict: indicting
indignantly: indignantly
indirect: indirect
indirectly: indirectly
individual: individual
individually: individually
indoor: indoors
industry: industry
inexorable: inexorable
inexplicable: inexplicable
inexpressibly: inexpressibly
infamous: infamous
infancy: infancy
infant: infant
infection: infection
infernal: infernal
infinitely: infinitely
influence: influence
inform: informs
infringement: infringement
ing: ing
innocent: innocent
innumerable: innumerable
inquire: inquire,inquired
inquiry: inquiry
insect: insect
insignificant: insignificant
insist: insisted
inspection: inspection
instance: instance
instant: instant
instantaneous: instantaneous
instantly: instantly
intellectual: intellectual
intelligent: intelligent
intense: intense
intent: intent
intention: intention,intentions
intently: intently
intercede: intercedes
intercourse: intercourse
interfere: interfere
intermediate: intermediate
internal: internal
international: international
interpret: interpret,interpreted
interpretation: interpretations
interrupt: interrupted
intervention: intervention
intimation: intimation
intricate: intricate
introduce: introduce
introduction: introduction
invalidity: invalidity
investment: investments
invisible: invisible
involuntarily: involuntarily
involve: involve
iron: iron,ironed,irons
ironmongery: ironmongery
irrepressible: irrepressible
irresistible: irresistible
irresistibly: irresistibly
irresolution: irresolution
irs: irs
island: island
iso: iso
issue: issue,issued
item: item
iv: iv
ivy: ivy
jack: jack
jacob: jacob
january: january
jason: jason
jaw: jaw,jaws
jefferson: jefferson
jest: jest
jet: jet
jiffy: jiffy
jocund: jocund
joe: joe
john: john
joint: joints
joke: joke,jokes
jolly: jolly
joseph: joseph
jostle: jostled
journey: journeys
jovial: jovial
joy: joy,joys
joyful: joyful
joyously: joyously
judge: judged,judges
judgment: judgment
jug: jug
juggle: juggling
juicy: juicy
justice: justice
justify: justified
keenly: keenly
keepsake: keepsake
ken: kenned
kerchief: kerchief
key: key
keyhole: keyhole
kick: kick
kill: killed
kin: kin
kindly: kindly
kindness: kindness,kindnesses
kindred: kindred
kiss: kissed,kissing
kitchen: kitchens
kith: kith
knee: knee,knees
kneel: knelt
knife: knife
knock: knock,knocked,knocking
knocker: knocker
knot: knot,knots
knowledge: knowledge
labour: labour,laboured,labours
labourer: labourers
lace: lace
lad: lad,lads
ladder: ladders
laden: laden
lady: ladies
lake: lake
lame: lame
lamentation: lamentation
lamp: lamp,lamps
land: land,lands
lane: lane,lanes
language: language
lash: lashes
late: late
lateness: lateness
latent: latent
lath: laths
laugh: laugh,laughed,laughing,laughs
laughter: laughter
laundress: laundress
law: law,laws
lay: laid,lay,laying
lead: lead,leading,led
leaf: leaf,leaves
leafless: leafless
league: league
lean: lean,leaning
leap: leap,leaped,leaping
learn: learn,learned,learnt
leave: leave,leaving,left
ledger: ledgers
leech: leech
leg: leg,legs
legal: legal
legally: legally
legatee: legatee
legion: legion
lemon: lemons
lesson: lesson,lessons
letter: letter,letters
lettuce: lettuce
liability: liability
liable: liable
liberal: liberal
liberality: liberality
library: library
licence: licence
license: license
licensed: licensed
lid: lid
lie: lie,lies,lying
lieu: lieu
life: life,lives
lifetime: lifetime
lift: lifting
light: light,lighted,lighter,lightest
lighthouse: lighthouse
lightly: lightly
likeness: likeness
limb: limbs
limit: limited,limits
limitation: limitation
limited: limited
linen: linen
linger: linger
link: link,linked,links
lip: lip,lips
list: list,listed
listen: listen,listened,listening
listener: listeners
literally: literally
literary: literary
live: live,lived,living
livery: livery
livid: livid
loath: loath
lobster: lobster
locate: located
location: locations
lock: lock,locked
locomotive: locomotive
lofty: lofty
loiter: loiter,loitered
loll: lolling
london: london
lonely: lonely
looker: lookers
loophole: loophole
loose: loose
loosely: loosely
lord: lord
lose: lose,loses,losing,lost
loss: loss
lot: lot,lots
loud: loud,louder
loudly: loudly
lovable: lovable
love: love,loved
lumber: lumber
lunatic: lunatic
lunch: lunch
lurk: lurked
luscious: luscious
lustily: lustily
lustrous: lustrous
lusty: lustiest,lusty
luxurious: luxurious
luxury: luxury
machine: machine
mad: mad
magnitude: magnitude
main: main
maintain: maintaining
malady: malady
mankind: mankind
manner: manner
mansion: mansion
manslaughter: manslaughter
mantle: mantle
map: maps
mark: mark,marked
market: market,marketing
marriage: marriage
married: married
marrow: marrow
marry: married
martha: martha
mash: mashed
mass: masses
master: master
match: match,matched
matron: matron
matter: matter,matters
mature: mature
maximum: maximum
mayor: mayor
meagre: meagre
meaning: meaning
measure: measuring
meat: meat
meditation: meditation
medium: medium
meet: meet,meeting,met
meeting: meeting
melancholy: melancholy
melt: melted
memorable: memorable
memory: memory
menacing: menacing
menagerie: menagerie
mention: mention,mentioned
merchant: merchant,merchants
merciful: merciful
merciless: merciless
mercy: mercy
mere: mere
merge: merged
merrier: merrier
merriment: merriment
merry: merrier,merriest,merry
messenger: messenger,messengers
metal: metal
method: method,methods
michael: michael
middle: middle
midnight: midnight
midst: midst
mighty: mighty
mild: mild
mildly: mildly
milkman: milkman
miller: miller
milliner: milliner
mince: mince
mind: mind
miner: miners
mingle: mingle
minister: ministers
minute: minute,minutes
miracle: miracle
mirror: mirrors
mirth: mirth
misanthropic: misanthropic
miscellaneous: miscellaneous
miserable: miserable
misery: misery
mislay: mislaying
missile: missile
mission: mission
mississippi: mississippi
mist: mist
mistake: mistakes
mistaken: mistaken
mistletoe: mistletoe
mistress: mistress
misuse: misused
mix: mixed
mixture: mixture
moan: moaning
modest: modest
modification: modification
modify: modified
moist: moist
molten: molten
moment: moment,moments
momentary: momentary
monday: monday
money: money
monster: monsters
monstrous: monstrous
month: month,months
mood: mood
moon: moons
moor: moor
moral: moral
morning: morning
morose: morose
morrow: morrow
mortal: mortal
moss: moss
mossy: mossy
mother: mother
motion: motion
motionless: motionless
mouldy: mouldy
mount: mounting
mountain: mountains
mourner: mourner
mournful: mournful
mourning: mourning
mouse: mice
mouth: mouth,mouths
movable: movable
movement: movements
mud: mud
mulled: mulled
multitude: multitude,multitudes
mumble: mumbled
murmur: murmur
muscular: muscular
muse: mused
music: music
musical: musical
mustard: mustard
mutter: muttered
mysterious: mysterious
mystery: mysteries,mystery
nail: nail,nails
naked: naked
nameless: nameless
narrow: narrow,narrowest
national: national
natural: natural
naturally: naturally
nature: nature
natured: natured
necessaries: necessaries
necessity: necessity
neck: neck
needle: needle
negative: negative
neglect: neglected
negligence: negligence
negus: negus
neighbour: neighbour,neighbouring
nephew: nephew
nervous: nervous
network: network
news: news
newsletter: newsletter
newspaper: newspapers
nice: nice
nick: nick
niece: niece
night: night
nightcap: nightcap
nip: nipped
noble: noble,nobler
noise: noise,noises
noisily: noisily
noisy: noisy
nonproprietary: nonproprietary
noon: noon
norfolk: norfolk
north: north
nose: nose
note: note
notice: notice,noticed
notify: notifies
notion: notion
nuisance: nuisance
numerous: numerous
nut: nuts
obedience: obedience
obey: obeyed
object: objected,objects
objection: objections
oblige: obliged
obscene: obscene
obscure: obscure,obscuring
observable: observable
observant: observant
observe: observe,observed,observing
obsolete: obsolete
occasion: occasion
occupation: occupation
occupy: occupies
occur: occur,occurred
ocean: ocean
odds: odds
odious: odious
odour: odours
offal: offal
offence: offences
offend: offend
offer: offer,offers
office: office,offices
officer: officers
official: official
officious: officious
ogre: ogre
oil: oil
oily: oily
ominous: ominous
onion: onion,onions
online: online
onslaught: onslaught
onward: onward
opaque: opaque
operation: operation
opinion: opinion
opportunity: opportunities,opportunity
opulence: opulence
orange: oranges
orchestra: orchestra
organ: organ
organize: organized
origin: origin
original: original
originator: originator
orson: orson
outcast: outcast
outdated: outdated
outer: outer
outline: outline
outpouring: outpouring
outrage: outrage
outset: outset
outstretched: outstretched
outward: outward
oven: oven
overcome: overcome
overhear: overheard
overrun: overrun
overtake: overtake
owe: owed
owner: owner,owners
oyster: oyster,oysters
pace: pace,paces
pack: packed
package: package
padlock: padlocks
pageant: pageant
pain: pain
paint: painted
pair: pair
pale: pale
palm: palm
palpable: palpable
pan: pan
panel: panels
panelling: panelling
pang: pang
panting: panting
paper: paper,papers
paperwork: paperwork
paragraph: paragraph,paragraphs
parapet: parapets
parcel: parcels
pardon: pardon
parks: parks
parliament: parliament
parlour: parlour,parlours
parrot: parrot
particle: particles
partner: partner,partners
party: parties,party
pass: pass,passed,passing
passage: passage
passenger: passengers
passion: passion,passions
passionless: passionless
pastrycook: pastrycook
pat: patted,patting
path: path,paths
pathos: pathos
patience: patience
patient: patient
pattern: pattern
paul: paul
pause: pause,paused
pave: paved
pavement: pavement
pawn: pawn
pay: paid,pay,paying
payment: payments
peace: peace
peal: peal,peals
pear: pears
peck: peck
peculiar: peculiar
pedestrian: pedestrian
peel: peeled
peep: peeping
pelt: pelt
pelting: pelting
pen: pen,pent
penance: penance
pencil: pencil
pendulous: pendulous
penetrate: penetrated
penitence: penitence
penny: penny
perfect: perfect
perfectly: perfectly
perform: perform,performed,performing
performance: performances
period: period
periodic: periodic
perish: perish
permanent: permanent
permission: permission
permit: permit,permitted
perplexed: perplexed
persecute: persecuted
persevere: persevered
person: people,person,persons
personal: personal
personally: personally
perspiration: perspiration
perversion: perversion
peter: peter
petrifaction: petrifaction
phantom: phantom,phantoms
pharaoh: pharaoh
phase: phases
phenomenon: phenomenon
phrase: phrase
physical: physical
piano: piano
pick: pick,picking
pictorial: pictorial
picture: picture,pictured
pie: pies
piece: piece
pierce: pierce,piercing
pig: pig,pigs
pigtail: pigtail
pile: pile,piled,piles,piling
pillage: pillaged
pimple: pimple
pin: pinned
pinch: pinched
pinion: pinioned
pipe: pipe,pipes
piping: piping
pitch: pitch
piteously: piteously
pity: pities,pity
plain: plain
plaintive: plaintive
plaster: plaster
plate: plates
platt: platt
platter: platter
play: play,played,playing
plead: plead,pleaded
pleasant: pleasant,pleasanter,pleasantest
pleasantly: pleasantly
pleasantry: pleasantry
pleased: pleased
pleasure: pleasure
pledge: pledged
plentiful: plentiful
plenty: plenty
plough: ploughed
pluck: plucked
plug: plug
plum: plum,plums
plume: plume
plummer: plummer
plump: plump,plumping
plunder: plunder,plundered
plunge: plunge,plunged
pocket: pocket,pocketed,pockets
poem: poem
poetically: poetically
poke: poked
poker: poker
polished: polished
ponder: pondering
ponderous: ponderous
pony: ponies
pooh: pooh
poor: poor
poplar: poplar
popularity: popularity
population: population
porch: porch
porter: porter
portion: portion
portly: portly
position: position
positive: positive
possess: possessed
possession: possession
possibility: possibility
post: post,posted,posts
postboy: postboy
pot: pot
potato: potato,potatoes
poulterer: poulterer
poultry: poultry
pound: pounds
pour: poured,pouring
poverty: poverty
power: power,powers
powerful: powerful
powerless: powerless
practically: practically
practice: practice
praise: praise,praised
pray: pray,prayed
prayer: prayer
precept: precepts
precious: precious
predicament: predicament
predict: predicted
prediction: prediction
preferred: preferred
prematurely: prematurely
prentice: prentice,prentices
preparation: preparations
prepare: prepare,prepared
prepared: prepared
preposterous: preposterous
presence: presence
presentation: presentation
preserve: preserve,preserved
press: pressed,pressing
pretend: pretending
pretty: pretty
prevent: prevent
previous: previous
price: price
pride: pride
prime: prime
princess: princess
principal: principal
principle: principle,principles
print: print,printed
prison: prisons
prisoner: prisoner
private: private
privation: privations
prize: prize
proceedings: proceedings
process: process
processing: processing
procession: procession
proclaim: proclaimed
procuring: procuring
prodigiously: prodigiously
produce: produce,produced,producing
production: production
profess: professes
professor: professor
proffer: proffering
profit: profit,profited,profits
profound: profound
progress: progress
prohibition: prohibition
project: project
prominently: prominently
promise: promise,promised
promote: promoting
promotion: promotion
pronounce: pronounced,pronouncing
proofread: proofread
proofreading: proofreading
property: property
prophet: prophet
proportion: proportions
propose: proposed
proprietary: proprietary
prose: prose
prostrate: prostrate
protect: protect
protrude: protruding
proudly: proudly
prove: proved
provide: provide,providing
province: province
provision: provision,provisions
provoke: provoking
public: public
publish: published
pudding: pudding,puddings
pull: pulled,pulling
pulpy: pulpy
pulse: pulse
pummel: pummel
punch: punch
punishment: punishment
punitive: punitive
purchase: purchases
pure: purest
purpose: purpose,purposes
purse: purses
pursue: pursue,pursued
pursuit: pursuit
push: pushing
pyramid: pyramids
quaint: quaint
quake: quake
quality: qualities,quality
quantity: quantity
quarrel: quarrel
quarter: quarter,quarters
queens: queens
quest: quest
question: question,questioned,questioning,questions
quick: quick
quicken: quickening
quiet: quiet
quote: quoted
race: race
radiant: radiant
rag: rags
rage: raged
ragged: ragged
rail: rail
rain: rain
raise: raise,raised,raising
raisin: raisins
raising: raising
rake: raked
rally: rallied
rampant: rampant
rampart: ramparts
range: range
rank: rank
rapid: rapid
rapidity: rapidity
rapture: rapture
rare: rare,rarest
rascal: rascal
rashly: rashly
rat: rats
rate: rate
rattle: rattled
ray: ray
reach: reach,reached,reaching
read: read,reading,reads
readable: readable
reading: reading
ready: ready
real: real
realist: realist
reality: reality
reappearance: reappearance
reason: reason
reasonable: reasonable
rebuke: rebuke
recall: recalling
recede: receded
receipt: receipt
receive: receive,received,receiving
reclamation: reclamation
recognise: recognise,recognised,recognising
recognition: recognition
recoil: recoiled
recollect: recollect
recollection: recollection
recompense: recompensed
reconcile: reconciled
recover: recover
recross: recrossed
recumbent: recumbent
red: red
redden: reddening
redistribute: redistribute,redistributing
redistributing: redistributing
redistribution: redistribution
reef: reef
reek: reeked
reel: reel
refer: referring
reference: reference,references
reflect: reflected
refuge: refuge
refund: refund
refuse: refuse
regale: regale
regard: regard,regarded
region: regions
register: register,registered
regret: regret
regularly: regularly
regulate: regulating
rejoice: rejoiced,rejoices
rejoin: rejoined
relate: relate
relaxed: relaxed
release: release,released
relent: relenting,relents
relentless: relentless
relief: relief
relinquish: relinquished
remain: remain,remained,remaining,remains
remark: remark
remarkable: remarkable
remarkably: remarkably
remedy: remedies
remember: remember,remembered
remind: reminded
remonstrate: remonstrated
remorse: remorse
remove: remove,removed,removing
rename: renamed
render: render
repair: repairing
repass: repassed
repeat: repeat,repeated
repeater: repeater
repent: repent
repentance: repentance
replace: replace
replacement: replacement
replenish: replenish
reply: replied,reply
report: reported,reports
repose: repose
represent: represented
representation: representations
repress: repress
reproach: reproach
repulse: repulsed
repute: repute
request: request
require: require,required,requires
requirement: requirements
residence: residence
residuary: residuary
resist: resisted
resistance: resistance
resolute: resolute
resolution: resolution,resolutions
resolve: resolved
resort: resort,resorting,resorts
resound: resounded
resource: resource
respect: respect
rest: rest
restless: restless
restore: restored
restriction: restrictions
result: result
resume: resumed
resurrection: resurrection
retentive: retentive
retire: retire,retired
retirement: retirement
retort: retorted
return: return,returned,returning,returns
reveal: revealed
revel: revelled
reveller: revellers
revenue: revenue
revere: revered
reverently: reverently
reverse: reversed
revolve: revolving
rhinoceros: rhinoceros
ribbon: ribbons
rich: rich,richer
riddle: riddles
ridiculous: ridiculous
rigid: rigid
rime: rime
ripe: ripe
rise: rise,rising,rose
river: river
road: road
roar: roar,roared,roaring
roast: roast
robe: robe
robert: robert
robin: robin
robinson: robinson
rock: rocks
rod: rod
roger: roger
roll: roll,rolled,rolling
roller: roller
rolling: rolling
roof: roof,roofs
root: root
rose: roses
rough: rough
rouse: roused
rove: roved
royalty: royalties,royalty
rub: rub,rubbed,rubbing
ruddy: ruddy
rude: rude
ruin: ruin,ruined
rule: rules
ruler: ruler
rush: rush
rust: rust
rusty: rusty
ruthlessly: ruthlessly
sacred: sacred
sad: sad
safe: safe
sage: sage
sail: sailing
sake: sake
salary: salary
sale: sale
sally: sallied
salt: salt
satire: satire
satirical: satirical
satisfaction: satisfaction
satisfactory: satisfactory
satisfied: satisfied
saturdays: saturdays
sauce: sauce
saucepan: saucepan
sausages: sausages
savage: savage
save: save
savour: savour
scabbard: scabbard
scale: scale,scales,scaling
scant: scant
scanty: scanty
scar: scarred
scarcely: scarcely
scatter: scatter,scattered
scene: scene
scent: scents
school: school
schoolmaster: schoolmaster
score: scores
scorn: scorning
scowl: scowling
scramble: scrambled
scrap: scrap
scrape: scraping
scratch: scratch
scream: screaming
screen: screen,screened
screw: screw,screws
scripture: scriptures
scrooge: scrooge
scrutinise: scrutinise
scuffle: scuffle
scuttle: scuttle
sea: sea
seal: seal,seals
sealing: sealing
search: search,searching
season: season
seasonable: seasonable
seat: seat,seated
seaweed: seaweed
secret: secret,secrets
secure: secure,secured
security: security
seek: seek,sought
seethe: seething
seize: seize,seized
seldom: seldom
select: selecting
selfishness: selfishness
sell: sold
send: send,sending,sends
sensation: sensation
sense: sense
sentence: sentence
sentiment: sentiment
separate: separate
september: september
series: series
servant: servant
serve: serve,served
service: service,services
set: set,setting
setting: setting
seventh: seventh
severally: severally
severe: severe
severity: severity
sewing: sewing
sexton: sexton
sha: sha
shabby: shabby
shade: shade
shadow: shadow,shadowing,shadows
shadowy: shadowy
shaggy: shaggy
shake: shake,shaking,shook
shakespeare: shakespeare
shaking: shaking
shame: shame
shape: shape,shaped
share: share,shared,sharing
sharp: sharp,sharper,sharpest
shave: shaving
shaving: shaving
shawl: shawl
sheath: sheath
sheen: sheen
sheet: sheet,sheets
shelf: shelves
shilling: shilling,shillings
shine: shine,shining,shone
ship: ship
shirt: shirt
shiver: shivered,shivering
shoe: shoe,shoes
shop: shop,shops
shopkeeper: shopkeepers
shore: shore
short: short,shortest
shot: shot
shoulder: shoulder
shout: shouted,shouts
shouting: shouting
shovel: shovel,shovelling
shower: shower
shred: shreds
shrewdly: shrewdly
shriek: shriek
shrink: shrunk
shrivel: shrivelled
shroud: shroud,shrouded
shudder: shudder,shuddering
shuffle: shuffled
shun: shun
shut: shut,shutting
shutter: shutter,shutters
shyly: shyly
sick: sick
sidle: sidled
sigh: sigh
sight: sight
sign: signed,signs
silence: silence
silent: silent
silently: silently
silken: silken
silly: silly
silver: silver
simile: simile
simmer: simmer
simple: simple
sin: sin
sing: sang,singing,sung
singer: singer
singing: singing
single: single
singular: singular
singularly: singularly
sink: sank,sunk
sinner: sinner
sir: sir
sister: sister,sisters
sit: sat,sit,sitting
situation: situation
sixpence: sixpence
size: size
skater: skater
skim: skimmed
skin: skin
skip: skipping
skirt: skirts
sky: skies,sky
slander: slander
sleep: sleep,sleeping,slept
sleet: sleet
sleeve: sleeve
slide: slide
slight: slight,slightest
slily: slily
slink: slunk
slipper: slippers
slipshod: slipshod
slow: slow,slower
slowly: slowly
slyness: slyness
smart: smart
smear: smears
smell: smell,smelt
smile: smile,smiled,smiling
smoke: smoked
smoking: smoking
smoky: smoky
smooth: smooth
smother: smothering
snap: snapped
snore: snore
snow: snow,snowing
snowball: snowball
snuff: snuff,snuffed
snug: snug
sob: sobbed,sobbing
sofa: sofa
soft: soft
soften: soften,softened,softening
softly: softly
sole: sole
solemn: solemn
solicit: solicit
solicitation: solicitation
solitary: solitary
solitude: solitude
solution: solution
son: son
song: song
sooty: sooty
sordid: sordid
sorrow: sorrow
sorrowful: sorrowful
sort: sort,sorts
soul: soul
sound: sound,sounded,sounds
source: source
sow: sow
space: space
spacious: spacious
spade: spade
spanish: spanish
spare: spare,spared
spark: spark
sparkle: sparkled
sparkling: sparkling
speak: speak,speaking,spoke,spoken
speaker: speaker,speakers
special: special
specific: specific
speck: specks
speckled: speckled
spectacles: spectacles
spectral: spectral
spectre: spectre
speech: speech
speed: sped,speed
speedily: speedily
spend: spend,spent
sphere: sphere
spice: spices
spirit: spirit,spirits
spirited: spirited
spite: spite
splendid: splendid
splinter: splinter
splitting: splitting
spoil: spoil
sponge: sponge
spontaneous: spontaneous
spoon: spoon,spoons
sport: sport,sports
spot: spot,spotted
spout: spout
spray: spray
spread: spread
sprig: sprigs
spring: spring,springing,sprung
sprinkle: sprinkle,sprinkled
sprinkling: sprinklings
spur: spur
sputter: sputtered
squab: squab
squeak: squeak
squeeze: squeeze,squeezing
stable: stables
staff: staff
stage: stages
stagger: stagger,staggered
stagnant: stagnant
stair: stair,stairs
staircase: staircase
stake: stake
stale: stale
stamp: stamp,stamping
stand: stand,standing,stood
star: star
stare: staring
start: start,started,starting
startled: startled
stately: stately
statement: statements
station: stations
statue: statues
stature: stature
status: status
stave: stave
stay: stay
steadiness: steadiness
steady: steady
steal: stolen
steam: steam
steel: steel
steep: steeped
steeple: steeples
stem: stem
step: step,steps
sternly: sternly
stick: sticking,sticks,stuck
stiff: stiff
stiffen: stiffened
stingy: stingy
stir: stir,stirred,stirring
stirring: stirring
stocking: stockings
stomach: stomach
stone: stone,stones
stony: stony
stool: stool
stoop: stooped
store: stored
storehouse: storehouse
storm: storm,storms
story: stories,story
stove: stove
straggle: straggling
straight: straight
strain: strain
strait: strait
strange: strange,strangest
stranger: stranger,strangers
streak: streak
stream: streamed
street: street,streets
strength: strength
stretch: stretch,stretched,stretching
strict: strict
strictly: strictly
strife: strife
strike: strike,strikes,struck
strive: strive
stroke: stroke
stroll: stroll,strolled
strong: strong,stronger
stronghold: stronghold
struggle: struggle,struggled,struggling
strut: strutted
stuff: stuff,stuffing
sturdily: sturdily
sturdy: sturdy
subject: subject,subjects
submissively: submissively
subscribe: subscribe
subsequently: subsequently
subside: subsided
substantial: substantial
substitute: substituted
suburb: suburbs
succeed: succeeded
success: success
successor: successor
suck: sucking
sudden: sudden
suddenly: suddenly
suffer: suffer,suffers
sufficient: sufficient
sugar: sugar
suitable: suitable
suite: suite
sullen: sullen
sultan: sultan
sum: sums
summer: summer
sun: sun
sunday: sunday
sunken: sunken
sunny: sunniest
supernatural: supernatural
supplication: supplication
support: support,supported
suppose: suppose,supposed,supposing
supposition: supposition
surely: surely
surface: surface
surmounted: surmounted
surplus: surplus
surprise: surprise
surprised: surprised
surprising: surprising
surround: surrounded
survey: surveying
survive: survive,surviving
susceptible: susceptible
suspect: suspected
suspicious: suspicious
swallow: swallow,swallowed
swamp: swamp
swan: swan
swarthy: swarthy
sweep: sweep,swept
sweet: sweet
sweeten: sweetened
swell: swell
swiftly: swiftly
swing: swing,swung
swinging: swinging
swoon: swoon
sword: sword
syllable: syllable
sympathy: sympathy
synonymous: synonymous
table: table
tacitly: tacitly
tail: tail,tails
tailor: tailor
talk: talk,talked,talking
tall: tall,taller
tank: tank
tap: tap
tarry: tarry
tartness: tartness
task: task
tassel: tassels
taste: tasted
tatters: tatters
tavern: tavern
tax: tax,taxes
taylor: taylor
tea: tea
teach: taught,teach
team: team
tear: tearing,tears,torn
temper: temper
temperature: temperature
tend: tended
tendency: tendency
tender: tender,tenderest
tenderness: tenderness
term: term,terms
terrestrial: terrestrial
terrible: terrible
terrify: terrified
terror: terror,terrors
texture: texture
thankee: thankee
thankful: thankful
thaw: thaw,thawed
theme: themes
thermometer: thermometer
thicken: thickened
thine: thine
thirsty: thirsty
thither: thither
thoroughfare: thoroughfares
thoughtful: thoughtful
thoughtfully: thoughtfully
thread: thread
threadbare: threadbare
threshold: threshold
thrill: thrilled
throne: throne
throw: threw
thunder: thunder
thundering: thundering
thy: thy
tickled: tickled
tie: tied
tiger: tiger
tight: tight
tights: tights
tile: tile,tiles
tim: tim
time: time,times
timidly: timidly
tint: tints
tiny: tiny
tiptoe: tiptoe
title: title
toast: toast
toil: toil
tolerably: tolerably
toll: tolled,tolls
tong: tongs
tooth: teeth
toothpick: toothpick
topper: topper
torch: torch
torture: torture
toss: toss
total: total
touch: touch,touched
tough: tough
towel: towels
tower: tower
town: town
toy: toys
trace: trace,tracing
trade: trade,trades
trademark: trademark
train: trains
transcribe: transcribe
transcription: transcription
transfer: transferred
transformation: transformation
transition: transition
transparent: transparent
transport: transports
travel: travel,travelling
traveller: travellers
travels: travels
tread: tread
treadmill: treadmill
treasure: treasure
treatment: treatment
tree: tree
tremble: trembled,trembling
tremendous: tremendous
tremendously: tremendously
tremulous: tremulous
trial: trial
trick: tricks
trifle: trifle,trifled
trigger: trigger
trim: trimmed,trimming
trip: tripped
triumphantly: triumphantly
trivial: trivial
trot: trotting
trouble: trouble
true: true,truest
trunk: trunk
trust: trust
truth: truth
tucker: tucker
tug: tug
tumble: tumbled,tumbling
tumbler: tumblers
tumult: tumult
tumultuous: tumultuous
tune: tune,tuned,tunes
tunic: tunic
turkey: turkey,turkeys
tut: tut
twelfth: twelfth
twine: twine
twinkling: twinkling
twist: twisted,twisting
twopence: twopence
type: types
ubiquitous: ubiquitous
ugly: uglier,ugly
unable: unable
unaltered: unaltered
unanimity: unanimity
unanimously: unanimously
unavailing: unavailing
unbroken: unbroken
uncertain: uncertain
uncle: uncle,uncles
uncomfortably: uncomfortably
uncommon: uncommon
unconscious: unconscious
unconsciously: unconsciously
unconstrained: unconstrained
uncurtained: uncurtained
underdone: underdone
undergo: undergoing,undergone,underwent
undermine: undermine
understand: understand,understood
understanding: understanding
undertaker: undertaker
undigested: undigested
undisturbed: undisturbed
undo: undo
undoubted: undoubted
undress: undressing
unearthly: unearthly
uneasy: uneasy
unenforceability: unenforceability
unfasten: unfastened
unfeeling: unfeeling
ungrateful: ungrateful
unhallowed: unhallowed
unhappy: unhappy
uniform: uniform
union: union
united: united
universal: universal
unknown: unknown
unlink: unlink
unmoved: unmoved
unpleasant: unpleasant
unprofitable: unprofitable
unquestionably: unquestionably
unseemly: unseemly
unseen: unseen
unsolicited: unsolicited
untrue: untrue
unusual: unusual
unwatched: unwatched
unwept: unwept
update: updated
uphold: upheld
upper: upper
uproarious: uproarious
upside: upside
urgently: urgently
useless: useless
user: user
usual: usual
ut: ut
utmost: utmost
utterance: utterance
vacant: vacant
vague: vague
vaguely: vaguely
vain: vain
valentine: valentine
vanilla: vanilla
vanish: vanished
vapour: vapour
varied: varied
variety: variety
vast: vast
vegetation: vegetation
veil: veil
vein: vein,veins
veneration: veneration
venture: ventured,venturing
veriest: veriest
version: version
vestige: vestige
vibrate: vibrate
vibration: vibrations
view: view,viewed,viewing
vigour: vigour
vile: vile
vinegar: vinegar
violate: violates
violent: violent
violently: violently
virus: virus
visible: visible
vision: vision,visions
visit: visit,visited,visits
visitation: visitation
visitor: visitor
voice: voice,voices
void: void
volume: volume
volunteer: volunteer,volunteers
wag: wag
wages: wages
waggish: waggish
waggon: waggons
waist: waist
waistcoat: waistcoat,waistcoats
wait: waiting
wake: waking
walk: walk,walked,walking,walks
walking: walking
wall: wall,walls
walled: walled
wander: wander,wandering
wane: waning
wanton: wanton
war: war
ward: ward,warded
warehouse: warehouse
wares: wares
warm: warm,warmer,warming
warmth: warmth
warn: warn,warned,warning
warrant: warranted
warranty: warranties,warranty
wash: wash
washing: washing
waste: waste,wasted
wasting: wasting
watch: watch,watched,watches
water: water,watered,waters
waterproof: waterproof
wave: waved,waves
wax: wax
waxy: waxy
weak: weak
weakness: weakness
wealth: wealth
wealthy: wealthy
weapon: weapons
wear: wear,wearing,wore,worn
weary: weary
weather: weather
weed: weeds
week: week
weekly: weekly
weep: wept
weigh: weigh
weight: weight,weights
welfare: welfare
welsh: welsh
west: west
wet: wet
whatsoever: whatsoever
wheel: wheel,wheels
wheeze: wheezing
whereat: whereat
wherefore: wherefore
wheresoever: wheresoever
whisper: whispered
whistle: whistle
white: white
whitechapel: whitechapel
wholly: wholly
whomsoever: whomsoever
whoop: whoop
wicked: wicked
wicker: wicker
wide: wide,widest
wife: wife
wig: wig
wild: wild
wildly: wildly
wilfully: wilfully
williams: williams
willingly: willingly
win: win
wind: wind,winding
winded: winded
window: window,windows
wine: wine
wing: wing,wings
wink: wink,winking
winter: winter
wintry: wintry
wipe: wiped
wiry: wiry
wisdom: wisdom
wise: wise,wiser,wisest
wit: wits
witch: witches
withal: withal
withdraw: withdraw,withdrawing,withdrew
wither: withered
withered: withered
witness: witness,witnesses
woe: woe
wolfish: wolfish
woman: woman,women
wonderful: wonderful
wonderfully: wonderfully
wood: wood,woods
wooden: wooden
word: word
wordy: wordy
workhouse: workhouses
worldly: worldly
worn: worn
worth: worth
worthless: worthless
worthy: worthy
wound: wound
wrapper: wrapper
wreath: wreath,wreaths
wrench: wrenching
wrestle: wrestled
wretched: wretched
wring: wrung
wringing: wringing
wrinkle: wrinkle
write: write,writing,written,wrote
writer: writer
writing: writing
wrong: wrong
yard: yard
yawn: yawn,yawning
yearn: yearned
yellow: yellow
yesterday: yesterday
yield: yield
yo: yo
yonder: yonder
york: york
youth: youth
zeal: zeal
