abandon: abandoned
abide: abide
ability: abilities,ability
abject: abject
abnormal: abnormal
abode: abode
abolish: abolish
abolition: abolition
abominable: abominable
abomination: abomination
abortion: abortions
abound: abound,abounds
abreast: abreast
abscond: absconded
absence: absence
absent: absent
absolute: absolute
absolutely: absolutely
absolution: absolution
absorb: absorbing
abstract: abstracted
absurd: absurd
absurdity: absurdity
abundance: abundance
abundant: abundant
abuse: abused
accede: accedes
accent: accent,accents
accept: accepted,accepts
acceptable: acceptable
accident: accident,accidents
accidental: accidental
acclimatise: acclimatised
accommodate: accommodate,accommodates
accompaniment: accompaniment
accompany: accompanied,accompany
accomplice: accomplices
accomplish: accomplish
accomplished: accomplished
account: account,accounts
accountant: accountant
accumulate: accumulate
accurately: accurately
accuse: accuse
accustom: accustomed
accustomed: accustomed
ace: ace
acknowledge: acknowledged
acknowledgment: acknowledgment
acquaint: acquaint,acquainted
acquaintance: acquaintance,acquaintances
acquainted: acquainted
acquire: acquire
acre: acres
action: action,actions
active: active
activity: activities,activity
actress: actresses
actual: actual
acute: acute
adage: adage
adapt: adapt,adapted
add: add,adds
addition: addition
address: address,addresses,addressing
adept: adepts
adhere: adhered
administration: administration
administrator: administrators
admirably: admirably
admiration: admiration
admire: admired,admiring
admired: admired
admission: admission
admit: admit,admitted
admonish: admonish
adolescence: adolescence
adolescent: adolescent
adopt: adopt
adoption: adoption
adorn: adorn
adornment: adornment,adornments
adroitly: adroitly
adullam: adullam
adult: adult,adults
advance: advance,advances,advancing
advanced: advanced
advancement: advancement
advantage: advantage,advantages
advertise: advertised
advertisement: advertisement
advice: advice
advise: advise,advised,advising
advocate: advocate
affair: affairs
affect: affect
affection: affection,affections
affirm: affirm
afflict: afflicted
affliction: affliction,afflictions
afford: afford
afraid: afraid
africa: africa
afternoon: afternoon
age: age,aged,ages
aged: aged
agency: agencies,agency
agent: agent
aggravate: aggravate
agony: agony
agree: agree,agreed
agreement: agreement
aid: aid,aided
ailment: ailments
aim: aim
air: air
airy: airy
alarm: alarm
alas: alas
alcohol: alcohol
alderman: alderman
alert: alert
alfred: alfred
alike: alike
alive: alive
alleviate: alleviate
alley: alley
allot: allotted
allowance: allowance
alter: alter,altered
alteration: alteration
alternate: alternated
alternately: alternately
alternation: alternations
alternative: alternative
altogether: altogether
amazed: amazed
ambition: ambitions
amend: amended,amends
amenity: amenities
america: america
american: americans
ample: ample
amply: amply
amputate: amputated
amusement: amusement
anaemia: anaemia
ancient: ancient,ancients
angel: angels
angle: angle
angry: angry
anguish: anguish
angus: angus
animal: animal,animals
animate: animated
animated: animated
annie: annie
anniversary: anniversary
annoy: annoyed
annoyance: annoyance
annual: annual
annually: annually
anomaly: anomalies
answer: answer,answered,answers
ant: ants
anticipate: anticipating
antiquity: antiquity
anxiety: anxieties,anxiety
anxious: anxious
apartment: apartments
apartments: apartments
apathy: apathy
apology: apologies,apology
appal: appal
appalling: appalling
apparatus: apparatus
apparent: apparent
appeal: appeal,appealed,appeals
appearance: appearance
appetite: appetite
application: application
apply: applied,applies,apply
appoint: appointed
appointment: appointments
apportion: apportioning
appreciably: appreciably
appreciation: appreciation
apprentice: apprentice,apprenticed,apprentices
approach: approach,approached,approaches,approaching
approval: approval
approve: approve,approved
architect: architect
argue: argue,arguing
arguing: arguing
argument: argument
argyll: argyll
aright: aright
arithmetic: arithmetic
arm: arm,arms
armed: armed
armstrong: armstrong
army: army
aroma: aroma
arouse: aroused
arraignment: arraignment
arrange: arrange,arranged
arrangement: arrangement,arrangements
arrest: arrest,arrested
arrive: arrive,arrived,arrives,arriving
arrow: arrows
arson: arson
art: art
article: article,articles
artificial: artificial
artisan: artisans
artist: artist,artists
artistic: artistic
ascend: ascend,ascended
ascertain: ascertained
ash: ashes
ashamed: ashamed
ashore: ashore
asleep: asleep
aspiration: aspiration,aspirations
assault: assault
assemble: assemble,assembled
assembly: assembly
assertive: assertive
asset: assets
assist: assist,assisted,assists
assistance: assistance
assistant: assistant
associate: associates
association: association,associations
assortment: assortment
assuage: assuaging
assume: assumes
assurance: assurance
assure: assured,assures
assured: assured
assuredly: assuredly
asthma: asthma
astonish: astonished,astonishes
astonished: astonished
astonishing: astonishing
astound: astound
astute: astute
asunder: asunder
asylum: asylum,asylums
athletic: athletic
atmosphere: atmosphere
atom: atom
atrophy: atrophy
attach: attach,attached,attaching
attack: attack,attacked
attainment: attainments
attempt: attempt,attempted,attempts
attend: attend,attended,attending,attends
attendance: attendance
attendant: attendant,attendants
attention: attention
attest: attested
attire: attire
attract: attract,attracted
attraction: attraction,attractions
attractive: attractive
attribute: attributed
auburn: auburn
audacity: audacity
audibly: audibly
audience: audience
aught: aught
augment: augmented
aunt: aunt
austin: austin
australia: australia
australian: australian
authorise: authorised
authority: authorities,authority
autocrat: autocrat
automatic: automatic
avail: avail
avaunt: avaunt
average: average
averse: averse
avert: avert
avoid: avoid,avoided
avoidable: avoidable
await: await,awaiting,awaits
awake: awoke
award: awarded
awful: awful
axiom: axiom
aye: aye
babble: babble
babe: babe
babel: babel
baby: babies,baby
bacchus: bacchus
bachelor: bachelor
backbone: backbone
backboneless: backboneless
backyard: backyard,backyards
bacon: bacon
bad: bad,worse,worst
badly: badly,worse
bag: bag,bagged
baker: baker
balcony: balconies
ball: ball,balls
balm: balm
band: band
bandage: bandages
banish: banished
bank: bank
banner: banner
bar: bar,bars
bare: bare
barely: barely
bargain: bargains
bargee: bargees
barrow: barrows
bartholomew: bartholomew
baseball: baseball
basement: basement
basin: basin
basis: basis
basket: basket,baskets
bassinet: bassinet
basted: basted
bastille: bastille
bat: bats
bath: bath,bathed,bathing
bathing: bathing
battered: battered
battle: battle,battles
bay: bay
bear: bear,bearing,bears,born,borne
beard: beard
bearing: bearing
beast: beast,beasts
beat: beat,beats
beautiful: beautiful
beauty: beauty
bed: bed,beds
bedding: bedding
bedford: bedford
bedroom: bedroom,bedrooms
bedside: bedside
bedstead: bedstead
beef: beef
beehive: beehives
beer: beer
befriend: befriend,befriended
beg: beg,begged,begging,begs
beggar: beggar
beggary: beggary
begone: begone
behalf: behalf
behave: behave,behaved
behaviour: behaviour
behold: behold
belief: belief
bell: bell,bells
belong: belong,belonging,belongs
beloved: beloved
belt: belts
ben: ben
bend: bent
beneath: beneath
beneficent: beneficent
benefit: benefit,benefited,benefits
benevolent: benevolent
bent: bent
bereave: bereaved
beseech: beseech
beset: beset
besetting: besetting
bestial: bestial
bestiality: bestiality
bestow: bestow,bestowed,bestows
betide: betide
betray: betray,betrayed
beware: beware
bewilder: bewildered,bewilders
bid: bid
bind: bind,bound
birch: birch
bird: bird,birds
birth: birth
bishop: bishops
bit: bit,bits
bitter: bitter,bitterest
bitterly: bitterly
bitterness: bitterness
black: black
blackfriars: blackfriars
blade: blade
blame: blame
blanch: blanched
blank: blank
blanket: blankets
blast: blast
blaze: blazed
bleed: bleeds
blend: blend
blended: blended
bless: bless,blessed
blessed: blessed
blessing: blessing,blessings
blight: blight,blighted
blind: blind,blinded,blinds
bloater: bloaters
block: block,blocked,blocks
blood: blood
bloom: bloom,blooming
blossom: blossoms
blouse: blouse,blouses
blow: blow,blowing,blows
blue: blue
board: board,boards
boast: boast,boasted
bode: bodes
bodied: bodied
bodily: bodily
body: bodies,body
bogy: bogy
boil: boiled
boiler: boiler
bold: bold
bona: bona
bond: bonds
bone: bones
bonnet: bonnets
book: book,books
boom: booming,booms
boon: boon
boot: boot,boots
booth: booth
bootlace: bootlaces
borough: borough
borrow: borrow
borstal: borstal
bottle: bottle,bottles
bound: bounds
boundary: boundaries
bow: bowed
bowery: bowery
bowl: bowls
box: box,boxes
boxing: boxing
boy: boy,boys
boyhood: boyhood
brace: brace,braces
brain: brain,brains
branch: branch,branches
brass: brass
brave: brave,bravest
bravely: bravely
braver: braver
bread: bread
breadth: breadth
break: break,breaking,broke,broken
breakdown: breakdown
breakfast: breakfast
breaking: breaking
breast: breast
breath: breath
breathe: breathe,breathed,breathing
breathing: breathing
breed: bred
brick: brick
bride: bride
bridge: bridge,bridged,bridges
brigade: brigade
brigades: brigades
bright: bright,brighter
brighten: brighten,brightened,brightens
brilliant: brilliant
brilliantly: brilliantly
bring: bring,bringing,brings,brought
britain: britain
britannica: britannica
british: british
britons: britons
broad: broad
broken: broken
brood: broods
brother: brother,brothers
brotherhood: brotherhood
brotherly: brotherly
brown: brown,browned
browning: browning
bruise: bruised
brush: brush,brushes
brutal: brutal
brutality: brutality
brute: brute,brutes
buckskin: buckskin
buffer: buffers
bug: bugs
bugle: bugle
build: build,building,builds,built
builder: builder
building: building,buildings
bulk: bulk
bump: bump
bundle: bundle,bundles
burden: burden,burdens
burglar: burglar
burglary: burglary
burgle: burgled
burgling: burgling
burial: burial
burn: burn,burned,burning
burrow: burrow,burrowing
burst: burst,bursting,bursts
bury: buried,bury
busily: busily
business: business
busy: busy
butcher: butcher,butchers
butt: butt
butter: butter
butterfly: butterflies
button: button,buttoned,buttons
cage: caged
cakebread: cakebread
cakewalk: cakewalk
calculate: calculating
calculation: calculations
calling: callings
calm: calm
canada: canada
canal: canal,canals
candle: candles
candour: candour
cannon: cannon
cap: cap,caps
capability: capabilities,capability
capable: capable
capacity: capacity
capital: capital
capitalist: capitalists
capricious: capricious
car: car
card: card,cards
cardboard: cardboard
care: care,cared,cares,caring
career: career
careful: careful
carefully: carefully
caretaker: caretaker
careworn: careworn
carman: carman
carnal: carnal
carnival: carnival
carpet: carpet,carpets
carriage: carriage
carrier: carriers
carry: carried,carries,carry,carrying
carton: carton
cassock: cassock
cast: cast,casts
casual: casual
casually: casually
cat: cat
catalogue: catalogue
catapult: catapult
catastrophe: catastrophe
catch: catch
catering: catering
cattle: cattle
cave: cave,caves
cease: cease
ceaseless: ceaseless
ceaselessly: ceaselessly
ceiling: ceiling
celebrate: celebrate
celebration: celebration
celerity: celerity
cell: cell,cells
cemetery: cemetery
censure: censure
central: central
centre: centre,centred,centres
century: centuries
cerebral: cerebral
cerement: cerements
ceremony: ceremony
certainty: certainty
certificate: certificate
certification: certification
certify: certified
chafe: chafing
chain: chains
chair: chair,chairs
chalk: chalk,chalked
chamber: chamber,chambers
chance: chance,chances
chandler: chandler
change: change,changed
chaos: chaos
chap: chap
chapel: chapel
chaplain: chaplain
chapter: chapter,chapters
character: character,characters
characteristic: characteristic,characteristics
characterless: characterless
charge: charge,charged,charges
chargeable: chargeable
charing: charing
charitable: charitable
charitably: charitably
charity: charity
charles: charles
charm: charms
charnel: charnel
chattel: chattels
cheap: cheap,cheaper
cheapside: cheapside
cheat: cheat
cheating: cheating
check: checking
cheer: cheer
cheerfully: cheerfully
cheery: cheery
cheese: cheese
cheque: cheque,cheques
cherish: cherished
cherry: cherries,cherry
chess: chess
chest: chest,chests
chested: chested
chief: chief
chiefly: chiefly
child: child,children
childhood: childhood
childlike: childlike
china: china
chloride: chloride
choice: choice
choicest: choicest
choir: choir
choke: choke,choked,choking
choose: choose,choosing,chosen
chop: chopped,chopping
chorus: chorus
christendom: christendom
christian: christian
christmas: christmas
chronicle: chronicled
church: church,churches
churchill: churchill
churchyard: churchyard
cigar: cigar,cigars
cigarette: cigarettes
circe: circe
circle: circle
circular: circular
circumscribe: circumscribed
circumstance: circumstances
circumstantially: circumstantially
citizen: citizen,citizens
citizenship: citizenship
city: cities,city
civilisation: civilisation
civilised: civilised
claim: claim,claims
clammy: clammy
clamour: clamouring
clarke: clarke
class: class,classed,classes
classification: classification
classified: classified
classify: classified,classify
claus: claus
clean: clean,cleaned,cleaner
cleaning: cleaning
cleanliness: cleanliness
cleanse: cleansed,cleansing
cleopatra: cleopatra
clergy: clergy
clergyman: clergyman,clergymen
clerical: clerical
clerk: clerk
clever: clever,cleverest
clicker: clicker
climb: climb,climbed,climbing
clime: clime
cling: cling
clock: clock
close: close,closed,closes
closely: closely
cloth: cloth
clothe: clad,clothed
clothes: clothes
clothing: clothing
club: club,clubs
coal: coal
coarse: coarse
coat: coat,coated,coats
coddle: coddled
code: code
coffer: coffers
coffin: coffin
coin: coins
cold: cold
collaborate: collaborate,collaborated
collapse: collapsed
colleague: colleagues
collect: collected,collecting,collects
collection: collection
collector: collector
colonial: colonial
colony: colonies,colony
colour: colour,colours
coloured: coloured
combination: combination
combine: combine,combined,combines
comedy: comedy
comfort: comfort,comforted,comforting,comforts
comfortable: comfortable
comfortably: comfortably
comforter: comforter
comforting: comforting
command: command
commemorate: commemorate
commence: commence,commenced
commencement: commencement
commend: commend
comment: comment,commented,comments
commerce: commerce
commercial: commercial
commingle: commingled
commission: commission,commissioned
commissioner: commissioners
commit: commit,committed,committing
commitment: commitment
committal: committal
committed: committed
committee: committee,committees
commodious: commodious
commodity: commodities
common: common
commonplace: commonplace
commons: commons
communication: communication
communicative: communicative
communion: communion
community: community
companion: companion,companions
companionship: companionship
company: companied,company
comparative: comparative
comparatively: comparatively
compare: compare,compared
compel: compel,compelled,compels
compelled: compelled
compelling: compelling
compensate: compensates
compensation: compensation,compensations
competence: competence
competency: competency
competent: competent
competitive: competitive
complacent: complacent
complain: complain
complaining: complaining
complaint: complaint
complete: complete,completed
complex: complex
complexion: complexion
compose: compose,composed
comprehensive: comprehensive
comprise: comprised,comprises
compulsion: compulsion
compulsory: compulsory
compunction: compunction
computing: computing
comus: comus
conceal: concealed
conceivable: conceivable
conceive: conceive
conception: conception
concern: concern,concerns
concerned: concerned
concurrence: concurrence
condemn: condemn,condemned
condemnation: condemnation
condense: condensed
condition: condition,conditions
conducive: conducive
conduct: conduct,conducted
confederate: confederates
confer: conferred
confess: confess,confessed
confession: confessions
confidence: confidence
confine: confined
confirm: confirm,confirmed,confirms
confirmation: confirmation
conflict: conflict
conflicting: conflicting
confound: confounded
confront: confront,confronts
confused: confused
confusion: confusion
congenital: congenital
congregate: congregate,congregated
congregation: congregation
connect: connected
connection: connection
conquer: conquered
conscience: conscience
conscious: conscious
consciousness: consciousness
conscript: conscripts
consecrate: consecrated
consent: consent
consequence: consequence,consequences
considerable: considerable
considerably: considerably
consideration: consideration
consign: consign,consigned
consist: consists
conspicuous: conspicuous
constable: constables
constant: constant
constantly: constantly
constitute: constitute,constituted,constituting
constitution: constitution
construction: construction
consult: consult,consulting
consultative: consultative
consume: consumed
consummate: consummate
consumption: consumption
consumptive: consumptive
contact: contact
contagion: contagion
contamination: contamination
contemplate: contemplate
contemplation: contemplation
contend: contend,contending
content: content
contented: contented
contentedly: contentedly
contents: contents
continent: continent
continual: continual
continually: continually
continuance: continuance
continue: continue,continued,continues
continued: continued
continuous: continuous
continuously: continuously
contract: contract
contradiction: contradictions
contradictory: contradictory
contrast: contrast,contrasts
contribute: contribute,contributes
contribution: contribution
contrivance: contrivance
control: control
convenience: convenience,conveniences
conversation: conversation,conversations
convert: convert,converted,converts
convex: convex
convey: convey,conveys
convict: convict,convicted,convicts
conviction: conviction,convictions
convince: convince,convinced
convinced: convinced
cook: cooked,cooking
cookery: cookery
cooking: cooking
cool: cool
coolly: coolly
cope: cope,coping
copper: coppers
cord: cords
corn: corn,corned
corner: corner,corners
coroner: coroner
corporal: corporal
corporate: corporate
corporation: corporations
corps: corps
correct: correct,corrected
correction: correction
correspond: corresponded
corrupt: corrupting
corruption: corruption
cos: cos
cost: cost,costs
costly: costly
cot: cot
council: council
count: count
countenance: countenance
counter: counters
counterbalancing: counterbalancing
counterfeit: counterfeit
counterpane: counterpane
counterpart: counterparts
countless: countless
country: countries,country
county: counties,county
couple: couple,couples
coupling: coupling
courage: courage
court: court,courts
courtesy: courtesy
cover: cover,covered,covering,covers
cradle: cradle
craft: craft
craftsman: craftsmen
cram: cram
cramped: cramped
craving: craving
crawl: crawling
crazy: crazy
create: create,created
creation: creations
creature: creature,creatures
credentials: credentials
credible: credible
credit: credit
creed: creed
creep: creep,creeping
crematorium: crematorium
cress: cress
cricket: cricket
crime: crime,crimes
criminal: criminal,criminals
criminally: criminally
cripple: cripple,crippled,cripples
crippled: crippled
critical: critical
crock: crocks
crockery: crockery
crook: crook
cross: cross,crossed,crosses
crowd: crowd,crowded,crowds
crowded: crowded
crown: crown
cruel: cruel
cruelty: cruelty
crumb: crumbs
crush: crush,crushed,crushing
crutch: crutches
cub: cubs
culture: culture,cultured
cumberer: cumberers
cunning: cunning
cup: cup,cups
curate: curate
cure: cure,cured
curious: curious
curl: curl,curled
curly: curly
current: current
curse: curse
curtain: curtains
custody: custody
custom: custom
cut: cut,cuts
daily: daily
dainty: dainty
dame: dame
damp: damp
dance: dance,dancing
dancing: dancing
danger: danger,dangers
dangerous: dangerous
daniel: daniel
dank: dank
dante: dante
dark: dark
darkness: darkness
darning: darning
dash: dash
daughter: daughter,daughters
dawn: dawn
day: day,days
daylight: daylight
dazed: dazed
dead: dead
deadly: deadly
deaf: deaf
deal: deal,dealing,deals,dealt
dealings: dealings
dearly: dearly
death: death,deaths
debauch: debauch
debauchery: debauchery
debility: debility
debris: debris
debt: debt
decadence: decadence
decadent: decadent
decay: decay,decayed
december: december
decency: decencies,decency
decent: decent
decently: decently
decide: decide,decided,deciding
decidedly: decidedly
decision: decision
decisive: decisive
declaim: declaim
declare: declare,declared,declares,declaring
decline: declined,declines
decoration: decorations
decrease: decrease
decree: decreed
deed: deed,deeds
deem: deemed
deep: deep,deeper,deepest,deeps
deeply: deeply
default: default
defeat: defeated
defect: defect,defects
defective: defective
defence: defence
defer: defer
defiance: defiance
deficiency: deficiency
deficient: deficient
defile: defiled
definite: definite
deform: deformed
deformity: deformity
defraud: defrauded
deft: deft
deftly: deftly
defy: defy
degenerate: degenerates,degenerating
degradation: degradation
degrade: degraded
degrading: degrading
degree: degree
deliberately: deliberately
delicate: delicate
delicately: delicately
delight: delight,delights
delinquency: delinquencies,delinquency
delinquent: delinquent,delinquents
delirium: delirium
deliver: deliver,delivered
deliverance: deliverance
delude: deluded
demand: demand,demanded,demanding,demands
demanding: demanding
demented: demented
dementia: dementia
demoniacal: demoniacal
demonstrate: demonstrated
demoralisation: demoralisation
demoralising: demoralising
demur: demur
demure: demure
den: dens
denial: denial
denmark: denmark
deny: denied,deny,denying
department: department,departments
depend: depend,depends
dependent: dependent
deplete: depleted
deplorable: deplorable
deplorably: deplorably
deport: deported
deposit: deposit,deposited
depot: depots
depravity: depravity
depredation: depredation
depress: depressing
depressing: depressing
depression: depression
deprivation: deprivation,deprivations
deprive: deprived,deprives
depth: depth
depths: depths
deputy: deputy
derelict: derelicts
derive: derive
descend: descend,descended
descendant: descendants
description: description,descriptions
desecrate: desecrated
desert: deserted
deserve: deserves
deserving: deserving
design: designs
desirable: desirable
desire: desire,desired
desirous: desirous
desk: desk,desks
desolation: desolation
despair: despair
despairing: despairing
destination: destination
destine: destined
destitute: destitute
destitution: destitution
destroy: destroy,destroyed
destroyer: destroyer
destruction: destruction
destructor: destructor
detain: detain,detained,detaining
detect: detect,detected,detecting
detective: detective,detectives
detention: detention
deter: deter
determine: determines
detestable: detestable
develop: develop,developed,developing,develops
development: development
devise: devise
devolve: devolved
devonshire: devonshire
devote: devoted
devoted: devoted
devotion: devotion
devoutly: devoutly
dew: dew
dick: dick
dickens: dickens
dicks: dicks
die: die,died,dies,dying
diet: diet
difference: difference
differentiate: differentiate
difficult: difficult
difficulty: difficulties,difficulty
diffidence: diffidence
dignified: dignified
dignify: dignifies
dignity: dignity
dilapidated: dilapidated
dilapidation: dilapidation
dim: dimmed
dimension: dimensions
diminish: diminish,diminished
dimly: dimly
dine: dined
dingy: dingy
dining: dining
dinner: dinner
dint: dint
dipsomania: dipsomania
dipsomaniac: dipsomaniac,dipsomaniacs
direct: direct
direction: direction,directions
director: directors
directory: directories
dirt: dirt
dirty: dirty
disability: disabilities
disabled: disabled
disappear: disappear,disappeared,disappears
disappearance: disappearance
disappoint: disappointed
disappointed: disappointed
disappointingly: disappointingly
disappointment: disappointment
disaster: disaster,disasters
disastrous: disastrous
disband: disbanded
discard: discarding
discharge: discharge,discharged
disciple: disciples
discipline: discipline
disciplined: disciplined
disclose: disclosed
disclosure: disclosures
discomfiture: discomfiture
discordantly: discordantly
discount: discount
discover: discover,discovered
discuss: discuss,discussed,discussing
discussion: discussion
disease: disease
diseased: diseased
disgrace: disgrace
disgraceful: disgraceful
disgust: disgust
disgusted: disgusted
disgusting: disgusting
disheartening: disheartening
dishonest: dishonest
dishonesty: dishonesty
dislike: disliked
dismally: dismally
dismay: dismay,dismayed
dismayed: dismayed
disorder: disorder
dispensary: dispensary
dispense: dispense,dispensed
dispossess: dispossess
dispute: dispute,disputed,disputes
disqualify: disqualified
dissipate: dissipated
dissipation: dissipation
dissolute: dissolute
distance: distance
distant: distant
distasteful: distasteful
distinct: distinct
distinction: distinctions
distinctly: distinctly
distinguish: distinguish
distress: distress
distressing: distressing
distribute: distribute,distributing
district: district,districts
disturb: disturbed
disturbing: disturbing
disuse: disuse
dive: dived
divide: divided,divides
division: division
divorce: divorced
dock: dock
doctor: doctor,doctors
document: document
dodge: dodge,dodging
dog: dog
doings: doings
dole: doles
doleful: doleful
dolorous: dolorous
domain: domain
domestic: domestic
dominate: dominates,dominating
donna: donna
doom: doomed,dooms
door: door,doors
doorstep: doorstep
doorway: doorway,doorways
doss: doss
double: double,doubled
doubly: doubly
doubt: doubt
doubtless: doubtless
dowdyism: dowdyism
downhearted: downhearted
downright: downright
downstairs: downstairs
downward: downward
downy: downy
dozen: dozen,dozens
drag: drag,dragged
dragging: dragging
dragon: dragon
drain: drain,drained,drains
dramatist: dramatists
draper: draper
draw: draw,drawing,drawn,draws
drawer: drawers
drawing: drawing
dread: dread,dreaded
dreaded: dreaded
dreadful: dreadful
dress: dress,dressed,dresses
dressed: dressed
dressing: dressing
drift: drift
drink: drank,drink,drinking,drinks
drinking: drinking
drive: drive,driven,drives
droll: droll
drone: droning
drop: dropped,dropping
dropsy: dropsy
droughty: droughty
drown: drowned
drudge: drudge
drum: drum,drumming
drunk: drunk
drunkard: drunkard,drunkards
drunken: drunken
drunkenness: drunkenness
dry: dry,drying
dual: dual
duchess: duchess
duke: duke
dull: dull
dumb: dumb
dun: duns
dupe: duped
duration: duration
dusky: dusky
dust: dust
dustbin: dustbins
dustheap: dustheaps
dutch: dutch
duty: duties,duty
dwarf: dwarf,dwarfs
dwell: dwell,dwells
dweller: dwellers
dwelling: dwelling,dwellings
eager: eager
eagerly: eagerly
ear: ears
earn: earn,earned,earning,earns
earnest: earnest
earnestly: earnestly
earnings: earnings
earth: earth
ease: ease
easily: easily
east: east
easter: easter
easy: easier,easy
eat: eat,eating,eats
eating: eating
ebb: ebbing,ebbs
economic: economic
economical: economical
economics: economics
economy: economy
ecstatic: ecstatic
edify: edifying
educate: educated
educated: educated
education: education
educational: educational
educative: educative
edward: edward
effectual: effectual
effort: effort,efforts
egg: egg
egypt: egypt
eighteen: eighteen
eighth: eighth
eject: eject,ejected
ejectment: ejectment
eke: eke
elapse: elapse
elbow: elbow,elbowing
eld: elder,eldest
elder: elder
elderly: elderly
elect: elected
electric: electric
electricity: electricity
element: element,elements
elemental: elemental
elementary: elementary
elephant: elephant
elevate: elevate
elevator: elevator,elevators
elevators: elevators
eleventh: eleventh
eliminate: eliminated
eliot: eliot
eloquence: eloquence
emaciated: emaciated
embankment: embankment
embarrass: embarrass
embezzlement: embezzlement
embodiment: embodiment
embrace: embrace,embracing
emerge: emerging
emergency: emergencies
emigrate: emigrate,emigrated,emigrates
emigration: emigration
emily: emily
eminence: eminence
emotion: emotions
emphasis: emphasis
emphasise: emphasise
emphatic: emphatic
empire: empire
employ: employed
employer: employers
employment: employment
empower: empowered
emulate: emulate
enable: enable,enabled,enabling
enchain: enchains
encourage: encourage,encourages
encyclopaedia: encyclopaedia
endeavour: endeavour
enders: enders
endless: endless
endow: endows
endurance: endurance
endure: endure,endured,endures,enduring
enemy: enemies,enemy
energy: energy
enforce: enforce,enforced
engage: engage,engaged
engagement: engagements
engine: engine
engineer: engineers
england: england
english: english
englishman: englishman
englishmen: englishmen
enjoy: enjoy,enjoyed,enjoying,enjoys
enlarge: enlarged
enlargement: enlargement
enlist: enlisting
enormity: enormity
enrich: enrich
ensue: ensue,ensued,ensuing
ensure: ensure,ensures
entail: entail
enter: enter,entered,entering,enters
enterprise: enterprise
entertain: entertain,entertained
enthusiastic: enthusiastic
entire: entire
entitle: entitle,entitled,entitling
entrance: entrance
enumerate: enumerate,enumerated
envelop: enveloped
envelope: envelope,envelopes
environ: environ
environment: environment
epilepsy: epilepsy
epileptic: epileptic,epileptics
equal: equal
equally: equally
erect: erect,erected,erects
errand: errand,errands
escape: escape,escaping
escort: escorted
espouse: espouses
esprit: esprit
essence: essence
establish: established,establishing
establishment: establishment,establishments
esteemed: esteemed
estimable: estimable
estimate: estimate
estrange: estranged
eternal: eternal
eternity: eternities
eugenist: eugenists
euphonious: euphonious
evaporate: evaporates
eve: eve
evening: evening,evenings
event: event,events
eventually: eventually
eventuate: eventuates
everlasting: everlasting
everlastingly: everlastingly
everyday: everyday
evidence: evidence,evidences
evident: evident
evidently: evidently
evil: evil,evils
evils: evils
evolution: evolution
evolve: evolve
exact: exact
exaggerate: exaggerate
exaggerated: exaggerated
exaggeration: exaggeration
examination: examination,examinations
examine: examine,examined
exceed: exceed
exceedingly: exceedingly
exception: exception,exceptions
excess: excess
excessive: excessive
exchange: exchange,exchanged,exchanges
exchequer: exchequer
excitable: excitable
excite: excite,excited,excites
excited: excited
excitedly: excitedly
excitement: excitement
exciting: exciting
exclamation: exclamation
exclude: excluded
excuse: excuse
exempt: exempt
exercise: exercise,exercises,exercising
exertion: exertions
exhaust: exhaust
exhaustion: exhaustion
exhibit: exhibit,exhibited
exhilaration: exhilaration
exhort: exhort
exist: exist,existed,exists
existence: existence
existent: existent
exit: exit
exodus: exodus
exorbitant: exorbitant
exorbitantly: exorbitantly
expand: expand
expect: expect,expected
expectation: expectation
expedition: expedition
expend: expend
expenditure: expenditure
expense: expense,expenses
expensive: expensive
expensively: expensively
experience: experience,experienced,experiences,experiencing
experienced: experienced
experiment: experiment
expire: expires
explain: explaining
explicit: explicit
exploit: exploits
exploitation: exploitation
exploration: explorations
explore: explore,explored
explosion: explosion,explosions
explosive: explosive
export: export,exported,exporting
expose: exposed
expostulate: expostulated
express: express,expressed,expressing
expression: expression,expressions
expunge: expunged
extend: extend,extended
extent: extent
extenuation: extenuation
exterminate: exterminate
extinguish: extinguished
extort: extort
extra: extra,extras
extract: extract,extracts
extraordinary: extraordinary
extravagant: extravagant
extreme: extremes
extremity: extremities
eye: eye,eyes
eyesight: eyesight
eyesore: eyesore
faced: faced
facetiously: facetiously
facial: facial
factor: factor,factors
factory: factory
fag: fag
fail: fail,failed,failing,fails
failure: failure
fain: fain
faint: faint,fainting
fair: fair
faith: faith
faithful: faithful
fall: fall,fallen,falling,falls,fell
false: false
falsely: falsely
falter: falter
fame: fame
familiar: familiar
familiarise: familiarise
family: families,family
famished: famished
famous: famous
fancy: fancy
fare: fared,fares
farewell: farewell
farm: farm
farmer: farmer,farmers
farth: farthest
fascinate: fascinated,fascinates
fascinating: fascinating
fascination: fascination
fashion: fashion,fashioned
fast: fast,fasted,fasting
fasten: fastened
fastidiously: fastidiously
fat: fat,fatter
fatal: fatal
fatalist: fatalist
fate: fate,fated
father: father,fathers
fatherless: fatherless
fault: fault,faults
favourable: favourable
favourably: favourably
favourite: favourite
fear: fear,feared,fears
fearful: fearful
fearsome: fearsome
feasting: feasting
february: february
feckless: feckless
fed: fed
feeble: feeble,feebler
feebleness: feebleness
feebly: feebly
feed: fed,feed,feeding,feeds
feeding: feeding
feel: feel,feeling,feels
feeling: feeling,feelings
fellow: fellow,fellows
fellowship: fellowship
female: female,females
femininity: femininity
fender: fender
fermentation: fermentation
fern: ferns
fervent: fervent
festering: festering
festival: festival
fetch: fetch,fetched
fetid: fetid
feverish: feverish
fickle: fickle
fiddle: fiddle
fide: fide
fides: fides
field: field,fields
fiend: fiends
fiery: fiery
fight: fight,fights
figure: figure,figures
file: file
filth: filth
filthy: filthy
final: final
finally: finally
financial: financial
financially: financially
fine: fine,fined,fines,fining
finely: finely
finger: finger,fingers
finish: finish,finished
finisher: finisher
fireside: fireside
firewood: firewood
firing: firing
firm: firm
firmly: firmly
fish: fish
fit: fit,fits,fitted,fitting
fitness: fitness
flabby: flabby
flag: flag
flannelled: flannelled
flash: flash
flashy: flashy
flat: flat,flats
flavour: flavour
flaxen: flaxen
flee: fled
flesh: flesh
flight: flights
fling: flung
flock: flock
flood: floods
floor: floor,floors
flounder: flounder
flourish: flourish
flow: flows
flower: flowers
fluent: fluent
fluently: fluently
fluffy: fluffy
flute: flute
fly: flies,fly
fog: fog
foggy: foggy
fold: folded
folk: folk,folks
follow: follow
folly: folly
fond: fond
food: food
foodstuff: foodstuffs
fool: fool,fools
foolish: foolish
foot: feet,foot
football: football,footballs
footed: footed
footsore: footsore
footstep: footstep
forbid: forbade,forbidden,forbidding,forbids
force: force,forced
forefather: forefathers
foreign: foreign
foremost: foremost
foreshadow: foreshadows
forest: forest
foretaste: foretaste
forgery: forgery
forget: forget,forgets,forgetting,forgot,forgotten
forgive: forgive
fork: fork,forks
forlorn: forlorn
form: form,formed,forming,forms
formidable: formidable
formulate: formulated
forsake: forsake,forsaken
forsooth: forsooth
forthcoming: forthcoming
forthwith: forthwith
fortitude: fortitude
fortnight: fortnight
fortunately: fortunately
fortune: fortune,fortunes
foster: foster
foul: foul
fountain: fountain
fourpence: fourpence
fourpenny: fourpenny
fourteen: fourteen
fourteenth: fourteenth
fourth: fourth
fracture: fractured
frame: frame,frames
france: france
francis: francis
frankly: frankly
fray: frayed
freedom: freedom
freehold: freehold
freely: freely
french: french
frequent: frequent
frequently: frequently
fresh: fresh
fret: fretting
friday: friday
fried: fried
friend: friend,friends
friendless: friendless
friendly: friendly
friendship: friendship,friendships
frighten: frighten
fringy: fringy
fro: fro
frock: frock
frowsy: frowsy
fruit: fruit,fruits
fruiterer: fruiterer
fruitful: fruitful
fruition: fruition
fruitless: fruitless
frustrated: frustrated
frying: frying
fulfil: fulfil,fulfilling
fulness: fulness
fume: fumes
fun: fun
fund: funds
funeral: funeral,funerals
funny: funny
fur: furs
furnish: furnished,furnishes
furnished: furnished
furniture: furniture
furrow: furrowed,furrows
furtive: furtive
fury: fury
futile: futile
futility: futility
future: future
gain: gain,gained
gait: gait
gall: gall
gallery: galleries
gamble: gambling
gambler: gamblers
gambling: gambling
game: game,games
games: games
gang: gang
gaol: gaol
gaoler: gaoler
garden: garden,gardens
gardener: gardener
garment: garment
gas: gas
gasp: gasp,gasping
gasworks: gasworks
gate: gate,gates
gather: gather,gathered,gathering,gathers
gay: gay
gaze: gaze,gazed
generation: generation,generations
generous: generous
genius: genius
gent: gents
genteel: genteel
gentle: gentle
gentleman: gentleman,gentlemen
gently: gently
genuine: genuine
genuinely: genuinely
geometrical: geometrical
george: george
germany: germany
gesticulation: gesticulation
gift: gift,gifts
gifted: gifted
girl: girl,girls
girlhood: girlhood
glad: glad
gladly: gladly
gladness: gladness
glance: glance
glass: glass,glasses
gleeful: gleeful
glimpse: glimpse,glimpses
glisten: glistening
glitter: glittering
gloom: gloom
gloomy: gloomy
glorious: glorious
glory: gloried,glory
glow: glow,glowing
goal: goal
god: god,gods
gold: gold
golden: golden
goldsmith: goldsmith
golf: golf
goodness: goodness
goose: goose
gorgeous: gorgeous
govern: govern,governing,governs
government: government,governments
governor: governor,governors
gown: gown
grace: grace,graces
graceless: graceless
graciously: graciously
grade: grade,graded
graduate: graduate,graduated
graham: graham
grain: grain
gramophone: gramophone
granary: granaries
grand: grand
grandmother: grandmothers
grant: grant,granting
grasp: grasped
grass: grass
grateful: grateful
gratification: gratification
gratify: gratify
gratuity: gratuity
grave: grave
gravitation: gravitation
gravy: gravy
greasy: greasy
greatly: greatly
greatness: greatness
greed: greed
green: green
greengrocer: greengrocer
greenwich: greenwich
greet: greets
grief: grief
grievous: grievous
grim: grim
grime: grime
grimy: grimy
grind: grinding
grit: grit
groan: groans
grope: grope,groping
gross: gross
grossness: grossness
grotesque: grotesque
grotto: grotto,grottos
ground: ground
grounds: grounds
groundsel: groundsel
grovel: grovelling
grow: grew,grow,growing,grown,grows
growth: growth
grub: grubbing
grudgingly: grudgingly
grumpy: grumpy
grundy: grundy
guarantee: guarantee,guaranteeing
guardian: guardian,guardians
guide: guide
guillotine: guillotine
guilt: guilt
guiltless: guiltless
guilty: guilty
guinea: guinea
gull: gulled
gum: gums
gusty: gusty
gutter: gutter,gutters
habit: habits
habitation: habitation,habitations
habitual: habitual
habituate: habituated
habitue: habitue,habitues
hackney: hackney
hag: hag
hair: hair
halfpence: halfpence
halfpenny: halfpenny
hall: hall
halt: halt,halting
ham: ham
hamilton: hamilton
hamper: hampered
hand: hand,handed,hands
handicap: handicapped
handicapped: handicapped
handicraft: handicraft
handle: handle
handsome: handsome
hang: hang,hangs,hung
happen: happen,happened,happening
happiness: happiness
happy: happier,happiest,happy
hard: hard,harder
harden: harden
hardened: hardened
hardship: hardships
hark: hark,harking
harm: harm
harpy: harpies
harry: harry
harvest: harvest
hasten: hasten,hastened
hasty: hasty
haunt: haunted
hawker: hawker
haystack: haystack,haystacks
hazard: hazard
head: head,headed,heads
headed: headed
heal: healed,healing
health: health
healthy: healthy
heap: heap,heaps
hear: hear,heard
heart: heart,hearts
heartbreaking: heartbreaking
hearted: hearted
heartfelt: heartfelt
heartily: heartily
hearty: hearty
heath: heath
heating: heating
heaven: heaven
heavenwards: heavenwards
heavy: heaviest,heavy
hedge: hedged
heedless: heedless
heel: heel,heels
height: height,heights
heir: heir
helpable: helpable
helpless: helpless
helplessness: helplessness
helpmate: helpmate
henceforth: henceforth
henceforward: henceforward
henry: henry
hercules: hercules
herne: herne
hero: hero,heroes
heroic: heroic
heroism: heroism
hesitate: hesitate
heterogeneous: heterogeneous
hewer: hewers
hide: hidden,hide
hieroglyphic: hieroglyphics
highly: highly
hire: hire
historical: historical
history: history
hit: hit
hitherto: hitherto
hoary: hoary
hockey: hockey
hog: hog,hogs
hold: held,hold,holding,holds
holder: holders
hole: hole,holes
holiday: holiday,holidays
holmes: holmes
holy: holy
homeless: homeless
homelessness: homelessness
homeward: homeward
honest: honest
honestly: honestly
honesty: honesty
honour: honour
hood: hood
hoof: hoof
hook: hook
hooligan: hooligans
hooliganism: hooliganism
hop: hop,hops
hope: hope,hoped,hopes,hoping
hopeful: hopeful
hopeless: hopeless
hopelessly: hopelessly
hopelessness: hopelessness
horde: horde
horrible: horrible
horribly: horribly
horrid: horrid
horrify: horrified,horrifies
horror: horror,horrors
horse: horse
horsewhip: horsewhip
hospital: hospital,hospitals
host: host
hot: hot
hour: hour,hours
hours: hours
house: house,houses
household: household
housekeeping: housekeeping
housewife: housewife
housing: housing
howard: howard
huddle: huddled
hue: hue,hues
huffy: huffy
hug: hugging,hugs
huge: huge
huguenots: huguenots
hum: hum
human: human,humans
humanity: humanity
humanly: humanly
humdrum: humdrum
humorous: humorous
humour: humour
hump: hump
hunchback: hunchback,hunchbacks
hundredth: hundredth
hundredweight: hundredweight
hunger: hunger
hungry: hungry
hunt: hunt
hurrah: hurrah
hurry: hurried,hurry,hurrying
hurt: hurt
husband: husband,husbands
hush: hush
hyde: hyde
hymn: hymn,hymns
hypnotism: hypnotism
idea: idea,ideas
ideal: ideal,ideals
idiocy: idiocy
idiot: idiot,idiots
idle: idle
idleness: idleness
ignorance: ignorance
ignorant: ignorant
ignore: ignoring
iii: iii
illegal: illegal
illness: illness
illuminate: illuminating
illumine: illumines
illusion: illusions
illustration: illustration
imaginary: imaginary
imagination: imagination,imaginations
imaginative: imaginative
imagine: imagine,imagined
imbecile: imbeciles
immense: immense
immerse: immersed
immoral: immoral
impassable: impassable
imperative: imperative
imperfectly: imperfectly
imperious: imperious
implore: implore,implored
imply: implies
importunate: importunate
impose: impose,imposed
impossible: impossible
impostor: impostors
impress: impresses
impression: impression
impressive: impressive
imprison: imprison,imprisoned
imprisonment: imprisonment,imprisonments
improve: improve,improved
improvement: improvement
impure: impure
impurity: impurity
inability: inability
inadequate: inadequate
inane: inane
incapable: incapable
incapacitated: incapacitated
incarceration: incarceration
incendiary: incendiary
incessant: incessant
incessantly: incessantly
inch: inches
incident: incident
incipient: incipient
incline: inclined
inclined: inclined
include: include,included,includes,including
income: income
inconceivable: inconceivable
incongruous: incongruous
inconsiderable: inconsiderable
incontinently: incontinently
inconvenient: inconvenient
increase: increase,increased,increases,increasing
incur: incurred
indebted: indebted
indecency: indecency
indictment: indictment,indictments
indifference: indifference
indifferent: indifferent
indifferently: indifferently
indignation: indignation
indiscriminate: indiscriminate
indiscriminately: indiscriminately
indispensable: indispensable
indisputably: indisputably
individual: individual,individuals
indomitable: indomitable
indoor: indoors
indoors: indoors
induce: induce
indulge: indulge,indulging
indulgence: indulgence
industrial: industrial
industrially: industrially
industrious: industrious
industry: industries,industry
inebriate: inebriate,inebriates
ineligible: ineligible
inertia: inertia
inevitable: inevitable
inevitably: inevitably
inexorably: inexorably
infant: infant,infants
infantile: infantile
inferior: inferior
inferiority: inferiority
inferno: inferno
infinite: infinite
infinitely: infinitely
infirmary: infirmary
infirmity: infirmities,infirmity
influence: influence
inform: informed,informs
ingrain: ingrained
inhabit: inhabit,inhabited
inhabitant: inhabitants
inhale: inhale,inhaled
inherent: inherent
inhuman: inhuman
initiate: initiated
initiative: initiative
injunction: injunctions
injury: injuries
injustice: injustice
inmate: inmates
innocent: innocent
innovation: innovation
innumerable: innumerable
inquest: inquest,inquests
inquire: inquire,inquired,inquiring
inquirer: inquirer
inquiry: inquiries,inquiry
insane: insane
insanity: insanity
inscribe: inscribed
insect: insects
inseparable: inseparable
inseparably: inseparably
insert: inserting
insist: insisted
insistently: insistently
insolently: insolently
inspect: inspect,inspected
inspection: inspection
inspector: inspector
inspire: inspire,inspired,inspires
instant: instant
instinct: instinct,instincts
instinctively: instinctively
institute: institute
institutes: institutes
institution: institution,institutions
instruct: instruct
instruction: instruction
instrumental: instrumental
insufficient: insufficient
insult: insult
insurance: insurance
insure: insured
intact: intact
intellect: intellect
intelligence: intelligence
intelligent: intelligent
intend: intended
intense: intense
intensely: intensely
intensify: intensified
intensity: intensity
intent: intent
intention: intentioned,intentions
intercourse: intercourse
interfere: interfere,interfered
interference: interference
interminable: interminable
interminably: interminably
interrogate: interrogated
intervene: intervenes
interview: interview
intimate: intimate,intimates
intimately: intimately
intolerable: intolerable
intricacy: intricacies
intrinsically: intrinsically
introduce: introduce,introduced
introduction: introduction
invade: invade
invalid: invalid
invaluable: invaluable
invariably: invariably
invasion: invasion
invective: invective
invent: invented
inventory: inventory
investigation: investigation
investment: investments
invite: invite,invited
involuntarily: involuntarily
ireland: ireland
iron: iron,ironed
irony: irony
irregular: irregular
irreligiously: irreligiously
irresponsible: irresponsible
irritate: irritates
irritating: irritating
irritation: irritation
issue: issue,issued,issues
item: item
iv: iv
ix: ix
jack: jack
jacket: jacket
jam: jam
james: james
jane: jane
january: january
jauntily: jauntily
jawbone: jawbone
jealous: jealous
jealousy: jealousy
jellyfish: jellyfish
jerky: jerky
jerry: jerry
jersey: jerseys
jest: jest
jesus: jesus
jewellery: jewellery
jibbed: jibbed
job: job
joint: joint
joke: joke,joking
jolly: jolly
jones: jones
joneses: joneses
jostle: jostle,jostles
journalist: journalist
journey: journey
journeyman: journeyman
joy: joy,joys
joyous: joyous
judgment: judgment
jug: jug
july: july
june: june
junior: junior
jurisdiction: jurisdiction
juror: juror
jury: juries,jury
justice: justice,justices
justify: justify
juvenile: juvenile
keen: keen,keenest
keeper: keeper
kettle: kettle
kettledrum: kettledrum
khaki: khaki
kick: kick,kicked,kicking
kill: kill,killed,killing,kills
kindly: kindly
kindness: kindness
kindred: kindred
king: king
kingdom: kingdom
kiss: kissed
kitchen: kitchen
knee: knee
knickers: knickers
knife: knives
knock: knock,knocking
knowledge: knowledge
label: labels
laboriously: laboriously
labour: labour,labours
labourer: labourers
lace: laces
lachrymose: lachrymose
lack: lack,lacking
lad: lad,lads
lads: lads
lady: ladies,lady
laggard: laggards
lair: lairs
lake: lakes
lame: lame
lamp: lamp,lamps
land: land,lands
landing: landing,landings
landlady: landlady
landlord: landlord,landlords
lane: lane,lanes
language: language
larceny: larceny
larder: larder
lassie: lassie,lassies
late: late
lath: lath
laugh: laugh,laughed,laughing,laughs
laughter: laughter
laundry: laundry
law: law,laws
lay: laid,lay
lazar: lazar
lea: lea
lead: lead,leading,leads,led
leaf: leaves
lean: lean,leaning
leap: leap,leaped
lear: lear
learn: learn,learned,learning
learning: learning
lease: lease
leave: leave,leaves,leaving,left
lecture: lectures
left: left
leg: leg,legs
legal: legal
legally: legally
legged: legged
legitimate: legitimate
leicester: leicester
lend: lend,lending
lengthen: lengthened
lengthy: lengthy
lenient: lenient
leprosy: leprosy
lessen: lessen,lessened
lesson: lesson
lethal: lethal
letter: letter,letters
level: level
lewd: lewd
liability: liability
liberal: liberal
liberally: liberally
liberty: liberty
licence: licence,licences
license: license,licensed
licking: licking
lie: lain,lie,lies,lying
life: life,lives
lift: lift,lifts
light: light,lighted,lighting,lights,lit
lighten: lighten
likelihood: likelihood
limb: limb,limbs
lime: lime
limit: limit,limited,limiting
limited: limited
linger: linger,lingering
lip: lips
list: list,listed,lists
listen: listen,listened,listening,listens
literature: literature
live: live,lived,lives,living
livelihood: livelihood
livelong: livelong
liver: liver
living: living
lo: lo
loaf: loaf,loafing
loathsome: loathsome
local: local
locate: locate,located
lock: locked
locust: locusts
lodge: lodge,lodged
lodger: lodgers
lodging: lodging
lodgings: lodgings
loitering: loitering
loll: lolls
london: london
londoners: londoners
lone: lone
lonely: lonely
longing: longing
loom: loom
loose: loosed
lord: lord
lords: lords
lose: lose,loses,losing,lost
loss: loss
lot: lot,lots
loud: loud,loudest
love: love,loved,loving
loving: loving
lucidity: lucidity
lucidly: lucidly
luck: luck
lull: lulling
lullaby: lullaby
lunatic: lunatic,lunatics
lunch: lunch,lunched
luncheon: luncheon
lung: lungs
lurid: lurid
lurk: lurks
lustful: lustful
luther: luther
luxurious: luxurious
luxury: luxury
machine: machine,machined,machines
machining: machining
machinist: machinist
mad: mad
madden: maddens
maddening: maddening
madness: madness
magic: magic
magistrate: magistrate,magistrates
magnificent: magnificent
mahomet: mahomet
maid: maid
maiden: maidens
maidenhair: maidenhair
maim: maimed,maiming
maimed: maimed
main: main
maintain: maintain,maintains
maintenance: maintenance
majestically: majestically
major: major
majority: majority
maker: maker,makers
male: male,males
malnutrition: malnutrition
malodorous: malodorous
malt: malt
manage: manage,managed,managing
management: management
manager: manager,managers
manchester: manchester
manfully: manfully
manhood: manhood
manifest: manifest
manliness: manliness
manly: manly
manner: manner
mansion: mansion
manslaughter: manslaughter
manufacture: manufacture
marble: marble
march: march,marching
margarine: margarine
maria: maria
marie: marie
mark: mark,marked,marks
marked: marked
marriage: marriage,marriages
married: married
marry: married,marry,marrying
martin: martin
marvel: marvel
marvellous: marvellous
mass: mass
massive: massive
master: master,masters
masterpiece: masterpiece
mastery: mastery
match: match,matches
matchbox: matchbox,matchboxes
mate: mate,mates
material: material,materials
materialise: materialise
maternal: maternal
maternity: maternity
mathematically: mathematically
matrimony: matrimony
matron: matron
matter: matter,matters
mattress: mattress
maximum: maximum
mayor: mayor
meadow: meadow
meagre: meagre
meal: meal,meals
meaning: meaning
meaningless: meaningless
measure: measure,measured,measures,measuring
meat: meat
mechanical: mechanical
mechanically: mechanically
medical: medical
medici: medici
meet: meet,meets,met
meeting: meeting
melee: melee
melt: melts
memorandum: memorandums
memory: memory
menace: menace
mend: mend,mends
mendicant: mendicant
mendicity: mendicity
mending: mending
meningitis: meningitis
mental: mental
mentally: mentally
mention: mention,mentioned
merchant: merchant,merchants
merciful: merciful
mercy: mercies,mercy
mere: mere
merit: merit,merited
merrily: merrily
merriment: merriment
merry: merriest,merry
mesh: meshes
message: message
metal: metal
meter: meter
method: method,methods
metropolis: metropolis
metropolitan: metropolitan
midday: midday
middle: middle
midnight: midnight
midst: midst
midway: midway
mighty: mighty
migrate: migrate
migratory: migratory
mild: mild
mile: mile,miles
military: military
milk: milk
milkman: milkman
milton: milton
mind: mind,minds
minded: minded
mindedness: mindedness
minding: minding
miniature: miniature
minimise: minimise
minimum: minimum
minor: minor
minstrel: minstrel,minstrels
minute: minute,minutes
miracle: miracle
mirth: mirth
mischievous: mischievous
miserable: miserable
miserably: miserably
misery: misery
misfortune: misfortune,misfortunes
misgiving: misgivings
mislead: mislead
misname: misnamed
misshapen: misshapen
mist: mist
mistaken: mistaken
mistress: mistress,mistresses
mitigate: mitigating
mix: mixed
mixed: mixed
mixture: mixture
moan: moan
model: model,models
modern: modern
modest: modest
modestly: modestly
modicum: modicum
moisture: moisture
mollify: mollify
moment: moment,moments
momentary: momentary
monday: monday
monetary: monetary
money: money
monkey: monkey
monopolise: monopolised
monopoly: monopoly
monotonous: monotonous
monotony: monotony
monstrosity: monstrosity
monstrous: monstrous
month: month,months
monument: monument
mood: mood,moods
moody: moody
moral: moral
morally: morally
morn: morn
morning: morning
morose: morose
morrow: morrow
mortality: mortality
mortification: mortification
mother: mother,mothers
motherhood: motherhood
motion: motion
motionless: motionless
motley: motley
motor: motor
mould: mould
mountain: mountains
mournfully: mournfully
mourning: mourning
moustache: moustache
mouth: mouth
movement: movement,movements
mud: mud
muddle: muddled
muddy: muddied
multiplication: multiplication
multiply: multiplying
municipal: municipal
municipality: municipalities
murder: murder
murky: murky
muscle: muscles
music: music
muster: muster
mutual: mutual
mysterious: mysterious
mysteriously: mysteriously
mystery: mysteries,mystery
mystify: mystified
nagging: nagging
naked: naked
narrate: narrated
narrative: narrative
narrow: narrow
nastiness: nastiness
nasty: nasty
nation: nation
national: national
natural: natural
naturally: naturally
nature: nature
natured: natured
navy: navy
neat: neat
necessaries: necessaries
necessity: necessities,necessity
neck: neck,necks
needful: needful
needle: needle
needless: needless
needlework: needlework
negative: negative
neglect: neglect,neglected
neighbour: neighbour,neighbouring,neighbours
neighbourhood: neighbourhood
nephew: nephew,nephews
nerve: nerve,nerves
nest: nest,nests
netherworld: netherworld
newcastle: newcastle
newly: newly
news: news
newspaper: newspapers
nice: nice
niche: niche
nickel: nickels
niggardly: niggardly
night: night,nights
nightly: nightly
ninepence: ninepence
nineteen: nineteen
ninth: ninth
noble: noble
nod: nodded
noise: noise
noisy: noisy
nomad: nomad,nomads
nomadic: nomadic
nonsense: nonsense
noon: noon
normal: normal
north: north
northwards: northwards
nose: noses
nostril: nostrils
notable: notable
note: note,notes
notice: notice,noticed
notion: notions
nourish: nourished,nourishing
nourished: nourished
nourishing: nourishing
nourishment: nourishment
novelist: novelist,novelists
november: november
nuisance: nuisances
numbered: numbered
numberless: numberless
numeral: numerals
numerous: numerous
nurse: nurse,nursed,nurses
nursing: nursing
nutrient: nutrient
nutrition: nutrition
oaf: oafs
oats: oats
obbligato: obbligato
obdurate: obdurate
obelisk: obelisk
obey: obey,obeyed
object: object,objects
objectionable: objectionable
objective: objective
obligation: obligation,obligations
oblige: obliges
oblivion: oblivion
obscenity: obscenities,obscenity
obscurity: obscurity
observation: observation
observe: observe,observed
obsess: obsessed
obstruction: obstruction
obtrude: obtrude
obvious: obvious
occasion: occasion
occasional: occasional
occasionally: occasionally
occupant: occupants
occupation: occupation,occupations
occupied: occupied
occupy: occupied,occupies,occupy,occupying
occur: occur,occurs
ocean: ocean
odd: odd
oddment: oddments
odds: odds
odour: odours
offence: offence,offences
offender: offender,offenders
offer: offer,offered,offering,offers
office: office,offices
officer: officer,officers
official: official,officials
oft: oft
oftener: oftener
oftentimes: oftentimes
oil: oil
oliver: oliver
omnipotent: omnipotent
onerous: onerous
onion: onions
onward: onward
operate: operate,operated,operates,operating
operatic: operatic
operation: operation,operations
opinion: opinion
opportunity: opportunities,opportunity
oppressed: oppressed
oppression: oppression
oppressor: oppressors
optimistic: optimistic
option: option
optional: optional
orchestral: orchestral
orderly: orderly
ordinary: ordinary
organ: organ,organs
organisation: organisation
organise: organise,organised
organised: organised
originality: originality
originally: originally
ormond: ormond
ounce: ounces
outbuilding: outbuilding,outbuildings
outcast: outcast,outcasts
outfit: outfit
outlay: outlay
outlet: outlet
outline: outlined
outlook: outlook
outrage: outrage,outraged
outraged: outraged
outrageous: outrageous
outspoken: outspoken
outstretched: outstretched
overclean: overclean
overcoat: overcoat,overcoats
overcome: overcome
overcrowding: overcrowding
overdue: overdue
overhead: overhead
overmaster: overmastering
overpower: overpowered
oversea: oversea
oversight: oversight
overtake: overtaken,overtakes
overwhelm: overwhelmed
overwork: overwork
overworld: overworld
owe: owe,owed
owner: owners
oxford: oxford
oxygen: oxygen
oyster: oyster
pace: pace
pack: pack
packer: packer
padded: padded
pageant: pageant
pain: pain
painfully: painfully
paint: painted
painter: painter
pair: pair,pairs
palace: palace,palaces
pale: pale
palm: palms
palpable: palpable
pan: pan,pans
pang: pangs
paper: paper,papers
parade: parade
paradise: paradise
paraffin: paraffin
paragraph: paragraph
paralyse: paralyse,paralysing
paralysed: paralysed
paralysis: paralysis
paralytic: paralytic
parapet: parapet
parasite: parasite,parasites
parcel: parcel
parched: parched
parent: parents
parentage: parentage
paris: paris
parish: parish
parisian: parisian
park: park,parks
parliament: parliament
parlour: parlour
parson: parson,parsons
particulars: particulars
partly: partly
partner: partner,partners
partnership: partnership
party: parties,party
pass: pass,passed,passes,passing
passage: passage,passages
passer: passers
passion: passion,passions
passionate: passionate
passive: passive
passively: passively
passport: passport
paste: pastes
patch: patch
path: path
pathetic: pathetic
pathos: pathos
patience: patience
patient: patient,patients
patrol: patrolled
patron: patron,patrons
patronage: patronage
patronise: patronised
paul: paul
pavement: pavement,pavements
pawn: pawn,pawned,pawning
pawnbroker: pawnbrokers
pawnshop: pawnshops
pay: paid,pay,paying,pays
payable: payable
payment: payment,payments
pea: peas
peace: peace
peaceful: peaceful
peculiar: peculiar
peculiarity: peculiarities
pecuniary: pecuniary
pedestal: pedestals
pedlar: pedlar
peep: peep
peevish: peevish
penal: penal
penalise: penalised
penalty: penalties,penalty
pence: pence
pend: pending
penitent: penitent
penniless: penniless
penny: pence,pennies,penny
pennyworth: pennyworth,pennyworths
pension: pension
penury: penury
people: peopled
perambulate: perambulating
perambulator: perambulators
perceive: perceive
percentage: percentage
perchance: perchance
perdition: perdition
perfect: perfect
perfection: perfection
perfectly: perfectly
perform: perform,performing
performance: performance
peril: perils
perilously: perilously
period: period,periods
perish: perish
permanence: permanence
permanent: permanent
permanently: permanently
permeate: permeated,permeates
permission: permission
permit: permit,permits,permitted
perpetrator: perpetrators
perpetual: perpetual
perpetually: perpetually
perpetuate: perpetuate,perpetuating
perpetuation: perpetuation
perplexed: perplexed
perseverance: perseverance
persevere: persevering
persist: persisted
persistent: persistent
persistently: persistently
person: people,person,persons
personal: personal
personally: personally
personification: personification
persuade: persuaded
pervade: pervade,pervades,pervading
pervading: pervading
pervert: perverted
pest: pests
pestiferous: pestiferous
pestilential: pestilential
petty: petty
pharaohs: pharaohs
phenomenal: phenomenal
phew: phew
philanthropic: philanthropic
philanthropist: philanthropist,philanthropists
philanthropy: philanthropy
philosophic: philosophic
philosophy: philosophy
photograph: photograph,photographs
photography: photography
physical: physical
physically: physically
physician: physician
physique: physique
piano: piano
pick: pick,picked
pickle: pickle,pickles
picture: picture,pictured,pictures
pictures: pictures
picturesque: picturesque
piece: piece,pieces
pig: pig
piggery: piggeries
pile: piled
pillar: pillar,pillars
pillow: pillow,pillows
pint: pint
pioneer: pioneer
pipe: pipes
piquancy: piquancy
pirate: pirated
pitch: pitch,pitched,pitches
pitched: pitched
pitcher: pitcher
pitching: pitching
pitiable: pitiable
pitiful: pitiful
pittance: pittance
pity: pity
plan: plan,planning,plans
plane: plane
planning: planning
plant: plants
plaster: plaster
platform: platform
plausible: plausible
play: play,played,playing,plays
player: player,players
playground: playground,playgrounds
playing: playing
plead: plead,pleaded,pleading
pleasant: pleasant
pleased: pleased
pleasing: pleasing
pleasure: pleasure,pleasures
pledge: pledged
plenary: plenary
plentiful: plentiful
plenty: plenty
plight: plight
plod: plodding
pluck: pluck
plunge: plunge
plymouth: plymouth
pocket: pocket,pockets
pocketful: pocketful
poe: poe
poem: poem
poet: poet,poets
poetry: poetry
poignancy: poignancy
poise: poise
poker: poker
pokey: pokey
police: police
policeman: policeman,policemen
polisher: polisher
polishing: polishing
political: political
ponder: ponder,pondered
pool: pool
poor: poor,poorer,poorest
pope: pope
poplar: poplar
popular: popular
popularity: popularity
populate: populated
population: population
portable: portable
portal: portals
portentous: portentous
portia: portia
portion: portion
pose: pose
position: position,positions
positive: positive
possess: possess,possessed,possesses,possessing
possession: possession,possessions
possibility: possibilities,possibility
post: post,posts
postal: postal
pot: pot,pots
potato: potatoes
potential: potential
pound: pound,pounds
pour: pour,poured,pours
poverty: poverty
power: power,powers
powerful: powerful
powerless: powerless
practicable: practicable
practical: practical
practically: practically
practice: practice
practise: practise,practising
prattle: prattle,prattled
pray: praying
prayer: prayers
preach: preached,preaching
precarious: precarious
precinct: precincts
precious: precious
precipitate: precipitated
precisely: precisely
preface: preface
prefer: prefer,preferred,preferring,prefers
prematurely: prematurely
premise: premises
premium: premium
preparation: preparation
prepare: prepare,prepared
prepared: prepared
presence: presence
presently: presently
preserve: preserve
press: press,pressed,pressing
pressure: pressure
pretence: pretence,pretences
pretty: prettier,pretty
prevail: prevail,prevailing,prevails
prevent: prevent,prevented,prevents
preventive: preventive
previous: previous
prey: prey,preying,preys
price: price,prices
pride: pride
prima: prima
primeval: primeval
prince: prince
principle: principle
print: print,printed
printer: printer
prison: prison,prisons
prisoner: prisoner,prisoners
private: private
privation: privations
privilege: privilege
privileged: privileged
prize: prizes
pro: pro,pros
probability: probability
probity: probity
procedure: procedure
proceed: proceed,proceeds
proceedings: proceedings
proceeds: proceeds
process: process
procession: procession
proclaim: proclaims
procreate: procreating
procure: procure,procured
produce: produce,produced,produces,producing
product: products
profession: professions
professional: professional
profit: profit
profitable: profitable
profound: profound
progeny: progeny
progress: progress
progression: progression
progressive: progressive
prohibition: prohibition,prohibitions
project: project
prolific: prolific
prolonged: prolonged
promise: promise,promised,promises,promising
promising: promising
promote: promote,promoted
prompt: prompt
prone: prone
pronounce: pronounced
proof: proof
prop: propped
propel: propel,propelled
proper: proper
properly: properly
property: properties,property
prophecy: prophecy
prophetic: prophetic
proportion: proportion
propose: propose,proposed
prosecutor: prosecutor
prospect: prospect
prospective: prospective
prosy: prosy
protect: protect,protected,protecting
protection: protection
protective: protective
protest: protesting
protract: protracted
prove: prove,proved
provide: provide,providing
provincial: provincial
provision: provision,provisions
provoke: provoke
prowl: prowl
proxy: proxy
psychological: psychological
public: public
publican: publican
publicly: publicly
publish: published
publisher: publisher
puling: puling
pull: pulled
pulpit: pulpit
pulse: pulses
pulsing: pulsing
punch: punching
punctiliously: punctiliously
punctuate: punctuates
pungency: pungency
punish: punish,punished
punishment: punishment
puny: puny
purchase: purchase,purchased,purchases
purchasing: purchasing
pure: pure
purify: purify
purifying: purifying
purlieus: purlieus
purpose: purpose,purposes
purposeless: purposeless
purse: purse
pursue: pursue,pursued,pursuing
push: push,pushed
puzzle: puzzle,puzzled,puzzles
puzzled: puzzled
puzzling: puzzling
pyjamas: pyjamas
quaint: quaint
quaker: quaker
qualification: qualification
qualified: qualified
qualify: qualify
quality: qualities,quality
quantity: quantities,quantity
quarrel: quarrel,quarrels
quarrelsome: quarrelsome
quart: quart
quarter: quarters
queen: queen
queenly: queenly
queer: queer
quell: quelled,quelling
quest: quest
question: question,questions
questioning: questioning
queue: queue
quiet: quiet
quietly: quietly
quiver: quivering
quoit: quoits
quota: quota
quote: quote,quoted
rabbit: rabbit,rabbits
race: race,raced,races
racial: racial
rag: rags
ragamuffin: ragamuffin,ragamuffins
rail: rail
railway: railway
rain: rains
raise: raise,raised,raises
range: range,ranged
rank: rank,ranks
rape: rape
rapid: rapid
rapidly: rapidly
rare: rare
rarely: rarely
rascal: rascal,rascals
rascality: rascality
rascally: rascally
rash: rash
rata: rata
rate: rate
ratify: ratify
rattle: rattle,rattled,rattling
ray: rays
reach: reach
read: read,reading
reader: reader,readers
ready: ready
real: real
realise: realise,realised,realising
reality: reality
reap: reaping,reaps
reason: reason,reasons
reasonable: reasonable
rebuke: rebuked
recall: recall
recast: recasting
receipt: receipts
receive: receive,received,receives,receiving
receiver: receiver
reception: reception
recess: recess,recesses
recidivist: recidivists
recite: recite,recited,recites
reckon: reckoned,reckons
reckoning: reckoning
reclaim: reclaim
recognise: recognise,recognised
recognition: recognition
recommend: recommend
recommendation: recommendations
record: record,records
recover: recover,recovered,recovering
recovery: recovery
recruit: recruited,recruits
recruiting: recruiting
rectitude: rectitude
recuperation: recuperation
recur: recurring
redden: reddened
redemption: redemption
redemptive: redemptive
reduce: reduced,reducing
reduction: reduction
refer: refer,referred
reference: references
refined: refined
refinement: refinement
reflect: reflect
reflection: reflection
reform: reform,reforming
reformative: reformative
reformatory: reformatories,reformatory
refresh: refreshed
refuge: refuge
refuse: refuse,refused,refusing
regain: regain
regard: regard
regenerate: regenerate
regent: regent
regiment: regiment
register: registers
regular: regular
regularity: regularity
regularly: regularly
regulation: regulations
reid: reid
reign: reigns
reiterate: reiterate
rejoice: rejoice,rejoicing
relapse: relapse
release: release,released
reliance: reliance
reliant: reliant
relic: relics
relief: relief
relieve: relieving
relieved: relieved
religion: religion
religiously: religiously
relinquish: relinquish
reluctant: reluctant
reluctantly: reluctantly
rely: rely
remain: remain,remained,remaining,remains
remainder: remainder
remains: remains
remand: remand,remanded
remarkable: remarkable
remarry: remarried
remedy: remedy
remember: remember,remembered,remembering,remembers
remembrance: remembrance
remind: remind
remission: remission
remorse: remorse
remove: remove,removed,removing
remuneration: remuneration
remunerative: remunerative
rend: rending
render: render,rendered
renew: renew
rent: rent,rents
rental: rental
repaint: repainted
repair: repaired
repass: repass
repay: repaid,repays
repeat: repeat,repeated,repeating
repeatedly: repeatedly
repine: repining
repining: repining
replace: replace,replaces
replenish: replenish
repletion: repletion
reply: replies,reply
report: report,reported,reporting,reports
reprehensible: reprehensible
represent: represent,represented,represents
representation: representation
representative: representatives
reproach: reproach
reproduce: reproduced,reproducing
reprove: reproves
repulsive: repulsive
reputation: reputation
request: request,requests
require: require,required,requires
requirement: requirements
requisite: requisite,requisites
requisition: requisitioned
rescue: rescue,rescues
resemble: resemble,resembles
resent: resented
resentment: resentment
reserve: reserves
residence: residence
resident: residents
residue: residue
resignation: resignation
resist: resist
resistant: resistant
resort: resort,resorts
resound: resounds
resource: resources
respect: respect,respecting
respectability: respectability
respectable: respectable
respected: respected
respective: respective
respite: respite
respond: respond,responded
response: response
responsibility: responsibilities,responsibility
responsible: responsible
rest: rest,resting
restaurant: restaurant
resting: resting
restore: restore,restored
restrain: restrain
restraint: restraint,restraints
result: result
resultant: resultant
resume: resume,resumed
resurrection: resurrection
retain: retain,retaining,retains
retire: retire
retreat: retreat
return: return,returned,returning,returns
reveal: reveal,revealed
revel: revel
revenge: revenge
revengeful: revengeful
reverence: reverenced
reversal: reversal
reverse: reverse
revert: revert,reverts
revisit: revisit
revive: reviving
revolution: revolution
revulsion: revulsion
reward: reward
rheumatic: rheumatics
rich: rich,richest
richly: richly
rid: rid
ride: ride
rightly: rightly
rigid: rigid
rise: rise,risen,rises,rising,rose
risk: risk
rival: rival
river: river
road: road
roadway: roadway
roam: roam
roar: roaring,roars
roast: roasting
rob: rob,robbed,robbing
robbery: robbery
robust: robust
rogue: rogue,rogues
roland: roland
roll: roll,rolled,rolls
romance: romance
roof: roof
rook: rooks
rookery: rookeries
root: root
rose: rose,roses
rosy: rosy
rotten: rotten
rough: rough,rougher
roughen: roughened
rounders: rounders
roundly: roundly
rouse: roused,rouses
routine: routine
row: row,rows
royal: royal
royally: royally
royalty: royalty
rub: rub
rude: rude
rue: rue
ruin: ruined,ruining
rule: rule,ruled,rules
ruling: ruling
rush: rush
russia: russia
rust: rusted
rusty: rusty
sabbath: sabbath
sack: sack
sacred: sacred
sacrifice: sacrifice
sacrilege: sacrilege
sad: sad
saddening: saddening
sadly: sadly
sadness: sadness
safeguard: safeguard,safeguarded,safeguards
safely: safely
safety: safety
saint: saints
sake: sake
sale: sale
sally: sally
salt: salt
salvage: salvage
salvation: salvation
salve: salve
sample: sampled
samuel: samuel
sanatoria: sanatoria
sancho: sancho
sanction: sanctioned
sanctuary: sanctuary
sand: sands
sandwich: sandwich
sane: sane
sanitary: sanitary
sanity: sanity
santa: santa
satirical: satirical
satisfaction: satisfaction
satisfactory: satisfactory
satisfied: satisfied
saturday: saturday
saucepan: saucepan
sausages: sausages
savage: savage,savages
save: save,saved,saves,saving
saving: saving
savings: savings
saviour: saviour
scald: scalded
scale: scale
scamper: scamper
scan: scan
scandalise: scandalised
scar: scars
scarce: scarce
scarcely: scarcely
scatter: scattered
scene: scene,scenes
scheme: scheme,schemes,scheming
scheming: scheming
scholar: scholars
scholarship: scholarship
school: school,schools
schoolmaster: schoolmaster
schools: schools
scientific: scientific
scientist: scientists
scope: scope
score: scores
scotch: scotch
scotchman: scotchman
scotland: scotland
scots: scots
scoundrel: scoundrel
scour: scour
scout: scouts
scouting: scouting
scrag: scrags
scrap: scraps
screw: screw,screws
scurrilous: scurrilous
scuttle: scuttle
sea: sea
seam: seamed
seaman: seaman
seamen: seamen
search: search,searched,searching
searchingly: searchingly
season: season,seasons
seat: seat,seated,seats
secondary: secondary
secrecy: secrecy
secret: secret
secretaries: secretaries
secretary: secretary
secular: secular
secure: secure,secured,secures
security: security
sedate: sedate
seduction: seductions
seductive: seductive
seek: seek,seeking,seeks,sought
seethe: seething
segregation: segregation
seize: seize,seized,seizes
seldom: seldom
select: select,selected
selection: selection,selections
selfishness: selfishness
sell: sell,selling,sells,sold
seller: sellers
selling: selling
semblance: semblance
send: send,sending,sends
senility: senility
senior: senior
sensation: sensation
sense: sense
senseless: senseless
sensibly: sensibly
sensual: sensual
sentence: sentence,sentenced,sentences
sentiment: sentiment
sentimental: sentimental
separate: separate,separated
separation: separation
septuagenarian: septuagenarian
sepulchre: sepulchre
sequel: sequel
serene: serene
seriousness: seriousness
serpent: serpent
servant: servant,servants
serve: serve,served,serves,serving
service: service,services
serviceable: serviceable
servitude: servitude
sessional: sessional
set: set,sets,setting
settle: settle,settled
settled: settled
seventeen: seventeen
seventh: seventh
sever: sever,severed
severe: severe
sew: sews
sewing: sewing
sex: sex,sexes
shabby: shabby
shade: shade
shades: shades
shadow: shadow
shake: shakes,shook
shakespeare: shakespeare
shame: shame
shamefaced: shamefaced
shape: shape
share: share,shared,sharing
sharp: sharp
sharpen: sharpened
shawl: shawl
sheer: sheer
sheet: sheets
shelter: shelter,sheltered,shelters
shelve: shelved
shill: shilling
shilling: shilling,shillings
shine: shining
ship: ships
shipwreck: shipwrecked
shirk: shirk
shirt: shirt
shiver: shivering
shock: shock,shocked
shocked: shocked
shoddy: shoddy
shoe: shoe,shoes
shoemaker: shoemaker
shop: shop,shops
shopboard: shopboard
shopkeeper: shopkeepers
shore: shores
short: short,shorter
shortly: shortly
shoulder: shoulder,shouldered,shoulders
shout: shouting,shouts
shouting: shouting
shovel: shovel
shrift: shrift
shudder: shudder,shuddered
shuffle: shuffle
shufflingly: shufflingly
shut: shut
shuttle: shuttle
sick: sick
sickening: sickening
sickly: sickly
sickness: sickness
sigh: sighs
sight: sight,sights
sign: sign,signed,signs
signal: signal
signify: signify
silence: silence
silent: silent
silently: silently
silk: silk
sill: sills
silly: silly
silver: silver
simple: simple
simply: simply
simulate: simulate,simulating
sin: sin,sins
sincerely: sincerely
sincerity: sincerity
sing: sang,sing,singing
singer: singers
singing: singing
single: single
sink: sinks
sinner: sinner,sinners
sir: sir
sister: sister,sisters
sit: sat,sit,sits,sitting
sitting: sitting
situate: situated
sixpence: sixpence,sixpences
sixteen: sixteen
sixth: sixth
size: size
sizzle: sizzling
sketch: sketch
skilful: skilful
skill: skill
skilled: skilled
skirt: skirts
sky: sky
skylight: skylight
slang: slang
slangy: slangy
slatternly: slatternly
slave: slave,slaves
slavery: slavery
sleep: sleep,sleeping,slept
sleeper: sleepers
sleeve: sleeve
slide: slide
slight: slight,slightest
slime: slime
slimy: slimy
slip: slip,slipped
slipper: slippers
slippery: slippery
slouch: slouching
slouching: slouching
slow: slow
slowly: slowly
slum: slum,slums
slumdom: slumdom
smart: smart
smell: smell,smelling
smile: smile,smiled,smiling
smiles: smiles
smite: smites
smitten: smitten
smoke: smoked,smoking
smoking: smoking
smooth: smoothed
sneak: sneak
soap: soap
sober: sober
sobriety: sobriety
social: social
socialist: socialist
socially: socially
society: societies,society
sock: socks
sodom: sodom
soften: soften
sojourn: sojourn
sole: sole
solemn: solemn
solicitously: solicitously
solid: solid
solitude: solitude
solution: solution
solve: solve,solved,solving
son: son,sons
song: song,songs
sooner: sooner
soother: soother
soothing: soothing
sordid: sordid
sore: sore,sores
sorely: sorely
sorrow: sorrow,sorrowed,sorrows
sorrowful: sorrowful
sort: sort,sorted,sorting,sorts
soul: soul,souls
sound: sound,sounds
soup: soup
source: source,sources
south: south
sovereign: sovereign,sovereigns
sowing: sowing
spa: spa
space: space,spaces
spacious: spacious
spain: spain
span: span
spanish: spanish
spare: spare,spared
spark: spark
sparkle: sparkling
sparkling: sparkling
sparse: sparse
speak: speak,speaking,speaks,spoke,spoken
speaker: speaker
special: special
specially: specially
species: species
specific: specific
specimen: specimen,specimens
specious: specious
speculate: speculating
speculation: speculation
speech: speech
speedily: speedily
spell: spell,spells
spend: spend,spending,spent
spending: spending
sphere: sphere,spheres
spick: spick
spill: spilled
spin: spin
spinster: spinster
spirit: spirit,spirits
spiritual: spiritual
spite: spite
splash: splash
splendid: splendid
splutter: splutter
spoil: spoil,spoils
spoliation: spoliation
spoon: spoons
spot: spot
spread: spread
spring: sprang,spring
squalor: squalor
squeamish: squeamish
stafford: stafford
stage: stage
stagger: stagger,staggered
staggerer: staggerer
staid: staid
stain: stained
stair: stairs
staircase: staircase
stairs: stairs
stale: stale
stalwart: stalwart
stamp: stamp
stand: stand,standing,stands,stood
standard: standard,standards
standing: standing
standpoint: standpoint
star: stars
stare: stared,stares
start: start,started,starts
starting: starting
startling: startling
starvation: starvation
starve: starve,starved,starving
statement: statement,statements
statesman: statesmen
station: station,stations
statistician: statisticians
statistics: statistics
statuary: statuary
stature: stature
status: status
stay: stay,stays
steadfast: steadfast
steady: steady
steak: steaks
steal: steal,stealing,steals,stolen
steam: steam
step: step,steps
stepmother: stepmother
stereotype: stereotyped
stereotyped: stereotyped
sterility: sterility
sterling: sterling
sternly: sternly
stew: stew,stewed
stick: stick,sticks
stimulate: stimulated
stir: stirring
stitch: stitch
stock: stock
stolidly: stolidly
stomach: stomachs
stone: stone,stones
store: stored,stores
storey: storey,storeys
story: stories,story
straight: straight
strain: strain,strained,strains
strand: strand,stranded
strange: strange,strangest
stranger: stranger,strangers
streak: streak
stream: streams
street: street,streets
strength: strength
strengthen: strengthened
strenuous: strenuous
stress: stress
stricken: stricken
strictly: strictly
stricture: strictures
strident: strident
strife: strife
strike: strike,strikes,striking,struck
striking: striking
stringent: stringent
strip: stripped
strive: strive
strong: strong,stronger
struggle: struggle,struggled,struggles,struggling
student: student
study: studied,studies,study
stuff: stuff
stumble: stumbled
stunt: stunted
stupendous: stupendous
stupid: stupid
stupidly: stupidly
sturdy: sturdier
style: style
subdued: subdued
subject: subject,subjects
submerge: submerged
submit: submit,submitted
subscribe: subscribing
subsequently: subsequently
subsidise: subsidise
subsistence: subsistence
substantial: substantial
substitute: substitute,substituted
suburb: suburbs
suburban: suburban
succeed: succeeding
success: success
successful: successful
succession: succession
successive: successive
succumb: succumbed
suck: sucking
sudden: sudden
suddenly: suddenly
suffer: suffer,suffered,suffering,suffers
sufferance: sufferance
sufferer: sufferers
suffering: suffering,sufferings
suffice: sufficed
sufficiency: sufficiency
sufficient: sufficient
suffocation: suffocation
sugar: sugar
suggestion: suggestion,suggestions
suggestive: suggestive
suicidal: suicidal
suicide: suicide
suit: suit,suits
suitable: suitable
suite: suites
sum: sum,summed,sums
summary: summary
summer: summer
sumptuously: sumptuously
sun: sun
sunday: sunday,sundays
superb: superb
superior: superior
superstructure: superstructure
supervene: supervenes
supervision: supervision
supple: supple
supplement: supplement,supplements
supply: supplied,supplies,supply
support: supported,supporting
suppose: suppose,supposed,supposing
supreme: supreme
supremely: supremely
surcease: surcease
surely: surely
surface: surface
surfeit: surfeited
surgical: surgical
surmise: surmise
surmount: surmounted
surplus: surplus
surprise: surprise,surprised
surprised: surprised
surprising: surprising
surrey: surrey
surround: surrounded
surroundings: surroundings
survey: survey
survival: survival
survive: survive
suspect: suspected
suspicion: suspicion,suspicions
suspicious: suspicious
sustain: sustain,sustained,sustains
sustentation: sustentation
swallow: swallow
swarm: swarm,swarming
sway: sway
sweater: sweater
sweet: sweet,sweeter,sweetest
sweetly: sweetly
sweetness: sweetness
swell: swell,swollen
swift: swift
swim: swim
switch: switched
sydney: sydney
sympathetically: sympathetically
sympathy: sympathies,sympathy
systematic: systematic
table: table
tabulate: tabulated
tackle: tackle,tackled
tail: tail,tails
taint: taint
taker: taker
tale: tale,tales
talent: talent,talents
talented: talented
talk: talk,talked,talking,talks
talkative: talkative
tall: tall
tapioca: tapioca
target: target
tariff: tariff
task: task
taste: taste,tasted,tastes
tattered: tattered
tax: tax
tea: tea
teach: taught,teach,teaches,teaching
teacher: teacher
teaching: teaching
team: team,teams
teapot: teapot
tear: tear,tearing,tears,torn
technical: technical
teem: teems
teens: teens
temerity: temerity
temper: temper,tempered
temple: temple
temporary: temporary
tempt: tempted,tempts
temptation: temptation,temptations
tempting: tempting
tenant: tenant,tenants
tend: tend,tended
tender: tender
tendril: tendrils
tennyson: tennyson
tense: tenses
tent: tents
tenth: tenth
term: term,termed,terms
terminate: terminates
terrible: terrible
terror: terror,terrors
terrorise: terrorise
terry: terry
testify: testified
testimony: testimony
texture: texture
thames: thames
thankful: thankful
theft: theft
theme: theme
thermometer: thermometer
thew: thews
thief: thief,thieves
thinking: thinking
thinly: thinly
thirdly: thirdly
thirteen: thirteen
thirteenth: thirteenth
thither: thither
thomas: thomas
thoroughfare: thoroughfare
thoughtfully: thoughtfully
thoughtless: thoughtless
thoughtlessly: thoughtlessly
thread: thread
threat: threat
threaten: threatening
threepence: threepence
threescore: threescore
thrill: thrill,thrills
thrive: thrive,thrives,thriving
thriving: thriving
throat: throats
throb: throbs
throw: threw,throw,throwing,thrown,throws
throwback: throwbacks
thrower: thrower
thrust: thrust
thunder: thunder
thursday: thursday
tick: ticks
ticket: ticket,tickets
tiddler: tiddler
tide: tide
tidy: tidy
tie: tie,tied,ties
tightly: tightly
time: time,times
timer: timer
timid: timid
tin: tin,tinned
tiny: tiny
tired: tired
tobacco: tobacco
tod: tod
toil: toil,toiled,toiling,toils
tolerate: tolerate,tolerated,tolerating
toll: toll
tom: tom
tomb: tomb,tombs
tomorrow: tomorrow
toms: toms
tone: tone
tongue: tongues
tool: tools
tooth: teeth,tooth
torment: tormented
toss: toss,tosses
tosser: tosser
tossing: tossing
total: total
touch: touch,touched
touching: touching
tough: tough
tour: tour
towel: towels
town: town,towns
track: track
tractability: tractability
trade: trade
traffic: traffic
tragedy: tragedies,tragedy
trail: trail
train: train,trained,trains
training: training
tramcar: tramcar,tramcars
tramp: tramp,tramped,tramping,tramps
transform: transform
transformation: transformation
transgressor: transgressor
transmute: transmute
transplant: transplanted
transportation: transportation
trap: trap
travel: travel,travels
traverse: traversing
treasure: treasures
treat: treat,treated
treatment: treatment
tremble: trembled
tremendous: tremendous
trespasser: trespassers
trial: trial
tribe: tribes
tribute: tribute
trip: trip,tripped
triumph: triumph
troop: troop
trophy: trophies
trouble: trouble,troubled,troubles
troubled: troubled
troublesome: troublesome
trouser: trouser
trousers: trousers
truant: truant
truce: truce
true: true,truer
trump: trump
trumpery: trumpery
trust: trust,trusting,trusts
trustee: trustee,trustees
truth: truth
truthful: truthful
tub: tubs
tulip: tulips
tumbrel: tumbrel
tune: tunes
tuneful: tuneful
turkey: turkey
twelfth: twelfth
twinkle: twinkle
twist: twist,twisted
twisted: twisted
twopence: twopence
tyne: tyne
type: type,types
typewrite: typewriting
typical: typical
ubiquitous: ubiquitous
ultimate: ultimate
ultimately: ultimately
umbrella: umbrella,umbrellas
unable: unable
unaffected: unaffected
unaltered: unaltered
unashamed: unashamed
uncanny: uncanny
unceasing: unceasing
unceasingly: unceasingly
unceremoniously: unceremoniously
uncertain: uncertain
unchanged: unchanged
uncle: uncle
unclean: unclean
uncommon: uncommon
unconcernedly: unconcernedly
unconsciously: unconsciously
uncontrolled: uncontrolled
unconvicted: unconvicted
undefined: undefined
undergo: undergo,undergoing,undergone
underground: underground
underpaid: underpaid
understand: understand,understands,understood
understanding: understanding
undertake: undertake,undertaken
undertaker: undertakers
underworld: underworld
undesirable: undesirable
undisciplined: undisciplined
undiscovered: undiscovered
undisputable: undisputable
undisputed: undisputed
undoubted: undoubted
undoubtedly: undoubtedly
undue: undue
unduly: unduly
uneasy: uneasy
uneducated: uneducated
unemployable: unemployable
unemployed: unemployed
unemployment: unemployment
unequalled: unequalled
unexpectant: unexpectant
unexpected: unexpected
unexplored: unexplored
unfailingly: unfailingly
unfit: unfit
unfitness: unfitness
unfitted: unfitted
unfold: unfold
unfortunate: unfortunate,unfortunates
unfriendly: unfriendly
unhealthy: unhealthy
unhelpable: unhelpable
uniform: uniform,uniforms
union: unions
unique: unique
unite: unite
united: united
universe: universe
university: university
unjust: unjust
unkempt: unkempt
unknown: unknown
unlucky: unlucky
unmistakable: unmistakable
unmistakably: unmistakably
unnatural: unnatural
unnerve: unnerved
unoccupied: unoccupied
unpardonable: unpardonable
unpleasant: unpleasant
unprepared: unprepared
unquestioned: unquestioned
unrestrained: unrestrained
unrewarded: unrewarded
unripe: unripe
unsaleable: unsaleable
unscrupulous: unscrupulous
unseen: unseen
unshaven: unshaven
unskilled: unskilled
unsound: unsound
unspeakable: unspeakable
unspeakably: unspeakably
unthought: unthought
untidy: untidy
untrammelled: untrammelled
unwashed: unwashed
unwise: unwise
unworthy: unworthy
uphold: uphold
uplift: uplift
upper: upper,uppers
upright: upright
upset: upset
upturned: upturned
urgent: urgent
urgently: urgently
useless: useless
uselessness: uselessness
usher: ushers
usual: usual
utmost: utmost
utter: utter,uttering
utterly: utterly
vacancy: vacancies
vagabond: vagabond,vagabonds
vagabondage: vagabondage
vagrancy: vagrancy
vagrant: vagrant,vagrants
vain: vain
vainly: vainly
valuable: valuable,valuables
vampire: vampires
van: van
vanish: vanished
vanity: vanity
varied: varied
variety: variety
varnish: varnish
vary: varied,vary,varying
vast: vast
vegetable: vegetable,vegetables
veil: veil
venerate: venerate
vengeance: vengeance
ventriloquist: ventriloquist
venture: venture,ventured
verdict: verdict
verge: verge
verily: verily
veritable: veritable
vermin: vermin
versatile: versatile
vest: vests
vested: vested
vex: vexed
vice: vice
vicinity: vicinity
vicious: vicious
victim: victim,victims
victoria: victoria
victory: victories
view: view,views
vigorous: vigorous
vigour: vigour
vii: vii
viii: viii
vile: vile
villa: villas
village: village,villages
villain: villain
vinegar: vinegar
violence: violence
violent: violent
violin: violin
violinist: violinist
virile: virile
virility: virility
virtue: virtue,virtues
virtuous: virtuous
visible: visible
visit: visit,visited,visiting,visits
visitor: visitors
vitality: vitality
vivid: vivid
voice: voice,voices,voicing
void: void
voluble: voluble
volume: volume
voluntary: voluntary
vote: votes
vouch: vouches
vulgar: vulgar
vulgarly: vulgarly
vulture: vultures
wage: wage
wages: wages
waistcoat: waistcoats
wait: wait,waited,waiting
wake: wake
wales: wales
walk: walk,walked,walking,walks
walking: walking
wall: wall,walls
wallow: wallow
wander: wander,wandered,wandering
wanderer: wanderers
wanderings: wanderings
war: war
ward: ward,wards
warder: warder,warders
wardress: wardress,wardresses
warehouse: warehouse,warehouses
warm: warm
warmly: warmly
warmth: warmth
warn: warn,warned,warning
warrant: warranted,warrants
warren: warrens
wash: wash,washed,washes,washing
washing: washing
washy: washy
wastage: wastage
waste: waste,wasted,wasting
wastrel: wastrels
watch: watch,watched,watching
watchful: watchful
watchman: watchman
water: water,waters
waterloo: waterloo
wayward: wayward
weak: weak,weaker
weaken: weakened
weakling: weaklings
weakly: weakly
weakness: weakness
wealth: wealth
wealthy: wealthy
wear: wear,wearing,wears,wore
wearily: wearily
weariness: weariness
weary: weary
wearying: wearying
weather: weather
weaver: weaver,weavers
wedding: wedding
weed: weeded,weeding
week: week,weeks
weekly: weekly
weep: wept
weigh: weigh,weighing,weighs
weight: weight
weird: weird
welfare: welfare
wellbeing: wellbeing
west: west
westminster: westminster
wet: wet
whereabouts: whereabouts
wherewith: wherewith
whiff: whiff
whimsical: whimsical
whine: whining
whirl: whirl
whirred: whirred
whisper: whisper,whispering
whistle: whistle
white: white
wholesale: wholesale
wholesome: wholesome
wholly: wholly
wicked: wicked
wickedness: wickedness
wide: wide
widow: widow,widowed,widows
wife: wife,wives
wild: wild,wilds
wilful: wilful
willingly: willingly
willingness: willingness
win: win
wind: wind
window: window,windows
windsor: windsor
wine: wine
wing: wing,wings
winsome: winsome
winter: winter
wisdom: wisdom
wise: wise,wiser,wisest
wisely: wisely
wit: wit,wits
withdraw: withdraw
wither: wither,withered,withering
witness: witness,witnessed,witnesses
witted: witted
witty: witty
wizened: wizened
woe: woe,woes
wolf: wolves
woman: woman,women
womanhood: womanhood
womanliness: womanliness
womanly: womanly
wonderful: wonderful
wonderland: wonderland
woo: woo
wood: wood
wooden: wooden
word: word
wordy: wordy
worker: worker,workers
workhouse: workhouse,workhouses
workman: workman,workmen
wormwood: wormwood
worn: worn
worry: worried,worries,worry
worship: worshipped
worth: worth,worths
worthless: worthless
worthy: worthy
wound: wounded,wounding,wounds
wounding: wounding
wrap: wrapped,wraps
wrapt: wrapt
wreck: wreck,wrecked
wreckage: wreckage
wrestle: wrestle,wrestles
wretch: wretch,wretches
wretched: wretched
wretchedly: wretchedly
wretchedness: wretchedness
write: write,writes,writing,written,wrote
writer: writer,writers
writhe: writhe
writing: writing
wrong: wrong,wrongs
wrongdoing: wrongdoing
xi: xi
xii: xii
xiii: xiii
xiv: xiv
yard: yards
yearning: yearning
yell: yelling
yesterday: yesterday
yield: yield
yonder: yonder
york: york
youngster: youngsters
youth: youth,youths
youthful: youthful
