abandon: abandoned
abide: abide,abiding
abomination: abomination
absence: absence
absolutely: absolutely
accept: accept,accepted,accepting
access: access,accessed
accessible: accessible
accessory: accessories
accomplice: accomplices
accomplish: accomplishing
account: account
accumulation: accumulation
accusation: accusations
accuse: accused
accuser: accusers
acquiesce: acquiesced
acquiescence: acquiescence
acquit: acquitted
action: action,actions
active: active
actual: actual
adams: adams
add: add,adds
addition: addition,additions
additional: additional
address: address,addressed,addresses
adroit: adroit
advance: advances
advancement: advancement
advantage: advantages
advice: advice
advise: advised
affair: affair,affairs
afraid: afraid
afro: afro
afterward: afterward
age: age
aged: aged
agency: agencies
agent: agent,agents
aggressor: aggressor
agree: agree,agreed
agreement: agreement
aid: aided
ak: ak
alabama: alabama
alarm: alarm,alarmed,alarming
alarmed: alarmed
alas: alas
alive: alive
alteration: alteration
alternate: alternate
altogether: altogether
american: american,americans
ancestor: ancestor
antebellum: antebellum
apathetic: apathetic
apologist: apologist
apology: apologies
appalling: appalling
apparent: apparent
appeal: appeal,appeals
appearance: appearance
applicable: applicable
apply: apply
appointment: appointment
appreciation: appreciation
approach: approach,approaching
archive: archive
arkansas: arkansas
arm: arm,armed,arms
armed: armed
army: army
arouse: arouse,aroused,arousing
array: array
arrest: arrested
ascii: ascii
aspect: aspect
assailant: assailant
assault: assault,assaulted,assaulting
assert: asserted,asserts
assertion: assertion
assistance: assistance
association: association
assume: assumed
athens: athens
atrocious: atrocious
attach: attached
attack: attack,attacked
attempt: attempt,attempted,attempting
attend: attended
attention: attention
attract: attract
attraction: attraction
author: author
authority: authorities,authority
avail: availed
avenging: avenging
await: awaited
awe: awe
awful: awful
baby: baby
backbone: backbone
bad: bad,worse,worst
bail: bail
bailey: bailey
ball: ball
ballot: ballot
baltimore: baltimore
barbarism: barbarism
barbarity: barbarity
bare: bare
barrett: barrett
base: based
baser: baser
bay: bay
bear: bear,born
bearing: bearing
beast: beasts
beat: beat
bed: bed
beg: beg,begs
belief: belief
belong: belonged
bestial: bestial
betray: betrayed
binary: binary
bind: bound
birth: birth
bishop: bishop
bite: biting
black: black,blacks
blacken: blackened
blackguard: blackguard
blind: blind
blood: blood
bloodless: bloodless
bloodthirsty: bloodthirsty
bloody: bloody
blue: blue
bodily: bodily
body: bodies,body
bondage: bondage
book: books
boorish: boorish
box: box
boy: boy,boys
boycott: boycott
branch: branch
brand: brand
brave: brave
breach: breach
break: broke,broken
breed: bred,breeding
bridge: bridge
bring: bring,bringing,brought
broad: broad
broken: broken
brooklyn: brooklyn
brother: brothers
brown: brown
brunette: brunette
brutal: brutal
brutalize: brutalized,brutalizing
brute: brute
buchanan: buchanan
building: building
bullet: bullets
bundle: bundles
burglar: burglars
burly: burly
burn: burn,burned,burning
burning: burning
business: business
butchery: butcheries
bystander: bystander
calculate: calculate,calculated
calumny: calumnies
calvin: calvin
campaign: campaign
camphor: camphor
candy: candy
cannon: cannon
capital: capital
capture: captured
car: car,cars
card: card
care: care
careful: careful
carolina: carolina
carry: carried,carry
caucasian: caucasian
cease: cease,ceased
cedar: cedar
center: centers
centre: centre
century: century
change: change
character: character
charge: charge,charged,charges
charitable: charitable
charity: charities
chattanooga: chattanooga
cheat: cheated
check: check,checks
chestnut: chestnuts
chicago: chicago
chief: chief
child: child,children
childhood: childhood
chloroform: chloroformed
choose: choose,chose
christian: christian
christianity: christianity
christianize: christianized
church: church
circumstance: circumstances
circumstantial: circumstantial
cite: cited
citizen: citizen,citizens
city: cities,city
civil: civil
civilization: civilization
civilized: civilized
claim: claim,claimed
clark: clark
clarksville: clarksville
class: class
clean: clean
clergy: clergy
clerk: clerk
cleveland: cleveland
climb: climb
close: closed
clothes: clothes
clothing: clothing
clutch: clutches
coach: coach
coachman: coachman
code: codes
cole: cole
collection: collection
color: color,colored
colored: colored
columbia: columbia
combination: combination
comment: comment
commercial: commercial
commission: commission
commit: committed
committee: committee
commotion: commotion
community: communities
company: company
compare: compare
comparison: comparison
compel: compelled
competent: competent
compilation: compilation
compile: compiled
compliance: compliance
comply: comply,complying
compress: compressed
compunction: compunction
concede: conceded,concedes
concept: concept
concerned: concerned
concession: concession
conclave: conclave
conclusion: conclusion
condemn: condemn,condemning
condemnation: condemnation
condemnatory: condemnatory
condition: condition,conditions
conduct: conduct
conference: conference
confess: confess,confessed
confession: confession
confirm: confirmed
confirmation: confirmation
conjecture: conjectures
conscience: conscience
consent: consent,consented
consequence: consequence
consequential: consequential
considerable: considerable
consideration: considerations
consort: consort
conspiracy: conspiracy
conspirator: conspirators
constant: constant
construe: construed
consume: consuming
consummation: consummation
contact: contact
content: content
continue: continue,continued
contract: contract,contracted
contrary: contrary
contribute: contribute
contribution: contribution,contributions
control: controlled
convention: convention
convert: convert
convict: convict,convicted
convincing: convincing
cook: cook
cool: cool
coon: coon
copying: copying
copyright: copyright
cordon: cordon
corner: corner
corporation: corporation,corporations
correct: correct
correspondent: correspondent
corrupt: corrupt
corruption: corruption
cost: cost,costs
cotton: cotton
counsel: counsel,counselled
counteract: counteract
country: countries,country
county: county
courage: courage
court: court,courts
courteous: courteous
cow: cow
coward: cowards
coy: coy
create: create,created,creating
creation: creation
credit: credit
creditor: creditors
creme: creme
crime: crime,crimes
criminal: criminal
criminally: criminally
crimini: criminis
cringe: cringes
crisis: crisis
critical: critical
crow: crow
crowd: crowd
cruel: cruel
cruelty: cruelty
crusade: crusade
curiosity: curiosities
current: current
curtain: curtains
cut: cut
cutthroat: cutthroats
daily: dailies,daily
dainty: dainty
damage: damage
damaged: damaged
damages: damages
damaging: damaging
dame: dames
danger: danger
dangerous: dangerous
dark: dark
dastardly: dastardly
datum: data
daughter: daughter,daughters
day: day,days
daylight: daylight
deal: dealt
dealer: dealer
death: death
decay: decay
december: december
decent: decent
decide: decide
declaration: declaration
declare: declared,declares,declaring
dedicate: dedicated
deductible: deductible
deed: deed
deep: deep
defect: defect,defects
defective: defective
defend: defend,defended,defending
defender: defenders
defense: defense
defenseless: defenseless
deference: deference
degeneracy: degeneracy
degree: degree
delay: delay
delegate: delegates
delegation: delegations
deletion: deletions
deliberate: deliberate
deliberately: deliberately
deliverance: deliverance
demand: demand,demanded,demanding,demands
demi: demi
denounce: denounced
denunciation: denunciation
deny: denied
depend: depends
depraved: depraved
depravity: depravity
deprive: deprived
deputy: deputies,deputy
derivative: derivative
derive: derive,derived
desert: deserted
deserve: deserved,deserves
designate: designated
desire: desire,desires
desirous: desirous
desperado: desperadoes
despoiler: despoiler
destroy: destroy,destroyed
destruction: destruction
detach: detach
detective: detective,detectives
deter: deterring
determination: determination
determine: determine
develop: developed
devilish: devilish
deviltry: deviltry
devise: devise
devote: devoting
devotion: devotion
die: died
difference: difference
difficulty: difficulty
dip: dipped
direct: direct
director: director
dirty: dirty
disappear: disappeared
disapprove: disapprove
disarm: disarmed
discard: discarded
discharge: discharged
disclaim: disclaim,disclaiming
disclaimer: disclaimer,disclaimers
discontinue: discontinue
discouraging: discouraging
discover: discover,discovered
discovery: discoveries
disease: disease
disfranchise: disfranchised
disgrace: disgrace,disgraced
disgraced: disgraced
disk: disk
dispatch: dispatches
display: display,displayed,displaying
disposition: disposition
disregard: disregard
distance: distance
distribute: distribute,distributed,distributing
distribution: distribution
distributor: distributor
disturb: disturb
dive: dive
divorce: divorce
divulge: divulge
doctor: doctor
doctored: doctored
dollar: dollar
domain: domain
donate: donate
donation: donation,donations
donor: donors
door: door,doors
dorr: dorr
doubt: doubt
doubtless: doubtless
download: downloading
drag: dragged
draw: drawing
dread: dread
drift: drifted
drive: drive
drug: drug
drunk: drunk
drunkard: drunkard
drunken: drunken
duke: duke
dusk: dusk
dust: dust
duty: duty
earnest: earnest
earth: earth
easily: easily
easy: easy
edition: edition,editions
editor: editor,editors
editorial: editorial
editorials: editorials
education: education
educational: educational
educator: educator
edward: edward
effective: effective
effectual: effectual
effectually: effectually
effort: effort,efforts
eighteen: eighteen
elect: elect
electronic: electronic
electronically: electronically
element: element
elicit: elicit
email: email
emancipation: emancipation
emigration: emigration
employ: employ,employed
employee: employee,employees
employer: employer
enable: enable,enabled
encode: encoding
encourage: encouraged
encouragement: encouragement
energetic: energetic
energy: energies
england: england
english: english
ensure: ensuring
enter: enter,entered
entire: entire
entity: entity
equal: equal
equally: equally
equipment: equipment
error: errors
escape: escape,escaped
eschew: eschewing
escort: escort
establish: established
esteem: esteem
eternity: eternity
evening: evening
evidence: evidence,evidenced
exact: exact
examination: examination
exceptional: exceptional
exchange: exchange
excitement: excitement
exclusion: exclusion
excursion: excursions
excuse: excuse,excused
execute: execute
executive: executive
exempt: exempt
exercise: exercise,exercising
exile: exile
exiled: exiled
exist: exist,existed,existing,exists
existence: existence
expend: expend
expense: expense,expenses
experience: experience
explain: explained
explainable: explainable
explanation: explanation
export: exporting
expose: exposed,exposing
exposition: exposition
exposure: exposure
express: express,expresses
extent: extent
extreme: extreme
eye: eyes
facility: facility
factor: factor
faintly: faintly
fair: fair
fairbanks: fairbanks
faithful: faithful
fall: fall,fallen,falls
falsehood: falsehood
family: families,family
fancy: fancy
farm: farm
farmer: farmer
fascination: fascination
fashionable: fashionable
fast: fast
father: father,fathers
favorable: favorable
fear: fear,feared,fearing,fears
fearful: fearful
feature: feature
february: february
federal: federal
fee: fee,fees
feeble: feeble
feel: feel
fellow: fellow,fellows
fever: fever
fidelity: fidelity
field: field
fiendish: fiendish
fiendishly: fiendishly
fight: fight
file: file,files
filthy: filthy
final: final
financial: financial
fit: fit
fitness: fitness
flay: flaying
flee: fled
fleming: fleming
flourish: flourishing
folk: folks
follow: follow
force: force,forced,forces
forego: foregoing
foregoing: foregoing
forehead: forehead
forget: forget
form: form
formal: formal
format: format,formats
formula: formula
foster: fosters
foundation: foundation
fowler: fowler
frank: frank
fred: fred
frederick: frederick
freedom: freedom
freely: freely
frenzied: frenzied
frequency: frequency
frequent: frequent
frequently: frequently
friction: friction
friend: friends
fruit: fruits
furniture: furniture
fury: fury
future: future
gain: gained
gambler: gambler
gang: gang
garbled: garbled
gaze: gaze
gazette: gazette
generation: generation,generations
georgia: georgia
girl: girl,girls
glad: glad
gladly: gladly
glee: glee
goal: goals
god: god,gods
godmother: godmother
gold: gold
govern: govern
government: government
governor: governor
grand: grand
grant: granted
gratefully: gratefully
gratification: gratification
grave: grave
greatly: greatly
gregory: gregory
grimly: grimly
grocery: grocery
gross: gross
ground: ground
grow: growing,grown,grows
guard: guard,guarded
guardian: guardians
guilt: guilt
guilty: guilty
gun: gun
hair: hair
hall: hall
halt: halt
hamburg: hamburg
hand: hand,hands
hands: hands
handsome: handsome
hang: hanged,hanging,hung
hanging: hanging
happen: happened
harden: hardened
harm: harm,harmed
harmless: harmless
hart: hart
hate: hate
head: head,heads
healthy: healthier,healthy
hear: hear,heard
hearing: hearing
heart: heart
heaven: heaven,heavens
heavy: heavy
heed: heeded
heinous: heinous
helpless: helpless
henry: henry
herald: herald,heralded
hide: hide
highway: highway
hill: hill
hinder: hindered
history: history
hold: held,hold
holder: holder
honest: honest
honestly: honestly
honor: honor
hope: hope,hoped,hoping
hopelessly: hopelessly
horrible: horrible
horrify: horrified
horror: horror,horrors
horrors: horrors
hospital: hospital
host: host
hot: hot
house: house
human: human
humiliation: humiliation
hundredth: hundredth
hunt: hunt,hunting
hurl: hurling
husband: husband
hush: hushed
hypothesis: hypothesis
ida: ida
idea: idea
identical: identical
identification: identification
identify: identify
idolize: idolized
ignorance: ignorance
illicit: illicit
illustrative: illustrative
imagination: imagination
imperil: imperilled
implicate: implicated
imply: implied
impose: imposed
impossible: impossible
impress: impress
impressed: impressed
impression: impression
imprison: imprisoned
improvement: improvement
impunity: impunity
inaccurate: inaccurate
incapable: incapable
incentive: incentive
incidental: incidental
include: include,included,includes,including
including: including
incomplete: incomplete
increase: increasing
indemnify: indemnify
indemnity: indemnity
independence: independence
independent: independent
indict: indict,indicted
indifferent: indifferent
indignation: indignation
indirect: indirect
indirectly: indirectly
indiscreet: indiscreet
individual: individual,individuals
indulge: indulged
industrial: industrial
inevitable: inevitable
infamous: infamous
infant: infant
inferior: inferiors
inflict: inflicted
infliction: infliction
influence: influence
infringement: infringement
inhabitant: inhabitants
inhuman: inhuman
injure: injured
injury: injuries
injustice: injustice
inmate: inmate
innocence: innocence
innocent: innocent
inquiry: inquiry
insatiate: insatiate
insolence: insolence
inspiration: inspiration
inspire: inspired
instance: instance,instances
instinct: instinct
institution: institution
insult: insulted
intellectual: intellectual
intelligence: intelligence
intelligent: intelligent
intention: intention
inter: inter
intercept: intercepted
internal: internal
international: international
interpret: interpreted
intersection: intersection
intervention: intervention
intimacy: intimacy
intimate: intimate
intimation: intimations
introduce: introduced
invalidity: invalidity
invariably: invariably
investigation: investigation
invitation: invitation
invite: invite,invited
iron: iron
irs: irs
issue: issue,issued
jackson: jackson
jacksonville: jacksonville
jail: jail,jailed,jails
january: january
jarvis: jarvis
jeanette: jeanette
jim: jim
john: john
johnson: johnson
jones: jones
journal: journal,journals
judge: judge,judges
judgment: judgment
judicious: judicious
july: july
june: june
jurisdiction: jurisdiction
jury: juries,jury
justice: justice
justify: justify
kansas: kansas
kentucky: kentucky
keynote: keynote
kill: kill,killing
killing: killing
kitchen: kitchen
knife: knives
knowledge: knowledge
labor: labor
lack: lack,lacking
lady: ladies,lady
lake: lake
land: land
language: language
lap: lap
law: law,laws
lawbreaker: lawbreakers
lawless: lawless
lawlessness: lawlessness
lawyer: lawyer
lead: lead,leading,led
leader: leader,leaders
leading: leading
learn: learn,learned,learning
leave: leave,leaving,left
ledger: ledger
legal: legal
legalized: legalized
legally: legally
legislature: legislature
legitimate: legitimate
lesson: lesson
letter: letter,letters
level: level
lewis: lewis
liability: liability
liable: liable
liaison: liaison
libelous: libelous
liberally: liberally
liberty: liberty
library: library
license: license
licensed: licensed
lie: lie
lieu: lieu
life: life,lives
lifeless: lifeless
light: light
limit: limit,limited,limits
limitation: limitation
limited: limited
liners: liners
link: linked,links
literary: literary
live: live,lived,lives,living
loathing: loathing
loathsome: loathsome
lobby: lobby
locality: localities
locate: located
location: locations
lock: locked
loose: loose
lose: losing,lost
loss: loss
lot: lot
louisiana: louisiana
love: love,loved
lust: lust,lusts
lustful: lustful
lynch: lynch,lynched,lynching
lyncher: lynchers
lynching: lynching,lynchings
lynchings: lynchings
lyric: lyric
machine: machine
madison: madison
maggie: maggie
main: main
maintain: maintained,maintaining
majesty: majesty
majority: majority
malicious: malicious
manager: manager
manhood: manhood
mania: mania
manner: manner
manners: manners
march: march
mark: marked
markedly: markedly
married: married
marry: marry
marshall: marshall
mask: mask,masks
mass: mass
massacre: massacres
master: master,masters
match: match
material: material
materialize: materialize
matter: matter
maximum: maximum
measure: measure,measured
medium: medium
meet: meet,met
meeting: meeting
melissa: melissa
melt: melted
memphis: memphis
merciful: merciful
mercy: mercies,mercy
method: method,methods
michael: michael
midday: midday
middle: middle
mighty: mighty
mile: mile,miles
military: military
militia: militia
minimum: minimum
minister: minister,ministers
minneapolis: minneapolis
minor: minor
minute: minutes
miscegenation: miscegenation
misrepresent: misrepresenting
mission: mission
mississippi: mississippi
mistake: mistake
mob: mob,mobs
mockery: mockery
modification: modification
modify: modified
moment: moment
monde: monde
money: money
monroe: monroe
montgomery: montgomery
month: month,months
moral: moral
morgan: morgan
morning: morning
mortification: mortification
moses: moses
mother: mother
motive: motive,motives
mouth: mouths
mulatto: mulatto
mule: mule
murder: murder,murdered,murdering
murderer: murderers
muster: mustered
mutual: mutual
naked: naked
nashville: nashville
natchez: natchez
natural: natural
naturally: naturally
nauseating: nauseating
necessity: necessity
needless: needless
negligence: negligence
negro: negro,negroes
negroes: negroes
neighbor: neighbors
neighborhood: neighborhood
network: network
news: news
newsletter: newsletter
newspaper: newspapers
night: night
nineteenth: nineteenth
noble: noble
nonproprietary: nonproprietary
north: north
northern: northern
note: note
notice: notice
notify: notifies
notion: notion
notorious: notorious
numerous: numerous
obedience: obedience
obey: obeys
objection: objection
oblige: obliged
obscene: obscene
obsolete: obsolete
obstinately: obstinately
occur: occur,occurred
ocean: ocean
october: october
offend: offending
offense: offense
offensive: offensive
offer: offered,offers
office: office
officer: officers
official: official,officials
oft: oft
ohio: ohio
oil: oil
oklahoma: oklahoma
omaha: omaha
online: online
openly: openly
operate: operate
operation: operation
opportunity: opportunities,opportunity
opposition: opposition
organ: organ
organize: organized
organized: organized
original: original
originator: originator
orleans: orleans
outcropping: outcropping
outcry: outcry
outdated: outdated
outermost: outermost
outfit: outfit
outrage: outrage,outraged,outrages,outraging
outraged: outraged
outrageous: outrageous
outraging: outraging
overcome: overcome
overpower: overpowered
overreach: overreach
owe: owe,owed,owes
owner: owner,owners
packer: packer
pain: pains
painstaking: painstaking
pair: pair
pale: pale
palliate: palliate
pamphlet: pamphlet
papa: papa
paper: paper,papers
paperwork: paperwork
parade: paraded
paragraph: paragraph,paragraphs
parish: parish
participation: participation
partisan: partisan
partition: partitions
partner: partner
party: parties,party
pass: pass,passed
passion: passion,passions
pat: pat
patience: patience
patronage: patronage
patronize: patronize
pay: paid,pay,paying
payment: payments
peace: peace
peaceful: peaceful
pen: penned
penalty: penalty
penitentiary: penitentiary
pennsylvania: pennsylvania
people: people
perform: perform,performed,performing
performance: performances
periodic: periodic
perish: perished
permanent: permanent
permission: permission
permit: permitted
perpetrate: perpetrated
perpetration: perpetration
perpetrator: perpetrators
persist: persist
persistent: persistent
persistently: persistently
person: people,person,persons
personal: personal
personally: personally
perusal: perusal
perversion: perversion
petition: petition,petitions
phase: phase,phases
phases: phases
phenomenal: phenomenal
phrase: phrase
physical: physical
physician: physician
picture: pictured
piece: pieces
pile: piles
pistol: pistol
pitiful: pitiful
plain: plain,plains
plan: planned,plans
platform: platform
plausible: plausible
play: playing
plea: plea
plead: plead,pleading
pleasant: pleasant
pleasure: pleasure
plenty: plenty
plow: plow,plowing
plunge: plunged
pocket: pocket
poison: poisoned
poker: poker
police: police
polite: polite
politeness: politeness
political: political
politics: politics
ponder: ponder
poor: poor
poplar: poplar
populate: populated
population: population
port: port
position: position
posse: posse
possess: possessed
possession: possession
possibility: possibility
post: post,posted
pour: poured
power: power
powerless: powerless
practical: practical
practically: practically
practice: practiced,practicing
preface: preface
preference: preference
prejudice: prejudice,prejudices
preliminary: preliminary
prepare: prepare,prepared
presence: presence
preserve: preserve
president: president
press: press
pretend: pretend
pretext: pretext
pretty: pretty
prevail: prevails
prevalence: prevalence
prevent: prevent,prevented
previous: previous
prey: preys
principal: principal
principally: principally
principle: principles
print: print,printed
prisoner: prisoner
processing: processing
proclaim: proclaim,proclaimed
proclamation: proclamation
produce: produce,produced
production: production
professor: professor
profit: profit,profits
programme: programme
progress: progress
prohibition: prohibition
project: project
prominent: prominent
prominently: prominently
promise: promises
promote: promoting
promotion: promotion
prompt: prompt,prompted
prompting: promptings
proof: proof
proofread: proofread
proofreading: proofreading
propensity: propensities
proper: proper
properly: properly
property: property
proposal: proposal
propose: proposed
proprietary: proprietary
proprietor: proprietors
protect: protect
protection: protection
protector: protector
protest: protesting
prove: prove,proved,proven,proves,proving
provide: provide,providing
provision: provision,provisions
provocation: provocation
public: public
publication: publication
publicly: publicly
publish: published,publishes
pulpit: pulpit,pulpits
punish: punish,punished,punishing
punishment: punishment
punitive: punitive
purpose: purpose,purposes
purse: purse
question: question
quick: quick
quote: quoting
race: race,races
racket: racket
radius: radius
rage: raged
raid: raids
railroad: railroad,railroads
rain: raining
raise: raise,raised
rally: rally
rank: rank
rape: rape,raped,rapes,raping
rapidly: rapidly
rapist: rapist,rapists
reach: reach,reached,reaching
reaction: reaction
read: read,reading
readable: readable
reader: reader
reading: reading
real: real
realize: realize,realized
reason: reason,reasons
reasonable: reasonable
receipt: receipt
receive: receive,received,receiving
reconstruction: reconstruction
record: record
red: red
redistribute: redistribute,redistributing
redistributing: redistributing
redistribution: redistribution
redress: redress
reduce: reduced
reese: reese
reference: references
reflect: reflecting
reflection: reflection
refuge: refuge
refund: refund
refusal: refusal
refuse: refuse,refused,refuses
regard: regard
register: registered
regular: regular
regulate: regulating
rehabilitation: rehabilitation
reign: reign
reiterate: reiterated
relation: relation,relations
release: release,released
relic: relic
religion: religion
remain: remain,remained,remaining,remains
remark: remarked
remarkable: remarkable
remedy: remedies,remedy
remember: remembered
remorse: remorse
remove: remove,removed
rename: renamed
render: render
repeal: repeal,repealed
repeat: repeated
replace: replace
replacement: replacement
report: report,reported,reports
representation: representations
reprint: reprinted
reproduce: reproduce
republic: republic
republican: republican
repulse: repulsed
repulsive: repulsive
reputation: reputation
reputed: reputed
request: request,requests
require: require,required
requirement: requirements
resent: resent,resented,resenting
resentment: resentment
residence: residence
resist: resist,resisted
resolution: resolutions
respect: respect
respectability: respectability
response: response
responsible: responsible
rest: rest
restrain: restraining
restraint: restraint
restriction: restrictions
result: result
retain: retained
return: return,returned,returns
reveal: reveal
revenue: revenue
revive: revived
revolting: revolting
revolution: revolution
richard: richard
ride: ride
rifle: rifle
rifles: rifles
rights: rights
riot: riot
rise: rise
risk: risk
road: roads
rob: robbed
robber: robbers
robbery: robberies,robbery
rock: rock
roll: roll,rolling
rough: rough
roving: roving
royalty: royalties,royalty
ruffian: ruffian,ruffians
ruin: ruined
rule: rule,rules
rumor: rumor,rumored
rush: rush
russell: russell
sacrifice: sacrifice
saddle: saddled
safely: safely
sagacity: sagacity
sake: sake
salt: salt
sanction: sanction
sarah: sarah
sassy: sassy
satisfy: satisfied
saturday: saturday
savage: savage
save: save
scatter: scattered
scene: scene
science: science
scimitar: scimitar
scoundrel: scoundrel,scoundrels
scrap: scrap
scream: scream,screamed
screen: screen
search: search
secret: secret
secretly: secretly
secure: secure,secured
seduce: seduce
seek: seeking,sought
seldom: seldom
select: selected
sell: sold
send: send,sending
sensation: sensation
sensibility: sensibility
sentence: sentence
sentiment: sentiment
separate: separate
servant: servant
serve: serve,served
service: service
servile: servile
set: set,sets
settle: settled
seventeen: seventeen
severe: severe
shadow: shadow
shame: shame
share: share,shared,sharing
shears: shears
sheriff: sheriff,sheriffs
shield: shield,shielding
shockingly: shockingly
shoot: shoot,shooting,shot
short: short
shot: shot
shower: showered
sign: signed
silence: silenced,silencing
silent: silent
silver: silver
similarity: similarity
simply: simply
sin: sinned,sinning
singles: singles
singularly: singularly
sister: sisters
sit: sat
situation: situation
slander: slandering
slave: slave,slaves
slavery: slavery
slight: slight
slogan: slogan
smile: smiles
smith: smith
smoke: smoking
social: social
society: society
solicit: solicit
solicitation: solicitation
solid: solid
solve: solve,solved
sort: sort
soul: soul
sound: sounded
source: source
south: south
southern: southern
spare: spare
speak: speak,spoken
special: special
specific: specific
specimen: specimens
spectacle: spectacle
speech: speech,speeches
speedy: speedy
spelling: spelling
spend: spending
spirit: spirit
spite: spite
spread: spread,spreading
spring: spring
staff: staff
stagnation: stagnation
stain: stain,stained
stake: stake
stalk: stalks
stamp: stamp,stamped,stamps
stanchion: stanchions
stand: stand,standing
standing: standing
start: start
statement: statement,statements
statistics: statistics
status: status
statute: statute
stay: stay,staying
steal: stole
step: step
stifle: stifled,stifling
stimulate: stimulate
stir: stirring
store: store,stored
story: stories,story
strange: strange
stranger: strangers
strangulation: strangulation
street: street,streets
strength: strength
strict: strict
strife: strife
strong: strong
stump: stumping
subdue: subdue
subject: subject
subjection: subjection
subjugation: subjugation
submission: submission
subordination: subordination
subscribe: subscribe
subsequently: subsequently
substantiate: substantiate,substantiated
substitute: substituting
suburb: suburb
subvert: subvert
succession: succession
succumb: succumbs
sudden: sudden
suffer: suffer
sufficient: sufficient
suggestion: suggestion
suit: suit,suits
suitor: suitor
sun: sun
superintendent: superintendent
superior: superior
support: support,supported
supposition: supposition
suppress: suppressed
surgical: surgical
survive: survive
suspect: suspect
suspend: suspended
suspension: suspension
sustain: sustains
suzanne: suzanne
swamp: swamp
swear: swore,sworn
sweetheart: sweethearting
swift: swift
swing: swung
sympathy: sympathy
synonymous: synonymous
tacit: tacit
tailor: tailor
tax: tax,taxes
taxpayer: taxpayers
teach: teach,teaches
teacher: teachers
team: team
tear: torn
telegram: telegrams
tenant: tenants
tender: tender
tennessee: tennessee
term: terms
territory: territories,territory
terror: terror
testify: testify
testimony: testimony
therefor: therefor
thickly: thickly
thinly: thinly
thirstiness: thirstiness
thirteen: thirteen
thoughtful: thoughtful
thrash: thrashed
thread: thread
threat: threats
threaten: threatened,threatening
threatened: threatened
thrifty: thrifty
throw: thrown
tie: tie
tillman: tillman
time: time,times
title: title
tolerate: tolerate,tolerated
tough: tough,toughs
town: town,towns
trace: traced
trademark: trademark
traditional: traditional
transcribe: transcribe
transcriber: transcriber
transcription: transcription
travel: travel
treasurer: treasurer
treatment: treatment
tree: tree
tremendous: tremendous
trial: trial
tribune: tribune
trouble: trouble
true: true
trust: trust
truth: truth
type: types
ugly: ugliest
unabated: unabated
uncontradicted: uncontradicted
understand: understand
underwood: underwood
undisturbed: undisturbed
unenforceability: unenforceability
unfortunate: unfortunate
unheard: unheard
uniform: uniform
union: union
united: united
unknown: unknown
unlink: unlink
unmistakably: unmistakably
unprecedented: unprecedented
unprotected: unprotected
unquestioned: unquestioned
unreliable: unreliable
unselfish: unselfish
unsolicited: unsolicited
untruthful: untruthful
unvarnished: unvarnished
unwritten: unwritten
update: updated
uplift: uplifted
urge: urge,urged
user: user
ut: ut
utter: utter,utters
utterance: utterance,utterances
vacation: vacation
vanilla: vanilla
variety: variety
vehemently: vehemently
vengeance: vengeance
verification: verification
verify: verify
version: version
vicinity: vicinity
victim: victim,victims
view: viewed,viewing
vile: vilest
vindicate: vindicate
violate: violates
violation: violation
violence: violence
violent: violent
virtue: virtue
virus: virus
visit: visit,visited
vital: vital
voice: voice
void: void
volume: volume
volunteer: volunteer,volunteers
wait: waited,waiting
walk: walking,walks
wander: wandered
war: war
warning: warning
warped: warped
warrant: warrant
warranty: warranties,warranty
watch: watched,watching
weak: weak
weakness: weakness
wealth: wealth
wealthy: wealthiest
wednesday: wednesday
week: week,weeks
weekly: weeklies
weigh: weighed
west: west
western: western
whatsoever: whatsoever
white: white
whites: whites
wholesale: wholesale
wholesome: wholesome
wide: wide,widest
widow: widow
wife: wife,wives
wild: wild
william: william
winchester: winchester
wing: wings
winter: winter
withdraw: withdrawn
withhold: withhold
woman: woman,women
wonderful: wonderful
wood: woods
word: word
wording: wording
worthy: worthy
wound: wounded,wounding
wounded: wounded
wrath: wrath
wreak: wreak
wretch: wretch
write: writing,written
writer: writer
writing: writing
wrong: wrongs
yard: yard
yield: yield,yielding,yields
york: york
zeal: zeal
