ab: ab
abandon: abandon,abandoned,abandons
abate: abate
abel: abel
abet: abet
abettor: abettors
abhor: abhor
abide: abide
ability: ability
abler: abler
abolish: abolish
abraham: abraham
abridge: abridge
absence: absence
absolute: absolute
absolutely: absolutely
absolve: absolve,absolved
absurdity: absurdities,absurdity
abundance: abundance
abuse: abuses
ac: ac
accept: accept,accepted,accepting
access: access,accessed
accessible: accessible
accident: accidents
accidental: accidental
accompany: accompany
account: account,accounted
accountable: accountable
accustom: accustomed
accustomed: accustomed
acknowledge: acknowledge,acknowledged
acorn: acorns
acquaint: acquainted
acquaintance: acquaintance
acquiesce: acquiesce,acquiesced,acquiescing
acquire: acquire,acquired
acre: acre,acres
acting: acting
action: action,actions
active: active
actual: actual
adam: adam
add: add,adds
addition: addition,additions
additional: additional
address: address,addresses
adjourn: adjourned
adjournment: adjournment
administer: administer
administration: administration
admirable: admirable
admire: admire
admit: admits,admitted
ado: ado
advance: advance,advances
advantage: advantage,advantages
adventitious: adventitious
adventure: adventured
adversary: adversaries,adversary
adversus: adversus
advertise: advertise
advice: advice
advise: advise
advocate: advocate
affair: affairs
affection: affection
affirm: affirm,affirmed
afford: afford,afforded,affords
affront: affront
age: age,ages
aged: aged
agent: agent
aggravate: aggravate
aggravation: aggravation
aggressor: aggressor
aggrieved: aggrieved
agit: agit
agree: agree,agreed,agreeing,agrees
agreeable: agreeable
agreement: agreement,agreements
aid: aided
alexandria: alexandria
algiers: algiers
alias: alias
alien: alien,aliens
alienable: alienable
alienation: alienation
alight: alight
alike: alike
aliquot: aliquot
alive: alive
allegiance: allegiance
alliance: alliance,alliances
allowance: allowance
almighty: almighty
alter: alter,altered,alters
alteration: alteration,alterations
alterius: alterius
alternate: alternate
alterum: alterum
altogether: altogether
amazed: amazed
ambiguity: ambiguity
ambition: ambition
ambitious: ambitious
amend: amend,amended
amendment: amendment
america: america
american: american,americans
amiss: amiss
ammonites: ammonites
amor: amor
amuse: amuse
anarchy: anarchy
ancestor: ancestors
ancient: ancient
anew: anew
animal: animals
animate: animated
animo: animo
ann: ann
annals: annals
annex: annex,annexed
anniversary: anniversary
anoint: anoint,anointed
answer: answer,answered,answers
answerable: answerable
answering: answering
ante: ante
antecedent: antecedent
apparent: apparent
appeal: appeal,appealing,appeals
appearance: appearance
appetite: appetite,appetites
apple: apples
applicable: applicable
application: application
apply: applied,apply
appoint: appoint,appointed,appointing,appoints
appointed: appointed
appointing: appointing
appointment: appointment
apprehend: apprehend
apprehension: apprehensions
apprentice: apprentice
approach: approach
approbation: approbation
appropriation: appropriation
approve: approve,approved
april: april
apt: apt
arbitrarily: arbitrarily
arbitrary: arbitrary
arbitration: arbitration
arbitrator: arbitrator
archive: archive
archphilosopher: archphilosopher
argue: argue
argument: argument,arguments
aright: aright
arm: armed,arms
army: armies,army
arrant: arrant
array: array
arrest: arrest
arrive: arrived
art: art,arts
article: article
artifice: artifice,artifices
ascii: ascii
ash: ashes
asia: asia
assailant: assailant
assault: assault
assemble: assemble,assembled,assembling
assembling: assembling
assembly: assemblies,assembly
assertor: assertor
assign: assigning,assigns
assignation: assignation
assist: assist,assisted
assistance: assistance
association: associations
assume: assume
assurance: assurance
assyria: assyria
assyrians: assyrians
athens: athens
attach: attached
attack: attack
attain: attain,attained,attaining
attempt: attempt,attempted,attempting,attempts
attend: attend,attending,attends
attendance: attendance
attentively: attentively
aught: aught
author: author
authority: authority
authorize: authorize,authorized,authorizes
averse: averse
aversion: aversion
avocation: avocations
avoid: avoid,avoided
avoidable: avoidable
bad: worse
baker: baker
balance: balance,balancing
baldwin: baldwin
bar: bar
bare: bare
barefaced: barefaced
barely: barely
bargain: bargain,bargains
bark: bark
barley: barley
barter: barter,bartered
base: based
baseness: baseness
basis: basis
bastard: bastard
bate: bating
battle: battle,battles
bear: bear,bearing,bears,bore,born,borne
beast: beast,beasts
beget: begets,begetting,begotten
beginner: beginners
begot: begot
behaviour: behaviour
beholden: beholden
belong: belong,belonged,belonging,belongs
beneath: beneath
benefactor: benefactor
beneficial: beneficial
benefit: benefit,benefits
bestow: bestow,bestowed
betray: betray,betrayed
betwixt: betwixt
beware: beware
bid: bid,bids
binary: binary
bind: bind,binding,binds,bound
bird: birds
birth: birth,births
bishop: bishop
bit: bit
blame: blamed
blind: blind
blinded: blinded
blindly: blindly
blood: blood
bloodshed: bloodshed
blow: blow,blows
boast: boasts
body: bodies,body
bog: bogs
boil: boiled
boldly: boldly
bona: bona
bond: bond,bonds
book: book,books
bound: bound,bounded,bounds
boundless: boundless
bounty: bounty
boy: boy
bran: bran
branch: branches
brave: bravest
brazil: brazil
breach: breach,breaches
bread: bread
break: break,breaking,breaks,broke,broken
breaking: breaking
breast: breast,breasts
breed: bred,breed
brethren: brethren
brick: bricks
bring: bring,bringing,brings,brought
brink: brink
britons: britons
broach: broaching
broil: broils
brood: brood
brother: brother,brothers
brutal: brutal
brute: brute,brutes
brutish: brutish
brutishness: brutishness
buchanan: buchanan
bucket: bucket
build: build,building,builds,built
burden: burden
burdensome: burdensome
burn: burning
bushel: bushels
business: business
busy: busy
cain: cain
calamity: calamity
calculate: calculate,calculated
calm: calm
cambridge: cambridge
cancel: cancel,cancelled,cancels
candidate: candidates
cannon: cannon
canon: canons
capable: capable
capacity: capacity
capital: capital
captain: captain,captains
captive: captive,captives
caput: caput
carcass: carcass
card: card
care: care
careful: careful
carefully: carefully
carriage: carriage
carry: carried,carries,carry,carrying
carve: carve,carved
cast: cast,casting
casus: casus
cat: cats
catalogue: catalogue
catch: catches,caught
cattle: cattle
caution: caution
cavilling: cavilling
cease: cease,ceased,ceases
censure: censure,censured
ceylon: ceylon
chain: chains
champion: champion
chance: chance,chanced
change: change,changed,changing
chap: chap
chapter: chapter
character: character
charge: charge,charged,charges
charitable: charitable
charity: charities,charity
chase: chase
chasten: chastened,chastens
chastise: chastising
check: check,checks
chief: chief
chiefly: chiefly
child: child,children
childhood: childhood
choice: choice
choose: choose,chosen
christ: christ
christendom: christendom
christian: christian,christians
chuck: chuck
church: church
chuse: chuse
circumstance: circumstances
city: cities,city
civil: civil
civilized: civilized
clad: clad
claim: claim,claimed
clarke: clarke
clearness: clearness
cleave: cleave
close: closer
closely: closely
cloth: cloth
clothes: clothes
coal: coals
coat: coat
cock: cock
code: codes
coherent: coherent
coherently: coherently
cold: cold
collate: collated
collection: collection,collections
collective: collective
college: college
collins: collins
collusion: collusion
colour: colour,coloured
combat: combat
combination: combination
combine: combine,combined
comfort: comfort,comforts
comfortable: comfortable
command: command,commanded,commanding,commands
commander: commander
commandment: commandment
commentary: commentaries
commerce: commerce
commercial: commercial
commission: commission,commissioned
commit: commits,committed
commodity: commodities,commodity
common: common,commons
commoner: commoner,commoners
commonly: commonly
commonness: commonness
commonwealth: commonwealth,commonwealths
communicate: communicated
communion: communion
community: communities,community
compact: compact,compacts
companion: companions
company: company
compare: compare
comparison: comparison
compass: compass
compel: compel,compels
compensate: compensate
competent: competent
competition: competition
compilation: compilation
complain: complain
complaint: complaint
complete: complete
compliance: compliance
complication: complication
comply: comply,complying
comport: comported
composition: composition
compounded: compounded
comprehend: comprehended,comprehending
compress: compressed
computation: computation
compute: computed
conceit: conceit
conceive: conceive,conceived,conceiving
concept: concept
concern: concern,concerned,concerns
concerned: concerned
concernment: concernment
conclude: conclude,concluded
concupiscence: concupiscence
concur: concurred
concurrence: concurrence
concurrent: concurrent
condemn: condemn
condemnation: condemnation
condition: condition,conditions
conduce: conduce
conduct: conduct
confer: confer
confess: confess
confidence: confidence
confine: confine,confined,confining
confinement: confinement
confirm: confirm,confirmed
confirmation: confirmation
conformable: conformable
confound: confounded,confounding
confused: confused
confusion: confusion
confutation: confutation
confute: confuted
conjecture: conjectures
conjugal: conjugal
conjunction: conjunction
connexion: connexion
conquer: conquer,conquered,conquering,conquers
conqueror: conqueror,conquerors
conquest: conquest
conscience: conscience,consciences
conscientiously: conscientiously
consent: consent,consented,consenting,consents
consequence: consequence,consequences
consequential: consequential
considerable: considerable
consideration: consideration
consist: consist,consisted,consisting,consists
consistency: consistency
consistent: consistent
constable: constable
constant: constant
constantly: constantly
constitute: constitute,constituted,constitutes,constituting
constitution: constitution,constitutions
constrain: constrain,constrained
constraint: constraint
consult: consult
consultation: consultation
consume: consume,consumed
consumption: consumption
contact: contact
contend: contend
contender: contenders
content: content
contented: contented
contention: contentions
contentious: contentious
contents: contents
contest: contest,contested
continual: continual
continuance: continuance
continuation: continuation,continuations
continue: continue,continued,continues,continuing
contra: contra
contract: contract,contracts
contradiction: contradiction,contradictions
contrariety: contrariety
contrary: contrary
contribute: contribute
contribution: contributions
contrivance: contrivance,contrivances
controversy: controversies,controversy
convene: convening
convenience: convenience
conveniency: conveniencies,conveniency
convenient: convenient
conveniently: conveniently
convening: convening
convention: conventions
convert: convert
convey: convey,conveyed,conveying
conveyance: conveyance
conviction: conviction
convince: convinced
convinced: convinced
convoke: convoke,convoking
copulation: copulation
copying: copying
copyright: copyright
corn: corn
corner: corners
coronation: coronation
corporation: corporation,corporations
corpus: corpus
correct: corrected,corrects
correction: correction
corrections: corrections
corrupt: corrupt,corrupted
corruption: corruption
cost: cost,costs
cottage: cottage
council: council,councils
counsellor: counsellors
count: counted
countenance: countenances
country: countries,country
county: county
courage: courage
court: court
courtier: courtier
covenant: covenants
covetousness: covetousness
cow: cows
crave: crave
create: created,creating
creation: creation
creator: creator
creature: creature,creatures
credit: credit
crime: crime,crimes
criminal: criminal
crippled: crippled
critical: critical
criticism: criticism
cross: cross
crowder: crowder
crown: crown,crowned
cruelly: cruelly
cruelty: cruelty
cudgeling: cudgeling
cultivate: cultivated,cultivates,cultivating
cum: cum
cunninger: cunninger
cure: cure,cured
current: current
custom: custom,customs
cut: cut,cuts,cutting
czar: czar
dagger: dagger
daily: daily
dam: dam
damage: damage
damaged: damaged
damages: damages
damnified: damnified
danes: danes
danger: danger,dangers
dangerous: dangerous
dangerously: dangerously
datum: data
dave: dave
david: david
davis: davis
day: day,days
dead: dead
deal: deal
dealing: dealing
death: death
debar: debarred
debate: debate
debating: debating
decay: decay,decaying
deceased: deceased
deceive: deceived
december: december
decemviri: decemviri
decide: decide,decided,decides
decision: decision,decisions
decisive: decisive
declaration: declaration
declare: declared,declares,declaring
declination: declinations
decline: decline
decree: decrees
deductible: deductible
deed: deeds
deep: deeper
deer: deer
defect: defect,defects
defective: defective
defence: defence
defend: defend,defending,defends
defender: defenders
deference: deference
define: defined
degenerate: degenerate,degenerates
degrade: degraded,degrades
degree: degree,degrees
dei: dei
delay: delay,delays
delegate: delegated
delegation: delegation
deletion: deletions
deliberate: deliberate
deliberation: deliberation
delight: delight,delights
delinquent: delinquents
deliver: deliver,delivered
delivery: delivery
deluge: deluge
demand: demand,demanded,demands
democracy: democracy
demolish: demolishing
demonstration: demonstration
demonstratively: demonstratively
den: den
deny: denied,denies,deny
depend: depend,depending,depends
dependence: dependence
dependency: dependency
dependent: dependent,dependents
depose: deposed
depraved: depraved
deprive: deprive,deprived
depute: deputed,deputes
deputy: deputies,deputy
derivative: derivative
derive: derive,derived,derives,deriving
descend: descended,descending
descendant: descendants
desert: desert,deserting
deserter: deserter
deserve: deserve,deserves
design: design,designed,designing,designs
designation: designation
designedly: designedly
desire: desire,desired,desires
desolate: desolate
desolation: desolation
desperate: desperate
despotical: despotical
destroy: destroy,destroyed,destroying,destroys
destruction: destruction
destructive: destructive
detach: detach
detect: detected
deter: deter
determinable: determinable
determination: determination
determine: determine,determined,determines
dethrone: dethroned
devise: devised
devolve: devolve,devolved,devolves,devolving
devonshire: devonshire
devour: devoured
diamond: diamond,diamonds
dictate: dictate,dictates
die: die,died,dies,dying
difference: difference,differences
difficult: difficult
difficulty: difficulties,difficulty
dig: digged
digest: digested
digitize: digitized
dignity: dignity
dilly: dilly
direct: direct,directed
direction: direction,directions
disadvantage: disadvantage
disarm: disarmed
discard: discard
discern: discern
discharge: discharge,discharged
discipline: discipline
disclaim: disclaim
disclaimer: disclaimer,disclaimers
discontented: discontented
discontinue: discontinue
discourse: discourse,discourses
discover: discover,discovered
discretion: discretion
dishonest: dishonest
disk: disk
dislike: dislike
dismember: dismembered
dismiss: dismissing
disobedience: disobedience
disobey: disobey
disorder: disorder,disorders
disown: disowning,disowns
dispatch: dispatch
dispense: dispense,dispensed
displace: displaced
display: display,displayed,displaying
disposal: disposal
dispose: dispose,disposed,disposing
disposed: disposed
disposer: disposers
dispossess: dispossess
disposure: disposure
disproportion: disproportion
disproportionate: disproportionate
dispute: dispute
disseize: disseized
dissipate: dissipated
dissolution: dissolution
dissolve: dissolve,dissolved,dissolves,dissolving
dissolving: dissolving
distant: distant
distinct: distinct
distinction: distinction
distinctly: distinctly
distinguish: distinguish,distinguished,distinguishing
distinguishable: distinguishable
distressed: distressed
distribute: distribute,distributed,distributing
distribution: distribution
distributor: distributor
disturb: disturb,disturbed
diver: divers
divest: divests
divide: divided
divine: divine
divinity: divinity
doctrine: doctrine
domain: domain
domestic: domestic
domination: domination
domineer: domineer
domineering: domineering
dominion: dominion,dominions
dominium: dominium
dominus: dominus
donate: donate
donation: donation,donations
donor: donors
door: door,doors
doth: doth
double: double
doubt: doubt,doubted,doubts
download: downloading
draught: draught
draw: draw,drawing,drawn,draws,drew
dream: dreamed
dress: dressed
drink: drink
drinking: drinking
drive: drive,driven
drop: drop
drudge: drudge
drudgery: drudgery
drug: drugs
drum: drum
duly: duly
duo: duo,duos
durable: durable
duration: duration
dust: dust
duty: duties,duty
dwell: dwell,dwells
ea: ea
earth: earth
earthly: earthly
earthquake: earthquake
ease: ease
easily: easily
easiness: easiness
easy: easier,easy
eat: eat,eating
eccl: eccl
ecclesiastic: ecclesiastic
ecclesiastical: ecclesiastical
edict: edict
edit: edited
edition: edition,editions
editions: editions
editor: editor
educate: educate
education: education
educational: educational
effective: effective
effectual: effectual
effectually: effectually
effort: effort,efforts
ego: ego
egyptian: egyptian
eld: eldest
elder: elder
elect: elect,electing
election: election,elections
elective: elective
elector: electors
electronic: electronic
electronically: electronically
elude: elude
email: email
eminent: eminent
empire: empire,empires
employ: employ,employed,employing,employs
employee: employee,employees
employment: employment
empower: empowered
enact: enact,enacted,enacting,enacts
enclose: enclosed,enclosing
enclosure: enclosure
encode: encoding
encourage: encouraged
encouragement: encouragement
encroach: encroached
encroachment: encroachment,encroachments
endamage: endamaging
endanger: endanger
endeavour: endeavour
endless: endless
endure: endure,endured,endures
enemy: enemies,enemy
enforce: enforcing
engage: engage,engaged,engages
engagement: engagement,engagements
england: england
english: english
englishman: englishman
enjoin: enjoin
enjoy: enjoy,enjoyed,enjoying,enjoys
enjoyment: enjoyment,enjoyments
enlarge: enlarge
enmity: enmity
enquire: enquire
enquiry: enquiry
enslave: enslave
ensure: ensuring
enter: enter,entered,entering,enters
entire: entire
entity: entity
entrance: entrance
eo: eo
equal: equal,equals
equality: equality
equally: equally
equipment: equipment
equitable: equitable
equity: equity
erect: erect,erected,erecting
erecting: erecting
ergo: ergo
err: err
error: errors
esau: esau
escape: escape
espouse: espouses,espousing
essay: essay
esse: esse
essence: essence
est: est
establish: establish,established,establishing
established: established
establisher: establisher
establishing: establishing
establishment: establishment
estate: estate,estates
esteem: esteem,esteemed
esteemed: esteemed
estimate: estimate
eternal: eternal
etiam: etiam
europe: europe
european: european
eve: eve
event: event,events
evidence: evidence
evident: evident
evidently: evidently
evil: evil,evils
examination: examination
examine: examine,examining
exceed: exceed,exceeding,exceeds
exceedingly: exceedingly
excellency: excellency
excellent: excellent
exception: exception
excess: excess
exchange: exchange
exclude: exclude,excluded,excludes
exclusion: exclusion
exclusive: exclusive
excuse: excuse,excuses
execute: execute,executed,executing
execution: execution
executioner: executioner
executive: executive
executor: executor
exemplum: exemplum
exempt: exempt,exempted,exempts
exemption: exemption
exercise: exercise,exercised,exercises,exercising
exhort: exhorted
exigency: exigencies
exist: exists
exorbitant: exorbitant
expect: expect,expected
expectation: expectation
expend: expend
expense: expense,expenses
experience: experience
experiment: experiment,experiments
explanation: explanation
explicit: explicit
export: exporting
expose: expose,exposed
express: express,expresses
expression: expression,expressions
expressly: expressly
extemporary: extemporary
extend: extend,extended,extending,extends
extent: extent
external: external
extort: extorted,extorting,extorts
extravagancy: extravagancy
eye: eye
fabric: fabric
facility: facility
facit: facit
faction: faction,factions
factious: factious
facto: facto
factum: factum
faculty: faculties
fail: fail,fails
fain: fain
fair: fair
faith: faith
fall: fall,falls,fell
false: false
fame: fame
familiar: familiar
family: families,family
fancy: fancies,fancy
fantastical: fantastical
farthing: farthing
fashion: fashion
fatal: fatal
fate: fate
father: father,fathers
fatherhood: fatherhood
fatherly: fatherly
fault: fault,faults
favour: favoured,favours
favourable: favourable
favourite: favourite
fealty: fealty
fear: fear,feared,fears
federal: federal
federative: federative
fee: fee,fees
feeble: feeblest
feed: feed,feeding,feeds
feeding: feeding
feel: feel
feeling: feeling
felicity: felicity
fell: felled
fellow: fellow
fellowship: fellowship
female: female
fence: fence,fences
ferment: ferment
fertile: fertile
fiat: fiat
fide: fide
fiduciary: fiduciary
fight: fight,fought
fighting: fighting
file: file,files
filial: filial
filmer: filmer
finally: finally
financial: financial
finis: finis
firm: firm
fish: fish
fit: fit,fitted,fitter,fittest
fitness: fitness
fixed: fixed
flat: flatter
flatter: flattered
flatterer: flatterers
flattery: flattery
flesh: flesh
flock: flocks
florida: florida
flourish: flourish,flourishing
flow: flows
flux: flux
follow: follow
follower: followers
folly: folly
food: food
foolish: foolish
footstep: footsteps
forasmuch: forasmuch
force: force,forced,forces
fore: fore
forego: foregoing
foreign: foreign
foreigner: foreigners
foresee: foresee
foresight: foresight
forfeit: forfeit,forfeited,forfeits
forfeiture: forfeiture
forget: forget
form: form,forms
format: format,formats
forte: forte
fortescue: fortescue
fortunate: fortunate
fortune: fortunes
forwards: forwards
foster: foster
foundation: foundation,foundations
founder: founders
fountain: fountain
fourthly: fourthly
fox: foxes
frailty: frailty
frame: frame,framed,framing
framer: framers
france: france
fraud: fraud
freedom: freedom
freely: freely
freeman: freeman,freemen
freemen: freemen
french: french
frequent: frequent
frequently: frequently
friend: friend,friends
friendship: friendship
fruit: fruit,fruits
fruitful: fruitful
fruitless: fruitless
function: function
fundamental: fundamental
furnish: furnish,furnished,furnishes
fury: fury
future: future
gain: gain
galley: galley
garden: garden
gather: gathered,gathering
gathering: gathering
generation: generation,generations
gentle: gentle
gentleman: gentleman
genuine: genuine
gideon: gideon
glad: glad
gladly: gladly
glib: glib
goal: goals
god: god
godlike: godlike
gold: gold
golden: golden
goodness: goodness
gospel: gospel
govern: govern,governed,governing,governs
government: government,governments
governor: governor,governors
gowan: gowan
grand: grand
grant: grant,granted,granting,grants
grasp: grasp
grass: grass
gratefully: gratefully
gratitude: gratitude
greatly: greatly
greatness: greatness
grecian: grecian
grievance: grievances
grieve: grieve
groan: groaned
gross: gross
ground: ground,grounded
grounds: grounds
grow: grew,grow,growing,grown
growth: growth
guard: guard,guarded,guards
guardian: guardian,guardians
guide: guide,guided
guilt: guilt
guilty: guilty
habet: habet
habitation: habitations
haec: haec
hand: hand,hands
hang: hang
happen: happen,happened,happening
happiness: happiness
happy: happier,happy
harass: harass
harbour: harbours
hard: hard
hardship: hardship
hare: hare
harm: harm
harmless: harmless
harshness: harshness
hart: hart
harvest: harvest
hast: hast
hasty: hasty
hath: hath
hatred: hatred
hazard: hazard
head: head,heads
heady: heady
health: health
healthy: healthy
heap: heap
hear: hear,heard
hearken: hearken
heart: heart,hearts
heat: heat,heats
heaven: heaven
heavy: heavy
hedge: hedges
heinousness: heinousness
heir: heir,heirs
helpless: helpless
hen: hen
herd: herd,herds
hereditary: hereditary
hereunto: hereunto
hero: heroes
hezekiah: hezekiah
hidden: hidden
highly: highly
highway: highway
hinder: hinder,hindered,hinders
hindrance: hindrance
history: history
hitherto: hitherto
hoard: hoard,hoarded
hoc: hoc
hold: held,hold,holds
holder: holder
holland: holland
homage: homage
honest: honest
honesty: honesty
honour: honour,honouring
hook: hook
hooker: hooker
hope: hope,hoped,hopes
horse: horse,horses
hostile: hostile
house: house
housing: housing
hubba: hubba
huic: huic
human: human
humour: humour
hundredth: hundredth,hundredths
hunt: hunting
hurt: hurt,hurting
hurtful: hurtful
husband: husband
husbandry: husbandry
hymen: hymen
hypothesis: hypothesis
ibid: ibid
identification: identification
identify: identify
igitur: igitur
ignorance: ignorance
ignorant: ignorant
iii: iii
illegal: illegal
image: image
imaginary: imaginary
imagine: imagine,imagined
imbody: imbodied
impair: impair
impartial: impartial
imperfect: imperfect
imperfection: imperfection,imperfections
imperious: imperious
imperiously: imperiously
imperium: imperium
impertinent: impertinent
implant: implanted
imply: implied
impose: impose,imposed
imposition: impositions
impossibility: impossibility
impossible: impossible
impoverish: impoverish
impower: impower,impowered,impowers
impracticable: impracticable
improbable: improbable
improve: improve,improved,improves,improving
improved: improved
improvement: improvement,improvements
impunity: impunity
imputed: imputed
inaccurate: inaccurate
inauguration: inauguration
incapable: incapable
incident: incident
incidental: incidental
inclination: inclination,inclinations
inclose: inclose,inclosed,incloses
include: include,included,includes,including
including: including
incomplete: incomplete
inconsiderable: inconsiderable
inconsistency: inconsistencies
inconsistent: inconsistent
inconstant: inconstant
inconvenience: inconvenience,inconveniences
inconveniency: inconveniencies,inconveniency
inconvenient: inconvenient
incorporate: incorporate,incorporated,incorporates
increase: increase,increased,increasing
incumbent: incumbent
inde: inde
indefinitely: indefinitely
indemnify: indemnify
indemnity: indemnity
independent: independent
indian: indian,indians
indianapolis: indianapolis
indifferent: indifferent
indifferently: indifferently
indirect: indirect
indirectly: indirectly
indiscretion: indiscretion
indispensable: indispensable
indispensably: indispensably
individual: individual,individuals
induce: induced
inducement: inducement
industrious: industrious
industry: industry
inequality: inequality
inevitably: inevitably
infancy: infancies,infancy
infant: infants
inferior: inferior
infinite: infinite
infinitely: infinitely
infirmity: infirmities
inflexible: inflexible
influence: influence
inform: inform,informed
infringement: infringement
ingross: ingross
inhabit: inhabit,inhabited
inhabitant: inhabitants
inherit: inherit
inheritance: inheritance
injure: injure,injured,injures
injured: injured
injuria: injuria
injurious: injurious
injury: injuries,injury
injustice: injustice
inland: inland
innocence: innocence
innocent: innocent,innocents
inquire: inquire
inroad: inroad,inroads
insensible: insensible
insensibly: insensibly
inseparable: inseparable
inseparably: inseparably
insignificant: insignificant
insolence: insolence
insolent: insolent
inspiration: inspiration
instance: instance,instances
instant: instant
institute: instituted
institution: institution
instruct: instruct,instructed
instruction: instruction
instrument: instrument,instruments
intellectual: intellectual
intelligent: intelligent
intelligible: intelligible
intend: intend,intended,intending,intends
intent: intent
intention: intention
intercept: intercepted
internal: internal
international: international
interpose: interpose,interposed
interpret: interpreted
interpreter: interpreter
interregnum: interregnum
interval: interval,intervals
intervene: intervened
intestine: intestine
intire: intire
intitle: intitled
intolerable: intolerable
intrench: intrench
intricate: intricate
intrinsic: intrinsic
introduce: introduce,introduced,introduces,introducing
introduction: introduction
intrust: intrust,intrusted
invade: invade,invaded,invades,invading
invaded: invaded
invalidate: invalidate
invalidity: invalidity
invasion: invasion,invasions
invest: invested
involve: involves
inwardly: inwardly
ipse: ipse
ipso: ipso
iron: iron
irregular: irregular
irreparable: irreparable
irs: irs
island: island
israel: israel
israelites: israelites
issue: issue
ita: ita
italy: italy
iv: iv
ix: ix
jam: jam
james: james
jews: jews
john: john
joint: joint
jointly: jointly
jot: jot
judah: judah
judge: judge,judged,judges,judging
judgment: judgment,judgments
judicature: judicature
judicial: judicial
judicious: judicious
jugulum: jugulum
jumble: jumbled
jupiter: jupiter
jure: jure
juris: juris
jurisdiction: jurisdiction,jurisdictions
jus: jus
justice: justice
justifiable: justifiable
justify: justify
justin: justin
justly: justly
juvenal: juvenal
keeping: keeping
kill: kill,killed
kindness: kindness
king: king,kings
kingdom: kingdom,kingdoms
kingly: kingly
knock: knock
knot: knot
knowledge: knowledge
laborious: laborious
labour: labour
labourer: labourer
lake: lake
lamb: lamb
land: land,lands
language: language
largeness: largeness
lasting: lasting
late: late
latins: latins
latitude: latitude
laurel: laurels
law: law,laws
lawful: lawful
lawfully: lawfully
lawfulness: lawfulness
lawmaking: lawmaking
lay: laid,lay,laying,lays
lead: lead,leads,led
leader: leader,leaders
leaf: leaves
league: league,leagues
leak: leaks
learn: learn,learned,learning
learning: learning
leather: leather
leave: leave,leaves,left
left: left
legal: legal
legally: legally
legislative: legislative
legislator: legislator,legislators
legislature: legislature
leisure: leisure
lessen: lessen,lessens
letter: letter,letters
lev: lev
level: level,levels
leviathan: leviathan
levy: levy
lex: lex
liability: liability
liable: liable
lib: lib
liber: liber
liberal: liberal
liberally: liberally
libertas: libertas
liberty: liberties,liberty
liberum: liberum
library: library
licence: licence
license: license
licensed: licensed
licentious: licentious
lie: lie,lies,lying
lieu: lieu
life: life,lives
lifetime: lifetime
light: light,lighted
limb: limb,limbs
lime: lime
limit: limit,limited,limiting,limits
limitation: limitation,limitations
limited: limited
link: linked,links
lion: lion,lions
list: lists
literary: literary
live: live,lived,living
living: living
loaf: loaf
local: local
locate: located
location: locations
lodge: lodged,lodges
lodging: lodging
london: london
loose: loose
loosen: loosen
lord: lord,lords
lose: lose,loses,lost
loss: loss,losses
lot: lot
loudly: loudly
love: love,loved,loves
lunatic: lunatics
lure: lure
lust: lust
luxury: luxury
machine: machine
mad: mad
madman: madmen
magistrate: magistrate,magistrates
maim: maim
main: main
maintain: maintain,maintained,maintaining,maintains
maintenance: maintenance
majority: majority
maker: maker,makers
maladministration: maladministration
malcontent: malcontent
male: male
malice: malice
malum: malum
manage: manage,managed,managing
management: management
manager: manager
manet: manet
mangle: mangle
manifest: manifest
manifestly: manifestly
mankind: mankind
manner: manner
manners: manners
march: march
mark: marked
marriage: marriage
martial: martial
mast: masts
master: master,mastered,masters
mate: mates
material: materials
matrimony: matrimony
matter: matter
mature: mature
maturity: maturity
maxim: maxims
maximum: maximum
measure: measure,measured,measures
meat: meat
meddle: meddle
meditator: meditator
medium: medium
meet: meet,met
meeting: meeting,meetings
memory: memory
mention: mentioned
merchantability: merchantability
mercy: mercy
mere: mere
merit: merit
metal: metal,metals
method: method,methods
mexico: mexico
michael: michael
middle: middle
mightily: mightily
mighty: mighty
milton: milton
mind: mind,minds
mindful: mindful
minister: ministers
ministerial: ministerial
ministerially: ministerially
minor: minor
minority: minority
misapply: misapply
miscarriage: miscarriages
mischief: mischief,mischiefs
miscite: miscite
miserable: miserable
misery: miseries,misery
mislead: misled
mismanagement: mismanagement
mission: mission
mississippi: mississippi
mistake: mistake,mistaken,mistakes
mistaken: mistaken
mistress: mistress
misuse: misuse
mitigate: mitigate
mix: mixing
mixed: mixed
mixture: mixture
mockery: mockery
model: model
moderate: moderate,moderated
modest: modest
modicum: modicum
modification: modification
modify: modified
modo: modo
moment: moment
monarch: monarch,monarchs
monarchical: monarchical
monarchy: monarchies,monarchy
money: money
morrow: morrow
moss: moss
mother: mother
mould: mould
mount: mount
mouth: mouth
multiplicity: multiplicity
multiply: multiplied,multiply
multitude: multitude,multitudes
municipal: municipal
murder: murder
murderer: murderer
murmur: murmur
mutiny: mutiny
mutual: mutual
mutually: mutually
mystery: mystery
nam: nam
narrow: narrow
narrowness: narrowness
nation: nation,nations
native: native
natura: natura
natural: natural
naturally: naturally
nature: nature
nearer: nearer
necessity: necessities,necessity
neck: neck
needful: needful
needy: needy
neglect: neglect,neglected,neglects
negligence: negligence
negligent: negligent
neighbour: neighbour,neighbours
neighbourhood: neighbourhood
nest: nest
network: network
newsletter: newsletter
nice: nice
night: night
nisi: nisi
noah: noah
nobility: nobility
noble: nobler
noise: noise
nominate: nominating
nonage: nonage
nonproprietary: nonproprietary
nonsense: nonsense
norman: norman,normans
north: north
note: note
notice: notice
notify: notifies
notion: notion,notions
nourish: nourish,nourished,nourishes
nourishment: nourishment
novas: novas
noxious: noxious
nullum: nullum
num: num
numerous: numerous
nurse: nurse
nursing: nursing
nut: nuts
oak: oak
oath: oath,oaths
obedience: obedience
obey: obey,obeyed,obeying
object: objected
objection: objection,objections
obligation: obligation,obligations
oblige: oblige,obliged,obliges
obscure: obscure
obscurity: obscurities
observance: observance
observation: observation,observations
observations: observations
observe: observe,observed,observing
observer: observers
obsolete: obsolete
obstinate: obstinate
obstruct: obstructed
obvious: obvious
occasion: occasion,occasioned,occasions
occasional: occasional
occur: occur
occurrence: occurrences
ocean: ocean
odd: odd
oddly: oddly
odds: odds
odium: odium
offence: offence,offences
offend: offended,offending
offender: offender,offenders
offer: offer,offered,offers
office: office,offices
officer: officer,officers
official: official
offspring: offspring
oftener: oftener
oil: oil
oligarchy: oligarchy
omit: omit
omni: omni
omnipotency: omnipotency
omnipotent: omnipotent
online: online
openly: openly
operate: operates
operator: operators
opinion: opinion,opinions
opportunity: opportunities,opportunity
oppose: oppose,opposed,opposes,opposing
opposer: opposers
opposition: opposition
oppress: oppress
oppressed: oppressed
oppression: oppression
oppressor: oppressors
oracle: oracles
ordain: ordained,ordaining,ordains
ordinance: ordinance
ordinarily: ordinarily
ordinary: ordinary
ore: ore
organize: organized
original: original,originals
originally: originally
originator: originator
outdated: outdated
outlast: outlast
outlive: outlived
outward: outward
outweigh: outweigh
oven: oven
overcome: overcomes
overplus: overplus
overrun: overrun
overthrow: overthrown
overturn: overturn,overturning,overturns
owe: owe,owed,owes
owen: owen
owner: owner
oxen: oxen
paction: paction
pain: pains
paper: paper,papers
paperback: paperback
paperwork: paperwork
paragraph: paragraph,paragraphs
paramount: paramount
parcel: parcel,parcels
pardon: pardon
parent: parents
parental: parental
parish: parish
parliament: parliament,parliaments
partage: partage
partake: partake
partial: partial
partiality: partiality
particulars: particulars
party: parties,party
pass: pass,passed,passes
passion: passion
passionate: passionate
passive: passive
pasturage: pasturage
pasture: pasture
paterfamilias: paterfamilias
paternal: paternal
patience: patience
patriarch: patriarch
patron: patron
pattern: pattern
pauperis: pauperis
pay: paid,pay,paying
payment: payments
peace: peace
peaceable: peaceable
peaceably: peaceably
peaceful: peaceful
pebble: pebble
peculiar: peculiar
penalty: penalties
penny: pence,penny
penury: penury
people: peopled,peoples,peopling
peopled: peopled
peopling: peopling
perceive: perceive
perdition: perdition
perfect: perfect,perfecting
perfection: perfection
perfectly: perfectly
perform: perform,performed,performing
performance: performances
perilous: perilous
period: periods
periodic: periodic
perish: perish,perished,perishing
perishable: perishable
perishableness: perishableness
perishing: perishing
perjure: perjured
permanent: permanent
permission: permission
permit: permit,permits,permitted,permitting
perpetual: perpetual
perpetually: perpetually
person: people,person,persons
persona: personas
personally: personally
persuade: persuade,persuaded,persuading
peru: peru
perverted: perverted
perverting: perverting
pest: pest,pests
peter: peter
petty: petty
phantom: phantom
philistines: philistines
phrase: phrase
physical: physical
pick: picked
piece: piece,pieces
piety: piety
pillage: pillaged
pirate: pirates
pistol: pistol
pitch: pitch,pitched
pitcher: pitcher
pity: pitied
plain: plain,plainer
plainly: plainly
plane: plane
plant: plant,planted,plants
planting: planting
plead: plead
pleased: pleased
pleasure: pleasure
plentiful: plentiful
plenty: plenty
plough: plough
plum: plums
plurality: plurality
pocket: pocket
poison: poison
pol: pol
pole: pole
policy: policy
politic: politic
political: political
politician: politicians
politics: politics
polity: polities,polity
polyphemus: polyphemus
poor: poor
popular: popular
populi: populi
populous: populous
populum: populum
populus: populus
portion: portion,portions
positive: positive
possess: possess,possessed,possessing
possession: possession,possessions
possessor: possessor,possessors
possibility: possibility
post: post,posted
posterity: posterity
posture: posture
potentate: potentate
potestas: potestas
potestate: potestate
pound: pounds
pour: pouring
power: power,powers
powerful: powerful
practicable: practicable
practically: practically
practice: practice
praecipuum: praecipuum
preach: preached
precede: precede
precedency: precedency
precedent: precedent
precept: precept
precipice: precipices
precise: precise
predecessor: predecessors
preengage: preengages
preface: preface
prefer: prefer,preferred
preferable: preferable
prefix: prefix
prejudice: prejudice
premise: premises
prepare: prepare,prepared
prerogative: prerogative
prescribe: prescribe,prescribed,prescribes,prescribing
prescription: prescription
presently: presently
preservation: preservation
preserve: preserve,preserved,preserving
press: pressing
presume: presumed,presuming
pretence: pretence,pretences
pretend: pretend,pretended,pretends
prevail: prevailed,prevails
prevarication: prevarications
prevent: prevent,prevented,preventing
prevention: prevention
previous: previous
prey: prey
pride: pride
priest: priest,priests
prince: prince,princes
principal: principal
principality: principality
principle: principle,principles
print: print,printed
private: private
privatum: privatum
privilege: privilege,privileges
pro: pro
probable: probable
proceed: proceed
process: process
processing: processing
proclaim: proclaimed
procreation: procreation
procure: procure,procured
procuring: procuring
produce: produce,produced,produces
product: product,products
production: production
profane: profane
professor: professor
profit: profit,profits
progenitor: progenitors
progress: progresses
prohibition: prohibition
project: project
prominently: prominently
promiscuously: promiscuously
promise: promise,promised,promises
promote: promote,promotes,promoting
promotion: promotion
promulgate: promulgated
proof: proof,proofs
proofread: proofread
propagate: propagating
proper: proper,properest
properly: properly
property: properties,property
proportion: proportion,proportions
proportionably: proportionably
proportionate: proportionate
proposition: propositions
proprietary: proprietary
proprietor: proprietor,proprietors
propriety: propriety
propter: propter
prosecute: prosecuting
prosecution: prosecution
prosper: prospered
prosperity: prosperity
protect: protect,protected
protection: protection
protector: protectors
prove: prove,proved
provide: provide,providing
provision: provision,provisions
provocation: provocation,provocations
prudence: prudence
prudent: prudent
public: public
publicly: publicly
publish: published
publishing: publishing
pull: pull,pulled
pulpit: pulpit
punish: punish,punished,punishes,punishing
punishment: punishment,punishments
punitive: punitive
pupil: pupil
pupilage: pupilage
purchase: purchase
pure: pure
purely: purely
purify: purifies
purpose: purpose,purposes
purse: purse
pursuant: pursuant
pursue: pursue,pursues
qua: quae
quae: quae
quality: qualities
quam: quam
quarrel: quarrel,quarrelling,quarrels
quarrelsome: quarrelsome
quarter: quarters
quench: quench
question: question,questioned
qui: qui
quia: quia
quibus: quibus
quick: quick
quid: quid
quiet: quiet
quietly: quietly
quit: quit,quits,quitted,quitting
quod: quod
quorum: quorum
quotation: quotation
race: race,races
rage: rage
railing: railing
raiment: raiment
raise: raise
rank: rank,ranks
rapine: rapine
rare: rare
rate: rated
rational: rational
ravenous: ravenous
raving: raving
reach: reach,reaches,reaching
read: read,reading,reads
readable: readable
reader: reader
ready: readiest,ready
real: real
reap: reap,reaped
reaper: reaper
reason: reason,reasons
reasonable: reasonable
rebel: rebelled,rebels
rebellion: rebellion
rebellious: rebellious
recant: recant
receipt: receipt
receive: receive,received,receives,receiving
reciprocal: reciprocal
reckon: reckon,reckoned
recompence: recompence
recompense: recompensed
reconcile: reconcile
reconciliation: reconciliation
record: recorded,records
recover: recover,recovered,recovering
rectify: rectified
rectitude: rectitude
red: reddest
redeem: redeemed
redistribute: redistribute,redistributing
redistributing: redistributing
redistribution: redistribution
redress: redress
reduce: reduce,reduced
refer: refer
reference: reference,references
reflection: reflection
refuge: refuge
refund: refund
refuse: refuses,refusing
regal: regal
regard: regard
regiment: regiment
register: registered
regnum: regnum
regulate: regulate,regulated,regulates,regulating
regulating: regulating
regulation: regulation
rei: rei
reign: reign,reigns
reinstate: reinstate
relation: relation,relations
release: release
relief: relief
relieve: relieved
religion: religion
rely: relying
remain: remain,remained,remaining,remains
remainder: remainder
remedium: remedium
remedy: remedies,remedy
remember: remember
remiss: remiss
remit: remit
remove: remove,removed,removes,removing
rename: renamed
render: rendering,renders
renew: renew
renounce: renounced
rent: rent
repair: repair,repaired
reparation: reparation
repeat: repeat
repellant: repellant
repent: repent
replace: replace
replacement: replacement
reply: reply
report: reported,reports
repose: reposed
represent: represented,representing
representation: representation,representations
representative: representative,representatives
reprint: reprinted
reproach: reproach
republic: republic
republish: republished
repugnant: repugnant
repulse: repulse
request: request
require: require,required,requires,requiring
requirement: requirements
requisite: requisite
resemblance: resemblance
reservation: reservation
resign: resign,resigned,resigning
resist: resist,resisted,resisting,resists
resistance: resistance
resolution: resolution,resolutions
resolve: resolve,resolved
respect: respect
respectful: respectful
respects: respects
responsum: responsum
rest: rest
restore: restore,restored
restorer: restorer
restrain: restrain,restrained,restraining
restraint: restraint
restriction: restrictions
resume: resume
retain: retain,retains
retake: retake
retire: retire
retract: retract
retribute: retribute
retribution: retribution
return: return,returned,returns
reveal: revealed
revelation: revelation
revenge: revenge
revenue: revenue
reverence: reverence
reverso: reverso
revert: revert,reverted,reverts
revoke: revoking
revolting: revolting
revolution: revolutions
reward: reward,rewarded,rewards
rex: rex
rich: rich
richardson: richardson
riches: riches
richly: richly
richness: richness
rid: rid
ridiculous: ridiculous
righteous: righteous
rightful: rightful
rightfully: rightfully
rightly: rightly
rigid: rigid
rigour: rigour
rise: rise,risen
river: river
rob: rob,robbed
robber: robber,robbers
robbery: robbery
robert: robert
rome: rome
root: root,roots
rope: ropes
rot: rotted
royalty: royalties,royalty
ruin: ruin,ruins
rule: rule,rules,ruling
ruler: ruler,rulers
sacred: sacred
sacredness: sacredness
sacrifice: sacrifices
safe: safe,safer
safely: safely
safety: safety
sake: sake
sale: sale
salt: salt
salus: salus
salute: saluted
sam: sam
samuel: samuel
sanction: sanction
sanctuary: sanctuary
satisfaction: satisfaction
satisfied: satisfied
satisfy: satisfy,satisfying
saul: saul
savage: savage
save: save,saved,saving
saxons: saxons
scarce: scarce
scarcely: scarcely
scatter: scattered
scattered: scattered
scepter: scepter
scilicet: scilicet
score: score
scotch: scotch
scripture: scripture
scruple: scruples
scrupulous: scrupulous
seal: seal
search: search
season: season,seasons
secretly: secretly
sect: sect
secundum: secundum
secure: secure,secured,securing
security: security
sed: sed
sedate: sedate
sedition: sedition
seditious: seditious
seed: seed
seek: seek,seeking,seeks,sought
seignior: seignior
seize: seize
seldom: seldom
select: select
sell: sell,selling,sold
semper: semper
senate: senate
send: send,sending,sends
sense: sense
sentence: sentence
separate: separate,separated,separating
separately: separately
separation: separation
sequel: sequel
serio: serio
serjeant: serjeant
servant: servant,servants
serve: serve,served,serves,serving
service: service
servile: servile
set: set,sets,setting
settle: settle,settled
settled: settled
severe: severe,severer
severity: severity
shadow: shadow
shake: shake,shaking
shalt: shalt
share: share,shared,shares,sharing
shattered: shattered
shechemites: shechemites
sheep: sheep
sheepcote: sheepcote
shepherd: shepherd
shew: shew,shewed,shewing,shewn,shews
shewed: shewed
shewing: shewing
shield: shield
shift: shift
ship: ship
short: short,shorter
shut: shuts
sight: sight
signification: signification
signify: signified,signifies,signify
silence: silence
silent: silent
silk: silk
silver: silver
simple: simple
sincerely: sincerely
sincerity: sincerity
single: single
sink: sunk
sir: sir,sirs
sit: sit,sits,sitting
sixth: sixth
skill: skill
skin: skins
slacken: slackened
slaughter: slaughter
slave: slave,slaves
slavery: slavery
slavish: slavish
slay: slay
slight: slight,slighted
slip: slips
slow: slow
slowness: slowness
soberly: soberly
sociable: sociable
societies: societies
society: societies,society
soever: soever
soil: soil
soldier: soldier,soldiers
sole: sole
solely: solely
solemn: solemn
solemnly: solemnly
solicit: solicit
solicitation: solicitation
solo: solo
solution: solutions
son: son,sons
sore: sore
sort: sort,sorts
soul: soul,souls
sound: sound,sounding
source: source
sovereign: sovereign
sovereignty: sovereignty
sow: sow,sowed,sown
spain: spain
spare: spare,spared
sparing: sparing
sparkling: sparkling
sparta: sparta
speak: speak,speaking,spoke
special: special
species: species
specious: specious
speech: speech
spend: spend
spender: spenders
spending: spending
spirit: spirit
spoil: spoil,spoiled,spoiling,spoils
spontaneous: spontaneous
spread: spread,spreading
spring: sprang,spring,sprung
staff: staff
stamp: stamp
stand: stand,standing,stands,stood
standard: standard
standing: standing
start: start
starve: starve,starved
statement: statements
station: station,stations
status: status
steadily: steadily
steady: steady
steal: stolen
steer: steering
stick: stuck
stickler: stickler
stile: stile
stir: stir
stock: stock,stocked,stocks
stone: stone,stones
stoop: stoop
store: store,stored
story: story
stout: stoutest
straiten: straitened,straitening
strange: strange
stranger: stranger,strangers
straw: straw
street: street
strength: strength
stress: stress
stretch: stretching
strict: strict
strife: strifes
strike: strike,striking
strip: strip,stripped
strong: strong,stronger,strongest
studier: studier
study: study
subdue: subdue,subdued,subduing
subdued: subdued
subject: subject,subjected,subjects
subjection: subjection
submission: submission
submit: submit,submits,submitted,submitting
subordinate: subordinate
subordination: subordination
subscribe: subscribe
subservient: subservient
subsist: subsist,subsisted,subsisting,subsists
subsistence: subsistence
substance: substance
substitute: substitute
subvert: subvert,subverts
success: success
succession: succession,successions
successor: successor,successors
sudden: sudden
suddenly: suddenly
suffer: suffer,suffered
sufferer: sufferers
suffice: suffice
sufficient: sufficient
sugar: sugar
suit: suit
suitable: suitable
suitably: suitably
suited: suited
summer: summer
summon: summoned
summons: summons
sundry: sundry
sunt: sunt
superintend: superintend
superior: superior
superiority: superiority
supply: supplied,supplies,supply
support: support,supported,supports
suppose: suppose,supposed,supposes,supposing
supposition: supposition
suppress: suppress
supreme: supreme
survive: survive
suspect: suspected
suspicion: suspicion,suspicions
sustain: sustained
sustenance: sustenance
swaddle: swaddling
swallow: swallowed
swamp: swamp
sweat: sweat
sweep: sweep
swiss: swiss
sword: sword,swords
sympathy: sympathy
synonymous: synonymous
syracuse: syracuse
tacit: tacit
tacitly: tacitly
talk: talk,talks
tame: tamed
tantum: tantum
tar: tar
task: task
tax: tax,taxes
teach: taught,teaches
teacher: teachers
tear: torn
teat: teat
temper: temper
temporary: temporary
tempore: tempore
tempt: tempted
temptation: temptation
tenant: tenant
tend: tend,tended,tending
tendency: tendency
tender: tender
tenderness: tenderness
tenth: tenths
term: term,terms
terminate: terminates
terrify: terrify
territory: territories,territory
testament: testament
testimony: testimonies
theatre: theatre
thee: thee
thenceforth: thenceforth
thereunto: thereunto
therewith: therewith
thief: thief
thinness: thinness
thirdly: thirdly
thirst: thirst
tho: tho
thousandth: thousandth
threat: threats
threaten: threaten,threatened,threatens
thresher: thresher
thro: thro
throat: throat
throne: throne
throw: throw
thrust: thrust
thy: thy
tie: tie,tied,ties
tillage: tillage
tim: tim
timber: timber
time: time,times
title: title,titles
tobacco: tobacco
toil: toil
tolerable: tolerable
tool: tools
tooth: tooth
totally: totally
totum: totum
touch: touching
town: town
trace: trace,tracing
tract: tract,tracts
trade: trade
trademark: trademark
train: train
tranquillity: tranquillity
transaction: transactions
transcribe: transcribe
transcription: transcription
transfer: transfer,transferring
transgress: transgress,transgressed,transgressing
transgression: transgression,transgressions
transgressor: transgressors
travel: travelling
treasure: treasure
treat: treat,treated,treats
treatise: treatise,treatises
treatment: treatment
tree: trees
trespass: trespass,trespasses
tribe: tribes
tribunal: tribunal
tribute: tribute
triumph: triumph,triumphs
troops: troops
trouble: trouble,troubles
truck: truck
true: true
trust: trust,trusted
trustee: trustee
truth: truth
tu: tu
tuition: tuition
tumult: tumult
turbulency: turbulency
turbulent: turbulent
turf: turfs
turkish: turkish
tutor: tutor,tutors
tye: tye
type: types
tyranni: tyranni
tyrannical: tyrannical
tyrannize: tyrannize
tyrannus: tyrannus
tyranny: tyranny
tyrant: tyrant,tyrants
ubi: ubi
ultimate: ultimate
ultimately: ultimately
ulysses: ulysses
umpirage: umpirage
umpire: umpire
unabridged: unabridged
unalterable: unalterable
unalterably: unalterably
unassisted: unassisted
unavoidably: unavoidably
unbiassed: unbiassed
uncapable: uncapable
uncertain: uncertain
uncertainty: uncertainty
unconceivable: unconceivable
unconcernedness: unconcernedness
unconfined: unconfined
uncultivated: uncultivated
undeniably: undeniably
underhand: underhand
understand: understand,understanding,understands,understood
understanding: understanding,understandings
undertake: undertake,undertakes
undetermined: undetermined
undoubted: undoubted
undoubtedly: undoubtedly
uneasy: uneasy
unenforceability: unenforceability
unequal: unequal
unfit: unfit
unforesee: unforeseeing
unforeseen: unforeseen
unfortunate: unfortunate
unfrequented: unfrequented
ungrateful: ungrateful
unhinge: unhinge
uniform: uniform
union: union
unite: unite,united,unites,uniting
united: united
unity: unity
universal: universal
universally: universally
universe: universe
unjust: unjust
unjustice: unjustice
unjustly: unjustly
unknown: unknown
unlawful: unlawful
unlimited: unlimited
unlink: unlink
unpossessed: unpossessed
unprotected: unprotected
unprovided: unprovided
unquestionable: unquestionable
unreasonable: unreasonable
unrestrained: unrestrained
unsafe: unsafe
unsecure: unsecure
unsolicited: unsolicited
unsteady: unsteady
untie: untie
untouched: untouched
unum: unum
unwilling: unwilling
unwritten: unwritten
upbraid: upbraids
update: updated
upright: upright
uprightness: uprightness
urge: urge,urged
usage: usage
useless: useless
user: user
usual: usual
usurp: usurp,usurped,usurping
usurpation: usurpation
usurper: usurper
ut: ut
utensil: utensils
utmost: utmost
utterly: utterly
vacant: vacant
vain: vain
valid: valid
valuable: valuable
vanilla: vanilla
vanish: vanish
vanquish: vanquished
variable: variable
variableness: variableness
variation: variation
varied: varied
variety: variety
vary: varied,vary,varying
vast: vast
vega: vega
vel: vel
venice: venice
venison: venison
vent: vented
version: version
vest: vested
vial: vial
vicious: vicious
victor: victor
victory: victory
view: viewed,viewing
vigour: vigour
vii: vii
viii: viii
villain: villain
vim: vim
vindicate: vindicated
violate: violated,violates,violating
violation: violation
violence: violence,violences
violent: violent
violently: violently
viper: vipers
virtue: virtue
virtuous: virtuous
virus: virus
visible: visible
visibly: visibly
visit: visit
vitae: vitae
viviparous: viviparous
voice: voice
void: void
voluntary: voluntary
volunteer: volunteer,volunteers
vote: vote,votes
wages: wages
walk: walks
wander: wandered,wandering
wantonness: wantonness
war: war,warred,wars
ward: ward
ware: ware
warrant: warrant
warranty: warranties,warranty
waste: waste,wasted,wasting
watch: watch,watching
water: water
weak: weak,weaker
weakness: weakness
weal: weal
wealth: wealth,wealths
wear: wear
wearer: wearer
weary: weary
weather: weather
weave: woven
week: week
weigh: weighed
weight: weight
welfare: welfare
west: west
whatsoever: whatsoever
wheat: wheat
whensoever: whensoever
whereat: whereat
wherefore: wherefore
whereof: whereof
wheresoever: wheresoever
whirl: whirl
white: white
wholly: wholly
whomsoever: whomsoever
whoso: whoso
whosoever: whosoever
wicked: wicked
wide: wider,widest
widespread: widespread
wife: wife,wives
wild: wild
wilderness: wilderness
wilfully: wilfully
william: william
willingly: willingly
wind: wind,winds
winding: windings
wine: wine
wing: wing
winter: winter
wisdom: wisdom
wise: wise,wiser,wisest
wisht: wisht
withdraw: withdraw,withdrawing
withstand: withstood
withy: withy
woful: woful
wolf: wolf
woman: woman
wonderful: wonderful
wood: wood,woods
woodfall: woodfall
wool: wool
word: word
workman: workmen
workmanship: workmanship
worldly: worldly
worth: worth
worthless: worthless
worthy: worthiest,worthy
wrapt: wrapt
wresting: wresting
wretched: wretched
writ: writ
write: writing,written
writer: writers
writing: writing
wrong: wrong,wrongs
xi: xi
xii: xii
xiii: xiii
xiv: xiv
xix: xix
xvi: xvi
xvii: xvii
xviii: xviii
xx: xx
xxi: xxi
yellow: yellow
yield: yield,yielded,yielding
yoke: yoke
zealous: zealous
