abandon: abandon,abandoned
abbey: abbey
abhor: abhor,abhorred
abhorred: abhorred
abhorrence: abhorrence
abhorrent: abhorrent
ability: ability
abject: abject
aboard: aboard
abode: abode
abortion: abortion
abortive: abortive
abrupt: abrupt
absence: absence
absent: absent
absolute: absolute
absolutely: absolutely
absolution: absolution
absorb: absorbed,absorbing
abstain: abstained
abstruse: abstruse
abyss: abyss
accede: acceded
accent: accent,accents
accept: accept
acceptance: acceptance
access: access
accident: accident,accidents
accidentally: accidentally
accompany: accompanied,accompany
accomplish: accomplish,accomplished
accomplishment: accomplishment,accomplishments
accord: accorded
account: account,accounted,accounts
accumulate: accumulated
accumulation: accumulation
accuracy: accuracy
accurate: accurate
accurse: accursed
accursed: accursed
accusation: accusation,accusations
accuse: accuse,accused,accuses
accustom: accustomed
accustomed: accustomed
ache: aching
achieve: achieve,achieved
achievement: achievements
acknowledge: acknowledged
acme: acme
acorn: acorns
acquaint: acquainted
acquaintance: acquaintance,acquaintances
acquainted: acquainted
acquiesce: acquiesced
acquire: acquire,acquired,acquiring
acquirement: acquirement
acquisition: acquisition
acquit: acquit,acquitted
acquittal: acquittal
action: action,actions
active: active
activity: activity
actor: actor
actual: actual
actuate: actuated
acuteness: acuteness
adam: adam
adapt: adapt
add: add
additional: additional
address: address,addressed
adduce: adduced
adequate: adequate
adieu: adieu
adjacent: adjacent
adjuration: adjuration
admirable: admirable
admiration: admiration
admire: admire,admired
admission: admission
admit: admit
admittance: admittance
adoration: adoration
adore: adored
adored: adored
adorn: adorned,adorns
adrift: adrift
advance: advance,advanced,advancing
advanced: advanced
advancement: advancement
advantage: advantage,advantages
adventure: adventure
adventurer: adventurer
adventurous: adventurous
adversary: adversary
adversity: adversity
advice: advice
advise: advise
advocate: advocate
aerial: aerial
affability: affability
affair: affair,affairs
affectation: affectation
affection: affection,affections
affectionate: affectionate
affectionately: affectionately
affirm: affirm
affirmative: affirmative
afflict: afflicted
affluence: affluence
afford: afford,afforded,affording,affords
affright: affright
afraid: afraid
africa: africa
afternoon: afternoon
agatha: agatha
age: age,ages
aged: aged
agent: agents
aggravation: aggravation
agile: agile
agitate: agitated,agitates
agitated: agitated
agitation: agitation
agonise: agonised
agonising: agonising
agony: agonies,agony
agree: agree,agreed
agreeable: agreeable
aid: aid,aided
aiguille: aiguilles
aim: aim,aimed
air: air,airs
airy: airy
akin: akin
alarm: alarm,alarmed
alarming: alarming
alas: alas
albatross: albatross
alchemist: alchemists
alight: alighted
alighting: alighting
alike: alike
alive: alive
allege: alleged,alleging
alleviate: alleviate,alleviated
allot: allotted
alloy: alloy
allude: allude,alluded
allure: allured
allurement: allurements
alluring: alluring
allusion: allusion
ally: allied
almighty: almighty
aloud: aloud
alphonse: alphonse
alpine: alpine
alps: alps
alter: alter,altered
alteration: alteration,alterations
altered: altered
alternate: alternate
altogether: altogether
amass: amassed
amazed: amazed
amazing: amazing
ambition: ambition
ameliorate: ameliorate
amend: amend
america: america
american: american
amiable: amiable
amphitheatre: amphitheatre
ample: ample
amuse: amuse
amused: amused
amusement: amusement,amusements
analyse: analysing
analysis: analysis
anatomise: anatomise
anatomy: anatomy
ancestor: ancestors
anchor: anchor
ancient: ancient
andes: andes
andrew: andrew
anew: anew
angel: angel
angelic: angelic
angelica: angelica
anger: anger
angrily: angrily
angry: angry
anguish: anguish
animal: animal,animals
animate: animate,animated
animated: animated
animating: animating
animation: animation
annihilation: annihilation
annoy: annoyed
annoying: annoying
anon: anon
answer: answer,answered,answers
antelope: antelope
anticipate: anticipated
anticipation: anticipation,anticipations
antipathy: antipathy
antique: antique
antiquity: antiquity
anxiety: anxiety
anxious: anxious
anxiously: anxiously
apartment: apartment,apartments
apathy: apathy
apothecary: apothecary
appalling: appalling
apparatus: apparatus
apparel: apparel
apparent: apparent
apparition: apparition
appeal: appeal,appeals
appearance: appearance,appearances
appease: appeased
appertain: appertaining
appertaining: appertaining
appetite: appetite
apple: apple
application: application
apply: applied,apply
appointment: appointment
apprehend: apprehended,apprehending
apprehension: apprehension,apprehensions
approach: approach,approached,approaching
approbation: approbation
approve: approve,approved
apt: apt
arab: arab
arabian: arabian
arabic: arabic
arbiter: arbiters
archangel: archangel
ardent: ardent
ardently: ardently
ardour: ardour
arduous: arduous
argue: argue
argument: argument,arguments
aright: aright
arm: arm,arms
armada: armada
armed: armed
arouse: aroused
arrange: arrange,arranged,arranging
arrangement: arrangements
arrest: arrest,arrested
arrival: arrival
arrive: arrive,arrived,arrives,arriving
arrow: arrow
arrowy: arrowy
art: art,arts
artery: arteries,artery
arthur: arthur
article: article,articles
articulate: articulate
artifice: artifice
artist: artist
ascend: ascend,ascended
ascent: ascent
ascertain: ascertain,ascertaining
ascribe: ascribed
ash: ashes
ashamed: ashamed
asia: asia
asleep: asleep
aspect: aspect
aspiration: aspirations
aspire: aspire,aspired,aspires
ass: ass
assail: assailed
assassin: assassin
assassinate: assassinated
assemblage: assemblage,assemblages
assemblance: assemblance
assemble: assembled
assert: asserted
assertion: assertion
asseveration: asseverations
assign: assigned
assist: assist,assisted,assisting
assistance: assistance
assistant: assistants
assizes: assizes
associate: associate,associates
association: association
assuage: assuage
assume: assume,assumed
assurance: assurance,assurances
assure: assure,assured,assures
assured: assured
assuredly: assuredly
astonish: astonished
astonishing: astonishing
astonishment: astonishment
astounded: astounded
astounding: astounding
asylum: asylum
atlantic: atlantic
atmosphere: atmosphere
atone: atone
atrocious: atrocious
attach: attach,attached
attachment: attachment
attack: attack,attacked,attacks
attain: attain,attained
attainment: attainment
attempt: attempt,attempted,attempts
attend: attend,attended,attending,attends
attendance: attendance
attendant: attendant,attendants
attention: attention,attentions
attentive: attentive
attentively: attentively
attest: attest
attitude: attitude
attract: attract,attracted,attracts
attraction: attractions
attractive: attractive
attribute: attributed
audible: audible
audibly: audibly
auditor: auditor
aught: aught
augment: augmented,augmenting
augury: auguries,augury
august: august
aunt: aunt
austria: austria
austrian: austrian
author: author,authors
authority: authority
autumn: autumn
avail: avail,availed
avalanche: avalanche
avenge: avenge
avenue: avenue
aver: averred
averse: averse
aversion: aversion
avert: avert
avidity: avidity
avoid: avoid,avoided
avow: avow,avowed
avowal: avowal
await: await,awaiting
awake: awake,awaking,awoke
awaken: awaken,awakened
award: award
aware: aware
awe: awe
awful: awful
ay: ay
babe: babe,babes
bad: bad,worse,worst
bade: bade
baffle: baffled
balance: balanced
balancing: balancing
ball: ball
ballot: ballots
balminess: balminess
balmy: balmy
ban: ban
banish: banish,banished
bank: banks
banker: banker
bar: barred
barbarity: barbarity
barbarous: barbarous
barbarously: barbarously
bare: bare,bared
bark: barks
barn: barn
barren: barren
barricade: barricade
barrier: barrier,barriers
base: base,basest
basket: basket
bat: bat
bath: bathed,baths
bauble: bauble
beach: beach
beam: beam,beaming
bear: bear,bearing,bears,bore,born,borne
beast: beast,beasts
beat: beat,beaten
beaufort: beaufort
beautiful: beautiful
beauty: beauties,beauty
bed: bed,beds
bedew: bedewed
bedim: bedim
bedroom: bedroom
bedside: bedside
befall: befall,befallen
befitting: befitting
beg: beg,begged
beggar: beggar,beggars
begone: begone
behalf: behalf
behaviour: behaviour
beheld: beheld
behold: beheld,behold,beholding
belief: belief
belong: belong,belonged,belonging,belongs
beloved: beloved
bend: bend,bending,bent
beneath: beneath
benefactor: benefactor,benefactors
beneficence: beneficence
beneficial: beneficial
benefit: benefit,benefits
benevolence: benevolence
benevolent: benevolent
benevolently: benevolently
benignity: benignity
bent: bent
benumb: benumbed
bernard: bernard
berry: berries
beseech: besought
besiege: besieged
bespoke: bespoke
bestow: bestow,bestowed,bestowing
betake: betook
betray: betray,betrayed
beware: beware
bewilder: bewildered
bid: bade,bid,bidding,bids
bier: bier
bind: bind,binding,bound
bird: bird,birds
biron: biron
birth: birth
bitter: bitter,bitterest
bitterly: bitterly
bitterness: bitterness
black: black,blackest
blackbird: blackbird
blackness: blackness
blamable: blamable
blame: blame
blameless: blameless
blanc: blanc
blanket: blankets
blast: blast,blasted
bleak: bleak
bleakness: bleakness
bless: bless,blessed
blessed: blessed
blessing: blessing,blessings
blight: blight
blind: blind,blinded
blindness: blindness
bliss: bliss
blood: blood
bloodless: bloodless
bloodshed: bloodshed
bloody: bloody
bloom: bloom,bloomed,blooming
blossom: blossom
blot: blot,blotted
blow: blew,blow,blows
blue: blue
blunt: blunt
board: board
boarder: boarder
boast: boast
boat: boat,boats
bodily: bodily
body: bodies,body
boil: boils
bold: bold
bolt: bolt,bolts
bond: bonds
bondage: bondage
bone: bone,bones
book: book,books
bosom: bosom,bosoms
bound: bounded,bounding,bounds
boundary: boundaries,boundary
boundless: boundless
bounty: bounty
bourne: bourne
bow: bowing
boy: boy
boyhood: boyhood
brace: braces
braid: braided
brain: brain
brake: brake
bramble: brambles
branch: branch,branches
brand: brand
brandy: brandy
brave: brave
brawl: brawling
bread: bread
break: break,breaking,broke,broken
breaker: breakers
breakfast: breakfast
breaking: breaking
breast: breast
breath: breath
breathe: breathe,breathed
breathless: breathless
breed: bred
breeze: breeze,breezes
brethren: brethren
bridal: bridal
bride: bride,brides
bridge: bridge
bright: bright,brightest
brightly: brightly
brightness: brightness
brilliant: brilliant
bring: bring,bringing,brought
brink: brink
britain: britain
broad: broad
broken: broken
brood: brooded
brooding: brooding
brook: brook
brother: brother,brothers
brotherly: brotherly
brow: brow,brows
bruise: bruised
brutality: brutality
brute: brute
bud: bud,budding,buds
buffet: buffeted
build: built
building: building,buildings
burden: burden,burdened
burn: burn,burned,burning,burns,burnt
burning: burning
burst: burst,bursting
bury: buried,bury
bush: bushes
busily: busily
business: business
bustle: bustle
busy: busied,busier,busy
cabin: cabin
cabinet: cabinets
cabriolet: cabriolet
cadence: cadence
cake: cake
calamity: calamities,calamity
calculate: calculated,calculating
calculation: calculations
callous: callous
calm: calm,calmed,calmer
calmly: calmly
calmness: calmness
campagne: campagne
candle: candle
candour: candour
canopy: canopied,canopy
canst: canst
canvass: canvassed
capable: capable
capacious: capacious
capacity: capacities,capacity
cape: cape
capitulate: capitulated
caprice: caprice,caprices
captain: captain
captive: captive
care: care,cares
career: career
carefully: carefully
careless: careless
carelessly: carelessly
carelessness: carelessness
caress: caresses
carnage: carnage
caroline: caroline
carpet: carpeted
carriage: carriage,carriages
carry: carried,carry,carrying
casement: casement
cast: cast,casting
castle: castle,castles
casualty: casualties
catalogue: catalogue
cataract: cataract
catastrophe: catastrophe
catch: catching,caught
catholic: catholic
causation: causation
caution: caution
cave: cave,caves
cease: cease,ceased,ceasing
celebrated: celebrated
celestial: celestial
cell: cell
cemetery: cemetery
centre: centre,centred
century: century
ceremony: ceremony
certainty: certainty
chain: chain,chained,chains
chair: chair,chairs
chaise: chaise
chamber: chamber
chamois: chamois
chance: chance,chanced,chances
change: change,changed,changing
changeable: changeable
channel: channel
chapter: chapter
character: character,characters
characterise: characterise
characteristically: characteristically
charge: charge,charged,charging
charity: charity
charles: charles
charm: charm,charmed,charms
charming: charming
charnel: charnel
chase: chase
chasm: chasms
chasten: chastened
chastise: chastise
chatter: chattered
cheat: cheat
check: check,checked
cheek: cheek,cheeks
cheer: cheered,cheering
cheerful: cheerful
cheerfully: cheerfully
cheerfulness: cheerfulness
cheering: cheering
cheese: cheese
chemical: chemical
chemist: chemist,chemists
chemistry: chemistry
cherish: cherish,cherished
cherub: cherub
chief: chief
chiefly: chiefly
child: child,children
childhood: childhood
childish: childish
childless: childless
chill: chill
chilled: chilled
chilly: chilly
chimera: chimera,chimeras
chimerical: chimerical
chimney: chimney
chink: chink,chinks
chivalrous: chivalrous
chivalry: chivalry
choice: choice,choicest
choke: choked
choose: choose,chosen
chord: chord
christian: christian
christianity: christianity
church: church
churchyard: churchyard
circle: circle
circulate: circulates
circumstance: circumstance,circumstances
circumstantial: circumstantial
citadel: citadel
city: city
civilised: civilised
claim: claim,claimed,claims
clap: clapped
clapping: clapping
clasp: clasp,clasping
clasped: clasped
class: class,classes
classification: classifications
clay: clay
clean: clean
cleaning: cleaning
clearness: clearness
clemency: clemency
clever: clever
cliff: cliffs
climate: climate
climb: climbing
clime: climes
cling: cling,clinging,clings,clung
cloak: cloak
clock: clock
close: close,closed,closer,closest
closely: closely
closing: closing
clothe: clad,clothed
clothes: clothes
clothing: clothing
cloud: cloud,clouded,clouds
clouded: clouded
cloudless: cloudless
clouds: clouds
cloudy: cloudy
clue: clue
clump: clump
coach: coach
coarse: coarse,coarser,coarsest
coast: coast,coasting
code: code
coffin: coffin
coincidence: coincidences
cold: cold
coldness: coldness
colleague: colleague
collect: collect,collected,collecting
collection: collections
college: college,colleges
cologne: cologne
colonization: colonization
colour: colour,colours
combat: combat
combine: combined
combustible: combustibles
comfort: comfort
comfortable: comfortable
comforter: comforter
comfortless: comfortless
command: command,commanded
commence: commence,commenced,commences
commencement: commencement
comment: comment
commerce: commerce
commiserate: commiserate
commission: commission
commit: commit,committed,committing
common: common
communicate: communicate,communicated,communicating
communication: communication
communion: communion
community: community
compact: compact
companion: companion,companions
companionship: companionship
company: company
comparable: comparable
comparative: comparative
compare: compared
compass: compass
compassed: compassed
compassion: compassion
compassionate: compassionate,compassionated
compensate: compensate,compensated
competent: competent
complacency: complacency
complain: complain,complained
complaint: complaints
complete: complete,completed,completes
completely: completely
completion: completion
complex: complex
complexion: complexion,complexions
complexity: complexity
comply: complied,comply
compose: compose,composed,composes,composing
composure: composure
comprehend: comprehend,comprehended
comprehensive: comprehensive
comprise: comprised
comrade: comrades
conceal: conceal,concealed,concealing
concealment: concealment
concede: concede
conceited: conceited
conceive: conceive,conceived,conceiving
concentrated: concentrated
conception: conception
concern: concern,concerned
concert: concert
conciliate: conciliating
conciliating: conciliating
conclude: conclude,concluded
conclusion: conclusion,conclusions
concussion: concussion
condemn: condemn,condemned,condemns
condemnation: condemnation
condescension: condescension
condition: condition,conditions
conduce: conduce
conducive: conducive
conduct: conduct,conducted,conducting
conductor: conductor,conductors
confer: confer
confess: confess,confessed,confessing
confession: confession
confessor: confessor
confide: confide,confided
confidence: confidence
confident: confident
confidential: confidential
confine: confine,confined
confinement: confinement
confines: confines
confirm: confirm,confirmed,confirms
confirmation: confirmation
confiscate: confiscated
conflagration: conflagration
conflict: conflict,conflicting
conformation: conformation
confused: confused
confusedly: confusedly
confusion: confusion
congeal: congeal
congenial: congenial
congratulatory: congratulatory
congregate: congregated
conjecture: conjecture,conjectured,conjectures
conjure: conjure,conjured
connect: connected
connected: connected
connection: connection
conquer: conquer,conquered
conscience: conscience
conscious: conscious
consciousness: consciousness
consecrate: consecrate,consecrated
consent: consent,consented
consequence: consequence,consequences
considerable: considerable
considerably: considerably
considerate: considerate
considerateness: considerateness
consideration: consideration,considerations
consist: consist,consisted
consistent: consistent
consolation: consolation
console: console,consoled,consoles
constant: constant
constantinople: constantinople
constantly: constantly
consternation: consternation
constrain: constrained
construct: construct,constructed
construe: construed
consult: consulted
consume: consume,consumed,consumes
consummate: consummate,consummated
consummation: consummation
consumption: consumption
contemplate: contemplate,contemplated
contemplation: contemplation
contempt: contempt
content: content
contented: contented
contention: contention
contentment: contentment
contents: contents
contest: contest
continual: continual
continually: continually
continuation: continuation
continue: continue,continued,continuing
continuing: continuing
contortion: contortions
contradictory: contradictory
contrary: contrary
contrast: contrast
contribute: contributed,contributes
contrived: contrived
control: control
contumely: contumely
convalescence: convalescence
convenience: convenience
conveniently: conveniently
convent: convent
conversation: conversation,conversations
converse: converse,conversed,conversing
convey: convey,conveyed,conveys
convict: convict,convicted
conviction: conviction
convince: convinced
convinced: convinced
convulse: convulsed
convulsion: convulsions
convulsive: convulsive
cooking: cooking
cool: cool
coolness: coolness
coop: cooped
cope: cope
cord: cord
cordial: cordial
core: core
cornelius: cornelius
corner: corner
corpse: corpse
correct: corrected
correspondence: correspondence
corruption: corruption
cot: cot
cottage: cottage,cottages
cottager: cottager,cottagers
counsel: counsel
counsellor: counsellors
countenance: countenance,countenances
countless: countless
country: countries,country
countryman: countryman,countrymen
courage: courage
courageous: courageous
court: court
courtyard: courtyard
cousin: cousin,cousins
cover: covered,covers
covet: coveted
cow: cow,cows
coward: coward,cowards
cowardice: cowardice
crack: cracked,cracking
crag: crags
cramp: cramped
crash: crash
craving: craving
crawl: crawled,crawling
creak: creaking
create: create,created,creates,creating
creation: creation,creations
creator: creator,creators
creature: creature,creatures
credit: credit,credited
creek: creek
creep: crept
crevice: crevice,crevices
crew: crew
crime: crime,crimes
criminal: criminal
criminality: criminality
critical: critical
croak: croaking
cross: cross,crossed,crossing
crowd: crowd,crowded,crowding
crown: crown
crucible: crucible
cruel: cruel,cruellest
cruelly: cruelly
cruelty: cruelty
crush: crush,crushed
cull: culled
cultivate: cultivated,cultivating
cultivation: cultivation
cumberland: cumberland
cup: cup
curb: curbed
curdle: curdles
cure: cure
curiosity: curiosities,curiosity
curious: curious
curiously: curiously
curl: curling
current: current
curse: curse,cursed,curses
cursed: cursed
cursory: cursory
curtain: curtain
custom: custom,customs
cut: cut
cypress: cypress
dabble: dabble,dabbled
dagger: dagger
daily: daily
damp: damp,damps
dance: danced,dancing
danger: danger,dangers
dangerous: dangerous
dangerously: dangerously
daniel: daniel
dank: dank
dante: dante
dark: dark
darken: darkened
darkness: darkness
darling: darling
dart: darted
dash: dash,dashed,dashing
daughter: daughter
dauntless: dauntless
dawn: dawn,dawned
day: day,days
daybreak: daybreak
daydream: daydreams
daylight: daylight
dazzle: dazzled
dazzling: dazzling
dead: dead
deadly: deadly
deal: deal
dealing: dealing
dearest: dearest
dearly: dearly
death: death,deaths
deathbed: deathbed
deathlike: deathlike
debar: debar,debarred
debasing: debasing
debilitate: debilitated
debility: debility
debt: debts
decay: decay,decayed,decaying
deceit: deceit
deceive: deceived
december: december
decide: decide,decided,decides
decidedly: decidedly
decipher: decipher
decision: decision
decisive: decisive
deck: deck
declamatory: declamatory
declaration: declaration
declare: declare,declared
decline: decline,declined,declining
decoration: decorations
decrease: decreased,decreasing
decree: decreed
dedicate: dedicate,dedicated
deduce: deduce,deduced
deed: deed,deeds
deem: deem,deemed
deep: deep,deeper,deepest
deeply: deeply
deer: deer
defeat: defeat
defect: defects
defence: defence
defend: defend
defer: deferred
deference: deference
defiance: defiance
define: define
deform: deformed
deformity: deformity
degenerate: degenerating
degradation: degradation
degrade: degraded
degree: degree,degrees
dejected: dejected
dejection: dejection
delay: delay,delayed
delicacy: delicacy
delicate: delicate
delicious: delicious
delight: delight,delighted,delights
delighted: delighted
delightful: delightful
delineate: delineate
delirium: delirium
deliver: deliver,delivered
deliverer: deliverer
delusion: delusion
demand: demand,demanded,demands
demeanour: demeanour
demoniacal: demoniacal
demonstrate: demonstrate
den: dens
denial: denial
denote: denote
denounce: denounce
dense: dense
deny: denied,deny
depart: depart,departed
department: department
departure: departure
depend: depend,depended,depending
dependent: dependent
deplore: deplored
depose: deposed
deposit: deposited,depositing
deposition: deposition
depraved: depraved
depravity: depravity
deprecate: deprecate
depress: depressed
depressed: depressed
deprive: deprived,deprives
depth: depth
depths: depths
deputation: deputation
derange: derange,deranged
derby: derby
derive: derive,derives
descend: descend,descended,descending,descends
descent: descent
description: description
desert: desert,deserted,deserts
deserted: deserted
desertion: desertion
deserve: deserve
deserved: deserved
deserving: deserving
design: design,designed,designs
desire: desire,desired,desires,desiring
desirous: desirous
desolate: desolate,desolated
desolated: desolated
desolating: desolating
desolation: desolation
despair: despair
despaired: despaired
despairing: despairing
desperate: desperate
desperately: desperately
desperation: desperation
despicable: despicable
despise: despise,despised
despond: despond,desponding
despondence: despondence
despondency: despondency
despondent: despondent
desponding: desponding
destination: destination
destine: destined
destiny: destiny
destitute: destitute
destroy: destroy,destroyed,destroying
destroyer: destroyer
destruction: destruction
destructive: destructive
detain: detain
detect: detect
determination: determination
determine: determined,determining
determined: determined
detest: detest,detested
detestable: detestable
detestation: detestation
detract: detracts
detrimental: detrimental
develop: developed
development: development
deviate: deviating
device: devices
devil: devil,devils
devilish: devilish
devolve: devolved
devote: devote,devoted,devoting
devoted: devoted
devotion: devotion
devour: devoured,devouring
devouring: devouring
dew: dew,dews
diabolical: diabolical
diabolically: diabolically
dialect: dialects
dialogue: dialogue
dictate: dictate,dictated
die: die,died,dying
diet: diet
difference: difference
difficult: difficult
difficulty: difficulties,difficulty
diffidence: diffidence
diffident: diffident
diffuse: diffused,diffusing
dig: digging
dignity: dignity
dilatoriness: dilatoriness
dilatory: dilatory
diligence: diligence,diligences
dim: dim,dimmed,dimming
dimple: dimples
dinner: dinner
dire: dire
direct: direct,directed
direction: direction,directions
dirge: dirge
dirt: dirt
disappear: disappeared
disappointed: disappointed
disappointment: disappointment,disappointments
disaster: disaster,disasters
disastrous: disastrous
disbelief: disbelief
discern: discerned,discerning
discernment: discernment
discharge: discharge
disciple: disciple
discipline: discipline
disclose: disclose,disclosed
discompose: discompose
disconcert: disconcerted
disconsolate: disconsolate
discontent: discontent
discontented: discontented
discourse: discourse
discover: discover,discovered,discovering
discoverer: discoverers
discovery: discoveries,discovery
discrimination: discrimination
disdain: disdain
disease: disease
disencumber: disencumbered
disgrace: disgrace
disguise: disguise
disgust: disgust
disgusted: disgusted
disgusting: disgusting
disinclined: disinclined
disinterested: disinterested
disk: disk
dislike: dislike,disliked
dismal: dismal
dismally: dismally
dismay: dismay
dismiss: dismissed,dismissing
dismount: dismount
disobey: disobey
disorder: disorder
disown: disowned
dispatch: dispatched
dispel: dispel,dispelled,dispelling
disperse: dispersed
display: displayed,displaying,displays
dispose: disposed
disposition: disposition,dispositions
dispute: dispute
disquiet: disquiet,disquieted
disquisition: disquisition,disquisitions
disregard: disregard
dissect: dissect
dissecting: dissecting
dissipate: dissipate,dissipated,dissipates
dissoluble: dissoluble
dissuade: dissuade
distance: distance
distant: distant
distaste: distaste
distemper: distemper
distinct: distinct
distinction: distinction
distinctly: distinctly
distinguish: distinguish,distinguished,distinguishing
distinguished: distinguished
distort: distorted
distorted: distorted
distraction: distraction
distress: distress
distressing: distressing
distribute: distributed,distributing
district: district
distrust: distrust,distrusted
disturb: disturb,disturbed,disturbs
disturbed: disturbed
disunion: disunion
diversity: diversity
divert: divert,diverted
divine: divine,divinest
divinely: divinely
division: division
divulge: divulged
dizzy: dizzy
docile: docile
dog: dog,dogs
dogmatism: dogmatism
dome: dome,domes
domestic: domestic
dominion: dominion,dominions
doom: doomed
door: door,doors
dormant: dormant
dote: doted,doting
doth: doth
double: double
doubly: doubly
doubt: doubt,doubted,doubts
doubtless: doubtless
downcast: downcast
downstairs: downstairs
doze: dozing
dozen: dozen
drag: drag,dragged,dragging
draught: draught
draw: draw,drawing,drawn,drew
drawer: drawer
dread: dread,dreaded,dreading
dreaded: dreaded
dreadful: dreadful
dreadfully: dreadfully
dream: dream,dreaming,dreams,dreamt
dreary: dreary
drench: drenched
dress: dress,dressed
drift: drifted,drifting
drink: drink,drunk
drive: drive,driven,drove
drop: drop,dropped,dropping,drops
dross: dross
drown: drowned
drug: drug
drunk: drunk
drunken: drunken
dry: dried,dry
du: du
dull: dull
dun: dun
dungeon: dungeon,dungeons
duration: duration
dusk: dusk
dusky: dusky
dust: dust
dutch: dutch
duty: duties,duty
dwell: dwell,dwelling,dwelt
dwelling: dwelling
eager: eager
eagerly: eagerly
eagerness: eagerness
eagle: eagle
ear: ear,ears
earn: earn
earnest: earnest
earnestly: earnestly
earnestness: earnestness
earth: earth
earthquake: earthquake
ease: ease
easily: easily
east: east
eastern: eastern
easy: easier
eat: ate,eat,eaten
eccentricity: eccentricities
echo: echoed
ecstasy: ecstasy
ecstatic: ecstatic
edge: edge,edges
edinburgh: edinburgh
educate: educate,educated
education: education
efface: efface
effectual: effectual
effort: effort
effusion: effusions
eighteenth: eighteenth
elapse: elapsed
elasticity: elasticity
eld: elder,eldest
elder: elder
electricity: electricity
element: element,elements
elemental: elemental
elementary: elementary
elevate: elevate,elevated,elevates,elevating
elevated: elevated
elevation: elevation
elixir: elixir
elizabeth: elizabeth
eloquence: eloquence
eloquent: eloquent
elude: elude,eluded
emaciate: emaciated
emaciated: emaciated
embark: embark,embarked,embarks
embarkation: embarkation
ember: embers
embittered: embittered
emblem: emblem
embrace: embrace,embraced
emergency: emergencies,emergency
emigration: emigration
eminently: eminently
emotion: emotion,emotions
empire: empire,empires
empires: empires
employ: employ,employed
employment: employment,employments
emulate: emulate
emulation: emulation
enable: enable,enabled
enchant: enchanted
enchanting: enchanting
enchantment: enchantment
encomium: encomiums
encompass: encompassed
encounter: encounter,encountered,encountering
encourage: encourage,encouraged
encouraging: encouraging
endanger: endangered
endear: endeared
endeavour: endeavour,endeavoured,endeavouring
endless: endless
endow: endow,endowed
endowment: endowments
endue: endued
endurance: endurance
endure: endure,endured,enduring
enemy: enemies,enemy
energetically: energetically
energy: energies,energy
enfranchise: enfranchised
engage: engage,engaged,engages,engaging
engagement: engagement
england: england
english: english
englishman: englishman,englishmen
engross: engrossed
enhance: enhanced
enigmatic: enigmatic
enjoin: enjoined
enjoy: enjoy,enjoyed,enjoying,enjoys
enjoyment: enjoyment,enjoyments
enkindle: enkindled
enlighten: enlightened
ennui: ennui
enormity: enormity
enounce: enounced
enquire: enquired
enrage: enraged
enraged: enraged
enrapture: enraptured
enraptured: enraptured
enslave: enslave,enslaved
ensue: ensued,ensuing
ensure: ensure
enter: enter,entered,entering,enters
enterprise: enterprise
entertain: entertain,entertained
enthusiasm: enthusiasm
enthusiastic: enthusiastic
entice: enticed
enticement: enticement,enticements
enticing: enticing
entire: entire
entitle: entitled
entrance: entrance,entranced
entrancingly: entrancingly
entreat: entreat,entreated,entreating
entreaty: entreaties
entrench: entrench
enunciation: enunciation
envelop: envelop,enveloped
environs: environs
envy: envy
ephemeral: ephemeral
epithet: epithets
epoch: epoch
equal: equal,equalled,equals
equally: equally
equitable: equitable
era: era
eradicate: eradicated,eradicating
erect: erect
ernest: ernest
erroneous: erroneous
erroneously: erroneously
error: errors
escape: escape,escaped,escapes
especial: especial
establish: established
esteem: esteem,esteemed
eternal: eternal
eternally: eternally
eternity: eternity
eulogy: eulogy
europe: europe
european: european
evade: evaded
eve: eve
evening: evening
event: event,events
eventful: eventful
eventual: eventual
everlasting: everlasting
everyday: everyday
evidence: evidence
evidently: evidently
evil: evil,evils
evince: evinced
exalt: exalted
examination: examination
examine: examine,examined,examining
exasperate: exasperate,exasperated
exceed: exceed,exceeded
exceedingly: exceedingly
excellence: excellence
excellent: excellent
exception: exception
excess: excess
excessive: excessive
excessively: excessively
exchange: exchange,exchanged
excite: excite,excited,excites
excited: excited
excitement: excitements
exciting: exciting
exclaim: exclaim,exclaimed
exclamation: exclamation,exclamations
exclude: excluded
excommunication: excommunication
exculpate: exculpated
excursion: excursion
excuse: excuse
execrate: execrate,execrated
execration: execration
execute: execute,executed,executing
execution: execution
exemplify: exemplified
exempt: exempt
exercise: exercise,exercised
exert: exert,exerted,exerting
exertion: exertion,exertions
exhaust: exhausted
exhausted: exhausted
exhaustion: exhaustion
exhibit: exhibit,exhibited
exhilarate: exhilarated
exhortation: exhortations
exile: exile
exist: exist,existed,existing,exists
existence: existence
exordium: exordium
exotic: exotic
expand: expanded,expanding
expanse: expanse
expect: expect,expected
expectation: expectation,expectations
expedite: expedite
expedition: expedition,expeditions
experience: experience,experienced
experienced: experienced
experiment: experiment,experiments
experimentalist: experimentalist
expiration: expiration
expire: expire
explain: explain,explained,explaining
explanation: explanation,explanations
explode: exploded
exploit: exploit
explore: explore
expose: exposed,exposing
expostulate: expostulate
express: express,expressed
expression: expression,expressions
expressive: expressive
exquisite: exquisite
exquisitely: exquisitely
extend: extended
extended: extended
extensive: extensive
extent: extent,extents
external: external
extinct: extinct
extinction: extinction
extinguish: extinguish,extinguished
extort: extort
extract: extract,extracting
extraordinary: extraordinary
extreme: extreme,extremes,extremest
extremely: extremely
extremity: extremities,extremity
extricate: extricate
exult: exult,exulting
exultation: exultation
eye: eye,eyes
eyeball: eyeballs
eyed: eyed
eyelash: eyelashes
facile: facile
facilitate: facilitated
facility: facility
faculty: faculties,faculty
fade: fade,faded
fail: fail,failed,failing
failure: failure
faint: faint,fainted,fainter,fainting
faintness: faintness
fair: fair,fairer,fairest
fairy: fairy
faith: faith
faithful: faithful
falkland: falkland
fall: fall,fallen,falling,fell
fallen: fallen
false: false
falsehood: falsehood
falsely: falsely
falter: faltering
fame: fame,famed
familiar: familiar
familiarise: familiarised
familiarity: familiarity
familiarly: familiarly
family: families,family
famine: famine
fan: fan,fanned
fancied: fancied
fanciful: fanciful
fancy: fancies,fancy,fancying
fang: fangs
fare: fare
farewell: farewell
farm: farm
farmer: farmer
farmhouse: farmhouse
fashion: fashion,fashioned
fast: fast
fastidious: fastidious
fatal: fatal
fatality: fatality
fatally: fatally
fate: fate
fated: fated
father: father
fatigue: fatigue,fatigues,fatiguing
fatigued: fatigued
fault: faults
faultiness: faultiness
faulty: faulty
favour: favour
favourable: favourable
favourite: favourite
fear: fear,feared,fearing,fears
fearful: fearful
fearfully: fearfully
fearless: fearless
feature: feature,features
february: february
fee: fee
feeble: feeble
feebly: feebly
feel: feel,feeling,feels
feeling: feeling,feelings
feint: feint
felix: felix
fellow: fellow,fellows
fellowship: fellowship
female: female,females
feminine: feminine
fertile: fertile
fervent: fervent
fervently: fervently
fervour: fervour
fester: festering
festival: festival
fetter: fetter,fettered
fever: fever
feverish: feverish
fibre: fibre,fibres
fidelity: fidelity
field: field,fields
fiend: fiend
fiendish: fiendish
fierce: fierce
fierceness: fierceness
fight: fight,fought
figure: figure,figures
filial: filial
film: film
filthy: filthy
final: final
finally: finally
fine: fine,finest
finger: finger,fingers
finish: finish,finished
fireside: firesides
firm: firm,firmest
firmly: firmly
firmness: firmness
fish: fish,fishing
fisher: fishers
fisherman: fishermen
fishing: fishing
fit: fit,fits,fitted,fitter
fitness: fitness
fitting: fitting
flagrant: flagrant
flame: flame,flames
flannel: flannel
flash: flash,flashed,flashes
flat: flat
flee: fled
flesh: flesh
flight: flight
fling: flung
flit: flit,flitted
float: float,floated,floating
flood: flood
floor: floor
florin: florins
flounder: floundering
flourish: flourished,flourishing
flow: flow,flowed,flowing,flows
flower: flower,flowers
flowery: flowery
fluctuate: fluctuate,fluctuating
flush: flushed
fly: flew,fly,flying
foe: foe,foes
fog: fog
fold: folds
foliage: foliage
folk: folks
follow: follow
follower: followers
folly: folly
fond: fond
fondly: fondly
fondness: fondness
food: food
fool: fool
foolish: foolish
foot: feet,foot
footed: footed
footstep: footsteps
forbear: forbear
forbid: forbid,forbidden
force: force,forced,forces,forcing
forcible: forcible
forcibly: forcibly
foreboding: forebodings
forehead: forehead
foreign: foreign
foresee: foresaw
forest: forest,forests
foretaste: foretaste
forget: forget,forgetting,forgot,forgotten
forgetfulness: forgetfulness
forgive: forgive
forgo: forgo
fork: forked
form: form,formed,forms
formation: formation
formidable: formidable
forsake: forsaken,forsakes
fort: fort
fortification: fortifications
fortify: fortify
fortitude: fortitude
fortnight: fortnight
fortunate: fortunate
fortunately: fortunately
fortune: fortune,fortunes
foster: foster
fosterage: fosterage
foundation: foundations
founder: founders
fountain: fountain
fourteen: fourteen
fragment: fragment
frail: frail
frame: frame,framed
france: france
frank: frank
frankenstein: frankenstein
frankness: frankness
frantic: frantic
fraud: fraud
fraught: fraught
freedom: freedom
freely: freely
freeze: freezing,frozen
french: french
frenchwoman: frenchwoman
frenzy: frenzy
frequent: frequent
frequently: frequently
fresh: fresh
fret: fretting
friend: friend,friends
friendless: friendless
friendship: friendship
frighten: frightened
frightful: frightful
fringe: fringed
frog: frogs
frontier: frontiers
frost: frost,frosts
frosty: frosty
frown: frowns
frowning: frowning
frozen: frozen
fruitless: fruitless
fruitlessly: fruitlessly
fuel: fuel
fugitive: fugitives
fulfil: fulfil,fulfilled,fulfilling
fulfilment: fulfilment
function: functions
fund: fund
funeral: funeral
fur: furs
furious: furious
furiously: furiously
furnish: furnished
furniture: furniture
furtherance: furtherance
fury: furies,fury
futile: futile
futility: futility
future: future
futurity: futurity
gaiety: gaiety
gain: gain,gained
gait: gait
gale: gale,gales
gall: gall
gallant: gallant
gallery: gallery
galvanism: galvanism
game: game
gaoler: gaolers
garb: garb
garden: garden,gardens
gardener: gardener
gasp: gasped
gate: gates
gather: gather,gathered
gaunt: gaunt
gay: gay
gaze: gaze,gazed,gazes,gazing
generation: generation,generations
generosity: generosity
generous: generous
geneva: geneva
genevan: genevan
genevese: genevese
genial: genial
genius: genius
gentle: gentle
gentleman: gentleman
gentleness: gentleness
gently: gently
geography: geography
german: german,germans
germany: germany
gesticulation: gesticulations
gesture: gesture,gestures
ghastly: ghastly
ghost: ghosts
giant: giant
gibe: gibe
gift: gift
gigantic: gigantic
gilded: gilded
girl: girl
giver: giver
glacier: glacier,glaciers
glad: glad
gladly: gladly
gladness: gladness
glance: glance
glare: glared,glaring
glen: glens
glide: glide,glided
glimmer: glimmer,glimmering,glimmers
glimpse: glimpse
glitter: glittering
globe: globe
gloom: gloom
gloomily: gloomily
gloomy: gloomy
glorious: glorious
glory: gloried,glory
glow: glow,glowed,glowing
glut: glut,glutted
gnash: gnashed,gnashes
gnashing: gnashing
god: god,gods
godlike: godlike
godwin: godwin
gold: gold
golden: golden
goodness: goodness
goring: goring
gospel: gospel
gossip: gossip
govern: governed,governing
government: government,governments
grace: grace
graceful: graceful
grade: grades
gradually: gradually
grand: grand
grandeur: grandeur
grant: grant
grapple: grapple,grappling
grasp: grasp,grasped,grasping
grass: grass
grate: grate,grated
grateful: grateful
gratification: gratification
gratify: gratified,gratify
gratifying: gratifying
gratitude: gratitude
grave: grave,graves
greatly: greatly
greatness: greatness
grecian: grecians
greece: greece
greedily: greedily
greek: greek,greeks
green: green
greenland: greenland
greenwich: greenwich
greeting: greeting
grey: grey
grief: grief,griefs
grieve: grieve,grieved
grievously: grievously
grin: grin
grind: ground
groan: groan,groaned,groans
ground: ground
groundwork: groundwork
grovel: grovel
grow: grew,grow,grown
growth: growth
grudge: grudge
gruff: gruff
guard: guarded,guards
guardian: guardian,guardians
guess: guess,guessed,guessing
guest: guest
guidance: guidance
guide: guide,guided,guiding
guile: guile
guilt: guilt
guiltless: guiltless
guiltlessness: guiltlessness
guilty: guilty
guise: guise
guitar: guitar
gun: gun
gurgle: gurgling
gush: gush,gushed
habit: habit,habits
habitable: habitable
habitation: habitation,habitations
hadst: hadst
haggard: haggard
hail: hail,hailed
hair: hair,hairs
halfway: halfway
hall: hall
halo: halo
hamlet: hamlet
hand: hand,handed,hands
handkerchief: handkerchief
handle: handle
handsome: handsome
handwriting: handwriting
hang: hanging,hangs,hung
hangman: hangman
hapless: hapless
happen: happen,happened,happening
happily: happily
happiness: happiness
happy: happier,happy
harbour: harbour
hard: hard,harder
harden: harden,hardened
hardship: hardship,hardships
hardy: hardy
hare: hare
harem: harem
harm: harm
harmless: harmless
harmony: harmony
harness: harnessed
harrowing: harrowing
harsh: harsh
harvest: harvest
hast: hast
haste: haste
hasten: hasten,hastened
hastily: hastily
hasty: hasty
hate: hate,hated
hateful: hateful
hatred: hatred
haughty: haughty
haunt: haunt,haunted
havoc: havoc
hay: hay
hazard: hazard
head: head
heal: heal,healed
health: health
hear: hear,heard,hearing
hearer: hearer,hearers
heart: heart,hearts
hearted: hearted
heartfelt: heartfelt
heartily: heartily
heartless: heartless
heat: heat
heath: heath,heaths
heatless: heatless
heaven: heaven,heavens
heavenly: heavenly
heavens: heavens
heavily: heavily
heaving: heaving
heavy: heavier,heavy
hedge: hedges
heed: heed,heeded
height: height
hellish: hellish
helpless: helpless
helplessness: helplessness
hemisphere: hemisphere
henceforth: henceforth
henry: henry
herb: herb
herbage: herbage
herd: herd,herds
hero: hero,heroes
heroic: heroic
heroical: heroical
heroism: heroism
hesitate: hesitate,hesitated
hidden: hidden
hide: hidden,hide,hides,hiding
hideous: hideous
hideously: hideously
hideousness: hideousness
hiding: hiding
highland: highlands
highly: highly
hilarity: hilarity
hill: hill,hills
hills: hills
hindrance: hindrance
hinge: hinges
hire: hire,hired
historical: historical
history: histories,history
hitherto: hitherto
hoarse: hoarse
hoarser: hoarser
hold: held,hold,holding,holds
holiday: holiday
holland: holland
holy: holy
homeless: homeless
homer: homer
homeward: homeward
honest: honest
honour: honour
honourable: honourable
honoured: honoured
hope: hope,hoped,hopes,hoping
hopeless: hopeless
horizon: horizon
horrible: horrible
horrid: horrid
horror: horror,horrors
horse: horses
horseback: horseback
hospitality: hospitality
host: host
hot: hot
hour: hour,hours
house: house,houses
household: household
hovel: hovel,hovels
hover: hover,hovered,hovers
howl: howl
hue: hue
huge: huge
human: human
humane: humane
humanity: humanity
humankind: humankind
humid: humid
humour: humour
hundredfold: hundredfold
hundredth: hundredth
hunger: hunger
hungry: hungry
hunt: hunt,hunted
hurricane: hurricane
hurry: hurried,hurries,hurry
hurt: hurt
husband: husband
hush: hushed
hut: hut,huts
hypocritical: hypocritical
hysteric: hysterics
ice: ice,ices
icy: icy
idea: idea,ideas
ideal: ideal
identify: identify
idle: idle
idleness: idleness
idler: idler
idol: idol
ignoble: ignoble
ignominious: ignominious
ignominy: ignominy
ignorance: ignorance
ignorant: ignorant
ignorantly: ignorantly
illiterate: illiterate
illness: illness
illuminate: illuminate,illuminated,illuminating
illustrate: illustrate,illustrated
illustrious: illustrious
image: image,imaged,images
imaginary: imaginary
imagination: imagination,imaginations
imaginative: imaginative
imagine: imagine,imagined
imbibe: imbibed
imbue: imbued
imitate: imitate
imitation: imitation
immaculate: immaculate
immeasurable: immeasurable
immeasurably: immeasurably
immense: immense
immensity: immensity
immerse: immersed
imminent: imminent
immoderate: immoderate
immortal: immortal
immortality: immortality
immure: immured
immutable: immutable
impart: imparted,imparting
impassable: impassable
impassive: impassive
impatience: impatience
impatient: impatient
impatiently: impatiently
impediment: impediment,impediments
impel: impelled
impend: impend
impending: impending
impenetrable: impenetrable
imperatively: imperatively
imperceptible: imperceptible
imperfect: imperfect
imperial: imperial
imperious: imperious
impertinent: impertinent
impervious: impervious
impetuous: impetuous
implement: implements
implore: implores
imply: imply
impose: imposed,imposing
impossibility: impossibilities,impossibility
impossible: impossible
impotence: impotence
impotent: impotent
impracticability: impracticability
impracticable: impracticable
imprecate: imprecate
imprecation: imprecations
impress: impress,impressed
impressed: impressed
impression: impression,impressions
impressive: impressive
imprint: imprinted
imprisonment: imprisonment
improbable: improbable
improve: improved
improvement: improvement,improvements
imprudence: imprudence
imprudently: imprudently
impulse: impulse,impulses
inaccessible: inaccessible
inaction: inaction
inadequate: inadequate
inanimate: inanimate
inapplicable: inapplicable
inarticulate: inarticulate
incalculable: incalculable
incantation: incantations
incapable: incapable
incessantly: incessantly
incident: incident,incidents
incipient: incipient
incite: inciting
incitement: incitement
inclemency: inclemency
inclination: inclination,inclinations
incline: incline
inclined: inclined
include: include,included,includes,including
incoherent: incoherent
incommode: incommoded
incomplete: incomplete
inconceivable: inconceivable
inconsiderate: inconsiderate
inconstant: inconstant
inconvenience: inconvenience,inconveniences
increase: increase,increased,increases,increasing
incredible: incredible
incredulity: incredulity
incredulous: incredulous
incurable: incurable
indebt: indebted
indecent: indecent
indecision: indecision
indefatigable: indefatigable
indelible: indelible
indelibly: indelibly
independence: independence
india: india
indian: indian
indication: indications
indifference: indifference
indifferent: indifferent
indignant: indignant
indignation: indignation
indiscriminately: indiscriminately
indispensable: indispensable
indistinct: indistinct
indolence: indolence
induce: induce,induced
induced: induced
indulge: indulge,indulged,indulging
indulgence: indulgence
industrious: industrious
ineffectual: ineffectual
inequality: inequalities
inestimable: inestimable
inevitable: inevitable
inexhaustible: inexhaustible
inexorable: inexorable
inexperience: inexperience
inexperienced: inexperienced
inexpressible: inexpressible
inextinguishable: inextinguishable
infallible: infallible
infallibly: infallibly
infamy: infamy
infancy: infancy
infant: infant
infantile: infantile
infantine: infantine
infatuation: infatuation
inferior: inferior,inferiors
infidel: infidels
infinite: infinite
infinitely: infinitely
infinity: infinity
infirmity: infirmities
inflame: inflamed
inflict: inflict,inflicted
infliction: infliction
influence: influence,influenced
inform: inform,informed
infuse: infuse,infused,infusing
ingenuity: ingenuity
inglorious: inglorious
ingratitude: ingratitude
inhabit: inhabit,inhabited,inhabits
inhabitant: inhabitant,inhabitants
inherit: inherited
inheritance: inheritance
inhospitably: inhospitably
inhuman: inhuman
injunction: injunction
injure: injure,injured
injurer: injurer
injury: injuries,injury
injustice: injustice
inmate: inmate,inmates
inmost: inmost
inn: inn
innocence: innocence
innocent: innocent
innumerable: innumerable
inquietude: inquietude
inquire: inquired,inquiring
inquirer: inquirer,inquirers
inquiry: inquiries
inquisitive: inquisitive
inquisitiveness: inquisitiveness
inroad: inroads
insanity: insanity
insatiable: insatiable
insatiate: insatiate
inscription: inscription,inscriptions
insect: insect
insensible: insensible
insight: insight
insist: insisted
insolent: insolent
inspect: inspecting
inspire: inspire,inspired,inspiring
inspirit: inspirited,inspiriting
instance: instance,instances
instant: instant,instants
instantly: instantly
instigate: instigate,instigated
instinct: instinct
instinctively: instinctively
institution: institutions
instruct: instructed,instructing
instruction: instruction,instructions
instructor: instructor,instructors
instrument: instrument,instruments
insufficient: insufficient
insult: insulted
insultingly: insultingly
insuperable: insuperable
insupportable: insupportable
insurance: insurance
insurmountable: insurmountable
insurrection: insurrection
integrity: integrity
intellect: intellect
intellectual: intellectual
intelligence: intelligence
intend: intend,intended
intense: intense
intensity: intensity
intention: intention,intentions
intently: intently
intercept: intercept,intercepted
interchange: interchange,interchanging
intercourse: intercourse
interfere: interfere,interfered
interference: interference
interment: interment
intermix: intermixed
internal: internal
interpret: interpret,interpreted
interpretation: interpretation
interpreter: interpreter
interrupt: interrupt,interrupted
interrupted: interrupted
interruption: interruption
intersect: intersected
intersperse: interspersed
intertwine: intertwined
interval: interval,intervals
intervene: intervened,intervening
interview: interview
intimacy: intimacy
intimate: intimate,intimated
intimidate: intimidated
intolerable: intolerable
intonation: intonations
intoxicating: intoxicating
intricacy: intricacies
introduce: introduce,introduced,introducing
introduction: introduction
intrude: intrude
intrusion: intrusion
intuitive: intuitive
inure: inuring
invade: invade
invader: invader
invective: invective
invent: invented
investigate: investigating
invigorate: invigorated
invincible: invincible
invisible: invisible
invitation: invitation
invoke: invoked
involuntarily: involuntarily
invulnerable: invulnerable
ireland: ireland
irish: irish
irksome: irksome
iron: iron
irradiate: irradiated
irradiation: irradiation
irregular: irregular
irremediable: irremediable
irreparable: irreparable
irreproachable: irreproachable
irresistible: irresistible
irresolute: irresolute
irresolution: irresolution
irretrievable: irretrievable
irretrievably: irretrievably
irrevocably: irrevocably
irritability: irritability
isaac: isaac
isis: isis
island: island,islands
islands: islands
isle: isle
issue: issue,issued,issuing
italian: italian,italians
italy: italy
jacket: jacket
jaw: jaws
jeer: jeer
jewel: jewel,jewels
john: john
joint: joint,joints
journal: journal
journey: journey,journeying
joy: joy,joys
joyful: joyful
joyous: joyous
judge: judge,judged,judges
judgement: judgement
judgment: judgment
july: july
jump: jumped
june: june
junior: junior
jura: jura
jury: jury
justice: justice
justified: justified
justify: justified,justify
justine: justine
jut: jutting
keel: keel
keen: keen
keeping: keeping
kennel: kennel
kick: kicked
kid: kid
kill: kill,killed
kindle: kindle,kindled,kindling
kindliness: kindliness
kindly: kindly
kindness: kindness
king: king,kings
kingdom: kingdoms
kinsman: kinsman
kiss: kiss,kissed
kitchen: kitchen
knee: knees
kneel: kneel,kneeling,knelt
knell: knell
knightly: knightly
knock: knocked
knowledge: knowledge
laboratory: laboratory
laborious: laborious
labour: labour,labours
labourer: labourers
lacey: lacey
lady: ladies,lady
lake: lake,lakes
lamb: lamb
lament: lament,lamented
lamentation: lamentations
lamp: lamp
land: land,landed,lands
landing: landing
landscape: landscape
language: language,languages
languid: languid
languish: languishing
languor: languor
lantern: lantern
lap: lap
lapse: lapse
lash: lashes
lassitude: lassitude
lastly: lastly
late: late
latitude: latitude
laudanum: laudanum
laugh: laugh,laughed,laughing
laughter: laughter
law: law,laws
lawgiver: lawgivers
lawless: lawless
lay: laid,lay,laying
lead: lead,led
leader: leader
leaf: leaf,leaves
league: league,leagues
leak: leak
lean: lean,leaning
leap: leaped
learn: learn,learned,learning,learnt
learning: learning
leathern: leathern
leave: leave,leaves,leaving,left
leaved: leaved
lecture: lecture,lectures
lecturing: lecturing
leghorn: leghorn
legible: legible
leisure: leisure
lend: lend
lessen: lessened
lessening: lessening
lesson: lesson,lessons
letter: letter,letters
level: level
liable: liable
liberal: liberal
liberally: liberally
liberate: liberated
liberty: liberty
library: library
lichen: lichen
lick: licked
lid: lids
lie: lie,lies,lying
lieutenant: lieutenant
life: life,lives
lifeless: lifeless
lifelessness: lifelessness
lift: lifted
ligament: ligaments
light: light,lighted,lighter,lights
lighten: lightened
lighthearted: lighthearted
lightning: lightning,lightnings
limb: limb,limbs
limit: limit
lineament: lineaments
linen: linen
linger: lingered,lingering
link: link,linked
lion: lion
lip: lips
list: list
listen: listen,listened,listening
listener: listener
listless: listless
listlessly: listlessly
literally: literally
literary: literary
literature: literature
littleness: littleness
live: live,lived,living
lively: lively
livid: livid
living: living
load: load,loaded
loaf: loaf
loathe: loathed
loathing: loathing
loathsome: loathsome
locality: localities
lock: lock,locking,locks
lofty: lofty
loiter: loitered
london: london
lonely: lonely
longing: longing
loose: loose
lord: lord,lords
lose: lose,lost
loss: loss
lost: lost
lot: lot
loud: loud
loudly: loudly
loudness: loudness
louis: louis
louisa: louisa
love: love,loved
loved: loved
loveliness: loveliness
lovely: lovely
lover: lover,lovers
lucerne: lucerne
lukewarm: lukewarm
lull: lulled,lulling
lullaby: lullaby
lurk: lurked
lustrous: lustrous
luxuriant: luxuriant
luxurious: luxurious
luxury: luxuries,luxury
machination: machinations
machine: machines
mad: mad
madame: madame
maddening: maddening
madly: madly
madman: madman
madness: madness
magic: magic
magistrate: magistrate
magnet: magnet
magnificence: magnificence
magnificent: magnificent
magnitude: magnitude
magnus: magnus
mainland: mainland
maintain: maintained
maintenance: maintenance
majestic: majestic
majesty: majesty
maker: maker
malice: malice
malicious: malicious
malignant: malignant
malignity: malignity
manacle: manacled
mandate: mandate
mangled: mangled
manifest: manifested
manifold: manifold
mankind: mankind
manly: manly
manner: manner
manners: manners
manoir: manoir
mantel: mantel
manuscript: manuscript
map: map
march: march
margaret: margaret
mariner: mariner
mark: mark,marked,marking,marks
market: market
marriage: marriage
married: married
marry: married,marrying
marrying: marrying
martyr: martyrs
marvellous: marvellous
mary: mary
masquerade: masquerades
mass: mass,masses
massacre: massacred,massacring
master: master,masters
match: match
mate: mate,mates
material: material,materials
materially: materially
maternal: maternal
mathematics: mathematics
matter: matter,matters
maw: maw
meadow: meadows
meal: meal
meandering: meandering
meaning: meaning
meanly: meanly
measure: measure,measured,measures
mechanic: mechanics
mechanical: mechanical
mechanism: mechanism
mediation: mediation
medical: medical
medicine: medicine,medicines
meditate: meditate
mediterranean: mediterranean
medium: medium
meed: meed
meet: meet,met
meeting: meeting
melancholy: melancholy
melbourne: melbourne
melt: melt
memorable: memorable
memory: memory
menace: menaced,menaces
mental: mental
mention: mention,mentioned,mentioning
mercenary: mercenary
merchant: merchant,merchants
merchantman: merchantman
merciless: merciless
mercy: mercy
mere: mere
merit: merit,merits
metal: metals
metaphysical: metaphysical
method: method,methods
mexico: mexico
microscope: microscope
middle: middle
midnight: midnight
midst: midst
mien: mien
mighty: mightier,mighty
milan: milan
milanese: milanese
mild: mild
mildly: mildly
mildness: mildness
mile: mile,miles
military: military
milk: milk
mimic: mimic
mind: mind,minds
minded: minded
mingle: mingled,mingling
miniature: miniature
minister: minister,ministered,ministers
minute: minute,minutes,minutest
minutely: minutely
minuteness: minuteness
minutiae: minutiae
miracle: miracle,miracles
miraculous: miraculous
mirror: mirror,mirrored
mischance: mischances
mischief: mischief
misdeed: misdeed
miserable: miserable
miserably: miserably
misery: miseries,misery
misfortune: misfortune,misfortunes
mislead: misled
missile: missile
mist: mist,mists
mistake: mistake
mistaken: mistaken
mistress: mistress
misty: misty
mix: mix
mixture: mixture
mock: mock
mockery: mockery
mode: mode
model: model
moderate: moderate
moderation: moderation
modern: modern
modest: modest
modesty: modesty
modify: modified
modulate: modulated
mole: mole
moment: moment,moments
momentarily: momentarily
momentary: momentary
monarchy: monarchies
monday: monday
money: money
monotonous: monotonous
monster: monster,monsters
monstrous: monstrous
mont: mont
month: month,months
monument: monument,monuments
mood: mood
moon: moon
moonlight: moonlight
moonshine: moonshine
moral: moral
moralize: moralizing
morning: morning
morrow: morrow
mortal: mortal,mortals
mortification: mortification
mother: mother
motion: motion,motioned,motions
motionless: motionless
motive: motive,motives
mould: mould,moulded
moulding: moulding
mount: mounted
mountain: mountain,mountains
mountaineer: mountaineers
mountainous: mountainous
mourn: mourn
mourner: mourner
mournful: mournful
mournfully: mournfully
mourning: mourning
moving: moving
muhammad: muhammad
muhammadan: muhammadan
mule: mule
multifarious: multifarious
multiplicity: multiplicity
multiply: multiplied
multitude: multitude
mummy: mummy
murder: murder,murdered,murdering
murderer: murderer
murderess: murderess
murderous: murderous
murmur: murmur,murmured
murmuring: murmuring
muscle: muscle,muscles
music: music
musical: musical
musty: musty
mutability: mutability
mutable: mutable
mute: mute
mutilate: mutilated
mutiny: mutiny
mutter: muttered
mutual: mutual
myriad: myriads
mysterious: mysterious
mystery: mysteries,mystery
nameless: nameless
naples: naples
narrate: narrated
narration: narration,narrations
narrative: narrative
narrow: narrow,narrowed,narrower
nation: nation,nations
national: national
native: native
natural: natural
nature: nature,natures
naval: naval
navigator: navigators
nearer: nearer
neat: neat,neater
necessity: necessity
neck: neck
needle: needle
neglect: neglect,neglected
negligently: negligently
negotiation: negotiation
neighbour: neighbouring,neighbours
neighbourhood: neighbourhood
nerve: nerves
nervous: nervous
news: news
newton: newton
nice: nicer
niche: niche
niece: niece
night: night,nights
nightingale: nightingale
nightly: nightly
nightmare: nightmare
noble: noble,noblest
nobleman: nobleman
nocturnal: nocturnal
noise: noise
noisome: noisome
noisy: noisy
nonsense: nonsense
nook: nook
noon: noon
north: north
northeast: northeast
northerly: northerly
northern: northern
northward: northward
northwards: northwards
note: notes
notice: notice
nought: nought
nourish: nourished
nourishment: nourishment
novelty: novelties,novelty
november: november
numa: numa
numerous: numerous
nuptial: nuptial
nurse: nurse,nursed
nut: nuts
oak: oak,oaks
oar: oar,oars
oaten: oaten
oath: oath
oatmeal: oatmeal
obdurate: obdurate
obedience: obedience
obedient: obedient
obey: obey,obeying
object: object,objects
oblige: oblige,obliged
obliterate: obliterate,obliterated
oblivion: oblivion
obnoxious: obnoxious
obscure: obscure,obscured
obscurely: obscurely
observation: observations
observe: observe,observed,observing
observer: observer
obstacle: obstacle,obstacles
obstinate: obstinate
obstruct: obstructed
obvious: obvious
occasion: occasion,occasioned,occasions
occupation: occupation,occupations
occupy: occupied,occupy
occur: occur,occurred
occurrence: occurrence,occurrences
ocean: ocean
october: october
odious: odious
offal: offals
offer: offer,offered,offering,offers
office: office,offices
officer: officer
officially: officially
offspring: offspring
oftener: oftener
ogre: ogre
omen: omen
ominous: ominous
omit: omit
omnipotence: omnipotence
omnipotent: omnipotent
onwards: onwards
opaque: opaque
openly: openly
operate: operate
operation: operation,operations
opinion: opinion,opinions
opportunity: opportunity
oppose: opposed,opposing
opposition: opposition
oppress: oppressed,oppresses
oppression: oppression
oppressive: oppressive
opprobrium: opprobrium
orb: orb,orbs
ordinary: ordinary
organ: organs
organization: organization
oriental: oriental
origin: origin
original: original
orphan: orphan
outcast: outcast
outhouse: outhouse
outline: outlines
outrage: outraged,outrages
outward: outward
overcast: overcast
overcome: overcame,overcome
overflow: overflowed,overflowing
overhang: overhanging,overhangs,overhung
overjoyed: overjoyed
overlook: overlook,overlooked,overlooking,overlooks
overpower: overpowered
overpowering: overpowering
overshadow: overshadowed
overspread: overspread
overtake: overtake
overtax: overtaxed
overthrow: overthrow
overweigh: overweigh
overwhelm: overwhelm,overwhelmed
overwhelmed: overwhelmed
overwhelming: overwhelming
owe: owe,owed,owes
owner: owner
oxford: oxford
pace: pace
pacific: pacific
pacing: pacing
pack: pack,packed
packet: packet
paddling: paddling
pail: pail
pain: pain,pains
pained: pained
painful: painful
painfully: painfully
painstaking: painstaking
paint: painted
painter: painters
palace: palace,palaces
pale: pale
pallid: pallid
palpable: palpable
palpitate: palpitate,palpitated
palpitation: palpitation
pane: panes
panegyric: panegyric
pang: pang,pangs
panic: panic
papa: papa
paper: paper,papers
paracelsus: paracelsus
paradise: paradise
paradisiacal: paradisiacal
paramount: paramount
parched: parched
pardon: pardon,pardoning
parent: parent,parents
paris: paris
parliament: parliament
paroxysm: paroxysm,paroxysms
partiality: partiality
partially: partially
participate: participate,participated
particulars: particulars
partly: partly
party: parties,party
pass: pass,passed,passes,passing
passage: passage,passages
passion: passion,passions
passionate: passionate
passionately: passionately
passive: passive
passport: passports
pasture: pasture
patch: patches
paternal: paternal
path: path,paths
pathetic: pathetic
pathless: pathless
pathway: pathways
patience: patience
patient: patient
patiently: patiently
patriarchal: patriarchal
patriot: patriot
patter: pattered
paul: paul
pause: pause,paused,pauses,pausing
pay: paid,pay,paying,pays
pays: pays
peace: peace
peaceable: peaceable
peaceably: peaceably
peaceful: peaceful
peak: peak,peaks
peaked: peaked
pearly: pearly
peasant: peasant,peasants
pebble: pebble
peculiar: peculiar
peculiarly: peculiarly
pedantry: pedantry
pedestrian: pedestrian
peep: peeped,peeping
pen: pen
penalty: penalty
penetrate: penetrate,penetrated
penetration: penetration
penniless: penniless
pensive: pensive
penury: penury
people: peopled
perambulation: perambulations
perceive: perceive,perceived,perceiving
perceptible: perceptible
perceptibly: perceptibly
perception: perceptions
perdition: perdition
perfect: perfect
perfection: perfection
perfectionate: perfectionate
perfectly: perfectly
perform: perform,performed,performs
peril: peril
perilous: perilous
period: period,periods
periodically: periodically
perish: perish,perished
permission: permission
permit: permit,permits,permitted
perpendicular: perpendicular
perpendicularity: perpendicularity
perpendicularly: perpendicularly
perpetrate: perpetrate,perpetrated
perpetual: perpetual
perpetually: perpetually
perplex: perplexed
persecute: persecuted
persecutor: persecutor
perseverance: perseverance
persevere: persevere,persevering
persian: persian
persist: persisted
person: people,person,persons
personal: personal
personally: personally
persuade: persuade,persuaded,persuades,persuading
persuasion: persuasion,persuasions
persuasive: persuasive
pertinacity: pertinacity
perturb: perturbed
peru: peru
peruse: perused
pervade: pervaded
perversity: perversity
pest: pest
petticoat: petticoat
petty: petty
phenomena: phenomena
philosopher: philosopher,philosophers
philosophical: philosophical
philosophy: philosophy
phrase: phrase
phraseology: phraseology
physical: physical
physician: physician
physiognomy: physiognomy
physiology: physiology
pick: picked,picking
picture: picture,pictured,pictures
picturesque: picturesque
piece: piece,pieces
pierce: pierce,pierced,piercing
pig: pig
pile: pile
pilgrimage: pilgrimage
pillow: pillow
pine: pine,pines
pink: pink
pinnacle: pinnacle
piny: piny
pioneer: pioneer
pistol: pistol,pistols
pitchy: pitchy
pitiable: pitiable
pitiless: pitiless
pittance: pittance
pity: pitied,pities,pity
placid: placid
plain: plain,plains
plainly: plainly
plait: plaited
plan: plan,plans
plank: plank,planks
plant: plants
play: play,played,playing,plays
playfellow: playfellow,playfellows
playfully: playfully
playmate: playmate
plaything: plaything
plead: plead
pleasant: pleasant
pleased: pleased
pleasing: pleasing
pleasurable: pleasurable
pleasure: pleasure,pleasures
pledge: pledge
plentiful: plentiful
plenty: plenty
plot: plot
plunge: plunge,plunged
plutarch: plutarch
pocket: pocket
poem: poems
poet: poet,poets
poetry: poetry
poignant: poignant
poignantly: poignantly
poison: poison,poisoned
pole: pole
politic: politic
politics: politics
pollute: polluted,pollutes
pool: pool
poor: poor
popular: popular
population: population
populous: populous
pore: pore
port: port
portend: portend
porter: porter
portion: portion
portmanteau: portmanteau
portrait: portrait
position: position
positively: positively
possess: possess,possessed,possesses,possessing
possession: possession,possessions
possibility: possibility
post: post
posterity: posterity
postpone: postpone,postponed
posture: posture
potent: potent
pour: pour,poured,pouring,pours
poverty: poverty
power: power,powers
powerful: powerful
practical: practical
practically: practically
practice: practice
praise: praise,praised,praises
pray: prayed
prayer: prayer,prayers
precarious: precarious
precaution: precaution,precautions
precede: preceded,preceding
precept: precepts
preceptor: preceptors
precious: precious
precipice: precipice,precipices
precipitate: precipitate,precipitated
precipitation: precipitation
precipitous: precipitous
precisely: precisely
precision: precision
predilection: predilection
prefer: preferred
preference: preference
prejudice: prejudice,prejudiced,prejudices
preliminary: preliminary
prelude: prelude
preparation: preparation,preparations
preparatory: preparatory
prepare: prepare,prepared,preparing
prepossess: prepossess
prescribe: prescribed
presence: presence
presentiment: presentiment
presently: presently
preservation: preservation
preserve: preserve,preserved
preserver: preserver
preside: preside
press: press,pressed
presumption: presumption
pretence: pretence
pretend: pretend,pretended
pretension: pretension
pretty: pretty
prevail: prevail,prevailed
prevent: prevent,prevented,prevents
previous: previous
prey: prey,preyed
price: price
pride: pride
priest: priest
principal: principal
principally: principally
principle: principle,principles
print: print
prison: prison
prisoner: prisoner
private: private
prize: prize,prized
probability: probabilities,probability
probable: probable
proceed: proceed,proceeded,proceeding
proceeding: proceeding
proceedings: proceedings
process: process
proclaim: proclaim
procrastinate: procrastinate
procure: procure,procured
produce: produce,produced,produces
production: production,productions
profane: profane
profession: profession,professions
professional: professional
professor: professor,professors
proficiency: proficiency
profit: profited,profits
profound: profound
profoundly: profoundly
profundity: profundity
progeny: progeny
prognosticate: prognosticate,prognosticated
progress: progress
progressively: progressively
project: project,projects
projector: projectors
prolong: prolong,prolonged,prolonging
prometheus: prometheus
promise: promise,promised,promises,promising
promontory: promontory
pronounce: pronounce,pronounced,pronouncing
pronunciation: pronunciation
proof: proof
propagate: propagated
proper: proper
property: properties,property
prophesy: prophesied
prophetic: prophetic
proportion: proportion,proportions
proportionably: proportionably
proportionate: proportionate
propose: propose,proposed
proposition: proposition
prosecution: prosecution
prospect: prospect
prospects: prospects
prosperity: prosperity
prosperous: prosperous
protect: protect,protecting
protection: protection
protector: protector,protectors
protectress: protectress
protestation: protestations
protract: protracted
protraction: protraction
prove: prove,proved,proves
provide: provide
providence: providence
provision: provision,provisions
provocation: provocation
provoke: provoke
prudence: prudence
prudent: prudent
public: public
publicly: publicly
pull: pulled,pulling
pulpit: pulpit
pulse: pulse,pulses
punish: punish
punishment: punishment
pupil: pupil
purchase: purchase,purchasing
pure: pure,purest
purloin: purloined
purport: purport
purpose: purpose,purposed,purposes
pursue: pursue,pursued,pursues,pursuing
pursuit: pursuit,pursuits
push: push
puzzle: puzzled
pyramid: pyramids
quality: qualities,quality
quantity: quantity
quarter: quarter,quarters
queen: queen
quell: quelling
quench: quenched
question: question,questioned,questions
quick: quick
quiet: quiet,quieted
quietly: quietly
quit: quit,quitted,quitting
quiver: quiver,quivered,quivering
race: race
radiance: radiance
radiant: radiant
raft: raft
rage: rage,raging
ragged: ragged
rain: rain
raise: raise,raised,raises
raising: raising
ramble: ramble,rambled,rambles,rambling
range: range,ranged,ranging
rank: rank,ranked
rankle: rankle,rankling
rapid: rapid
rapidity: rapidity
rapidly: rapidly
rapture: rapture
rapturously: rapturously
rare: rare
rarely: rarely
rash: rash
rashly: rashly
rate: rate
rational: rational
rave: raved
raven: raven
ravenous: ravenous
ravine: ravine,ravines
ravings: ravings
ravish: ravish
ravished: ravished
rawness: rawness
ray: rays
reach: reach,reached
read: read,reading
readier: readier
reading: reading
ready: ready
real: real
realise: realise,realised
reality: realities,reality
reap: reap
reason: reason,reasoned,reasons
reasonable: reasonable
reasoning: reasoning
reassure: reassure,reassured
recall: recall,recalled
recapitulation: recapitulation
receive: receive,received,receiving
receptacle: receptacle
reception: reception
recess: recess,recesses
recital: recital
recognise: recognise,recognised
recollect: recollect,recollected
recollection: recollection,recollections
recommence: recommence,recommencing
recommend: recommended
recompense: recompense,recompensing
reconcile: reconcile,reconciled
record: record,recorded,recording
recourse: recourse
recover: recover,recovered,recovering
recovered: recovered
recovery: recovery
recur: recur,recurred
recurrence: recurrence
red: red
redeem: redeem
redress: redress
reduce: reduced
refer: referred
reference: reference
refine: refined
refined: refined
refinement: refinement
reflect: reflect,reflected,reflecting,reflects
reflection: reflection,reflections
refrain: refrain,refrained
refresh: refreshed
refuge: refuge
refuse: refuse,refused,refusing
regard: regard,regarded
region: region,regions
regret: regret,regretted
regular: regular
regularity: regularity
regularly: regularly
regulate: regulate,regulated
reign: reign,reigned
reiterate: reiterating
reject: rejected
rejoice: rejoice,rejoiced
rejoin: rejoined
rekindle: rekindled
relapse: relapse,relapses
relate: relate,relates,relating
relation: relation,relations
relationship: relationships
relative: relative,relatives
relax: relaxed
relaxed: relaxed
release: release,released
relic: relics
relief: relief
relieve: relieve,relieved
religion: religion,religions
relinquish: relinquish,relinquished,relinquishing
reluctant: reluctant
rely: relied,rely
remain: remain,remained,remaining,remains
remainder: remainder
remains: remains
remark: remark,remarked
remarkable: remarkable
remarkably: remarkably
remedy: remedy
remember: remember,remembered,remembering
remembrance: remembrance
remind: remind,reminded,reminds
remissness: remissness
remnant: remnants
remonstrate: remonstrate
remorse: remorse
remote: remote,remoter,remotest
removal: removal
remove: remove,removed,removes
rend: rending,rends
render: render,rendered,rendering,renders
rendezvous: rendezvous
renew: renew,renewed,renewing
renounce: renounce
renovate: renovating
renowned: renowned
rent: rent
repair: repair,repaired,repairing
repass: repassed
repast: repast
repay: repaid,repay
repeat: repeat,repeated,repeating
repent: repent
repentance: repentance
repentant: repentant
repetition: repetition
repine: repined
replace: replace,replaced
replenish: replenished
replete: replete
reply: replied,reply
report: report,reported
repose: repose,reposed
represent: represented
representation: representations
repress: repressed
reproach: reproach,reproaches
reprobate: reprobated
reproduce: reproduce
republic: republic,republics
republican: republican
repugnance: repugnance
repulse: repulses
repulsive: repulsive
reputation: reputation
request: request,requested
require: require,required,requires
requisite: requisite
requisition: requisition
requite: requited
reread: reread
rescue: rescued
resemblance: resemblance
resemble: resembled,resembling
resentment: resentment
reserve: reserve
reside: reside,resided,residing
residence: residence
resident: residents
resign: resign,resigned
resignation: resignation
resist: resist
resistless: resistless
resolution: resolution,resolutions
resolve: resolve,resolved,resolving
resource: resource,resources
respect: respect,respected,respecting
respectable: respectable
respects: respects
respite: respite
rest: rest,rested,resting,rests
resting: resting
restless: restless
restlessness: restlessness
restoration: restoration
restorative: restorative
restore: restore,restored
restrain: restrain,restrained
restrained: restrained
result: result
resume: resume,resumed
retain: retain,retains
retard: retard,retarded
retire: retire,retired
retirement: retirement
retreat: retreat,retreated,retreats
retribution: retribution
retrod: retrod
retrospect: retrospect
return: return,returned,returning,returns
reveal: reveal,revealed
revel: revel
revenge: revenge
reverberate: reverberated
reverence: reverence
reverential: reverential
reverie: reverie,reveries
reverse: reverse,reverses
revert: reverted
revisit: revisit
revive: revive,revived
revoke: revoke
revolt: revolt
revolution: revolution,revolutions
revolve: revolved
reward: reward,rewarded
rhine: rhine
ribbon: ribbons
rich: rich
riches: riches
ride: riding
ridge: ridges
ridicule: ridicule
rift: rifts
riot: riot
ripen: ripen
ripple: rippling
rise: rise,risen,rising,rose
rival: rival
river: river,rivers
road: road,roads
roam: roaming
roar: roared
roaring: roarings
roasted: roasted
rob: rob,robbed
robert: robert
rock: rock,rocks
rocky: rocky
roll: roll,rolled
roman: roman,romans
romance: romance
romantic: romantic
rome: rome
romulus: romulus
roof: roof
root: rooted,roots
rose: roses
rosy: rosy
rotterdam: rotterdam
rough: rough,rougher
roughly: roughly
rouse: rouse,roused,rouses
route: route
routine: routine
row: row
rowing: rowing
rub: rubbed,rubbing
rudder: rudder
rude: rude
ruffle: ruffled
rugged: rugged
ruggedness: ruggedness
ruin: ruin,ruined,ruins
ruins: ruins
rule: rule,ruled
rumble: rumbling
rush: rush,rushed,rushing
russia: russia
russian: russian
rustic: rustic
rustling: rustling
sacred: sacred
sacrifice: sacrifice,sacrificed
sacrilege: sacrilege
sad: sad,saddest
sadness: sadness
safe: safe
safety: safety
sagacity: sagacity
sail: sail,sailed,sailing,sails
sailor: sailors
saintly: saintly
sake: sake,sakes
sally: sallies
salubrious: salubrious
salutation: salutations
salute: saluted
salvation: salvation
sand: sands
sandy: sandy
sanguinary: sanguinary
sanskrit: sanskrit
satan: satan
satiate: satiate,satiated
satisfaction: satisfaction
satisfied: satisfied
satisfy: satisfied,satisfy,satisfying
savage: savage
save: save,saved
saviour: saviour
savoury: savoury
savoy: savoy
scaffold: scaffold
scale: scale,scaling
scanty: scanty
scarce: scarce
scarcely: scarcely
scare: scared,scaring
scarlet: scarlet
scatter: scattered
scene: scene,scenes
scenery: scenery
scent: scent,scents
scheme: schemes
school: school,schools
schoolboy: schoolboys
schoolfellow: schoolfellow
schoolmaster: schoolmaster
science: science,sciences
scientific: scientific
scion: scion
scoff: scoffing
scoffing: scoffing
scope: scope
scorn: scorn
scotch: scotch
scotland: scotland
scourge: scourge
scraggy: scraggy
scream: scream,screamed
sea: sea,seas
seafaring: seafaring
seal: seal,sealed
seaman: seamen
search: search,searching
seashore: seashore
season: season,seasons
seat: seat,seated,seating
secluded: secluded
seclusion: seclusion
secondary: secondary
secret: secret,secrets
secretly: secretly
secure: secure,secured,securing
securely: securely
security: security
sedulous: sedulous
seek: seek,seeking,sought
seemingly: seemingly
seize: seize,seized,seizing
seizure: seizure
seldom: seldom
select: select,selected
selfish: selfish
selfishness: selfishness
sell: sell
semblance: semblance
send: send,sending
sensation: sensation,sensations
sense: sense
senseless: senseless
sensibility: sensibilities,sensibility
sensibly: sensibly
sensitive: sensitive
sensitiveness: sensitiveness
sentence: sentence,sentences
sentiment: sentiment,sentiments
separate: separated
separation: separation
september: september
sepulchre: sepulchre
serene: serene
serenity: serenity
series: series
seriousness: seriousness
serpent: serpent
servant: servant,servants
serve: serve,serves,serving
service: service,services
serviceable: serviceable
set: set,setting
setting: setting
settle: settled
seventeen: seventeen
severe: severe
severity: severity
sex: sex,sexes
shade: shade,shaded
shades: shades
shadow: shadow,shadows
shake: shake,shaken,shook
shakespeare: shakespeare
shame: shame
shamefully: shamefully
shape: shape,shapes
share: share,shared
shatter: shattered
shattered: shattered
sheet: sheet,sheets
shelley: shelley
shelter: shelter,sheltered
shepherd: shepherd
shift: shifting
shine: shine,shining,shone
ship: ship
shipping: shipping
shiver: shiver,shivering
shock: shock,shocks
shocking: shocking
shoot: shooting,shot
shore: shore,shores
short: short
shorten: shortened
shortly: shortly
shoulder: shoulder,shoulders
shout: shout
shower: shower,showers
shriek: shrieked,shrieks
shrill: shrill
shrine: shrine
shrink: shrank,shrink
shrivel: shrivelled
shroud: shroud
shudder: shudder,shuddered,shuddering
shun: shunned
shut: shut,shutting
shutter: shutters
shutting: shutting
sick: sick
sickbed: sickbed
sicken: sicken,sickened,sickening
sickening: sickening
sickness: sickness
sigh: sigh,sighed
sight: sight,sights
sign: sign,signs
signal: signal
signification: signification
silence: silence
silent: silent
silken: silken
silver: silver
similarity: similarity
simple: simple,simpler,simplest
simply: simply
sin: sinned,sins
sincerely: sincerely
sincerity: sincerity
sing: sang
single: single
singular: singular
singularly: singularly
sinister: sinister
sink: sank,sink,sinking,sinks,sunk
sir: sir
siroc: siroc
sister: sister
sit: sat,sit,sitting
situate: situated
situation: situation,situations
sixteen: sixteen
sixth: sixth
skeleton: skeleton
skiff: skiff
skill: skill
skim: skims
skin: skin
skirt: skirted,skirting
sky: skies,sky
slacken: slackened
slake: slaked
slaughter: slaughter
slave: slave
slavery: slavery
sledge: sledge,sledges
sleep: sleep,sleeping,sleeps,slept
sleeper: sleeper
sleepless: sleepless
slenderly: slenderly
slight: slight,slightest
slip: slipped
slope: sloping
slothful: slothful
slough: slough
slow: slow
slowly: slowly
slumber: slumbers
sly: sly
smell: smelt
smile: smile,smiled,smiles,smiling
smitten: smitten
smoke: smoke
smooth: smooth,smoothed
smother: smothered
snake: snake
snatch: snatched,snatches
snow: snow,snows
snowy: snowy
soar: soar,soaring
sob: sobbed,sobs
social: social
society: society
socket: sockets
sod: sod
soft: soft
soften: soften,softened
softly: softly
softness: softness
soil: soil
soldier: soldier
sole: sole
solely: solely
solemn: solemn
solemnity: solemnity
solicit: solicited
solicitude: solicitude
solid: solid
solitary: solitary
solitude: solitude,solitudes
solon: solon
solve: solve
sombre: sombre
son: son
song: song,songs
soothe: soothe,soothed,soothing
soothing: soothing
sophism: sophisms
sorrow: sorrow,sorrows
sorrowful: sorrowful
sorrowing: sorrowing
sorrows: sorrows
soul: soul,souls
sound: sound,sounded,sounding,sounds
soundly: soundly
soup: soup
source: source,sources
south: south
southern: southern
southwards: southwards
southwesterly: southwesterly
space: space
spanish: spanish
spare: spare,spared
spark: spark
sparkle: sparkled
sparrow: sparrow
speak: speak,speaking,speaks,spoke,spoken
speaker: speaker
species: species
specimen: specimen
speck: speck,specked
spectacle: spectacle
spectator: spectators
spectre: spectre
speculation: speculation,speculations
speech: speech
speechless: speechless
speed: speed
speedily: speedily
speedy: speedy
spend: spend,spent
sphere: sphere
spire: spire,spires
spirit: spirit,spirits
spite: spite
splendour: splendour
splintered: splintered
split: split
spoil: spoiled
spoiler: spoiler
spoke: spoke
sport: sport
sportiveness: sportiveness
spot: spot,spots
spout: spout
spread: spread,spreading
spring: sprang,spring,springs,sprung
springing: springing
spur: spurred
spurn: spurn,spurned
squalid: squalid
squalidness: squalidness
squat: squat
stag: stag
stage: stage,stages
stagecoach: stagecoach
stagger: staggered
stair: stairs
staircase: staircase
stamp: stamp
stand: stand,standing,stood
standard: standard
star: star,stars
stare: stare,stared
starry: starry
start: start,started,starting
startle: startled
starvation: starvation
stately: stately
statement: statement
station: station
stature: stature
stay: stay,stayed
steadily: steadily
steady: steady
steal: steal,stole,stolen
stealth: stealth
steel: steel
steep: steep
steeple: steeple,steeples
steer: steered
step: step,stepped,steps
stick: stick
stiff: stiff
stifle: stifle
stigma: stigma
stillness: stillness
stimulate: stimulated
stimulus: stimulus
sting: sting,stings
stir: stir,stirred
stock: stock
stone: stone,stones
stony: stony
store: store,stores
storm: storm
story: story
stove: stove
straight: straight
strain: strain,strained
strange: strange,strangest
strangely: strangely
stranger: stranger,strangers
strangle: strangled
straw: straw
stream: stream,streamed,streams
street: street,streets
strength: strength
strengthen: strengthened
strenuously: strenuously
stretch: stretch,stretched
strew: strewed
strife: strife
strike: struck
strive: strive,striving,strove
strong: strong,stronger
structure: structure
struggle: struggle,struggled
student: student,students
study: studied,studies,study,studying
stuff: stuff
stump: stump
stupendous: stupendous
stupid: stupid
sty: sty
style: style
subdue: subdue,subdued,subduing
subject: subject,subjects
sublime: sublime
submission: submission
submit: submit
subscribe: subscribed
subsequent: subsequent
subsist: subsist,subsisted
subsistence: subsistence
substance: substance
succeed: succeed,succeeded
success: success
succession: succession
successive: successive
successor: successors
succour: succour
sudden: sudden
suddenly: suddenly
suffer: suffer,suffered,suffering
sufferer: sufferer
suffering: suffering,sufferings
suffice: suffice
sufficiency: sufficiency
sufficient: sufficient
suffocate: suffocated
suffocated: suffocated
suggestion: suggestion
suicide: suicide
suit: suit,suited
sullen: sullen
sum: sum
summer: summer,summers
summit: summit,summits
summon: summoned
sun: sun
sunday: sunday
sunlight: sunlight
sunny: sunny
sunrise: sunrise
sunset: sunset
sunshine: sunshine
superfluous: superfluous
superhuman: superhuman
superior: superior,superiors
supernatural: supernatural
superscription: superscription
superstition: superstition
supple: supple
suppliant: suppliant
supplication: supplication
supply: supplied,supply
support: support,supported
suppose: suppose,supposed,supposing
supposition: supposition
suppress: suppress,suppressed,suppressing
supreme: supreme
surely: surely
surface: surface
surgeon: surgeon
surmount: surmount,surmounted,surmounting
surpass: surpassed,surpassing
surprise: surprise,surprised
surprised: surprised
surprising: surprising
surround: surround,surrounded,surrounding
survive: survive,surviving
survivor: survivors
susceptible: susceptible
suspect: suspect
suspend: suspended
suspense: suspense
suspicion: suspicion,suspicions
suspicious: suspicious
sustain: sustain,sustained
sustenance: sustenance
swallow: swallow,swallowed
sway: sway
swear: swear,swore,sworn
sweep: swept
sweet: sweet,sweeter,sweetest
sweetness: sweetness
swell: swell,swelled,swelling,swells
swift: swifter
swiftness: swiftness
swim: swim,swimming
swiss: swiss
switzerland: switzerland
sword: sword
symmetry: symmetry
sympathise: sympathise,sympathised,sympathising
sympathy: sympathies,sympathy
symptom: symptoms
syndic: syndic,syndics
table: table
tackle: tackle
taint: tainted
tale: tale,tales
talent: talent,talents
talk: talk,talked,talking,talks
tall: tall
tame: tamer
tangible: tangible
tap: tapped
taper: tapers
tardily: tardily
tarnish: tarnish
tartary: tartary
task: task
taste: taste,tasted,tastes
taunt: taunt
tay: tay
teach: taught,teach
teacher: teacher,teachers
tear: tear,tearing,tears,tore,torn
tearful: tearful
tears: tears
tease: teased
tedious: tedious
telescope: telescopes
temper: temper
temperature: temperature
tempest: tempest
temple: temple,temples
temporary: temporary
tempt: tempted
temptation: temptation
tend: tend,tended
tendency: tendency
tender: tender,tenderest
tenderly: tenderly
tenderness: tenderness
tenement: tenement
tenet: tenets
tenfold: tenfold
tenth: tenth
term: term,terms
terminate: terminate,terminated
termination: termination
terrible: terrible
terribly: terribly
terrific: terrific
terrifically: terrifically
terrify: terrified
terror: terror,terrors
tertiary: tertiary
testify: testify
testimony: testimonies,testimony
texture: texture
thames: thames
thankfulness: thankfulness
thatch: thatch
thee: thee
theme: theme
thenceforth: thenceforth
theory: theories,theory
theseus: theseus
thicken: thickened
thickly: thickly
thine: thine
thinking: thinking
thirst: thirst,thirsted,thirsting
thirteen: thirteen
thither: thither
thomas: thomas
thoughtful: thoughtful
thoughtfulness: thoughtfulness
thoughtlessly: thoughtlessly
thousandth: thousandth
threat: threat,threats
threaten: threaten,threatened,threatening
threshold: threshold
thrice: thrice
thrill: thrill
throat: throat,throats
throw: threw,throw,throwing,thrown
thrush: thrush
thrust: thrust
thunder: thunder,thunders
thunderstorm: thunderstorm
thursday: thursday
thy: thy
thyself: thyself
tide: tide
tiding: tidings
tie: tie,ties
tilbury: tilbury
time: time,times
timid: timid
timorous: timorous
tinge: tinged
tingle: tingle,tingling
title: title
toil: toil,toiled,toils
toilsome: toilsome
token: tokens
tolerable: tolerable
tolerably: tolerably
tolerate: tolerated
tomb: tomb
tomorrow: tomorrow
tone: tone,tones
toned: toned
tongue: tongue,tongues
tool: tools
tooth: teeth
topic: topic
torch: torch,torches
torment: torment,tormented,tormenting,torments
tormentor: tormentor
torpor: torpor
torrent: torrent,torrents
torture: torture,tortured,tortures,torturing
torturer: torturer
total: total
totally: totally
touch: touch,touched,touching
touching: touching
tour: tour
tower: tower,towered,towering,towers
town: town,towns
trace: trace,traced,traces,tracing
track: track
trade: trade
trader: trader
tragedy: tragedy
train: train,trained,trains
trait: trait
traitor: traitor
trample: trample,trampled
trance: trance
tranquil: tranquil
tranquillise: tranquillise
tranquillity: tranquillity
tranquilly: tranquilly
transact: transacted
transaction: transaction
transcendent: transcendent
transfer: transfer
transitory: transitory
transmit: transmit
transmute: transmuted
transparent: transparent
transport: transport,transported
transversely: transversely
trash: trash
travel: travel,travelled,travelling
traveller: traveller,travellers
travels: travels
traverse: traverse,traversed,traversing
treacherous: treacherous
treachery: treachery
tread: tread,treading,trod
treasure: treasure,treasures
treat: treated,treating
treatment: treatment
treble: treble
tree: tree,trees
tremble: tremble,trembled,trembling
tremendous: tremendous
tremulous: tremulous
trial: trial,trials
tribute: tribute
trickle: trickle,trickling
trifle: trifled
trifling: trifling
triumph: triumph,triumphed
triumphant: triumphant
triumphantly: triumphantly
trouble: trouble,troubled
troubled: troubled
truce: truce
true: true,truest
trust: trust
truth: truth
tumult: tumult
tumultuous: tumultuous
turbulence: turbulence
turk: turk
turkey: turkey
turkish: turkish
turks: turks
turmoil: turmoil
turnkey: turnkeys
tutor: tutored
twinkling: twinkling
type: type
tyrannical: tyrannical
tyranny: tyranny
tyrant: tyrant,tyrants
tyro: tyros
ugliness: ugliness
ugly: ugly
ultimately: ultimately
unabated: unabated
unable: unable
unaccountable: unaccountable
unacquainted: unacquainted
unadept: unadept
unallied: unallied
unalterable: unalterable
unavoidable: unavoidable
unbelief: unbelief
unbending: unbending
unbounded: unbounded
unbridled: unbridled
unceasing: unceasing
uncertain: uncertain
unchain: unchained
unchecked: unchecked
uncle: uncle
uncommon: uncommon
uncommonly: uncommonly
unconscious: unconscious
uncontrollable: uncontrollable
uncontrollably: uncontrollably
uncouth: uncouth
uncover: uncovered
undeceive: undeceive,undeceiving
undergo: undergo,undergone,underwent
understand: understand,understanding,understood
understanding: understanding
undertake: undertake,undertaking
undertaking: undertaking
underwood: underwood
undiscovered: undiscovered
undisturbed: undisturbed
undivided: undivided
undoubtedly: undoubtedly
undulation: undulations
unearthly: unearthly
uneasiness: uneasiness
uneasy: uneasy
uneducated: uneducated
unemployed: unemployed
unequal: unequal
unequalled: unequalled
uneven: uneven
unexampled: unexampled
unexpected: unexpected
unexplored: unexplored
unfailing: unfailing
unfair: unfair
unfashioned: unfashioned
unfavourable: unfavourable
unfeeling: unfeeling
unfinished: unfinished
unfit: unfit
unfitness: unfitness
unfitted: unfitted
unfold: unfold,unfolded,unfolding
unformed: unformed
unfortunate: unfortunate
unfulfilled: unfulfilled
ungratitude: ungratitude
unguarded: unguarded
unhallowed: unhallowed
unhappiness: unhappiness
unhappy: unhappy
unheard: unheard
uniform: uniform
unintelligible: unintelligible
uninterested: uninterested
uninteresting: uninteresting
uninterrupted: uninterrupted
union: union
unite: unite,united
universal: universal
university: university
unjust: unjust
unjustly: unjustly
unkindness: unkindness
unknown: unknown
unlawful: unlawful
unlimited: unlimited
unlock: unlocked
unmingled: unmingled
unmolested: unmolested
unnatural: unnatural
unparalleled: unparalleled
unperceived: unperceived
unplastered: unplastered
unpractised: unpractised
unprejudiced: unprejudiced
unprotected: unprotected
unqualified: unqualified
unquenched: unquenched
unquiet: unquiet
unravel: unravel
unrelaxed: unrelaxed
unremitted: unremitted
unremitting: unremitting
unreservedly: unreservedly
unrestrained: unrestrained
unsatisfactory: unsatisfactory
unsatisfied: unsatisfied
unseen: unseen
unsettle: unsettled
unsocial: unsocial
unspeakable: unspeakable
unstained: unstained
unsuccessful: unsuccessful
unsullied: unsullied
unsupported: unsupported
unsympathised: unsympathised
untame: untamed
untaught: untaught
untimely: untimely
untrodden: untrodden
unusual: unusual
unutterable: unutterable
unveil: unveiled
unvisited: unvisited
unwearied: unwearied
unwholesome: unwholesome
unwilling: unwilling
unwillingly: unwillingly
unwillingness: unwillingness
unworthiness: unworthiness
unworthy: unworthy
upright: upright
urge: urged
uri: uri
usage: usage
useless: useless
usual: usual
utensil: utensils
utility: utility
utmost: utmost
utter: utter,uttered,uttering
utterance: utterance
utterly: utterly
vacancy: vacancy
vacant: vacant
vacillate: vacillating
vagabond: vagabond
vagrant: vagrants
vain: vain
vainly: vainly
vale: vale,vales
valley: valley,valleys
valuable: valuable
vampire: vampire
vanish: vanish,vanished
vanquish: vanquished
variable: variable
varied: varied
variegate: variegated
variety: variety
vary: varied
vast: vast
vault: vaults
vegetable: vegetables
vehement: vehement
vehicle: vehicle
veil: veil,veiled
vein: veins
venerable: venerable
vengeance: vengeance
venom: venom
vent: vent,venting
venture: venture,ventured,ventures
verdant: verdant
verdure: verdure
verge: verge
vessel: vessel,vessels
vestige: vestige
vexation: vexations
viand: viands
vicar: vicar
vice: vice,vices
vicinity: vicinity
vicious: vicious
victim: victim,victims
victor: victor
victorious: victorious
victory: victory
view: view,viewed,views
vigilance: vigilance
vigorous: vigorous
vigour: vigour
vile: vile
villa: villa
village: village
villager: villagers
villain: villain,villains
vine: vines
vineyard: vineyards
vintage: vintage
violence: violence
violent: violent
violently: violently
virtue: virtue,virtues
virtuous: virtuous
visage: visage
visible: visible
vision: vision,visions
visit: visit,visited,visits
visitor: visitor
vital: vital
vivacity: vivacity
vivid: vivid
voice: voice,voices
voiceless: voiceless
void: void
volcano: volcano
volume: volume,volumes
voluntarily: voluntarily
voluntary: voluntary
vow: vow,vowed,vows
voyage: voyage,voyages
vulgar: vulgar
vulture: vulture
waft: wafted
wail: wail
wait: wait,waited,waiting
wake: waking
walk: walk,walked,walking,walks
wall: wall,walls
wallet: wallet
wan: wan
wander: wander,wandered,wandering
wanderer: wanderer
wanderings: wanderings
wantonly: wantonly
wantonness: wantonness
war: war,warring,wars
warbling: warbling
warm: warm,warmed,warmer,warmest
warmly: warmly
warmth: warmth
warrant: warrant
waste: waste,wasted,wasting
watch: watch,watched,watching
watchful: watchful
water: water,waters
waterfall: waterfalls
watery: watery
wave: waved,waves
waver: wavering
weak: weak
weaken: weaken,weakened
weakened: weakened
weakness: weakness
wealth: wealth
wean: wean
weapon: weapons
wear: wear,wearing,wears,wore,worn
wearily: wearily
weary: wearied,weary,wearying
weather: weather
wedding: wedding
week: week,weeks
weep: weep,weeping,weeps,wept
weigh: weigh,weighed,weighs
weight: weight
welfare: welfare
west: west
western: western
wet: wet
whale: whale
whaler: whaler
whatsoever: whatsoever
wheel: wheel
wherefore: wherefore
whine: whine
whirl: whirled
whirlwind: whirlwind,whirlwinds
whisper: whisper,whispered,whispers
white: white
whiteness: whiteness
whitewashed: whitewashed
wholesome: wholesome
wholly: wholly
wicked: wicked
wickedness: wickedness
wide: wide,wider
widow: widow
wife: wife,wives
wild: wild,wilds
wildest: wildest
wildness: wildness
wiliness: wiliness
william: william
willingly: willingly
willow: willow
willowy: willowy
win: win,winning
wind: wind,winding,winds,wound
winding: windings
window: window,windows
windsor: windsor
wine: wine
wing: wings
winged: winged
winter: winter
wipe: wipe,wiped,wiping
wisdom: wisdom
wise: wise,wiser,wisest
withdraw: withdrawn,withdrew
wither: withered
withhold: withhold
withstand: withstand
witness: witness,witnessed,witnesses
woe: woe,woes
woeful: woeful
woman: woman,women
wonderful: wonderful
wonderfully: wonderfully
wondrous: wondrous
wondrously: wondrously
wood: wood,woods
woolwich: woolwich
word: word
workman: workman
workshop: workshop
worldly: worldly
worm: worm,worms
worn: worn
worship: worship
worth: worth
worthy: worthy
wouldst: wouldst
wound: wound,wounds
wounded: wounded
wrap: wrap,wrapped,wrapping
wreak: wreak,wreaked
wreath: wreaths
wreck: wreck,wrecked
wrench: wrenched
wrestle: wrestle
wretch: wretch
wretched: wretched
wretchedly: wretchedly
wretchedness: wretchedness
wrinkle: wrinkled
write: write,writes,writing,written,wrote
writer: writers
writhe: writhed,writhing
writing: writing
writings: writings
wrong: wrong
wrongfully: wrongfully
wrung: wrung
yard: yard,yards
yearn: yearned
yellow: yellow
yesterday: yesterday
yesternight: yesternight
yield: yield,yielded
yon: yon
youngster: youngster
youth: youth
youthful: youthful
zeal: zeal
