aback: aback
abandon: abandon,abandoned,abandoning
abbey: abbey
abduction: abduction
abe: abe
aberration: aberration
abet: abetted
abhor: abhors
abhorrent: abhorrent
abide: abide
ability: ability
abnormally: abnormally
abode: abode
abominable: abominable
abortive: abortive
abrasion: abrasion
abreast: abreast
abrupt: abrupt
abscond: absconding
absence: absence
absent: absent
absolute: absolute
absolutely: absolutely
absorb: absorbed
abstracted: abstracted
abstruse: abstruse
absurd: absurd
absurdly: absurdly
abuse: abuse
abyss: abyss
academic: academic
accent: accent
accept: accept,accepted,accepting
acceptable: acceptable
acceptance: acceptance
access: access,accessed
accessible: accessible
accessory: accessory
accident: accident
accidental: accidental
accidentally: accidentally
accompaniment: accompaniments
accompany: accompanied,accompany
accomplice: accomplice
accomplish: accomplish
accord: accord
account: account,accounted,accounts
accumulate: accumulating
accuracy: accuracy
accurately: accurately
accursed: accursed
accusation: accusation
accuse: accuse,accused
accustom: accustomed
accustomed: accustomed
acid: acid
acknowledge: acknowledge,acknowledged
acquaint: acquainted
acquaintance: acquaintance,acquaintances
acquiescence: acquiescence
acquire: acquired,acquiring
acquit: acquitted
acre: acres
acrobat: acrobat
action: action,actions
active: active
activity: activity
actor: actors
actual: actual
acumen: acumen
adapt: adapted
adaptable: adaptable
add: add,adding
addition: addition,additions
additional: additional
address: address,addressed,addresses,addressing
adelaide: adelaide
adequate: adequate
adhere: adhere
adjective: adjectives
adjoin: adjoining
adjust: adjusted
administration: administration
admirable: admirable
admirably: admirably
admiralty: admiralty
admiration: admiration
admire: admire
admirer: admirer,admirers
admit: admit,admits,admitted
adopt: adopt
adorn: adorned
advance: advance,advanced,advances,advancing
advantage: advantage,advantages
adventure: adventure,adventures
adventurous: adventurous
advertisement: advertisement,advertisements
advice: advice
advise: advise,advised,advises
affair: affair,affairs
affairs: affairs
affect: affect
affection: affection
affectionate: affectionate
affectionately: affectionately
affluent: affluent
afford: afford,afforded
afghan: afghan
afoot: afoot
afraid: afraid
africa: africa
african: african
afternoon: afternoon
agatha: agatha
age: age
aged: aged
agency: agencies,agency
agent: agent,agents
ages: ages
aggressive: aggressive
aggressively: aggressively
agile: agile
agitate: agitated
agitated: agitated
agitation: agitation
agony: agony
agree: agree,agreed
agreeable: agreeable
agreement: agreement
aha: aha
aid: aid,aided
aim: aim,aimed
air: air
ajar: ajar
akimbo: akimbo
alarm: alarm,alarmed
alarmed: alarmed
alas: alas
alert: alert
alertness: alertness
alexandria: alexandria
alexandrian: alexandrian
alexis: alexis
alibi: alibi
alight: alight,alighted,alighting
alike: alike
alive: alive
alley: alley
allowance: allowance
allude: allude,alluded
allusion: allusion,allusions
ally: ally
aloud: aloud
alphabet: alphabet
alteration: alteration,alterations
alternate: alternate
alternative: alternative,alternatives
altogether: altogether
amateur: amateur
amaze: amaze
amazed: amazed
amazement: amazement
amazing: amazing
amber: amber
ambition: ambitions
ambuscade: ambuscade
amend: amends
america: america
american: american
amiability: amiability
amiss: amiss
ample: ample
amply: amply
amuse: amuse,amused
amused: amused
amusement: amusement
amusing: amusing
analysis: analysis
analyze: analyze
anarchist: anarchist
ancestor: ancestors
ancient: ancient
andaman: andaman
angel: angel
anger: anger
angle: angle
anglo: anglo
angry: angry
anguish: anguish
angular: angular
animal: animal
aniseed: aniseed
ankle: ankle,ankles
anna: anna
announcement: announcement
annoy: annoys
annoyance: annoyance
annoyed: annoyed
anonymous: anonymous
answer: answer,answered,answering
answerable: answerable
antagonist: antagonist
antic: antics
anticipate: anticipate,anticipated
antidote: antidote
anxiety: anxieties,anxiety
anxious: anxious
apartment: apartment
ape: ape
aperture: aperture
apologize: apologize,apologized
apology: apologies,apology
appalled: appalled
apparent: apparent
appeal: appeal,appealed,appealing,appeals
appearance: appearance,appearances
appetite: appetite
applause: applause
apple: apple
applicable: applicable
applicant: applicant
application: application
apply: applied,apply
appointment: appointment
apprehend: apprehended
apprehension: apprehension
approach: approach,approached,approaching
approve: approve
approvingly: approvingly
april: april
aquiline: aquiline
arable: arable
arbitrary: arbitrary
arch: arched
archie: archie
architectural: architectural
architecture: architecture
archive: archive
arctic: arctic
ardent: ardent
argentine: argentine
argue: argue,argued,argues,arguing
argument: argument,arguments
aristocrat: aristocrat
aristocratic: aristocratic
arm: arm,arms
armchair: armchair
armed: armed
arms: arms
armstrong: armstrong
army: army
arouse: arouse,aroused
arrange: arrange,arranged,arranges,arranging
arrangement: arrangement
array: array
arrest: arrest,arrested,arresting
arrival: arrival
arrive: arrive,arrived,arrives,arriving
arson: arson
art: art
artery: artery
arthur: arthur
article: article,articles
artificial: artificial
artist: artist,artists
ascend: ascended
ascertain: ascertain,ascertained
ascetic: ascetic
ascii: ascii
ash: ash,ashes
ashamed: ashamed
ashen: ashen
askance: askance
asleep: asleep
asperity: asperities
assailant: assailant
assassin: assassin
assault: assault,assaults
assemble: assembled
assent: assent,assented
assert: assert,asserted
assiduously: assiduously
assist: assist
assistance: assistance
assistant: assistant
assize: assizes
associate: associate,associates
association: associations
assume: assume,assumed
assurance: assurance
assure: assure,assured,assures
asthmatic: asthmatic
astonish: astonish,astonished
astonished: astonished
astonishing: astonishing
astonishingly: astonishingly
astonishment: astonishment
astounding: astounding
astrakhan: astrakhan
athlete: athlete
athletic: athletic
atmosphere: atmosphere
atom: atoms
atone: atones
atonement: atonement
attach: attached,attaches
attack: attack,attacked,attacks
attain: attain,attained
attempt: attempt,attempted,attempting
attend: attend,attended,attends
attendant: attendant
attention: attention,attentions
attentive: attentive
attic: attic
attire: attire,attired
attitude: attitude
attract: attracted
attribute: attribute,attributed
audacity: audacity
audience: audience
august: august
augustus: augustus
austere: austere
austerlitz: austerlitz
australia: australia
australian: australian
author: author
authority: authorities
autograph: autograph
autumn: autumn
avail: avail,availed
avenge: avenged
avenger: avenger
avenue: avenue
average: average
averse: averse
aviary: aviary
avidity: avidity
avoid: avoid,avoided
await: await,awaited,awaiting,awaits
awaken: awakened
aware: aware
awful: awful
awkward: awkward
awry: awry
ax: axed
babble: babbled
baboon: baboon
baby: baby
baccy: baccy
bachelor: bachelor
backhander: backhander
backwater: backwater
bad: bad,worse,worst
badly: badly,worse
baffle: baffled
bag: bag,bags
bagatelle: bagatelle
baggage: baggage
bait: bait
baize: baize
baker: baker
balance: balance,balanced
bald: bald
baldness: baldness
baldwin: baldwin
ball: ball
balmoral: balmoral
band: band,bands
banish: banish
bank: bank,banked,banks
banker: banker,bankers
banking: banking
banknote: banknotes
bannister: bannister
bar: bar,barred
barbed: barbed
bare: bare
bargain: bargain
baron: baron,barons
baronet: baronet
barrel: barrel,barrels
barrett: barrett
barrow: barrow
base: base,based
basement: basement
basil: basil
basis: basis
bass: bass
batch: batch
bath: bath,bathing
battle: battle
bawl: bawl
bay: bay
beagle: beagle
beam: beamed
bear: bear,bearing,bears,bore,born,borne
beard: beard
bearded: bearded
bearing: bearing
bearskin: bearskin
beast: beast,beasts
beat: beat,beaten,beating,beats
beautiful: beautiful
beauty: beauties,beauty
bed: bed
bedroom: bedroom,bedrooms
bedside: bedside
bee: bee
beer: beer
beeswing: beeswing
beetle: beetle
befall: befall,befallen,befell
beg: beg,begged
beggarly: beggarly
behalf: behalf
behaviour: behaviour
behold: behold
belated: belated
belgrade: belgrade
belief: belief
bell: bell
bellow: bellow
belong: belong,belonged,belonging,belongs
belt: belt
bench: bench
bend: bend,bending,bent
beneath: beneath
benefactor: benefactor
benefit: benefit
benevolence: benevolence
bent: bent
bereavement: bereavement
bert: bert
berth: berth
beseech: beseeching
bespatter: bespattered
bestow: bestow
bet: bet,betting
betaken: betaken
betray: betray,betrayed
bewilder: bewildered
bibliophile: bibliophile
bicycle: bicycle,bicycled,bicycles
bicyclist: bicyclist
bid: bade,bid,bids
billiard: billiard
billiards: billiards
binary: binary
bind: bind,binding,bound
biography: biographies
bird: bird,birds
birth: birth
biscuit: biscuit,biscuits
bit: bit,bits
bite: bite
bitter: bitter
bitterly: bitterly
bitterness: bitterness
bizarre: bizarre
black: black,blackest
blacker: blacker
blackguard: blackguard
blackmail: blackmailed,blackmailing
blackmailer: blackmailers
blackness: blackness
blackthorn: blackthorn
blackwater: blackwater
blade: blade
blame: blame
bland: blandest
blandest: blandest
blank: blank
blaze: blaze,blazed,blazes,blazing
bleak: bleak
bleat: bleat
bleeding: bleeding
blended: blended
bless: bless,blessed
blessing: blessing
blind: blind,blinds
blindness: blindness
blink: blinking
block: block,blocked,blocks
blond: blond
blonde: blonde
blood: blood
bloodless: bloodless
bloom: bloom
blossom: blossoms
blotting: blotting
blow: blew,blow,blowing,blown
bludgeon: bludgeons
blue: blue
bluebottle: bluebottles
blues: blues
blunder: blunder
blunt: blunt
blurred: blurred
blurt: blurted
blush: blushed
board: board,boards
boarding: boarding
boast: boasted
boat: boat
bob: bob
bode: boded
bodied: bodied
body: body
bog: bog
boggle: boggling
boggy: boggy
boil: boil
boisterous: boisterous
bold: bold
bolt: bolt,bolted
bone: bone,bones
bonny: bonny
bony: bony
book: book,books
bookcase: bookcase
bookshop: bookshop
bookworm: bookworm
boom: boomed
boot: boots
border: border,bordering,borders
bored: bored
borrow: borrow,borrowed
bosom: bosom
boss: boss
bother: bother,bothered,bothers
bothered: bothered
bottle: bottle
boulder: boulder,boulders
boulevard: boulevard
bound: bounded
bow: bow,bowed
bowling: bowling
box: box,boxes
boxing: boxing
boy: boy,boys
brace: braced,bracing
bracket: bracket
brain: brain,brains
branch: branch
brandy: brandy
brass: brass
bravado: bravado
brawl: brawl
brawny: brawny
brazen: brazen
breach: breach
breadth: breadth
break: break,breaking,breaks,broke,broken
breaker: breaker
breakfast: breakfast,breakfasted
breast: breast
breath: breath
breathe: breathe,breathed,breathing
breathing: breathing
breathless: breathless
breech: breech
brew: brewing
bribe: bribe
brick: brick
bridegroom: bridegroom
bridge: bridge
bright: bright,brighter,brightest
brighten: brightened
brightly: brightly
brightness: brightness
brilliant: brilliant
brim: brimmed
brindled: brindled
bring: bring,bringing,brings,brought
brink: brink
brisk: brisk,briskest
bristle: bristled,bristling
britain: britain
british: british
broad: broad,broader
broaden: broadened
broken: broken
broker: broker,brokers
brood: brooding
brooding: brooding
brother: brother
brotherhood: brotherhood
brothers: brothers
brougham: brougham
brow: brow,brows
browbeat: browbeat
brown: brown
bruise: bruise
brush: brushed
brutal: brutal
brutality: brutality
brute: brute
bucket: bucket,buckets
budding: budding
budge: budge,budges
build: build,building,built
builder: builder
building: building,buildings
bulky: bulky
bull: bull
bulldog: bulldog
bullet: bullet,bullets
bully: bully,bullying
bulwark: bulwark
bundle: bundle,bundles
bungler: bungler
bunk: bunk
burden: burden
bureau: bureau
burglar: burglar,burglars
burglary: burglary
burgle: burgle,burgled,burgling
burn: burn,burned,burning,burns
burrow: burrow
burst: burst
bury: buried,burying
bus: bus
bush: bush,bushes
business: business
bust: bust,busts
bustle: bustled
bustling: bustling
busy: busied,busiest,busy
busybody: busybody
butcher: butcher
butler: butler
butt: butt
butter: butter
button: buttoned,buttons
bye: bye
byway: byways
cab: cab
cabin: cabin
cabinet: cabinet
cable: cable,cabled
cablegram: cablegram
cabman: cabman
cadaverous: cadaverous
cairns: cairns
calculate: calculate,calculated
calculation: calculation,calculations
calling: calling
callous: callous
calm: calm
calmly: calmly
cam: cam
cambridge: cambridge
camden: camden
camera: camera
camp: camp,camped
campaign: campaign
canadian: canadian
canal: canal
canary: canary
candelabra: candelabra
candidate: candidate
candle: candle,candles
cane: cane
canine: canine
canter: cantering,canters
cap: cap
capable: capable
capacity: capacities,capacity
capital: capital
capricious: capricious
captain: captain
captive: captive
capture: capture,captured
carafe: carafe
caravan: caravan
carcass: carcass
card: card,cards
cardboard: cardboard
cardinal: cardinal
care: care,cared
career: career
careful: careful
carefully: carefully
careless: careless
carelessly: carelessly
carelessness: carelessness
carey: carey
caricature: caricature
carotid: carotid
carpet: carpet
carriage: carriage,carriages
carry: carried,carry,carrying
cart: cart
cartridge: cartridge,cartridges
carve: carve,carved,carving
cash: cashed
cast: cast,casts
caste: caste
castle: castle
casual: casual
cat: cat
cataract: cataract
catastrophe: catastrophe
catch: catch,catching,caught
catholic: catholic
cattle: cattle
caunter: caunter
caution: caution
cautious: cautious
cautiously: cautiously
cavendish: cavendish
cavity: cavity
cease: cease,ceased
ceiling: ceiling
celebrity: celebrities
cell: cell
central: central
centre: centre
century: centuries,century
ceremony: ceremony
certainty: certainty
chaff: chaff,chaffed
chain: chain
chair: chair,chairs
chalk: chalk
challenge: challenged
chamber: chamber,chambers
chance: chance,chanced,chances
chancellery: chancelleries
chandler: chandler
change: change,changed,changing
channel: channel,channels
chap: chap
chapter: chapter
character: character,characters
characteristic: characteristic,characteristics
charcoal: charcoal
charge: charge,charged,charges
charing: charing
charitable: charitable
charity: charities
charles: charles
charm: charm
charmed: charmed
charming: charming
charred: charred
chart: chart,charts
charter: charters
chase: chased,chasing
chasm: chasm
chastened: chastened
chat: chat,chatting
chatter: chattering
cheap: cheap
cheat: cheating
check: check,checks
cheek: cheek,cheeks
cheer: cheer
cheerful: cheerful
cheery: cheery
chemical: chemical,chemicals
cherish: cherished
chest: chest
chested: chested
chesterfield: chesterfield
chestnut: chestnuts
chevron: chevron
chicago: chicago
chief: chief
child: child,children
childish: childish
chiltern: chiltern
chime: chimed,chimes
chimney: chimneys
chin: chin,chins
chip: chip,chips
chivalrous: chivalrous
choice: choice
choke: choke,choking
choose: choose,chooses,choosing,chose,chosen
chronicle: chronicle,chronicles
chubb: chubb
chuckle: chuckle,chuckled
church: church,churches
cigar: cigar
cigarette: cigarette,cigarettes
cipher: cipher,ciphers
circle: circle,circles
circulate: circulated
circumlocution: circumlocution
circumstance: circumstance,circumstances
circus: circus
citizen: citizens
city: city
civilization: civilization
civilly: civilly
claim: claim,claimed,claiming
clang: clang
clap: clapped
clapping: clapping
claret: claret
clasp: clasp,clasping
clasped: clasped
class: class
classic: classic
classical: classical
clatter: clatter,clattered
claw: claw,clawed,clawing
clay: clay
clean: clean,cleaned
cleaner: cleaners
clearing: clearing
clearness: clearness
clench: clenched
clenched: clenched
clergyman: clergyman
clerical: clerical
clerk: clerk
clever: clever
cleverly: cleverly
cleverness: cleverness
client: client,clients
cliff: cliff
climb: climb,climbed,climbing,climbs
cling: cling,clung
clink: clinking
clip: clips
clock: clock
close: close,closed,closer,closing
closed: closed
closely: closely
clot: clotted
cloth: cloth
clothe: clad
clothes: clothes
clothing: clothing
cloud: cloud,clouded,clouds
cloven: cloven
club: club,clubbed,clubs
clue: clue,clues
clump: clump,clumped,clumps
clumsily: clumsily
clutch: clutched
coachman: coachman
coal: coal
coarse: coarse
coast: coast
coat: coat,coats
coax: coax,coaxing
cobwebs: cobwebs
cock: cock
cocoa: cocoa
cocoanut: cocoanut
code: code,codes
coffee: coffee
coherent: coherent
coil: coil
coin: coins
coincidence: coincidence
cold: cold,colder
coldly: coldly
collapse: collapsed
collar: collar
colleague: colleague
collect: collect,collected,collecting
collection: collection
collector: collector
college: college
colonel: colonel
colonial: colonial
colony: colonies,colony
colossal: colossal
colour: colour,coloured
coloured: coloured
colouring: colouring
colourless: colourless
column: column,columns
combination: combination
comely: comely
comfort: comfort
comfortable: comfortable
comic: comic
command: command,commanded,commands
commence: commence
commencement: commencement
commend: commend
comment: comment,commented,comments
commercial: commercial
commission: commission,commissioned
commit: commit,commits,committed
common: common
commonplace: commonplace
communicate: communicate,communicated
community: community
companion: companion,companions
company: company
comparatively: comparatively
compare: compare,compared,comparing
comparison: comparison
compartment: compartments
compel: compel,compelled
compete: compete
compilation: compilation
complacent: complacent
complain: complain
complaint: complaint
complete: complete,completed
completely: completely
complex: complex
complexion: complexion
compliance: compliance
complicate: complicated
complicated: complicated
complication: complication,complications
comply: comply,complying
compose: composed
composition: composition
composure: composure
compress: compressed
compromise: compromise
compunction: compunction
comrade: comrade,comrades
comradeship: comradeship
concave: concave
conceal: conceal,concealed
concealment: concealment
conceivable: conceivable
conceivably: conceivably
conceive: conceived
concentrate: concentrate,concentrating
concentrated: concentrated
concentration: concentration
concept: concept
concern: concern,concerns
concerned: concerned
concise: concise
conclude: concluded
conclusion: conclusion,conclusions
conclusive: conclusive
conclusively: conclusively
concoct: concocted
concoction: concoction
concussion: concussion
condemn: condemned
condition: condition,conditions
condone: condoned
conducive: conducive
conduct: conduct,conducted
conduit: conduit
confederacy: confederacy
confederate: confederate
confess: confess,confessed,confessing
confession: confession
confidant: confidant
confide: confide
confidence: confidence,confidences
confident: confident
confidential: confidential
confidentially: confidentially
confine: confined
confirm: confirmed
confirmation: confirmation
conflagration: conflagration
confront: confronted
confused: confused
congenial: congenial
congratulate: congratulate
congratulation: congratulation
conjecture: conjecture,conjectured
conjurer: conjurer
conk: conk
connect: connect,connected
connected: connected
connection: connection
connoisseur: connoisseur
conscience: conscience
conscious: conscious
consciousness: consciousness
consent: consent,consented
consequence: consequence,consequences
consequential: consequential
conservatory: conservatory
considerable: considerable
considerably: considerably
consideration: consideration
consign: consigned
consist: consist,consisted,consists
consolation: consolation
console: consoling
conspiracy: conspiracy
conspire: conspire
constable: constable,constables
constabulary: constabulary
constant: constant
construct: construct,constructed
consult: consult,consulted,consulting
consultant: consultant
consultation: consultations
consulting: consulting
consume: consume,consumed,consuming
consumption: consumption
contact: contact
contemplate: contemplating
contemplation: contemplation
contempt: contempt
content: content
contented: contented
contents: contents
continent: continent
continually: continually
continuation: continuation
continue: continue,continued
continued: continued
continuous: continuous
continuously: continuously
contract: contract,contracted
contraction: contraction
contrary: contrary
contrast: contrast
contribution: contributions
control: control
conundrum: conundrum
convalescent: convalescent
convenience: convenience
convenient: convenient
conventional: conventional
conversation: conversation
converse: conversing
convert: convert
convey: convey,conveyed,conveying,conveys
convict: convict
conviction: conviction
convince: convince,convinced,convincing
convinced: convinced
convincing: convincing
convulse: convulsed
convulsion: convulsion
convulsive: convulsive
convulsively: convulsively
cook: cook
cool: cool
coolly: coolly
coolness: coolness
cooperation: cooperation
cope: coping
copious: copious
copper: copper
coptic: coptic
copying: copying
copyright: copyright
coram: coram
cord: cord,cords
cork: cork
corkscrew: corkscrew
corn: corn
cornelius: cornelius
corner: corner,corners
cornwall: cornwall
coroner: coroner
corporation: corporation
correct: correct
correctly: correctly
correspond: correspond
correspondence: correspondence
correspondent: correspondent,correspondents
corridor: corridor,corridors
corroborate: corroborate,corroborated,corroborates
corroboration: corroboration
corroborative: corroborative
corrupt: corrupt
cost: cost,costs
costa: costa
cottage: cottage,cottages
couch: couch,couched
cough: coughing
council: council
counsel: counsel
countenance: countenance
counter: counter
counterfeit: counterfeited
counterfoil: counterfoil
countess: countess
counties: counties
country: countries,country
countryman: countryman
countryside: countryside
county: county
couple: couple
courage: courage
court: court,courts
courteous: courteous
courtesy: courtesy
courting: courting
courtly: courtly
courtyard: courtyard
cousin: cousin
coventry: coventry
cover: cover,covered,covering
covered: covered
covering: coverings
cow: cow,cows
coward: coward
cowardly: cowardly
cower: cowered,cowering
crabbed: crabbed
crack: crack,cracked
crackle: crackle,crackled,crackling
craft: craft
crafty: crafty
cram: cram,crammed
crane: craned
crash: crash
cravat: cravats
crave: craved
crawl: crawled,crawling
craze: crazed
crazy: crazy
creak: creak,creaked,creaking
create: created,creating
creation: creation
creature: creature,creatures
credit: credit,credited
creditor: creditor,creditors
creep: creeping,crept
creole: creole
crew: crew
cricket: cricket
crime: crime,crimes
crimean: crimean
criminal: criminal,criminals
crimson: crimson
crisis: crisis
crisp: crisp
critical: critical
criticism: criticism
croak: croaking
crocker: crocker
crocodile: crocodile
crocus: crocuses
crook: crook,crooks
crop: crop
crosby: crosby
cross: cross,crossed,crossing
crosspiece: crosspiece
crouch: crouched,crouching
crowd: crowd,crowded
crown: crown
crowning: crowning
cruel: cruel
cruelty: cruelty
cruet: cruet
crumble: crumbling
crumple: crumpled
crush: crush,crushed,crushing
crystal: crystal
cuddle: cuddled
cudgel: cudgel
cue: cue
cuff: cuffs
culminate: culminate,culminated
culpable: culpable
culprit: culprit
cultivate: cultivated
cumulative: cumulative
cunning: cunning
cunningly: cunningly
cup: cup
cupboard: cupboard
curb: curb
cure: cure
curiosity: curiosity
curious: curious
curiously: curiously
curl: curling
curlew: curlew
current: current,currents
curse: curse,cursed
cursed: cursed
cursing: cursing
curt: curt
curtain: curtain,curtains
curtly: curtly
curve: curve,curving
curved: curved
cushion: cushion
custody: custody
custom: custom
customer: customer
cut: cut,cutting
cutlet: cutlets
cutter: cutter
cutting: cuttings
cycle: cycle,cycling
cyclist: cyclist
cylinder: cylinder
cynical: cynical
cyril: cyril
dabble: dabbled
dagger: dagger
daily: daily
dainty: dainty
damage: damage,damaged
damaged: damaged
damages: damages
damn: damn
damning: damning
damp: damp
dance: dance,dancing
dancing: dancing
dandle: dandled
danger: danger,dangers
dangerous: dangerous
dangle: dangling
dapper: dapper
daresay: daresay
daring: daring
dark: dark,darkest
darken: darkening
darkening: darkening
darkness: darkness
dart: darted,darting
dash: dashed
dashed: dashed
datum: data
daughter: daughter
dawn: dawn
dawson: dawson
day: day,days
daylight: daylight
daze: dazed
dazed: dazed
dead: dead
deadly: deadly
deal: deal,dealing,deals,dealt
dealer: dealer
death: death
debt: debt
decade: decade
decanter: decanter,decanters
decay: decay
deceased: deceased
deceive: deceive,deceived
december: december
decent: decent
deception: deception
deceptive: deceptive
decide: decide,decided
decidedly: decidedly
decipher: deciphering
decision: decision
decisive: decisive
deck: deck
declare: declare,declared,declares
decline: declining
decoy: decoyed
decree: decrees
deductible: deductible
deduction: deduction,deductions
deed: deed,deeds
deep: deep,deepest
deepen: deepens
deeply: deeply
deer: deer
defaced: defaced
defeat: defeat
defect: defect,defects
defective: defective
defence: defence
defender: defenders
deference: deference
defiance: defiance
defiant: defiant
defiantly: defiantly
defier: defiers
definite: definite
deform: deformed
deftly: deftly
degree: degree,degrees
dei: dei
deign: deigning
dejected: dejected
dejection: dejection
delay: delay
deletion: deletions
deliberate: deliberate
deliberately: deliberately
deliberation: deliberation
delicacy: delicacy
delicate: delicate
delicately: delicately
delicious: delicious
delight: delight
delighted: delighted
delirious: delirious
delirium: delirium
deliver: deliver,delivered
delusion: delusions
demand: demand,demands
demoniacal: demoniacal
demonstration: demonstration,demonstrations
demur: demur
demure: demure
demurely: demurely
den: den
dene: dene
dense: dense
deny: denied,deny,denying
depart: departed,departs
department: department
departmental: departmental
departure: departure
depend: depend,depends
dependent: dependent
deplorable: deplorable
deplorably: deplorably
deplore: deplore
depose: deposed
depravity: depravity
deprecation: deprecation
depress: depressed
depressed: depressed
deprive: deprived
depth: depth
depths: depths
derision: derision
derivative: derivative,derivatives
derive: derive,derived
descend: descend,descended,descending
description: description
desert: deserted
deserted: deserted
deserve: deserved,deserves
deserved: deserved
deserving: deserving
design: design,designs
desire: desire,desired,desires,desiring
desirous: desirous
desk: desk
desolate: desolate
despair: despair
despaired: despaired
despatch: despatch,despatched,despatches
desperate: desperate
desperately: desperately
despondent: despondent
destination: destination
destine: destined
destroy: destroy,destroyed,destroying
destruction: destruction
destructive: destructive
detach: detach
detailed: detailed
detain: detain
detect: detect,detected
detection: detection
detective: detective,detectives
determination: determination
determine: determine,determined,determines
develop: develop,developed,develops
development: development,developments
device: device,devices
devil: devil
devilry: devilry
devise: devised
devoid: devoid
devote: devote,devoted,devoting
devoted: devoted
devour: devoured
dexterous: dexterous
diagram: diagrams
diamond: diamond,diamonds
diary: diary
dictation: dictation
die: die,died,dies,dying
difference: difference
difficult: difficult
difficulty: difficulties,difficulty
diffidence: diffidence
dig: dug
digestion: digestion
dignified: dignified
dignity: dignity
dilemma: dilemma
dim: dim,dimmed
dimly: dimly
dine: dine
dinghy: dinghy
dingy: dingy
dining: dining
dinner: dinner
dint: dint
diploma: diplomas
diplomatic: diplomatic
direct: direct,directed,directing
direction: direction,directions
dirty: dirty
disadvantage: disadvantages
disagreeable: disagreeable
disappear: disappear,disappeared,disappearing
disappearance: disappearance
disappoint: disappointed
disappointed: disappointed
disappointing: disappointing
disappointment: disappointment
disaster: disaster
disc: discs
discern: discern
discharge: discharge,discharged
disclaim: disclaim
disclaimer: disclaimer,disclaimers
disclose: disclose,disclosed,disclosing
disclosure: disclosures
discolour: discoloured
discomfort: discomforts
disconsolate: disconsolate
discontinue: discontinue
discover: discover,discovered,discovering
discovery: discovery
discreet: discreet
discreetly: discreetly
discretion: discretion
discuss: discuss,discussed
discussion: discussion
disdain: disdain
disease: disease
disfigured: disfigured
disgrace: disgrace
disgraceful: disgraceful
disguise: disguise,disguised,disguises
disgust: disgust
dish: dish,dishes
disheveled: disheveled
disinclination: disinclination
disk: disk
dismay: dismay,dismayed
dismiss: dismiss,dismissed
dismissal: dismissal
dismount: dismounted
disorder: disorder
disordered: disordered
dispatch: dispatched
dispensary: dispensary
displace: displaced
displacement: displacement
display: display,displayed,displaying
disposal: disposal
disposed: disposed
disposition: disposition
disprove: disproved
disregard: disregard,disregarded
dissipate: dissipated
dissipation: dissipation
dissolve: dissolved
dissuade: dissuading
distance: distance
distant: distant
distinct: distinct
distinction: distinctions
distinguish: distinguish,distinguished
distinguished: distinguished
distort: distorted
distract: distracted,distracts
distractedly: distractedly
distraction: distractions
distrait: distrait
distress: distress
distribute: distribute,distributed,distributing
distribution: distribution
distributor: distributor
district: district
disturb: disturb,disturbed
disturbance: disturbance
divide: divided,dividing
divine: divined
division: division
divulge: divulge
dock: dock
docket: docket
doctor: doctor,doctors
document: document,documents
dodge: dodge
dog: dog,dogged,dogging,dogs
dogmatic: dogmatic
doings: doings
dolorously: dolorously
domain: domain
domestic: domestic
dominant: dominant
dominate: dominated
donate: donate
donation: donation,donations
donor: donors
dook: dook
door: door,doors
doorstep: doorstep
doorway: doorway
dorking: dorking
dot: dot,dots,dotted
doth: doth
double: double
doubt: doubt,doubted,doubts
doubtless: doubtless
dough: dough
doughy: doughy
dour: dour
downfall: downfall
download: downloading
downstairs: downstairs
doyle: doyle
dozen: dozen
drab: drab,drabs
draft: draft
drag: dragged,dragging
draghound: draghound
dragon: dragon
drain: drain,drained
drama: drama
dramatic: dramatic
dramatist: dramatist
drape: draped
draught: draught
draw: draw,drawing,drawn,draws,drew
drawback: drawback
drawer: drawer,drawers
drawing: drawing
dread: dread
dreadful: dreadful
dream: dream,dreamed,dreaming,dreams
dreamer: dreamer
dreary: dreary
dregs: dregs
drenching: drenching
dress: dress,dressed,dressing
dressed: dressed
dressing: dressing
dribble: dribbling
drift: drift,drifted
drill: drilled,drills
drink: drank,drink,drinking
drive: drive,driven,driving,drove
driver: driver
drone: drone,droned,droning
droning: droning
droop: droop,drooping
drooped: drooped
drooping: drooping
drop: drop,dropped,dropping
drought: drought
drown: drowned
drug: drug
drugget: drugget
drumming: drumming
drunk: drunk
drunkard: drunkard
drunken: drunken
dry: dried,dry,drying
ducal: ducal
duchess: duchess
duel: duel
duke: duke
dull: dull
duly: duly
dumb: dumb
dummy: dummy
dun: dun,duns
dundee: dundee
dunlop: dunlop
duplicate: duplicate,duplicates
dusk: dusk
dust: dust
duster: duster
dusty: dusty
dutch: dutch
duty: duties,duty
dwell: dwell
dwelling: dwelling,dwellings
dwindle: dwindling
eager: eager
eagerly: eagerly
eagerness: eagerness
eagle: eagle
ear: ear,ears
eared: eared
earl: earl
earn: earn,earned
earnest: earnest
earnestly: earnestly
earnestness: earnestness
earth: earth
ease: ease
easily: easily
east: east
eastern: eastern
easy: easier,easy
eat: ate,eat,eaten,eating,eats
eaves: eaves
eccentric: eccentric
eccentricity: eccentricity
echo: echoed
ecstasy: ecstasy
edge: edge,edged,edges
edifice: edifices
edith: edith
edition: edition,editions
eduardo: eduardo
educate: educated
education: educations
educational: educational
effective: effective
effeminacy: effeminacy
efficient: efficient
effigy: effigy
effort: effort,efforts
egg: eggs
egypt: egypt
eighteen: eighteen
eighteenth: eighteenth
ejaculate: ejaculated
ejaculation: ejaculation
ejector: ejector
elaborate: elaborate
elapse: elapse,elapsed
eld: elder
elder: elder
elderly: elderly
elect: elect
electric: electric
electrical: electrical
electrician: electrician,electricians
electronic: electronic
electronically: electronically
elegant: elegant
element: element
elemental: elemental
elicit: elicit
elizabethan: elizabethan
elm: elms
email: email
embark: embarking,embarks
embassies: embassies
embassy: embassy
embellish: embellish
ember: embers
emblem: emblem,emblems
embodiment: embodiment
embroider: embroidered
emerge: emerged
emergency: emergency
eminent: eminent
eminently: eminently
emotion: emotion,emotions
emotional: emotional
emperor: emperor
empire: empire
employ: employ,employed
employee: employee,employees
employer: employer
employment: employment
emporium: emporium
empower: empowered
enable: enable,enabled
enact: enacted
enclosure: enclosure
encode: encoding
encourage: encourage,encourages
endeavour: endeavour,endeavoured,endeavouring
endless: endless
endow: endowed
endure: endure,endured
enemy: enemies,enemy
energetic: energetic
energy: energy
enfeebled: enfeebled
enforce: enforcing
engage: engage,engaged,engaging
engaged: engaged
engagement: engagement
engine: engines
engineer: engineer
england: england
english: english
englishman: englishman
engrave: engraved
engross: engrossed
enhance: enhanced
enigmatic: enigmatic
enigmatical: enigmatical
enjoy: enjoy,enjoyed
enjoyable: enjoyable
enlighten: enlighten
enliven: enliven
enormity: enormity
enormous: enormous
enormously: enormously
enraged: enraged
ensue: ensue
ensure: ensured,ensuring
entail: entail
entangle: entangled
enter: enter,entered,entering,enters
enterprising: enterprising
enthusiastic: enthusiastic
entire: entire
entity: entity
entrance: entrance,entrances
entry: entries,entry
envelop: enveloped
envelope: envelope,envelopes
epilogue: epilogue
episode: episode,episodes
epitome: epitome
equal: equal
equally: equally
equanimity: equanimity
equipment: equipment
ere: ere
erect: erect
err: err
errand: errand
erroneous: erroneous
error: error,errors
escape: escape,escaped,escapes,escaping
escort: escort
essential: essential,essentials
establish: establish,established,establishing
establishment: establishment
estate: estate,estates
estimable: estimable
eternal: eternal
eton: eton
europe: europe
european: european
eustace: eustace
eva: eva
eve: eve
evening: evening,evenings
event: event,events
eventful: eventful
everyday: everyday
evidence: evidence
evident: evident
evidently: evidently
evil: evil
evoke: evoked
exact: exact
exam: exam
examination: examination
examine: examine,examined,examining
examiner: examiners
exceedingly: exceedingly
excellent: excellent
exception: exception,exceptions
exchange: exchange,exchanged,exchanges
excitable: excitable
excite: excite,excites
excited: excited
excitedly: excitedly
excitement: excitement
exciting: exciting
exclaim: exclaimed
exclamation: exclamation
exclusion: exclusion
excursion: excursions
excuse: excuse
execution: execution
exempt: exempt
exercise: exercise
exertion: exertion
exhaust: exhausted
exhausted: exhausted
exhaustion: exhaustion
exhibit: exhibited,exhibiting
exhilaration: exhilaration
exhortation: exhortation
exist: exist,existed,existing,exists
existence: existence
exit: exit,exits
exotic: exotic
expand: expanding
expanse: expanse
expect: expect,expected,expecting
expectant: expectant
expectation: expectation,expectations
expedition: expedition
expel: expelled
expend: expend
expenditure: expenditure
expense: expense,expenses
experience: experience,experienced,experiences
experienced: experienced
expert: expert
expire: expire
explain: explain,explained
explanation: explanation,explanations
explicit: explicit
exploit: exploit,exploits
exploration: explorations
explore: explored,exploring
explosion: explosion
export: exporting
expose: expose,exposed,exposing
exposure: exposure
express: express,expressed
expression: expression
expressive: expressive
exquisite: exquisite
extend: extended,extending
extent: extent
extract: extracted
extraordinarily: extraordinarily
extraordinary: extraordinary
extreme: extreme
extremely: extremely
extremity: extremities
exult: exulted
exultant: exultant
exultantly: exultantly
exultation: exultation
eye: eye,eyes
eyebrow: eyebrows
eyed: eyed
eyeglass: eyeglasses
eyelash: eyelashes
eyelid: eyelids
fabrication: fabrication
faced: faced
facility: facility
facing: facing
facsimile: facsimile
factor: factor
factory: factory
faculty: faculties,faculty
fail: fail,failed,failing
failure: failure,failures
faint: faint,fainted,faintest
faintly: faintly
fair: fair
fairy: fairy
faithful: faithful
faithfully: faithfully
fall: fall,fallen,falling,falls,fell
fallacy: fallacy
false: false
fame: fame
familiar: familiar
family: families,family
famous: famous
fan: fan
fanatic: fanatic
fanatical: fanatical
fanciful: fanciful
fancy: fancy
fang: fang
fanlight: fanlight
fantastic: fantastic
fantastically: fantastically
farcical: farcical
farewell: farewell
farm: farm
farmer: farmer,farmers
farming: farming
fashion: fashion
fashionable: fashionable
fashioned: fashioned
fast: fast,faster
fasten: fasten,fastened,fastening
fatal: fatal
fate: fate
father: father
fatigue: fatigue
fault: fault
faulty: faulty
favour: favour,favoured
favourable: favourable
favourite: favourite
fear: fear,feared,fears
fearful: fearful
feat: feat
feature: feature,featured,features
february: february
federal: federal
fee: fee,fees
feel: feel,feeling,feels
feeling: feeling,feelings
fell: felled
fellow: fellow,fellows
felon: felons
felony: felony
female: female
fence: fence
ferment: ferment
ferocity: ferocity
ferret: ferret
fetch: fetch
fetid: fetid
fever: fever
fiasco: fiasco
fidget: fidget,fidgeted
field: field,fields
fiend: fiend
fiendish: fiendish
fierce: fierce,fiercer
fiercely: fiercely
fifteenth: fifteenth
fight: fight,fighting
fighting: fighting
figure: figure,figures
file: file,files
film: film
final: final
finally: finally
financial: financial
fine: fine,finer,finest
fineness: fineness
finesse: finesse
finger: finger,fingers
fingertip: fingertips
finish: finish,finished
finished: finished
firelight: firelight
fireman: firemen
fireplace: fireplace
firing: firing
firm: firm,firms
firmly: firmly
fisher: fisher
fist: fist
fit: fit,fits,fitted
fitness: fitness
fitting: fitting,fittings
fiver: fiver
fixe: fixe
flag: flag,flagged,flags
flame: flamed,flames
flannel: flannel
flap: flap
flash: flash,flashed,flashing
flask: flask
flat: flat
flatten: flattened
flattened: flattened
flaw: flaw
flaxen: flaxen
flee: fled
fleet: fleet
flesh: flesh
flicker: flickering
flier: flier,fliers
flight: flight
fling: flung
flock: flock
flog: flog
flood: flood
floor: floor
flooring: flooring
flop: flopped
florence: florence
florid: florid
flourish: flourishing
flow: flow,flowed
flower: flower,flowering,flowers
flowers: flowers
flowery: flowery
fluffy: fluffy
flurry: flurried
flush: flush,flushed,flushing
fly: flew,flies,fly,flying
focus: focus
fog: fog,fogs
fold: folded,folding
foliage: foliage
folk: folk
follow: follow
follower: followers
folly: folly
foment: foment
fond: fond
food: food
fool: fool
foolish: foolish
foolscap: foolscap
foot: feet,foot
football: football
foothold: footholds
footman: footman
footmark: footmarks
footpath: footpath
footstep: footstep,footsteps
foppish: foppish
forbid: forbid,forbidding
forborne: forborne
force: force,forced,forces,forcing
forcibly: forcibly
forearm: forearms
foreboding: forebodings
forefinger: forefinger
foreground: foreground
forehead: forehead
foreign: foreign
foremost: foremost
forenoon: forenoon
forerunner: forerunners
foresee: foresaw,foresee,foreseen
foresight: foresight
forest: forest
forge: forged
forger: forger
forgery: forgery
forget: forget,forgot,forgotten
forgetfulness: forgetfulness
forgive: forgive,forgiven
forgiveness: forgiveness
form: form,formed,forms
formal: formal
format: format,formats
formidable: formidable
fortescue: fortescue
fortnight: fortnight
fortunate: fortunate
fortune: fortune
foul: foul
foundation: foundation
founder: founder
fourth: fourth
foxhound: foxhound
fracture: fractured
fragment: fragments
fragrance: fragrance
frail: frail
frame: frame,framed
framework: framework
france: france
frank: frank
frankly: frankly
frankness: frankness
frantic: frantic
frantically: frantically
fraser: fraser
fray: frayed,fraying
freakish: freakish
freely: freely
freemason: freemason
freeze: frozen
french: french
frenzied: frenzied
frenzy: frenzy
frequent: frequented
frequently: frequently
fresh: fresh
friction: friction
friend: friend,friends
friendless: friendless
friendly: friendly
friendship: friendship
frieze: frieze
fright: fright
frighten: frighten,frightened
frightened: frightened
frightening: frightening
frightful: frightful
fringe: fringe,fringed
fro: fro
frosty: frosty
frown: frown
frozen: frozen
frugal: frugal
fruitless: fruitless
frustrated: frustrated
fugitive: fugitives
fulfil: fulfilled
fume: fumes
furious: furious
furiously: furiously
furnish: furnish,furnished
furnished: furnished
furniture: furniture
furrow: furrow,furrowed
furtive: furtive
fury: fury
future: future
gable: gables
gage: gages
gain: gain,gained,gaining,gains
gainer: gainer
gaiter: gaiters
gale: gale,gales
gallant: gallant
gallantry: gallantry
gallop: gallops
gallows: gallows
game: game,games
gang: gang,gangs
gap: gap,gaps
garden: garden
gardener: gardener
garment: garments
garroter: garroter
garrulous: garrulous
gas: gas
gash: gash
gasp: gasp,gasped
gate: gate,gates
gateway: gateway
gather: gather,gathered,gathering
gathering: gathering
gaunt: gaunt
gauze: gauze
gaze: gaze,gazed
gelder: gelder
generate: generate
generation: generations
generosity: generosity
genial: genial
genius: genius
genteel: genteel
gentle: gentle,gentlest
gentleman: gentleman,gentlemen
gently: gently
gentry: gentry
genuine: genuine
geographical: geographical
george: george
german: german
gesticulation: gesticulation
gesture: gesture,gestures
ghastly: ghastly
ghost: ghost
giant: giant
gibe: gibes
gibraltar: gibraltar
gift: gift
gigantic: gigantic
gild: gild
gill: gill
gipsy: gipsies
girl: girl
glad: glad
glade: glade
glance: glance,glanced,glances,glancing
glare: glare,glared,glaring
glass: glass,glasses
glazed: glazed
gleam: gleam,gleamed,gleaming,gleams
glide: glided,gliding
glimmer: glimmer,glimmering
glimpse: glimpse,glimpses
glitter: glitter,glittering
globe: globe
gloom: gloom
gloomily: gloomily
gloomy: gloomy
glorious: glorious
gloriously: gloriously
glory: glory
glossy: glossy
glove: glove,gloves
gloved: gloved
glow: glow,glowed,glowing
goal: goal,goals
goatee: goatee
god: god
godfrey: godfrey
goer: goers
gold: gold
golden: golden
golf: golf
golosh: goloshes
gong: gong
goodness: goodness
goodwill: goodwill
gore: gored
gorse: gorse
gossip: gossip
gothic: gothic
gout: gout
govern: govern
governess: governess
government: government
governor: governor
gown: gown
grab: grab
grace: grace
graceful: graceful
gracious: gracious
gradually: gradually
graham: graham
grain: grain,grains
grand: grand
grandly: grandly
grandparent: grandparents
grange: grange
granite: granite
grant: granted,granting
grasp: grasp,grasped,grasping
grass: grass
grate: grate,grating
grateful: grateful
gratefully: gratefully
gratitude: gratitude
grave: grave,graver
gravely: gravely
gray: gray
grazing: grazing
greasy: greasy
greatly: greatly
greek: greek
green: green
greenhouse: greenhouse
greensward: greensward
greet: greeted
grey: grey,greys
grief: grief
grieve: grieve
grievous: grievous
grim: grim
grime: grime
grimly: grimly
grimy: grimy
grin: grinning
grind: grind,grinding,ground
grip: grip,gripped
grizzled: grizzled
grizzly: grizzly
groan: groan,groaned
groom: groom
groove: groove
gross: gross
grossly: grossly
grotesque: grotesque
grotesquely: grotesquely
ground: ground
grounds: grounds
grove: grove,groves
grow: grew,grow,growing,grown,grows
grudge: grudge
gruff: gruff
guarantee: guarantee
guard: guard,guarded
guess: guess,guessed
guest: guests
guide: guide
guilt: guilt
guiltless: guiltless
guilty: guilty
guinea: guineas
gulp: gulped
gun: gun,guns
gurgle: gurgle
gutter: guttered
ha: ha
habit: habit,habits
hack: hack
haggard: haggard
hail: hailed
hair: hair
haired: haired
hairless: hairless
hairpin: hairpin
halfway: halfway
hall: hall
halloa: halloa
halt: halt,halted
halted: halted
hammer: hammer
hammersmith: hammersmith
hand: hand,handed,hands
handbag: handbag
handcuffs: handcuffs
handed: handed
handicap: handicap
handiwork: handiwork
handkerchief: handkerchief
handle: handle,handled,handling
handling: handling
handsome: handsome
handsomely: handsomely
handwriting: handwriting
handy: handy
hang: hang,hanged,hanging,hung
hanging: hangings
hansom: hansom
haphazard: haphazard
happen: happen,happened
happiness: happiness
happy: happiest,happy
harass: harassed
hard: hard,harder
harden: harden
harding: harding
hardship: hardship
hardy: hardy
hark: hark
harm: harm
harmless: harmless
harmonium: harmonium
harp: harp
harpoon: harpoon,harpoons
harpooner: harpooner,harpooners
harshly: harshly
harshness: harshness
hart: hart
hasten: hastened,hastening
hastily: hastily
hasty: hasty
hat: hat
hate: hate,hated
hateful: hateful
hatpin: hatpin
hatred: hatred
haughtily: haughtily
haul: haul
haunch: haunches
haunt: haunted
haunted: haunted
hayes: hayes
head: head,headed,heading,heads
headache: headache
headed: headed
heading: heading
headline: headlines
headquarters: headquarters
health: health
healthy: healthier,healthy
hear: hear,heard,hearing
heart: heart,hearts
hearted: hearted
hearth: hearth
hearthrug: hearthrug
heartily: heartily
heat: heat
heated: heated
heath: heath
heather: heather
heaven: heaven,heavens
heavily: heavily
heaving: heaving
heavy: heavy
hector: hector
hedge: hedge
heed: heed
heel: heel,heeled,heels
height: height
heir: heir
helpless: helpless
helplessly: helplessly
hempen: hempen
henry: henry
heraldic: heraldic
herder: herder
hereditary: hereditary
herr: herr
herring: herring
hesitate: hesitate,hesitated
hesitation: hesitation
hidden: hidden
hide: hidden,hide,hiding
hideous: hideous
hideously: hideously
hiding: hiding
hieroglyphic: hieroglyphic,hieroglyphics
highly: highly
highway: highway
hilarious: hilarious
hilda: hilda
hill: hill,hills
hillside: hillside
himalayas: himalayas
hind: hind
hinder: hinder
hinge: hinge,hinged,hinges
hint: hint
histon: histon
historian: historian
history: history
hit: hit
hoarse: hoarse
hobble: hobbling
hobby: hobby
hobnob: hobnobbed
hold: held,hold,holding,holds
holder: holder
holding: holdings
hole: hole
holiness: holiness
hollow: hollow,hollowed,hollows
holmes: holmes
holy: holy
homage: homage
homely: homely
homemade: homemade
homesickness: homesickness
homeward: homeward
homicidal: homicidal
honest: honest
honesty: honesty
honey: honey
honour: honour,honoured,honours
honourable: honourable
hoof: hoofs
hook: hook
hooked: hooked
hooliganism: hooliganism
hop: hop
hope: hope,hoped,hopes,hoping
hopeless: hopeless
horace: horace
horizon: horizon
horn: horn
horrible: horrible
horribly: horribly
horrified: horrified
horrify: horrified
horror: horror
horse: horse,horses
host: host
hot: hot
hotel: hotel
hound: hound,hounds
hour: hour,hours
hourly: hourly
house: house,houses
household: household
housekeep: housekeeping
housekeeper: housekeeper
housemaid: housemaid
houses: houses
howl: howled
hudson: hudson
huge: huge
hugh: hugh
hum: hum
human: human,humans
humble: humble
humorous: humorous
humorously: humorously
humour: humour,humours
hunger: hunger
hungry: hungry
hunt: hunt,hunted,hunting
hunter: hunter,hunters
hunting: hunting
huntsman: huntsman
hurdle: hurdles
hurl: hurled
hurrah: hurrah
hurricane: hurricane
hurried: hurried
hurriedly: hurriedly
hurry: hurried,hurry,hurrying
hurrying: hurrying
hurt: hurt
husband: husband
hush: hush,hushed
hut: hut
hypodermic: hypodermic
hypothesis: hypothesis
hysteric: hysterics
ice: ice
iconoclast: iconoclast
idea: idea,ideas
identification: identification
identify: identified,identify,identifying
identity: identity
idle: idling
idleness: idleness
ignite: ignited
ignominious: ignominious
ignorant: ignorant
illegal: illegal
illness: illness
illuminate: illuminated,illuminating
illusion: illusion
illustrate: illustrate
illustration: illustration
illustrious: illustrious
image: image,images
imaginary: imaginary
imagination: imagination
imagine: imagine,imagined,imagines
immense: immense
immensely: immensely
immerse: immersed
imminent: imminent
impatience: impatience
impatiently: impatiently
impecunious: impecunious
impede: impede
impenetrable: impenetrable
imperative: imperative
imperfectly: imperfectly
imperial: imperial
implore: implore,implored,imploring
imply: implied
impose: impose,imposed,imposing
impossibility: impossibility
impossible: impossible
impound: impound
impress: impress,impressed,impresses
impression: impression,impressions
impressive: impressive
imprint: imprinted
imprisonment: imprisonment
improbability: improbability
improve: improve,improved
improvement: improvement
imprudent: imprudent
impudent: impudent
impulse: impulse
impulsive: impulsive
impunity: impunity
inaccessible: inaccessible
inaccurate: inaccurate
inaction: inaction
inanition: inanition
incapable: incapable
incessant: incessant
incessantly: incessantly
inch: inch,inches
incident: incident,incidents
incidental: incidental
incidentally: incidentally
incisive: incisive
inclination: inclination,inclinations
incline: inclined
inclined: inclined
inclose: inclosed
include: include,included,includes,including
including: including
inclusive: inclusive
incoherent: incoherent
income: income
incomplete: incomplete
inconceivable: inconceivable
incongruous: incongruous
increase: increased,increasing
incredible: incredible
incredulity: incredulity
incriminate: incriminate
indebt: indebted
indebted: indebted
indecision: indecision
indefatigable: indefatigable
indefinite: indefinite
indemnify: indemnify
indemnity: indemnity
indentation: indentation
independent: independent
independently: independently
indescribable: indescribable
indescribably: indescribably
india: india
indian: indian,indians
indication: indication,indications
indifferent: indifferent
indignation: indignation
indirect: indirect
indirectly: indirectly
indiscreet: indiscreet
indiscretion: indiscretion
indispensable: indispensable
indistinct: indistinct
individual: individual,individuals
indolent: indolent
indorsed: indorsed
induce: induce,induced
inductive: inductive
indulgently: indulgently
industrious: industrious
inefficient: inefficient
inestimable: inestimable
inevitable: inevitable
inexcusable: inexcusable
inexhaustible: inexhaustible
inexorable: inexorable
inexplicable: inexplicable
infallibly: infallibly
infer: infer
inference: inference,inferences
infernal: infernal
infinite: infinite
infinitely: infinitely
inflexible: inflexible
inflict: inflict,inflicted,inflicting
influence: influence,influenced,influences
inform: inform,informed
infringement: infringement
ingenious: ingenious
ingenuity: ingenuity
ingloriously: ingloriously
ingratiating: ingratiating
inhabit: inhabit,inhabited
inhabitant: inhabitants
inhale: inhaling
inherit: inherit
inheritance: inheritance
inhospitable: inhospitable
inhuman: inhuman
initial: initials
injudicious: injudicious
injudiciously: injudiciously
injure: injure,injured
injured: injured
injury: injuries,injury
injustice: injustice
inkling: inkling
inmate: inmates
inn: inn,inns
innate: innate
innocence: innocence
innocent: innocent
innumerable: innumerable
inoffensive: inoffensive
inquest: inquest
inquire: inquire,inquired,inquiring
inquiry: inquiries,inquiry
insane: insane
insanely: insanely
inscribe: inscribed
inscription: inscription
inscrutable: inscrutable
insensible: insensible
insert: inserted
insignificant: insignificant
insincere: insincere
insincerity: insincerity
insist: insist,insisted,insisting
insistent: insistent
insolence: insolence
insolent: insolent
inspect: inspect,inspected
inspection: inspection
inspector: inspector
instance: instance
instant: instant
instantaneous: instantaneous
instantly: instantly
instinct: instinct,instincts
institution: institution
instruct: instruct,instructed
instruction: instructions
instructive: instructive
instrument: instrument,instruments
insufferable: insufferable
insult: insult
insure: insure
intact: intact
intake: intake
intellect: intellects
intellectual: intellectual
intelligence: intelligence
intelligent: intelligent
intend: intend,intended,intending
intense: intense
intensely: intensely
intensify: intensified
intensity: intensity
intent: intent
intention: intention
intently: intently
intentness: intentness
interfere: interfere
interference: interference
interior: interior
intermittent: intermittent
internal: internal
international: international,internationals
interpret: interpreted
interrupt: interrupted
interruption: interruption,interruptions
intersect: intersected
interval: interval
interview: interview,interviewed,interviews
intimacy: intimacy
intimate: intimate,intimated
intimation: intimation
intricate: intricate
intrigue: intrigue
intrinsically: intrinsically
introduce: introduce,introduced
introduction: introduction
introspective: introspective
intrude: intrude,intruded,intruding
intruder: intruder
intrusion: intrusion
intrust: intrusted
invader: invaders
invalid: invalid
invalidity: invalidity
invent: invent,invented
inverse: inverse
invest: invest
investigate: investigate,investigated,investigating
investigation: investigation,investigations
invigorate: invigorating
invisible: invisible
invitation: invitation
invite: invite
invoke: invoke
involuntarily: involuntarily
involve: involve,involved
irksome: irksome
iron: iron
ironical: ironical
irregular: irregular
irregularity: irregularity
irrelevant: irrelevant
irreparable: irreparable
irrepressible: irrepressible
irresolute: irresolute
irs: irs
islander: islander
issue: issue,issued
italian: italian,italians
ivory: ivory
ivy: ivy
jack: jack
jackal: jackal
jacket: jacket
jagged: jagged
jail: jail
james: james
january: january
japanese: japanese
jaw: jaw
jay: jay
jealous: jealous
jealousy: jealousy
jemmy: jemmy
jeremy: jeremy
jerk: jerking
jew: jew
jewel: jewel
jingo: jingo
job: job,jobs
johann: johann
johannesburg: johannesburg
john: john
johnson: johnson
joint: joint
joke: joke,joking
joker: joker
jonas: jonas
josiah: josiah
jot: jotted
journal: journal
journalist: journalist
journalistic: journalistic
journey: journey,journeys
journeys: journeys
jove: jove
jovial: jovial
joy: joy
joyous: joyous
jubilee: jubilee
judge: judge
judging: judging
judgment: judgment
judicial: judicial
judicious: judicious
july: july
jump: jump
jumper: jumper
jumping: jumping
june: june
jungle: jungle
junior: junior
jury: juries,jury
justice: justice
justifiable: justifiable
justify: justified,justify
justly: justly
keen: keen,keener,keenest
keener: keener
keenly: keenly
keenness: keenness
keeper: keeper
kennedy: kennedy
kensington: kensington
kent: kent
kentish: kentish
key: key
keyed: keyed
keyhole: keyhole
khalifa: khalifa
khartoum: khartoum
kick: kick,kicked
kid: kid
kidnap: kidnap,kidnapped
kill: kill,killed,killing,kills
kin: kin
kindly: kindly
kindness: kindness
king: king
kiss: kissed
kit: kit
kitchen: kitchen
knee: knee,knees
kneel: kneeled,kneeling
knickerbockers: knickerbockers
knife: knife,knifed,knives
knit: knitted
knob: knobs
knock: knock,knocked,knocking,knocks
knot: knot,knots,knotted
knowledge: knowledge
knuckle: knuckles
laboratory: laboratory
laborious: laborious
labourer: labourer
laburnum: laburnum
lace: lace
lack: lack
lackey: lackey
lad: lad,lads
lady: ladies,lady
ladyship: ladyship
lake: lake
lama: lama
lamb: lamb
lament: lamented
lamentable: lamentable
lamp: lamp,lamps
lancashire: lancashire
lancaster: lancaster
land: land,landed
landing: landing
landlady: landlady
landlord: landlord
landmark: landmarks
landscape: landscape
landsman: landsman,landsmen
lane: lane,lanes
language: language
languid: languid
languidly: languidly
lank: lank
lantern: lantern,lanterns
lap: lap
lapse: lapse
larceny: larceny
lash: lashed,lashes
latch: latch
late: late
lath: lath
lattice: lattice,latticed
lauder: lauder
laugh: laugh,laughed,laughing
laughter: laughter
launch: launched
laurel: laurel,laurels
law: law,laws
lawn: lawn
lawyer: lawyer
lay: laid,lay,laying
lazily: lazily
lead: lead,leading,leads,led
leaden: leaden
leader: leader
leaf: leaf,leaves
league: league
lean: leaned,leaning
leaning: leaning
learn: learn,learned,learning,learns
learning: learning
lease: lease,leases
leash: leash
leather: leather
leave: leave,leaves,leaving,left
lecture: lecture
lecturer: lecturer
ledge: ledge
ledger: ledger
lee: lee
leech: leech
left: left
leg: leg,legs
legal: legal
legally: legally
legged: legged
legion: legion
legitimate: legitimate
leisure: leisure
leisurely: leisurely
lemon: lemon
lend: lend,lends
lengthy: lengthy
lenient: lenient
lens: lens
leslie: leslie
lesson: lesson
letter: letter,letters
lettering: lettering
level: level
lever: lever
levy: levying
liability: liability
liable: liable
liberally: liberally
liberty: liberties,liberty
library: libraries,library
license: license
licensed: licensed
lichen: lichen
lick: lick,licked
lid: lid,lids
lie: lain,lie,lied,lies,lying
lieu: lieu
lieutenant: lieutenant
life: life,lives
lifetime: lifetime
light: light,lighted,lighting,lights,lit
lighten: lightened
lighting: lighting
lightly: lightly
lightning: lightning
liking: liking
limb: limb,limbs
limestone: limestone
limit: limit,limited,limits
limitation: limitation
limited: limited
limp: limped
lineament: lineament
linen: linen
linguist: linguist
link: link,linked,links
lion: lion
lip: lip,lips
lipped: lipped
list: list,lists
listen: listen,listened,listening
listless: listless
literally: literally
literary: literary
lithe: lithe
litter: litter,littered
live: live,lived,lives,living
liverpool: liverpool
living: living
load: loaded
loafer: loafers
loathe: loathe,loathed,loathes
local: local
locally: locally
locate: located
location: locations
lock: lock,locked,locking,locks
lodge: lodge,lodged
lodger: lodgers
lodgings: lodgings
log: logs
logbook: logbooks
logical: logical
loiter: loitered
loiterer: loiterers
london: london
lonely: lonely
lonesome: lonesome
longitudinal: longitudinal
lookout: lookout
loose: loose
loosen: loosened
lop: lop
lord: lord
lose: lose,lost
loser: loser
loss: loss,losses
lost: lost
lot: lot
loud: loud,louder
loudly: loudly
love: love,loved,loves,loving
lovely: lovely
lover: lover,lovers
loving: loving
loyal: loyal
lucidity: lucidity
luck: luck
lucky: lucky
lucretia: lucretia
luke: luke
lumber: lumber
luminous: luminous
lump: lump
lunacy: lunacy
lunatic: lunatic
lunch: lunch,lunching
luncheon: luncheon
lurch: lurched
lurk: lurk,lurked,lurking,lurks
luxurious: luxurious
machine: machine
machinery: machinery
mad: mad
madam: madam
maddening: maddening
madly: madly
madman: madman
madness: madness
madrid: madrid
mafia: mafia
magistrate: magistrate
magnificent: magnificent
magnificently: magnificently
magnify: magnifying
magnifying: magnifying
magnum: magnum
maid: maid,maids
main: main
maintain: maintaining
majestic: majestic
majesty: majesty
majority: majority
maker: maker
malicious: malicious
malignant: malignant
mall: mall
malodorous: malodorous
maltreat: maltreated
manacled: manacled
manage: manage,managed
management: management
manager: manager
manchester: manchester
mane: mane
manhood: manhood
mania: mania
manly: manly
manner: manner
mannered: mannered
manners: manners
manor: manor
mansion: mansion
mantelpiece: mantelpiece
mantle: mantle
manufacture: manufactured
manufacturer: manufacturers
manuscript: manuscript
map: map,maps
mar: mar,marred
marauding: marauding
marble: marble
march: march
marengo: marengo
margin: margin
maritime: maritime
mark: mark,marked,marking,marks
marked: marked
marker: marker
market: market
marking: markings
marksman: marksman
marriage: marriage
married: married
marrow: marrow
marry: married,marry,marrying
marsh: marshes
marshal: marshalled
martial: martial
martin: martin
marvellous: marvellous
mary: mary
masculine: masculine
mask: mask,masked,masks
masked: masked
masonry: masonry
mass: mass,massed,masses
massive: massive
master: master,mastered,masters
masterful: masterful
masterpiece: masterpiece
mat: matting
match: match,matches
mate: mate
material: material
mathematical: mathematical
matted: matted
matter: matter,mattered,matters
matting: matting
mature: maturing
maw: maw
maximum: maximum
meal: meal,meals
meaning: meaning
meaningless: meaningless
measles: measles
measure: measured,measuring
mecca: mecca
mechanic: mechanic
mechanism: mechanism
medical: medical
medicine: medicine
meditative: meditative
medium: medium
meet: meet,meeting,meets,met
meeting: meeting,meetings
melancholy: melancholy
membership: membership
memorable: memorable
memorandum: memoranda,memorandum
memory: memories,memory
menacing: menacing
mental: mental
mention: mention,mentioned
merchant: merchant,merchants
merchantability: merchantability
mercy: mercy
mere: mere
meretricious: meretricious
merit: merits
merriment: merriment
merrow: merrow
merry: merry
message: message,messages
messenger: messenger
metal: metal
metallic: metallic
method: method,methods
methodical: methodical
methodically: methodically
mew: mews
michael: michael
midday: midday
middle: middle
midland: midland
midlands: midlands
midnight: midnight
midst: midst
midway: midway
mighty: mighty
mild: mild
mile: mile,miles
miles: miles
military: military
milk: milk
millionaire: millionaire
milner: milner
mincing: mincing
mind: mind
minerals: minerals
mingle: mingled
minimize: minimize
minister: minister
ministers: ministers
minor: minor
minute: minute,minutes
minutely: minutely
mire: mire
miry: miry
misadventure: misadventures
miscalculate: miscalculated
mischief: mischief
mischievous: mischievous
miser: miser
miserable: miserable
misery: misery
misfortune: misfortune
mishandle: mishandled
misjudge: misjudged
misshapen: misshapen
missing: missing
mission: mission
mississippi: mississippi
mist: mist
mistake: mistake,mistaken,mistaking,mistook
mistaken: mistaken
mister: mister
mistress: mistress
mitigate: mitigating
mix: mixed
mixture: mixture
moat: moat
mobile: mobile
mock: mock
model: model
moderate: moderate
modern: modern
modest: modest
modification: modification
modify: modified,modifies
moisten: moisten,moistening
molehill: molehills
molest: molest,molested,molests
moment: moment,moments
momentous: momentous
monastery: monasteries
monday: monday
money: money
monogram: monogram
monograph: monograph
monomania: monomania
monomaniac: monomaniac
monsieur: monsieur
monster: monster
monstrous: monstrous
month: month,months
monumental: monumental
mood: mood,moods
moon: moon
moonlight: moonlight
moor: moor,moors
mope: moped
moral: moral
morally: morally
moran: moran
morass: morass
morbid: morbid
morgan: morgan
morning: morning,mornings
morose: morose
morrow: morrow
morse: morse
mortgage: mortgages
mortification: mortification
mortifying: mortifying
mortimer: mortimer
morton: morton
mortuary: mortuary
moss: moss
mossy: mossy
mother: mother
motherly: motherly
motion: motioned,motioning
motionless: motionless
motive: motive,motives
mottled: mottled
mould: mould,moulding,moulds
moulder: mouldering
moulding: moulding
mount: mount,mounted
mountain: mountains
mournfully: mournfully
mouse: mouse
moustache: moustache
moustached: moustached
mouth: mouth
mouthed: mouthed
mouthful: mouthful
moved: moved
movement: movement,movements
mud: mud
muddy: muddy
muffle: muffled
multiplex: multiplex
murder: murder,murdered,murdering,murders
murderer: murderer,murderers
murderous: murderous
murillo: murillo
murky: murky
murmur: murmur,murmured,murmuring
murray: murray
muscle: muscle,muscles
museum: museum
mushroom: mushroomed
music: music
musical: musical
musician: musician
mute: mute
mutilate: mutilated
mutter: muttered,muttering
mutual: mutual
muzzle: muzzle
mysterious: mysterious
mystery: mysteries,mystery
mystification: mystification
nab: nab
nail: nailed,nails
naked: naked
nameless: nameless
naples: naples
napoleon: napoleon,napoleons
napoleonic: napoleonic
napoleons: napoleons
narrative: narrative,narratives
narrow: narrow,narrowed
narrowly: narrowly
native: native
natural: natural
naturally: naturally
nature: nature
naturedly: naturedly
nearer: nearer
neat: neat
necessaries: necessaries
necessity: necessity
neck: neck
neckcloth: neckcloth
necktie: necktie
negative: negative
neglect: neglect,neglected
negligence: negligence
negotiate: negotiate
neighbour: neighbour,neighbouring,neighbours
neighbourhood: neighbourhood
nephew: nephew
nerve: nerve,nerves
nervous: nervous
nervously: nervously
nervousness: nervousness
nest: nests
nestle: nestled
nettled: nettled
network: network
neutralize: neutralized
newcomer: newcomer
newly: newly
news: news
newsletter: newsletter
newspaper: newspapers
nice: nice
nickel: nickel
nicotine: nicotine
niece: niece
niggard: niggard
niggardly: niggardly
night: night,nights
nightfall: nightfall
nightshirt: nightshirt
nihilist: nihilist
nihilists: nihilists
nobility: nobility
noble: noble,noblest
nobleman: nobleman
nocturnal: nocturnal
nod: nodded
noise: noise
noiseless: noiseless
noiselessly: noiselessly
nonchalant: nonchalant
nonproprietary: nonproprietary
noose: noose
norfolk: norfolk
north: north
northern: northern
norway: norway
norwegian: norwegian
nose: nose,noses
nosed: nosed
nostril: nostrils
notable: notable
notably: notably
notch: notches
note: note,notes,noting
notebook: notebook,notebooks
noteworthy: noteworthy
notice: notice,noticed
noticeable: noticeable
notify: notifies
notion: notion
notoriety: notoriety
notorious: notorious
november: november
novo: novo
nowadays: nowadays
nuisance: nuisance
numerical: numerical
numerous: numerous
nurse: nurse,nursed
nut: nuts
oak: oak,oaks
oaken: oaken
oath: oaths
obedience: obedience
object: object,objected,objects
oblige: oblige,obliged,obliging
obliterate: obliterated
obscure: obscure
obscurity: obscurities
observant: observant
observation: observation,observations
observe: observe,observed,observes
observer: observer
obsolete: obsolete
obstinate: obstinate
obtuse: obtuse
obvious: obvious
occasion: occasion,occasions
occasional: occasional
occasionally: occasionally
occupant: occupants
occupation: occupation
occupy: occupied,occupies,occupy,occupying
occur: occur,occurred,occurs
occurrence: occurrence
ocean: ocean
odd: odd
odds: odds
odious: odious
offence: offence
offensive: offensive
offer: offer,offered,offers
office: office,offices
officer: officer,officers
official: official,officials
omit: omit
online: online
onward: onward
opalescent: opalescent
opera: opera
operate: operate,operating
operation: operation,operations
opinion: opinion,opinions
opponent: opponent
opportunity: opportunities,opportunity
optician: optician,opticians
option: option
opus: opus
orchestra: orchestra
ordain: ordained
ordinary: ordinary
ordnance: ordnance
ore: ore
organic: organic
organize: organized
oriental: oriental
origin: origin
original: original
originally: originally
originator: originator
orphan: orphan
oscar: oscar
ostler: ostler
ounce: ounce
outcast: outcast,outcasts
outcome: outcome
outdated: outdated
outer: outer
outhouse: outhouse
outline: outline,outlined
outrage: outrage
outset: outset
outspoken: outspoken
outstretched: outstretched
outwardly: outwardly
overbearing: overbearing
overboard: overboard
overcoat: overcoat,overcoats
overcome: overcome
overflow: overflowed
overhang: overhanging
overhung: overhung
overjoyed: overjoyed
overlook: overlook,overlooked,overlooking,overlooks
overmaster: overmastering
overpower: overpower,overpowered
overpowering: overpowering
overtake: overtake,overtaken,overtook
overwhelm: overwhelmed
overwhelmed: overwhelmed
overwhelmingly: overwhelmingly
overwrought: overwrought
owe: owe,owed
owner: owner
oxford: oxford
pace: pace,paced
pacific: pacific
pacing: pacing
pack: pack,packed
packet: packet,packets
pad: pad
padre: padre
pain: pain,pains
painful: painful
painless: painless
paint: paint
pair: pair
pal: pals
pale: pale,paled
paler: paler
palimpsest: palimpsest
pall: pall
pallid: pallid
pallor: pallor
palm: palm
palmer: palmer
palpitate: palpitating
pan: paned
panama: panama
pane: pane
panel: panel,panelled
panelling: panelling
panting: panting
pantry: pantry
paper: paper,papers
paperwork: paperwork
paragraph: paragraph,paragraphs
parallel: parallel
paralyse: paralysing
pardon: pardon
parent: parents
paris: paris
parish: parish
parisian: parisian
park: park
parker: parker
parliament: parliament
parlour: parlour
paroxysm: paroxysm
parsley: parsley
parson: parson
particulars: particulars
partition: partition
partly: partly
partner: partner
partnership: partnership
party: parties,party
pass: pass,passed,passes,passing
passage: passage,passages
passenger: passenger
passer: passers
passing: passing
passion: passion
passionate: passionate
passionately: passionately
paste: paste
pat: pat,patted
patch: patch,patched,patches
patched: patched
paternity: paternity
path: path,paths
pathway: pathway
patience: patience
patient: patient,patients
patrick: patrick
patriotism: patriotism
pause: pause,paused
pavement: pavement,pavements
pay: paid,pay,paying,pays
payment: payments
pea: peas
peace: peace
peaceful: peaceful
peak: peak
peal: peal
pearl: pearl
peasant: peasant
peat: peat
peaty: peaty
pebble: pebble
peculiar: peculiar
peculiarity: peculiarities
peculiarly: peculiarly
pedal: pedal,pedalled,pedals
pedestal: pedestal
pedigree: pedigree
peep: peep,peeped,peeping
peer: peered,peering
peg: peg,pegs
pellet: pellet
pen: pen
penal: penal
penalty: penalty
pencil: pencil,pencils
penetrate: penetrated,penetrating
penitent: penitent
penknife: penknife
penniless: penniless
penny: penny
pensioner: pensioner
peppery: peppery
perceive: perceive,perceived,perceiving
perceptible: perceptible
peremptorily: peremptorily
perfect: perfect
perfectly: perfectly
perform: perform,performed,performing,performs
performance: performance,performances
performer: performer
peril: peril
perilous: perilous
period: period,periods
periodic: periodic
permanent: permanent
permanently: permanently
permissible: permissible
permission: permission
permit: permit,permitted
perpetrator: perpetrator
perpetual: perpetual
perplexed: perplexed
persecution: persecution
perseverance: perseverance
persia: persia
persian: persian
persist: persisted
persistent: persistent
person: people,person,persons
personal: personal
personality: personality
personally: personally
persuasion: persuasion
peter: peter
petrified: petrified
petroleum: petroleum
petty: petty
phenomenon: phenomenon
phial: phial
philosopher: philosopher
philosophic: philosophic
photograph: photograph,photographs
phrase: phrase,phrases
physical: physical
pick: pick,picked,picking
pickwick: pickwick
picture: picture,pictured,pictures
picturesque: picturesque
piece: piece,pieces
pierce: pierced,piercing
pig: pig
pile: pile,piled,piles,piling
pillar: pillar
pillow: pillows
pin: pin,pinned
pinion: pinion
pink: pink
pioneer: pioneer
pioneers: pioneers
pipe: pipe
pippin: pippin
pistol: pistol
pit: pit
pitch: pitch
piteous: piteous
pith: pith
pitiable: pitiable
pitiful: pitiful
pity: pities,pity
plague: plague
plain: plain,plainest
plainly: plainly
plan: plan,plans
planet: planet
planking: planking
plant: plant,plants
plantation: plantation
plaster: plaster,plastered
plate: plate,plated,plates
platform: platform
play: play,played,playing,plays
player: player
plead: pleaded
pleasant: pleasant
pleasantry: pleasantry
pleased: pleased
pleasure: pleasure,pleasures
pledge: pledge,pledged
plentifully: plentifully
plenty: plenty
plethoric: plethoric
plight: plight
plot: plot
plover: plover
pluck: plucked
plum: plum
plumage: plumage
plumb: plumb
plumber: plumber
plump: plump
plunder: plunder
plunge: plunge,plunged
plural: plural
pocket: pocket,pocketed,pockets
pocketbook: pocketbook
poise: poise
poison: poison
poisoner: poisoner
poisonous: poisonous
poke: poking
poker: poker
pole: pole
police: police
policeman: policeman,policemen
policy: policy
polished: polished
polite: polite
politeness: politeness
political: political
politician: politicians
politics: politics
pomp: pomp
pompey: pompey
pompous: pompous
pond: pond
ponder: pondered
ponderous: ponderous
pony: pony
pool: pool
poor: poor,poorer
pop: popped
pope: pope
popular: popular
population: population
populi: populi
port: port
porter: porter
porticoed: porticoed
portion: portion
portrait: portrait
position: position
positive: positive
possess: possess,possessed,possesses,possessing
possession: possession,possessions
possibility: possibilities,possibility
post: post,posted,posting
postmark: postmark
postoffice: postoffice
postpone: postponed
postscript: postscript
pot: pots
potentate: potentate
pouch: pouch,pouches
pound: pound,pounds
pour: poured,pouring
poverty: poverty
powder: powder
power: power,powers
powerful: powerful
practical: practical
practically: practically
practice: practice,practices
practise: practising
practised: practised
practitioner: practitioner
praise: praise
prank: prank
pray: pray,prayed,praying
prayer: prayer,prayers
precaution: precaution,precautions
precede: preceded,precedes
precious: precious
precipitate: precipitate
precipitous: precipitous
precise: precise
precision: precision
precursor: precursor
predecessor: predecessor
predispose: predispose
predominate: predominates
prefer: prefer,prefers
preference: preference
prelude: prelude
premature: premature
premier: premier
premise: premises
preparation: preparations
preparatory: preparatory
prepare: prepare,prepared,preparing
prepared: prepared
preponderance: preponderance
prescribe: prescribe
prescription: prescription
presence: presence
presently: presently
presentment: presentment
preserve: preserve,preserved
president: president
press: press,pressed,pressing
pressing: pressing
pressure: pressure
presume: presume,presumed,presuming
pretence: pretence
pretend: pretend
pretext: pretext
pretty: pretty
prevent: prevent,prevented,preventing
previous: previous
prey: prey
price: price
prick: prick,pricked
pride: pride
prim: prim
prime: prime
primness: primness
prince: prince
princely: princely
princess: princess
principal: principal
principally: principally
pringle: pringle
print: print,printed
printer: printer,printers
priory: priory
prisoner: prisoner,prisoners
privacy: privacy
private: private
privately: privately
privet: privet
privilege: privilege
prize: prize
probable: probable
proceed: proceed,proceeded,proceeding
proceeding: proceeding
proceedings: proceedings
proceeds: proceeds
process: process
processing: processing
procession: procession
proclaim: proclaimed
procure: procure
produce: produce,produced,producing
product: product
production: production,productions
profess: professed
profession: profession,professions
professional: professional
professor: professor
proficiency: proficiency
profile: profile,profiles
profit: profit,profiting,profits
profitable: profitable
profitably: profitably
profound: profound
profoundly: profoundly
profusion: profusion
progress: progress
prohibition: prohibition
project: project,projected,projecting
projection: projection
prominent: prominent
prominently: prominently
promiscuous: promiscuous
promise: promise,promised,promises
promising: promising
promote: promoted,promoting
promotion: promotion
prompt: prompt,prompted,prompting
prompting: promptings
pronounce: pronounce,pronounced
pronounced: pronounced
proof: proof,proofs
proofread: proofread
prop: propped
proper: proper
property: property
proportion: proportion
proposal: proposal
propose: propose,proposed
proprietary: proprietary
propriety: proprieties
prosecution: prosecution
prospect: prospect
prosperity: prosperity
prostrate: prostrate,prostrated
prostration: prostration
protect: protect,protected
protection: protection
protest: protest,protested
protrude: protruded
prove: prove,proved,proves
provide: provide,providing
providential: providential
provincial: provincial
provision: provision,provisions
provocation: provocation
provocative: provocative
provoke: provoking
pry: pry
psychologist: psychologists
pub: pub
public: public
publican: publican,publicans
publication: publication
publicity: publicity
publish: publish,published
puckered: puckered
pudding: pudding
puff: puffing,puffs
puffy: puffy
pull: pull,pulled
pulse: pulse
pumpkin: pumpkin
punctually: punctually
pungent: pungent
punish: punished
punishment: punishment
punitive: punitive
punt: punt
pupil: pupil
puppet: puppets
purchase: purchase,purchased
pure: pure
purely: purely
puritan: puritan
purpose: purpose,purposes
purposeful: purposeful
purposeless: purposeless
purr: purred
purse: purse
pursue: pursued,pursuing
pursuer: pursuer,pursuers
pursuit: pursuit
purveyor: purveyor
push: push,pushed,pushing
putty: putty
puzzle: puzzle,puzzled
puzzled: puzzled
puzzling: puzzling
pyramid: pyramid,pyramids
pyramidal: pyramidal
quadrangle: quadrangle
quality: qualities,quality
quantity: quantity
quarrel: quarrel,quarreled,quarrelled
quarter: quarter,quarters
queenly: queenly
queer: queer,queerest
queerer: queerer
querulous: querulous
quest: quest
question: question,questioned,questioning,questions
quick: quick,quicker
quicksand: quicksand
quiet: quiet
quietly: quietly
quill: quill
quit: quit,quitted
quiver: quiver,quivered,quivering
quote: quoted,quoting
rabbit: rabbit,rabbits
race: race
racer: racer
rack: rack,racked
radiant: radiant
radius: radius
rage: rage
ragged: ragged
rail: rail
railing: railing,railings
railway: railway
rain: rain,rained,raining
rainy: rainy
raise: raise,raised,raises,raising
rake: rake,raking
rakish: rakish
rally: rallied
ralph: ralph
ramble: rambles
ramification: ramifications
randall: randall
random: random
range: ranging
rank: ranks
rankle: rankled
ransack: ransack
ransom: ransom
rapid: rapid
rapidity: rapidity
rapidly: rapidly
rare: rare
ras: ras
rascal: rascal,rascals
rasp: rasped
rat: rat
rate: rate,rated,rates
rattle: rattle,rattled,rattling
ravage: ravaged
rave: raving
razor: razors
reach: reach,reached,reaches,reaching
react: react
read: read,reading
readable: readable
reader: reader,readers
reading: reading
ready: ready
real: real
realization: realization
realize: realize,realized
realm: realms
reappear: reappeared
reappearance: reappearance
rear: rear,reared
reason: reason,reasons
reasonable: reasonable
reasoning: reasoning
reassure: reassured
reassuring: reassuring
recall: recall
recapitulate: recapitulate,recapitulated
receipt: receipt,receipted
receive: receive,received,receives,receiving
recess: recess
reckless: reckless
reckon: reckoning
recline: reclining
recognize: recognize,recognized,recognizing
recollect: recollect
recollection: recollection
recommend: recommend,recommended
reconcile: reconcile
reconstruct: reconstruct
reconstruction: reconstruction
record: record,recorded,records
recount: recounted,recounting
recourse: recourse
recover: recover,recovered,recovering
recovery: recovery
red: red
reddish: reddish
redistribute: redistribute,redistributing
redistributing: redistributing
redistribution: redistribution
reduce: reduced
reek: reek,reeking
reenter: reentered
reestablishment: reestablishment
refer: referred,referring,refers
reference: reference,references
refinement: refinement
reflect: reflect,reflected
reflection: reflection
reformer: reformers
refresh: refreshed
refreshment: refreshment
refuge: refuge,refuges
refund: refund
refusal: refusal
refuse: refuse,refused,refuses
regain: regain,regaining
regal: regal
regard: regard
regent: regent
region: region,regions
register: register,registered
registry: registry
regret: regret
regular: regular
regulate: regulating
rein: reins
rejoice: rejoice,rejoiced,rejoicing
relapse: relapsed
relate: relate,relating
relation: relation,relations
relative: relative,relatives
relax: relaxed
release: release,released,releasing
reliable: reliable
relic: relic,relics
relief: relief
relieve: relieved
religion: religion
relit: relit
reluctance: reluctance
reluctant: reluctant
rely: rely,relying
remain: remain,remained,remaining,remains
remains: remains
remark: remark,remarked,remarks
remarkable: remarkable
remarkably: remarkably
remedy: remedied,remedies
remember: remember,remembered,remembering,remembers
remind: remind
remiss: remiss
remonstrance: remonstrances
remonstrate: remonstrate
remorse: remorse
remount: remounted
remove: remove,removed,removing
rename: renamed
render: render
rendering: rendering
repair: repair
reparation: reparation
repass: repassed
repeat: repeat,repeated,repeating
repentant: repentant
repetition: repetitions
replace: replace,replaced
replacement: replacement
reply: reply
report: report,reported,reports
represent: represent,represented,representing,represents
representation: representation,representations
representative: representative
reproach: reproach,reproached,reproaching
reprobate: reprobate
reproduce: reproduce,reproduced
reproduction: reproduction
republican: republicans
repulsion: repulsion
repulsive: repulsive
reputation: reputation,reputations
request: request,requested
require: require,required,requires
requirement: requirements
rescue: rescue,rescued
resent: resent,resented
reservation: reservations
reserve: reserve
reside: residing
residence: residence
resident: resident
resign: resigned
resignation: resignation
resistance: resistance
resolution: resolution
resolve: resolve,resolved
resource: resource,resources
respect: respect,respected
respectable: respectable
respects: respects
response: response
responsibility: responsibility
responsible: responsible
rest: rest,rested,resting,rests
restaurant: restaurant
restless: restless
restlessness: restlessness
restore: restore,restored
restrain: restrain,restraining
restriction: restrictions
result: result
resume: resume,resumed
retail: retail
retailer: retailer,retailers
retain: retain,retained,retaining
retention: retention
reticence: reticence
retire: retired,retires,retiring
retired: retired
retrace: retraced
retreat: retreat,retreated,retreating
retrieve: retrieving
retriever: retriever
return: return,returned,returning,returns
reuben: reuben
reveal: reveal,revealed,revealing
revenge: revenge
revengeful: revengeful
revenue: revenue
reverberate: reverberated
reverence: reverence
reverently: reverently
reverie: reveries
reverse: reverse,reversed
revolutionist: revolutionists
revolver: revolver
reward: reward,rewarded
rhodesia: rhodesia
rhodesian: rhodesian
ribbon: ribbon,ribbons
ribston: ribston
rich: rich,richer,richest
rid: rid
ride: ride,riding,rode
rider: rider
riding: riding
rifle: rifle,rifled
rigid: rigid
rigidity: rigidity
rim: rim
rimmed: rimmed
ripe: ripe
rise: rise,risen,rises,rising,rose
rising: rising
risk: risk
rival: rival
river: river
riverside: riverside
rivet: rivet,riveted
road: road,roads
roam: roamed,roams
roar: roared
roaring: roaring
rob: rob
robber: robbers
robbery: robbery
rock: rock,rocks
rocky: rocky
rode: rode
rogue: rogues
roll: roll,rolled,rolling
rolling: rolling
romp: romp
ronald: ronald
roof: roof,roofed
roomed: roomed
roost: roost
root: root,roots
rope: rope
rotten: rotten
rotund: rotund
rough: rough
roughening: roughening
roughly: roughly
rounded: rounded
rouse: rouse,roused
route: route
routine: routine
row: row,rows
royalty: royalties,royalty
rub: rubbed,rubbing
rubber: rubber
ruddy: ruddy
rude: rude
rue: rue
ruffian: ruffian,ruffians
ruffle: ruffled
rug: rug,rugs
rugby: rugby
rugged: rugged
rugger: rugger
ruin: ruin,ruined
rule: rule,rules
rum: rum
rumble: rumble
rummage: rummaged,rummaging
rumour: rumour,rumoured,rumours
rumpled: rumpled
rush: rush,rushed,rushing
russell: russell
russet: russet
russia: russia
russian: russian
rustic: rustic
rustle: rustle
rusty: rusty
sack: sacked
sacrilege: sacrilege
sad: sad
saddle: saddle
safe: safe,safes
safely: safely
safety: safety
saffron: saffron
sagacity: sagacity
sail: sailed
sailing: sailing
sailor: sailor,sailors
sake: sake
sale: sale,sales
sallow: sallow
salt: salt
saltire: saltire
salute: saluted
salver: salver
sample: sample
san: san
sandwich: sandwiches
sandy: sandy
sanity: sanity
sardonic: sardonic
sash: sash
satisfaction: satisfaction
satisfactory: satisfactory
satisfied: satisfied
satisfy: satisfy
saturate: saturated
saturday: saturday
saunders: saunders
savage: savage
savagely: savagely
save: save,saved,saving
savoury: savoury
sawdust: sawdust
saxon: saxon
scale: scale,scales
scandal: scandal,scandals
scantily: scantily
scar: scars
scare: scare,scared
scared: scared
scatter: scattered
scene: scene
scenery: scenery
scent: scent
scheme: scheme,schemes,scheming
scholar: scholar
scholarship: scholarship
school: school
schoolmaster: schoolmaster
science: science
scientific: scientific
scientist: scientist
scintillate: scintillating
score: score,scored
scotland: scotland
scott: scott
scout: scouting
scramble: scrambled
scrap: scrap
scrapbook: scrapbooks
scrape: scraping
scratch: scratch,scratched,scratches
scrawl: scrawl,scrawled
scream: scream,screamed,screaming,screams
screaming: screaming
screen: screen
screw: screw
scribble: scribbled
scrip: scrip
scrum: scrum
scruple: scruple
scrupulously: scrupulously
scrutinize: scrutinized
scrutiny: scrutiny
scuffle: scuffle
scullery: scullery
sculptor: sculptor
sculpture: sculpture
sea: sea,seas
seal: seal,sealed,seals
sealer: sealer
sealing: sealing
sealskin: sealskin
seam: seamed
seaman: seaman
seaport: seaport
search: search,searched,searching
searcher: searcher
searching: searching
season: season
seat: seat,seated,seating
sebastian: sebastian
secluded: secluded
secrecy: secrecy
secret: secret,secrets
secretary: secretary
secretive: secretive
secure: secure,secured,securing
securely: securely
security: securities
sedative: sedative
sedentary: sedentary
seedy: seedy
seek: seek,seeking,sought
seize: seized,seizes,seizing
seldom: seldom
select: select
selection: selection
selfish: selfish
selfishness: selfishness
sell: sell,sold
seller: seller
send: send,sending,sends
sender: sender
senior: senior
sensation: sensation
sensational: sensational
sense: sense
senseless: senseless
sensitive: sensitive
sensualist: sensualist
sentence: sentence,sentences
sentiment: sentiment
sentinel: sentinel
separate: separate,separated
separation: separation
sequel: sequel
sequence: sequence
sequin: sequin
serenely: serenely
sergius: sergius
series: series
serpent: serpents
servant: servant,servants
serve: serve,served,serves
service: service,services
servitude: servitude
set: set,sets,setting
setback: setback
settee: settee
settle: settle,settled,settles,settling
seventeen: seventeen
sever: sever
severe: severe
severely: severely
severity: severity
sex: sex
shabby: shabby
shade: shade,shading
shadow: shadow,shadowed,shadows
shaggy: shaggy
shake: shake,shaken,shaking,shook
shallow: shallow
shame: shame
shamefully: shamefully
shape: shape,shaped,shapes
shard: shard,shards
share: share,shared,shares,sharing
sharp: sharp,sharpest
sharpen: sharpen,sharpened
sharply: sharply
sharpness: sharpness
shatter: shattered
shattered: shattered
shaven: shaven
shaw: shaw
sheaf: sheaf
sheath: sheath
sheep: sheep
sheer: sheer
sheet: sheet,sheets
shelf: shelf,shelves
shelter: shelter,sheltering
sherlock: sherlock
shetland: shetland
shield: shield,shielded
shift: shifted
shifty: shifty
shikari: shikari
shilling: shilling,shillings
shine: shines,shining,shone
shingle: shingle
shining: shining
ship: ship
shipping: shipping
shirt: shirt
shiver: shivered,shivering
shock: shock
shocking: shocking
shoe: shod,shoe,shoes
shoot: shoot,shooting,shot
shop: shop
short: short,shorter
shortly: shortly
shot: shot,shots
shoulder: shoulder,shouldered,shoulders
shout: shout,shouted
shove: shoved
shred: shreds
shrill: shrill
shrilly: shrilly
shrink: shrank,shrinking
shrinking: shrinking
shroud: shrouded
shrub: shrubs
shrubbery: shrubbery
shrug: shrug,shrugged
shudder: shuddered
shuffle: shuffled
shut: shut
shutter: shutters
siberia: siberia
sibilant: sibilant
sideboard: sideboard
sidelight: sidelights
sidelong: sidelong
sideways: sideways
sidle: sidled
sift: sift
sigh: sigh,sighed
sight: sight,sighted,sights
sightseer: sightseers
sign: sign,signed,signs
signal: signals
significance: significance
signify: signifies
silence: silence
silent: silent
silhouette: silhouette,silhouettes
silk: silk
sill: sill,sills
silver: silver
silvery: silvery
simian: simian
similarity: similarity
simple: simple,simpler,simplest
simplicity: simplicity
simplify: simplify
simply: simply
sin: sin
sinewy: sinewy
sing: sang
single: single
singleton: singleton
singular: singular
singularly: singularly
sinister: sinister
sink: sank,sinking,sunk
sir: sir
sister: sister
sit: sat,sit,sitting
sitting: sitting
situate: situated
situation: situation
sixteen: sixteen
size: size
sized: sized
skeleton: skeleton
sketch: sketches
skilful: skilful
skill: skill
skin: skin
skipper: skipper,skippered
skirt: skirts
skulk: skulking
skulking: skulking
skull: skull
sky: sky
slam: slam,slammed
slane: slane
slant: slanting
slap: slapped
slapping: slapping
slate: slate
slater: slater
slatternly: slatternly
slaughter: slaughter
slave: slave
sleep: sleep,sleeping,sleeps,slept
sleeper: sleeper
sleepless: sleepless
sleepy: sleepy
sleeve: sleeve,sleeves
slight: slight,slightest
slim: slim
sling: slinging
slink: slinking,slunk
slip: slip,slipped,slipping,slips
slipper: slipper
slippered: slippered
slit: slit,slits
slithery: slithery
slobber: slobbered
slog: slogging
slope: slope,sloping
slow: slow,slowed
slowly: slowly
slur: slur
sly: sly
smack: smack
smash: smashed
smear: smeared,smears
smell: smell,smelled,smelt
smile: smile,smiled,smiling
smith: smith
smithy: smithy
smoke: smoke,smoked,smoking
smoker: smoker
smoking: smoking
smooth: smooth,smoothed,smoothing
smoulder: smouldered,smouldering
smudge: smudge
snap: snap,snapped
snapshot: snapshot
snarl: snarl
snatch: snatch,snatched,snatches,snatching
sneer: sneer
snick: snick
sniff: sniff,sniffed
soak: soaked
sob: sobbing,sobs
sober: sober
social: social
society: society
sock: socks
sodden: sodden
sofa: sofa
soft: soft,softer
soften: soften
softly: softly
soil: soil
sojourn: sojourn
soldier: soldier
sole: sole,soled
solemn: solemn
solemnize: solemnize
solicit: solicit
solicitation: solicitation
solicitor: solicitor
solid: solid
solidity: solidity
solitary: solitary
solitude: solitude
solution: solution
solve: solve,solved
son: son,sons
sonorous: sonorous
sooner: sooner
soothe: soothe
soothing: soothing
sorcerer: sorcerer
sorely: sorely
sorrow: sorrow
sort: sort,sorts
soul: soul,souls
sound: sound,sounded,soundest,sounds
source: source
south: south
southerly: southerly
sovereign: sovereign
space: space
span: spanned
spare: spare
spasm: spasm
spatulate: spatulate
speak: speak,speaking,speaks,spoke,spoken
speaker: speaker
spear: spear
special: special
specialist: specialist
specially: specially
specialty: specialty
specimen: specimen,specimens
speck: specks
spectacles: spectacles
speculation: speculation
speech: speech
speechless: speechless
speed: speed,speeding
speedily: speedily
speedy: speedy
spell: spells
spend: spend,spending,spent
spider: spider
spike: spike,spikes
spill: spill
spin: spun
spirit: spirit,spirited,spirits
spirited: spirited
spirituality: spirituality
spite: spite
spitting: spitting
splash: splashed,splashing
splendid: splendid
splendidly: splendidly
splinter: splinter
splintered: splintered
splintering: splintering
spoil: spoilt
spontaneous: spontaneous
sport: sport
sporting: sporting
sportsman: sportsman
spot: spot,spots,spotted
sprain: sprained
spread: spread,spreading
sprightly: sprightly
spring: sprang,spring,springing,sprung
springy: springy
sprint: sprint,sprints
sprinting: sprinting
spurt: spurt
spy: spies,spy
spying: spying
squalid: squalid
square: square,squares
squareness: squareness
squat: squat,squatted
squeal: squeal
squeeze: squeeze
squire: squire
squirrel: squirrel
ss: ss
stab: stab,stabbed,stabbing
stable: stable,stables
stack: stack,stacked,stacks
staff: staff
stage: stage
stagger: stagger,staggered
stagnant: stagnant
stain: stain,stained,stains
stair: stair,stairs
staircase: staircase
stake: stake,stakes
stale: stale
stalwart: stalwart
stammer: stammer
stamp: stamp,stamped,stamping
stand: stand,standing,stands,stood
standstill: standstill
stanley: stanley
star: stars
stare: stare,stared,staring
start: start,started,starting
starter: starter
starting: starting
startled: startled
startling: startling
stately: stately
statement: statement,statements
statesman: statesman,statesmen
station: station,stations
stationer: stationer,stationers
stationmaster: stationmaster
statue: statues
stature: stature
status: status
staunch: staunch
stay: stay,stayed,staying
steadiness: steadiness
steady: steady
steal: steal,stole,stolen
stealthily: stealthily
stealthy: stealthy
steam: steam,steaming
steamer: steamers
steamship: steamship
steel: steel
step: step,stepped,stepping,steps
stepney: stepney
stepping: stepping
stern: stern
sternly: sternly
stewart: stewart
stick: stick,stuck
stiff: stiff
stillness: stillness
stimulus: stimulus
stir: stirred,stirring
stock: stock
stockholder: stockholders
stolid: stolid
stone: stone,stones
stonemason: stonemason
stonily: stonily
stool: stool
stoop: stooped,stooping
store: store,stored,stores
storm: storm,storms
stormy: stormy
story: stories,story
stout: stout
straggle: straggling
straight: straight
straighten: straightened
strain: strained,strains
strained: strained
strand: strand,stranded
strange: strange
stranger: stranger,strangers
stratagem: stratagem
straw: straw
stray: stray
streak: streaked,streaks
stream: stream,streaming
street: street,streets
strength: strength
strengthen: strengthen,strengthening
strenuous: strenuous
stress: stress
stretch: stretch,stretched,stretches
strew: strewn
stricken: stricken
strict: strict
strictly: strictly
stride: stride,striding,strode
strike: strike,strikes,striking,struck
striking: striking
string: string
stringent: stringent
strip: strip,strips
stripe: stripes
strive: striving
stroke: stroke
stroll: stroll,strolled
strong: strong,strongest
struggle: struggle,struggled
stub: stub
stud: studded
student: student,students
study: studied,studies,study
stuff: stuff,stuffed
stupid: stupid
stupidity: stupidity
suave: suave
suavely: suavely
subdue: subdued
subject: subject,subjected,subjects
submerge: submerged
submit: submit,submitted
subscribe: subscribe
subscriber: subscribers
subsequent: subsequent
substantial: substantial
subtle: subtle
suburb: suburb
suburban: suburban
succeed: succeed,succeeded
success: success,successes
successful: successful
succession: succession
sudden: sudden
suddenly: suddenly
suddenness: suddenness
suez: suez
suffer: suffer,suffered,suffering
suffering: suffering,sufferings
suffice: suffice
sufficient: sufficient
suggestion: suggestion,suggestions
suggestive: suggestive
suicide: suicide
suit: suit,suits
suitable: suitable
suitor: suitor
sulky: sulky
sullen: sullen
sum: sum,sums
summer: summer
summon: summon,summoned
summons: summons
sumner: sumner
sumptuous: sumptuous
sun: sun,suns
sunburned: sunburned
sunday: sunday
sundial: sundial
sunlight: sunlight
sunshine: sunshine
superficial: superficial
superintendent: superintendent
superior: superior,superiors
supervision: supervision
supper: supper
supple: supple
supplement: supplement,supplemented
supplication: supplication
supply: supplied,supplies,supply,supplying
support: support
suppose: suppose,supposed,supposing
supposition: supposition
suppress: suppressed
suppression: suppression
supremacy: supremacy
supreme: supreme
surely: surely
surface: surface
surgeon: surgeon,surgeons
surgery: surgery
surmise: surmised
surmount: surmounted
surplice: surplice
surprise: surprise,surprised,surprises
surprised: surprised
surrey: surrey
surround: surrounded,surrounding
surroundings: surroundings
survey: survey,surveying
survive: survive
susan: susan
suspect: suspect,suspected
suspense: suspense
suspicion: suspicion,suspicions
suspicious: suspicious
sussex: sussex
sustain: sustained
swagger: swagger,swaggered
swamp: swamp
swan: swan
swarm: swarmed
swarthy: swarthy
sway: swayed
swear: swear,swearing,swears,swore,sworn
sweep: sweep,swept
sweet: sweeter
sweetheart: sweetheart
swell: swelled,swollen
swelling: swelling
swelter: swelter
swift: swift
swiftly: swiftly
swill: swilled
swim: swimming,swims
swindle: swindle
swing: swing,swung
swinging: swinging
swirl: swirled
switch: switch
switzerland: switzerland
symbol: symbol,symbols
sympathetic: sympathetic
sympathy: sympathies,sympathy
symptom: symptoms
syndicate: syndicate
synonymous: synonymous
syria: syria
syringe: syringe
systematic: systematic
table: table,tables
taciturn: taciturn
tackle: tackling
tact: tact
tail: tail
tailor: tailor
tale: tale,tales
talent: talents
talk: talk,talked,talking,talks
talking: talking
tall: tall,taller
tamper: tampered,tampering
tan: tan
tangle: tangle,tangled
tantalus: tantalus
tap: tap,tapped
tape: tape
tapestry: tapestry
tar: tar
target: target
task: task
taste: taste,tastes
tax: tax,taxed,taxes
tea: tea
teach: taught,teach
teacher: teacher
team: team
tear: tear,tears,tore,torn
technically: technically
telegram: telegram,telegrams
telegraph: telegraph,telegraphing
telegraphic: telegraphic
teller: teller
temper: temper
temperament: temperament
tempestuous: tempestuous
temple: temple
tempt: tempt
temptation: temptation
tempting: tempting
tenacious: tenacious
tenacity: tenacity
tenant: tenant,tenanted,tenants
tenderness: tenderness
tenement: tenement
tenner: tenner
tennis: tennis
tenor: tenors
tense: tense
term: term,terms
termination: termination
terrace: terrace
terrible: terrible
terribly: terribly
terror: terror
testimonial: testimonials
tether: tethered
teutonic: teutonic
textbook: textbook
thames: thames
thankful: thankful
thatched: thatched
thaw: thawed
theatre: theatre
theatrical: theatrical
theft: theft,thefts
theorize: theorize
theory: theories,theory
theresa: theresa
thief: thief,thieves
thigh: thigh
thinker: thinker
thirsty: thirsty
thirteen: thirteen
thirtieth: thirtieth
thither: thither
thong: thong
thoroughfare: thoroughfare
thorpe: thorpe
thoughtful: thoughtful
thoughtfully: thoughtfully
thread: thread,threaded,threads
threadbare: threadbare
thready: thready
threat: threats
threaten: threaten,threatened,threatening
threatening: threatening
threshold: threshold
thrill: thrill,thrilled
thrilling: thrilling
throat: throat,throats
throng: throng
throw: threw,throw,throwing,thrown,throws
thrust: thrust
thud: thud
thumb: thumb
thursday: thursday
thy: thy
tiara: tiara
tibet: tibet
tick: ticked,ticks
ticket: ticket
tickle: tickled
tidiness: tidiness
tidy: tidy,tidying
tie: tied,ties
tiger: tiger,tigers
tight: tight,tighter
tighten: tightened
tightly: tightly
tile: tiled
timber: timber
time: time,timed,times
times: times
tin: tin
tinder: tinder
tinge: tinge,tinged
tingle: tingling
tinkle: tinkle
tint: tinted
tiny: tiny
tiptoe: tiptoe
tire: tire,tires
tired: tired
title: title
tobacco: tobacco
toe: toes
toilet: toilet
token: token
tolerably: tolerably
tomfoolery: tomfoolery
tomorrow: tomorrow
tone: tone
tong: tongs
tongue: tongue
tool: tool,tools
tooth: teeth
torment: torment
torrent: torrent
torture: tortures
tosca: tosca
toss: tossed,tossing
totally: totally
totter: tottered
touch: touch,touched,touches
touchline: touchline
tower: tower,towers
towered: towered
towers: towers
town: town,towns
trace: trace,traced,traces,tracing
track: track,tracked,tracks
tracker: trackers
tracking: tracking
tract: tract
trade: trade
trademark: trademark
tragedy: tragedy
tragic: tragic
trail: trail,trailing
trailer: trailer
train: train,trained,trains
trainer: trainer
training: training
traitor: traitor
tramp: tramp
trample: trampled
trance: trance
transaction: transactions
transcribe: transcribe
transcription: transcription
transfer: transfer
transfix: transfix,transfixed
translation: translation
transpire: transpired
trap: trap
travel: travel,travelled,travelling
traverse: traversed
tray: tray
treacherous: treacherous
treachery: treachery
tread: tread,trod
treasure: treasure,treasured
treasury: treasury
treat: treat,treated,treating
treatise: treatise
treatment: treatment
tree: tree,trees
tremble: trembled,trembling
tremendous: tremendous
tremendously: tremendously
tremor: tremor,tremors
trial: trial
trick: trick,tricks
trickle: trickled
trifle: trifle,trifling
trifling: trifling
trigger: trigger
trim: trim
trinity: trinity
trip: trip
triumph: triumph
triumphant: triumphant
triumphantly: triumphantly
trivial: trivial
trodden: trodden
trophy: trophy
tropical: tropical
trouble: trouble,troubled,troubles,troubling
troubled: troubled
trouser: trouser
trousers: trousers
trove: trove
truculent: truculent
trudge: trudge
true: true
truncate: truncated
trunk: trunk
trust: trust,trusted,trusting
trusty: trusty
truth: truth
truthful: truthful
tube: tube
tuck: tucked
tudor: tudor
tuesday: tuesday
tuft: tufted,tufts
tufted: tufted
tug: tugging
tumble: tumble
tumultuous: tumultuous
turf: turf
tut: tut
tutor: tutor
tweed: tweed
twilight: twilight
twinkle: twinkle,twinkled,twinkling
twist: twisted
twitching: twitching
type: type,types
typewrite: typewriting
typewriter: typewriter
ugly: uglier,ugly
ultimate: ultimate
umbrella: umbrella
unable: unable
unaccountable: unaccountable
unarmed: unarmed
unavoidable: unavoidable
unaware: unaware
unbalanced: unbalanced
unceremonious: unceremonious
unchanged: unchanged
unclasp: unclasping
unclasped: unclasped
uncle: uncle
uncomfortable: uncomfortable
unconditional: unconditional
unconscious: unconscious
unconsciously: unconsciously
uncontrollable: uncontrollable
uncourteous: uncourteous
uncover: uncovered
undecided: undecided
undergo: undergo
underside: underside
understand: understand,understands,understood
understanding: understanding
undertake: undertake,undertaken
undertaker: undertaker
undertaking: undertaking
undetected: undetected
undo: undone
undoubted: undoubted
undoubtedly: undoubtedly
uneasiness: uneasiness
uneasy: uneasy
unecclesiastical: unecclesiastical
unemotional: unemotional
unemployed: unemployed
unenforceability: unenforceability
unerring: unerring
uneventful: uneventful
unexpected: unexpected
unexplained: unexplained
unexplored: unexplored
unfair: unfair
unfamiliar: unfamiliar
unfasten: unfastened
unfold: unfolded,unfolding
unfortunate: unfortunate
unfrocked: unfrocked
unfurnished: unfurnished
ungenerous: ungenerous
ungloved: ungloved
ungracious: ungracious
unguarded: unguarded
unhappily: unhappily
unhappiness: unhappiness
unhappy: unhappy
unheard: unheard
unicorn: unicorn
uniform: uniform
uniformed: uniformed
uninteresting: uninteresting
unique: unique
unite: unites
united: united
university: universities,university
unjust: unjust
unjustifiable: unjustifiable
unkempt: unkempt
unkind: unkind
unknown: unknown
unlink: unlink
unlock: unlock,unlocked
unmarried: unmarried
unmixed: unmixed
unnatural: unnatural
unnecessarily: unnecessarily
unnecessary: unnecessary
unobserved: unobserved
unobtrusive: unobtrusive
unofficial: unofficial
unpardonable: unpardonable
unpleasant: unpleasant
unprincipled: unprincipled
unprotected: unprotected
unquestionably: unquestionably
unreasonable: unreasonable
unreasoning: unreasoning
unresponsive: unresponsive
unrivalled: unrivalled
unroll: unrolling
unromantic: unromantic
unsatisfied: unsatisfied
unscrupulous: unscrupulous
unseen: unseen
unselfish: unselfish
unshaven: unshaven
unsightly: unsightly
unsolicited: unsolicited
unstained: unstained
unsuccessful: unsuccessful
unsullied: unsullied
untenanted: untenanted
unthinkable: unthinkable
untidiness: untidiness
untidy: untidy
untimely: untimely
untiring: untiring
untouched: untouched
untoward: untoward
unturned: unturned
unusual: unusual
unwelcome: unwelcome
unwonted: unwonted
unworldly: unworldly
update: updated
upper: upper
uppermost: uppermost
upraised: upraised
upright: upright
upset: upset
upsetting: upsetting
upstairs: upstairs
upturned: upturned
upward: upward
urge: urge
urgency: urgency
urgent: urgent
urgently: urgently
usage: usage
useless: useless
user: user
usher: ushered
usual: usual
ut: ut
utmost: utmost
utter: utter,uttered,uttering
utterly: utterly
vacancy: vacancies
vacant: vacant
vague: vague
vaguely: vaguely
vain: vain
vale: vale
valet: valet,valets
valuable: valuable,valuables
van: van
vanilla: vanilla
vanish: vanish,vanished
variable: variable
varied: varied
variety: variety
varnish: varnish
varsity: varsity
vary: varying
vast: vast
vehicle: vehicle
veil: veil
veined: veined
velvet: velvet
venerable: venerable
vengeance: vengeance
venomous: venomous
venture: venture,ventured
veranda: veranda
verdict: verdict
verge: verge
verify: verified,verify
version: version
vessel: vessel
vibrate: vibrated,vibrating
vicar: vicar
vice: vices
vicinity: vicinity
vicious: vicious
victim: victim,victims
victory: victory
view: view,viewed,viewing,views
vigil: vigil
vigorous: vigorous
vigour: vigour
vile: vile,vilest
villa: villa
village: village,villages
villager: villagers
villain: villain
villainous: villainous
villainy: villainy
vincent: vincent
vindictive: vindictive
vinegar: vinegar
vintage: vintage
violate: violates
violence: violence
violent: violent
violently: violently
violet: violet
violin: violin
virile: virile
virtuous: virtuous
virulent: virulent
virus: virus
visible: visible
visibly: visibly
vision: vision
visit: visit,visited,visiting,visits
visitor: visitor,visitors
vitality: vitality
vivid: vivid
voice: voice,voices
void: void
volcano: volcano
volley: volley
volume: volume,volumes
voluntarily: voluntarily
voluntary: voluntary
volunteer: volunteer,volunteered,volunteers
von: von
vox: vox
voyage: voyage,voyages
wager: wager
wages: wages
wail: wail
waistcoat: waistcoat
wait: wait,waited,waiting,waits
waiting: waiting
wake: wake,waking,woke
waken: wakened
wales: wales
walk: walk,walked,walking,walks
walking: walking
wall: wall,walls
walled: walled
wander: wander
wane: waning
wanton: wanton
war: war
wardrobe: wardrobe
wares: wares
warm: warm
warmly: warmly
warmth: warmth
warn: warn,warned,warning
warning: warning
warp: warp
warrant: warrant
warranty: warranties,warranty
wary: wary
wash: washed
waste: waste,wasted,wasting
watch: watch,watched,watching
watcher: watchers
water: water,waters
watercourse: watercourse
watering: watering
waterloo: waterloo
waterproof: waterproof
watson: watson
wave: wave,waved,waving
wax: wax,waxed
waxen: waxen
wayside: wayside
wayward: wayward
weak: weak
weakness: weakness
weald: weald
wealth: wealth
wealthy: wealthiest,wealthy
wean: weaned
weapon: weapon,weapons
wear: wearing,wore,worn
wearer: wearer
wearied: wearied
wearily: wearily
weary: weary
weather: weather
weave: weaving,woven
wedding: wedding
wedge: wedged
wednesday: wednesday
week: week,weeks
weigh: weigh
weight: weight
weird: weird
welt: welted
west: west
western: western
westminster: westminster
westward: westward
wet: wet
whale: whale
whaler: whaler
whatsoever: whatsoever
wheel: wheel,wheeled,wheels
wheeler: wheeler
whereabouts: whereabouts
whiff: whiff
whimper: whimper
whimsical: whimsical
whine: whine,whined
whip: whip,whipped
whirl: whirl,whirling
whisk: whisk,whisked
whisker: whiskers
whisky: whisky
whisper: whisper,whispered,whispers
whist: whist
whistle: whistle,whistled
white: white,whiter
whitehall: whitehall
whitewashed: whitewashed
whiz: whiz
wholesale: wholesale
wholly: wholly
wicked: wicked
wickedness: wickedness
wide: wide,widest
widen: widens
widespread: widespread
widow: widow
widower: widower
wife: wife
wild: wild
wilder: wilder
wilderness: wilderness
wildly: wildly
wildness: wildness
wilful: wilful
willful: willful
willingly: willingly
wilson: wilson
win: winning
wince: winced
wind: wind,winds,wound
winding: windings
window: window,windows
windowed: windowed
wine: wine
wineglass: wineglasses
wing: wing
winner: winner
winnings: winnings
winter: winter
wipe: wiped
wire: wire,wired,wires
wiring: wiring
wise: wise,wiser
wisely: wisely
wit: wits
withdraw: withdraw,withdrawn,withdrew
wither: wither,withered
withhold: withheld
witness: witness,witnessed,witnesses
witted: witted
wizard: wizard
wizened: wizened
wolf: wolf
woman: woman,women
womanly: womanly
wonderful: wonderful
wonderfully: wonderfully
wood: wood,woods
wooden: wooden
woodman: woodman
woodwork: woodwork
word: word
worker: workers
workingman: workingman
workman: workman
workmanlike: workmanlike
workpeople: workpeople
worn: worn
worried: worried
worry: worrying
worship: worship
worth: worth
worthy: worthy
wound: wound,wounded,wounds
wounded: wounded
wreck: wreck
wreckage: wreckage
wrench: wrenched
wrestling: wrestling
wretched: wretched
wriggle: wriggle
wright: wright
wring: wring,wrings,wrung
wrist: wrist,wrists
write: write,writing,written,wrote
writer: writer
writhe: writhing
writing: writing
writings: writings
wrong: wrong
wrung: wrung
xxx: xxx
yacht: yacht
yard: yard,yards
yarn: yarn,yarned
yawn: yawns
yell: yell,yelled
yellow: yellow
yesterday: yesterday
yew: yew
yield: yielded
yonder: yonder
york: york
youngster: youngster
youth: youth
youthful: youthful
zealous: zealous
zenith: zenith
zest: zest
zoo: zoo
