abandon: abandon,abandoned
abandonment: abandonment
abate: abate,abates
abide: abiding
ability: abilities,ability
abject: abject
abolish: abolished
abortive: abortive
abreast: abreast
absence: absence
absent: absent
absolute: absolute
absolutely: absolutely
absorb: absorbed
abstain: abstain,abstains
abundance: abundance
accept: accept,accepted
acceptable: acceptable
access: access
accession: accession
accident: accident
acclaim: acclaimed
accommodate: accommodate
accompany: accompanied
accomplish: accomplish,accomplished
accomplished: accomplished
accomplishment: accomplishments
accord: accord,accorded
account: account
accredit: accredited
accumulate: accumulate
accuse: accuse,accused
accustom: accustomed,accustoms
accustomed: accustomed
achieve: achieve,achieved,achieving
achievement: achievements
achilles: achilles
acknowledge: acknowledge,acknowledged
acquaint: acquainted
acquire: acquire,acquired,acquires,acquiring
acquisition: acquisition
acting: acting
action: action,actions
activity: activities,activity
actor: actors
acuteness: acuteness
adapt: adapted
add: add,adding,adds
addict: addict
addition: addition
additional: additional
address: address,addressed
adduce: adduce
adhere: adhered
adherent: adherents
administration: administration
administrator: administrator,administrators
admirable: admirable
admirably: admirably
admiration: admiration
admire: admire,admired
admit: admit,admits,admitted
admonish: admonished
adopt: adopt
adorn: adorned
adornment: adornments
adriatic: adriatic
adroitly: adroitly
advance: advance,advances
advantage: advantage,advantages
advantageous: advantageous
adventure: adventures
adventurous: adventurous
adversary: adversaries
adverse: adverse
adversity: adversity
advice: advice
advisable: advisable
advise: advised
adviser: advisers
advocate: advocates
affability: affability
affable: affable
affair: affair,affairs
affection: affection,affections
affirm: affirm
afraid: afraid
africa: africa
age: age,ages
agency: agencies
agent: agent
aggrandize: aggrandize,aggrandized
aggrandizement: aggrandizement
aggrieved: aggrieved
agility: agility
agree: agree,agreed,agrees
agreeable: agreeable
agreement: agreement
agriculture: agriculture
aid: aid
aim: aim,aims
air: air
alamanni: alamanni
alarm: alarmed
alarmed: alarmed
alba: alba
alexander: alexander
alexandria: alexandria
alien: aliens
alienate: alienate
alike: alike
alive: alive
allegation: allegations
allege: allege,alleged
alleged: alleged
alliance: alliance,alliances
allo: allo
allude: alluded
allurement: allurements
ally: allied,allies,ally
alter: altered
alterum: alterum
altogether: altogether
amazement: amazement
ambassador: ambassador
ambiguous: ambiguous
ambition: ambition,ambitions
ambitious: ambitious
amity: amity
ample: ample
amuse: amusing
anarchy: anarchy
ancestor: ancestors
ancient: ancient
ancor: ancor
andria: andria
anger: anger,angered
animosity: animosity
anne: anne
annex: annexed
annoyance: annoyances
answer: answer,answered,answers
anticipate: anticipated,anticipating
antiquity: antiquity
antonio: antonio
anxiety: anxieties,anxiety
anxious: anxious
apparel: apparel
apparent: apparent
appearance: appearance
append: appended
applicable: applicable
apply: applied,apply
appoint: appointed
appointment: appointment
appreciative: appreciative
apprehend: apprehends
approach: approach,approached,approaches,approaching
arbiter: arbiter,arbiters
arbitrament: arbitrament
archbishop: archbishop
archer: archers
architect: architect
argue: argue
argument: argument
arm: arm,armed,arming,arms
armament: armaments
armed: armed
army: armies,army
arrange: arrange,arranged
arrangement: arrangement
array: array,arrayed
arrest: arrest,arrested
arrival: arrival
arrive: arrive,arrived,arrives
arrow: arrow
ars: ars
art: art,arts
arte: arte
artel: artel,artels
artfully: artfully
artillery: artillery
artistic: artistic
ascend: ascends
ascendancy: ascendancy
ascent: ascent
ashamed: ashamed
asia: asia
asiatic: asiatic
aspect: aspect
asperity: asperity
aspire: aspire,aspired
assail: assailed
assassination: assassination,assassinations
assault: assault
assemble: assemble,assembled,assembling
assent: assent
assert: asserted,asserting
assign: assigned
assignable: assignable
assist: assist,assisted,assisting,assists
assistance: assistance
associate: associate
association: associations
assume: assume,assumed
assure: assured,assures
astonished: astonished
astonishing: astonishing
astute: astute
astuteness: astuteness
athenians: athenians
athens: athens
atop: atop
attach: attach,attached
attachment: attachment
attack: attack,attacked,attacking,attacks
attain: attain,attained,attaining,attains
attempt: attempt,attempted,attempts
attention: attention,attentions
attentively: attentively
attract: attract,attracted
attraction: attraction
attribute: attribute,attributed,attributes
audacity: audacity
augment: augmenting
august: august
auspices: auspices
austere: austere
austria: austria
author: author
authority: authorities,authority
auxiliaries: auxiliaries
auxiliary: auxiliaries
avail: avail,availed,availing
avarice: avarice
avaricious: avaricious
avenge: avenge,avenged
average: average
avoid: avoid,avoided,avoiding,avoids
await: await,awaited
awaken: awaken
aware: aware
awed: awed
axiom: axiom
baby: baby
bacon: bacon
bad: bad,worse,worst
badly: badly
balance: balanced
balcony: balcony
band: band
banish: banished
banishment: banishment
bank: bank,banks
banner: banner
banquet: banquet,banquets
baptize: baptized
barbarian: barbarians
barbarity: barbarity
barbarous: barbarous
bare: bare
baron: baron,barons
barren: barren
barrier: barriers
base: based
baseness: baseness
basis: bases
bath: baths
bathe: bathes
battalion: battalions
battle: battle,battles
battlefield: battlefield
beam: beams
bear: bear,bearing,bears,born,borne
bearing: bearing
beast: beast,beasts
beat: beat,beaten
beatrice: beatrice
beautiful: beautiful
becomingly: becomingly
bed: bed
befall: befall
beg: beg,begged,begging
beget: begets
behalf: behalf
behave: behave
behead: beheaded
behold: beheld
behove: behoved
belief: belief
belong: belong,belongs
beloved: beloved
benefactor: benefactor
benefice: benefices
benefit: benefit,benefited,benefits
benignant: benignant
benignity: benignity
bergamo: bergamo
beset: beset
besiege: besiege,besieged,besieging
bestow: bestowed,bestows
bestrew: bestrewn
betake: betook
betrayal: betrayal
bianca: bianca
bianchi: bianchi
bid: bid
billet: billets
bind: bind,binding,binds,bound
birth: birth
bit: bit
biting: biting
blacksmith: blacksmith
blame: blame,blamed
blindfold: blindfolded
block: block,blocks
blood: blood
bloodshed: bloodshed
bloody: bloody
blow: blow,blows
blunder: blunder
blush: blush,blushing
boast: boast,boasting
bodily: bodily
body: bodies,body
bodyguard: bodyguard
bold: bold,bolder
boldly: boldly
boldness: boldness
bologna: bologna
bolognese: bolognese
bond: bond
bondage: bondage
bondman: bondmen
bone: bones
bons: bons
book: book,books
border: borders
bound: bound,bounded,bounds
boundless: boundless
bow: bow
bowshot: bowshot
boy: boy,boys
braccio: braccio
brag: bragged
branch: branch
brave: brave
break: break,broke,broken
breed: breeds
brevity: brevity
bridge: bridge
bridle: bridle
bring: bring,bringing,brings,brought
british: british
brittany: brittany
brocaded: brocaded
brother: brother
brutal: brutal
buckler: bucklers
build: build,builds,built
building: building,buildings
burd: burd
burden: burden,burdening
burgundy: burgundy
burn: burn,burnt
bury: buried
business: business
caesar: caesar
calling: callings
calm: calm
calumny: calumnies
camp: camp
campaign: campaign,campaigns
canal: canal
cancel: cancel
canonry: canonry
canst: canst
canzoni: canzoni
cap: cap
capability: capabilities
capable: capable
capacity: capacity
cape: cape
capital: capital
capitano: capitano
captain: captain,captains
captive: captive
capture: capture,captured
cardinal: cardinal,cardinals
care: care,cares,caring
career: career
careful: careful
carefully: carefully
carlo: carlo
carrara: carrara
carry: carried,carry,carrying
carthaginian: carthaginian
cask: cask
cast: cast
castellan: castellan
castile: castile
castle: castle,castles
catch: catch
catherine: catherine
catholic: catholic
caution: caution
cautious: cautious
cautiously: cautiously
cavalcade: cavalcade
cavalry: cavalry
cease: ceased
celebrate: celebrated,celebrating
cenotaph: cenotaph
centaur: centaur
center: center
centre: centre
centurion: centurion
century: centuries
certainty: certainty
cesare: cesare
chain: chained
chalk: chalk
challenge: challenge
chamber: chamber
champion: champion
chance: chance,chances
chancellor: chancellor
chancery: chancery
change: change,changed
changeable: changeable
changeful: changeful
chapter: chapter
character: character,characters
characteristic: characteristic,characteristics
charge: charge,charged
charger: charger
charles: charles
charm: charm
chase: chase
chaste: chaste
chastise: chastised
chastity: chastity
che: che
cheat: cheated
check: check
cherish: cherish
chiding: chiding
chief: chief,chiefs
chiefly: chiefly
child: child,children
childhood: childhood
chill: chill
chiron: chiron
choice: choice
choose: choose,chooses,choosing,chose
christendom: christendom
christian: christian
christopher: christopher
church: church
cicero: cicero
circle: circles
circumspect: circumspect
circumstance: circumstance,circumstances
circumvent: circumvent
citadel: citadel
cite: cite,cited
citizen: citizen,citizens
city: cities,city
civil: civil
clan: clans
class: classes
clean: clean
cleanse: cleanse
clemency: clemency
clement: clement
clever: clever
cleverly: cleverly
cleverness: cleverness
cloak: cloak
close: close,closed
closely: closely
cloth: cloth
clothe: clothed
clothes: clothes
cloud: cloud
col: col
coldly: coldly
colleague: colleague
collect: collected
collection: collection
collectively: collectively
college: college
colony: colonies,colony
colouring: colouring
combat: combat,combats
combatter: combatter
combination: combination
comedy: comedy
coming: coming
command: command,commanded,commands
commemoration: commemoration
commence: commenced,commencing
commencement: commencement
commend: commended
comment: commenting,comments
commerce: commerce
commission: commission,commissioned
commissioner: commissioners
commit: commit,committed
common: common
commotion: commotion
communicate: communicate,communicated
communication: communications
community: community
companion: companion,companions
company: company
comparatively: comparatively
compare: compare,compared
comparison: comparison
compass: compass
compassion: compassion
compassionate: compassionate
compel: compelled,compels
compete: compete
complacent: complacent
complain: complained
complete: complete,completed
completely: completely
complex: complex
compliance: compliance
complicate: complicated
complicity: complicity
compose: composed
composite: composite
composition: composition
comprehend: comprehended,comprehends
comprehensively: comprehensively
compromise: compromising
conceal: conceal,concealed,conceals
concede: conceded
conceive: conceived
concern: concerns
concerned: concerned
concession: concessions
conclude: conclude,concluded,concludes
conclusion: conclusion,conclusions
concur: concur
concurrent: concurrent
concurrently: concurrently
condemn: condemn
condemnation: condemnation
condition: condition,conditions
conduce: conduce
conduct: conduct
confer: confer,conferred
confess: confess
confide: confided
confidence: confidence
confine: confining
confirm: confirmed,confirming
conflict: conflict
conform: conform,conformed
confront: confront,confronted
confusion: confusion,confusions
conjecture: conjecture
connect: connected
connection: connection
conquer: conquer,conquered,conquering,conquers
conqueror: conqueror,conquerors
conquest: conquest,conquests
conscious: conscious
consent: consent,consented
consequent: consequent
consideration: consideration,considerations
consist: consisted,consisting,consists
consistent: consistent
consolidated: consolidated
consort: consort
conspiracy: conspiracies,conspiracy
conspirator: conspirator,conspirators
conspire: conspire,conspired,conspires
constant: constant
constantinople: constantinople
constitute: constituted,constitutes
constitution: constitution,constitutions
constrain: constrain,constrained
constraint: constraint
construct: constructed
construction: construction
consult: consulted
consume: consume,consuming
consummate: consummate,consummating
contact: contact
contemplate: contemplate
contemporary: contemporaries,contemporary
contempt: contempt
contemptible: contemptible
contend: contend,contended
content: content
contented: contented
contents: contents
contest: contesting
continual: continual
continuance: continuance
continue: continue,continued,continues,continuing
contrary: contrary
contribute: contributed,contributes
control: control,controlled
contumeliously: contumeliously
convenient: convenient
convention: convention
converge: converge
conversation: conversation
convert: converting
convey: conveys
convinced: convinced
cool: cooled
coolness: coolness
copiously: copiously
corn: corn
corporation: corporation
correct: correct
correctly: correctly
correspondence: correspondence
correspondency: correspondencies,correspondency
corrupt: corrupt,corrupted,corrupting
corrupter: corrupter
corruption: corruption
coryphaeus: coryphaeus
cose: cose
cost: cost,costs
costly: costly
council: council,councils
councillor: councillors
counsel: counsel,counsels
counsellor: counsellors
count: count
countenance: countenance
counter: counter
counteract: counteract
counterfeit: counterfeit
countess: countess
country: countries,country
countryside: countryside
courage: courage
courageous: courageous
court: court,courts
courteous: courteous
courtesy: courtesy
covenant: covenants
cover: covered
covetous: covetous
cowardice: cowardice
cowardly: cowardly
craft: craft
create: create,created
credit: credit,credited
creed: creed
crime: crime,crimes
cringe: cringed
critic: critics
cross: cross,crossed,crosses,crossing
crossing: crossing
crown: crown
cruel: cruel
cruelty: cruelties,cruelty
crush: crush,crushed,crushing
cum: cum
cunning: cunning
curb: curb,curbing
cure: cure,cured
curiously: curiously
current: currents
curse: cursed
custode: custode
custom: custom,customs
customary: customary
cut: cut
cyrus: cyrus
da: da
daily: daily
dainty: dainty
dal: dal
damage: damage
danaro: danaro
dance: dancing
danger: danger,dangers
dangerous: dangerous
dante: dante
darius: darius
dash: dashed
dastardy: dastardy
daughter: daughter
david: david
day: day,days
daybreak: daybreak
dead: dead
deal: deal,dealing,deals,dealt
dealing: dealing
dealings: dealings
dearness: dearness
death: death,deaths
debatable: debatable
debate: debate
debt: debts
decade: decade
deceit: deceits
deceive: deceive,deceived,deceives
december: december
decide: decide,decided
decision: decision
decisive: decisive
declare: declare,declares,declaring
decline: decline
decrease: decrease
decree: decree,decreed,decrees
dedicate: dedicate,dedicated,dedicates
dedication: dedication
deed: deeds
deem: deeming
deep: deep
deeply: deeply
defeat: defeat,defeated
defect: defect,defects
defence: defence,defences
defend: defend,defended,defending,defends
defender: defender,defenders
defensive: defensive
defer: defer,deferred
deferential: deferential
defiance: defiance
deflect: deflect
defy: defy
degree: degree
dei: dei
deity: deity
dejected: dejected
del: del
delay: delayed
deliberately: deliberately
delicate: delicate
delight: delight,delighting
delighted: delighted
delightful: delightful
delinquent: delinquents
deliver: deliver,delivered
deliverance: deliverance
dell: dell
della: della
demand: demand,demanded,demands
demolish: demolish
demonstrate: demonstrate
denounce: denouncing
deny: deny
depart: depart
departure: departure
depend: depend,depended
dependent: dependent,dependents
depict: depicted
depot: depots
deprive: deprived,deprives,depriving
deputy: deputy
descend: descending
descent: descent
description: description
deserve: deserved
design: design,designing,designs
designate: designate
desirable: desirable
desire: desire,desired,desires,desiring
desirous: desirous
desist: desist
desolation: desolation
despair: despair
despairing: despairing
desperate: desperate
desperation: desperation
despise: despised
despiser: despiser
despoil: despoiled
destroy: destroy,destroyed,destroying,destroys
destruction: destruction
destructive: destructive
detect: detect,detected
deter: deterred
determine: determined
detriment: detriment
deviate: deviate,deviated
devise: devised
devote: devoted
devoted: devoted
devotion: devotion
dexterity: dexterity
di: di
dialogue: dialogue
dictate: dictated
dido: dido
die: die,died,dying
diet: diet
difference: difference,differences
difficult: difficult
difficulty: difficulties,difficulty
digest: digested
dignified: dignified
dignity: dignity
diligence: diligence
diligently: diligently
diminish: diminished
dinner: dinner
diplomatic: diplomatic
direct: direct,directed,directs
direction: direction
dirt: dirt
disadvantage: disadvantage
disadvantageous: disadvantageous
disaffected: disaffected
disarm: disarm,disarmed
disaster: disaster
disastrous: disastrous
discern: discern,discerned,discerning
discipline: discipline
discontent: discontent,discontented
discontented: discontented
discourage: discourage
discourse: discourse,discoursed,discourses
discover: discover,discovered
discreetly: discreetly
discretion: discretion
discriminating: discriminating
discrimination: discrimination
discuss: discuss,discussed,discussing
discussion: discussion,discussions
disdain: disdain
disengage: disengaged
disgrace: disgrace
disguise: disguise
disgusted: disgusted
disloyal: disloyal
dismantle: dismantle,dismantled
dismay: dismay
dismayed: dismayed
dismiss: dismissed
dismissal: dismissal
dismount: dismounted
disorder: disorder,disorders
dispatch: dispatched,dispatches
dispense: dispensed
disperse: dispersed
dispersed: dispersed
displace: displace
display: display,displaying
displease: displease
displeased: displeased
dispose: disposed
disposed: disposed
disposition: disposition,dispositions
dispossessed: dispossessed
disputable: disputable
dispute: dispute,disputes
disregard: disregard
dissembler: dissembler
dissension: dissensions
dissolution: dissolution
dissolve: dissolving
distance: distance
distant: distant
distinct: distinct
distinction: distinction
distinguish: distinguish,distinguished
distinguished: distinguished
distract: distracted
distribute: distributed
district: district,districts
distrust: distrust,distrusted
disturb: disturbed
disturbance: disturbance,disturbances
disunion: disunion
disunited: disunited
ditch: ditch,ditches
diver: divers
diverge: diverge
divert: diverted
divide: divide,divided,dividing
divided: divided
divorce: divorced
doctor: doctors
doctrine: doctrine
dog: dogs
domination: domination
dominion: dominion,dominions
door: door
dost: dost
doth: doth
double: double
doubly: doubly
doubt: doubt
doubtless: doubtless
downfall: downfall
downright: downright
downward: downward
draw: draw,drawing,drawn,draws,drew
dread: dread
dream: dream
dress: dress
dressed: dressed
drill: drilled,drilling
drink: drink
drinking: drinking
drive: drive,driven,drives,driving,drove
ducat: ducat,ducats
duchy: duchy
duel: duels
duke: duke,dukes
duo: duo
dupe: dupes
dura: dura
durable: durable
duration: duration
dust: dust
duty: duties,duty
eagerness: eagerness
ear: ears
earn: earn,earned
earthen: earthen
ease: ease
easily: easily
eastern: eastern
easy: easier,easy
eat: eat,eaten,eating
eating: eating
ecclesiastical: ecclesiastical
economy: economy
edge: edge
edifice: edifice
edify: edifying
edition: edition,editions
edward: edward
effective: effective
effeminacy: effeminacy
effeminate: effeminate
efficacious: efficacious
efficient: efficient
egypt: egypt
egyptian: egyptians
eighteenth: eighteenth
eighth: eighth
elect: elect,elected
election: election
element: elements
elevate: elevate,elevated
elevation: elevation
eleventh: eleventh
elizabethan: elizabethan
elucidate: elucidates
embassy: embassies
embellish: embellish,embellished
embolden: emboldened
embroider: embroidered
embroil: embroil
eminence: eminence
eminent: eminent
emperor: emperor,emperors
empire: empire
employ: employ,employed,employs
employment: employment,employments
enable: enable,enabled,enables,enabling
encampment: encampment,encampments
encounter: encounter,encountered
encourage: encourage,encouraged
encouragement: encouragement
endanger: endangered
endeavour: endeavour,endeavoured
endless: endless
endow: endow,endowed
endure: endure,endured,enduring
enemy: enemies,enemy
energy: energy
enforce: enforced
enforced: enforced
engage: engage,engaged
engaged: engaged
engagement: engagements
english: english
englishman: englishman
enhance: enhanced
enjoy: enjoy,enjoyed
enlarge: enlarged
enlist: enlist,enlisted,enlisting
enmity: enmities
ennoble: ennobled
enormous: enormous
enormously: enormously
enrage: enraged
enrich: enriching
enrol: enrolled
ensign: ensigns
enslave: enslaved
enter: enter,entered,entering,enters
enterprise: enterprise,enterprises
entertain: entertain,entertained
entertainment: entertainments
entire: entire
entrance: entrance
entreat: entreat,entreated,entreats
entrust: entrusting
entry: entry
enumerate: enumerated
envelop: enveloped
envious: envious
environment: environment
envoy: envoy,envoys
envy: envied,envy
eo: eo
equal: equal,equals
equally: equally
equivalent: equivalent
era: era
err: err,erred
erroneous: erroneous
error: error,errors
escape: escape,escaped
essential: essential
essex: essex
est: est
establish: establish,established,establishing
estate: estate
esteem: esteem,esteemed
esteemed: esteemed
estimate: estimate
estimation: estimation
eternal: eternal
ethic: ethics
europe: europe
european: european
evening: evening,evenings
event: event,events
eventuality: eventualities
evidence: evidence,evidences
evil: evil,evils
exact: exact
exalt: exalted
examine: examine,examined,examining
exasperate: exasperated
excel: excelled
excellent: excellent
exceptional: exceptional
excess: excess,excesses
excessive: excessive
exchange: exchange
excision: excisions
exclaim: exclaims
excuse: excuse,excuses
execute: executed
execution: execution,executions
executor: executor
exemplar: exemplar
exercise: exercise,exercised,exercises
exhaust: exhausted
exhausted: exhausted
exhibit: exhibit
exhort: exhorted,exhorting
exhortation: exhortation
exile: exile,exiled,exiles
exist: exist
existence: existence
expand: expanded
expanse: expanse
expansion: expansion
expect: expect,expected,expecting,expects
expectation: expectation,expectations
expedient: expedient,expedients
expedition: expedition,expeditions
expense: expense,expenses
experience: experience,experiences
experiment: experiment
expose: exposed
express: express
expression: expression
expulsion: expulsion
extend: extended
extent: extent
exterminate: exterminate,exterminated,exterminating
external: external
extinguish: extinguish,extinguished
extortion: extortion
extract: extracts
extraordinarily: extraordinarily
extraordinary: extraordinary
extreme: extreme
extremity: extremity
extricate: extricating
extrinsic: extrinsic
eye: eye,eyes
facile: facile
facilitate: facilitates
faction: faction,factions
fade: fade
fail: fail,failed,failing,fails
failure: failure,failures
fair: fair
faith: faith
faithful: faithful
faithless: faithless
faithlessness: faithlessness
fall: fall,fallen,falling,falls,fell
fallacious: fallacious
false: false
fame: fame
family: families,family
famous: famous
fancy: fancies
fano: fano
fare: fare
fast: fast
fasten: fasten
fatal: fatal
fatality: fatality
fate: fate
father: father,fathers
fatherland: fatherland
fatigue: fatigue
fatigued: fatigued
fault: fault
favour: favour,favoured,favouring,favours
favourable: favourable
fear: fear,feared,fearing,fears
feast: feasts
february: february
feed: fed,feed
feel: feel,feeling
felicity: felicity
fellow: fellow
ferocity: ferocity
ferrara: ferrara
fervent: fervent
fester: festered
festival: festivals
feud: feud
fever: fever,fevers
fickle: fickle
fidelity: fidelity
field: field
fiery: fiery
fight: fight,fighting,fought
fighting: fighting
figuratively: figuratively
filippo: filippo
final: final
finally: finally
fine: fine,fines,finest
finish: finish,finished
firebrand: firebrand
firing: firing
firm: firm
firmly: firmly
firstly: firstly
fish: fishes
fisherman: fisherman
fit: fit
flank: flank,flanks
flatterer: flatterer,flatterers
flavour: flavour
flee: fled
flight: flight
flock: flocked
flood: flood
florence: florence
florentine: florentine
florentines: florentines
florin: florins
flourish: flourished
flower: flowers
fluent: fluent
fly: flies,fly
focus: focused
foe: foe
foliage: foliage
follow: follow
follower: followers
folly: folly
food: food,foods
fool: fool
foot: feet,foot
foothold: foothold
footing: footing
footman: footmen
footstep: footsteps
forbearance: forbearance
force: force,forced,forces,forcing
fordable: fordable
forefather: forefathers
foreign: foreign
foreigner: foreigner,foreigners
foremost: foremost
foresee: foreseeing,foreseen
forget: forget
form: form,formed,forms
formidable: formidable
forsake: forsook
fort: fort
forte: forte
fortify: fortified,fortify,fortifying
fortitude: fortitude
fortress: fortress,fortresses
fortunate: fortunate
fortune: fortune,fortunes
foster: foster,fostered
foundation: foundation,foundations
founder: founder
fourteen: fourteen
fourthly: fourthly
fox: fox
fra: fra
frame: framed
france: france
francia: francia
francis: francis
fraud: fraud
fray: fray
frederick: frederick
freedom: freedom
freely: freely
french: french
frenchmen: frenchmen
frequent: frequent
frequently: frequently
fresh: fresh
friar: friar
friend: friend,friends
friendly: friendly
friendship: friendship,friendships
frivolous: frivolous
fruit: fruit
frustrate: frustrated
fulfil: fulfilled
fulfilment: fulfilment
fundamental: fundamental
furnish: furnish,furnished
furore: furore
fury: fury
future: future
gain: gain,gained,gaining
gallantly: gallantly
game: games
gaming: gaming
garden: gardens
garrison: garrison,garrisons
gate: gate,gates
gather: gather,gathered
gazette: gazette
genera: genera
generality: generality
generous: generous
genius: genius
genoa: genoa
gentile: gentile
gentleman: gentleman,gentlemen
gently: gently
george: george
germ: germs
german: german,germans
germany: germany
gesso: gesso
ghibelline: ghibelline
gibe: gibe
gift: gift,gifts
giovanni: giovanni
girl: girl
giver: giver
gladiator: gladiators
glass: glass
glorious: glorious
gloriously: gloriously
glory: glory
gluttonous: gluttonous
goal: goal
god: god
gold: gold
goliath: goliath
goodness: goodness
goodwill: goodwill
goths: goths
govern: govern,governed,governs
governance: governance
government: government,governments
governor: governor
governorship: governorship,governorships
grace: grace,graces
gracious: gracious
graciously: graciously
granada: granada
grandfather: grandfather
grandson: grandson
grant: grant,granted
gratify: gratify
gratitude: gratitude
grave: grave
gravity: gravity
greatly: greatly
greatness: greatness
greece: greece
greed: greed
greek: greeks
green: green
ground: ground
grow: grew,grow,growing
guard: guard,guarding,guards
guelph: guelph
guerdon: guerdon
guidance: guidance
guide: guide,guided
guido: guido
guild: guilds
guilds: guilds
hail: hail
hair: hair
hallowed: hallowed
hand: hand,hands
handed: handed
handle: handled,handling
handsome: handsome
hang: hung
hannibal: hannibal
happen: happen,happened
happy: happy
harbour: harbour,harbouring
hard: hard
hardship: hardship,hardships
harm: harm
harsh: harsh
hast: hast
haste: haste
hasten: hastened
hat: hat
hate: hate,hated
hatred: hatred
haughty: haughty
haunted: haunted
hazard: hazard
hazardous: hazardous
head: head,heads
headquarters: headquarters
heal: heal
health: health
hear: hear,heard,hearing,hears
heavy: heavy
hebrews: hebrews
hectic: hectic
height: height
heir: heir,heirs
heliogabalus: heliogabalus
hellespont: hellespont
helmet: helmet
helpful: helpful
helpless: helpless
henry: henry
herb: herbs
hereditary: hereditary
heresy: heresy
hero: hero
hesitate: hesitate,hesitated,hesitates
hesitation: hesitation
hide: hidden
highly: highly
hill: hill,hills
hinder: hinder,hindered
hindrance: hindrance
historical: historical
history: histories,history
hit: hit
hoc: hoc
hold: held,hold,holding,holds
holiness: holiness
holy: holy
homage: homage
honest: honest
honestly: honestly
honesty: honesty
honor: honor
honour: honour,honoured,honouring,honours
honourably: honourably
hope: hope,hoped,hopes,hoping
horse: horse,horses
horseback: horseback
horseman: horseman,horsemen
hostile: hostile
hot: hot
hour: hours
house: house,houses
huge: huge
huguenot: huguenot
human: human
humane: humane
humanity: humanity
humble: humble,humbled,humbling
humour: humours
hungry: hungry
hunt: hunted
hurry: hurried
hurt: hurt
hurtful: hurtful
husband: husbands
idea: idea
idle: idle,idled
idleness: idleness
ignominy: ignominies
ignorance: ignorance
ignore: ignoring
iii: iii
illness: illness
illustrate: illustrate,illustrated
illustrious: illustrious
imaginary: imaginary
imagination: imagination
imagine: imagine,imagined
imitate: imitate,imitated
imitation: imitation
immense: immense
impart: imparted
impede: impeded
imperial: imperial
imperil: imperilled
impetuous: impetuous
impetuously: impetuously
impinge: impinge
imply: implies,implying
impose: imposing
impossible: impossible
impotence: impotence
impressed: impressed
impression: impression
imprison: imprisoned
improve: improved,improving
improvement: improvements
imprudent: imprudent
impugn: impugn
impulse: impulse
imputation: imputation
incautious: incautious
incense: incensed
inception: inception
incessantly: incessantly
incident: incidents
incite: incited
incline: inclined,inclines
inclined: inclined
include: include,included
income: income
inconsiderable: inconsiderable
inconstant: inconstant
incontrovertible: incontrovertible
increase: increase,increased,increasing
incredulity: incredulity
incur: incur,incurred,incurring
incurable: incurable
indebted: indebted
indication: indication,indications
indifferently: indifferently
indignity: indignity
individual: individual,individuals
induce: induce,induced,induces
inducement: inducement
induct: inducted
indulge: indulge
indulgence: indulgence
industry: industry
inevitably: inevitably
inexperience: inexperience
inexperienced: inexperienced
inextricably: inextricably
infamous: infamous
infamy: infamies
infant: infant
infantry: infantries,infantry
infantryman: infantrymen
infantrymen: infantrymen
infelicity: infelicity
infer: infer,inferred
inferior: inferior,inferiors
inferiority: inferiority
inferno: inferno
infidel: infidels
infinite: infinite
infinitely: infinitely
inflict: inflict,inflicted,inflicting
influence: influence,influenced,influences
inform: informed
ingratitude: ingratitude
inhabitant: inhabitants
inherent: inherent
inherit: inherited
inhuman: inhuman
inhumanity: inhumanity
iniquity: iniquity
initiative: initiative
injure: injure,injured,injures,injuring
injurious: injurious
injury: injuries,injury
innovation: innovations
innovator: innovator,innovators
inordinate: inordinate
inquire: inquire,inquired,inquires
inquirer: inquirer
inquiry: inquiries
insecure: insecure
insight: insight
insignificant: insignificant
insist: insisting,insists
insolence: insolence
insolent: insolent
insomuch: insomuch
inspire: inspire,inspiring
instance: instance,instances
institution: institutions
instruction: instruction
instrumental: instrumental
instrumentality: instrumentality
insufficiency: insufficiency
insult: insulted
insurgent: insurgents
insurrection: insurrections
integrity: integrity
intellect: intellect,intellects
intelligence: intelligence
intend: intended,intending,intends
intention: intention,intentions
intercept: intercept
interfere: interfere,interfered,interfering
internal: internal
interpret: interpret
interval: interval
intervene: intervened
intervention: intervention
intimate: intimate
intolerable: intolerable
intoxicate: intoxicated
intrigue: intrigue
introduce: introduce,introduced
introduction: introduction
invade: invade,invaded
invariably: invariably
invasion: invasion
invent: invent
invest: invests
invite: invited
involved: involved
inwardly: inwardly
irresolute: irresolute
irrevocable: irrevocable
israel: israel
issue: issue,issued
italian: italian,italians
italici: italici
italy: italy
iv: iv
ix: ix
january: january
javelin: javelin,javelins
jealousy: jealousy
jeanne: jeanne
joannes: joannes
johanna: johanna
john: john
joust: jousts
jove: jove
judge: judge,judges
judgment: judgment,judgments
julian: julian
julius: julius
june: june
justice: justice
justification: justification
justify: justified
kill: kill,killed,killing
kindness: kindnesses
king: king,kings
kingdom: kingdom,kingdoms
knee: knees
knife: knife
knight: knight,knighted,knights
knot: knot
knowingly: knowingly
knowledge: knowledge
labour: labour,laboured,labours
lace: lace
lack: lack,lacks
lad: lad
ladder: ladder
lady: ladies,lady
lamentable: lamentable
lance: lance
lancer: lancers
land: land,lands
landing: landing
landscape: landscapes
language: language
lap: lap,laps
lapse: lapse
lascivious: lascivious
late: late
latin: latin
laugh: laugh,laughed
law: law,laws
lawyer: lawyer
lay: laid,lay
le: le
lead: lead,leading,leads,led
leader: leader,leaders
leadership: leadership
leading: leading
leaf: leaves
league: league
leap: leaping
learn: learn,learned,learning,learns,learnt
learning: learning
leave: leave,leaves,leaving,left
left: left
legate: legate
leghorn: leghorn
legitimate: legitimate
leo: leo
lessen: lessen,lessened
lesson: lessons
letter: letter,letters
letters: letters
liability: liability
liable: liable
liberal: liberal
liberality: liberality
liberate: liberate,liberated,liberating
liberation: liberation
liberator: liberator
liberty: liberty
license: license
licentiously: licentiously
licet: licet
lie: lie,lying
lieutenant: lieutenant
life: life,lives
lifetime: lifetime
lift: lifted
light: light,lighter
lightly: lightly
liking: liking
limb: limbs
limit: limits
linen: linen
lingua: lingua
link: link
lion: lion
lip: lips
list: list
listen: listen,listened,listening
listener: listener
literal: literal
literary: literary
literature: literature
live: live,lived,lives,living
lively: lively
living: living
lo: lo
locality: localities,locality
lodge: lodged
lodgings: lodgings
lofty: lofty
lombardian: lombardian
lord: lord,lords
lords: lords
lordship: lordship
lorenzo: lorenzo
lose: lose,loses,losing,lost
loss: loss,losses
lost: lost
louis: louis
love: love,loved,loving
lover: lover,lovers
lovingly: lovingly
lowly: lowly
loyal: loyal
loyalty: loyalty
lucchese: lucchese
luck: luck
luigi: luigi
lukewarm: lukewarm
lukewarmly: lukewarmly
luxury: luxuries
macedon: macedon
macedonia: macedonia
machiavel: machiavel
madonna: madonna
magistracy: magistracy
magistrate: magistrate,magistrates
magnanimous: magnanimous
magnificence: magnificence
magnificent: magnificent
magnifico: magnifico
main: main
maintain: maintain,maintained,maintaining,maintains
maintenance: maintenance
majesty: majesty
majority: majority
malady: malady
malcontent: malcontent,malcontents
malignity: malignity
mall: mall
manacle: manacles
manage: manage,managed
management: management
manfred: manfred
manifest: manifest,manifested
mankind: mankind
manna: manna
manner: manner
mantua: mantua
march: march,marched,marching
maria: maria
mark: mark
marquess: marquess
marriage: marriage
marry: married,marry
marsh: marshes
martial: martial
marvel: marvel
mary: mary
mass: masses
massa: massa
master: master,mastered,masters
mastery: mastery
material: material
maternal: maternal
matter: matter,matters
maxim: maxims
maximus: maximus
meaning: meaning
meanness: meanness
measure: measure,measured,measures
measured: measured
medal: medals
mediation: mediation
mediator: mediator
medicean: medicean
medici: medici
medicine: medicine
meditation: meditation
meet: meet,meeting,meets,met
meeting: meeting,meetings
memorial: memorials
memory: memories,memory
mental: mental
mention: mention,mentioned,mentioning
mercenary: mercenaries,mercenary
merchant: merchants
merciful: merciful
mercy: mercy
mere: mere
merit: merited,merits
messer: messer
method: method,methods
michelle: michelle
midday: midday
middle: middle
midnight: midnight
midst: midst
mighty: mighty
milan: milan
milanese: milanese
mild: mild
mile: mile,miles
military: military
mind: mind,minds
minister: minister,ministers
minor: minor
minority: minority
miracle: miracle
miserable: miserable
miserly: miserly
misfortune: misfortunes
mislead: misled
mission: mission,missions
mistake: mistake,mistakes
misuse: misuse
mitigate: mitigate
mix: mixed
mixed: mixed
moderate: moderate,moderated
moderately: moderately
modern: modern
modest: modest
modestly: modestly
modesty: modesty
modo: modo
monarch: monarch
monarchy: monarchy
money: money
mons: mons
monsignor: monsignor
month: month,months
monument: monument
moors: moors
moral: moral
moralize: moralizes
morning: morning,mornings
moro: moro
morrow: morrow
moses: moses
mother: mother
motion: motion
motive: motives
mots: mots
mould: mould
mount: mount,mounted,mounting
mountain: mountains
mountaineer: mountaineers
mourning: mourning
mouth: mouth,mouths
movement: movement,movements
mud: mud
mule: mules
multiply: multiply
multitude: multitude
munitions: munitions
murder: murder,murdered,murdering,murders
murderer: murderer
music: music
nabis: nabis
nam: nam
naples: naples
narrow: narrow
narrowly: narrowly
narrowness: narrowness
nation: nation,nations
national: national
native: native,natives
natural: natural
naturally: naturally
nature: nature,natures
neapolitan: neapolitans
nearer: nearer
necessity: necessities,necessity
necromancer: necromancer
nefarious: nefarious
neglect: neglect,neglected,neglecting,neglects
negotiate: negotiate
neighbour: neighbours
nell: nell
nephew: nephew,nephews
neri: neri
neutral: neutral
neutrality: neutrality
newly: newly
news: news
nicolo: nicolo
night: night
nobility: nobility
noble: noble,nobles
nobleman: noblemen
nobly: nobly
noise: noise
normandy: normandy
nose: nose
notable: notable
note: note,noting
noteworthy: noteworthy
notice: notice,noticed,noticing
noticeable: noticeable
notion: notions
november: november
numberless: numberless
numerous: numerous
nurse: nurse,nursed
oath: oath,oaths
obedience: obedience
obedient: obedient
obeisance: obeisance
obey: obey,obeyed
object: object,objects
objection: objections
obligation: obligation,obligations
oblige: obliged
obscurity: obscurity
obsequy: obsequies
observance: observance,observances
observation: observation
observe: observe,observed,observes,observing
obsolete: obsolete
obstacle: obstacles
obstinate: obstinate
obstruct: obstructed
obvious: obvious
occasion: occasion,occasioned,occasions
occasional: occasional
occupation: occupations
occupied: occupied
occupy: occupied,occupy,occupying
occur: occur,occurred
occurrence: occurrence,occurrences
odious: odious
offence: offence
offend: offend,offended,offending,offends
offended: offended
offer: offer,offered,offering,offers
office: office,offices
officer: officers
official: official,officials
oligarchy: oligarchy
omit: omit
oneself: oneself
onset: onset
openly: openly
opinion: opinion,opinions
opponent: opponents
opportunity: opportunities,opportunity
oppose: oppose,opposed,opposing
opposition: opposition
oppress: oppress,oppressed,oppressing
oppressed: oppressed
oration: oration
ordain: ordained
ordinance: ordinance,ordinances
ordinary: ordinary
organize: organized
oriental: oriental
original: original
originate: originate,originated
ornament: ornaments
orphan: orphan
ottave: ottave
outrage: outrage,outraged
outrageous: outrageous
outwit: outwit
overawe: overawed
overcome: overcame,overcome,overcoming
overflow: overflows
overheated: overheated
overlook: overlook
overreach: overreached
overrun: overrun
overthrow: overthrow,overthrown
overturn: overturn
overwhelm: overwhelmed
owe: owe,owed
owner: owner
ox: ox
pain: pains
paint: painted
pair: pairs
palace: palace
pall: pall
paltry: paltry
papacy: papacy
papal: papal
paradise: paradise
paragraph: paragraph
paraphrase: paraphrase
pardon: pardon
parent: parents
parentage: parentage
paris: paris
parliament: parliament
parricide: parricide
participator: participators
particulars: particulars
partisan: partisans
partition: partition
partly: partly
partridge: partridge
party: parties,party
pass: pass,passed,passes,passing
passage: passage
passive: passive
path: path,paths
patience: patience
patient: patient
patrimony: patrimony
patron: patron
pattern: pattern
paucity: paucity
pave: paved
pavia: pavia
pay: paid,pay
payment: payments
peace: peace
peaceable: peaceable
peaceably: peaceably
peaceful: peaceful
peacefully: peacefully
peasant: peasant
pecuniarily: pecuniarily
penalty: penalty
penny: penny
pensioner: pensioner
people: peoples
perceive: perceive,perceived,perceiving
perfect: perfect
perfectly: perfectly
perform: perform,performed
peril: peril,perils
perilous: perilous
period: period,periods
permanency: permanency
permanent: permanent
permission: permission
permit: permit,permitted,permitting
pernicious: pernicious
perpetrate: perpetrated
persian: persians
persist: persist,persisted
person: people,person,persons
personage: personages
personality: personality
personally: personally
persuade: persuade,persuaded,persuades
persuasion: persuasion,persuasions
pest: pest
philip: philip
philistine: philistine
philosopher: philosopher
phrase: phrase,phrases
phrasemonger: phrasemonger
physician: physicians
piazza: piazza
picture: picture,pictured
piece: piece,pieces
pier: pier
pike: pikes
pillage: pillage,pillaged
pious: pious
pisa: pisa
pisan: pisan
pithy: pithy
pius: pius
plagiarize: plagiarized
plain: plain,plains
plan: plan,planned,plans
plane: plane
play: play,playing
plea: plea
pleased: pleased
pleasure: pleasure
pledge: pledge
pliant: pliant
plot: plot
plunder: plundered,plundering
podesta: podesta
poem: poem,poems
poison: poison
policy: policy
polish: polishing
political: political
politician: politician
politics: politics
pomp: pomp
ponder: pondering
pontiff: pontiff,pontiffs
pontificate: pontificate
poor: poor
pope: pope
popular: popular
portcullis: portcullis
portentous: portentous
portico: portico
portion: portion,portions
position: position,positions
possess: possess,possessed,possesses,possessing
possession: possession,possessions
possessor: possessors
post: post,posted
posture: posture
potentate: potentates
potter: potter
pounce: pounced
pour: pour,poured
poverty: poverty
power: power,powers
powerful: powerful
powerless: powerless
practice: practice,practices
practise: practise,practised
praetor: praetor
praetorian: praetorian
praise: praise,praised,praises
praiseworthy: praiseworthy
pray: pray,prayed
prayer: prayers
preach: preaches
precaution: precautions
precept: precept,precepts
preceptor: preceptor
precious: precious
predominancy: predominancy
prefect: prefects
prefer: preferred
prelate: prelates
preparation: preparations
prepare: prepare,prepared
prepared: prepared
prerogative: prerogatives
presence: presence
presentation: presentation
presentiment: presentiment
presently: presently
preservation: preservation
preserve: preserve,preserved,preserves,preserving
president: president
press: pressed,pressing
pressure: pressure
prestige: prestige
presumption: presumption
presumptuous: presumptuous
presuppose: presupposes
pretence: pretence,pretences
pretender: pretender
pretext: pretext,pretexts
prevail: prevail
prevent: prevent,prevented
previous: previous
prey: prey
priest: priest,priests
priesthood: priesthood
priestly: priestly
prima: prima
prime: prime
primo: primo
prince: prince,princes
princedom: princedom
principal: principal
principalities: principalities
principality: principalities,principality
principe: principe
principle: principle,principles
prior: prior
prison: prison
prisoner: prisoner,prisoners
private: private
privilege: privileges
proceed: proceed
proceedings: proceedings
proclaim: proclaimed
procure: procured
produce: produce
production: production
profess: professed
profession: profession,professions
proficient: proficient
profit: profit
progress: progress
project: project
prologue: prologue
prolonged: prolonged
promise: promise,promised,promises,promising
promote: promoted
prompt: prompt
promulgate: promulgated
proof: proof
proper: proper
properly: properly
property: property
prophet: prophet,prophets
propitious: propitious
proportion: proportioned
proportionate: proportionate
proposal: proposal
propose: propose,proposed
proprium: proprium
prose: prose
prosecution: prosecution
prospect: prospect
prospective: prospective
prospects: prospects
prosper: prosper,prospered,prospering
prosperity: prosperity
prosperous: prosperous
protect: protect,protected
protection: protection
protest: protest
prove: prove,proved,proves
proverb: proverb
provide: provide
province: province,provinces
provision: provision
provoke: provoked
prudence: prudence
prudent: prudent
prudently: prudently
public: public
publish: published
pull: pull
punish: punish,punished,punishing
punishment: punishment
pupil: pupil
purpose: purpose,purposes
pursue: pursue
pursuit: pursuit
push: pushed
pusillanimity: pusillanimity
pyrrhus: pyrrhus
qualification: qualifications
quality: qualities,quality
quantity: quantities
quarrel: quarrels
quarter: quartered,quarters
quartermaster: quartermasters
queen: queen
question: question
quickness: quickness
quiet: quiet
quietly: quietly
quintius: quintius
quis: quis
quit: quit
race: races
rage: raging
rain: rained
raise: raise,raised,raising
rally: rally
rallying: rallying
ramiro: ramiro
rank: rank,ranks
ransom: ransom
rapacious: rapacious
rapacity: rapacity
rapidly: rapidly
rare: rare
rarely: rarely
rash: rash
rashness: rashness
ravage: ravaged
ravaging: ravaging
raze: razed
reach: reach,reached,reaches,reaching
read: read,reading,reads
reader: reader
ready: ready
real: real
reality: reality
realize: realize
realm: realm,realms
reap: reap,reaped
rear: rear,reared
reason: reason,reasoned,reasons
reasonable: reasonable
reassure: reassure
rebel: rebel,rebelled
rebellion: rebellion,rebellions
rebellious: rebellious
rebus: rebus
recall: recall,recalled
recapitulation: recapitulation
receive: receive,received
reckon: reckon,reckoned
recognise: recognised
recognition: recognition
recognize: recognize,recognized,recognizing
recollection: recollection
recommend: recommended,recommending
reconcile: reconciled
reconciliation: reconciliation
record: record,recorded,records
recount: recount
recourse: recourse
recover: recover,recovered,recovering
recovery: recovery
recur: recur,recurs
red: red
redeem: redeemed
redemption: redemption
redress: redressed
reduce: reduce,reduced
reduction: reduction
refer: refer,refers
reference: reference
reflect: reflected
reform: reformed
refuge: refuge
refuse: refuse,refused
regain: regain,regained,regaining
regard: regard
regimental: regimental
region: regions
regulate: regulated
reign: reign,reigned
reiterate: reiterates
reject: rejected
relate: relate,relating
relation: relations
relationship: relationship
release: release,released
reliable: reliable
reliance: reliance
relieve: relieved
religion: religion
religious: religious
reluctance: reluctance
rely: relied,relies,rely,relying
remain: remain,remained,remaining,remains
remainder: remainder
remark: remark,remarked
remarkable: remarkable
remedy: remedies,remedy
remember: remembered,remembering
remit: remitting
removal: removal
remove: removed
renaissance: renaissance
render: render,rendered
rendering: rendering
renown: renown
reorganize: reorganize
repay: repay
repeat: repeat,repeated
replace: replace
replete: replete
reply: replied,reply
report: reported
represent: representing
representative: representative
repress: repressed
reproach: reproach,reproached,reproaches
reprove: reproved
republic: republic,republics
repudiate: repudiated
reputation: reputation
repute: repute,reputed
reputed: reputed
request: request
require: require,required
requisite: requisite
resemblance: resemblance
resemble: resembled,resembling
reservation: reservation
reserve: reserves
reside: reside,resided,resides
residence: residence
resident: resident
resist: resist,resisting
resistance: resistance
resolution: resolution,resolutions
resolve: resolved
resort: resort,resorted
resource: resource,resources
respect: respect,respected
respectful: respectful
respectfully: respectfully
respects: respects
respond: responded
responsible: responsible
rest: rest,resting,rests
restoration: restoration
restore: restore,restored
restrain: restrain
result: result
retain: retain,retained
retainer: retainers
retire: retired
retirement: retirement
retreat: retreat
retrieve: retrieve
return: return,returned,returning
reveal: revealed,reveals
revenge: revenge
revenue: revenues
revere: revered
revolt: revolt
revolution: revolution,revolutions
reward: reward,rewarded,rewards
rewarding: rewarding
rich: rich,richest
riches: riches
rid: rid
ride: ride,rode
rider: riders
righteous: righteous
rightly: rightly
rima: rima
rioting: rioting
rise: rise,risen,rises,rising,rose
risk: risk
rival: rival
river: river,rivers
road: road
rob: rob,robbed
robbery: robberies,robbery
roberto: roberto
rock: rock
roll: rolled
roman: roman,romans
rome: rome
romulus: romulus
root: root,roots
rota: rota
rouen: rouen
roughness: roughness
rounded: rounded
rout: rout
route: routed
royal: royal
ruin: ruin,ruined,ruining
rule: rule,ruled,rules,ruling
ruler: rulers
russia: russia
rustling: rustling
sack: sack,sacked
sad: sad
saddle: saddle,saddles
safe: safe,safer,safest
safely: safely
safety: safety
saint: saints
saliva: saliva
salute: saluted
san: san
sanction: sanction
sanguinary: sanguinary
sanjak: sanjaks
santa: santa
satisfaction: satisfaction
satisfactorily: satisfactorily
satisfied: satisfied
satisfy: satisfied,satisfy
saturate: saturate
saul: saul
save: save,saved
savour: savour
scale: scale
scanty: scanty
scarcely: scarcely
scarcity: scarcity
scatter: scattered
scattered: scattered
scheme: scheme,schemes
school: school
scorn: scorn,scorned
scouring: scourings
scruple: scruple
sea: sea
season: season,seasoning,seasons
seat: seat,seated
secondo: secondo
secrecy: secrecy
secret: secret,secrets
secretary: secretaries,secretary
secretive: secretive
secretly: secretly
sect: sects
secure: secure,secured,securing
securely: securely
security: security
seed: seeds
seek: seek,seeking,seeks,sought
seignior: seigniors
seize: seize,seized,seizing
select: select
sempre: sempre
senate: senate
senator: senator,senators
send: send,sending,sends
sense: sense
separate: separate,separated
separately: separately
september: september
sequel: sequel
sergeant: sergeants
sermon: sermon
servant: servant,servants
serve: serve,served,serving
service: service,services
serving: serving
servitude: servitude
set: set,setting
settle: settle,settled
seventeenth: seventeenth
seventh: seventh
severe: severe
severity: severities,severity
shade: shade
shadow: shadow
shakespeare: shakespeare
shame: shame
shameless: shameless
shape: shape
share: share,sharing
sharp: sharp
sharply: sharply
sheep: sheep
sheer: sheer
shelter: shelter,sheltered,sheltering
shield: shields
shift: shifts
shifting: shifting
ship: ship
shock: shock
shore: shore,shores
short: short,shortest
shortly: shortly
shortness: shortness
shot: shot
shoulder: shoulders
shouldst: shouldst
shout: shouted,shouts
shrewdness: shrewdness
shun: shun
shut: shut
sicilian: sicilian
sicily: sicily
sick: sick
sickness: sickness
siege: siege
siena: siena
sienese: sienese
sight: sight
sighted: sighted
sign: sign,signs
signa: signa
signal: signal,signalled
signification: signification
signify: signifies,signify
signor: signor
signori: signori
signoria: signoria
silence: silence,silenced
silent: silent
silk: silk
similarity: similarity
simple: simple
simplicity: simplicity
simply: simply
sin: sins
sincerity: sincerity
single: single
singly: singly
singularly: singularly
sinister: sinister
sink: sank
sir: sir
sister: sister
sit: sit
situate: situated
situation: situation
sixteenth: sixteenth
sixth: sixth
sixtus: sixtus
skilful: skilful
skill: skill
skirmish: skirmishes
slaughter: slaughter,slaughtered
slave: slaves
slavery: slavery
slay: slay
sleep: slept
slight: slight
sling: sling
slip: slip
sloth: sloth
slow: slow
slowly: slowly
snare: snares
snow: snowed
society: societies,society
soft: soft
soil: soil
soldan: soldan
soldier: soldier,soldiers
soldiery: soldiery
sole: sole
solely: solely
solemn: solemn
solemnly: solemnly
solid: solid
son: son,sons
sore: sores
sorel: sorel
sorrow: sorrow
sort: sort
soul: soul
sound: sound
source: source,sources
south: south
sovereignty: sovereignty
sow: sow
space: space
spain: spain
spaniard: spaniard
spaniards: spaniards
spanish: spanish
spare: sparing
spark: spark
sparta: sparta
spartan: spartan,spartans
speak: speak,speaking,speaks,spoke,spoken
speaker: speakers
special: special
spectacle: spectacle
spectacles: spectacles
spend: spend,spends,spent
spirit: spirit,spirits
spirited: spirited
spiritual: spiritual
spit: spat,spit
spittle: spittle
splendid: splendid
splendidly: splendidly
splendour: splendour
spoil: spoils
spot: spot
spread: spread
spring: sprang,spring,springs,sprung
squadron: squadrons
squander: squander,squandering
square: square,squares
stable: stable
stand: stand,standing,stands,stood
standard: standard
standstill: standstill
start: start,started
statecraft: statecraft
stately: stately
statement: statement
statesman: statesman,statesmen
station: station
stature: stature
stay: stayed
steadfast: steadfast
steadily: steadily
steep: steep
step: step,steps
sternness: sternness
stick: stuck
stink: stinks
stipend: stipend
stipulate: stipulated
stockade: stockade
stone: stones
storm: storm
story: stories
stout: stout
straight: straight
strange: strange
stranger: stranger
strangle: strangled
street: street,streets
strength: strength
strengthen: strengthen,strengthened
strenuously: strenuously
strike: strike,struck
strip: stripped
strive: strive,striving,strove
stroke: stroke
strong: strong,stronger,strongest
stubborn: stubborn
study: studies,study
stuff: stuffed
style: style
subdue: subdue
subject: subject,subjects
subjection: subjection
subjugate: subjugated
submit: submit,submitted
subordinate: subordinated
subsist: subsisting
substance: substance
subtlety: subtlety
suburb: suburb
succeed: succeed,succeeded,succeeds
success: success,successes
successful: successful
successor: successor,successors
sudden: sudden
suffer: suffer,suffered,suffering
suffice: suffice
sufficient: sufficient
suggestion: suggestions
suit: suits
summarize: summarized
summit: summit
summon: summon
sumptuously: sumptuously
sundry: sundry
sunrise: sunrise
superfluous: superfluous
superior: superior
supper: supper
supply: supplied,supplies
support: support,supported,supporting
supporter: supporters
suppress: suppress
supreme: supreme
surmount: surmount
surname: surnamed
surprise: surprise,surprised
surprised: surprised
surrender: surrender,surrendered
surround: surround,surrounded,surrounding
survive: survived
suspect: suspected,suspects
suspense: suspense
suspicion: suspicion,suspicions
sustain: sustain,sustained
sway: sway
swear: swear
sweep: sweeping
swell: swelling
swift: swift
swindle: swindling
swiss: swiss
sword: sword,swords
sylvester: sylvester
syracusan: syracusan
syracuse: syracuse
tactic: tactics
tale: tales
talent: talent
taro: taro
task: task
taste: taste,tasted
tax: tax,taxes,taxing
teach: taught,teaches
teacher: teacher
tear: tears,torn
tedious: tedious
temperate: temperate
tempest: tempest
temporal: temporal
temporize: temporize
tempt: tempt
tenuto: tenuto
terence: terence
term: term,terms
terrible: terrible
terrify: terrified,terrify
territory: territories,territory
testament: testament
testify: testify
testimony: testimony
theatre: theatre
thee: thee
theme: theme,themes
theory: theories
theseus: theseus
thine: thine
thinking: thinking
thirdly: thirdly
thirst: thirst
thirteen: thirteen
thither: thither
threaten: threatened
thriftiness: thriftiness
throne: throne
throw: threw,throw,thrown
thy: thy
tie: tied
tight: tighter
tightly: tightly
timber: timber
time: time,times
timid: timid
timidity: timidity
tired: tired
title: title
titus: titus
toga: toga
token: token
toothing: toothing
torture: torture,tortured
touch: touch,touched,touching
tournament: tournaments
tower: tower,towers
town: town,towns
trade: trade
train: trained
training: training
trample: trampled
tranquillity: tranquillity
transaction: transactions
transgress: transgress
translate: translated,translating
translation: translation
transversely: transversely
travel: travelled
treacherous: treacherous
treachery: treacheries,treachery
tread: tread
treat: treated
treatise: treatise
treatment: treatment
treaty: treaties,treaty
tree: trees
tremble: trembles
tremendous: tremendous
trial: trial
tribe: tribe
tributary: tributary
tribute: tribute
trifle: trifle
trite: trite
troop: troop
troops: troops
trouble: trouble,troubles
troubled: troubled
truce: truce
true: true,truer
trust: trust,trusted,trusting
truth: truth,truths
tumult: tumult,tumults
turk: turk
turks: turks
tuscan: tuscan
tuscany: tuscany
tutor: tutor
tutto: tutto
twelfth: twelfth
type: type
tyrannical: tyrannical
tyrant: tyrant
ultimate: ultimate
ultimately: ultimately
unable: unable
unaccustomed: unaccustomed
unarmed: unarmed
unaspiring: unaspiring
unbeliever: unbelievers
unbelieving: unbelieving
uncertain: uncertain
unclaimed: unclaimed
uncle: uncle
unconquerable: unconquerable
underlying: underlying
understand: understand,understands,understood
understanding: understanding
undertake: undertake,undertaken
undertaking: undertaking
undignified: undignified
undismay: undismayed
undo: undo,undoes,undone
undoubtedly: undoubtedly
unduly: unduly
uneasy: uneasy
unexpected: unexpected
unexpectedly: unexpectedly
unfaithful: unfaithful
unfitted: unfitted
unforeseen: unforeseen
unfortunate: unfortunate
unfruitful: unfruitful
ungrateful: ungrateful
unguarded: unguarded
unhappily: unhappily
unhappy: unhappy
unhealthy: unhealthy
unheard: unheard
unhistorical: unhistorical
unholy: unholy
uniformity: uniformity
unify: unified
uninjured: uninjured
union: union
unite: unite,united
united: united
unity: unity
universal: universal
universe: universe
unjudged: unjudged
unknown: unknown
unmake: unmake
unmeritedly: unmeritedly
unnecessary: unnecessary
unprotected: unprotected
unready: unready
unreliable: unreliable
unrestrained: unrestrained
unsettle: unsettled
unsettled: unsettled
unsettling: unsettling
unstable: unstable
unsuccessful: unsuccessful
untie: untie
untrue: untrue
unum: unum
unusual: unusual
unwilling: unwilling
unwillingly: unwillingly
unworthy: unworthy
upbraid: upbraided
uphold: upheld,uphold,upholds
upright: upright
uproar: uproar
upset: upset
upside: upside
urbanity: urbanity
urge: urge,urged
useless: useless
usual: usual
usurper: usurper,usurpers
uti: uti
utmost: utmost
utterly: utterly
vain: vain
vainly: vainly
val: val
valiant: valiant
valiantly: valiantly
valley: valleys
valorous: valorous
valour: valour
variable: variable
variation: variation,variations
vary: varies,vary,varying
vase: vase
vast: vast
venerate: venerated
venetian: venetian,venetians
vengeance: vengeance
venice: venice
vent: vent
verb: verb
verify: verified
verse: verse
veteran: veterans
vexation: vexation
viand: viands
vice: vice,vices
vicinity: vicinity
vicissitude: vicissitudes
victim: victims
victor: victor
victorious: victorious
victory: victories,victory
victual: victualled
view: view
vigorous: vigorous
vigour: vigour
vii: vii
viii: viii
vile: vile
village: village
vim: vim
vincula: vincula
vine: vine
vineyard: vineyard
violator: violator
violence: violence
violent: violent
virgil: virgil
virtu: virtu
virtue: virtue,virtues
virtuous: virtuous
vision: vision
visit: visit
visor: visors
vita: vita
vital: vital
vitality: vitality
void: void
volume: volume
voluntary: voluntary
vulgar: vulgar
wait: wait,waited,waiting,waits
walk: walking
wall: walls
war: war,wars
warlike: warlike
warn: warn,warned
warning: warning
wash: washed
waste: waste,wastes
watch: watch,watched
watchword: watchword
water: water,waters
weak: weak,weaker,weakest
weaken: weaken,weakened,weakening
weakness: weakness
weapon: weapons
wear: wearing,wore
weariness: weariness
wearisome: wearisome
weary: wearied,weary
weather: weather
week: weeks
weigh: weigh,weighed,weighing
weight: weight
weightiness: weightiness
weighty: weighty
west: west
wet: wetted
whale: whale
wheel: wheeled
whencesoever: whencesoever
white: white
wholly: wholly
wicked: wicked
wickedness: wickedness
wide: wide
widow: widow
wield: wielded
wife: wife,wives
wild: wild
wiles: wiles
willingly: willingly
willingness: willingness
win: win,winning
wind: wind,winds,wound
wing: wings
winter: winter
wipe: wiped
wisdom: wisdom
wise: wise,wiser,wisest
wit: wit
withdraw: withdrew
withstand: withstand,withstood
witness: witness
witty: witty
wolf: wolves
woman: woman,women
wonderful: wonderful
wonderfully: wonderfully
wood: wood
word: word
worth: worth
worthy: worthy
wound: wounded,wounds
wrest: wrested
wrestling: wrestling
write: write,writes,writing,written,wrote
writer: writer,writers
writing: writing
writings: writings
written: written
wrong: wrong,wrongs
xi: xi
xii: xii
xiii: xiii
xiv: xiv
xix: xix
xvi: xvi
xvii: xvii
xviii: xviii
xx: xx
xxi: xxi
xxii: xxii
xxiii: xxiii
xxiv: xxiv
xxv: xxv
yearly: yearly
yield: yield,yielded
yoke: yoke
youth: youth
zeal: zeal
zenith: zenith
