aback: aback
abandon: abandoned,abandoning
abandonment: abandonment
abide: abide
abject: abject
abnormal: abnormal
aboard: aboard
abrupt: abrupt
abruptly: abruptly
absolutely: absolutely
absorb: absorb,absorbed,absorbs
abstraction: abstraction
absurd: absurd
absurdity: absurdity
absurdly: absurdly
abuse: abuse
abut: abutted
accentuate: accentuated
accept: accept,accepted,accepting
acceptable: acceptable
access: access,accessed
accessible: accessible
accident: accident,accidents
accidental: accidental
accommodation: accommodation
accompany: accompanied
accomplish: accomplished
accord: accord
accost: accost
account: account
accounting: accounting
accumulate: accumulate
accursed: accursed
ace: ace,aces
acid: acid
acknowledgment: acknowledgment
action: action
active: active
activity: activity
actual: actual
acute: acute
addition: addition,additions
additional: additional
address: address,addressed,addresses,addressing
adjoining: adjoining
adjust: adjusted
admire: admiring
admit: admit,admits,admitted
ado: ado
adolescent: adolescents
adorn: adorned
advance: advance,advanced,advances,advancing
advantage: advantage,advantages
adventure: adventure
adventurous: adventurous
adverse: adverse
advice: advice
advisability: advisability
aerial: aerial
affair: affair,affairs
afford: afford
afire: afire
afraid: afraid
afternoon: afternoon
age: age
aged: aged
agency: agency
agent: agent
aggressive: aggressive
aggressively: aggressively
aghast: aghast
agitated: agitated
agitation: agitation
aglare: aglare
agree: agree,agreed,agreeing
agreeable: agreeable
agreeably: agreeably
agreement: agreement
agrimony: agrimony
aid: aid
aim: aim,aimed,aiming
aimless: aimless
air: air
ajar: ajar
akimbo: akimbo
alacrity: alacrity
alarm: alarm,alarmed
alarmed: alarmed
albany: albany
albeit: albeit
albinism: albinism
albino: albino
alert: alert
alertly: alertly
alertness: alertness
algal: algal
algiers: algiers
alike: alike
alive: alive
alley: alley
aloud: aloud
alter: altered
alteration: alteration
altercation: altercation
altered: altered
alternate: alternate
alternately: alternately
alternative: alternative,alternatives
altogether: altogether
amateur: amateur
amazed: amazed
amazement: amazement
amazing: amazing
amazingly: amazingly
ambition: ambition
amenable: amenable
america: america
american: american
ammonite: ammonite
ample: ample
amplify: amplifying
amuse: amused
amusement: amusements
amusing: amusing
anaemic: anaemic
anarchist: anarchist
andrew: andrew
anger: anger
anglo: anglo
angry: angry
anguish: anguish
animal: animal
animation: animation
ankle: ankle,ankles
annoy: annoy
annoyance: annoyance
annoyed: annoyed
anonymous: anonymous
answer: answer,answered
antagonist: antagonist,antagonists
anticipate: anticipated
anticipation: anticipation
anxious: anxious
anxiously: anxiously
apartment: apartment,apartments
apathetic: apathetic
apex: apex
apologise: apologise,apologised
appalled: appalled
apparatus: apparatus
apparent: apparent
apparition: apparition
appeal: appealed
appearance: appearance
appetite: appetite
appliance: appliances
applicable: applicable
apply: applied,apply,applying
apprehension: apprehension
apprehensive: apprehensive
apprentice: apprentice
apprise: apprising
approach: approach,approached,approaching
april: april
apron: aprons
aproned: aproned
archie: archie
archive: archive
arf: arf
argue: argue
argument: arguments
argumentative: argumentative
arm: arm,armed,arms
armchair: armchair
armed: armed
armour: armour
army: army
arouse: arouse,aroused
arrange: arranged
arrangement: arrangement,arrangements
array: array
arrest: arrested
arrival: arrival
arrive: arrived,arriving
art: art
artery: arteries
artful: artful
article: articles
artificial: artificial
ascertain: ascertain,ascertained
ascii: ascii
ash: ash,ashes
ashamed: ashamed
askew: askew
asleep: asleep
asparagus: asparagus
ass: ass,asses
assailant: assailant
assault: assaulted
assert: assert,asserted,asserts
assertion: assertion
asseveration: asseverations
assimilate: assimilated
assist: assisted
assistance: assistance
assistant: assistant,assistants
assume: assume,assumed
assurance: assurance
assure: assured
astir: astir
astonish: astonished
astonished: astonished
astonishing: astonishing
astonishment: astonishment
astray: astray
athwart: athwart
attach: attached
attack: attack,attacked
attainment: attainment
attempt: attempt,attempted,attempts
attend: attended
attendance: attendance
attention: attention
attenuate: attenuated
attic: attics
attitude: attitude
attract: attract,attracted
audible: audible
audibly: audibly
august: august
aunt: aunt
author: author
authority: authorities
automatically: automatically
ave: ave
averse: averse
avert: avert
avoid: avoid,avoided,avoiding
await: await,awaited,awaiting
awake: awake,awoke
awaken: awakened
aware: aware
awkwardly: awkwardly
axe: axe
axle: axle
babel: babel
bachelor: bachelor
bacon: bacon
bad: bad,worse,worst
badge: badges
badly: badly
bag: bag
baggage: baggage
bait: bait
balance: balance
balustrade: balustrade
band: band
bandage: bandage,bandaged,bandages
bandaged: bandaged
bandaging: bandaging
bandy: bandy,bandying
bank: bank,banks
banking: banking
banner: banner
bar: bar,barred,barring,bars
bare: bare
barefaced: barefaced
barefoot: barefoot
barely: barely
bargain: bargain
bark: bark,barking
barman: barman
barracks: barracks
barrel: barrel
base: based
basement: basement
basin: basin
basket: basket,baskets
bath: bath
batter: battered
bawl: bawled,bawling
bawling: bawling
bead: beaded
beam: beam
bear: bear,bearing,bore
beard: beard
bearded: bearded
bearing: bearing
beast: beast
beat: beat,beaten,beats
beating: beating
bed: bed
bedclothes: bedclothes
bedding: bedding
bedford: bedford
bedroom: bedroom,bedrooms
bedstead: bedstead,bedsteads
beech: beech
beechwood: beechwoods
beef: beef
beer: beer
beetle: beetle
beggarly: beggarly
behave: behave,behaving
behaviour: behaviour
beheld: beheld
behold: beheld
belated: belated
belie: belied
belief: belief
believer: believer,believers
bell: bell,bells
bellow: bellowing
belly: bellied
belongings: belongings
belvedere: belvedere
bench: bench
bend: bend,bending,bent
beneath: beneath
bent: bent
benzoline: benzoline
betray: betray,betrayed
bicycle: bicycles
bid: bid
binary: binary
bind: bound
biscuit: biscuit
bit: bit
bite: bit,bite,biting,bitten
black: black
blackly: blackly
blackness: blackness
blacksmith: blacksmith
blade: blade
blame: blame
blank: blank
blanket: blankets
blankly: blankly
blare: blare
blaze: blazing
bleach: bleach
bleeding: bleeding
bless: bless,blessed
blessed: blessed
blimey: blimey
blind: blind,blinded,blinding,blinds
blindingly: blindingly
blink: blinking,blinks
blinkers: blinkers
blister: blistering
blood: blood
bloodhound: bloodhounds
bloody: bloody
bloom: blooming
bloomsbury: bloomsbury
blow: blew,blow,blowing,blown,blows
blown: blown
bludgeon: bludgeoning,bludgeons
blue: blue
blunder: blunder,blundered,blundering
board: board,boards
boast: boast
boat: boats
bobby: bobby
body: bodies,body
bogey: bogey
bogie: bogies
boil: boil,boiled
bold: bold
bolt: bolt,bolted,bolting,bolts
bone: bone,bones
book: book,books
bookshelf: bookshelf,bookshelves
boot: boot,boots
booth: booths
bootless: bootless
border: bordering
bosom: bosom
bother: bother,bothered
bottle: bottle,bottles
bound: bound
bounder: bounder
bout: bout
bow: bowed
bowl: bowled
bowler: bowler
bowling: bowling
box: box,boxes
boy: boy,boys
brace: braces
bracket: bracket
brain: brain
brandy: brandy
breach: breach
bread: bread
breadth: breadth
break: break,breaking,broke,broken
breakfast: breakfast,breakfasts
breath: breath
breathe: breathing
breathing: breathing
breed: breed
breeze: breeze
brevity: brevity
brick: brick,bricks
brickwork: brickwork
bright: bright,brighter
brightly: brightly
brilliant: brilliant
brim: brim,brims
bring: bring,bringing,brought
brink: brink
brisk: brisk,brisked
briskly: briskly
bristle: bristle,bristling
broad: broad
broken: broken
brood: brood
brook: brooked
broom: brooms
brother: brother
brow: brow,browed,brows
brown: brown
bruise: bruised,bruises
brush: brush
brutal: brutal
brute: brute
bubble: bubble
builder: builders
bulk: bulk
bull: bull
bullet: bullet,bullets
bumpkin: bumpkin
bundle: bundle,bundled
bung: bungs
bunt: bunting
bunting: bunting
burden: burden,burdens
burdock: burdock
burglar: burglar
burglary: burglary
burgle: burgle
burgundy: burgundy
burly: burly
burn: burning,burnt
burning: burning
burst: burst
burton: burton
bury: buried,bury
bush: bush,bushes
business: business
busted: busted
bustle: bustle,bustles
busy: busy
butcher: butcher
butter: butter
butterfly: butterflies,butterfly
button: buttoning,buttons
bystander: bystander
cab: cab
cabman: cabman,cabmen
cadge: cadging
calculate: calculate,calculated
calculation: calculations
calico: calico
calm: calm,calmed
campaign: campaign
candle: candle,candles
candy: candied
canister: canisters
canvas: canvas
cap: cap,caps
capture: capture,captured
card: card
care: care,caring
career: career
carefully: carefully
carelessly: carelessly
carelessness: carelessness
caricature: caricature
carpet: carpet
carriage: carriage
carrier: carrier
carry: carried,carry,carrying
cart: cart,carts
carter: carter
cartilage: cartilage
cartridge: cartridges
carving: carving
cash: cash
cashmere: cashmere
cast: cast,casting
casual: casual
cat: cat
cataclysmic: cataclysmic
catch: catch,catching,caught
cauterise: cauterised
cautious: cautious
cautiously: cautiously
cavity: cavity
cease: cease,ceased
ceiling: ceiling
celebrate: celebrated
cell: cell
cellar: cellar
central: central
centre: centre,centres
century: century
ceremony: ceremony
certainty: certainty
chain: chain
chair: chair,chairs
chance: chance,chances
change: change,changed,changing
chant: chanting
chap: chap,chaps
chapter: chapter
character: character
characteristic: characteristic
charge: charge,charged,charges
charitable: charitable
charity: charities,charity
chase: chase,chased,chasing
cheap: cheap
cheat: cheated
check: check,checked,checking,checks
cheek: cheek,cheeks
cheese: cheese
chemical: chemical,chemicals
chemist: chemist
chemistry: chemistry
cheque: cheque
chest: chest
cheval: cheval
chief: chief
chiefly: chiefly
chiffonnier: chiffonnier
child: child,children
chilled: chilled
chilly: chilly
chimney: chimney
chin: chin,chins
chink: chink,chinked
chirk: chirk
chlorine: chlorine
chloroform: chloroform,chloroformed
chocolate: chocolate
choke: choking
choose: choose,chooses,chose,chosen
christmas: christmas
chronic: chronic
chump: chump
chunk: chunk
church: church
cigar: cigar,cigars
circle: circle
circuit: circuit
circuitously: circuitously
circumstance: circumstance,circumstances
cistern: cistern
citizen: citizen
city: city
civilised: civilised
claim: claim
clamber: clambered,clambering
clamped: clamped
clang: clang
clank: clanking
clap: clap
clash: clash,clashing
clasp: clasping
clasped: clasped
clatter: clatter
claw: clawing,claws
clay: clay
clean: clean,cleaning
clench: clenched
clergyman: clergyman
clerical: clerical
clever: clever
cliff: cliff
climate: climate
climax: climax
climb: climbing
cling: clinging,clung
clink: clink
clock: clock
close: close,closed,closer,closing
closed: closed
closely: closely
closing: closing
clot: clot
cloth: cloth
clothe: clothe
clothes: clothes
clothing: clothing
clouded: clouded
cloudy: cloudy
clover: clover
club: club,clubbed
clue: clue,clues
clump: clump
clumsily: clumsily
clumsiness: clumsiness
clutch: clutch,clutched,clutching
coach: coach
coachman: coachman
coagulate: coagulates
coal: coal,coals
coarse: coarse
coat: coat
cobbler: cobbler
cock: cock,cocking
cocked: cocked
cockney: cockney
cocoanut: cocoanut,cocoanuts
code: codes
coffee: coffee
coffin: coffin
coil: coiled
coin: coins
cold: cold
coldness: coldness
collapse: collapse,collapsed
collar: collar,collared,collars
collate: collated
collect: collected
collection: collection
college: college
collide: collided
collision: collisions
colonel: colonel
colour: colour,coloured,colours
coloured: coloured
colouring: colouring
colourless: colourless
column: columns
comfort: comfort
comfortable: comfortable
comfortably: comfortably
comforter: comforter
commercial: commercial
commercialism: commercialism
commit: committed
common: common
communication: communication
companion: companion
company: company
compare: compared
comparison: comparisons
compass: compass
compilation: compilation
complain: complain
complete: complete,completed
completely: completely
compliance: compliance
complicated: complicated
compliment: compliments
comply: comply,complying
comprehensible: comprehensible
compress: compressed
compromiser: compromisers
computation: computations
concave: concave
conceal: conceal,concealing
conceivable: conceivable
conceive: conceiving
concentrate: concentrating
concept: concept
conception: conceptions
concerned: concerned
concert: concert
concisely: concisely
conclude: concluded
conclusion: conclusion
conclusively: conclusively
concussion: concussion
condition: condition,conditions
conduct: conducts
conductor: conductor
confederate: confederate
conference: conference
confide: confide
confidence: confidence,confidences
confident: confident
confidential: confidential
confine: confine
confirm: confirm,confirmed
confirmation: confirmation
conflict: conflict,conflicting
confound: confound,confounded
confoundedly: confoundedly
confront: confronted
confused: confused
confusion: confusion
conjuring: conjuring
conjuror: conjuror
connect: connected
connection: connections
connexion: connexion
conscientiously: conscientiously
consecutive: consecutive
consequence: consequences
consequential: consequential
considerable: considerable
considerably: considerably
consideration: considerations
consist: consisted
constable: constable
constant: constant
consternation: consternation
constitutionally: constitutionally
consult: consult
consulting: consulting
contact: contact
contemplate: contemplating
contempt: contempt
contemptuously: contemptuously
contents: contents
continue: continued
continuous: continuous
continuously: continuously
contra: contra
contract: contract
contrast: contrast
contribution: contributions
contrived: contrived
control: control,controlling
convention: conventions
conversation: conversation
conversational: conversational
converse: conversed
convert: convert
convey: convey
conveyance: conveyance
conviction: conviction
convince: convinced
convulse: convulsed
convulsive: convulsive
cook: cook,cooked
cool: cool,cooling
cooper: cooper
copious: copious
copying: copying
copyright: copyright
cordon: cordon
cork: cork,corks
corner: corner,corners
corporation: corporation
corpulent: corpulent
correct: correct
corrupt: corrupt
cost: cost,costs
coster: coster
costume: costume
costumed: costumed
costumier: costumier,costumiers
cottage: cottage
cotton: cotton
cough: cough,coughed,coughing
council: council
count: count,counted,counts
countenance: countenance
counter: counter,countered,counters
counterpane: counterpane
country: countries,country
countryside: countryside
couple: couple
courage: courage
court: court
covent: covent
cover: cover,covered,covering,covers
covered: covered
covering: covering
covet: coveted
crack: crack,cracked
cramped: cramped
crane: craning
crash: crash
crate: crate,crates
crawl: crawl,crawled,crawling
creak: creaked,creaking
create: create,created,creating
creation: creation
creature: creature
credible: credible
credit: credit,credited
creep: creeping,crept
crepitation: crepitation
crest: crest
crestfallen: crestfallen
cricketers: cricketers
crime: crime
criminal: criminal
crisis: crisis
critical: critical
crockery: crockery
cross: cross,crossed
crossbar: crossbar
crossing: crossing
crouch: crouched,crouching
crowd: crowd,crowded,crowds
crowded: crowded
crown: crown
cruel: cruel
cruelly: cruelly
cruelty: cruelty
crumb: crumbs
crumple: crumpled
crush: crushed,crushing
crust: crust
cuff: cuff
cultivate: cultivated
culture: cultures
cum: cum
cupboard: cupboard
cur: cur
curate: curate
curiosity: curiosity
curious: curious
curiously: curiously
current: current
curse: curse,cursed,curses,cursing
cursorily: cursorily
curtain: curtains
curtly: curtly
curve: curve
curved: curved
cushion: cushions
cuss: cuss
custom: custom
customary: customary
customer: customer,customers
cut: cut,cutting
cutlet: cutlet,cutlets
cutting: cutting
cylindrical: cylindrical
cypher: cypher
damage: damage
damaged: damaged
damages: damages
damn: damn
damnable: damnable
damned: damned
damp: damp,damping
dance: dance,dancing
dandy: dandies
danger: danger,dangers
dangerous: dangerous
daresay: daresay
darg: darg
dark: dark
darken: darkened
darkness: darkness
darn: darn,darned
dash: dash,dashed
dashed: dashed
dating: dating
datum: data
dawn: dawn
day: day,days
daylight: daylight
daytime: daytime
dazed: dazed
dazzle: dazzled
dazzling: dazzling
dazzlingly: dazzlingly
dead: dead
deadly: deadly
deal: deal
dealer: dealer
death: death,deaths
decapitate: decapitated
deceit: deceit
deceive: deceived
december: december
decide: decided,deciding
decision: decision
decisive: decisive
declare: declared
decolourise: decolourise
decorous: decorous
decorum: decorum
deductible: deductible
deed: deed
deep: deep
deepen: deepened
defect: defect,defects
defective: defective
defence: defences
defend: defend,defending
definite: definite
deformity: deformity
deftly: deftly
delay: delay,delaying
deletion: deletions
deliberate: deliberate,deliberated
deliberation: deliberation
delicately: delicately
delighted: delighted
delilah: delilah
delivery: delivery
demand: demand,demanded
demonstrate: demonstrated
demonstrator: demonstrator
denial: denial
dense: dense,denser
density: density
deny: denied
department: department,departments
departure: departure
depend: depends
depredation: depredations
depress: depressed
depression: depression
depth: depth
derivative: derivative
derive: derive,derived
descend: descended,descending
description: description
desecrated: desecrated
desert: deserted
deserted: deserted
design: design
desirable: desirable
desire: desire
desisted: desisted
desk: desk
desolate: desolate
desolation: desolation
despair: despair
despairing: despairing
desperate: desperate
destroy: destroy
destruction: destruction
destructive: destructive
detach: detach
detached: detached
detachment: detachment
detect: detect,detected
detection: detection
detective: detective,detectives
determine: determine
determined: determined
deuce: deuce
develop: developed
devil: devil,devils
devilish: devilish
devilry: devilry
devise: devised
devote: devote,devoted
devour: devoured
devouring: devouring
dexterously: dexterously
diabolically: diabolically
diagram: diagrams
diamond: diamond
diaphragm: diaphragm
diary: diary
die: die,died,dies
difference: difference
difficult: difficult
difficulty: difficulty
diffused: diffused
dig: dug
dignified: dignified
dilated: dilated
dilettante: dilettante
dim: dim
dimension: dimension,dimensions
diminish: diminished
dingy: dingy
dining: dining
dinner: dinner
direct: direct,directed
direction: direction,directions
dirt: dirt
dirty: dirty
disadvantage: disadvantage,disadvantages
disagreeable: disagreeable
disappear: disappear,disappearing
disappoint: disappointed
disappointed: disappointed
disappointment: disappointment
disaster: disaster
discipline: discipline,disciplined
disclaim: disclaim
disclaimer: disclaimer,disclaimers
discolour: discoloured
discomfort: discomfort
discontinue: discontinue
discourage: discouraging
discouragement: discouragements
discouraging: discouraging
discover: discover,discovered,discovering
discovery: discovery
discuss: discusses,discussing
discussion: discussion
disengage: disengaged
disfigured: disfigured
disfigurement: disfigurements
disgraceful: disgraceful
disguise: disguise,disguised
disheveled: disheveled
dishevelled: dishevelled
disillusionment: disillusionment
disintegration: disintegration
disk: disk
dislike: dislike,disliked,disliking
dislodge: dislodged
dismal: dismal
dismally: dismally
dismay: dismay
disobey: disobey
disorder: disorder
disordered: disordered
disorderly: disorderly
display: display,displayed,displaying,displays
dispose: disposed
disposition: disposition
disregard: disregard,disregarded
disreputable: disreputable
disrobe: disrobe
dissolve: dissolve
distance: distance,distanced
distastefully: distastefully
distinct: distinct
distinctly: distinctly
distinguish: distinguished,distinguishes
distribute: distribute,distributed,distributing
distribution: distribution
distributor: distributor
district: district
disturb: disturbed
disturbance: disturbance
disturbed: disturbed
disturbing: disturbing
ditch: ditch,ditches
dive: dives
divide: divided
diving: diving
doctor: doctor
dodge: dodge,dodged,dodging
dog: dog,dogs
domain: domain
domestic: domestic
dominate: dominate
domino: dominoes
donate: donate
donation: donation,donations
donor: donors
door: door,doors
doorstep: doorstep
doorward: doorward
doorway: doorway
dose: dose
dot: dotted
double: doubled
doubt: doubt,doubts
downcast: downcast
downfall: downfall
downhill: downhill
downland: downland
download: downloading
downstairs: downstairs
downward: downward
doze: dozes,dozing
dozen: dozen
drag: dragged
drainage: drainage
draper: draper
draught: draught
draw: draw,drawing,drawn,drew
drawback: drawbacks
drawer: drawer,drawers
drawing: drawing
dread: dread,dreading,dreads
dream: dream,dreaming,dreams,dreamt
dress: dress,dressing
dressing: dressing
drift: drift,drifting
drily: drily
drink: drank,drink
drip: dripped
dripping: dripping
drive: drive,driven,driving,drove
driver: driver
driving: driving
droning: droning
droop: drooping
drop: drop,dropped,dropping,drops
dropping: dropping
drowsy: drowsy
drug: drugs
drum: drum
drunk: drunk
drury: drury
dry: dried,dry,drying
duck: ducked
dull: dull
dumb: dumb
dummy: dummy
durgan: durgan
dusk: dusk
dusky: dusky
dust: dust
dusty: dusty
duty: duty
dynamo: dynamos
eager: eager
eagerly: eagerly
eagerness: eagerness
ear: ear,ears
earn: earn
earth: earth
ease: ease
easily: easily
east: east
easy: easier,easy
eat: ate,eat,eaten,eating
eating: eating
eavesdropping: eavesdropping
eccentricity: eccentricity
echo: echoes
ecstatically: ecstatically
eddy: eddy
edge: edge,edged,edges,edging
edition: edition,editions
educate: educated
educated: educated
educational: educational
eerie: eerie
effort: effort,efforts
egg: eggs
egotistical: egotistical
eighth: eighth
ejaculate: ejaculating
ejectment: ejectment
elaborate: elaborate,elaborated,elaborating
elastic: elastic
elated: elated
elation: elation
elbow: elbow,elbowed,elbows
elder: elder,elders
elderly: elderly
elect: elect
electrician: electrician
electronic: electronic
electronically: electronically
element: element
elementary: elementary
eloquent: eloquent
elusively: elusively
email: email
embarrassed: embarrassed
embonpoint: embonpoint
emerge: emerged,emerging
eminent: eminent
emotion: emotions
emotional: emotional
emphasis: emphasis
empire: empire
employee: employee,employees
emporium: emporium
emptiness: emptiness
en: en
enable: enabled
encode: encoding
encounter: encounter,encountered
endeavour: endeavouring
enemy: enemy
energetic: energetic
energy: energies
engage: engaged
engine: engine
england: england
english: english
engross: engrossed
enjoy: enjoy
enormous: enormous
ensign: ensigns
ensure: ensuring
enter: enter,entered,entering
enterprise: enterprise
entertain: entertained
enthusiasm: enthusiasm
entire: entire
entity: entity
entrance: entrance,entrances
entry: entry
envelope: envelope
envy: envy
epilogue: epilogue
epoch: epoch
equally: equally
equilibrium: equilibrium
equip: equipped
equipment: equipment
ere: ere
erect: erect
error: error,errors
escape: escape,escaped,escaping
essence: essence
essential: essential
essentially: essentially
establish: establish
establishment: establishment
ethereal: ethereal
evade: evades
evening: evening,evenings
event: events
eventuality: eventuality
everlasting: everlasting
evidence: evidence
evident: evident
evidently: evidently
evil: evil
evoke: evoke
exaltation: exaltation
examination: examination
examine: examine,examined,examines
exasperate: exasperated,exasperating
exasperating: exasperating
exasperation: exasperation
excavation: excavation
exceedingly: exceedingly
excellent: excellent
exceptionally: exceptionally
excessive: excessive
excessively: excessively
excite: excited
excited: excited
excitedly: excitedly
excitement: excitement
exclaim: exclaim,exclaimed,exclaiming
exclamation: exclamation
exclusion: exclusion
excruciating: excruciating
excuse: excuse
execute: execute,executing
execution: execution
exempt: exempt
exercise: exercise
exhausted: exhausted
exist: exists
existence: existence
expect: expect,expected
expectation: expectation
expedient: expedient
expend: expend
expense: expense,expenses
experience: experience,experienced,experiences
experiment: experiment,experiments
experimental: experimental
expert: expert
explain: explain,explained
explanation: explanation
explicit: explicit
explode: explode
explore: explore,explored
explosive: explosive,explosives
export: exporting
expose: expose,exposed
expostulation: expostulation
exposure: exposure
express: express,expressed
expression: expression,expressions
extend: extended,extending
extent: extent
extinction: extinction
extra: extra
extract: extracted
extraordinarily: extraordinarily
extraordinary: extraordinary
eye: eye,eyeing,eyes
eyebrow: eyebrow,eyebrows
eyed: eyed
eyelid: eyelids
fabric: fabric,fabrics
fabrication: fabrication
faced: faced
faceless: faceless
facility: facility
fade: fade,faded
fag: fag
fail: fail,failed
faint: faint,fainter
fainting: fainting
faintly: faintly
fair: fair,fairs
faith: faith
fall: fall,fallen,falling,fell
false: false
falter: faltered
fame: fame
familiar: familiar
famous: famous
fancy: fancied,fancy
fantastic: fantastic
farewell: farewell
fascinate: fascinated
fashion: fashion
fashionable: fashionable
fashioned: fashioned
fast: fast,fasted,faster
fasten: fastened
fastening: fastenings
fastidiously: fastidiously
fasting: fasting
fat: fat
fatal: fatal
fate: fate
father: father
fatigue: fatigue
fatigued: fatigued
fatuity: fatuities
favour: favour,favours
favourable: favourable
fawn: fawn
fear: fear,feared,fearing
fearful: fearful
feast: feast
feature: features
february: february
federal: federal
fee: fee,fees
feeble: feeble
feel: feel,feeling
feeling: feeling
fell: felled
fellow: fellow,fellows
fellowship: fellowship
fence: fence
fencing: fencing
fender: fender
fern: fern
festival: festival
festivity: festivities
festoon: festoons
fetch: fetched
fever: fever
feverish: feverish
feverishly: feverishly
fibre: fibre,fibres
fiddle: fiddle
field: field,fields
fierce: fiercer
fiercely: fiercely
fight: fights
fighting: fighting
figure: figure,figures
file: file,files
filter: filtered
filtering: filtering
filthy: filthy
final: final
finality: finality
finally: finally
financial: financial
fine: fine,finer,finest
finger: finger,fingers
fingernail: fingernails
finish: finish,finished
finishing: finishing
firelight: firelight
fireplace: fireplace
firm: firm
firmly: firmly
fish: fish,fished,fishing
fishmonger: fishmonger
fist: fist,fists
fit: fit,fits
fitfully: fitfully
fitness: fitness
fixed: fixed
fixedly: fixedly
fixture: fixtures
flabbergast: flabbergasted
flabbiness: flabbiness
flag: flags
flagrant: flagrant
flail: flails
flake: flakes
flanking: flanking
flap: flap,flapping
flare: flared
flash: flash,flashed,flashes,flashing
flat: flat
flatly: flatly
flavour: flavour
flaxen: flaxen
flee: fled
flesh: flesh
fletcher: fletcher
flexible: flexible
flicker: flicker,flickered
flight: flight
flinch: flinch
fling: fling,flinging,flung
flint: flint,flints
flit: flitting
float: floating
flock: flock
flood: flooded
floor: floor
flounder: floundering
flow: flow
fluctuate: fluctuating
fluid: fluids
flush: flushed
flute: fluted
flutter: fluttered,fluttering
fly: flew,fly,flying
foam: foam
fog: fog
fogginess: fogginess
fold: folded,folding
folk: folk,folks
follow: follow
folly: folly
food: food
fool: fool,fooling,fools
foolery: foolery
foolish: foolish
foolishness: foolishness
foot: feet,foot
football: football
footfall: footfalls
footing: footing
footmark: footmarks
footprint: footprint
footstep: footstep,footsteps
force: forced,forces
forcibly: forcibly
fore: fore
forego: forego
forehead: forehead
forenoon: forenoon
forge: forge
forget: forget,forgets,forgot,forgotten
forgetfulness: forgetfulness
form: form,formed,forms
format: format,formats
formula: formula
formulate: formulate
forthwith: forthwith
fortunate: fortunate
fortune: fortune
forwards: forwards
foundation: foundation
fountain: fountain
fours: fours
fragment: fragments
frame: frame
france: france
frantic: frantic
frantically: frantically
freedom: freedom
freely: freely
freeze: freezing
french: french
frenzy: frenzy
frequent: frequent,frequented
fresh: fresh
fret: fretting
friend: friend,friends
fright: fright
frightened: frightened
frightful: frightful
fro: fro
frock: frocks
frost: frost
frosted: frosted
frosty: frosty
fruit: fruit,fruits
fugitive: fugitive
fulness: fulness
fumble: fumbling
function: functions
fund: fund
funeral: funeral
funk: funk
furious: furious
furiously: furiously
furnish: furnish,furnished
furniture: furniture
furry: furry
furtive: furtive
furtively: furtively
fury: fury
furze: furze
fuss: fuss
future: future
gag: gagged
gain: gain
gait: gait
gal: gal
gala: gala
gallery: galleries,gallery
game: game,games
gap: gaps
gape: gaped,gaping
garbled: garbled
gard: gard
garden: garden
garment: garment,garments
garnet: garnets
garrison: garrison
gas: gas
gasp: gasp,gasped,gasping
gate: gate,gates
gateway: gateway
gather: gather,gathered,gathering
gathering: gathering
gaud: gauds
gaunt: gaunt
gay: gay
gayer: gayer
gazette: gazette
gem: gem
generation: generations
generously: generously
genius: genius
gent: gent
gentleman: gentleman,gentlemen
gently: gently
gentry: gentry
geometrical: geometrical
george: george
german: german
germinate: germinated
gesticulate: gesticulating
gesticulation: gesticulations
gesture: gesture,gestures
ghastly: ghastly
ghost: ghost,ghosts
ghostly: ghostly
gibbons: gibbons
gift: gift
gifted: gifted
gin: gin
gingerly: gingerly
gipsy: gipsies
girl: girl,girls
glad: glad
glairy: glairy
glance: glance,glanced,glances,glancing
glare: glared
glaring: glaring
glass: glass,glasses
glassy: glassy
glimmer: glimmer,glimmering
glimpse: glimpse
glint: glint
glistening: glistening
gloaming: gloaming
gloat: gloating
glove: glove,gloves
gloved: gloved
glow: glow,glowed,glowing
gnarled: gnarled
gnaw: gnawed,gnawing
goal: goal,goals
god: god
goggle: goggle,goggling
goggles: goggles
gold: gold
golden: golden
gossip: gossip
govern: govern
government: government
gown: gown
graceful: graceful
grain: grain
grand: grand
grano: grano
grant: granted
grasp: grasp,grasped
grass: grass
grate: grating
gratefully: gratefully
grave: grave
gravel: gravel
gravity: gravity
graze: graze
greasy: greasy
greatly: greatly
greece: greece
greedily: greedily
greek: greek
green: green
greengrocer: greengrocer
grey: grey
greyish: greyish
gribble: gribble
grievance: grievance
griffin: griffin
grim: grim
grimace: grimaces
grimly: grimly
grip: grip,gripped,gripping
gritted: gritted
groan: groaned,groaning
grocer: grocer
grocery: grocery
groin: groin
gross: gross
grotesque: grotesque
grotesquely: grotesquely
ground: ground
grow: grew,grow,growing
growl: growl,growling
grumble: grumble
grunt: grunted
guard: guard,guarding,guards
guess: guess,guessed
guest: guest,guests
guidance: guidance
guinea: guinea
gun: guns
gust: gust,gusts
gusty: gusty
gutter: gutter,guttering
ha: ha
habit: habit,habits
hag: hag
haggler: haggler
hail: hailed
hair: hair,hairs
hairy: hairy
halfway: halfway
hall: hall
hallo: hallo
hallucination: hallucinations
ham: ham
hammer: hammer
hamper: hamper
hand: hand,handed,hands
handbag: handbag
handcuffs: handcuffs
handful: handfuls
handkerchief: handkerchief
handle: handle,handles
handless: handless
handwriting: handwriting
handy: handy
hang: hang,hanged,hanging,hangs,hung
hanger: hanger
hansom: hansom
happen: happen,happened,happening
happening: happenings
happily: happily
happiness: happiness
happy: happy
hard: hard
harmless: harmless
hart: hart
haste: haste
hastily: hastily
hastings: hastings
hat: hat,hats
hate: hated
haul: haul
hazy: hazy
head: head,heading,heads
heading: heading
headless: headless
headlong: headlong
heap: heap,heaps
hear: hear,heard,hears
hearing: hearing
hearse: hearse
heart: heart,hearts
hearth: hearth
heartily: heartily
hearty: hearty
heat: heat
heated: heated
heaven: heaven,heavens
heavily: heavily
heavy: heavier,heavy
heed: heeded,heeding
heel: heel,heels
helmet: helmet
helper: helper,helpers
helpless: helpless
helplessly: helplessly
hem: hemmed
hereabouts: hereabouts
hero: hero
hesitate: hesitate,hesitated,hesitating
hesitation: hesitation
hex: hex
hide: hidden,hide,hiding
hiding: hiding
highly: highly
hill: hill,hills
hillside: hillside
hiss: hissing
hit: hit,hitting
hitherto: hitherto
hoarse: hoarse
hoarsely: hoarsely
hoax: hoax,hoaxing
hobbledehoy: hobbledehoy
hobnail: hobnails
hold: held,hold,holding
holder: holder,holders
holiday: holiday
hollow: hollow
homicidal: homicidal
honour: honour
hoot: hooted
hop: hop,hopped
hope: hope,hoped
hopeless: hopeless
hopelessly: hopelessly
horizontal: horizontal
horn: horns
horrible: horrible
horribly: horribly
horrified: horrified
horror: horror,horrors
horse: horse,horses
horses: horses
horseshoe: horseshoes
host: host
hostess: hostess
hot: hot
hotel: hotel
hound: hound
hour: hour,hours
house: house,houses
housebreaking: housebreaking
housekeeper: housekeeper
housekeeping: housekeeping
housemaid: housemaid
howl: howled,howling
huge: huge
hullo: hullo
human: human
humanity: humanity
humbug: humbugging
humiliation: humiliation
humph: humph
hunch: hunched
hunchback: hunchback
hunger: hunger
hungry: hungry
hunt: hunt,hunted,hunting
hunter: hunter,hunters
hunting: hunting
hurl: hurled
hurried: hurried
hurriedly: hurriedly
hurry: hurried,hurry,hurrying
hurrying: hurrying
hurt: hurt,hurting
husband: husband
hush: hush
huskiness: huskiness
huxter: huxter
hydrogen: hydrogen
hymn: hymn
hypnotism: hypnotism
hypothesis: hypothesis
hysterics: hysterics
idea: idea,ideas
identification: identification
identify: identify
idiot: idiot
ignorant: ignorant
ignore: ignoring
iii: iii
illuminate: illuminated
illustrate: illustrate
illustration: illustrations
imagination: imagination
imaginative: imaginative
imagine: imagine,imagined
imitation: imitation
immovable: immovable
impatience: impatience
impatient: impatient
impatiently: impatiently
impede: impeded
impel: impelled
impenetrable: impenetrable
impenetrably: impenetrably
imperceptible: imperceptible
imperfect: imperfect
implement: implements
imply: implied
impose: imposed
impossibility: impossibility
impossible: impossible
impotent: impotent
imprecation: imprecation
impregnably: impregnably
impress: impress,impressed
impressed: impressed
impression: impression,impressions
imprison: imprison
impromptu: impromptu
impulse: impulse
impunity: impunity
inaccurate: inaccurate
inaction: inaction
inadvertently: inadvertently
inanity: inanity
inarticulate: inarticulate
inaudible: inaudible
incapable: incapable
incessant: incessant
inch: inch,inches
incident: incident,incidents
incidental: incidental
incidentally: incidentally
inclination: inclination
incline: inclined
inclined: inclined
include: include,included,includes,including
including: including
incoherent: incoherent
incoherently: incoherently
incomplete: incomplete
incomprehensible: incomprehensible
inconceivable: inconceivable
inconclusive: inconclusive
incongruity: incongruity
incontinently: incontinently
increase: increase,increased,increasing
incredible: incredible
incredulous: incredulous
indecipherable: indecipherable
indecorous: indecorous
indemnify: indemnify
indemnity: indemnity
indescribably: indescribably
indeterminate: indeterminate
india: india
indicative: indicative
indirect: indirect
indirectly: indirectly
indisputable: indisputable
indistinct: indistinct
individual: individual
indoors: indoors
induce: induce
ineffectual: ineffectual
inevitable: inevitable
inevitably: inevitably
inexplicably: inexplicably
inexpressibly: inexpressibly
infant: infant
inferior: inferior
infernal: infernal
infest: infested
infinite: infinite
infinity: infinity
inflame: inflamed
inflate: inflating
inflict: inflicted
influence: influence
infrequent: infrequent
infringement: infringement
infuriate: infuriated
ingredient: ingredients
inhuman: inhuman
injure: injured
injury: injuries
inkling: inkling,inklings
inky: inky
inn: inn,inns
inoffensive: inoffensive
inquire: inquired
inquirer: inquirers
inquiringly: inquiringly
inquiry: inquiries,inquiry
inquisitively: inquisitively
insane: insane,insanest
inscrutable: inscrutable
insensible: insensible
insist: insisted
inspect: inspect,inspecting
inspection: inspection
inspiration: inspiration
instance: instance,instances
instantaneously: instantaneously
instantly: instantly
instinct: instinct
instruct: instructed
instruction: instructions
instrument: instruments
insure: insured
insurmountable: insurmountable
intact: intact
intellect: intellect
intellectual: intellectual
intelligence: intelligence
intelligible: intelligible
intend: intended,intending
intense: intense
intensely: intensely
intensity: intensity
intent: intent
intention: intention
intently: intently
intercept: intercept
interior: interior
interlocutor: interlocutor
interminable: interminable
internal: internal
international: international
interpret: interpreted
interrogate: interrogating
interrogation: interrogation,interrogations
interrogative: interrogative
interrupt: interrupt,interrupted
interstice: interstices
interval: interval,intervals
intervene: intervened
interview: interview,interviews
interviews: interviews
intimation: intimations
intolerable: intolerable
intonation: intonation
intricate: intricate
introduction: introduction
introductory: introductory
intruder: intruder
intrusion: intrusion
intuition: intuitions
invade: invade
invalidity: invalidity
invariably: invariably
investigate: investigating
investigation: investigations
investigator: investigator
invigorate: invigorated
invisibility: invisibility
invisible: invisible
invisibly: invisibly
invitation: invitation
involve: involved,involving
irascibility: irascibility
iridescent: iridescent
iron: iron
ironmongery: ironmongery
irony: irony
irradiate: irradiated
irregular: irregular
irreligious: irreligious
irresistible: irresistible
irresistibly: irresistibly
irresolutely: irresolutely
irritability: irritability
irritable: irritable
irritably: irritably
irritated: irritated
irritating: irritating
irritation: irritation
irs: irs
isolate: isolated
issue: issue
iv: iv
ix: ix
jabber: jabber
jack: jacks
jacket: jacket,jackets
jagged: jagged
jaggers: jaggers
jam: jammed
james: james
january: january
jar: jar
jasmine: jasmine
jauntily: jauntily
jaw: jaw,jaws
jealous: jealous
jelly: jelly
jerk: jerk,jerked,jerking,jerks
jerkily: jerkily
jerry: jerry
jersey: jersey,jerseys
jest: jest
jet: jet
jew: jew
jewel: jewels
job: job
jobber: jobber
joint: joint
joke: joke
joker: joker
jolly: jolly
jostle: jostled
journalist: journalist
jove: jove
jubilee: jubilee
judge: judge,judged
judicial: judicial
judicious: judicious
jump: jump,jumped,jumping
junction: junction
june: june
justice: justice
keenly: keenly
keeper: keeper
kemp: kemp
ken: ken
key: key
kick: kick,kicked,kicking
kill: kill,killed,killing
killing: killing
kilt: kilt
kindly: kindly
kindred: kindred
kitchen: kitchen
knavish: knavish
knee: knee,knees
kneel: kneeling,knelt
knife: knife,knives
knit: knit
knob: knob
knock: knock,knocked,knocking
knot: knots
knowledge: knowledge
knuckle: knuckled
label: label,labeled,labelled,labels
laboratory: laboratory
labourer: labourer,labourers
laburnum: laburnum
lace: lace,laces
lack: lacked
lad: lad
lady: ladies,lady
lair: lair
lake: lake
lame: lame
lamp: lamp,lamps
lampshade: lampshade
landing: landing
landlady: landlady
landlord: landlord
lane: lane,lanes
language: language
languid: languid
lanky: lanky
lantern: lantern
lapse: lapse,lapsed,lapses
larceny: larceny
larder: larder
larva: larvae
latch: latch,latched
late: late
laugh: laugh,laughed,laughing
laughter: laughter
law: law,laws
lawn: lawn
lawyer: lawyers
lay: laid,lay
lead: lead,leading,led
leaf: leaf,leaves
lean: lean,leaning,leans,leant
leap: leap,leaping,leapt
leapt: leapt
learn: learn,learnt
leastways: leastways
leather: leather
leathery: leathery
leave: leave,leaves,leaving,left
left: left
leg: leg,legs
legal: legal
legally: legally
legend: legend
leisurely: leisurely
lend: lent
lens: lenses
letter: letter,letters
level: level
leveret: leveret
liability: liability
liable: liable
liberty: liberty
library: library
license: license
licensed: licensed
lick: lick
lid: lid
lie: lie,lying
lieu: lieu
life: life
lift: lift,lifted,lifting,lifts
ligature: ligature
light: light,lighter,lighting,lights,lit
lighted: lighted
likeness: likeness
likes: likes
limb: limb,limbs
limit: limited
limitation: limitation
limited: limited
limp: limp
limping: limping
linen: linen
lining: linings
link: linked,links
linoleum: linoleum
lip: lip,lips
lipped: lipped
liquid: liquid
liquor: liquor
liquorish: liquorish
list: list
listen: listen,listened,listening
listener: listener
listening: listening
literary: literary
litter: litter,littered
live: live,lived,living
living: living
lo: lo
loaf: loaf
loath: loath
lobster: lobster
locate: located
location: locations
lock: lock,locked,locking,locks
locked: locked
locomotive: locomotive
lodge: lodge,lodged
lodger: lodgers
lodging: lodging
lodgment: lodgment
loiter: loitered
london: london
lone: lone
lonely: loneliest,lonely
lookout: lookout
looky: looky
loom: loomed
loose: loose,loosed
loosely: loosely
loosen: loosened
lord: lord
lose: loses,losing,lost
loss: loss
lot: lot
loud: loud
loudly: loudly
louis: louis
lounge: lounge
lout: lout
love: love,loved
luck: luck
luckily: luckily
lucky: lucky
lug: lugged,lugging
luggage: luggage
lumber: lumber
lumpily: lumpily
lunatic: lunatic
lunch: lunch
lymphatic: lymphatic
machine: machine
mad: mad
madden: madden
madness: madness
magic: magic
magistrate: magistrate
magnificent: magnificent
magnify: magnified
magnitude: magnitude
maid: maid
maim: maiming
main: main
maintain: maintain,maintaining
malignant: malignant
manage: manage,managed
manager: manager,managers
manchester: manchester
mania: mania
manner: manner
manners: manners
mantel: mantel
manuscript: manuscript
march: marched,marching
mariner: mariner
mark: mark,marked
marked: marked
market: market
marry: married
marvel: marvel,marvelling,marvels
marvellously: marvellously
mask: mask,masks
masked: masked
mass: mass,masses
master: master
mat: mat
match: match,matches
mathematical: mathematical
mathematician: mathematicians
matter: matter,matters
mattress: mattresses
maximum: maximum
maze: maze
meadow: meadow
meal: meal,meals
meander: meandering
meandering: meandering
measure: measured
meat: meat
medal: medal
medical: medical
medicine: medicine
meditation: meditation
meditative: meditative
medium: medium
meet: meet,met
mell: mell
melting: melting
memorable: memorable
memorandum: memoranda
mend: mended,mending
mending: mending
mental: mental
mention: mentioned
merchantability: merchantability
mercy: mercy
mere: mere
mesh: meshes
mess: mess,messing
metal: metal
metamorphose: metamorphosed
method: method,methods
methodical: methodical
miaow: miaow,miaowed,miaowing
miaowing: miaowing
michael: michael
microscope: microscope
microscopic: microscopic
midday: midday
middle: middle
midst: midst
mighty: mighty
mild: mild
mile: mile,miles
milk: milk
millie: millie
mind: mind
minded: minded
mingle: mingle
minor: minor
minority: minority
minute: minute,minutes
miracle: miracle,miracles
miraculously: miraculously
mirror: mirror
miscellaneous: miscellaneous
miser: miser
miserable: miserable
misery: misery
misfortune: misfortune
missile: missile
missing: missing
mission: mission
mississippi: mississippi
missive: missive
mist: mist
mistake: mistake,mistaking
mister: mister
misty: misty
mix: mixing
modest: modest
modification: modification
modify: modified
moisten: moistened
moisture: moisture
molecular: molecular
moment: moment,moments
momentary: momentary
monday: monday
mondays: mondays
money: money
monger: monger
monologue: monologue
monstrous: monstrous
montague: montague
month: month,months
mood: mood
moon: moon
morning: morning,mornings
morrow: morrow
mother: mother,mothers
motion: motion
motionless: motionless
motive: motives
mottled: mottled
mound: mounds
mount: mounted
mountain: mountain
mourner: mourners
moustache: moustache
mouth: mouth
mouthed: mouthed
mouthful: mouthful
mouthpiece: mouthpiece
movement: movement,movements
mow: mowing
mud: mud
muddy: muddy
muffle: muffled,muffling
muffled: muffled
muffler: muffler
multiply: multiplies
multitude: multitude,multitudes
multitudinous: multitudinous
mumble: mumbled
mumbling: mumbling
murder: murder,murdered
murderer: murderer
murderous: murderous
murmur: murmur,murmuring
muscular: muscular
museum: museum
music: music
muslin: muslin
mustard: mustard
muster: muster
mutter: muttered,muttering
muttered: muttered
mysterious: mysterious
mysteriously: mysteriously
mystery: mystery
nail: nails
naked: naked
nape: nape
napkin: napkin
nar: nar
nare: nares
narrative: narrative
narrow: narrow
narrowly: narrowly
nation: nation
national: national
naturalist: naturalist
naturally: naturally
nature: nature
nauplii: nauplii
nautical: nautical
navvy: navvies,navvy
necessitate: necessitates
necessity: necessity
neck: neck,necks
negligence: negligence
neighbour: neighbour
neighbourhood: neighbourhood
nerve: nerve,nerved,nerves
nervous: nervous
nervously: nervously
nettle: nettles
network: network
newly: newly
news: news
newsletter: newsletter
newspaper: newspaper,newspapers
nicely: nicely
night: night,nights
nightfall: nightfall
nightmare: nightmare
ninth: ninth
nip: nipped
nipping: nipping
nod: nodded
noise: noise,noises
noiseless: noiseless
noiselessly: noiselessly
noisily: noisily
noisy: noisy
nonproprietary: nonproprietary
nonsense: nonsense
noon: noon
north: north
northward: northward
nose: nose,noses
notably: notably
note: note,notes
nothingness: nothingness
notice: notice,noticed,noticing
notify: notifies
notion: notion
nowadays: nowadays
nuisance: nuisance
numerous: numerous
nurse: nurse
oath: oath
ob: ob
obdurate: obdurate
object: object,objects
objection: objection
oblige: oblige
obliquely: obliquely
oblong: oblong,oblongs
obscure: obscured
observant: observant
observation: observation
observe: observe,observed
obsolete: obsolete
obstacle: obstacle
obstinately: obstinately
obvious: obvious
occasion: occasion,occasioned
occasional: occasional
occasionally: occasionally
occult: occult,occulted
occupation: occupation
occupy: occupied
occur: occur,occurred
occurrence: occurrences
october: october
odd: odd
oddly: oddly
odour: odour
offence: offence
offensive: offensive
offer: offers
office: office,offices
officer: officers
official: official,officials
oil: oil
oliver: oliver
omnium: omnium
online: online
opaque: opaque
operation: operations
operator: operator
opinion: opinion
opium: opium
opportunity: opportunities,opportunity
opposition: opposition
optical: optical
opulence: opulence
ordinary: ordinary
organ: organ
organise: organising
organize: organized
original: original
originally: originally
originator: originator
ornamental: ornamental
ostentatiously: ostentatiously
outburst: outburst
outcast: outcast
outdated: outdated
outdoor: outdoor
outer: outer
outfit: outfit
outline: outline
outlook: outlook
outsider: outsiders
outskirts: outskirts
outstretched: outstretched
outwardly: outwardly
overbearing: overbearing
overcoat: overcoat
overcome: overcome
overhead: overhead
overlook: overlooked,overlooking
overnight: overnight
oversetting: oversetting
overshadow: overshadowed
overtake: overtaken,overtaking
overthrow: overthrowing,overthrown
overturn: overturning
overwhelming: overwhelming
overwork: overwork
ow: ow
owe: owed
owner: owner
ox: ox
oxford: oxford
pace: pace
pacing: pacing
pack: packed,packing
packing: packing
pad: pad
padded: padded
pail: pails
pain: pain
painful: painful
painfully: painfully
paint: paint
painting: painting,paintings
pair: pair,pairs
pal: pals
palaeolithic: palaeolithic
pale: pale
paler: paler
pallid: pallid
pallor: pallor
palm: palm
pan: pans
pane: pane,panes
panel: panel,panels
panic: panic
pansy: pansy
panting: panting
pantomime: pantomime
pantry: pantry
pants: pants
paper: paper,papers
paperwork: paperwork
paragraph: paragraph,paragraphs
parallelogram: parallelogram
paralysed: paralysed
parcel: parcel,parcels
pardon: pardon
parley: parleying
parliamentary: parliamentary
parlour: parlour
parsimony: parsimony
partially: partially
particle: particles
particulars: particulars
partner: partner
party: party
pass: pass,passed,passes,passing
passably: passably
passage: passage
passenger: passenger
passer: passer,passers
passion: passion
passionately: passionately
passive: passive
pasteboard: pasteboard
pat: patted
patch: patch,patched,patches
patchy: patchy
path: path,paths
patience: patience
patois: patois
patter: patter
pattering: pattering
pause: pause,paused
pavement: pavement
pavilion: pavilion
pay: paid,pay,paying
payment: payment,payments
peace: peace
peak: peak,peaked
peasant: peasants
peculiar: peculiar
peel: peeling
peep: peep
peer: peer,peered,peering
peewit: peewit
pell: pell
pelt: pelting
pen: pen,pent
pencil: pencil
penetrate: penetrate,penetrated,penetrating
penetratingly: penetratingly
pensive: pensive
penthouse: penthouse
penultimate: penultimate
penury: penury
perambulator: perambulator
perceive: perceive,perceived
perception: perceptions
perfect: perfect
perfectly: perfectly
perform: perform,performed,performing
performance: performances
periodic: periodic
perish: perish
permanent: permanent
permission: permission
permit: permitted
perplex: perplexed
perplexed: perplexed
perplexing: perplexing
perplexity: perplexity
person: people,person
personage: personage
personal: personal
personality: personality
perspire: perspiring
persuasion: persuasion
petty: petty
pharmaceutical: pharmaceutical
pharynx: pharynx
phase: phase
phenomenon: phenomenon
phew: phew
philanthropy: philanthropy
philosophical: philosophical
photograph: photographs
phrase: phrase
physical: physical
physicist: physicist
physics: physics
physiology: physiology
pick: picked,picking
picnic: picnic
picture: picture
picturesque: picturesque
piebald: piebald
piece: piece,pieces
pier: pier
pig: pigs
pigment: pigment,pigments
pile: pile,piled,piles
pillar: pillar,pillars
pillow: pillow
pin: pinned
pine: pine
pink: pink
pinky: pinky
pipe: pipe
pistol: pistol
pit: pit
pitch: pitch,pitched
pitfall: pitfalls
pitiful: pitiful
pity: pity
plain: plain
plainly: plainly
plan: plan,planned,planning,plans
plank: plank,planks
planning: planning
plant: planted
plaster: plaster
plate: plates
play: play,played,playing
pleasant: pleasant
pleased: pleased
pleasure: pleasure
plot: plot,plotted
plough: ploughed
pluck: plucked
plume: plumes
plunder: plunder
plunge: plunged
pocket: pocket,pocketing,pockets
pointedly: pointedly
poise: poised
poison: poison
poke: poked
poker: poker
police: police
policeman: policeman,policemen
polish: polish
politely: politely
politics: politics
pond: pond,ponds
poor: poor
popular: popular
pore: pored
port: port
portico: portico
portion: portion
portland: portland
portmanteau: portmanteau
portmanteaux: portmanteaux
position: position
possess: possessed,possesses
possession: possession
possibility: possibilities,possibility
post: post,posted,posts
postman: postman
postmark: postmark
pot: pot,pots
pound: pounded,pounding,pounds
pour: pouring
poverty: poverty
powder: powder,powdered,powdering,powders
powdered: powdered
powdering: powdering
power: power
powerful: powerful
practical: practical
practically: practically
practice: practice
practitioner: practitioner
precaution: precautions
precipitately: precipitately
precise: precise
precisely: precisely
preconception: preconceptions
prefer: prefer,preferred
preoccupied: preoccupied
preparation: preparations
preparatory: preparatory
prepare: prepare,prepared,preparing
prepared: prepared
prescription: prescription
presence: presence
presently: presently
preserve: preserve
press: press
pressure: pressure
pretty: pretty
prevent: prevent,prevented
previous: previous
prick: pricked
pride: pride
primrose: primrose
principal: principal
principle: principle,principles
print: print,printed
prison: prison
prisoner: prisoner
privacy: privacies
private: private
prize: prize
probable: probable
probationary: probationary
probe: probed
proceed: proceeded,proceeds
proceeding: proceeding
proceedings: proceedings
process: process,processed,processes
processing: processing
procession: procession
proclaim: proclaimed
proclamation: proclamation,proclamations
procure: procure
produce: produce,produced,produces
production: production
profanity: profanity
professional: professional
professor: professor
profit: profits
profound: profound
progress: progress
progression: progression
prohibition: prohibition
project: project,projected
promenade: promenading
prominently: prominently
promiscuous: promiscuous
promise: promise
promote: promoting
promotion: promotion
prompt: prompt,prompted
prone: prone
proofread: proofread
proper: proper
properly: properly
property: property
proportion: proportions
proposal: proposal
propose: proposed
proprietary: proprietary
proprietor: proprietor
prosaic: prosaic
prostrate: prostrate
protect: protect,protected
protest: protest,protested,protests
protrusion: protrusion
prove: prove,proved
provide: provide,providing
provincial: provincial
provision: provision,provisions
provocation: provocation
provoke: provoke
prowl: prowl,prowled,prowling
pry: pry,prying
public: public
publication: publications
publicity: publicity
publish: publish
puddle: puddle
puff: puff,puffed
pugnaciously: pugnaciously
pull: pull,pulled,pulling,pulls
pulley: pulley
punctual: punctual
pungency: pungency
pungent: pungent
punitive: punitive
purblind: purblind
purchase: purchase
pure: pure
purple: purple
purpose: purpose,purposes
purr: purring
purse: purse
pursuant: pursuant
pursue: pursue,pursued,pursuing
pursuer: pursuer,pursuers
pursuit: pursuit,pursuits
purview: purview
push: push,pushed,pushing
puzzle: puzzled
puzzled: puzzled
puzzlement: puzzlement
quaintly: quaintly
quality: qualities,quality
qualm: qualms
quantity: quantity
quarrel: quarrel
quarry: quarry
quarter: quarter,quarters
quatorze: quatorze
queen: queen
queer: queer
quest: quest
question: question,questioned,questions
quick: quick
quickness: quickness
quiet: quiet
quietly: quietly
quill: quill
quilt: quilts
quiver: quiver,quivering
quoth: quoth
rabbit: rabbit
race: race,races
rack: racking
radiant: radiant
radiate: radiated,radiating
radiator: radiators
rag: rag
rage: rage,raging
rail: rail
railing: railings
railway: railway
rain: rain
raise: raise,raised,raising
random: random
rank: rank
ransack: ransack
rap: rapped,rapping
rapid: rapid
rapidity: rapidity
rapidly: rapidly
rapping: rapping
rare: rare
rarely: rarely
rarity: rarity
rat: rat,rats
rate: rate,rated
rational: rational
rattle: rattled,rattling
rave: raving
raw: raw
ray: ray
reach: reached,reaching
read: read,reading,reads
readable: readable
reader: reader
ready: ready
reagent: reagents
real: real
realisation: realisation
realise: realise,realised,realising
reality: reality
realization: realization
realm: realm
reappear: reappear,reappeared
rear: reared
reason: reason
reasonable: reasonable
reassure: reassured
recall: recalling
recede: receded,receding
receipt: receipt
receive: receive,received,receiving
receptacle: receptacles
recipient: recipient
reckon: reckoned,reckons
recognise: recognised
recoil: recoiled
recollection: recollection
recover: recover,recovered,recovering
recovery: recovery
recrimination: recriminations
recross: recrossed
red: red
redistribute: redistribute,redistributing
redistributing: redistributing
redistribution: redistribution
reel: reeling
refasten: refastened,refastening
refer: referring
reference: references
reflect: reflect,reflected,reflects
reflection: reflection,reflections
refract: refract,refracted,refracts
refraction: refraction
refractive: refractive
refreshment: refreshment
refuge: refuge
refund: refund
refuse: refused
regain: regain
regard: regard
region: region
register: register,registered
regular: regular
regulate: regulating
reign: reign
reiterate: reiterated
rejoin: rejoined
relate: relates
relax: relax,relaxes
relaxed: relaxed
release: release,released
relief: relief
relieve: relieved,relieving
relieved: relieved
reluctant: reluctant
reluctantly: reluctantly
remain: remain,remained,remaining,remains
remark: remark,remarked
remarkable: remarkable
remarkably: remarkably
remedy: remedies
remember: remember,remembered,remembers
remind: reminded,reminding
reminiscence: reminiscences
remittance: remittance,remittances
remorse: remorse
remorselessly: remorselessly
remote: remote
remove: remove,removed
rename: renamed
render: render
renew: renewed
rent: rent
reopen: reopened
repeat: repeat,repeated
replace: replace,replaced
replacement: replacement
reply: reply
report: report,reported,reports
reporter: reporters
representation: representations
reprint: reprinted
repulse: repulse
reputation: reputation
request: request
require: require,required,requiring
requirement: requirements
rescue: rescue
reservation: reservation
reserve: reserve
resident: resident
resignation: resignation
resist: resisted
resistance: resistance
resolute: resolute
resolutely: resolutely
resolution: resolution
resolve: resolved
resonance: resonance
resound: resounded
resounding: resounding
resource: resources
resourceful: resourceful
respect: respected
respectability: respectability
respectable: respectable
respectfully: respectfully
resplendent: resplendent
rest: rest
resting: resting
restless: restless
restlessly: restlessly
restorative: restoratives
restore: restoring
restriction: restrictions
result: result
resume: resume,resumed
retain: retain
retina: retina
retire: retired,retiring
retirement: retirement
retort: retorted
retreat: retreat,retreated,retreating
return: return,returned,returning,returns
reveal: revealed
revel: revel
revenue: revenue
reverse: reverse
revolver: revolver,revolvers
rib: ribs
ribbon: ribbon,ribbons
rich: rich
ricochet: ricochetted
rid: rid
riddle: riddle,riddles
ride: rode
ridicule: ridicule
rightly: rightly
rigid: rigid
riot: riot
rioting: rioting
rip: rip,ripped
ripple: ripple
rise: rise,rising,rose
risk: risks
ritual: ritual
road: road,roads
roadside: roadside
roadway: roadway
rob: rob,robbed,robbing
robber: robber
robe: robe,robes
rod: rod
roll: rolled
romance: romance
roof: roof,roofs
roomy: roomy
rope: rope
rosiness: rosiness
rosy: rosy
rot: rot
rotate: rotating
rouge: rouge
rough: rough
roughly: roughly
roughness: roughness
rouleaux: rouleaux
roundabout: roundabout
rouse: rouse,roused
rout: rout
route: routing
roving: roving
row: row,rows
royal: royal
royalty: royalties,royalty
rub: rubbed,rubbing
rubber: rubber
rubbish: rubbish
rubble: rubble
rubicund: rubicund
ruddy: ruddier,ruddy
rude: rude
rug: rug
rugby: rugby
ruin: ruins
rule: rule,ruled,rules
rum: rum
rummage: rummage
rummy: rummy
rumour: rumour
runaway: runaway
running: running
rush: rush,rushed,rushing
russell: russell
russian: russian
rust: rust
rustic: rustic
rustle: rustle
sack: sack,sacking
sackbut: sackbut
sacking: sacking
safe: safe
safety: safety
sagely: sagely
sailing: sailing
sailor: sailor
sake: sake,sakes
salad: salad
sale: sale
sally: sallied
salt: salt
salvation: salvation
sandy: sandy
sane: sane
sanity: sanity
sarsaparilla: sarsaparilla
sash: sash,sashes
satisfaction: satisfaction
satisfied: satisfied
satisfy: satisfy
savage: savage
savagely: savagely
save: save,saved,saving
sawdust: sawdust
saxon: saxon
scant: scant
scanty: scanty
scar: scars
scarcely: scarcely
scared: scared
scarf: scarfs
scarlet: scarlet
scatter: scattered,scattering,scatters
scattered: scattered
scene: scene
scent: scent
sceptic: sceptics
scepticism: scepticism
scheme: scheme,schemes,scheming
school: school,schools
schoolroom: schoolroom
scientific: scientific
scoffing: scoffing
scramble: scrambled
scrap: scrap,scraps
scrape: scrape
scratch: scratch,scratched
scream: scream,screamed,screaming,screams
screen: screen,screens
screw: screwed,screwing
scrutinise: scrutinised
scrutiny: scrutiny
scullery: scullery
scurry: scurrying
scuttle: scuttle
scythe: scythe
sea: sea
search: search
seasonable: seasonable
seat: seat,seated
secrecy: secrecy
secret: secret,secrets
secrete: secrete
secretive: secretive
secure: secure,secured
seed: seed
seek: seeking,sought
seemingly: seemingly
seethe: seethe
seize: seized
selection: selection
selfishness: selfishness
sell: selling,sold
seller: seller
send: send,sending
sensation: sensation,sensations
sense: sense
sensitive: sensitive
sentence: sentence,sentences
sentimentality: sentimentality
serenity: serenity
sermon: sermon
servant: servant,servants
serve: served
service: service
serviette: serviette
set: set,sets,setting
settee: settee
settle: settle,settled
severe: severe
severely: severely
sex: sexes
sexton: sexton
shabby: shabby
shade: shade,shaded
shadow: shadows
shadowy: shadowy
shady: shady
shaft: shaft
shake: shaken,shaking,shook
shallow: shallow
sham: sham,shamming
shamefully: shamefully
shamming: shamming
shape: shapes
shaped: shaped
share: share,shared,sharing
sharp: sharp
sharpen: sharpened
sharply: sharply
sharpness: sharpness
shatter: shattered
shattered: shattered
shaving: shaving
sheepishly: sheepishly
sheer: sheer
sheet: sheet,sheets
shelf: shelf
shelter: shelter,sheltering
sherry: sherry
shilling: shilling,shillings
shimmer: shimmer
shin: shin
shine: shining,shone
shiny: shiny
ship: ships
shipping: shipping
shirt: shirt,shirts
shiver: shiver,shivered,shivering
shoal: shoal
shock: shock
shoe: shoe,shoes
shoot: shoot,shot
shooting: shooting
shop: shop,shops
shopman: shopmen
short: short
shortish: shortish
shot: shot,shots
shoulder: shoulder,shoulders
shout: shout,shouted,shouting,shouts
shouting: shouting
shove: shoved,shoving
shrewd: shrewd
shriek: shriek,shrieked,shrieking,shrieks
shrillness: shrillness
shrub: shrubs
shrubbery: shrubbery
shudder: shuddered
shuffling: shuffling
shut: shut,shutting
shutter: shutters
shy: shies,shy
sick: sick
sickly: sickly
sickness: sickness
sidelight: sidelights
sideways: sideways
sidney: sidney
siege: siege
sigh: sigh,sighed
sight: sight
sign: sign,signed,signs
signal: signals
silas: silas
silence: silence,silenced
silent: silent
silently: silently
silk: silk
sill: sill
silly: silly
silver: silver
silvery: silvery
simple: simple
simply: simply
simultaneous: simultaneous
simultaneously: simultaneously
sincerity: sincerity
sinew: sinews
sing: sang
singular: singular
singularity: singularity
singularly: singularly
sinister: sinister
sir: sir
sister: sister
sit: sat,sit,sits,sitting
situation: situation
skeleton: skeleton
sketch: sketch,sketched
skin: skin
skirmish: skirmishes
skirt: skirts
skull: skull
sky: sky
slacken: slackened
slackly: slackly
slam: slam,slammed,slamming
slamming: slamming
slap: slapped
slash: slashing
slave: slave
slaying: slaying
sleep: sleep,sleeping,sleeps,slept
sleepily: sleepily
sleeve: sleeve
slender: slender
slicer: slicer
slide: sliding
slight: slight,slightest
slime: slime
slip: slip,slipped,slips
slipper: slippers
slippery: slippery
slope: slope
slouch: slouch
slow: slow,slower
slowly: slowly
slowness: slowness
sluggish: sluggish
slum: slum,slums
slush: slush
sly: sly
smack: smack
smart: smart
smartly: smartly
smash: smash,smashed,smashing
smell: smell,smelling
smile: smiled
smite: smiting
smock: smocked
smoke: smoke,smoked,smoking
smoking: smoking
smooth: smooth
smote: smote
smoulder: smouldered
smut: smuts
snap: snap,snapped
snappishly: snappishly
snatch: snatch,snatched,snatching
sneeze: sneeze,sneezed,sneezes,sneezing
sniff: sniff,sniffed,sniffing
snivelling: snivelling
snow: snow
snowfall: snowfall
snowstorm: snowstorm
snub: snubbed,snubbing
sob: sobbed,sobbing
sociable: sociable
sociably: sociably
social: social
society: society
sock: socks
socket: sockets
soda: soda
sodden: sodden
soft: soft
softly: softly
sojourn: sojourned
solar: solar
soldier: soldiers
sole: sole,soled
solemnly: solemnly
solicit: solicit
solicitation: solicitation
solid: solid
soliloquy: soliloquy
solitary: solitary
solitude: solitude
solution: solutions
solve: solved
son: son,sons
song: song
sooner: sooner
sordid: sordid
sore: sore
sort: sort
soul: soul
sound: sound,soundest,sounding,sounds
source: source,sources
south: south
sovereign: sovereign,sovereigns
sow: sown
space: space
spacious: spacious
spade: spade
spadeful: spadefuls
spain: spain
spare: spare
sparrow: sparrow
spasmodic: spasmodic
speak: speak,speaking,spoke,spoken
speaker: speaker
special: special
species: species
specific: specific
speck: specks
spectacles: spectacles
spectacular: spectacular
speculate: speculating
speculation: speculation,speculations
speechless: speechless
speedy: speedier
spell: spelt
spend: spent
spin: spinning,spun
spirit: spirit,spirits
spit: spit
spite: spite
spitefully: spitefully
splash: splash,splashes
splendid: splendid
splinter: splinter
splintered: splintered
splintering: splintering
split: split
splitting: splitting
spoil: spoil
spoke: spokes
sponge: sponge
spoon: spoon
sporadic: sporadic
sporadically: sporadically
sport: sport
spot: spot,spots
sprawl: sprawl,sprawled,sprawling
spread: spread
spreading: spreading
spring: sprang,spring
springing: springing
sprinkle: sprinkled
spur: spur
spurt: spurt,spurted,spurting
squalid: squalid
square: square
squeal: squeal
stab: stabbed,stabs
staccato: staccato
staff: staff
stag: stag
stage: stage
stagger: staggered,staggering
staggering: staggering
stain: stain,stained
stair: stair,stairs
staircase: staircase
stake: stakes
stall: stall
stalwart: stalwart
stamp: stamped
stand: stand,standing,stands,stood
standing: standing
staple: staples
star: starred,stars
stare: stare,stared,staring
stark: stark
starred: starred
start: start,started,starting,starts
startle: startle,startled
startled: startled
startling: startling
starve: starving
stateliness: stateliness
statement: statement,statements
station: station,stations
stationery: stationery
status: status
stay: stay,stayed,staying
steadily: steadily
steady: steadied,steady
steal: steal
stealthy: stealthy
steam: steam
steamer: steamers
steel: steel
steep: steep
steepness: steepness
step: step,stepped,stepping,steps
steward: steward
stick: stick,sticking,stuck
stickiness: stickiness
stiff: stiff
stiffly: stiffly
stillness: stillness
stimulate: stimulate
sting: stinging,stung
stinging: stinging
stipulate: stipulated
stir: stir,stirred,stirring
stirring: stirring
stitch: stitch
stock: stock
stocking: stockings
stone: stone,stones
stones: stones
stonily: stonily
stool: stool
stoop: stoop,stooped,stooping
stopper: stoppers
store: stored
storeroom: storeroom
storey: storeys
story: stories,story
stout: stout
stoutly: stoutly
straggle: straggling
straight: straight
strand: strand
strange: strange,strangest
strangely: strangely
strangeness: strangeness
stranger: stranger,strangers
strangle: strangled
strap: strap
straw: straw
stream: stream,streaming
street: street,streets
strength: strength
stress: stress
stretch: stretch,stretched,stretching
strict: strict
stride: stride,strides,striding,strode
strike: strike,strikes,striking,struck
striking: striking
string: string,strings
stringent: stringent
stroke: stroke,stroked
strong: strong,strongest
struggle: struggle,struggled,struggles,struggling
strychnine: strychnine
student: student,students
study: study,studying
stuff: stuff
stumble: stumbled
stun: stunned
stunned: stunned
stupid: stupid
stupidly: stupidly
sturdy: sturdy
subconscious: subconscious
subdue: subdued
subdued: subdued
subject: subject
subscribe: subscribe
subscription: subscription
subsequent: subsequent
subsequently: subsequently
subside: subsides
substance: substance
substitution: substitution
subtle: subtle
succeed: succeeded
success: success
sudden: sudden
suddenly: suddenly
suddenness: suddenness
suffer: suffered,suffering
suffering: suffering
suffice: suffice,sufficed,suffices
sufficient: sufficient
suggestion: suggestion,suggestions
suit: suit
suitable: suitable
sullenly: sullenly
summat: summat
summer: summer
summit: summit
summons: summons
sumptuous: sumptuous
sun: sun
sunday: sunday
sunlight: sunlight
sunny: sunny
sunset: sunset
sunshine: sunshine
superiority: superiority
supernatural: supernatural
superstition: superstitions
superstitious: superstitious
supply: supplied
support: support,supported,supporting,supports
suppose: suppose,supposed,supposing
supposition: supposition
suppress: suppressed
surely: surely
surface: surface,surfaces
surgical: surgical
surprise: surprise,surprised
surprised: surprised
surrender: surrender
surrey: surrey
surround: surrounded
surroundings: surroundings
survey: surveyed
survive: survive
suspect: suspected
suspend: suspended
suspicion: suspicion
suspicious: suspicious
suspiciously: suspiciously
sussex: sussex
swallow: swallowed
swamp: swamp
swathe: swathed
sway: swayed,swaying
swear: swear,swearing,swore,sworn
swearing: swearing
sweep: sweeping,swept
sweet: sweet,sweets
swell: swelling
swift: swift
swiftly: swiftly
swim: swam
swimming: swimming
swindle: swindled
swing: swing,swings,swung
swinging: swinging
swish: swish
syllable: syllables
sympathetic: sympathetic
sympathise: sympathise
sympathy: sympathy
synonymous: synonymous
syphon: syphon,syphons
systematic: systematic
ta: tas
table: table,tables
tack: tack
tail: tail,tails
taint: tainted
tale: tale
talent: talent
talk: talk,talked,talking
tall: tall
tangent: tangent
tangible: tangible
tap: tap,tapped,tapping
tapetum: tapetum
tas: tas
taste: taste,tastes
tasteful: tasteful
tater: taters
tawdry: tawdry
tax: tax,taxes
tea: tea
teach: teaching
teapot: teapot
tear: tear,tearing,tears,tore,torn
ted: ted
teddy: teddy
teem: teeming
telegraph: telegraph
telephone: telephone
telescoping: telescoping
temper: temper
temporarily: temporarily
tend: tend
tennis: tennis
tense: tense
tent: tent
tentative: tentative
tenth: tenth
term: term,terms
terminate: terminated
terrace: terrace
terrible: terrible
terrify: terrify
terror: terror,terrors
terrorise: terrorised
terse: terse
testify: testified,testifies
thaw: thaw,thawed
thawing: thawing
theatrical: theatrical
theologian: theologian
theory: theory
thicket: thicket,thickets
thickly: thickly
thief: thief
thinker: thinker
thinking: thinking
thirsty: thirsty
thirteenth: thirteenth
thomas: thomas
thrash: thrashed
threat: threat,threats
threaten: threatened
thrice: thrice
thrill: thrill
throat: throat
throng: throng
throw: threw,throw,throwing,thrown
thrust: thrust
thud: thud
thumb: thumb
thunder: thundering
tick: ticking
ticking: ticking
tide: tide
tidy: tidied,tidy
tie: tied,ties
tight: tight
tighten: tightened
tightly: tightly
tile: tile
tilt: tilt,tilted
time: time,timed,times
timorously: timorously
tin: tin
tinge: tinged
tinker: tinkered
tinkle: tinkling
tinsel: tinsel
tint: tint
tiptoe: tiptoed
tired: tired
tissue: tissue
title: title
tizzy: tizzy
tobacco: tobacco
toe: toe,toes
toil: toiled
tom: tom
tomfoolery: tomfoolery
tone: tone
tongue: tongue
tonic: tonic
tonsil: tonsils
tool: tool
tooth: teeth,tooth
toothache: toothache
toothpick: toothpick
toothsome: toothsome
topic: topic
topmost: topmost
torment: tormenting
tornaria: tornarias
toss: tossed,tossing
touch: touch,touched,touching
tough: tough
tower: tower
town: town
toy: toy,toys
trace: trace,traced
track: tracks
trade: trade
trademark: trademark
traffic: traffic
tragedy: tragedy
tragic: tragic
tragical: tragical
trail: trail,trailing
train: train,trains
training: training
traitor: traitor
tram: tram
tramp: tramp,tramps
trample: trampled
trampled: trampled
tranquillity: tranquillity
transcend: transcend,transcending
transcribe: transcribe
transcription: transcription
transient: transient
transit: transit
transitory: transitory
translucency: translucencies
translucent: translucent
transparent: transparent
trap: trap
travel: travel,travelled,travelling
traveller: traveller
tray: tray
treachery: treachery
tread: tread
treasure: treasure
treat: treat
treatment: treatment
tree: trees
tremble: tremble,trembled,trembling
tremendous: tremendous
tremulous: tremulous
tremulously: tremulously
trespass: trespass
triangle: triangle,triangles
trick: trick,tricked
trifle: trifle
trip: tripped
triumph: triumph
trod: trod
trodden: trodden
tropically: tropically
trot: trotted,trotting
trouble: trouble,troubled,troubles,troubling
trousering: trousering
trousers: trousers
trove: trove
truckle: truckle
trudge: trudged,trudging
true: true
truncheon: truncheon
trunk: trunks
trust: trust
trustful: trustful
truth: truth
truthfulness: truthfulness
tube: tube,tubes
tug: tugging
tumble: tumble,tumbled,tumbling
tumbled: tumbled
tumbler: tumbler
tumult: tumult
tumultuous: tumultuous
tune: tune
turf: turf
turnip: turnips
turpentine: turpentine
twang: twang
twilight: twilight
twill: twill
twine: twine
twinkle: twinkled
twist: twist,twisted
twisted: twisted
type: type,types
ugh: ugh
ugly: ugliest,ugly
ultimate: ultimate
umbrella: umbrella
unable: unable
unaccountable: unaccountable
unaccountably: unaccountably
unaccustomed: unaccustomed
unaided: unaided
unassimilated: unassimilated
unassuming: unassuming
unavoidable: unavoidable
unbolt: unbolted
unbolted: unbolted
unbuttoned: unbuttoned
uncanny: uncanny
uncarpeted: uncarpeted
unceasingly: unceasingly
uncertain: uncertain
unclouded: unclouded
uncomfortable: uncomfortable
uncommon: uncommon
unconscious: unconscious
uncurtained: uncurtained
undecided: undecided
undeniable: undeniable
underclothing: underclothing
undergo: undergo,undergoes
underground: underground
underlip: underlip
undermost: undermost
understand: understand,understood
undertake: undertake
undertone: undertone
undisturbed: undisturbed
undo: undo,undone
undoubtedly: undoubtedly
undying: undying
uneasily: uneasily
uneasiness: uneasiness
unendurable: unendurable
unenforceability: unenforceability
unexpected: unexpected
unfeeling: unfeeling
unfinished: unfinished
unfold: unfolded
unfounded: unfounded
unfurnished: unfurnished
unhappy: unhappy
unheard: unheard
unhitch: unhitched
uniform: uniform
union: union
unitarian: unitarian
united: united
universal: universal
universally: universally
universe: universe
university: university
unknown: unknown
unlink: unlink
unlock: unlocked,unlocking,unlocks
unmade: unmade
unmeaning: unmeaning
unnecessary: unnecessary
unnerve: unnerve,unnerved
unnerved: unnerved
unobserved: unobserved
unpack: unpack
unpacked: unpacked
unpitied: unpitied
unpleasant: unpleasant
unprotected: unprotected
unreasonable: unreasonable
unreasonably: unreasonably
unreliable: unreliable
unsaid: unsaid
unseen: unseen
unsettled: unsettled
unshaven: unshaven
unsolicited: unsolicited
unspectacled: unspectacled
unsportsmanlike: unsportsmanlike
unstable: unstable
unsuspected: unsuspected
untended: untended
untidy: untidy
untie: untied
unusually: unusually
unveil: unveiling
unveiling: unveiling
update: updated
upper: upper
uppermost: uppermost
upright: upright
upset: upset
upstairs: upstairs
upward: upward
urban: urban
urchin: urchins
urgent: urgent
urn: urn
useless: useless
user: user
usual: usual
ut: ut
utmost: utmost
utter: utter
vacancy: vacancy
vacantly: vacantly
vague: vague,vaguest
vaguely: vaguely
vain: vain
valuable: valuable
van: van
vanilla: vanilla
vanish: vanish,vanished,vanishes,vanishing
variety: variety
vast: vast
vastly: vastly
vault: vaulted
vehemently: vehemently
vehicle: vehicles
veil: veil
vein: veins
velvet: velvet
vengeance: vengeance
venomously: venomously
ventriloquise: ventriloquising
venture: ventured,venturing
veranda: veranda
verbal: verbal
verdict: verdict
verily: verily
version: version
vest: vest,vests
vestige: vestiges
vibrate: vibrating
vibration: vibration,vibrations
vicar: vicar
vicarage: vicarage
viciously: viciously
victim: victim
victorian: victorian
view: view,viewed,viewing
vigorous: vigorous
vigorously: vigorously
vigour: vigour
vii: vii
viii: viii
villa: villa,villas
village: village
villager: villager,villagers
violate: violates
violence: violence
violent: violent
violently: violently
violet: violets
virtue: virtue
virus: virus
visage: visage
visibility: visibility
visible: visible
vision: vision,visions
visit: visit
visitor: visitor,visitors
vista: vista
vital: vital
vivid: vivid
vividly: vividly
vivisect: vivisecting
vivisection: vivisection
vivisectionist: vivisectionist
vocabulary: vocabulary
voce: voce
vociferate: vociferating
vociferation: vociferation
vociferous: vociferous
voice: voice,voices
void: void
volume: volume,volumes
volunteer: volunteer,volunteers
vox: vox
waggon: waggon,waggons
wail: wailing
waistcoat: waistcoat
wait: wait,waited,waiting,waits
wake: wake,woke
walk: walk,walked,walking,walks
walking: walking
wall: wall,walls
wand: wand
wander: wandered,wandering
wanton: wanton
war: war
wardrobe: wardrobe,wardrobes
warehouse: warehouse
warm: warm,warmed,warmer
warn: warned,warning
warnt: warnt
warrant: warrant
warranty: warranties,warranty
wary: wary
wash: wash,washed
washstand: washstand
wasp: wasp
waste: waste,wasted
watch: watch,watched,watches,watching
watchful: watchful
watchfulness: watchfulness
water: water
watery: watery
wave: waving
waverer: waverers
weak: weak,weaker
weapon: weapon,weapons
wear: wore,worn
weary: weary
weather: weather
wedge: wedge,wedged,wedging
weed: weeds
week: week,weeks
weep: weeping
weight: weight
weirdly: weirdly
wench: wenches
west: west
westward: westward
wet: wet
whack: whack
whatsoever: whatsoever
wheel: wheel,wheels
wheeler: wheeler
whereabouts: whereabouts
whiff: whiffs
whimper: whimpered
whip: whip,whipped,whipping
whirl: whirled,whirling
whirling: whirling
whisk: whisk,whisked
whisker: whisker,whiskers
whiskey: whiskey
whisper: whispered,whispering,whispers
whispering: whispering
whistle: whistled
whit: whit
white: white
whiten: whitened
whiteness: whiteness
whitewash: whitewash,whitewashing
whitsuntide: whitsuntide
whiz: whizzed
whizz: whizz
whoop: whooped
whup: whup
wi: wi
wicker: wicker
wide: wide,widest
widespread: widespread
wife: wife
wifely: wifely
wig: wig,wigs
wild: wild
wilderness: wilderness
willingly: willingly
wim: wim
win: winning
wince: winced
wind: wind
window: window,windows
windows: windows
windy: windy
wine: wine
wintertime: wintertime
wintry: wintry
wipe: wiped,wiping
wire: wire,wires
wiry: wiry
wisdom: wisdom
wise: wise
wit: wits
witchcraft: witchcraft
withdraw: withdraw,withdrew
witness: witness,witnessed,witnesses
wolf: wolf
woman: woman,women
wonderful: wonderful
wonderfully: wonderfully
wood: wood,woods
wooden: wooden
woody: woody
wool: wool
word: word,worded
worker: worker
worn: worn
worry: worry
worth: worth
worthy: worthy
wound: wound,wounded,wounds
wounded: wounded
wow: wow
wrap: wrapped,wrapping
wrapper: wrapper
wrapping: wrapping,wrappings
wreath: wreath
wreckage: wreckage
wrest: wrested
wrestling: wrestling
wretched: wretched
wriggle: wriggling
wrinkle: wrinkled
wrist: wrist,wrists
writ: writ
write: writing,written,wrote
writer: writer
writhe: writhed
writing: writing
wrong: wrong
xi: xi
xii: xii
xiii: xiii
xiv: xiv
xix: xix
xvi: xvi
xvii: xvii
xviii: xviii
xx: xx
xxi: xxi
xxii: xxii
xxiii: xxiii
xxiv: xxiv
xxv: xxv
yap: yap
yard: yard,yards
yawn: yawn,yawned
yell: yell,yelled,yelling
yellow: yellow
yelp: yelp,yelped,yelping
yelping: yelping
yer: yer
yesterday: yesterday
yiddish: yiddish
yield: yielded
yokel: yokels
youngster: youngsters
youth: youth
