aback: aback
abandon: abandon,abandoned
abandonment: abandonment
abashed: abashed
abdication: abdication
abhorrence: abhorrence
abide: abide
abnormal: abnormal
abolish: abolish
abolition: abolition
abortion: abortion
abram: abram
abrasion: abrasions
abrupt: abrupt
absence: absence
absolute: absolute
absolutely: absolutely
abstemious: abstemious
abstract: abstract
abstraction: abstraction
absurd: absurd
absurdity: absurdities
absurdly: absurdly
academic: academic
acceleration: acceleration
accept: accept,accepted,accepting
access: access,accessed
accessible: accessible
accidie: accidie
accommodate: accommodated
accompaniment: accompaniment
accompany: accompanied
accomplish: accomplished
accomplished: accomplished
accomplishment: accomplishment,accomplishments
account: account,accounted
accumulation: accumulations
accuracy: accuracy
accuse: accuse
accustom: accustomed
acetylene: acetylene
ache: ached
achieve: achieved
achieved: achieved
achievement: achievement,achievements
acquaint: acquainted
acquaintance: acquaintance
acquiesce: acquiesce
acquire: acquired,acquiring
acrid: acrid
acrobat: acrobats
acroceraunian: acroceraunian
action: action
active: active
activity: activities,activity
actual: actual
acute: acute
acutely: acutely
adam: adam
adapt: adapt
adaptation: adaptations
add: add,adding
addict: addicted
addio: addio
addition: addition,additions
additional: additional
address: address,addressed,addresses
adduce: adduced
adherence: adherence
adjective: adjective
adjourn: adjourned
adjunct: adjunct
administer: administered
admirable: admirable
admiration: admiration
admire: admire,admired,admiring
admit: admit,admitted
adolescence: adolescence
adolescent: adolescents
adorable: adorable
adore: adored
adult: adult,adults
advance: advanced,advances,advancing
advantage: advantage
advent: advent
adventure: adventure,adventures,adventuring
adventurous: adventurous
advertisement: advertisement,advertisements
advice: advice
advisable: advisable
advise: advise,advised,advising
aesthetic: aesthetic
aesthetically: aesthetically
aesthetics: aesthetics
affair: affair
affaire: affaire
affection: affection,affections
affectionate: affectionate
affectionately: affectionately
affirm: affirming
affluence: affluence
afford: afford
affront: affronting,affronts
afraid: afraid
afternoon: afternoon
age: age,ages
aged: aged
ageless: ageless
agency: agency
agent: agent
aggressively: aggressively
agile: agile
agility: agility
agitate: agitated
agitation: agitation
agonising: agonising
agonizingly: agonizingly
agony: agony
agree: agree,agreed
agreeable: agreeable
agreeably: agreeably
agreement: agreement
aim: aim
aimlessly: aimlessly
air: air,airs
airily: airily
airing: airing
airy: airy
ajar: ajar
ak: ak
alacrity: alacrity
alarming: alarming
alarmingly: alarmingly
alarum: alarum
alas: alas
alchemical: alchemical
alcohol: alcohol
alcove: alcove
alert: alert
alight: alight,alighted
alive: alive
alley: alleys
allies: allies
alliteration: alliteration
allure: allure
almond: almonds
aloof: aloof
aloofness: aloofness
aloud: aloud
alt: alt
alteration: alteration
alternate: alternate
alternative: alternatives
alternatively: alternatively
altogether: altogether
amateur: amateur
amazed: amazed
amazement: amazement
amazon: amazon
ambassador: ambassador
amber: amber
ambition: ambition,ambitions
america: america
american: americans
amiable: amiable
amor: amor
amorous: amorous
amorously: amorously
amour: amour
amphitheatre: amphitheatre
ample: ample
ampleness: ampleness
amuse: amuse,amused,amuses,amusing
amused: amused
amusement: amusement,amusements
amusing: amusing
anatomical: anatomical
ancestor: ancestors
anchorite: anchorite
ancient: ancient
anecdote: anecdote,anecdotes
angel: angel
angelic: angelic
anger: anger
angle: angle
anglican: anglican
angrily: angrily
angry: angry
animal: animal,animals
ankle: ankle
anna: anna
anne: anne
annex: annexed
anniversary: anniversary
annoyance: annoyance
annoyed: annoyed
anonymous: anonymous
answer: answer,answered,answers
anthropologist: anthropologist,anthropologists
anticipate: anticipating
antiquarian: antiquarian
antique: antique,antiques
antiquity: antiquities,antiquity
anxiety: anxiety
anxious: anxious
apartment: apartment
aphorism: aphorism,aphorisms
aphorismic: aphorismic
apologize: apologized
apophthegm: apophthegm
apoplexy: apoplexy
appal: appalled
appalling: appalling
apparatus: apparatus
apparent: apparent
apparition: apparition
appeal: appealed,appeals
appearance: appearance
appetite: appetite,appetites
applause: applause
apple: apple
applicable: applicable
applied: applied
apply: applied,apply
appreciation: appreciation
appreciative: appreciative
approach: approach,approached,approaching
approvingly: approvingly
apt: apt
aptitude: aptitude,aptitudes
aptly: aptly
aptness: aptness
aquiline: aquiline
arch: arch
archbishop: archbishop
archery: archery
architect: architect
architecture: architecture
archive: archive
ardour: ardour
arduous: arduous
argal: argal
argue: argues,arguing
argument: argument
argyll: argyll
aristocracy: aristocracies,aristocracy
aristocrat: aristocrat,aristocrats
aristocratic: aristocratic
arm: arm,arms
armageddon: armageddon
armed: armed
armistice: armistice
army: army
aromatically: aromatically
arrange: arranged,arranging
arrangement: arrangement,arrangements
array: array
arrest: arrested,arresting
arrival: arrival,arrivals
arrive: arrive,arrived,arriving
arrow: arrow
art: art,arts
arterial: arterial
artery: arteries,artery
article: articles
articulate: articulate,articulated
artificial: artificial
artificially: artificially
artist: artist,artists
artistic: artistic
ascend: ascend
ascetic: ascetic
ascii: ascii
ash: ashes
ashamed: ashamed
asleep: asleep
aspect: aspect
ass: ass
assault: assault,assaults
assemble: assembled
assent: assent,assented
assert: assert,asserted
assertion: assertion
assign: assign,assigned
assistance: assistance
associate: associate
association: associations
assonance: assonance
assortment: assortment
assume: assume,assumed
assure: assure,assured,assuring
assuredly: assuredly
astonish: astonished
astonished: astonished
astonishing: astonishing
astonishment: astonishment
astral: astral
atmosphere: atmosphere
atrociously: atrociously
attach: attached
attack: attack,attacked
attain: attain,attained
attainment: attainment
attempt: attempt,attempts
attend: attend,attended
attention: attention,attentions
attentive: attentive
attentively: attentively
attitude: attitude
attract: attracted
attraction: attraction
attribute: attributed
audible: audible
august: august
augustus: augustus
aunt: aunt
aura: aura
auras: auras
aurelius: aurelius
auricular: auricular
austere: austere
austria: austria
author: author,authors
authority: authorities,authority
automatic: automatic
automatically: automatically
automaton: automaton
autumn: autumn
avail: avail
avarice: avarice
avaricious: avaricious
avert: averted,averting
avoid: avoid,avoided,avoids
await: awaiting
awake: awake,awoke
awaken: awakened
aware: aware
awe: awe
awful: awful
axiomatic: axiomatic
baa: baa
baby: baby
babylonian: babylonian
bacchanal: bacchanal
bacchus: bacchus
background: background
bacon: bacon
bad: bad,worse,worst
badly: badly,worse
bag: bag
baggage: baggage
bait: baited
bake: baked
balance: balance,balances,balancing
balanced: balanced
bald: bald
baldly: baldly
baleful: baleful
balister: balister
ball: ball,balls
ballet: ballet
balloon: balloon,balloons
baluster: balusters
balustrade: balustrade
band: band,bands
bandage: bandaging
bandana: bandana
bandit: bandit
bang: bang
banish: banished
bank: bank
banner: banner
banquet: banquet
bar: barred,bars
barbarously: barbarously
barbary: barbary
barbecue: barbecue
bard: bard
bare: bare
bark: bark
barn: barns
barometer: barometer
baronet: baronet
baronial: baronial
baroque: baroque
barrier: barrier,barriers
bartholomew: bartholomew
base: base,based
bask: basked
basket: basket
bass: bass
bastion: bastion
batch: batch
bath: bath,bathing
bathe: bathe
bathing: bathing
bazaar: bazaar
beady: beady
beagle: beagles
beak: beak,beaked,beaks
beam: beam
bean: beans
bear: bear,bears,born,borne
beard: beard
bearer: bearers
beast: beast,beasts
beat: beat,beating
beautiful: beautiful
beautifully: beautifully
beauty: beauties,beauty
bed: bed,beds
bedroom: bedroom
bedside: bedside
bee: bee,bees
beget: begetting
behave: behave,behaved,behaving
behold: behold
belgium: belgium
belief: belief,beliefs
believer: believer
believing: believing
bell: bell,bells
bellow: bellow
belly: bellies,belly
belong: belong,belonged,belonging
belt: belt
bench: bench
bend: bent
beneath: beneath
bengal: bengal
benignly: benignly
bent: bent
berger: berger
bergere: bergere
berkeley: berkeley
berkshire: berkshire
besant: besant
bet: betted,betting
betray: betrayed
betters: betters
bewilderment: bewilderment
bewitchingly: bewitchingly
bianchi: bianchi
bias: bias
bible: bible
bicycle: bicycle
bid: bade,bidden,bidding
billiards: billiards
binary: binary
bind: bound
biographer: biographer
biographical: biographical
biographies: biographies
biography: biographies,biography
bird: bird,birds
birmingham: birmingham
birth: birth
birthday: birthday
bis: bis
bishop: bishop
bit: bit
bite: bit,bites,biting
bitter: bitter
bitterly: bitterly
black: black
blackamoor: blackamoors
blacken: blackened
blacker: blacker
blackfellow: blackfellow
blackmail: blackmail
blackness: blackness
blacksmith: blacksmith
bladder: bladder,bladders
blade: blades
blame: blame
blank: blank
blanket: blankets
blast: blast
blaze: blazed
bleed: bled
blessed: blessed
blight: blight
blind: blind,blinded,blinding
blindly: blindly
blink: blinked,blinking
bliss: bliss
block: block,blocks
blood: blood
bloodless: bloodless
bloody: bloody
bloom: bloomed
bloomsbury: bloomsbury
blossom: blossom,blossoming
blot: blot,blots
blotting: blotting
blow: blow,blowing,blown
bludgeon: bludgeon
blue: blue
blunt: blunt
blush: blush,blushed,blushing
boar: boar
board: board
boast: boast
boat: boat
bob: bob,bobbed,bobbing
bobbing: bobbing
bodice: bodice
bodily: bodily
body: bodies,body
bog: bogged
bohemian: bohemian
boisterous: boisterous
bold: bold
bole: bole
bolt: bolt
bombinate: bombinating
bon: bon,bons
bond: bond,bonds
bondage: bondage
bone: bone,bones
bony: bony
book: book,books
bookseller: booksellers
bookshelf: bookshelves
boom: boomed
booming: booming
boot: booted,boots
booth: booth,booths
border: borders
bore: bore,bored
bored: bored
boredom: boredom
boring: boring
borough: borough
borrow: borrowed
bosh: bosh
bottle: bottle,bottles
boudoir: boudoir
bounce: bouncing
bound: bounded
boundary: boundaries
boundless: boundless
bourbons: bourbons
bourgeois: bourgeois
bow: bow,bowed
bowl: bowl,bowls
bowler: bowler
box: box,boxes
boxroom: boxroom
boy: boy,boys
boycott: boycott
boys: boys
brain: brain
brainless: brainless
brake: brakes
branch: branches
brandy: brandy
brass: brass
brawn: brawn
brawny: brawny
bray: bray
brazen: brazen
breach: breach
break: break,breaking,broke,broken
breakfast: breakfast
breaking: breaking
breast: breast
breath: breath
breathe: breathed,breathing
breathing: breathing
breathless: breathless
breathlessly: breathlessly
breeches: breeches
breed: bred,breed,breeding,breeds
breeder: breeder
brew: brew
bribe: bribe,bribed
brick: brick
bride: bride
bright: bright,brighter
brighten: brightened
brightly: brightly
brightness: brightness
brilliance: brilliance
brilliant: brilliant
brim: brimmed
bring: bring,bringing,brings,brought
brink: brink
briskly: briskly
bristly: bristly
broad: broad
broadsheet: broadsheet
broadsword: broadsword
broken: broken
bronze: bronze
brood: brood,brooded
brooding: brooding
brook: brooks
brother: brothers
brow: brow
brown: brown
brownish: brownish
bruise: bruised
brush: brushed,brushes,brushing
brutally: brutally
brute: brute
brutish: brutish
bubble: bubble,bubbling
buckle: buckles
bud: buds
budge: budge
budget: budget
buffet: buffeted
buffoonish: buffoonish
build: build,building,builds,built
builder: builder
building: building,buildings
bulk: bulk
bull: bull
bulwark: bulwark
bump: bump
bumpingly: bumpingly
bun: buns
bunch: bunch
bundle: bundled
bunt: bunting
buoy: buoy
burden: burden
burgeon: burgeoning
burgess: burgesses
burgundy: burgundy
burn: burned,burning
burnished: burnished
burns: burns
burst: burst,bursting
bus: bus
bush: bushes
busily: busily
business: business
bust: bust
bustle: bustles
busy: busiest,busy
butler: butler
butter: butter
butterfly: butterfly
button: button
buttonhole: buttonhole,buttonholes
buzzing: buzzing
bye: bye
byre: byres
byron: byron
byronic: byronic
cabinet: cabinet
cackle: cackled,cackling
caesar: caesar
caesarean: caesarean
cage: cage
cake: cake
calash: calash
calculate: calculate,calculated
calculation: calculations
calendar: calendar
calf: calves
calling: calling
calm: calm
calmly: calmly
camlet: camlet
canalise: canalise,canalised
candid: candid
candle: candle,candles
cannon: cannon
canopy: canopy
cantata: cantatas
cantatrice: cantatrice
canvas: canvas,canvases
cap: caps
capable: capable
capital: capital
capri: capri
captain: captains
capture: capture
car: car
carcase: carcase
card: card
cardboard: cardboard
care: care,cared
career: career
careful: careful
carefully: carefully
careless: careless
carelessly: carelessly
careme: careme
caress: caress,caressed,caressing
caricature: caricature,caricatures
carmen: carmen
carminative: carminative
carnation: carnation
carnival: carnival
caro: caro
caroline: caroline
carpet: carpet
carriage: carriage,carriages
carry: carried,carries,carry,carrying
cart: cart,carted
cartoon: cartoon
carve: carved
casing: casing
cassock: cassock
cassocks: cassocks
cast: cast,casting
castle: castle
casual: casual
casually: casually
cat: cat,cats
cataclysm: cataclysms
catalogue: catalogue
catch: catch,catching,caught
catechism: catechism
category: category
catholic: catholic
cauldron: cauldron
causerie: causerie
caution: caution
cautious: cautious
cautiously: cautiously
cavendish: cavendish
cavern: caverns
cavernous: cavernous
ce: ce
cease: cease,ceased
cedar: cedar
ceiling: ceiling
celebrate: celebrated,celebrating
celebration: celebration
cell: cell
cellar: cellars
central: central
centralised: centralised
centre: centre
century: centuries,century
certainty: certainty
chain: chained
chair: chair,chairs
chamber: chamber,chambers
champagne: champagne
champing: champing
championship: championship
chance: chance
change: change,changed,changing
channel: channels
chaos: chaos
chapter: chapter,chapters
char: charred
character: character,characters
characterise: characterised
characteristic: characteristics
charge: charge,charges
charitable: charitable
charity: charities,charity
charles: charles
charm: charm,charmed,charms
charmer: charmer,charmers
charming: charming
chase: chase
chasm: chasm
chastisement: chastisement
chasuble: chasubles
chattel: chattels
chaucer: chaucer
check: check,checked,checks
cheek: cheek,cheeks
cheer: cheer,cheered
cheerful: cheerful
chequer: chequered
cherub: cherubs
chestnut: chestnut
chew: chewed,chewing
chez: chez
chiaroscuro: chiaroscuro
chicken: chicken
chief: chief
chien: chien
child: child,children
childe: childe
childhood: childhood
childish: childish
childlike: childlike
chilly: chilly
chimney: chimney
chin: chin
china: china
chinese: chinese
chink: chinks
chintz: chintz
choice: choice,choicest
choke: choking
choose: choose,chose,chosen
chord: chord
christ: christ
christen: christened
christian: christian,christians
christophe: christophe
chronic: chronic
chronicle: chronicle
chuckle: chuckled
church: church,churches
churchyard: churchyard
cigar: cigar
cigarette: cigarette,cigarettes
cinema: cinema
cinnamon: cinnamon
circle: circle
circular: circular
circulate: circulating
circulation: circulation
circumstance: circumstance,circumstances
circus: circus
city: cities,city
civilisation: civilisation
civilised: civilised
claim: claim,claims
clairvoyance: clairvoyance
clamber: clambered
clamorously: clamorously
clamour: clamour
clap: clap
clapping: clapping
claptrap: claptrap
claret: claret
clarify: clarified
clash: clashing
class: class,classes
classical: classical
classicist: classicist
classification: classification
classified: classified
classify: classified
clatter: clattered
claudius: claudius
clavichord: clavichord
claw: claw
clay: clay
clean: clean,cleaning
clergy: clergy
clergyman: clergyman
clerical: clerical
clerk: clerk
clever: clever
client: clients
climate: climates
climb: climb,climbed,climbing
clinch: clinched
cling: cling
clip: clipped
cloak: cloak
clock: clock
clockwork: clockwork
clod: clods
cloddish: cloddish
cloister: cloister
close: close,closed,closer,closing
closely: closely
closet: closet
cloth: cloth
clothe: clad,clothed
clothes: clothes
clothing: clothing
cloud: cloud,clouds
clown: clowns
club: club
cluck: cluck
clucking: clucking
clueless: clueless
cluster: clustered,clustering
coach: coach,coaches
coarse: coarse
coat: coat,coats
cobalt: cobalt
cobwebs: cobwebs
cockade: cockade
cocoa: cocoa
cocoanut: cocoanut
code: codes
coffee: coffee
coffin: coffin
cogent: cogent
cognisance: cognisance
coiffure: coiffure
coil: coiled
coincidence: coincidence
cold: cold
coldly: coldly
collapse: collapsed
collar: collar,collars
collection: collection
colonial: colonials
colour: colour,coloured,colours
coloured: coloured
colourless: colourless
column: column
combe: combes
combine: combine
combiner: combiner
comedy: comedy
comfort: comfort,comforted
comfortable: comfortable
comfortably: comfortably
comforting: comforting
comic: comic
command: commanded,commanding
commemorate: commemorated
comment: comment,commented
commentary: commentary
commercial: commercial
commiserate: commiserated
commit: commit,committed
committee: committee
common: common
commonality: commonality
commonly: commonly
commotion: commotion
communication: communication
community: community
companion: companion,companions
company: company
comparative: comparative
compare: compared,compares
compass: compass
compel: compel,compelled
compelling: compelling
compendiously: compendiously
compensate: compensated
compilation: compilation
compile: compile
complain: complain,complained
complaisant: complaisant
complementary: complementary
complete: complete
completely: completely
completion: completion
complexion: complexion
compliance: compliance
complicate: complicated
complicated: complicated
comply: comply,complying
compose: compose,composed
composition: composition,compositions
comprehend: comprehend
comprehensible: comprehensible
comprehensive: comprehensive
compress: compressed
compromise: compromise
conceal: concealed
conceive: conceived
concentrate: concentrate
concentrated: concentrated
concept: concept
concern: concern
concerned: concerned
concert: concert,concerts
concerted: concerted
conclude: concluded
conclusion: conclusion,conclusions
conclusive: conclusive
concoct: concoct
concrete: concrete
concretely: concretely
concussion: concussion
condemn: condemned
condescension: condescension
condition: condition
conducive: conducive
conduct: conduct
conduit: conduits
confess: confess
confidence: confidence,confidences
confident: confident
confidential: confidential
confidently: confidently
confine: confined
confirm: confirmed
confirmation: confirmation
conflict: conflict
confront: confronted
congenial: congenial
congo: congo
congratulate: congratulate,congratulated,congratulating
congregate: congregate
congregation: congregation
connect: connect,connected
connection: connection
conscience: conscience
conscious: conscious
consciously: consciously
consciousness: consciousness
consequential: consequential
conservative: conservative
considerable: considerable
consideration: consideration,considerations
consist: consisted,consisting
consistent: consistent
consolation: consolation,consolations
conspire: conspire
constancy: constancy
constant: constant
constantly: constantly
constatation: constatation
constitution: constitution
construct: constructed
consult: consulted
consummate: consummated
contact: contact,contacts
contemplation: contemplation
contemporary: contemporary
contempt: contempt
content: content
contented: contented
contentment: contentment
contents: contents
context: context
continent: continent
continental: continental
contingency: contingencies
contingent: contingent
continual: continual
continue: continue,continued,continuing
continuous: continuous
continuously: continuously
contract: contract
contraction: contraction
contrast: contrasted,contrasting
contribution: contributions
contrive: contriving
contrived: contrived
control: control,controlled
controller: controller
conveniently: conveniently
conversation: conversation
conversational: conversational
convert: convert,converted,converting
conviction: conviction
convince: convinced
convinced: convinced
convincing: convincing
cooing: cooing
cook: cook
cool: cool,cooler,coolest
copse: copse
copying: copying
copyright: copyright
cork: cork
corkscrewed: corkscrewed
corn: corn
corner: corner,corners
cornish: cornish
coronet: coronet
corporal: corporal
corporation: corporation
corpulent: corpulent
corpuscle: corpuscles
corridor: corridor,corridors
corrupt: corrupt
corsair: corsair
corsican: corsican
cosmology: cosmology
cosmos: cosmos
cost: cost,costs
costume: costume
cottage: cottage
cough: cough,coughed,coughing
counsel: counsels
count: count,counted,counts
countenance: countenance
counteract: counteract
countless: countless
country: countries,country
countryman: countrymen
countryside: countryside
county: county
couple: couple,coupled,couples
courage: courage
court: court
courtship: courtship
courtyard: courtyard
cover: cover,covered
covered: covered
covert: covert
cow: cows
cowshed: cowsheds
crab: crab
crack: cracked
crackle: crackling
craft: crafts
cram: crammed
cramped: cramped
cranny: crannies
crash: crash,crashed
crass: crass
creak: creaking
cream: cream
create: create,created,creating
creation: creation
creative: creative
creature: creature,creatures
credit: credit
creed: creed
creep: creep,crept
cremona: cremona
crescendo: crescendo
crest: crest
crew: crew
cricket: cricket
crime: crimes
crisis: crisis
critic: critic
critical: critical
critically: critically
criticism: criticism
crocodile: crocodile
crome: crome
crooked: crooked
crookedly: crookedly
cross: cross,crossed,crosses,crossing
croup: croup
crowd: crowd,crowds
crown: crowned,crowns
crucial: crucial
crucified: crucified
crucifixion: crucifixion
crude: crude
cruel: cruel
cruelly: cruelly
cruelty: cruelty
crumble: crumbled
crumple: crumple
crunch: crunched
crusade: crusade,crusades
crush: crushed
cryptic: cryptic
crystal: crystal
cubism: cubism
cubist: cubist
cuckoo: cuckoo,cuckooed
culminate: culminating
cultivate: cultivate,cultivating
cultivation: cultivation
culture: culture,cultured
cumbrous: cumbrous
cunningly: cunningly
cup: cup,cups
cupboard: cupboard
curate: curates
cure: cure
curiosity: curiosity
curious: curious
curiously: curiously
curl: curls
curly: curly
current: current
curtain: curtain,curtains
curtly: curtly
curtseying: curtseying
curve: curves
curved: curved
cushion: cushions
custom: custom,customs
customarily: customarily
customary: customary
cut: cut,cuts,cutting
cutter: cutters
cylinder: cylinder
cymbal: cymbals
cypress: cypress
cyprian: cyprian
da: da
dabble: dabbles
daily: daily
dally: dallied
damage: damage
damaged: damaged
damages: damages
damn: damn
damnable: damnable
damned: damned
damp: damp,damped
dampness: dampness
dance: dance,danced,dances,dancing
dancer: dancer,dancers
dancing: dancing
dandelion: dandelion
danger: danger
dangerous: dangerous
dangle: dangling
dark: dark
darkness: darkness
darling: darling
dart: darted
darts: darts
darwin: darwin
dash: dashed,dashing
dateless: dateless
datum: data
daughter: daughter,daughters
david: david
dawn: dawn,dawns
day: day,days
daylight: daylight
days: days
daze: dazed
dazed: dazed
dazzle: dazzling
dazzling: dazzling
dead: dead
deaf: deaf
deafness: deafness
deal: deal,dealing
death: death
debutante: debutante,debutantes
decade: decade
decanter: decanter
decay: decay
decaying: decaying
december: december
decency: decencies,decency
decently: decently
deceptively: deceptively
decide: decide,decided
decidedly: decidedly
decision: decision
decisive: decisive
decisively: decisively
deck: deck
declare: declare,declared
decline: decline,declined
decolletage: decolletage
decorously: decorously
dedicate: dedicated,dedicating
deductible: deductible
deep: deep,deeper
deepen: deepened
deeply: deeply
defect: defect,defects
defective: defective
define: defined
definition: definition
deformity: deformity
degas: degas
degrading: degrading
degree: degree,degrees
dejected: dejected
dejectedly: dejectedly
delay: delay
delectation: delectation
deletion: deletions
deliberate: deliberate
deliberately: deliberately
delicate: delicate
delicately: delicately
delicious: delicious
deliciously: deliciously
delight: delight,delights
delighted: delighted
delightful: delightful
delineation: delineation
delirium: delirium
deliver: deliver,delivered
dell: dell
delusion: delusion
delving: delving
demand: demand,demanded,demanding
demon: demon
demonstration: demonstration
den: den
denial: denial
denigration: denigration
denis: denis
dense: dense
deny: denies
depart: depart,departed
departure: departure
depend: depend,depended,depends
deplorable: deplorable
deplore: deplore
deposit: deposit
deprecate: deprecating
deprecatingly: deprecatingly
depress: depressed
depressed: depressed
depressing: depressing
depression: depression,depressions
depth: depth
depths: depths
derange: deranged
derby: derby
derivation: derivations
derivative: derivative
derive: derive,derived
descant: descant
descend: descend,descended,descending
descendant: descendants
descent: descent
description: description,descriptions
descriptive: descriptive
descry: descry
desecrate: desecrated
desert: deserted
deserted: deserted
deserve: deserved
desiccation: desiccation
design: design,designs
desirability: desirability
desirable: desirable
desire: desire,desired,desires
desk: desk
desolate: desolate,desolated
despair: despair
despairing: despairing
despairingly: despairingly
desperate: desperate
desperately: desperately
despise: despised
destination: destination
destine: destined
destiny: destinies,destiny
destroy: destroy,destroyed
destruction: destruction
detach: detach
detached: detached
detachment: detachment
detailed: detailed
detect: detect
deter: deterred
determine: determine,determined
determined: determined
deterrent: deterrent
develop: develop,developed
development: development
devil: devil
devise: devising
devote: devote,devoted,devoting
devotions: devotions
devour: devour
dew: dew
di: di
dia: dia
diabolic: diabolic
dialect: dialect
diamond: diamonds
diary: diaries,diary
dictate: dictated
dictionary: dictionaries,dictionary
didactically: didactically
die: die,died,dies,dying
diet: diet
difference: difference,differences
difficult: difficult
difficulty: difficulty
dig: digs,dug
dignified: dignified
dignity: dignity
dilemma: dilemma
dilettante: dilettante
dim: dim
dimension: dimension,dimensions
diminish: diminish,diminishing
diminishingly: diminishingly
diminutive: diminutive
dimpled: dimpled
dine: dine,dined
dining: dining
dinner: dinner
dinted: dinted
dip: dipping
dipsomaniac: dipsomaniac,dipsomaniacs
direct: direct,directing
direction: direction
director: director,directors
dirt: dirt
dirtily: dirtily
disagree: disagree
disagreeable: disagreeable
disappear: disappear,disappeared,disappears
disappointed: disappointed
disappointment: disappointment,disappointments
disastrous: disastrous
discharge: discharged
disciple: disciples
discipline: discipline
disclaim: disclaim
disclaimer: disclaimer,disclaimers
discomfort: discomfort
disconcertingly: disconcertingly
discontent: discontent
discontinue: discontinue
discourse: discourse,discoursed,discourses,discoursing
discover: discover,discovered
discovery: discoveries,discovery
discreet: discreet
discreetly: discreetly
discrete: discrete
discretion: discretion
discuss: discuss,discussed
discussion: discussion
disease: disease,diseases
disembowel: disembowelled
disengage: disengaged
disguise: disguised
disgust: disgust
disgusting: disgusting
dish: dish
disinterested: disinterested
disk: disk
dislike: dislike
dismal: dismal
dismantle: dismantled
dismay: dismay
dismember: dismembered
disobey: disobeyed
disorder: disorder
disorganised: disorganised
disparage: disparaging
disparagement: disparagement
dispassionately: dispassionately
dispense: dispensing
disperse: dispersed
display: display,displayed,displaying
displeasure: displeasure
disport: disport
disquiet: disquiet
disquieting: disquieting
disregard: disregard,disregarded
dissatisfied: dissatisfied
dissect: dissected
dissent: dissent
dissipate: dissipated
dissociate: dissociate,dissociating
dissolution: dissolution
dissolve: dissolving
distance: distance,distances
distant: distant
distended: distended
distinct: distinct
distinguish: distinguished
distinguished: distinguished
distract: distracted
distractingly: distractingly
distress: distress,distressed
distressed: distressed
distressing: distressing
distressingly: distressingly
distribute: distribute,distributed,distributing
distribution: distribution
distributor: distributor
district: district
disturb: disturb,disturbed,disturbs
disturbed: disturbed
disused: disused
ditchwater: ditchwater
divagate: divagate
dive: dived
diver: divers
diversify: diversified
diversion: diversions
divide: divided,dividing
divine: divine
divinely: divinely
divinity: divinity
divulge: divulge,divulged
dizzy: dizzy
docket: docketed
dog: dog,dogs
dogma: dogma
doings: doings
doll: doll
dollish: dollish
dolly: dolly
domain: domain
dominant: dominant
donate: donate
donation: donation,donations
donne: donne
donor: donors
doom: doomed
door: door,doors
doorway: doorway
doris: doris
dose: dose
double: double
doubt: doubt
downfall: downfall
downhill: downhill
downily: downily
download: downloading
downstairs: downstairs
doze: dozing
dozen: dozen,dozens
dozy: dozy
drag: dragged
dragon: dragon
drain: drain
drainpipe: drainpipes
dramatically: dramatically
draught: draught
draw: draw,drawn,drew
drawer: drawer
drawing: drawing,drawings
dread: dreads
dreadfully: dreadfully
dream: dream,dreaming,dreamt
drearily: drearily
dreary: dreary
dress: dress,dressed,dresses
dressing: dressing
dressy: dressy
drift: drift
drink: drank,drink,drinking
drinking: drinking
drive: drive,driven,drives,driving,drove
driver: driver
droop: drooped,drooping
droopy: droopy
drop: drop,dropped,drops
drown: drown,drowned
drowsily: drowsily
drowsiness: drowsiness
drowsy: drowsy
drudge: drudge
drug: drugged
drum: drum,drummed,drumming,drums
drumming: drumming
drumstick: drumstick,drumsticks
drunk: drunk
drunken: drunken
dry: dry
drying: drying
du: du
ducal: ducal
duck: duck,ducks
dug: dugs
dull: dull
duly: duly
dummy: dummy
dung: dung
dust: dust,dusted
dusty: dusty
duty: duties
dwarf: dwarf,dwarfs
dwarfish: dwarfish
dwelt: dwelt
dynamo: dynamo
eager: eager
eagerly: eagerly
ear: ear,ears
earnest: earnest
earnestly: earnestly
earnestness: earnestness
earth: earth
earthquake: earthquakes
earthward: earthward
earthy: earthy
easel: easel
easily: easily
east: east
eastern: eastern
eastward: eastward
easy: easier,easiest,easy
eat: ate,eat,eaten,eating,eats
ebb: ebbing
eccentric: eccentric,eccentrics
eccentricity: eccentricities,eccentricity
ecclesiastical: ecclesiastical
ecclesiastically: ecclesiastically
echo: echo,echoed,echoes,echoing
economical: economical
ecstasy: ecstasies
ecstatic: ecstatic
eddy: eddy
edge: edge,edges
edgeway: edgeways
edinburgh: edinburgh
edition: edition,editions
editor: editor
educate: educated
education: education
educational: educational
efficiency: efficiency
effort: effort,efforts
egeria: egeria
eglantine: eglantine
egypt: egypt
egyptian: egyptian,egyptians
eighteen: eighteen
eighteenth: eighteenth
einstein: einstein
elaborate: elaborate
elaboration: elaboration
elan: elan
elapse: elapsed
elastic: elastic
elbow: elbow,elbows
eld: eldest
elect: elect,elected
electric: electric
electrical: electrical
electricity: electricity
electronic: electronic
electronically: electronically
elegance: elegance,elegances
elegant: elegant
elegantly: elegantly
elegiac: elegiac
element: element,elements
elephant: elephants
elevate: elevated
elisha: elisha
elizabeth: elizabeth
elizabethan: elizabethan
elm: elms
eloquence: eloquence
email: email
embalm: embalmed
embark: embarked
embarrassing: embarrassing
embarrassment: embarrassment
embay: embayed
embayed: embayed
embed: embedded
emblazon: emblazon
embody: embodied
embolden: emboldened
embower: embowered
embrace: embrace,embraced,embracing
embracement: embracement
embroil: embroiled
emerald: emerald
emerge: emerge,emerged,emerging
eminent: eminent
eminently: eminently
emit: emitted
emotion: emotion,emotions
emotional: emotional
emphasise: emphasised
empire: empire,empires
employ: employ,employed
employee: employee,employees
empyrean: empyrean
en: en
enable: enabled
enamel: enamelled
enamelled: enamelled
enamour: enamoured
enchantment: enchantment
enchiridion: enchiridion
encircle: encircling
enclose: enclosed
enclosure: enclosure
encode: encoding
encourage: encourage,encourages,encouraging
encouragement: encouragement
encouragingly: encouragingly
encyclopaedia: encyclopaedia
endless: endless
endow: endowing
endowment: endowments
enemy: enemies
energy: energy
enforcement: enforcement
engage: engaged
engagement: engagements
engaging: engaging
engender: engendered
engine: engine
engineering: engineering
england: england
english: english
engrave: engraved
engraving: engraving,engravings
engulf: engulfed
enhance: enhance,enhancing
enigmatic: enigmatic
enjoy: enjoy,enjoyed,enjoying,enjoys
enliven: enlivened
enormous: enormous
enormously: enormously
enrichment: enrichment
enrol: enrolled
ensue: ensued
ensure: ensures,ensuring
entail: entailed
enter: enter,entered
entertaining: entertaining
enthusiasm: enthusiasm,enthusiasms
enthusiast: enthusiasts
enthusiastic: enthusiastic
entity: entity
entrails: entrails
entrance: entrance
entreaty: entreaties
enumerate: enumerate
enunciate: enunciated
envelop: enveloped
envelope: envelope,envelopes
enviable: enviable
enviously: enviously
environment: environment
envisage: envisaged
envy: envied,envy
epipsychidion: epipsychidion
episode: episode
equal: equal,equals
equally: equally
equanimity: equanimity
equilibrium: equilibrium
equipment: equipment
erasmus: erasmus
ere: ere
erect: erect,erected
ernest: ernest
eros: eros
errand: errand,errands
erratic: erratic
error: errors
erudition: erudition
escape: escape,escaped,escapes
essential: essentials
essentially: essentially
establish: establish,established,establishing
establishment: establishment
estate: estate
esteem: esteem
estimable: estimable
estimation: estimation
eternal: eternal
eternity: eternity
ethereal: ethereal
ethic: ethics
ethiopia: ethiopia
eton: eton
euphrates: euphrates
europe: europe
european: european
evade: evade
evanescent: evanescent
evangelisation: evangelisation
evase: evase
eve: eve
evening: evening,evenings
event: events
everlastingly: everlastingly
evidence: evidence
evident: evident
evil: evil
evoke: evoke,evoked,evokes,evoking
exacerbate: exacerbated,exacerbating
exact: exact
exaggerate: exaggerated
exaggerated: exaggerated
exalt: exalted
exaltation: exaltation
examination: examination
examine: examine,examined,examining
exasperatingly: exasperatingly
excalibur: excalibur
excavator: excavator
excel: excelled
excellent: excellent
exception: exception
excess: excesses
excessive: excessive
excitement: excitement
exciting: exciting
exclaim: exclaimed
exclusion: exclusion
exclusively: exclusively
excruciating: excruciating
excursion: excursion
excuse: excuse,excused
execute: execute,executed,executing
execution: execution
executive: executive
exemplary: exemplary
exempt: exempt
exercise: exercise,exercised,exercises
exhaust: exhausting
exhausting: exhausting
exhibit: exhibit,exhibited,exhibiting
exhilarating: exhilarating
exhort: exhorting
exile: exile
exist: exist,existed,exists
existence: existence
exmoor: exmoor
exorbitantly: exorbitantly
exotic: exotic
expand: expanded,expanding
expanse: expanse,expanses
expansion: expansion
expect: expect,expected,expecting
expectant: expectant
expected: expected
expedient: expedient
expend: expend,expended,expending
expense: expense,expenses
expensive: expensive
experience: experience,experiences
experienced: experienced
experiment: experiment,experimented
expire: expiring
explain: explain,explained
explanation: explanation
explicit: explicit
exploit: exploited,exploits
exploitation: exploitation
explore: explore,exploring
export: exporting
express: express,expressed,expressing
expression: expression,expressions
expressionless: expressionless
expressive: expressive
exquisite: exquisite
exquisitely: exquisitely
extend: extend
extended: extended
extension: extension
extensive: extensive
extent: extent
external: external
externalise: externalised,externalising
externally: externally
extinct: extinct
extinction: extinction
extra: extra
extraction: extraction
extraordinarily: extraordinarily
extraordinary: extraordinary
extravagant: extravagant
extreme: extreme
extremely: extremely
exuberantly: exuberantly
eye: eye,eyes
eyebrow: eyebrows
eyed: eyed
eyelash: eyelashes
eyelid: eyelids
fable: fable
fabulist: fabulists
fabulous: fabulous
facade: facade
faced: faced
facility: facility
faculty: faculties,faculty
fade: faded,fading
fadingly: fadingly
fail: fail,failed
faint: faint,fainter,faints
faintly: faintly
fair: fair
fairbanks: fairbanks
faith: faith
faithful: faithful
fall: fall,fallen,falling,falls,fell
fallen: fallen
false: false
fame: fame
familiar: familiar
family: family
famine: famine,famines
famous: famous
fan: fanning
fancy: fancy
fangled: fangled
fantastic: fantastic
fantastically: fantastically
farewell: farewell,farewells
farm: farm
farmer: farmer,farmers
farming: farming
farmyard: farmyard
fascinate: fascinated,fascinates
fascinating: fascinating
fascisti: fascisti
fashion: fashion
fashionable: fashionable
fashioned: fashioned
fast: fast
fastidious: fastidious
fat: fat
fatal: fatal
fatalistically: fatalistically
fate: fate,fates
father: father
fatigue: fatigue
fault: fault
favour: favour,favoured
favourite: favourite
fawn: fawn
fear: fear,feared
fearful: fearful
feast: feast,feasted,feasts
feat: feat
feather: feather,feathers
feathery: feathery
feature: feature,features
federal: federal
fee: fee,fees
feeble: feeble
feed: fed,feed
feel: feel,feeling
feeling: feeling
feign: feigning
fellow: fellow,fellows
female: female
femme: femme
ferial: ferial
fermented: fermented
ferociously: ferociously
ferocity: ferocity
ferrule: ferrule
festal: festal
festive: festive
festivity: festivity
festoon: festoon
fever: fever
feverish: feverish
fiction: fiction
fiddle: fiddle,fiddled
fiddler: fiddler
fidelity: fidelity
fidgety: fidgety
field: field,fields
fiendish: fiendish
fierce: fierce
fiercely: fiercely
fiery: fiery
fifteenth: fifteenth
fiftieth: fiftieth
fight: fighting,fought
figure: figure,figured,figures
file: file,files
final: final
finality: finality
finally: finally
financial: financial
finding: finding
fine: fine,finest
finery: finery
finger: finger,fingers
finish: finished,finishing
finished: finished
finnish: finnish
fireman: firemen
fireplace: fireplace
firm: firm
firmly: firmly
fish: fish
fit: fit,fits,fitted
fitfully: fitfully
fitness: fitness
fitting: fitting
fixed: fixed
flail: flail
flake: flaked
flamboyantly: flamboyantly
flame: flame
flank: flank,flanks
flannel: flannel
flap: flap,flapped
flare: flared,flares
flash: flashing
flat: flat
flatter: flattered
flawless: flawless
flay: flaying
flee: fled
flesh: flesh
fleshy: fleshy
flick: flick
flight: flight
flimsy: flimsier
fling: fling,flung
flint: flint
flirt: flirted
flit: flit
float: float,floated,floating
floater: floaters
flock: flock,flocked,flocks
flood: flood
floor: floor,floors
flooring: flooring
florid: florid
flourish: flourish,flourished,flourishes
flow: flow,flowed,flowing
flower: flower,flowered,flowers
fluently: fluently
fluff: fluff
fluid: fluid
flush: flush,flushed
flushed: flushed
flute: flute
flutter: fluttered
fluty: fluty
fly: flew,flies,fly,flying
focal: focal
focus: focus,focusing
foible: foibles
fold: folded,folds
foliage: foliage
folio: folios
follow: follow
folly: folly
fond: fond
food: food
fool: fool
foolish: foolish
foot: feet,foot
football: football
footpath: footpath
footprint: footprint
footstep: footsteps
forbid: forbidding
force: forced,forces
forefinger: forefinger
foreground: foreground
forehead: forehead
foreign: foreign
foremost: foremost
foreshortened: foreshortened
forest: forest
foretell: foretell,foretelling
forget: forget,forgets,forgotten
forgiveness: forgiveness
fork: fork
forlornly: forlornly
form: form,formed,forms
formal: formal
formalise: formalised
formality: formality
format: format,formats
formidable: formidable
formula: formula,formulas
formulate: formulate,formulated
forthcoming: forthcoming
forthwith: forthwith
fortification: fortification
fortuitously: fortuitously
fortunately: fortunately
fortune: fortune,fortunes
forwards: forwards
fossil: fossils
foundation: foundation,foundations
founder: founders
fount: fount
fountain: fountain
fourteen: fourteen
fourteenth: fourteenth
fourth: fourth
fowl: fowls
fox: foxes
fracture: fractured
fragment: fragments
fragmentary: fragmentary
fragrant: fragrant
frail: frail
frame: frame
france: france
francis: francis
franco: franco
frank: frank
frankness: frankness
frantic: frantic
freedom: freedom
freely: freely
freeze: frozen
french: french
frenzy: frenzy
frequently: frequently
fresh: fresh
fret: fretted
friend: friend,friends
friendly: friendly
friendship: friendship
fright: fright
frighten: frightened
frightened: frightened
frightful: frightful
frightfully: frightfully
frigid: frigid
fringe: fringed
frith: frith
frock: frock
frown: frown,frowned,frowning
frozen: frozen
fruit: fruit
fulfilment: fulfilment
fullness: fullness
fumble: fumbling
fun: fun
function: function,functioned,functioning,functions
functioning: functioning
fund: funds
fundamental: fundamental
fundamentally: fundamentally
funeral: funeral
funnel: funnel
fur: fur
furious: furious
furiously: furiously
furl: furled
furniture: furniture
fury: fury
fut: fut
futile: futile
future: future
gadding: gadding
gaiety: gaieties,gaiety
gaily: gaily
gain: gained,gaining
gainsay: gainsaid
galbe: galbe
gallantry: gallantry
gallery: gallery
gambit: gambit
gamble: gambled
game: game,games
gaol: gaol,gaoled
gap: gap
gape: gaping
garden: garden
gardener: gardeners
garment: garment
garnish: garnished
gashed: gashed
gasp: gasp,gasped,gasping,gasps
gaspingly: gaspingly
gate: gate,gates
gather: gather
gaudy: gaudy
gaunt: gaunt
gay: gay
gaze: gazed,gazing
gehenna: gehenna
generalisation: generalisation
generalise: generalising
generation: generation,generations
generous: generous
generously: generously
genial: genial
genially: genially
genius: genius
gentle: gentle
gentleman: gentlemen
gently: gently
gentry: gentry
genuine: genuine
genuinely: genuinely
geology: geology
geometrical: geometrical
george: george
georgian: georgian
georgiana: georgiana
german: german,germans
germany: germany
gesticulate: gesticulating
gesture: gesture,gestures
ghost: ghost
ghostly: ghostly
giant: giant,giants
giants: giants
gibber: gibbering
gibbosity: gibbosity
gibbous: gibbous
gift: gift,gifts
gig: gig
gigantic: gigantic
giggle: giggled
gilded: gilded
gin: gin
girdle: girdles
girl: girl,girls
glad: glad
gladness: gladness
gladstone: gladstone
glance: glance,glanced
glare: glare,glared
glass: glass,glasses
glaucous: glaucous
glazed: glazed
gleam: gleam
glide: gliding
glitter: glittered
globe: globe
gloom: gloom
gloomily: gloomily
gloomy: gloomy
glorify: glorified
glorious: glorious
glory: glories,glory
glove: glove
glow: glow,glowed
glowing: glowing
glumly: glumly
gnomic: gnomic
goal: goals
goblet: goblet
god: god
goddess: goddess
godwin: godwin
gold: gold
golden: golden
gomorrah: gomorrah
gong: gong
goodness: goodness
goose: geese,goose
gorge: gorge
gospel: gospel
gothic: gothic
govern: govern
government: government
governor: governors
gown: gown
grace: grace
graceful: graceful
gracefulness: gracefulness
gracious: gracious
graciousness: graciousness
gradually: gradually
grammar: grammar
grammarian: grammarians
gramophone: gramophone
granary: granary
grand: grand
grandeur: grandeur
grandfather: grandfather
grandiose: grandiose
grandiosely: grandiosely
grandsire: grandsire
grant: granted
grape: grapes
grasp: grasped
grass: grass,grasses
grate: grating
grateful: grateful
gratefully: gratefully
gratitude: gratitude
grave: grave,graver
gravely: gravely
gravid: gravid
gravity: gravity
greatness: greatness
greed: greed
greedily: greedily
greedy: greedy
greek: greek,greeks
green: green
greenish: greenish
greeting: greeting
gregory: gregory
grey: grey
greyhound: greyhounds
greyish: greyish
grim: grim
grimace: grimace
grimness: grimness
grimy: grimy
grind: grinding
grip: grip,gripped,gripping
groan: groaned
groom: grooms
grope: groped,groping
gross: gross
grossly: grossly
grotesque: grotesque
ground: ground
grow: grew,grow,growing,grown,grows
growl: growl
grown: grown
growth: growth
grub: grubbing
grudgingly: grudgingly
grunt: grunt,grunting
guard: guard
guess: guess,guessed
guest: guest,guests
guffaw: guffawing
guide: guided,guiding
guiltily: guiltily
guinea: guineas
guise: guise
guitar: guitars
gulf: gulf
gurgle: gurgle
gush: gushes
gut: gut
gutter: guttered
habit: habit,habits
habitual: habitual
hackneyed: hackneyed
hag: hag
haggard: haggard
hail: hail
hair: hair
haired: haired
hall: hall
halls: halls
halt: halt,halted
ham: ham
hamadryad: hamadryad
hammer: hammer
hamper: hamper
hampshire: hampshire
hand: hand,handed,hands
handbook: handbooks
handful: handful,handfuls
handkerchief: handkerchief
handle: handle
handsome: handsome,handsomest
handsomely: handsomely
hang: hang,hung
hanker: hanker
haphazard: haphazard
happen: happen,happened,happening
happily: happily
happiness: happiness
happy: happier,happy
hard: hard
hare: hares
harmless: harmless
harmonious: harmonious
harmoniously: harmoniously
harmoniousness: harmoniousness
harmony: harmonies,harmony
harness: harness
harpsichord: harpsichord
harrow: harrow
harry: harry
harsh: harsh
hart: hart
harvest: harvest,harvests
haste: haste
hasten: hastened
hastily: hastily
hat: hat,hats
hate: hated
hatful: hatfuls
hatred: hatred
haul: hauled
haunt: haunted,haunts
havelock: havelock
hazard: hazard,hazarded
hazel: hazel
head: head,headed,heads
headlong: headlong
health: health
healthful: healthful
healthy: healthy
heap: heaped,heaping
hear: hear,heard,hearing
hearer: hearers
hearing: hearing
hearse: hearse
heart: heart,hearts
hearted: hearted
hearth: hearth
heartily: heartily
heat: heat
heathen: heathen
heaven: heaven,heavens
heavily: heavily
heavy: heavier,heavy
hedge: hedge,hedged,hedges
heel: heels
height: height
heirloom: heirlooms
helen: helen
helpless: helpless
hen: hen
henna: henna
henry: henry
hercules: hercules
herd: herd,herds
hereditary: hereditary
heredity: heredity
hero: hero,heroes
heroes: heroes
heroic: heroic
heroically: heroically
heroism: heroism,heroisms
hesitate: hesitated
hesitatingly: hesitatingly
hew: hewed
hiccough: hiccoughed
hide: hidden
hideous: hideous
highly: highly
highway: highway
hill: hill,hills
hinge: hinges
hint: hint
hinterland: hinterland
hip: hip,hips
hiss: hissing
hissingly: hissingly
historic: historic
historically: historically
history: histories,history
histrionic: histrionic
hit: hit
hitherto: hitherto
hoarse: hoarse
hock: hock
hoist: hoist,hoisted
hold: held,hold,holding
holder: holder
hole: hole,holes
holiday: holiday,holidays
holidays: holidays
holiness: holiness
hollow: hollowed,hollows
holy: holy
homer: homer
homeric: homeric
homo: homo
honest: honest
honestly: honestly
honour: honour,honoured
honourable: honourable
hoof: hoof,hoofs
hootingly: hootingly
hope: hope,hoped,hopes,hoping
hopeful: hopeful
hopeless: hopeless
hopelessly: hopelessly
horde: horde
horizontal: horizontal
horn: horn,horns
horoscope: horoscope,horoscopes
horrible: horrible
horribly: horribly
horrify: horrified
horrifying: horrifying
horror: horror,horrors
horse: horse,horses
horseman: horsemen
hospitably: hospitably
hospital: hospital
hospitality: hospitality
host: host
hostess: hostess
hostile: hostile
hot: hot
hotel: hotel
hotly: hotly
hour: hour,hours
house: house,houses
household: household
housemaid: housemaids
hovel: hovel,hovels
howl: howled
hue: hue,hues
huge: huge
hugely: hugely
hullo: hullo
hum: hum,humming
human: human
humanity: humanity
humankind: humankind
humble: humble
humiliate: humiliated
humiliating: humiliating
humiliation: humiliation
humour: humour
hump: hump
hunchbacked: hunchbacked
hundredth: hundredth
hunger: hunger
hungrily: hungrily
hungry: hungry
hunt: hunt,hunted
hunting: hunting
hurriedly: hurriedly
hurry: hurried
hurt: hurt
husband: husband,husbands
huskily: huskily
husky: husky
hut: hut
hydrogen: hydrogen
hypnotise: hypnotise,hypnotised
icily: icily
idea: idea,ideas
ideal: ideal
identical: identical
identification: identification
identify: identified,identify
idiot: idiots
idiotic: idiotic
idle: idle,idlest
idly: idly
ignorance: ignorance
ignorant: ignorant
ignore: ignore
iii: iii
ilex: ilex
illuminate: illuminated,illuminating
illumination: illumination
illusory: illusory
illustrate: illustrate
illustration: illustration,illustrations
image: image
imaginary: imaginary
imagination: imagination
imaginatively: imaginatively
imagine: imagine,imagined
imbecile: imbecile,imbeciles
imbecility: imbecility
imitation: imitation,imitations
imitations: imitations
immemorial: immemorial
immense: immense
immensely: immensely
immortality: immortality
impart: impart
impassive: impassive
impatience: impatience
impatient: impatient
impatiently: impatiently
impeachment: impeachment
impenetrable: impenetrable
imperative: imperative,imperatives
imperceptibly: imperceptibly
imperfection: imperfections
impersonal: impersonal
impinge: impinging
impious: impious
implacably: implacably
implore: implored
imploringly: imploringly
imply: implied
importunate: importunate
impose: imposed,imposes,imposing
impossible: impossible
impotent: impotent
impregnate: impregnated
impress: impress
impressed: impressed
impression: impression
imprint: imprints
imprison: imprison
improbable: improbable
improvise: improvise,improvised
inaccurate: inaccurate
inadequate: inadequate
inanity: inanity
inappropriate: inappropriate
inaudible: inaudible
inauguration: inauguration
incense: incense
incessant: incessant
incessantly: incessantly
inch: inch,inches
incident: incident
incidental: incidental
inclined: inclined
include: include,included,includes,including
including: including
income: income,incomes
incompatible: incompatible
incomplete: incomplete
incomprehensible: incomprehensible
inconceivable: inconceivable
inconceivably: inconceivably
inconsiderate: inconsiderate
increase: increase,increased,increasing
increasingly: increasingly
incredible: incredible
incredulous: incredulous
incredulously: incredulously
incubator: incubators
indecency: indecency
indefinite: indefinite
indemnify: indemnify
indemnity: indemnity
independent: independent
india: india
indian: indian
indiana: indiana
indifferent: indifferent
indigenous: indigenous
indignant: indignant
indignantly: indignantly
indignation: indignation
indignity: indignities
indirect: indirect
indirectly: indirectly
indiscretion: indiscretion
indistinguishable: indistinguishable
individual: individual,individuals
indolent: indolent
indolently: indolently
indrawn: indrawn
induce: induce
indulge: indulge
indulgence: indulgence
indulgently: indulgently
industriously: industriously
industry: industry
inebriate: inebriate
ineffaceable: ineffaceable
ineradicable: ineradicable
inert: inert
inevitable: inevitable
inevitably: inevitably
inexhaustible: inexhaustible
inexorable: inexorable
inexperienced: inexperienced
inexpressible: inexpressible
infallibly: infallibly
infancy: infancy
infant: infant
infectious: infectious
infidelity: infidelity
infinite: infinite
infinity: infinity
inflict: inflict
influence: influence,influences
inform: inform,informed,informs
infringement: infringement
infuriatingly: infuriatingly
ingenious: ingenious
ingeniously: ingeniously
ingenuity: ingenuity
ingenuous: ingenuous
inglorious: inglorious
inhabitant: inhabitants
inherit: inherited
inheritance: inheritance
inhumanly: inhumanly
initial: initials
injunction: injunction
injustice: injustices
ink: ink
inlay: inlaid
inmate: inmates
innocence: innocence
innocent: innocent
innocently: innocently
inquire: inquired,inquiring
inquiry: inquiries
inquisition: inquisition
insane: insane
insanely: insanely
insanity: insanities,insanity
insecurely: insecurely
insensibly: insensibly
insignificant: insignificant
insipid: insipid
insist: insist,insisted
insistence: insistence
insistent: insistent
insistently: insistently
inspection: inspection
inspiration: inspiration
inspire: inspire,inspired,inspiring
instant: instant
instinct: instincts
instinctive: instinctive
instinctively: instinctively
institution: institution,institutions
instrument: instrument,instruments
insufferable: insufferable
insult: insulted
intact: intact
intellect: intellect
intellectual: intellectual,intellectuals
intelligence: intelligence,intelligences
intelligences: intelligences
intelligent: intelligent
intelligently: intelligently
intend: intending
intense: intense
intensify: intensified
intent: intents
intention: intention
intently: intently
interior: interior,interiors
interlaced: interlaced
interlocutor: interlocutor
internal: internal
international: international
interposition: interposition
interpret: interpreted
interrupt: interrupted,interrupting
interrupted: interrupted
interruption: interruption
intimate: intimate,intimates
intolerable: intolerable
intolerably: intolerably
intoxicate: intoxicate,intoxicated
intoxication: intoxication
intricate: intricate
intrigue: intrigues
introduce: introduced
introduction: introduction
intruder: intruder
intrusion: intrusion
intuition: intuition
invade: invade
invalidity: invalidity
invariable: invariable
invent: invent,invented
inverted: inverted
invest: invested
invincible: invincible
invisible: invisible
invitation: invitation
invite: invite,invited,invites,inviting
involuntary: involuntary
involve: involved,involving
inwardly: inwardly
ireland: ireland
iron: iron
ironic: ironic
irradiation: irradiation
irrational: irrational
irregularity: irregularities
irrelevant: irrelevant
irreparably: irreparably
irrepressible: irrepressible
irresistible: irresistible
irresolute: irresolute
irresponsibly: irresponsibly
irritated: irritated
irritation: irritation
irs: irs
island: island
issue: issued,issues,issuing
italian: italian,italians
italy: italy
item: item
iv: iv
ivory: ivory
ix: ix
jabbed: jabbed
jack: jack
jacket: jacket,jackets
jangled: jangled
january: january
japan: japan
jaw: jaws
jealous: jealous
jealousy: jealousy
jean: jean
jelly: jelly
jenny: jenny
jerk: jerked,jerks
jerusalem: jerusalem
jesuitical: jesuitical
jesuitry: jesuitry
jesus: jesus
jet: jets
jig: jig,jigged
jinks: jinks
joanna: joanna
job: job,jobs
jockey: jockey
john: john
johnson: johnson
joke: joke
jollity: jollities
jolly: jolly
jolt: jolt
jostle: jostled
jour: jour
journalist: journalist,journalists
journey: journey
jovial: jovial
jovially: jovially
joy: joy
joyfully: joyfully
joyous: joyous
judge: judge,judged,judges
judgment: judgment
julius: julius
july: july
jumbo: jumbo
jump: jump,jumped,jumping
jupiter: jupiter
justice: justice
justifiable: justifiable
justification: justification
justify: justifies,justifying
justly: justly
keg: keg
key: key
keyhole: keyhole
khaki: khaki
kick: kicking
kill: kill
kindle: kindled
kindly: kindly
kindness: kindness
king: king,kings
kingdom: kingdom
kiss: kiss,kissed,kisses,kissing
kitchen: kitchen
kitten: kittens
kittenishness: kittenishness
knee: knee,knees
knife: knife
knight: knight
knock: knocked,knocks
knop: knops
knot: knot
knowledge: knowledge
knuckle: knuckles
label: label,labelled
laboriously: laboriously
labour: labour
labourer: labourers
labyrinth: labyrinth
lace: lace
lack: lack,lacked,lacking
laconism: laconism
ladder: ladder,ladders
ladies: ladies
lady: ladies,lady
lake: lake
lamb: lamb,lambs
lambert: lambert
lambs: lambs
lamp: lamp,lamps
lamplight: lamplight
land: land,landed
landmark: landmarks
landscape: landscape
language: language
languid: languid
languidly: languidly
languor: languor
lantern: lantern
lap: lap
lapith: lapith
larynx: larynx
lash: lashed
latch: latch
late: late
lateral: lateral
latin: latin
laud: laud
laugh: laugh,laughed,laughing,laughs
laughter: laughter
launch: launched
laurel: laurel
lavender: lavender
lavish: lavish
law: law,laws
lawn: lawn,lawns
lay: laid,lay,laying
lazy: lazy
le: le
lea: lea
lead: lead,leads,led
leaden: leaden
leaf: leaves
league: league
lean: leaned,leaning,leant
leaning: leaning
leap: leap,leaping
learn: learn,learnt
learning: learning
leather: leather
leave: leave,leaves,leaving,left
leaven: leavening
lecture: lecture
leda: leda
lee: lee
left: left
leg: leg,legs
legal: legal
legally: legally
legend: legend,legends
legged: legged
leipzig: leipzig
leisure: leisure,leisured
leisured: leisured
lemon: lemon
leo: leo
leonine: leonine
les: les
lesson: lesson,lessons
lethal: lethal
letter: letter,letters
level: level
lever: levers
levity: levity
lewdness: lewdness
lexicographical: lexicographical
liability: liability
liable: liable
liberty: liberty
libidinousness: libidinousness
library: library
license: license
licensed: licensed
lichenous: lichenous
lid: lid,lids
lie: lie,lies,lying
lieu: lieu
life: life,lives
lifelong: lifelong
lift: lifted,lifting
light: light,lighted,lighter,lights,lit
lightly: lightly
lightning: lightning
likeness: likeness
limb: limbs
limit: limited,limits
limitation: limitation,limitations
limited: limited
limp: limp
limply: limply
lines: lines
linger: linger,lingered,lingering
link: linked,links
lion: lion
lip: lip,lips
liquid: liquid
liquor: liquor
lisette: lisette
lisp: lisp
list: list
listen: listen,listened,listening
listless: listless
listlessness: listlessness
literary: literary
literate: literate
literature: literature
litter: litter
live: live,lived,lives,living
lively: liveliest,lively
livery: liveries,livery
living: living
lizard: lizard,lizards
loathing: loathing
local: local
locate: located
location: locations
lock: locked
locomotive: locomotive
locution: locutions
lofty: lofty
log: logs
logic: logic
logical: logical
logically: logically
loin: loin
lombard: lombard
london: london
lonely: lonelier,lonely
loom: loomed
loose: loose,loosed
loosely: loosely
loosen: loosened
lor: lor
lord: lord
lose: lose,losing,lost
loss: loss,losses
lot: lot,lots
lotus: lotus
lotuses: lotuses
louche: louche
loud: loud,louder,loudest
loudly: loudly
louis: louis
lounge: lounging
loutish: loutish
love: love,loved
lovely: lovely
lover: lover,lovers
lovingly: lovingly
lubber: lubber
luce: luce
lucina: lucina
lucius: lucius
luck: luck
luckily: luckily
luggage: luggage
lugubrious: lugubrious
lui: lui
lull: lull
luminous: luminous
luminously: luminously
luna: luna
lunch: lunch
luncheon: luncheon
lure: lures,luring
lurid: lurid
lurk: lurked
luscious: luscious
lust: lust
lusus: lusus
lute: lute
luther: luther
luxuriant: luxuriant
lying: lying
lyre: lyre
lyrical: lyrical
machine: machine,machines
machinery: machinery
mackintosh: mackintosh
mad: mad
madly: madly
madman: madman,madmen
madmen: madmen
madness: madness
magdalen: magdalen
magic: magic
magical: magical
magically: magically
magician: magicians
magisterial: magisterial
magisterially: magisterially
magistrate: magistrates
magnificent: magnificent
magnificently: magnificently
magnify: magnify
magnifying: magnifying
magnum: magnum
mahogany: mahogany
maid: maid,maids
maidenhead: maidenhead
maidish: maidish
main: main
maintain: maintaining
majority: majority
malady: malady
male: male
malice: malice
malicious: malicious
maliciously: maliciously
malthusian: malthusian
maltreat: maltreat
mamma: mamma
manage: managed
mane: mane
manfully: manfully
mangled: mangled
mangold: mangold
mania: mania
maniac: maniacs
maniacal: maniacal
manifest: manifested
manifestation: manifestation
mankind: mankind
manly: manly
manner: manner
manners: manners
manoeuvre: manoeuvre
manor: manor
mansion: mansion,mansions
mantelpiece: mantelpiece
manual: manual
map: maps
marble: marble,marbles
march: march
marginal: marginal
margot: margot
mariner: mariner
mark: mark,marked,marks
marquee: marquees
marriage: marriage
marriageable: marriageable
married: married
marry: married,marry
marsala: marsala
marseilles: marseilles
martyr: martyr
marvellous: marvellous
marvellously: marvellously
mary: mary
masculine: masculine
mask: mask,masks
masked: masked
mason: mason
mass: mass,masses
massive: massive
masted: masted
master: master,mastered,masters
masterful: masterful
masterpiece: masterpiece,masterpieces
masters: masters
mastiff: mastiff,mastiffs
match: match
material: material,materials
maternal: maternal
mathematical: mathematical
mathematics: mathematics
matter: matter,matters
matthew: matthew
mattress: mattress,mattresses
maul: mauled
mauve: mauve
maximum: maximum
meal: meal
meaning: meaning
meaningless: meaningless
meat: meat
mechanical: mechanical
mechanically: mechanically
mecum: mecum
medici: medici
meditate: meditated
meditation: meditation
meditative: meditative
meditatively: meditatively
medium: medium
meekly: meekly
meet: meet,met
meeting: meeting
melancholy: melancholy
mellow: mellow
melodramatically: melodramatically
melody: melodies,melody
melt: melting
membrane: membrane
memorable: memorable
memorial: memorial
memories: memories
memory: memories,memory
menace: menace,menaced
menacing: menacing
mental: mental
mentality: mentality
mentally: mentally
mention: mentioned
merchant: merchant
merciful: merciful
merciless: merciless
mere: mere,merest
meridian: meridian
meridional: meridional
merino: merino
merit: merit,merits
merry: merry
mesopotamia: mesopotamia
message: messages
metal: metal
metallic: metallic
metaphorically: metaphorically
meteor: meteor
meteorite: meteorite,meteorites
meteorology: meteorology
method: method,methods
methodically: methodically
meticulous: meticulous
meticulously: meticulously
metrical: metrical
metropolis: metropolis
mi: mi
michael: michael
middle: middle
midnight: midnight
midst: midst
mighty: mighty
mildew: mildew
mildly: mildly
mile: miles
miles: miles
military: military
milk: milk
millionaire: millionaire
milord: milord,milords
mimic: mimicked
mind: mind,minded,minds
minded: minded
mingle: mingle,mingled
minority: minority
minute: minute,minutes
miracle: miracle,miracles
miraculous: miraculous
mire: mire
mirror: mirror,mirrored,mirrors
misalliance: misalliances
miscellaneous: miscellaneous
mischief: mischief
miserable: miserable
miserably: miserably
misery: miseries,misery
misfortune: misfortune
mission: mission
missionary: missionary
mississippi: mississippi
mist: mists
mistake: mistake,mistaken,mistakes
mistaken: mistaken
mistress: mistress
mixed: mixed
mixture: mixture
mock: mock
mocker: mockers
mockery: mockery
mockingly: mockingly
model: model,modelled
modern: modern,moderns
modernisation: modernisation
modest: modest
modestly: modestly
modification: modification
modify: modified
moment: moment,moments
momentary: momentary
monastery: monasteries
monastic: monastic
monday: monday
money: money
monk: monks
mono: mono
monograph: monographs
monophysite: monophysite
monotonous: monotonous
monster: monsters
monstrous: monstrous
month: month,months
monument: monument,monuments
monumental: monumental
mood: mood,moods
moon: moon
moonbeam: moonbeams
moonlight: moonlight
moonlike: moonlike
moonlit: moonlit
morality: morality
morning: morning
moroseness: moroseness
morris: morris
morrow: morrow
morsel: morsel
mortal: mortals
mortice: morticing
mortify: mortifying
moscow: moscow
moses: moses
mote: motes
mother: mother,mothers
motion: motion
motionless: motionless
motor: motor
mould: moulded,moulding
moulded: moulded
moulder: mouldered
moult: moulted
mound: mound,mounds
mount: mount,mounted,mounting
mountain: mountain,mountains
mountainous: mountainous
mountebank: mountebank
mournful: mournful
mourning: mourning
moustache: moustaches
mouth: mouth,mouths
mouton: mouton
moutons: moutons
movement: movement,movements
mud: mud
muffled: muffled
muller: muller
mullion: mullion
multiplication: multiplication
multiply: multiply
multitude: multitude
mumble: mumbled
mumbling: mumbling
mummy: mummy
muniment: muniment
murder: murder,murdered
murmur: murmur,murmured,murmurs
muscle: muscle
muscular: muscular
mushroom: mushrooms
music: music
musical: musical
muslin: muslin,muslins
mute: mute
mutely: mutely
mutter: muttered
mutton: mutton
mysteries: mysteries
mysterious: mysterious
mysteriously: mysteriously
mystic: mystic,mystics
mystical: mystical
nail: nailed,nails
naive: naive
naked: naked
nameless: nameless
namesake: namesake
nape: nape
napoleon: napoleon
napoleonic: napoleonic
narrative: narrative
narrow: narrow,narrowed
nasty: nasty
nation: nation,nations
national: national
nationality: nationalities
native: native
natura: naturae
natural: natural
naturally: naturally
nature: nature
nautical: nautical
naval: naval
neapolitan: neapolitan
nearer: nearer
neat: neat
neatly: neatly
necessity: necessities
neck: neck,necks
necropolis: necropolis
needle: needle
negative: negative
negligence: negligence
negotiate: negotiating
neigh: neigh
neighbour: neighbouring
neighbourhood: neighbourhood
nelson: nelson
nervous: nervous
nervously: nervously
nestle: nestle
network: network
newly: newly
news: news
newsletter: newsletter
newspaper: newspapers
niagara: niagara
nibble: nibble
nice: nice
niece: niece
niggardly: niggardly
nigger: nigger
night: night,nights
nightingale: nightingale
nightly: nightly
nightmare: nightmare
nihil: nihil
nile: nile
nineteen: nineteen
nineteenth: nineteenth
nip: nip,nipped
nobility: nobility
noble: noble,nobler,noblest
nobleman: nobleman
nobly: nobly
nod: nod,nodded,nodding,nods
noire: noires
noise: noise,noises
noiselessly: noiselessly
noisy: noisy
nonproprietary: nonproprietary
nonsense: nonsense
noon: noon
norfolk: norfolk
normal: normal
norman: norman
north: north
nose: nose,noses
nosed: nosed
nostalgic: nostalgic
notable: notable
note: note,notes
notebook: notebook
notice: notice,noticed
notify: notifies
notion: notion,notions
nouvelle: nouvelle
novelist: novelist,novelists
november: november
nowadays: nowadays
nubile: nubile
nuisance: nuisance
numerous: numerous
nut: nuts
nymphomaniac: nymphomaniac
oak: oak
oaken: oaken
oasis: oases
obedience: obedience
obedient: obedient
obediently: obediently
obey: obey,obeyed,obeying
obituary: obituary
object: object,objects
objective: objective
oblong: oblong,oblongs
obscene: obscene
obscure: obscure
observe: observed
obsolete: obsolete
obstruction: obstructions
obverse: obverse
obviate: obviated
obvious: obvious
occasion: occasion,occasioned
occasional: occasional
occasionally: occasionally
occult: occult
occupant: occupants
occupation: occupation,occupations
occupy: occupied,occupy,occupying
occur: occur,occurred
occurrence: occurrence
octave: octave,octaves
october: october
octopus: octopus
oddity: oddity
oddly: oddly
ode: ode
odious: odious
offer: offer,offered,offers
office: office
official: official
officially: officially
oil: oil
oily: oily
olive: olive
olympian: olympian
omen: omen
omniscient: omniscient
oneself: oneself
online: online
onward: onward
ooh: ooh
ooze: oozed,oozing
oozily: oozily
op: op
opal: opal
opaque: opaque
openness: openness
opera: opera,operas
opinion: opinion,opinions
opium: opium
opportunity: opportunities,opportunity
opposed: opposed
oppressed: oppressed
oppressive: oppressive
oppressor: oppressors
optimism: optimism
optimistically: optimistically
opus: opus
oracle: oracle
oracular: oracular
orange: orange
ordinary: ordinary
organ: organ,organs
organise: organised,organising
organize: organized
oriental: oriental
orientally: orientally
orientation: orientations
origin: origin
original: original
originally: originally
originator: originator
orphan: orphan,orphans
ostler: ostlers
ottoman: ottoman
outburst: outburst
outcome: outcome
outdated: outdated
outdoor: outdoor
outer: outer
outfitters: outfitters
outgoing: outgoing
outhouse: outhouses
output: output
outrage: outraged
outskirts: outskirts
outstretched: outstretched
outwardly: outwardly
outwards: outwards
oval: oval
overcome: overcome
overjoyed: overjoyed
overmasteringly: overmasteringly
overtop: overtopping
overwhelm: overwhelmed
overwhelming: overwhelming
overwork: overwork,overworked
owe: owed
owl: owls
owner: owner
oxford: oxford
oyster: oysters
pace: pace,paced
pacific: pacific
pacing: pacing
pack: pack,packed
package: packages
packet: packet
pad: pad
padded: padded
paddle: paddled
pagan: pagan
pain: pain,pains
pained: pained
painful: painful
painfully: painfully
paint: paint,painted,painting
painter: painter
painting: painting,paintings
pair: pair
palace: palace
palais: palais
pale: pale,palest
palette: palette
pallor: pallor
palm: palm,palms
palpitate: palpitate,palpitating
pamphlet: pamphlet
panel: panel,panelled,panelling,panels
panelling: panelling
pang: pang
panic: panic
pant: panted
papal: papal
papally: papally
paper: paper,papers
paperwork: paperwork
papist: papist
parachute: parachute
paradise: paradise
paragraph: paragraph,paragraphs
parallel: parallel
paralyse: paralysing
parapet: parapet
parched: parched
parchment: parchment
parent: parents
parenthetically: parenthetically
parfum: parfum
paris: paris
parish: parish
parisian: parisian
park: park
partake: partaken
parterre: parterres
partial: partial
partly: partly
partner: partner
party: parties,party
pass: pass,passed,passes,passing
passably: passably
passage: passage
passenger: passengers
passion: passion,passions
passionate: passionate
passionately: passionately
passive: passive
passoverish: passoverish
pat: patted
patch: patch
patent: patent
paternal: paternal
path: path
pathetic: pathetic
pathos: pathos
patience: patience
patiently: patiently
patriarchal: patriarchal
patriot: patriot
patriotic: patriotic
patriotism: patriotism
patter: patter,pattered
pattern: patterned,patterns
pause: pause,paused
pavilion: pavilion
pay: paid,pay,paying
payment: payments
peace: peace
peach: peach,peaches
peacock: peacock
peaked: peaked
peal: peal
pearl: pearl,pearls
peasant: peasants
peasantry: peasantry
peculiar: peculiar
peculiarity: peculiarities,peculiarity
peculiarly: peculiarly
pedal: pedal
pedestal: pedestal
pedigree: pedigree
peep: peep,peeped
peer: peered,peers
peerage: peerage
pen: pen
pencil: pencil
pendulous: pendulous
penetrate: penetrating
penetratingly: penetratingly
peninsula: peninsula
pensive: pensive
pensively: pensively
people: peoples
peopled: peopled
perceive: perceived
perceptibly: perceptibly
perch: perched
percy: percy
perfect: perfect,perfected
perfectibility: perfectibility
perfection: perfection
perfectly: perfectly
perforce: perforce
perform: perform,performed,performing,performs
performance: performance,performances
performer: performer,performers
perfume: perfume
period: period,periods
periodic: periodic
periodically: periodically
peripatetic: peripatetic
perish: perished
permanence: permanence
permanent: permanent
permanently: permanently
permission: permission
permit: permit,permitted
perpendicular: perpendicular
perpendicularly: perpendicularly
perpetual: perpetual
perpetually: perpetually
persecute: persecute,persecuting
persecution: persecution
persevere: persevere
persist: persist,persisting
persistence: persistence
person: people,person,persons
personal: personal
personality: personalities,personality
personally: personally
perspiration: perspiration
persuade: persuading
persuasion: persuasion
perverse: perverse
perversely: perversely
pessimism: pessimism
pest: pest
pestilence: pestilences
petal: petals
petals: petals
peter: peter
petrified: petrified
pew: pew
phantasmagorical: phantasmagorical
phantom: phantom
pharos: pharos
phenomenon: phenomena,phenomenon
phillis: phillis
philosopher: philosophers
philosophic: philosophic
philosophical: philosophical
philosophy: philosophies,philosophy
phrase: phrase,phrases
physical: physical
physically: physically
physician: physicians
piano: piano
pianola: pianola
piccadilly: piccadilly
pick: pick,picked
pickle: pickled
picture: picture,pictured,pictures
picturesque: picturesque
piebald: piebald
piece: piece,pieces
pierce: piercing
piercingly: piercingly
piety: piety
pig: pig,pigs
piggery: piggery
pigmy: pigmy
pile: pile,piled
pillar: pillar,pillars
pillow: pillow,pillows
pin: pinned
pink: pink
pinnacle: pinnacle
pious: pious
pipe: pipe,pipes
pique: piqued
pistol: pistol
pit: pit,pits
pitch: pitch
pitiful: pitiful
pity: pity
piu: piu
placard: placard
placid: placid
placing: placing
plague: plague,plagues
plain: plain
plait: plaited
plan: plan,planned,planning
plane: plane,planes
plant: plant,planted
plate: plate,plates
platform: platform
platonic: platonic
play: play,played,playing,plays
player: players
pleasant: pleasant,pleasanter
pleasantly: pleasantly
pleased: pleased
pleasing: pleasing
pleasure: pleasure,pleasures
plentiful: plentiful
plenum: plenum
plod: plodded
plot: plot
pluck: plucked
plum: plum
plume: plumes
plump: plump
plunge: plunged
pocket: pocket,pockets
poem: poem,poems
poet: poet,poets
poetical: poetical
poetry: poetry
pointer: pointer
pointless: pointless
pole: poles
poles: poles
policeman: policeman
polished: polished
polite: polite
politely: politely
politeness: politeness
political: political
politics: politics
polynesia: polynesia
polynesian: polynesian
pompeii: pompeii
pond: pond
ponderous: ponderous
ponderously: ponderously
pony: ponies
pool: pool
poor: poor,poorer
pop: pop,popped
popery: popery
poplar: poplar
poppy: poppies
population: population
porcelain: porcelain
porch: porch
pore: pored
porridge: porridge
port: port
portentous: portentous
portentously: portentously
porter: porter
portfolio: portfolio
portland: portland
portrait: portrait,portraits
portugal: portugal
pose: pose
position: position
positively: positively
posse: posse
possess: possess,possessed,possesses,possessing
possession: possession
possessor: possessor
possibility: possibilities,possibility
post: post,posted,posts
postage: postage
postcard: postcard
posterior: posteriors
postpone: postponed
postscript: postscript
postulate: postulate
pot: pot
potential: potential
potentiality: potentialities
pounce: pounced
pound: pound,pounds
pour: pour,poured,pours
poverty: poverty
powder: powdered
powdery: powdery
power: power,powers
powerful: powerful
practical: practical
practically: practically
practice: practice
practise: practise,practised,practising
praise: praised
pray: pray
prayer: prayer
preach: preached,preaching
preacher: preachers
preaching: preaching
precarious: precarious
precariously: precariously
precede: preceded,preceding
precept: precepts
preceptor: preceptor
precious: precious
precipice: precipices
precipitately: precipitately
precipitous: precipitous
precipitously: precipitously
precise: precise
precisely: precisely
precision: precision
precursor: precursors
predict: predicted
prediction: prediction,predictions
preening: preening
prefer: prefer,preferred
preferable: preferable
pregnant: pregnant
prejudice: prejudices
preliminary: preliminary
prelude: prelude
premonitory: premonitory
preoccupation: preoccupations
preoccupy: preoccupied
preparatory: preparatory
prepare: prepare,prepared,preparing
prepared: prepared
preponderate: preponderate
preposterous: preposterous
prescription: prescriptions
presence: presence
presentiment: presentiment,presentiments
preserve: preserve,preserved
preside: presided
press: press,pressed
presume: presume,presumed
presumptuous: presumptuous
pretend: pretend,pretended,pretending
preternaturally: preternaturally
pretext: pretext
pretty: pretty
prevalence: prevalence
prevent: prevent,prevented
previous: previous
prey: prey
prick: pricks
pride: pride
primary: primary
prime: prime,primed
primitive: primitives
principal: principal
principle: principle,principles
print: print,printed,prints
printer: printer
printing: printing
priscilla: priscilla
prison: prison
privacy: privacy
private: private
privately: privately
privilege: privilege
privy: privies,privy
probe: probing
proceed: proceeded
proceeding: proceeding
proceeds: proceeds
process: process,processes
processing: processing
proclaim: proclaimed,proclaiming
prodigious: prodigious
produce: produce,produced,producing
product: product,products
production: production,productions
professional: professional
professor: professor
professors: professors
proffer: proffer,proffered
proficient: proficient
profile: profile
profit: profit,profited,profits
profound: profound,profounder,profoundest
profoundly: profoundly
progress: progress
prohibition: prohibition
project: project,projected,projecting,projects
prolonged: prolonged
promenade: promenade
prominence: prominence
prominently: prominently
promise: promise,promised
promising: promising
promote: promoting
promotion: promotion
promptitude: promptitude
pronged: pronged
pronounce: pronounce,pronounced,pronouncing
pronounced: pronounced
pronouncement: pronouncement
pronunciation: pronunciation
proof: proof
proofread: proofread
propagate: propagated
propagation: propagation
proper: proper
property: property
prophecy: prophecy
prophesy: prophesied
prophet: prophet
prophetic: prophetic
proportion: proportion,proportioned,proportions
proportionable: proportionable
proposal: proposal
propose: propose,proposed
proposition: proposition
proprietary: proprietary
prose: prose
prospect: prospect
prosperous: prosperous
prostrate: prostrate
protect: protect,protected
protection: protection
protective: protective
protector: protector
protest: protested
prove: prove,proved
provencal: provencal
proverbs: proverbs
provide: provide,providing
providence: providence
providentially: providentially
provision: provision,provisions
provoke: provoked,provoking
prudence: prudence
prudent: prudent
prussian: prussian
psychical: psychical
psychologist: psychologists
psychology: psychology
public: public
publicly: publicly
publish: publish,published
pucker: puckered,puckers
pudding: pudding,puddings
pudic: pudic
puff: puff
pug: pug,pugs
pull: pulled,pulling
pullulation: pullulation
pulpit: pulpit
pulse: pulse
pulsing: pulsing
pump: pump
punctilious: punctilious
punctuate: punctuated
puncture: punctured
punitive: punitive
purchase: purchase
pure: pure
purification: purification
puritan: puritan
puritans: puritans
purple: purple
purpose: purpose,purposes
pursue: pursued,pursuing
pursuit: pursuit
push: push,pushed
putrefy: putrefying
putti: putti
puzzle: puzzled
puzzled: puzzled
pyjama: pyjama
pyjamas: pyjamas
pyrotechnical: pyrotechnical
quack: quack,quacking
quacking: quacking
quaint: quaint
quaintness: quaintness
qualified: qualified
quality: qualities,quality
quantity: quantities
quarry: quarry
quart: quart
quarter: quarter,quarters
quarto: quarto
quatrain: quatrain
queen: queen
queenly: queenly
queer: queer
question: question,questioned,questions
questioning: questioning,questionings
questioningly: questioningly
queue: queue
quick: quick
quicken: quickened
quickness: quickness
quiescent: quiescent
quiet: quiet
quietist: quietist
quietly: quietly
quill: quill
quire: quire
quiver: quivered,quivering
quotation: quotation,quotations
quotations: quotations
quote: quoted,quoting
quotidian: quotidian
ra: ra
rabbit: rabbit,rabbits
rabelais: rabelais
race: race,races
racing: racing
rack: rack
radiate: radiated
radium: radium
radius: radius
rag: rags
rage: raging
ragtime: ragtime
raid: raids
rain: rain,rained
raise: raise,raised,raising
ram: rams
ramblingly: ramblingly
random: random
randomly: randomly
range: range,ranged
rapid: rapid
rapidity: rapidity
rapidly: rapidly
rapine: rapine
rapping: rapping
rare: rare,rarer
rarely: rarely
rat: rat,rats
rate: rate
ratiocination: ratiocination
rational: rational
ravage: ravaged
raven: raven,ravens
ravishingly: ravishingly
raw: raw
ray: rays
razor: razor
reach: reach,reached,reaching
react: react,reacting
reaction: reaction
read: read,reading,reads
readable: readable
reader: reader
reading: reading
readjust: readjusted
ready: ready
real: real
realisation: realisation
realise: realise,realising
realism: realism
realistic: realistic
reality: reality
realize: realized
reap: reaped,reaping
reappear: reappeared
rear: rear
reason: reason,reasons
reasonable: reasonable
reasonableness: reasonableness
reasoning: reasoning
reassure: reassured,reassuring
reassuringly: reassuringly
rebecca: rebecca
rebel: rebels
rebellion: rebellion
rebellious: rebellious
rebelliously: rebelliously
rebound: rebounded
rebuke: rebuke
recall: recalled
recede: receded,receding
receipt: receipt
receive: receive,received,receiving
receiving: receiving
receptive: receptive
recess: recess
reckon: reckon
recognisable: recognisable
recognise: recognise,recognised
recollect: recollecting
recommend: recommended
recompose: recompose
reconstruct: reconstruct,reconstructs
reconvert: reconvert
record: record,recorded,records
recover: recovered,recovering
recross: recrossing
rector: rector
rectory: rectory
recurrent: recurrent
red: red
reddish: reddish
redistribute: redistribute,redistributing
redistributing: redistributing
redistribution: redistribution
redskins: redskins
reduce: reduced
reduplicate: reduplicated
reel: reeling
refer: referred,refers
reference: references
refill: refilled
reflect: reflect,reflected,reflecting
reflectively: reflectively
reform: reform,reformed
reformation: reformation
refrain: refrain
refresh: refresh,refreshes,refreshing
refuge: refuge
refund: refund
refuse: refuse,refused
refuser: refuser
refute: refute
regain: regained
regard: regard,regarded
regency: regency
region: regions
register: registered
regret: regret
regular: regular
regularity: regularity
regularly: regularly
regulate: regulating
regurgitate: regurgitated
reign: reign,reigned
rein: rein
reject: rejected
rejoice: rejoicing
relate: relating
relation: relations
relationship: relationship
relative: relative
relax: relax,relaxed
release: release,released
relentless: relentless
reliable: reliable
relief: relief,reliefs
relieve: relieved
relieved: relieved
relight: relighted
religion: religion,religions
religious: religious
religiously: religiously
relishingly: relishingly
reluctantly: reluctantly
rely: rely
remain: remain,remained,remaining,remains
remains: remains
remark: remark,remarked,remarks
remarkable: remarkable
remarkably: remarkably
remedy: remedies
remember: remember,remembered,remembering
remind: reminds
reminder: reminder
remodel: remodelling
remote: remote
remoteness: remoteness
remoter: remoter
remove: remove,removed
rename: renamed
renew: renewed,renewing
renewal: renewal
renowned: renowned
repair: repaired
repeat: repeat,repeated,repeating
repel: repelled
repent: repent
repentance: repentance
repeopled: repeopled
replace: replace,replaced,replacing
replacement: replacement
replenish: replenish
repletion: repletion
replica: replica
reply: replied,reply,replying
report: report,reported,reports
repose: repose,reposed,reposing
represent: represent,represented
representation: representation,representations
representationalism: representationalism
representative: representative
repress: repress
repression: repressions
reproach: reproaches
reproduce: reproduce
repulsive: repulsive
request: request,requested
require: require,required,requires
requirement: requirements
resemble: resemble,resembled
resentment: resentment
reservation: reservation,reservations
reserve: reserve
reservoir: reservoir
resign: resign
resignation: resignation
resigned: resigned
resonance: resonance
resound: resounded
resourceful: resourceful
respect: respect
respectable: respectable
respective: respective
respects: respects
respond: respond,responded
response: response
responsibility: responsibility
responsible: responsible
rest: rest,rested,resting
restaurant: restaurant
restful: restful
restless: restless
restlessly: restlessly
restlessness: restlessness
restore: restored
restriction: restrictions
result: result
resume: resumed
retain: retain
retire: retire,retired
retort: retort,retorted
retreat: retreat,retreating
retrospective: retrospective
return: return,returned,returning,returns
reveal: revealed,revealing
revelation: revelation
revenge: revenge
revenue: revenue
revert: reverted
review: review
reviewer: reviewers
revile: reviled
revive: revived
revolt: revolting
revolting: revolting
revolution: revolution
reward: reward
rhapsody: rhapsody
rhetorical: rhetorical
rheumatical: rheumatical
rhubarb: rhubarb
rhyme: rhymed,rhymes
rhythm: rhythm
rhythmic: rhythmic
rhythmical: rhythmical
rib: ribs
ribbon: ribbons
rich: rich,richer
richly: richly
rickety: rickety
rid: rid
ride: ridden,riding,rode
rider: rider
ridge: ridge
ridiculous: ridiculous
riding: riding
rife: rife
righteous: righteous
righteousness: righteousness
rightly: rightly
rigid: rigid
rigidity: rigidity
rimmed: rimmed
ringlet: ringlets
ripe: ripe,ripest
ripen: ripen
ripeness: ripeness
ripple: rippled
rise: rise,risen,rising,rose
risk: risk,risks
rite: rite
rivalry: rivalries
river: river
rivet: riveted
road: road,roads
roar: roared
rob: robbing
robin: robin
robust: robuster
rock: rocks
rococo: rococo
roll: roll,rolling,rolls
roman: roman
romance: romance
romantic: romantic
rome: rome
roof: roof
rook: rook
root: roots
rope: rope,roped
rose: roses
rosemary: rosemary
rosette: rosette
rosily: rosily
rosy: rosy
rot: rot
rough: rough
roughly: roughly
roundabout: roundabout
roundness: roundness
rouse: roused
rout: routs
routine: routines
row: row,rows
rowing: rowing
rowley: rowley
royal: royal
royalty: royalties,royalty
rub: rubbed,rubbing
rubber: rubber
rubens: rubens
ruby: ruby
rude: rude
rudely: rudely
rudeness: rudeness
rue: rue
ruefully: ruefully
ruffian: ruffian
rugbeian: rugbeian
ruin: ruin,ruined
rule: rules
ruler: rulers
rum: rum
ruminate: ruminated
rumour: rumoured
runaway: runaway
rung: rungs
runt: runt
rural: rural
rush: rush,rushed,rushing
ruskinian: ruskinian
russia: russia
russian: russian
rustic: rustic
sack: sack
sacred: sacred
sacrifice: sacrifice
sad: sad,sadder
sadly: sadly
safe: safe,safer,safest
safely: safely
safety: safety
sag: sagged,sagging
sage: sage
sail: sailed,sails
sainte: sainte
sake: sake
sale: sale
sallies: sallies
salt: salt,salted
salute: salute
salver: salver
sand: sand
sane: sane
sanitary: sanitary
sanitation: sanitation
sanity: sanities,sanity
sap: sapped
sapiens: sapiens
sapling: sapling
sarcophagus: sarcophagus
satan: satan
satisfaction: satisfaction
satisfactory: satisfactory
satisfied: satisfied
satisfying: satisfying
saturday: saturday
saurian: saurian
savage: savage,savages
savagely: savagely
savagery: savagery
save: save
savour: savour,savoured
sawing: sawing
scale: scale
scaly: scaly
scandal: scandal
scarce: scarce
scarcely: scarcely
scarlet: scarlet
scatter: scattered
scene: scene,scenes
scent: scent,scented
sceptres: sceptres
scheme: scheme,schemes
scholarly: scholarly
school: school
schooling: schooling
science: science
scientific: scientific
scientifically: scientifically
scoop: scoop,scooped
scope: scope
scorn: scorn
scornfully: scornfully
scowl: scowled
scrabble: scrabbling
scrap: scrap
scrape: scraping
scratch: scratch,scratched,scratching
scream: scream,screamed,screams
screech: screeched
screen: screen
screw: screwed
scribble: scribbled,scribbling
sculpture: sculpture,sculptured,sculptures
sculptured: sculptured
scurf: scurf
scutcheon: scutcheon
scythe: scythe
sea: sea
seal: seal,sealed
search: search
season: season,seasons
seat: seat,seated,seats
seclusion: seclusion
secrecy: secrecy
secret: secret,secrets
secure: secure
sedan: sedan
seduction: seductions
seed: seed,seeds
seek: seek,seeking,seeks,sought
seemingly: seemingly
seethe: seethed
seething: seething
seicento: seicento
seize: seize,seized,seizing
seldom: seldom
select: select,selected
selection: selection
sell: sell,sold
semblance: semblance
send: send,sending,sends
seneca: seneca
sensation: sensation,sensations
sense: sense
senseless: senseless
sensibility: sensibility
sensitive: sensitive
sensual: sensual
sentence: sentence
sententiously: sententiously
sentiment: sentiments
separate: separate,separated
september: september
sepulchrally: sepulchrally
serbia: serbia
serene: serene
serenely: serenely
serenity: serenity
serf: serfs
series: series
seriousness: seriousness
sermon: sermon,sermons
servant: servant,servants
serve: served
service: service
set: set,sets,setting
setter: setters
setting: setting
settle: settle,settled,settling
seventeen: seventeen
seventeenth: seventeenth
seventh: seventh
sever: severed
severance: severance
severe: severe
severely: severely
severest: severest
sewage: sewage
sex: sex,sexes
sexual: sexual
sha: sha
shabby: shabby
shade: shade,shaded,shading
shadeless: shadeless
shadow: shadow,shadows
shadowy: shadowy
shady: shady
shaft: shaft,shafts
shake: shake,shaken,shaking,shook
shakespeare: shakespeare
shamble: shambled
shamblingly: shamblingly
shame: shame
shank: shanks
shape: shape,shaped,shapes
share: share,shared,sharing
sharp: sharp
sharply: sharply
shatter: shattered,shattering
shave: shaved
shaven: shaven
sheeny: sheeny
sheep: sheep
sheer: sheer
sheet: sheet,sheets
shelf: shelf,shelves
shelley: shelley
shelter: shelter
shelve: shelving
shepherd: shepherd
shetland: shetland,shetlands
shetlands: shetlands
shift: shift
shilling: shilling
shimmering: shimmering
shine: shining,shone
ship: ship,ships
shirt: shirt
shoe: shoes
shoot: shoot
short: short,shorter
shot: shot
shoulder: shoulder,shoulders
shout: shout,shouted,shouting,shouts
shower: shower
shrill: shrill
shrilly: shrilly
shrine: shrine
shrink: shrank,shrinking
shrug: shrug,shrugged
shudder: shudder
shuffle: shuffle,shuffled
shuffling: shuffling
shut: shut,shutting
shutter: shuttered
shy: shied,shies,shy
shyness: shyness
sibilant: sibilant
sick: sick
sideboard: sideboard
sideways: sideways
sienese: sienese
sigh: sigh,sighed
sight: sight,sights
sighted: sighted
sign: sign,signs
significance: significance
signify: signify
silence: silence,silences
silent: silent
silently: silently
silesia: silesia
silhouette: silhouette
silk: silk
silliness: silliness
silly: silly
silver: silver
silvery: silvery
simile: simile
simon: simon
simple: simple,simpler
simplicity: simplicity
simplification: simplification
simply: simply
simulate: simulating
simultaneous: simultaneous
sin: sin
sinful: sinful
sing: sang,sing,singing,sings,sung
singer: singers
singing: singing
single: single
sinister: sinister
sink: sank,sinking,sinks,sunk
sip: sips
siphon: siphon
sir: sir
sister: sisters
sit: sat,sit,sits,sitting
sitter: sitter
sitting: sitting
situation: situation
sixpence: sixpence
sixteen: sixteen
sixteenth: sixteenth
size: size,sizes
sketch: sketches,sketching
skin: skin
skip: skipped
skirmish: skirmish
skirt: skirt,skirts
skittle: skittles
skull: skull,skulls
sky: sky
slack: slack
slacken: slackened
slam: slammed
slant: slanting
slap: slap
slash: slashed
slaughter: slaughter
slave: slave
slaver: slaver
slavery: slavery
slay: slain
sleek: sleek
sleep: sleep,sleeping,sleeps,slept
sleeping: sleeping
sleepless: sleepless
sleepy: sleepy
sleeve: sleeve
slender: slender
slice: slice
slide: slid,slide
slight: slight,slightest
slighter: slighter
slim: slim
slink: slunk
slip: slipped,slips
slit: slit
slope: slope,sloped,slopes,sloping
slough: slough
slow: slow,slower
slowly: slowly
slumbering: slumbering
smack: smacks
smallness: smallness
smallpox: smallpox
smart: smart
smell: smell,smelling,smells,smelt
smile: smile,smiled,smiling
smite: smite,smote
smith: smith
smoke: smoke,smoked,smoking
smooth: smooth
smoulder: smouldering
smut: smut
snake: snakes
snap: snapped
sniff: sniffed
snort: snorting
snow: snow
snuff: snuffed
snug: snug
soar: soared
sob: sobbed
sober: sober,sobered
soberly: soberly
social: social
society: society
socket: socket,sockets
socrates: socrates
soda: soda
sodom: sodom
sofa: sofa
soft: soft
softly: softly
soil: soiled
solace: solace
sole: sole
solely: solely
solemn: solemn
solemnity: solemnity
solemnly: solemnly
solicit: solicit
solicitation: solicitation
solicitous: solicitous
solicitously: solicitously
solicitude: solicitude
solid: solid
solidarity: solidarity
solidity: solidity
solidly: solidly
solitariness: solitariness
solitary: solitary
solitude: solitude
solomon: solomon
solution: solution
sombre: sombre
somerset: somerset
somnambulist: somnambulist
son: son,sons
song: song,songs
sonorous: sonorous
soothe: soothing
soothingly: soothingly
sophisticated: sophisticated
sorceress: sorceress
sort: sort
soul: soul,souls
sound: sound,sounded,sounding,sounds
soundless: soundless
soup: soup
sour: sour
source: source
soutane: soutane
south: south
sow: sow
space: space
spacious: spacious
spain: spain
spaniel: spaniels
spanish: spanish
spare: spare,spared
spavin: spavin
speak: speak,speaking,spoke,spoken
special: special
species: species
specific: specific
specimen: specimen,specimens
spectacle: spectacle
spectacles: spectacles
spectator: spectators
speculation: speculations
speech: speech
speechless: speechless
speechlessly: speechlessly
speed: speed
spell: spell,spells
spellbound: spellbound
spelling: spelling
spend: spend,spending,spends,spent
spew: spews
sphere: sphere
spike: spikes
spiked: spiked
spill: spilt
spilt: spilt
spindly: spindly
spiral: spirals
spirit: spirit,spirits
spiritual: spiritual
spiritualism: spiritualism
spite: spite
splash: splash,splashing
splendid: splendid
splendidly: splendidly
spoil: spoils
spontaneous: spontaneous
spoonful: spoonful,spoonfuls
sport: sport,sported,sports
sporting: sporting
sportively: sportively
spotted: spotted
sprawl: sprawling
spread: spread,spreading
sprig: sprig
sprightly: sprightlier
spring: sprang,spring,sprung
sprout: sprouted
spurs: spurs
spurt: spurted
square: square
squeal: squeal,squealing
squeeze: squeezed,squeezing
squelch: squelch
squire: squire
squirt: squirting
stab: stabbed
stable: stable,stables
stack: stack
staff: staff
stage: stage,stages
stagger: staggered
staggering: staggering
stain: stained
stair: stair,stairs
staircase: staircase
stale: stale
stamp: stamped,stamping,stamps
stanch: stanches
stand: stand,standing,stood
standard: standard,standards
standardise: standardise
standstill: standstill
star: stars
stare: stared,staring
stark: stark
starry: starry
stars: stars
start: start,started,starting
startle: startled
startled: startled
startling: startling
startlingly: startlingly
stately: stately
statement: statements
statesman: statesman
station: station,stations
statue: statues
stature: stature
status: status
stay: stay,stayed,staying
steadily: steadily
steady: steady
steal: steals
stealth: stealth
steam: steam
steel: steel
steep: steep,steeper
steeply: steeply
stem: stem
stentorian: stentorian
step: step,stepped,stepping,steps
stephen: stephen
sterilise: sterilised
sterility: sterility
steward: steward
stick: stick,stuck
stile: stile
stillness: stillness
stimulus: stimulus
stink: stinking
stipple: stippled
stir: stir,stirred,stirring
stock: stock,stocked,stocks
stomach: stomach
stone: stone,stones
stones: stones
stool: stool
stoop: stooping
stopping: stopping
store: store,stored
storm: storm
story: story
stout: stout
straight: straight
straighten: straightened
strain: strained,strains
strange: strange
strangely: strangely
stranger: stranger
strangle: strangled
strawberry: strawberries
strawy: strawy
stray: stray
streak: streaked
stream: stream
street: streets
strength: strength
stretch: stretch,stretched,stretches,stretching
stretti: stretti
strict: strict
stride: strides,striding
strife: strife
strike: strike,struck
string: string
strip: strip
striped: striped
strive: striving
stroke: stroke
stroll: strolled
strong: strong,stronger
structure: structure
struggle: struggle,struggled,struggling
stubborn: stubborn
stubby: stubby
stud: stud
studiedly: studiedly
studio: studio
studious: studious
study: studies,study
stuff: stuff
stuffy: stuffy
stunt: stunt
stupid: stupid
stupidity: stupidity
sturdy: sturdy
sty: sty
stye: styes
style: style
subconscious: subconscious
subject: subject,subjects
subscribe: subscribe,subscribed
subterranean: subterranean
subtle: subtle
subtlety: subtlety
subtly: subtly
suburb: suburbs
succeed: succeed,succeeded
success: success,successes
successful: successful
succession: succession
successor: successors
succumb: succumbed
suck: sucking
sudden: sudden
suddenly: suddenly
sue: sue
suffer: suffer,suffered,suffering,suffers
sufferer: sufferer
suffering: suffering,sufferings
suffice: suffice,sufficed,suffices
sufficient: sufficient
suffocate: suffocating
suffuse: suffused
suggestibility: suggestibility
suggestion: suggestion,suggestions
suggestive: suggestive
suicide: suicide,suicides
suit: suit
suitable: suitable
suitably: suitably
suiting: suitings
sulla: sulla
sullenly: sullenly
sum: sum
summer: summer
summit: summit
summon: summon,summoned,summoning
sun: sun
sunday: sunday
sunflower: sunflowers
sung: sung
sunlight: sunlight
sunlit: sunlit
sunny: sunny
sunrise: sunrise
sunset: sunset
sunshade: sunshade
sunshine: sunshine
sunstroke: sunstroke
superbly: superbly
supererogatory: supererogatory
superficial: superficial
superfluous: superfluous
superhuman: superhuman
superior: superior
superiority: superiority
supper: supper
supple: supple
suppliant: suppliants
supplication: supplication
supply: supply
support: support,supported,supporting
suppose: suppose,supposed
supposition: suppositions
surely: surely
surface: surface
surmount: surmounted
surplice: surplice,surplices
surprise: surprise,surprised
surprised: surprised
surprising: surprising
surprisingly: surprisingly
surrey: surrey
surround: surrounded,surrounding
surroundings: surroundings
survey: surveyed
survive: survive,survived,surviving
susceptible: susceptible
suspend: suspended
suspicious: suspicious
suspiciously: suspiciously
sustain: sustaining
sustaining: sustaining
swallow: swallowed
swamp: swamp
swan: swan
swarm: swarmed
sway: swayed,swaying
swaying: swaying
sweep: swept
sweeping: sweeping
sweet: sweet
sweetly: sweetly
swell: swell,swelled,swelling
swift: swift
swim: swim,swimming
swimmer: swimmers
swimming: swimming
swine: swine
swing: swings,swung
swirl: swirling
swish: swish,swishing
swiss: swiss
switchbacks: switchbacks
swoon: swooned
sword: sword
syllabic: syllabic
syllable: syllables
symbol: symbol
symbolic: symbolic
symbolical: symbolical
symbolise: symbolised
sympathetic: sympathetic
sympathy: sympathy
symptom: symptom,symptoms
synonymous: synonymous
syphilis: syphilis
systematically: systematically
table: table,tables
tact: tact
tactful: tactful
tag: tags
tail: tail
tailor: tailored
tale: tale,tales
talent: talent
talk: talk,talked,talking
tall: tall,taller
tambourine: tambourine
tame: tame,tamed
tangible: tangible
tangled: tangled
tank: tank
tans: tans
tap: tap,tapped,taps
tapered: tapered
task: task
taste: taste,tastes
tasteful: tasteful
tastefully: tastefully
tat: tat,tats
taunt: taunts
tax: tax,taxes
te: te
tea: tea
teach: teach
teacher: teacher
teaching: teaching
team: teams
tear: tear,tears,tore
tearful: tearful
technical: technical
teddy: teddy
tedious: tedious
tediousness: tediousness
tedium: tedium
teem: teeming
telegram: telegram
telepathist: telepathist
tellus: tellus
temper: temper,tempered
temperament: temperament
temperamentally: temperamentally
temperance: temperance
temperate: temperate
temperature: temperature
temple: temple,temples
tempt: tempting
temptation: temptation
tenant: tenant
tend: tend
tendency: tendency
tender: tenderest
tendre: tendre
tenor: tenor
tension: tension
tent: tent,tents
tenuous: tenuous
tepid: tepid
tercentenary: tercentenary
term: term,terms
terrace: terrace
terrible: terrible
terribly: terribly
terrific: terrific
terrified: terrified
terrifying: terrifying
terrifyingly: terrifyingly
terror: terror,terrors
tertiary: tertiary
testify: testify
thankful: thankful
thankfulness: thankfulness
theatre: theatre
theatricals: theatricals
thee: thee
theological: theological
theoretical: theoretical
theory: theories,theory
thibet: thibet
thief: thief
thinker: thinker
thoroughgoing: thoroughgoing
thoughtful: thoughtful
thoughtfully: thoughtfully
thread: thread
threshold: threshold
thrift: thrift
thrilling: thrilling
thrive: thrived
throat: throat,throats
throb: throbbed
thrones: thrones
throng: thronged
throw: threw,throw,throwing,thrown,throws
thrust: thrust,thrusting
thumb: thumb
thump: thump,thumped,thumping
thunder: thunder
thunderstorm: thunderstorms
thursday: thursday
ti: ti
tiberius: tiberius
tic: tics
tickle: tickle
tie: tie,tied
tight: tight
tighten: tightened,tightening
tightly: tightly
tightrope: tightrope
tile: tiles
tilt: tilting
tilted: tilted
time: time,times
times: times
tinge: tinge,tinged
tinkle: tinkled
tinny: tinny
tiny: tiny
tiptoe: tiptoe,tiptoed
tired: tired
tireless: tireless
tirelessly: tirelessly
tiresome: tiresome
tit: tits
titanic: titanic
title: title,titles
toad: toads
toadstool: toadstools
toast: toast
tobacco: tobacco
toe: toes
toil: toiling
token: token
toledo: toledo
tolerate: tolerate,tolerated,tolerates
tom: tom
tomb: tomb
ton: tons
tone: tone,tones
tongue: tongue
tonic: tonic
tool: tool
tooth: teeth
toothy: toothy
topic: topics
topless: topless
topple: toppled
toque: toque
torch: torch
torment: torments
tormentor: tormentor
torrent: torrent
torso: torso
tortoise: tortoise
torture: torture,torturing
toss: tossed
total: total
totally: totally
touch: touch,touched,touching
touchstone: touchstone,touchstones
tour: tour,tours
tow: towing
tower: tower,towered,towering,towers
towering: towering
town: town
toy: toy,toyed
trace: trace,traces
tractate: tractates
trademark: trademark
tradition: tradition
traffic: traffic
tragedy: tragedies
trail: trailed,trailing
train: train,trained,trains
training: training
trait: trait
tramp: tramps
trample: trampled,trampling
trampling: trampling
trance: trance,tranced
transcendental: transcendental
transcendentalist: transcendentalist
transcribe: transcribe
transcription: transcription
transformation: transformation,transformations
transience: transience
translate: translated
transmit: transmitted
trap: trap
trapeze: trapeze
travel: travel,travelling
travelling: travelling
travels: travels
tray: tray
treacle: treacle
tread: tread,trod
treasure: treasured
treasured: treasured
treat: treated
treatment: treatment
tree: tree,trees
treeless: treeless
tremble: trembled,trembling
tremendous: tremendous
tremendously: tremendously
tremolo: tremolo
tremulous: tremulous
triangle: triangle
tricolour: tricolour
trifle: trifle
trio: trio
triumph: triumph
triumphant: triumphant
triumphantly: triumphantly
trod: trod
trompe: trompe
trop: trop
trophy: trophies,trophy
trot: trotted
trouble: trouble,troubled,troubles
troubled: troubled
trouser: trouser
trousers: trousers
true: true
trump: trump
trunk: trunk,trunks
trustful: trustful
truth: truth,truths
truthfully: truthfully
truthfulness: truthfulness
tu: tu
tubal: tubal
tube: tube,tubes
tubular: tubular
tudor: tudor
tuesday: tuesday
tug: tugged
tum: tum
tumbler: tumbler
tumultuous: tumultuous
tumultuously: tumultuously
tune: tune
tuneless: tuneless
tunic: tunic
tunnel: tunnel,tunnelled,tunnels
turbine: turbines
turf: turf
turk: turk
turkish: turkish
tuscan: tuscan
twelfth: twelfth
twentieth: twentieth
twiddly: twiddly
twin: twins
twine: twined
twinkle: twinkled
twinkling: twinkling
twist: twisted,twisting
twopence: twopence
type: type,types
typewriter: typewriter
typhoid: typhoid
tyranny: tyranny
tyrant: tyrant
ugliness: ugliness
ultimate: ultimate
unable: unable
unadulterated: unadulterated
unadventurous: unadventurous
unageing: unageing
unamenable: unamenable
unanswered: unanswered
unappeased: unappeased
unappetising: unappetising
unassailable: unassailable
unassisted: unassisted
unattached: unattached
unattainable: unattainable
unaware: unaware
unawares: unawares
unbelief: unbelief
unbeliever: unbelievers
unbent: unbent
unbiased: unbiased
unbroken: unbroken
uncelebrated: uncelebrated
uncertainty: uncertainty
unchanged: unchanged
unchanging: unchanging
unchristian: unchristian
uncle: uncle
unclean: unclean
uncomfortable: uncomfortable
uncomfortably: uncomfortably
uncomplaining: uncomplaining
unconscious: unconscious
unconsciously: unconsciously
uncontrollable: uncontrollable
uncritical: uncritical
unctuous: unctuous
underbred: underbred
undergraduate: undergraduate
understand: understand,understood
understanding: understanding
undertake: undertake
undesirable: undesirable
undoubtedly: undoubtedly
undressed: undressed
uneasily: uneasily
unenforceability: unenforceability
unequalled: unequalled
unevenly: unevenly
uneventful: uneventful
unexpected: unexpected
unexpectedly: unexpectedly
unexperienced: unexperienced
unexplored: unexplored
unfailing: unfailing
unfair: unfair
unfavourably: unfavourably
unfit: unfit
unflagging: unflagging
unforgettable: unforgettable
unforgivable: unforgivable
unfortunate: unfortunate
ungentlemanly: ungentlemanly
ungrammatical: ungrammatical
unhappy: unhappy
unhealthy: unhealthy
unheed: unheeding
unhesitatingly: unhesitatingly
unification: unification
uniform: uniform,uniforms
unillumined: unillumined
unintelligent: unintelligent
unintelligible: unintelligible
uninterested: uninterested
uninteresting: uninteresting
uninterrupted: uninterrupted
union: union
unison: unison
unite: united
united: united
universe: universe,universes
university: university
unjointed: unjointed
unkindness: unkindness
unknowable: unknowable
unknown: unknown
unlink: unlink
unmistakably: unmistakably
unmoving: unmoving
unnatural: unnatural
unobserved: unobserved
unobtrusive: unobtrusive
unobtrusively: unobtrusively
unopened: unopened
unostentatious: unostentatious
unpack: unpacked
unpeopled: unpeopled
unpleasant: unpleasant
unpractical: unpractical
unprejudiced: unprejudiced
unpretentious: unpretentious
unreadable: unreadable
unreasonably: unreasonably
unreliable: unreliable
unreligious: unreligious
unrighteous: unrighteous
unruffled: unruffled
unsatisfied: unsatisfied
unseal: unsealed
unseen: unseen
unsolicited: unsolicited
unspiritual: unspiritual
unsteadily: unsteadily
unsteadiness: unsteadiness
unsuccessful: unsuccessful
unsuggestible: unsuggestible
unsuitable: unsuitable
unsuspected: unsuspected
untempered: untempered
untidy: untidy
untimely: untimely
untoward: untoward
untrained: untrained
untrammelled: untrammelled
untrue: untrue
unusual: unusual
unwearied: unwearied
unwritten: unwritten
upbringing: upbringing
update: updated
upholster: upholstered
uplifting: uplifting
upper: upper
upright: upright
uproar: uproar
upset: upset
upsetting: upsetting
upside: upside
upstairs: upstairs
upturned: upturned
upward: upward
urban: urban
urgent: urgent
urn: urn
useless: useless
uselessness: uselessness
user: user
usual: usual
ut: ut
utmost: utmost
utter: utter,uttered,uttering
utterance: utterance
utterly: utterly
vacation: vacation
vacuum: vacuum
vade: vade
vague: vague
vaguely: vaguely
vail: vailed
vain: vain
vainly: vainly
valley: valley,valleys
valuable: valuable
van: van
vanilla: vanilla
vanish: vanished
vanity: vanity
vapours: vapours
variety: variety
varletry: varletry
varnish: varnished
varnished: varnished
vary: varied,vary
vast: vast,vaster
vault: vault
vaunted: vaunted
veal: veal
vein: veins
velvet: velvet
venerable: venerable
venerate: venerated
venery: venery
venetian: venetian
venice: venice
vent: vent
venture: venture,ventured
venus: venus
verbal: verbal
verge: verge
verse: verse,verses
verses: verses
versified: versified
version: version
vertical: vertical
vertu: vertu
vesperal: vesperal
vice: vice,vices
victim: victim
victor: victor
victory: victories,victory
vie: vied
view: view,viewed,viewing,views
vii: vii
viii: viii
vile: vile
villa: villa
village: village,villages
villager: villagers
vintage: vintage
viol: viol
violate: violates
violent: violent
violin: violin
virgin: virgin
virtue: virtues
virtuosi: virtuosi
virtuosity: virtuosity
virtuoso: virtuoso
virtuous: virtuous
virus: virus
vis: vis
visible: visible
visibly: visibly
vision: vision,visions
visit: visit
visitor: visitor,visitors
vital: vital
vitality: vitality
vitally: vitally
vitiate: vitiate
vivacious: vivacious
vivaciously: vivaciously
vivid: vivid
vivisector: vivisector
vocabulary: vocabulary
voice: voice
voiced: voiced
void: void
volage: volage
volley: volleys
volume: volume,volumes
volunteer: volunteer,volunteers
volupte: volupte
voluptuously: voluptuously
vortex: vortex
vox: vox
voyage: voyages
vulture: vultures
wage: wage,waging
waggon: waggons
waist: waist
waistcoat: waistcoat
wait: wait,waited,waiting
wake: wake,waking,woke,woken
walk: walk,walked,walking,walks
walking: walking
wall: wall,walls
walled: walled
wallflower: wallflower
wallow: wallowed,wallowing
walnut: walnut,walnuts
waltz: waltz
wander: wander,wandered,wandering
wanderings: wanderings
wane: waning
war: war,warring,wars
ward: ward
warm: warm,warmer,warming,warms
warmly: warmly
warmth: warmth
warning: warning
warranty: warranties,warranty
warrior: warriors
wash: wash
washstand: washstand
wasp: wasp
waste: waste,wasted,wasting
watch: watch,watched,watching
water: water,waters
waterloo: waterloo
watery: watery
wave: wave,waved,waving
waver: wavering
wavy: wavy
wax: wax
weak: weak
weakling: weakling
weakly: weakly
weakness: weaknesses
wealth: wealth
wear: wear,wearing,wears,wore,worn
wearied: wearied
wearily: wearily
weariness: weariness
wearisome: wearisome
weary: weary
weather: weather
weave: weave
wedding: wedding
weddings: weddings
wedge: wedged
week: week,weeks
weekly: weekly
weep: weep,wept
weigh: weigh,weighed,weighing
weight: weight,weighted,weights
weighty: weighty
west: west
western: western
wet: wet
whatsoever: whatsoever
wheat: wheat
wheel: wheels
wheeze: wheezed
whet: whetted
whetted: whetted
whip: whipped
whir: whir
whirl: whirled,whirling
whirlwind: whirlwind
whisker: whiskers
whisper: whisper,whispered,whispers
white: white
whiten: whitened,whitening
whiteness: whiteness
whites: whites
wholesome: wholesome
wholly: wholly
wicked: wicked
wickedness: wickedness
wicket: wicket,wickets
wide: wide,wider,widest
widespread: widespread
wield: wield
wife: wife
wig: wig
wild: wild
willed: willed
william: william
willingly: willingly
wimpled: wimpled
win: winning
wince: wince,winced
wind: wind,winding,wound
winded: winded
windless: windless
window: window,windows
windsor: windsor
wine: wine
wing: wing,wings
winner: winner
winter: winter
wipe: wipe
wiry: wiry
wisdom: wisdom
wise: wise,wiser,wisest
wit: wit
witch: witch
witlessly: witlessly
witness: witness,witnessed,witnesses
wizardry: wizardries
wizened: wizened
wobble: wobble
wobbly: wobbly
woe: woe
wolf: wolf
woman: woman,women
women: women
wonderful: wonderful
wonderfully: wonderfully
wood: wood,woods
wooden: wooden
wool: wool
woolly: woolly
word: word
worker: worker
workings: workings
workmanship: workmanship
worn: worn
worried: worried
worship: worship
worth: worth
wound: wounds
wounded: wounded
wrath: wrath
wreath: wreaths
wreathe: wreathed
wretched: wretched
wriggle: wriggled
wrinkle: wrinkled,wrinkles
wrist: wrist
write: write,writes,writing,written,wrote
writer: writer,writers
writhe: writhing
writing: writing
wrong: wrong
wrongly: wrongly
xi: xi
xii: xii
xiii: xiii
xiv: xiv
xix: xix
xvi: xvi
xvii: xvii
xviii: xviii
xx: xx
xxi: xxi
xxii: xxii
xxiii: xxiii
xxiv: xxiv
xxv: xxv
xxx: xxx
yard: yard,yards
yawn: yawning
yearly: yearly
yeast: yeast
yeastily: yeastily
yell: yelling
yellow: yellow
yellowness: yellowness
yew: yew,yews
yield: yield
youth: youth,youths
youthful: youthful
youthfully: youthfully
zenobia: zenobia
zulu: zulu
