abalone: abalone
abandon: abandon,abandoned,abandoning
abdomen: abdomen
abdominal: abdominals
abeyance: abeyance
abide: abide,abiding
ability: ability
ablaze: ablaze
aboard: aboard
abode: abode
abominable: abominable
aborigine: aborigines
abound: abounded
abraham: abraham
abrasion: abrasions
abreast: abreast
abridged: abridged
abruptly: abruptly
absence: absence
absent: absent
absolute: absolute
absolutely: absolutely
absolve: absolve
absorb: absorb,absorbed,absorbing,absorbs
absurd: absurd
abundance: abundance
abundant: abundant
abundantly: abundantly
abuse: abuse
academy: academy
accelerate: accelerate,accelerated
accent: accent,accented,accenting
accentuate: accentuated
accentuation: accentuation
accept: accept,accepted,accepting
acceptable: acceptable
acceptance: acceptance
access: access
accessory: accessories
accident: accident,accidents
accidental: accidental
accidentally: accidentally
acclaim: acclaimed
acclimatize: acclimatized
accommodation: accommodations
accompany: accompanied,accompany,accompanying
accomplice: accomplice,accomplices
accomplish: accomplish,accomplished
account: account,accounting
accumulation: accumulation
accuracy: accuracy
accurate: accurate
accurately: accurately
accursed: accursed
accuse: accused,accusing
accustom: accustomed
accustomed: accustomed
acephala: acephala
acetabuliferous: acetabuliferous
ache: ached
achieve: achieve,achieved
achievement: achievement,achievements
acquaintance: acquaintance
acquiesce: acquiesce
acquire: acquired,acquiring
acre: acres
acrobatic: acrobatic
acropolis: acropolis
acting: acting
actinidia: actinidia
action: action,actions
actium: actium
activate: activate,activated
active: active
activity: activities,activity
actual: actual
acute: acute
adapt: adapt
add: add,adding,adds
addicted: addicted
addition: addition
additional: additional
address: address,addressed,addressing
adelaide: adelaide
adelphi: adelphi
aden: aden
adequate: adequate
adequately: adequately
adhere: adhering
adjoin: adjoining,adjoins
adjust: adjust,adjusted,adjusting
administration: administration
admirable: admirable
admiral: admiral
admiralty: admiralty
admire: admire
admissible: admissible
admission: admission
admit: admit,admits,admitted,admitting
ado: ado
adopt: adopt,adopting
adoration: adoration
adorn: adorned,adorning
adornment: adornment
adriatic: adriatic
adroit: adroit
adult: adult,adults
advance: advance,advanced,advances,advancing
advanced: advanced
advantage: advantage
advantageous: advantageous
adventure: adventure,adventures
adventurer: adventurer
adversary: adversaries,adversary
advice: advice
advisable: advisable
advise: advise,advised
aerial: aerial
affability: affability
affable: affable
affair: affairs
affect: affect
affection: affection
affectionate: affectionate
afford: afford
affront: affront
afloat: afloat
afoot: afoot
aforesaid: aforesaid
afoul: afoul
afraid: afraid
africa: africa
aft: aft
afterdeck: afterdeck
aftermath: aftermath
afternoon: afternoon
aftershock: aftershocks
age: age
ageless: ageless
aggressive: aggressive
agile: agile
agility: agility
agitate: agitated
agitated: agitated
agitation: agitation
agonizing: agonizing
agree: agree,agreed
agreeable: agreeable
agreement: agreement,agreements
aground: aground
aha: aha
ahoy: ahoy
aid: aid
ailing: ailing
ailment: ailments
aim: aim,aimed,aiming
air: air
airship: airship
airtight: airtight
ajar: ajar
akin: akin
alacrity: alacrity
alarm: alarm,alarmed
alarmed: alarmed
alarming: alarming
albacore: albacore
albatross: albatross
albeit: albeit
album: albums
alcove: alcoves
alcyon: alcyon
alcyonaria: alcyonaria
alcyonarian: alcyonarian
alert: alert,alerted
aleutian: aleutian
alexandria: alexandria
alga: algae
algae: algae
algebraic: algebraic
algiers: algiers
alien: alien
alight: alighted
alive: alive
allan: allan
allege: alleged
alley: alley
alliance: alliance
alligator: alligators
allot: allotted
allowance: allowance
allude: allude
allure: allure,allured
alluring: alluring
allusion: allusion
ally: allied,allies,ally
almighty: almighty
almond: almond
aloe: aloes
aloft: aloft
alpenstock: alpenstock,alpenstocks
altar: altar
alter: altering
alteration: alteration
alternately: alternately
alternative: alternatives
altitude: altitude
altogether: altogether
amalgam: amalgam
amass: amass,amassed,amassing
amaze: amaze,amazed,amazes
amazed: amazed
amazement: amazement
amazing: amazing
amazingly: amazingly
amazon: amazon
amboina: amboina
amenable: amenable
america: america
american: american,americans
amethyst: amethysts
amidship: amidships
ammonia: ammonia
ammunition: ammunition
amorous: amorous
amphibian: amphibians
amphibious: amphibious
amphipod: amphipods
ample: ample
amplitude: amplitude
amply: amply
amulet: amulets
amuse: amused
anal: anal
analyst: analysts
analyze: analyzing
anatomically: anatomically
anatomist: anatomists
ancestor: ancestors
anchor: anchor,anchors
anchovy: anchovies
ancient: ancient,ancients
andaman: andaman
anderson: anderson
andes: andes
anecdote: anecdotes
anemone: anemone,anemones
aneurysm: aneurysms
anew: anew
angel: angel
angelfish: angelfish
anger: anger,angered
angle: angle,angles
angler: anglers
anglo: anglo
anguish: anguish
anguished: anguished
animal: animal,animals
animation: animation
anjou: anjou
annals: annals
annelid: annelid
annelida: annelida
annex: annex
announcement: announcement
annoyed: annoyed
annual: annual
annually: annually
anomaly: anomaly
anomura: anomura
answer: answer,answered,answering,answers
answerable: answerable
ant: ants
antarctic: antarctic
antenna: antenna,antennas
anthill: anthill
antic: antics
anticipate: anticipate,anticipated
anticipation: anticipation
antilles: antilles
antipodes: antipodes
antiquity: antiquity
antisocial: antisocial
antony: antony
anxiety: anxieties,anxiety
anxious: anxious
apace: apace
apartment: apartment
apathy: apathy
ape: apes
apiece: apiece
aplacental: aplacental
aplysia: aplysia
apod: apods
apoplexy: apoplexy
appal: appalled
apparent: apparent
apparition: apparition
appearance: appearance,appearances
appease: appeased
appendage: appendage,appendages
appetite: appetite,appetites
appetizer: appetizers
appetizing: appetizing
applaud: applauding
application: application
apply: applied,applies,apply
appoint: appointed
appreciably: appreciably
appreciation: appreciation
approach: approach,approached,approaches,approaching
approachable: approachable
appropriately: appropriately
approval: approval
approve: approved,approving
april: april
apt: apt
aptly: aptly
aquarium: aquarium
aquatic: aquatic
aqueduct: aqueduct
aqueous: aqueous
aquiver: aquiver
arab: arab,arabs
arabesque: arabesques
arabia: arabia
arabian: arabian
arabic: arabic
arachne: arachne
arbor: arbor,arbors
arc: arc
arch: arch,arched,arches,arching
archaeology: archaeology
archaeotherium: archaeotherium
archangel: archangel
archduke: archduke
arched: arched
archerfish: archerfish
archimedes: archimedes
arching: arching
archipelago: archipelago
architecture: architecture
arctic: arctic
arduous: arduous
argo: argo
argonaut: argonaut,argonauts
argonauts: argonauts
argue: argue,arguing
argument: argument,arguments
argus: argus
arid: arid
aristocrat: aristocrat,aristocrats
aristotle: aristotle
arithmetic: arithmetic
ark: ark
arm: arm,armed,arms
armadillo: armadillos
armed: armed
arming: arming
armistice: armistice
armor: armor,armored
armored: armored
army: armies,army
aroma: aroma
arouse: arouse,aroused,arousing
arrange: arrange,arranged
arrangement: arrangement,arrangements
array: arrayed
arrival: arrival
arrive: arrive,arrived,arrives,arriving
arrow: arrow,arrows
arsenal: arsenal,arsenals
art: art
artery: arteries,artery
arthur: arthur
artichoke: artichoke
article: article,articles
articulate: articulate,articulates,articulating
artifact: artifacts
artificial: artificial
artillery: artillery
artist: artist,artists
artistic: artistic
artocarpus: artocarpus
aru: aru
ascend: ascended,ascending
ash: ash
ashore: ashore
asia: asia
asian: asian
asiatic: asiatic
asleep: asleep
aspect: aspect,aspects
asphyxiate: asphyxiated
asphyxiation: asphyxiation
ass: ass
assai: assai
assailant: assailants
assault: assault,assaulted,assaults
assemble: assembled
assembly: assemblies,assembly
assert: assert
assess: assess,assessed
assessment: assessment
asset: assets
assign: assigned
assignment: assignment
assimilate: assimilate
assist: assist,assisted
assistance: assistance
assistant: assistant
association: association
assorted: assorted
assortment: assortment
assume: assume,assumed,assuming
assumption: assumption
assurance: assurance,assurances
assure: assured
assuredly: assuredly
aster: aster
astern: astern
astir: astir
astonish: astonish,astonished
astonished: astonished
astonishing: astonishing
astonishment: astonishment
astounding: astounding
astoundingly: astoundingly
astray: astray
astrolabe: astrolabe
astronomer: astronomer,astronomers
astronomical: astronomical
astronomy: astronomy
asturian: asturian
astute: astute
athens: athens
athletic: athletic
atlanta: atlanta
atlantean: atlantean
atlantic: atlantic
atlantis: atlantis
atlas: atlas
atmosphere: atmosphere,atmospheres
atmospheric: atmospheric
atoll: atolls
atom: atom,atoms
atop: atop
atrocious: atrocious
attach: attach,attached,attaches
attack: attack,attacked,attacking,attacks
attain: attain,attained,attaining
attempt: attempt,attempts
attend: attend,attending
attention: attention,attentions
attentive: attentive
attest: attested,attesting
attitude: attitude,attitudes
attract: attract,attracted,attracting
attraction: attraction
attribute: attribute
audible: audible
audient: audient
auger: auger
august: august
augustus: augustus
auk: auk,auks
aura: aura
aures: aures
auricula: auricula
aurora: aurora
auspices: auspices
austere: austere
australia: australia
austria: austria
austrian: austrian
authentic: authentic
author: author,authors
authoritative: authoritative
authority: authority
authorize: authorize,authorized
automate: automated
automatically: automatically
autumn: autumn
avail: avail
avalanche: avalanche
avarice: avarice
avenge: avenge
avenger: avenger
avenue: avenue
average: average
avoid: avoid,avoided,avoiding,avoids
avowed: avowed
awake: awake,awoke
awaken: awaken,awakened
aware: aware
awash: awash
awful: awful
awhile: awhile
awkward: awkward
awl: awl
ax: ax
axis: axes
aye: aye
azores: azores
azure: azure
bab: bab
babble: babble,babbling
babirusa: babirusa
baby: baby
bachelor: bachelor
backbone: backbone,backbones
backdrop: backdrops
background: background
backside: backside
bacon: bacon
bad: bad,worse,worst
badland: badlands
badly: badly
baffle: baffled
baffling: baffling
bag: bag,bagged
baggage: baggage
bah: bah
bahama: bahama
bahamas: bahamas
bail: bail
bailiwick: bailiwick
bait: bait
bake: baked
baker: baker
balaenoptera: balaenoptera
balance: balance
baleen: baleen
balistes: balistes
ball: ball
ballard: ballard
ballast: ballast
ballistics: ballistics
balloon: balloon
bamboo: bamboo
ban: banned
banality: banality
banana: banana,bananas
band: band,bands
bandage: bandages
banded: banded
bandit: bandits
bang: banged
banish: banished
bank: bank,banks
banker: bankers
banks: banks
banter: bantering
bantering: bantering
banyan: banyan
baptize: baptized
bar: bar,barred,bars
barbaric: barbaric
barbary: barbary
barbed: barbed
bare: bare,bared
barely: barely
bari: bari
bark: bark
barnacle: barnacles
barometer: barometer
barrel: barrel,barrels
barricade: barricades
barrier: barrier,barriers
basalt: basalt
basaltic: basaltic
base: base,based
basically: basically
basin: basin,basins
basis: bases,basis
bask: bask,basking
basket: basket,baskets
basques: basques
bass: bass
bastard: bastard
bat: bat,bats
batch: batch
batfish: batfish
bath: bath,bathed
bathroom: bathroom
batter: batter,battered
battering: battering
battery: batteries,battery
battle: battle,battled,battles
battlefield: battlefield
battlements: battlements
battleship: battleship
bay: bay
beach: beach,beaches
beached: beached
beacon: beacon
bead: beads
beady: beady
beak: beak,beaks
beam: beam,beams
bean: beans
bear: bear,bearing,bears,bore,born,borne
bearable: bearable
bearded: bearded
bearer: bearer
bearing: bearing,bearings
beast: beast,beasts
beat: beat,beating,beats
beautiful: beautiful
beauty: beauties,beauty
beckon: beckoned,beckoning
bed: bed,beds
bedizen: bedizened
bedouin: bedouins
bedrock: bedrock
bedside: bedside
bedstead: bedstead
bee: bees
beef: beef
beefsteak: beefsteak
beefwood: beefwood
beethoven: beethoven
befall: befell
befuddle: befuddled
beg: beg,begged,begging
beguile: beguile,beguiled
behalf: behalf
behave: behaved
behavior: behavior
behold: beheld,behold
belabor: belaboring
belch: belching
belief: belief,beliefs
believer: believer,believers
bell: bell,bells
belle: belle
belligerent: belligerent
bellow: bellowed,bellowing,bellows
belly: bellies,belly
belong: belong,belonged,belonging,belongs
beloved: beloved
belt: belt,belts
bench: bench
bend: bended,bending,bent
beneath: beneath
benefaction: benefaction
beneficial: beneficial
benefit: benefit,benefited
benevolence: benevolence
bengal: bengal
bent: bent
bering: bering
berlin: berlin
beroe: beroe
berry: berry
bertrand: bertrand
besiege: besieged
bestow: bestowed
bet: bet
betray: betrayed,betraying
beverage: beverage
bewhiskered: bewhiskered
bewilder: bewildered
bias: bias
bible: bible
biblical: biblical
biconvex: biconvex
bid: bid
biennium: biennium
bigeye: bigeye
bile: bile
billow: billow,billows
billowy: billowy
bimonthly: bimonthly
bind: bind,binding,binds,bound
biography: biography
biological: biological
biology: biology
biped: bipeds
bird: bird,birds
bishop: bishop,bishops
bit: bit,bits
bite: bite,bites,bitten
bitter: bitter
bituminous: bituminous
bivalve: bivalve,bivalves
bizarre: bizarre
black: black,blackest,blacks
blackish: blackish
bladder: bladder,bladders
blade: blade,blades
bladed: bladed
blame: blame
blanc: blanc
blanco: blanco
blast: blast,blasted,blasts
blaze: blaze,blazing
blemish: blemish
blenny: blennies
bless: blessed
blessed: blessed
blessing: blessing
blind: blind,blinded,blinding
blindfold: blindfolded
blindly: blindly
blink: blink
blister: blisters
blithely: blithely
blizzard: blizzard,blizzards
bloated: bloated
block: block,blocked,blocks
blockade: blockaded
blood: blood
blooded: blooded
bloodshed: bloodshed
bloodthirstily: bloodthirstily
bloodthirstiness: bloodthirstiness
bloom: bloom,bloomed,blooms
blossom: blossoming,blossoms
blossoming: blossoming
blotch: blotches
blow: blew,blow,blowing,blown,blows
blowfish: blowfish
blowhole: blowholes
blowing: blowing
blue: blue
bluish: bluish
blunder: blunder
blunderbuss: blunderbuss,blunderbusses
blunt: blunt,blunted
blur: blurred,blurs
blurred: blurred
blushing: blushing
boar: boar
board: board,boarded,boarding,boards
boarding: boarding
boast: boasted,boasting,boasts
boat: boat,boats
boatman: boatman
bobstay: bobstays
bode: boded,bodes
bodily: bodily
body: bodies,body
bohemia: bohemia
boil: boil,boiling
boiler: boiler,boilers
boilerplate: boilerplate
boiling: boiling
boisterous: boisterous
bold: bold,bolder,boldest
boldly: boldly
bolt: bolt,bolted,bolting,bolts
bolts: bolts
bombay: bombay
bon: bon
bond: bond
bone: bone,boned,bones
boneyard: boneyard
bonito: bonito
bony: bony
book: book,books
bookcase: bookcases
booming: booming
boot: boot,boots
border: bordered,bordering,borders
bore: bore,bored,bores
borealis: borealis
bored: bored
boredom: boredom
borer: borers
boring: borings
bos: bos
bosh: bosh
boston: boston
bosun: bosun
botanical: botanical
botanist: botanist
botany: botany
bother: bother,bothered,bothering
bottle: bottling
bough: boughs
bounce: bounced
bound: bounding,bounds
boundary: boundaries,boundary
boundless: boundless
bouquet: bouquets
bow: bow,bowed,bows
bowels: bowels
bowery: bowery
bowhead: bowhead
bowie: bowie
bowsprit: bowsprit
box: box,boxed
boxfish: boxfish
boy: boy,boys
brace: braces,bracing
bracelet: bracelet,bracelets
brachyura: brachyura
brain: brain,brains
branch: branch,branches
brandish: brandished,brandishing
brandy: brandy
brave: brave,braving
bravery: bravery
bravo: bravo
bray: brayed
braying: braying
brazen: brazen
brazenly: brazenly
brazier: brazier,braziers
brazil: brazil
breach: breach
bread: bread
breadfruit: breadfruit
breadth: breadth
break: break,breaking,broke,broken
breaker: breakers
breakfast: breakfast
breakup: breakup
bream: bream
breast: breast,breasts
breastplate: breastplate,breastplates
breath: breath,breaths
breathable: breathable
breathe: breathe,breathed,breathes,breathing
breather: breather
breathing: breathing
breech: breech
breed: breed
breeding: breeding
breeze: breeze,breezes
brest: brest
brethren: brethren
brick: brick,bricks
bright: bright,brighter,brightest
brightly: brightly
brightness: brightness
brill: brill
brilliance: brilliance
brilliant: brilliant
brimstone: brimstone
brine: brine
bring: bring,bringing,brings,brought
brisk: brisk
briskly: briskly
bristle: bristle,bristling
britain: britain
british: british
brittany: brittany
brittle: brittle
broad: broad
broadside: broadside
broadsword: broadswords
broadway: broadway
broken: broken
bromide: bromide
bronchial: bronchial
bronze: bronze
brood: broods
brooding: brooding
brook: brook
brooklyn: brooklyn
brother: brother
brow: brow,brows
brown: brown,browns
brownish: brownish
brush: brush,brushed
brutally: brutally
brute: brute
bubble: bubble,bubbling
buccaneer: buccaneers
bucket: buckets
buckle: buckling
bud: buds
budding: budding
buffalo: buffalo
buffet: buffeted
build: build,building,builds,built
builder: builder,builders
building: building,buildings
bulb: bulb
bulge: bulge,bulges,bulging
bulk: bulk
bulkhead: bulkhead,bulkheads
bulkiness: bulkiness
bulky: bulky
bull: bulls
bulldog: bulldog
bullet: bullet,bullets
bulletin: bulletin,bulletins
bullhead: bullhead,bullheads
bullheaded: bullheaded
bulwark: bulwarks
bump: bump,bumped,bumping,bumps
bunch: bunches
bundle: bundle
bunker: bunker,bunkers
bunsen: bunsen
bunt: bunting
bunting: bunting
buoy: buoy,buoyed,buoying
burden: burden,burdens
bureau: bureau
burin: burin
burley: burley
burn: burn,burned,burning
burrow: burrowing,burrows
burrower: burrowers
burst: burst,bursting
bury: buried,bury
bush: bush,bushes
bushy: bushy
business: business
bustard: bustards
bustle: bustling
busy: busiest,busy
butcher: butcher
butchery: butchery
butt: butt
butter: butter
butterfish: butterfish
butterfly: butterflies,butterfly
button: button
buzz: buzzing
bygone: bygone
byron: byron
cabbage: cabbages
cabin: cabin,cabins
cabinet: cabinet
cable: cable,cables
cabochon: cabochon
cackle: cackling
cactus: cactus
caesar: caesar
cage: cage
cake: cake,caked
calamity: calamity
calcium: calcium
calculate: calculate,calculated,calculating
calculation: calculation,calculations
calcutta: calcutta
caledonia: caledonia
calendar: calendar
calf: calf
california: california
caliph: caliph
calligraphy: calligraphy
callosity: callosities
calm: calm,calmed,calmer
calmness: calmness
camel: camels
camera: camera
camp: camp
campaign: campaign
camphor: camphor
campsite: campsite
canada: canada
canadian: canadian
canal: canal
canaries: canaries
canary: canary
cancel: canceled
cancer: cancer
candid: candid
candor: candor
canine: canine,canines
cannibal: cannibal,cannibals
cannibalism: cannibalism
cannon: cannon,cannons
cannonade: cannonade,cannonaded,cannonading
cannonball: cannonball
cannoneer: cannoneer
canoe: canoe,canoes
canopy: canopies
canted: canted
canvas: canvas,canvases
cap: cap,caps
capable: capable
capacity: capacity
cape: cape,capes
capital: capital
capricorn: capricorn
capsize: capsize
capstan: capstan
capsule: capsule,capsules
captain: captain,captains
captivate: captivated
captive: captive,captives
capture: capture,captured,captures,capturing
carapace: carapace,carapaces
carbon: carbon
carbonate: carbonate
carcass: carcass,carcasses
care: care,cared
career: career,careers
carefree: carefree
careful: careful
carefully: carefully
caress: caresses
cargo: cargo
caribbean: caribbean
carnivora: carnivora
carnivore: carnivore
carolina: carolina
carolinas: carolinas
carp: carp
carpet: carpet,carpeted,carpets
carpeting: carpeting
carriage: carriage,carriages
carrier: carrier,carriers
carry: carried,carries,carry,carrying
cartier: cartier
cartilage: cartilage
cartilaginous: cartilaginous
cartridge: cartridge
carve: carve,carved
cascade: cascades
casing: casing
cask: casks
caspian: caspian
cast: cast,casting
castaway: castaway,castaways
castilian: castilian
casualty: casualties,casualty
cat: cat
cataclysm: cataclysm,cataclysms
catalog: catalog,cataloged,catalogs
cataract: cataract
catastrophe: catastrophe,catastrophes
catatonic: catatonic
catch: catch,catches,catching,caught
catchphrase: catchphrase
cattle: cattle
caudal: caudal
caulerpa: caulerpa
caulk: caulked
causeway: causeway
caustic: caustic
caution: caution
cautious: cautious
cautiously: cautiously
cavalla: cavalla
cavalry: cavalry
cave: cave,caved,caves
cavern: cavern,caverns
cavity: cavities,cavity
cavort: cavorting
cease: ceased,ceases,ceasing
ceiling: ceiling
celebrate: celebrates,celebrating
celebrated: celebrated
cell: cell,cells
cellular: cellular
cement: cement,cemented
cemetery: cemetery
center: center,centered,centers
centigrade: centigrade
centimeter: centimeter,centimeters
central: central
century: centuries,century
cephalopod: cephalopod
cephalopoda: cephalopoda
cerebral: cerebral
ceremony: ceremonies
certainty: certainty
cervical: cervical
cetacea: cetacea
cetacean: cetacean,cetaceans
cetera: cetera
ceylon: ceylon
chaff: chaff
chafing: chafing
chagrin: chagrin
chain: chain,chained,chains
chalice: chalice,chalices
chalky: chalky
challenge: challenge
chamber: chamber
chamois: chamois
champ: champed
chance: chance,chanced,chances
chancy: chancy
chandelier: chandelier
change: change,changed,changing
channel: channel,channels
chanticleer: chanticleer
chaotic: chaotic
chapter: chapter
character: character,characters
characteristic: characteristic,characteristics
characterize: characterized
charcoal: charcoal
charge: charge,charged,charges,charging
chariot: chariot
charitable: charitable
charitably: charitably
charity: charity
charles: charles
charm: charm,charms
charming: charming
chart: chart,charts
charter: charter,chartered
chase: chase,chased,chasing
chasm: chasm,chasms
chassepot: chassepot
chat: chat,chatted,chatting
chateau: chateau
check: check,checked,checking,checks
cheek: cheek
cheer: cheered,cheers
cheerful: cheerful
cheese: cheese
chef: chef
chelonia: chelonia
chemical: chemical
chemist: chemist,chemists
cherish: cherished
chesapeake: chesapeake
chessboard: chessboard
chest: chest,chests
chestful: chestful
chestnut: chestnut
chew: chewed
chicken: chicken
chide: chided
chief: chief
chiefly: chiefly
chieftain: chieftains
child: child,children
chill: chill,chills
chime: chime
chin: chin
china: china
chinese: chinese
chip: chipped
chitchat: chitchat
chlorate: chlorate
chloride: chloride
choice: choice,choices
choir: choir
choke: choked,choking
choose: choose,chosen
chop: chop,chopped,chopping
chord: chord,chords
chore: chores
chorister: choristers
chorus: chorus
christen: christened
christian: christian
christmas: christmas
christopher: christopher
chronicle: chronicles
chronicler: chronicler
chronological: chronological
chronometer: chronometer,chronometers
chrysanthemum: chrysanthemums
chum: chums
chunk: chunk,chunks
church: church
churn: churned,churning
cicero: cicero
cigar: cigar,cigars
cinder: cinders
cinnabar: cinnabar
circle: circle,circled,circles,circling
circuit: circuit
circular: circular
circulate: circulating
circulation: circulation
circulatory: circulatory
circumference: circumference
circumnavigate: circumnavigate
circumpolar: circumpolar
circumstance: circumstance,circumstances
cirripedia: cirripedia
cirrus: cirrus
cite: cited
citizen: citizen,citizens
city: cities,city
civil: civil
civilian: civilians
civilization: civilization
civilized: civilized
claim: claim,claimed,claiming,claims
claire: claire
clam: clam,clams
clamor: clamor
clamped: clamped
clang: clang
clank: clanking
clap: clap,clapped,claps
clarity: clarity
clark: clark
clasp: clasp,clasping,clasps
class: class,classed,classes
classic: classic
classification: classification
classifier: classifier
classify: classified,classify,classifying
claw: clawed,claws
clean: clean,cleaned,cleaner
clearing: clearing
clench: clenched
cleopatra: cleopatra
clever: clever
cliff: cliff,cliffs
cliffside: cliffside
climate: climates
climax: climax
climb: climb,climbed,climbing
clime: clime,climes
cling: cling,clinging,clung
clip: clip
cloak: cloak,cloaked,cloaks
clock: clock,clocks
clogged: clogged
close: close,closed,closer,closes,closing
closed: closed
closely: closely
closing: closing
clot: clots
cloth: cloth
clothe: clad,clothe
clothes: clothes
clothing: clothing
cloud: cloud,clouds
clouds: clouds
cloudy: cloudy
clown: clowns
clue: clue
clump: clump,clumps
clumsily: clumsily
clumsy: clumsy
clung: clung
cluster: cluster,clustered,clusters
clutch: clutched,clutches,clutching
cluttered: cluttered
clyde: clyde
coach: coach
coal: coal,coals
coalfield: coalfield
coast: coast,coasted,coasts
coastal: coastal
coastline: coastline,coastlines
coat: coat,coated,coats
coax: coax
cobblestone: cobblestones
cockatoo: cockatoos
cocked: cocked
cockle: cockles
cockleboat: cockleboat
cockleshell: cockleshells
coconut: coconut,coconuts
coconuts: coconuts
cod: cod
codfish: codfish
coffee: coffee
coffer: coffers
coil: coil,coiling,coils
coin: coined
coincide: coincide
colander: colander
cold: cold,colder,colds
coldly: coldly
coldness: coldness
coles: coles
collapse: collapse,collapsed,collapses,collapsing
collar: collar,collars
collate: collated
colleague: colleagues
collect: collect,collected,collecting,collects
collection: collection,collections
collector: collector,collectors
collide: collide
collision: collision,collisions
colonial: colonial
colony: colony
color: color,colored,colors
coloration: coloration
colored: colored
colorful: colorful
coloring: coloring
colorless: colorless
colossal: colossal
columbus: columbus
column: column,columns
columnist: columnist
comb: comb
combination: combination
combine: combined
combustible: combustible
comet: comets
comfort: comfort,comforted,comforting
comfortable: comfortable
comfortably: comfortably
comical: comical
coming: coming,comings
command: command,commanded
commander: commander,commanders
comment: comment,commented,comments
commentary: commentary
commerce: commerce
commercial: commercial
commit: commit,commits,committed,committing
commodore: commodore
common: common
commonly: commonly
commonplace: commonplace
commotion: commotion
communal: communal
communicate: communicate
communication: communication
communicative: communicative
community: community
compact: compact
compagnie: compagnie
companion: companion,companions
companionway: companionway,companionways
company: companies,company
comparable: comparable
comparative: comparative
comparatively: comparatively
compare: compare,compared,comparing
comparison: comparison
compartment: compartment,compartments
compass: compass,compasses
compassion: compassion
compelled: compelled
compensate: compensated
compete: compete,competed,competing
competition: competition
complain: complain,complained,complaining
complaint: complaint,complaints
complement: complemented
complete: complete,completed,completing
completely: completely
completion: completion
complicated: complicated
complication: complication
complicity: complicity
compliment: compliment
comply: complied
component: component
compose: compose,composed
composer: composers
composition: composition
composure: composure
comprehensive: comprehensive
compress: compressed,compresses
compressed: compressed
comprise: comprises
compulsion: compulsion
compulsive: compulsive
compute: compute
comrade: comrade
comradeship: comradeship
conceal: conceal
concede: conceded
conceive: conceived
concentrate: concentrate,concentrated
concentric: concentric
concern: concern,concerned,concerns
concerned: concerned
concert: concerts
conch: conch,conchs
conchological: conchological
conchologist: conchologist
conchology: conchology
conclude: conclude,concluded
conclusion: conclusion
concoct: concocting
concretion: concretions
concussion: concussion
condense: condense,condensed,condensing
condition: condition,conditions
conduct: conduct,conducted,conducting,conducts
conductor: conductor
conduit: conduit
cone: cone
confer: confer,confers
confess: confess,confesses
confidence: confidence
confident: confident
confine: confine,confined
confinement: confinement
confirm: confirm
conflict: conflict
confound: confounded
confuse: confused,confuses,confusing
confused: confused
confusing: confusing
confusion: confusion
congeal: congeal,congealed
congealing: congealing
conger: conger
congested: congested
congo: congo
congregate: congregate
congress: congress
conical: conical
conjecture: conjecture
connect: connect,connected,connecting,connects
connection: connection
connoisseur: connoisseur
conquer: conquer,conquered
cons: cons
conscience: conscience
consciousness: consciousness
consent: consent
consequence: consequences
conserve: conserving
considerable: considerable
considerably: considerably
consideration: consideration,considerations
consign: consign,consigned
consist: consist,consisted,consisting,consists
consistency: consistency
consistent: consistent
conspicuous: conspicuous
constant: constant
constantly: constantly
constellation: constellations
constitute: constitute
constitution: constitution
constitutionalist: constitutionalist
constrain: constrained
construct: constructed
construction: construction
consult: consult,consulted,consulting
consulting: consulting
consume: consume,consumed,consumes,consuming
consummate: consummate
consumption: consumption
contact: contact
container: containers
contemplate: contemplate,contemplated,contemplating
contemplation: contemplation
contemporary: contemporaries,contemporary
contempt: contempt
contend: contend
content: content
contentment: contentment
contents: contents
contest: contest,contests
context: context
continent: continent,continents
continental: continental
continual: continual
continually: continually
continue: continue,continued,continues,continuing
continuity: continuity
continuous: continuous
continuously: continuously
contour: contours
contoured: contoured
contract: contract,contracted,contracting
contracting: contracting
contradict: contradicted,contradicting
contradiction: contradiction,contradictions
contradictory: contradictory
contraption: contraption
contrary: contrary
contrast: contrast,contrasted,contrasting,contrasts
contrivance: contrivance
contrived: contrived
control: control,controlled
contusion: contusion
convalesce: convalescing
convenient: convenient
conveniently: conveniently
conventional: conventional
converge: converged,converging
conversation: conversation
converse: conversed,conversing
conversely: conversely
convey: convey,conveyed
conviction: conviction
convince: convinced
convinced: convinced
convoy: convoy
convulsion: convulsion,convulsions
convulsive: convulsive
convulsively: convulsively
cook: cook,cooked,cooking
cooking: cooking
cool: cool,cooling
cooling: cooling
coolly: coolly
coolness: coolness
coop: cooped
cope: cope
copenhagen: copenhagen
copper: copper
copyright: copyright
coquina: coquina
coral: coral
corallina: corallina
cordial: cordial
cordially: cordially
core: core
cork: cork
corner: corner,corners
coromandel: coromandel
corpse: corpse,corpses
corpus: corpus
correct: correct,corrected
correctly: correctly
correspond: corresponds
corrode: corroded
corrosive: corrosive
corset: corseted
cortez: cortez
cosmos: cosmos
cost: cost,costing,costs
costume: costume,costumes
cotton: cotton
couch: couch,couched,couches
cough: cough
counsel: counsel
count: count,counted,counting
counter: counter
counteract: counteract
countercurrent: countercurrent
counterfeit: counterfeit
countless: countless
country: countries,country
countryman: countryman,countrymen
countryside: countryside
couple: couple
courage: courage
courageously: courageously
court: courting,courts
courteously: courteously
courtesy: courtesy
courtier: courtiers
cousin: cousins
cover: cover,covered,covering,covers
covered: covered
covering: covering
covey: covey
cow: cow,cows
cowardly: cowardly
cowl: cowls
cowrie: cowries
cowry: cowry
coxswain: coxswain
crab: crab,crabs
crack: cracked,cracking
crackle: crackle,crackling
crackling: crackling,cracklings
craft: craft
crafty: crafty
crag: crag,crags
craggy: craggy
cram: crammed
cramp: cramps
cramped: cramped
cranium: cranium,craniums
crash: crashed,crashes,crashing
crater: crater,craters
crave: craves
craving: craving
crawl: crawling
crayfish: crayfish
craze: crazed
cream: cream
crease: creases,creasing
create: create,created,creates,creating
creation: creation,creations
creative: creative
creator: creator
creature: creature,creatures
credence: credence
credibility: credibility
credit: credit,credited
credulity: credulity
creep: crept
creeper: creepers
crescent: crescent,crescents
crest: cresting,crests
cretan: cretan
crete: crete
crevasse: crevasse
crevice: crevice,crevices
crew: crew,crews
crewman: crewman,crewmen
crimson: crimson
crinoid: crinoids
crisis: crises
crisscross: crisscrossed
crisscrossed: crisscrossed
criticism: criticism
croaker: croakers
crocodile: crocodiles
crop: cropped
cross: cross,crossed,crosses,crossing
crossing: crossing,crossings
crosstree: crosstrees
crosswise: crosswise
crouch: crouch,crouching
crowd: crowd,crowded,crowding,crowds
crown: crown,crowned,crowns
crowning: crowning
crude: crude
cruel: cruel
cruelty: cruelty
cruise: cruise,cruised,cruising
crumb: crumb,crumbs
crumble: crumbled,crumbling
crush: crush,crushed,crushing
crust: crust,crusts
crustacea: crustacea
crustacean: crustacean,crustaceans
crypt: crypt
crystal: crystal,crystals
crystallize: crystallized
cuba: cuba
cuban: cubans
cubic: cubic
cubit: cubits
cucumber: cucumber,cucumbers
cucuyo: cucuyo
culprit: culprit
cultivate: cultivated
cumberland: cumberland
cunning: cunning
cup: cup,cups
cupola: cupolas
curator: curator
curb: curb,curbed
curdle: curdle
cure: cured
curiosity: curiosities,curiosity
curl: curled,curls
currency: currency
current: current,currents
curse: curse,cursed,curses
curt: curt
curtain: curtain,curtains
curve: curve,curves,curving
curved: curved
curving: curving
cushion: cushion
cussword: cusswords
custody: custody
custom: custom
customary: customary
cut: cut,cuts,cutting
cutlass: cutlass
cutlet: cutlets
cutout: cutouts
cutting: cutting
cuttlefish: cuttlefish
cyclades: cyclades
cyclone: cyclone,cyclones
cyclostome: cyclostomes
cylinder: cylinder,cylinders
cylindrical: cylindrical
cypraea: cypraea
cyrus: cyrus
cythera: cythera
da: da
dab: dab
daddy: daddy
dagger: dagger
daily: daily
daintily: daintily
dainty: daintiest,dainty
damage: damage
damaged: damaged
damnation: damnation
damned: damned
damp: damp
dampen: dampening
damselfish: damselfish
dandy: dandy
danes: danes
danger: danger,dangers
dangerous: dangerous
dangle: dangle,dangled,dangling
daniel: daniel
daniele: daniele
danube: danube
dappled: dappled
daring: daring
daringly: daringly
darius: darius
dark: dark
darken: darkened
darkness: darkness
darling: darling
dart: darted,darting
darwin: darwin
dash: dashed
data: data
datum: data
daunt: daunting
daunting: daunting
davis: davis
dawn: dawn,dawned
day: day,days
daybreak: daybreak
daydream: daydreaming
daylight: daylight
daylong: daylong
daytime: daytime
daze: daze
dazzle: dazzled,dazzling
dazzling: dazzling
dead: dead
deaden: deadened
deadlight: deadlight
deadwood: deadwood
deaf: deaf
deafening: deafening
deal: deal,dealing,dealt
dealings: dealings
dearly: dearly
death: death,deaths
deathbed: deathbed
deathblow: deathblow
debate: debate,debated,debating
debating: debating
debt: debt
decade: decades
decamps: decamps
decapod: decapods
deceased: deceased
december: december
decency: decency
decent: decent
decently: decently
deception: deception,deceptions
decide: decide,decided,deciding
decimeter: decimeter,decimeters
decision: decision
decisive: decisive
decisively: decisively
deck: deck,decked,decks
decker: decker
declaim: declaimed
declare: declare,declared
decline: decline
decompose: decomposed,decomposes,decomposing
decompression: decompression
decor: decor
decorate: decorated
decorative: decorative
decrease: decreases,decreasing
decree: decrees
dedicate: dedicated
dedicated: dedicated
deed: deed,deeds
deem: deem
deep: deep,deeper,deepest
deepen: deepened,deepening
deeply: deeply
deer: deer
defeat: defeated
defective: defective
defend: defend,defended
defender: defender
defensive: defensive
defiance: defiance
deficient: deficient
define: defined
definite: definite
definition: definition
definitive: definitive
deform: deformed
deformity: deformities,deformity
defy: defied,defies,defy
degree: degree,degrees
del: del
delay: delay,delayed
delectable: delectable
deliberately: deliberately
delicacy: delicacy
delicate: delicate
delicately: delicately
delicious: delicious
delight: delight,delighted,delighting
delighted: delighted
delightful: delightful
delirium: delirium
deliver: deliver,delivered
delphinia: delphinia
delta: delta
demand: demand,demanded,demanding,demands
demarcation: demarcation
dement: demented
demolish: demolish,demolished,demolishing
den: den
denial: denial,denials
denizen: denizens
denote: denote,denoted,denoting
dense: dense,denser
densely: densely
density: densities,density
denude: denuded
deny: denied,deny
depart: depart,departed,departing
departure: departure
depend: depend,depending
dependent: dependent
depict: depict,depicted,depicting
deplete: depleted
deplorable: deplorable
depopulate: depopulate,depopulated
deposit: deposited,deposits
depression: depression
deprive: deprive,deprived,depriving
depth: depth
depths: depths
deputy: deputy
derange: deranged
derelict: derelict
derivation: derivation
derive: derived
desalt: desalts
descend: descend,descended,descending
descendant: descendants
descent: descent
description: description
desert: desert,deserted,deserting
deserted: deserted
deserter: deserter
deserve: deserve,deserved,deserves
design: design,designed,designing,designs
designation: designation,designations
desire: desire,desired,desires,desiring
desolate: desolate
despair: despair
despairing: despairing
desperate: desperate
desperately: desperately
despise: despise
dessert: dessert
destine: destined
destiny: destinies,destiny
destroy: destroy,destroyed,destroying
destruction: destruction
destructive: destructive
detach: detach,detached,detaching
detailed: detailed
detain: detained
detect: detect,detected
determine: determine,determined,determining
determined: determined
detest: detest,detests
detour: detour
detractor: detractors
detriment: detriment
devastate: devastates,devastating
devastation: devastation
develop: developed,developing
development: development,developments
device: device,devices
devil: devil,devils
devilfish: devilfish
devise: devising
devote: devoted
devoted: devoted
devotion: devotion
devour: devour,devoured,devouring
dew: dew
dexterity: dexterity
dextrality: dextrality
diagnosis: diagnosis
diagonal: diagonal
diagonally: diagonally
dial: dial
dialect: dialect,dialects
dialogue: dialogue,dialogues
diameter: diameter
diamond: diamond,diamonds
diana: diana
diary: diary
diatom: diatoms
dibranchiata: dibranchiata
dichromate: dichromate
dick: dick
dicks: dicks
dictate: dictate,dictated
dictation: dictation
didactic: didactic
die: die,died,dies,dying
diet: diet
difference: difference,differences
difficult: difficult
difficulty: difficulties,difficulty
diffuse: diffuse
dig: dig,digging,dug
digestion: digestion
digging: digging
dignity: dignity
dimension: dimensions
diminish: diminish,diminished
diminutive: diminutive
dimly: dimly
diner: diners
dinghy: dinghy
dingy: dingy
dining: dining
dinner: dinner
dinnertime: dinnertime
dinnerware: dinnerware
diorama: diorama
dioxide: dioxide
dip: dip,dipped
dire: dire
direct: direct,directing,directs
direction: direction,directions
directive: directive
dirge: dirge
disabled: disabled
disappear: disappear,disappeared,disappearing,disappears
disappearance: disappearance
disappointed: disappointed
disappointment: disappointment
disaster: disaster
disastrous: disastrous
disbelief: disbelief
discard: discarded
discharge: discharge
disciple: disciple
discipline: discipline
discolor: discolored
discomfort: discomfort
discontent: discontent
discordant: discordant
discount: discount
discourage: discourage,discouraged
discouragement: discouragement
discourteous: discourteous
discover: discover,discovered,discovering
discoverer: discoverers
discovery: discoveries,discovery
discredit: discredited
discuss: discuss,discussed,discussing
discussion: discussion,discussions
disease: disease
disembark: disembark,disembarked
disemboweled: disemboweled
disentangle: disentangled
dish: dish,dishes
disheartened: disheartened
disheveled: disheveled
disinterested: disinterested
disk: disk,disks
dislocate: dislocated
dislocated: dislocated
dismal: dismal
dismay: dismay
dismissal: dismissal
disorder: disorder,disorders
disown: disowned
dispatch: dispatch
dispel: dispel
dispense: dispense
disperse: disperse,dispersed,dispersing
displace: displace,displaced,displaces
displacing: displacing
display: display,displayed,displaying,displays
displease: displease,displeasing
displeasure: displeasure
disposal: disposal
dispose: dispose
disposition: disposition
dispute: dispute,disputed,disputes
disrupt: disrupted
dissect: dissect,dissected,dissecting
dissolve: dissolved,dissolving
dissolving: dissolving
distaff: distaff
distance: distance,distances
distant: distant
distaste: distaste
distasteful: distasteful
distended: distended
distil: distilling
distinct: distinct
distinction: distinction
distinctly: distinctly
distinctness: distinctness
distinguish: distinguish,distinguished,distinguishes,distinguishing
distinguished: distinguished
distracted: distracted
distress: distress
distressed: distressed
distressing: distressing
distribute: distributed
distribution: distribution
district: districts
distrust: distrust
disturb: disturb,disturbed,disturbing
disturbance: disturbances
disturbing: disturbing
dive: dive,dived,dives,dove
diver: diver,divers
diverge: diverging
diversion: diversion
divert: diverted
divest: divest
divide: divide,divided,divides,dividing
dividing: dividing
divine: divine
divinely: divinely
diving: diving
division: division,divisions
dizziness: dizziness
dizzy: dizzy
dizzying: dizzying
dock: dock,docks
doctor: doctor
document: documented,documents
documentary: documentary
dodge: dodged
dog: dogged,dogs
dogfish: dogfish
doggedly: doggedly
doings: doings
dolmen: dolmens
dolphin: dolphin,dolphins
dolphinfish: dolphinfish
domain: domain,domains
dome: domes
dominant: dominant
domination: domination
dominican: dominicans
dominion: dominion
donkey: donkeys
doodle: doodle
doom: doomed
door: door,doors
doors: doors
doorway: doorway
dorado: dorado,dorados
dorados: dorados
dorsal: dorsal
dose: dose,doses
dot: dots
dote: dote,dotes
double: double,doubled,doubling
doubly: doubly
doubt: doubt,doubted,doubting,doubts
dow: dow
downpour: downpour
downright: downright
downtrodden: downtrodden
downward: downward
doze: doze,dozed
dozen: dozen,dozens
draft: draft,drafted,drafts
drag: drag,dragged,drags
dragnet: dragnet,dragnets
dragon: dragon,dragons
dragonet: dragonets
dragonfish: dragonfish
drain: drain,drained
dram: dram
drama: drama
dramatize: dramatized
drat: drat
draw: draw,drawing,drawn,draws,drew
drawback: drawback
drawing: drawing,drawings
dread: dread,dreaded,dreading,dreads
dreadful: dreadful
dreadfully: dreadfully
dream: dream,dreamed,dreaming,dreams
dredge: dredge,dredged,dredges
dregs: dregs
drench: drenched
dress: dress,dressed,dresses,dressing
dressed: dressed
drift: drift,drifted,drifting
drill: drilled,drilling
drink: drank,drink
drinking: drinking
drive: drive,driven,driving,drove
dromedary: dromedaries
droop: drooped
drop: drop,dropped,dropping,drops
droplet: droplet,droplets
drown: drown,drowned
drowsiness: drowsiness
drunk: drunk
drunken: drunken
dry: dried,dry
dryness: dryness
dub: dub,dubbed
dubious: dubious
duck: duck
dugong: dugong
dugout: dugout,dugouts
duke: duke
dull: dull
dumbfounded: dumbfounded
dumbstruck: dumbstruck
dungeon: dungeons
dunking: dunking
duplicate: duplicate,duplicated
dusk: dusk
dust: dust
dutch: dutch
dutchman: dutchman,dutchmen
dutchmen: dutchmen
duty: duty
dwarf: dwarves
dwell: dwell,dwelling,dwells
dweller: dweller
dye: dye,dyed
dynamic: dynamic
eager: eager
eagerly: eagerly
eagle: eagle
ear: ear,ears
earlobe: earlobes
earn: earn,earned,earns
earnest: earnest
earring: earrings
earth: earth
earthenware: earthenware
earthly: earthly
earthquake: earthquakes
ease: ease,eased
easily: easily
east: east
easterly: easterly
eastern: eastern
easternmost: easternmost
eastward: eastward
easy: easier,easy
eat: ate,eat,eaten,eating
eater: eater,eaters
eating: eating
eavesdropping: eavesdropping
ebb: ebb,ebbing
ebony: ebony
eccentric: eccentric
ecclesiastes: ecclesiastes
echeneis: echeneis
echidna: echidna
echo: echoing
ecology: ecology
economical: economical
economics: economics
ecstasy: ecstasy
eddy: eddies,eddy
edgar: edgar
edge: edge,edged,edges
edible: edible
edifice: edifices
edition: edition,editions
educate: educated
edwards: edwards
eel: eel,eels
eelgrass: eelgrass
eelpout: eelpout
effectively: effectively
efficiency: efficiency
efficient: efficient
effort: effort,efforts
effortless: effortless
egg: egg,eggs
eggs: eggs
egypt: egypt
egyptian: egyptian,egyptians
eighteen: eighteen
eighth: eighth
el: el
elastic: elastic
elasticity: elasticity
elbow: elbow,elbows
elder: elders
elderly: elderly
electric: electric
electrical: electrical
electrically: electrically
electrician: electricians
electricity: electricity
electro: electro
electrocute: electrocute,electrocuted,electrocuting
electromagnet: electromagnets
elegant: elegant
elegantly: elegantly
element: element,elements
elephant: elephant,elephants
elevated: elevated
elevation: elevation
elevator: elevator
eliminate: eliminated
elkhorn: elkhorn
elocution: elocution
elongated: elongated
eloquence: eloquence
elude: elude,eluded
elusive: elusive
emanation: emanation
emancipate: emancipated
embankment: embankment
embarrassment: embarrassment
embed: embedded
embellish: embellished
embittered: embittered
embody: embody
embolden: emboldening
embrace: embraced
embroider: embroidered
embroidery: embroidery
emerald: emerald,emeralds
emerge: emerge,emerged,emerges,emerging
emission: emission
emit: emitting
emotion: emotion
emotionless: emotionless
emotionlessness: emotionlessness
emperor: emperor,emperors
emphasis: emphasis
emphatically: emphatically
empire: empire
employ: employ
employer: employer,employers
enable: enable,enabled,enables,enabling
enamel: enamel
encase: encase,encased
encircle: encircled
enclose: enclose,enclosed,enclosing
encompass: encompassed
encounter: encounter,encountered,encountering,encounters
encourage: encouraging
encouraging: encouraging
encrust: encrusted
encyclopedia: encyclopedia
endeavor: endeavor
endless: endless
endorse: endorsed
enemy: enemies,enemy
energetic: energetic
energetically: energetically
energy: energies,energy
enforce: enforce
engage: engaged
engender: engendered
engine: engine,engines
engineer: engineer,engineers
engineering: engineering
england: england
english: english
englishman: englishman
englishmen: englishmen
engrave: engraved
enhance: enhanced
enhydra: enhydra
enjoy: enjoy,enjoyed,enjoys
enjoyable: enjoyable
enkindle: enkindling
enlarge: enlarged,enlarging
enlighten: enlightened
enlightenment: enlightenment
enlistment: enlistment
enliven: enlivened
enormous: enormous
enormously: enormously
enrapture: enraptured
enrich: enrich,enriched
ensconce: ensconced
enshroud: enshrouded
enslave: enslaved
ensue: ensued,ensuing
entail: entail,entailed
entangle: entangle,entangled
enter: enter,entered,entering
entered: entered
entertain: entertain,entertained
entertaining: entertaining
enthusiasm: enthusiasm
enthusiast: enthusiast
enthusiastic: enthusiastic
enticement: enticement
entire: entire
entitle: entitled
entrails: entrails
entrance: entrance
entrepreneur: entrepreneurs
entrust: entrust,entrusted
entwine: entwine,entwined
environment: environment
envision: envisioned,envisioning
envy: envied
epic: epic
epicure: epicure,epicures
episode: episode
episodic: episodic
epithet: epithet
epoch: epoch,epochs
equal: equal,equaled,equaling,equals
equally: equally
equator: equator
equatorial: equatorial
equinoctial: equinoctial
equinox: equinox
equip: equip,equipped
equipment: equipment
equivalent: equivalent,equivalents
era: era
erebus: erebus
erect: erect,erected
ernest: ernest
erode: eroded
erratic: erratic
erratically: erratically
error: error,errors
erupt: erupt
eruption: eruption,eruptions
escape: escape,escaped,escaping
escarpment: escarpment
escort: escort,escorted,escorting
esparto: esparto
essence: essence
essential: essential
essex: essex
est: est
establish: establish,established,establishing
established: established
esteem: esteem
estimate: estimate,estimated,estimates,estimating
estuary: estuary
etch: etched
etching: etchings
eternal: eternal
eternity: eternity
ethic: ethics
ethical: ethical
etna: etna
europe: europe
european: european,europeans
evaporate: evaporating
evaporation: evaporation
evasion: evasion,evasions
evasive: evasive
evasively: evasively
eve: eve
evening: evening
event: event,events
eventuality: eventuality
evergreen: evergreens
everlasting: everlasting
everlastingly: everlastingly
everyday: everyday
evidence: evidence
evocative: evocative
exact: exact,exacting
exaggerate: exaggerate,exaggerated
exaggerated: exaggerated
exalt: exalted
examination: examination
examine: examine,examined,examining
excavate: excavating
excavation: excavations
exceed: exceed,exceeded,exceeding,exceeds
excel: excels
excellence: excellence
excellent: excellent
exception: exceptions
exceptionally: exceptionally
excerpt: excerpt
excess: excess
excessive: excessive
exchange: exchange,exchanged,exchanging
excitable: excitable
excite: excite,excited
excited: excited
excitement: excitement
exciting: exciting
exclaim: exclaim,exclaimed
exclamation: exclamations
exclude: exclude
exclusive: exclusive
exclusively: exclusively
excursion: excursion,excursions
excuse: excuse
execute: executed,executing
execution: execution
executioner: executioner
exercise: exercise
exertion: exertion,exertions
exhalation: exhalation
exhale: exhaled
exhaust: exhaust,exhausted,exhausting
exhausted: exhausted
exhausting: exhausting
exhaustion: exhaustion
exhibit: exhibit,exhibited,exhibits
exhibition: exhibition,exhibitions
exhilarate: exhilarating
exile: exile,exiles
exist: exist,existed,existing,exists
existence: existence
exit: exit
exotic: exotic
expand: expanded
expanse: expanse
expect: expect,expected,expecting
expectation: expectations
expedition: expedition
expel: expel,expelled,expelling
expenditure: expenditure
expense: expense,expenses
experience: experience,experienced,experiences,experiencing
experiment: experiment,experiments
expert: expert,experts
expertly: expertly
expire: expired
explain: explain,explained,explaining,explains
explanation: explanation,explanations
explicit: explicit
explode: exploded,explodes,exploding
exploit: exploit,exploiting,exploits
exploration: exploration
explore: explore,explored,exploring
explorer: explorer,explorers
exploring: exploring
explosion: explosion,explosions
expose: expose,exposed
expound: expounded
express: express,expressed
expression: expression,expressions
expressive: expressive
expressively: expressively
expressly: expressly
exquisite: exquisite
exquisitely: exquisitely
extend: extend,extended,extending,extends
extended: extended
extension: extensions
extensive: extensive
extent: extent
exterior: exterior
exterminate: exterminated
external: external
extinct: extinct
extinction: extinction
extinguish: extinguish,extinguished
extract: extract,extracted,extracting
extraordinary: extraordinary
extreme: extreme
extremely: extremely
extremist: extremist
extremity: extremities
eye: eye,eyes
eyebrow: eyebrow
eyed: eyed
eyelet: eyelets
eyelid: eyelids
eyepiece: eyepiece
eyesight: eyesight
eyewitness: eyewitness
fable: fable
fabled: fabled
fabric: fabric,fabrics
fabulous: fabulous
facet: facet,facets
facial: facial
facilitate: facilitate,facilitated
facility: facility
factor: factor
factual: factual
faculty: faculties,faculty
fade: fade,faded,fades,fading
fail: fail,failed,failing,fails
failure: failure
faint: faint,fainted,faintest
fainting: fainting
faintly: faintly
fair: fair
fairy: fairy
faith: faith
faithful: faithful
faithfully: faithfully
fake: fake
falkland: falkland
fall: fall,fallen,falling,falls,fell
falter: faltered
familiar: familiar
familiarity: familiarity
familiarly: familiarly
family: families,family
famished: famished
famous: famous
fan: fan,fanned,fans
fanatic: fanatic
fanciful: fanciful
fancy: fancied,fancies,fancy
fanged: fanged
fantasize: fantasizing
fantastic: fantastic
fantastically: fantastically
fantasy: fantasies,fantasy
faraday: faraday
fare: fare,fared
farewell: farewell
farfetched: farfetched
farina: farina
farmed: farmed
farmer: farmers
farth: farthest
farthest: farthest
fascinate: fascinate,fascinated
fascinating: fascinating
fascination: fascination
fashion: fashion,fashioned,fashions
fashioned: fashioned
fast: fast,faster,fastest
fasten: fastened,fastening
fastening: fastenings
fat: fat
fatal: fatal
fate: fate,fated,fates
fated: fated
father: father
fathom: fathom,fathoms
fatten: fattening
faucet: faucets
fault: fault
faulty: faulty
fauna: fauna
favor: favor,favored,favoring,favors
favorable: favorable
favorite: favorite
fear: fear,feared,fearing,fears
fearful: fearful
fearsome: fearsome
feasible: feasible
feast: feast
feasting: feasting
feat: feat,feats
feather: feather,feathers
feature: feature,featured,features,featuring
february: february
feeble: feeble
feed: fed,feed,feeding,feeds
feel: feel,feeling,feels
feeling: feeling,feelings
feldspar: feldspar
felicitously: felicitously
fell: felled
fellow: fellow,fellows
female: female,females
fennel: fennel
fermented: fermented
fern: ferns
ferocious: ferocious
ferret: ferreted
ferry: ferries,ferry
fertile: fertile
fertility: fertility
fervor: fervor
festering: festering
festoon: festooned,festoons
fetch: fetching
fetter: fetter,fetters
fever: fever,fevers
feverish: feverish
feverishly: feverishly
fiber: fibers
fibrous: fibrous
fickle: fickle
fickleness: fickleness
fiction: fiction
fictitious: fictitious
field: field,fields
fierce: fierce
fiery: fiery
fig: fig
fight: fight,fighting,fought
fighter: fighter
fighting: fighting
figuratively: figuratively
figure: figure,figured,figures
fiji: fiji
filament: filament,filaments
film: film
filter: filtered,filtering
fin: fin,finned,fins
final: final
finally: finally
financial: financial
finback: finback
finder: finder
finding: findings
fine: fine,finest
fineness: fineness
finger: finger,fingers
fingerlike: fingerlike
finicky: finicky
finis: finis
finish: finish,finished,finishing
finished: finished
firefly: fireflies
fireplace: fireplace
firewood: firewood
firework: fireworks
firm: firm
firmly: firmly
fish: fish,fished,fishing
fisherman: fisherman,fishermen
fishery: fisheries
fishhook: fishhook
fishing: fishing
fissurella: fissurella
fist: fist,fists
fit: fit,fits,fitted,fitting
fitful: fitful
fitting: fittings
fitz: fitz
fitzroy: fitzroy
fivefold: fivefold
fivescore: fivescore
fixture: fixtures
flabbergast: flabbergasted
flag: flag
flail: flailing
flaky: flaky
flame: flame,flames,flaming
flamingo: flamingo
flank: flank,flanks
flap: flapping
flare: flare,flaring
flash: flash,flashed,flashes,flashing
flask: flasks
flat: flat,flats
flatfish: flatfish
flatly: flatly
flatten: flattened
flatter: flattered
flattering: flattering
flavor: flavor
flaw: flaw
flea: fleas
fleck: flecked,flecking
fledged: fledged
flee: fled,flee,fleeing
fleet: fleet,fleets
fleeting: fleeting
flemish: flemish
flesh: flesh
fleshy: fleshy
fleur: fleur
flex: flexes
flexible: flexible
flick: flicked
flicker: flicker,flickers
flight: flight,flights
flimsy: flimsy
fling: fling,flung
flint: flint
flip: flip
flipper: flippers
flit: flitted
float: float,floated,floating,floats
flock: flocks
floe: floes
flood: flood,flooded,flooding,floods
flooding: flooding
floor: floor
flora: flora
florida: florida
flotation: flotation
flotilla: flotilla
flounder: flounder
flour: flour
flourish: flourished
flow: flow,flowing,flows
flower: flower,flowers
flowerbed: flowerbed
fluency: fluency
fluently: fluently
fluid: fluid
flung: flung
flurry: flurries
flush: flush,flushed
flute: flutes
flutelike: flutelike
flutter: flutter,fluttered,fluttering
fly: flew,flies,fly,flying
flycatcher: flycatchers
foam: foam,foamed,foaming
focus: focused
foe: foe
fog: fog
foggy: foggiest
fold: folded,folds
foliage: foliage
folk: folk
follow: follow
follower: followers
fond: fond
fondle: fondle
font: font,fonts
food: food,foods
foodstuff: foodstuff
fool: fool,fools
foolhardiness: foolhardiness
foolhardy: foolhardy
foolish: foolish
foot: feet,foot
footed: footed
foothill: foothills
footprint: footprint,footprints
footstep: footsteps
footwear: footwear
forage: foraging
foraminifera: foraminifera
forbid: forbid,forbidden,forbids
force: force,forced,forces,forcing
forcefully: forcefully
forcibly: forcibly
ford: fording
fore: fore
forearm: forearms
foreboding: forebodings
forecast: forecast,forecasts
forecastle: forecastle
forego: foregoing
foreground: foregrounds
forehead: forehead
foreign: foreign
foreigner: foreigner
foremast: foremast
foremost: foremost
forepart: forepart
foresee: foreseen
forest: forest,forests
forestall: forestalling
foretell: foretell
forge: forge,forged
forger: forgers
forget: forget,forgetting,forgot,forgotten
forgive: forgive
fork: fork,forked,forks
form: form,formed,forming,forms
formal: formal
formality: formality
formation: formation,formations
formulate: formulate
formulation: formulation,formulations
forsake: forsake
fort: forts
forthcoming: forthcoming
fortieth: fortieth
fortification: fortifications
fortress: fortress
fortunate: fortunate
fortunately: fortunately
fortune: fortune,fortunes
fossil: fossil,fossils
foul: foul,fouled
fouled: fouled
foundation: foundation,foundations
founder: founder,founders
founding: founding
foundry: foundry
fourteen: fourteen
fourth: fourth
fowl: fowl
fox: fox
fracture: fracture
fragile: fragile
fragrance: fragrance
frail: frail
frame: frame,framed
framework: framework
franc: franc,francs
france: france
francisco: francisco
frank: frank
frankly: frankly
frantic: frantic
freak: freak
freckled: freckled
frederick: frederick
freedom: freedom
freely: freely
freeze: freeze,freezes,froze,frozen
freezing: freezing
french: french
frenchman: frenchman
frenchmen: frenchmen
frenzy: frenzy
frequent: frequent,frequented,frequenting,frequents
frequently: frequently
fresh: fresh
freshly: freshly
freshwater: freshwater
friend: friend,friends
friendly: friendly
frigate: frigate,frigates
frighten: frightened
frightened: frightened
frightening: frightening
frightful: frightful
frightfully: frightfully
fringe: fringe,fringed,fringes,fringing
fringed: fringed
frog: frog
frond: fronds
frosted: frosted
frown: frown,frowning
frozen: frozen
frugal: frugal
fruit: fruit,fruits
fruitless: fruitless
frustrate: frustrate
fry: frying
fucus: fucus
fuel: fuel
fulfil: fulfilled
fume: fumes
fun: fun
function: function,functioned,functions
functional: functional
funeral: funeral
fungus: fungus
funnel: funnel,funnels
funny: funny
fur: fur,furs
furies: furies
furious: furious
furiously: furiously
furled: furled
furnace: furnace,furnaces
furnish: furnish,furnished,furnishes,furnishing
furnishing: furnishing
furnishings: furnishings
furniture: furniture
furrow: furrow,furrowed,furrowing,furrows
fury: fury
fuse: fused
fusion: fusion
futile: futile
future: future,futures
futuristic: futuristic
gadoid: gadoid
gaff: gaff
gain: gained,gaining,gains
gal: gal
galen: galen
galileo: galileo
gallant: gallant
galleon: galleons
gallery: galleries,gallery
galley: galley,galleys
gallows: gallows
galvanic: galvanic
gam: gam
gambier: gambier
gamble: gamble,gambling
gambler: gamblers
game: game,games
gamut: gamut
gange: ganges
gangway: gangway,gangways
gap: gaps
gape: gaped,gaping
garden: gardens
gardens: gardens
garfish: garfish
gargantua: gargantua
garland: garlands
garnish: garnished
gas: gas
gaseous: gaseous
gash: gash
gasp: gasp,gasped,gasping
gastropoda: gastropoda
gate: gate
gather: gather,gathered,gathering,gathers
gathering: gathering
gauge: gauge
gaze: gaze,gazed
gazette: gazette
gear: gear,geared,gearing,gears
geese: geese
gelatin: gelatin
gelatinous: gelatinous
gem: gems
genera: genera
generate: generate,generated,generates,generating
generating: generating
generation: generations
generator: generator
generis: generis
generosity: generosity
generous: generous
generously: generously
genius: genius,geniuses
genre: genre
gent: gent
gentle: gentle
gentleman: gentleman,gentlemen
gentleness: gentleness
gentler: gentler
gently: gently
genuine: genuine
genuinely: genuinely
genus: genus
geographer: geographer
geographic: geographic
geographical: geographical
geography: geography
geologic: geologic
geologist: geologists
geology: geology
geometry: geometry
george: george
georgia: georgia
gerard: gerard
germ: germ
german: german
germany: germany
gestation: gestation
gesticulate: gesticulated,gesticulating
gesture: gesture,gestured,gestures
getaway: getaway
geyser: geyser
ghastly: ghastly
ghost: ghost
giant: giant,giants
gibraltar: gibraltar
gift: gift,gifted,gifts
gifted: gifted
gigantic: gigantic
gill: gill,gills
gilthead: gilthead
gimlet: gimlet
gin: gin
gingerbread: gingerbread
girdle: girdle
girth: girth
gist: gist
glacier: glaciers
glad: glad
glade: glades
gladly: gladly
glance: glanced,glancing
glare: glare
glasgow: glasgow
glass: glass,glasses
glasswort: glasswort
glassy: glassy
glaucous: glaucous
gleam: gleam,gleamed,gleaming,gleams
glee: glee
gleeful: gleeful
glide: glide,glided,gliding
glimmer: glimmer,glimmering,glimmers
glimpse: glimpse,glimpsed,glimpses
glisten: glisten,glistened,glistening
glitter: glitter,glittered,glittering
global: global
globe: globe,globes
globefish: globefish
globular: globular
globule: globules
gloom: gloom
gloomy: gloomier,gloomy
glorify: glorify
glorious: glorious
gloriously: gloriously
glory: glory
glove: glove,gloves
glow: glow,glowed,glowing
glowing: glowing
glowworm: glowworm
glue: glue,glued,gluing
glut: glutted
glutinous: glutinous
glutton: glutton
gluttonous: gluttonous
gluttony: gluttony
gnash: gnashing
goat: goat,goats
goatee: goatee
gobio: gobio
goby: gobies,goby
god: god,gods
goddess: goddess
gold: gold
golden: golden
goldfish: goldfish
gondola: gondolas
goose: goose
gooseberry: gooseberries
gordon: gordon
gorge: gorge
gorgonian: gorgonian
gouge: gouge,gouged
govern: governed
government: government,governments
governor: governor
grab: grab
grace: grace
graceful: graceful
gracefully: gracefully
gracious: gracious
graciously: graciously
graciousness: graciousness
gradient: gradient,gradients
gradual: gradual
gradually: gradually
graham: graham
grain: grain
grained: grained
grainy: grainy
gram: gram,grams
grand: grand
grandson: grandson
granite: granite
grant: grant,granted
granular: granular
graphite: graphite
grapple: grappling
grasp: grasp,grasped,grasping
grass: grass,grasses
grassy: grassy
grateful: grateful
gratify: gratify
gratitude: gratitude
grave: grave,graves
gravel: gravel
gravitate: gravitated,gravitating
gravity: gravity
gray: gray
grayish: grayish
graze: graze,grazing
grease: grease
greatly: greatly
greco: greco
greece: greece
greedily: greedily
greek: greek,greeks
green: green,greenest
greenery: greenery
greenfish: greenfish
greenish: greenish
greenland: greenland
greenwich: greenwich
greet: greet,greeted
greeting: greeting
grenada: grenada
grenadier: grenadier,grenadiers
griddle: griddles
grief: grief,griefs
grill: grilled
grilling: grilling
grim: grim
grind: grind,ground
grip: grip,gripped
grizzled: grizzled
groan: groaned
grocery: grocery
groove: groove,grooves
grope: grope,groping
ground: ground
grounds: grounds
grouper: groupers
grove: grove
grow: grew,grow,growing,grown,grows
grower: growers
growl: growling
growth: growth
grueling: grueling
gruesome: gruesome
grunt: grunts
grunting: grunting
guaranian: guaranian
guarantee: guaranteed,guarantees
guard: guard,guarded,guards
gudgeon: gudgeon
guerilla: guerilla
guess: guess,guessed
guesswork: guesswork
guest: guests
guiana: guiana
guide: guide,guided,guides,guiding
guinea: guinea
guitarfish: guitarfish
gulf: gulf,gulfs
gulfweed: gulfweed
gull: gulls
gullet: gullet,gullets
gulp: gulp,gulps
gummy: gummy
gun: gun,guns
gunboat: gunboat
gunner: gunner
gunpowder: gunpowder
gunshot: gunshot,gunshots
gunwale: gunwale
gurnard: gurnard,gurnards
gust: gust
gutta: gutta
gymnotus: gymnotus
ha: ha
habeas: habeas
habit: habit,habits
habitat: habitat
habitual: habitual
habitually: habitually
hack: hacked
hades: hades
hague: hague
hail: hail,hailing
hair: hair
hairpiece: hairpiece
hairy: hairy
hake: hake
halfway: halfway
halicore: halicore
halifax: halifax
hallucination: hallucinations
halt: halt,halted,halts
halted: halted
hammer: hammer
hammerhead: hammerhead
hammock: hammocks
hamper: hamper,hampered
hand: hand,handed,handing,hands
handbell: handbells
handed: handed
handiwork: handiwork
handkerchief: handkerchief,handkerchiefs
handle: handle,handled
handrail: handrail
handshake: handshake
handsome: handsome
handsomely: handsomely
handwriting: handwriting
handy: handier,handy
hang: hang,hanging,hangs,hung
haphazard: haphazard
hapless: hapless
happen: happen,happened,happening
happening: happenings
happenstance: happenstance
happily: happily
happiness: happiness
happy: happy
harbor: harbor,harbored
hard: hard,harder,hardest
hardcover: hardcover
harden: harden,hardened
hardship: hardships
hardworking: hardworking
hare: hare,hares
harm: harm
harmless: harmless
harmonious: harmonious
harmony: harmonies,harmony
harness: harness,harnessing
harp: harp
harpoon: harpoon,harpooned,harpooning,harpoons
harpooner: harpooner
harpooners: harpooners
harpooning: harpooning
harrow: harrowed
harrowing: harrowing
harsh: harsh,harshest
hart: hart
harvest: harvest
harvester: harvesters
harvesting: harvesting
hasten: hastened
hastily: hastily
hasty: hasty
hatch: hatch,hatched,hatches,hatching
hate: hate,hated,hates
hatred: hatred
haul: haul,hauled
haunt: haunted,haunting,haunts
havana: havana
haversack: haversack
hawaii: hawaii
hawaiian: hawaiian
hawk: hawks
hawkins: hawkins
hawksbill: hawksbill
haydn: haydn
hazard: hazards
hazardous: hazardous
haze: haze
hazel: hazel
hazily: hazily
hazy: hazy
head: head,headed,heading,heads
headache: headaches
headgear: headgear
heading: heading
headland: headlands
headless: headless
headlong: headlong
headpiece: headpiece
headstrong: headstrong
health: health
healthy: healthy
heap: heap,heaped
hear: hear,heard,hearing
hearing: hearing
heart: heart,hearts
heartily: heartily
heartland: heartland
heartlessly: heartlessly
hearty: hearty
heat: heat,heated,heating
heating: heating
heave: heaved,heaving,hove
heaven: heaven,heavens
heavily: heavily
heaviness: heaviness
heaving: heaving
heavy: heavier,heaviest,heavy
hebrew: hebrew
hebrews: hebrews
hectare: hectare,hectares
hector: hector
hedge: hedges
hee: hee
heed: heeded
heedlessly: heedlessly
heel: heel,heeled,heels
height: height,heights
heighten: heightened
heir: heir
heliotrope: heliotropes
hellenic: hellenic
helm: helm
helmet: helmet,helmets
helmsman: helmsman,helmsmen
helpful: helpful
helplessness: helplessness
helvetia: helvetia
hemisphere: hemisphere,hemispheres
hempen: hempen
henpecked: henpecked
herald: herald,heralds
heraldic: heraldic
herb: herb,herbs
herculean: herculean
hercules: hercules
herd: herd,herds
hereabouts: hereabouts
hermetically: hermetically
hermit: hermit
hero: hero,heroes
heroic: heroic
herring: herring
hesitate: hesitate,hesitated,hesitating
hesitation: hesitation
hew: hewed
hexangular: hexangular
hibernia: hibernia
hibiscus: hibiscus
hidden: hidden
hide: hidden,hide,hides
hideous: hideous
hideously: hideously
hiding: hiding
hieroglyphic: hieroglyphics
highly: highly
hill: hills
hilt: hilt
himalayas: himalayas
hinder: hinder
hindu: hindu
hinge: hinges
hint: hints
hip: hip
hippolytus: hippolytus
hire: hiring
hispanic: hispanic
hiss: hiss,hisses,hissing
hissing: hissing
historian: historian,historians
historic: historic
historical: historical
history: history
hit: hit,hits,hitting
hitch: hitch
hive: hive
hoax: hoaxes
hoc: hoc
hoist: hoist,hoisted
hoisting: hoisting
hold: held,hold,holding,holds
hole: hole,holes
holiday: holiday
holland: holland
hollow: hollow,hollowed,hollows
hollowness: hollowness
holmes: holmes
holocaust: holocaust
holy: holy
homeland: homeland
homer: homer
homeric: homeric
homesickness: homesickness
hometown: hometown
homeward: homeward
hone: honed
honest: honest
honestly: honestly
honesty: honesty
honey: honey
honeycomb: honeycombs
honor: honor,honored,honoring,honors
honorable: honorable
honorary: honorary
hoodwink: hoodwinked
hooflike: hooflike
hook: hook,hooks
hoop: hoops
hop: hop
hope: hope,hoped,hopes,hoping
hopelessly: hopelessly
horde: horde
horizon: horizon,horizons
horizontal: horizontal
horizontally: horizontally
horn: horn,horns
horrible: horrible
horror: horror,horrors
horse: horse,horses
horsepower: horsepower
hose: hose,hoses
hospitable: hospitable
hospitably: hospitably
hospital: hospitals
hospitality: hospitality
host: host,hosts
hostility: hostility
hot: hot,hotter
hotel: hotel
hotly: hotly
hound: hound,hounds
hour: hour,hours
house: house,houses
household: household,households
housing: housing
houston: houston
hove: hove
hover: hovered,hovering
howl: howl,howling
hubbub: hubbub
huddle: huddled
hudson: hudson
hue: hue,hues
hued: hued
hug: hug,hugged
huge: huge
hugo: hugo
hulk: hulks
hull: hull,hulls
human: human
humanity: humanity
humankind: humankind
humble: humble
humbly: humbly
humidistat: humidistat
humiliating: humiliating
hummingbird: hummingbirds
humorous: humorous
hump: humps
humpback: humpback
humph: humph
humus: humus
hunch: hunch,hunches
hundredfold: hundredfold
hungarian: hungarian
hunger: hunger
hungry: hungry
hunk: hunk
hunt: hunt,hunted,hunting,hunts
hunted: hunted
hunter: hunter,hunters
hunting: hunting
huntsman: huntsman
hurl: hurl,hurled
hurricane: hurricane,hurricanes
hurriedly: hurriedly
hurry: hurried,hurry
hurtle: hurtling
husband: husbands
husk: husks
hustle: hustled
hustling: hustling
hut: hut,huts
hydra: hydra
hydras: hydras
hydraulic: hydraulic
hydrogen: hydrogen
hydrographic: hydrographic
hydrography: hydrography
hydromedusa: hydromedusa
hydroxide: hydroxide
hymn: hymn
hypothesis: hypotheses,hypothesis
hyracotherium: hyracotherium
ice: ice
iceberg: iceberg,icebergs
ichthyological: ichthyological
ichthyologist: ichthyologists
ichthyology: ichthyology
icily: icily
icy: icy
idea: idea,ideas
ideal: ideal
identical: identical
identifiable: identifiable
identify: identified,identify,identifying
identity: identities,identity
idle: idle
igneous: igneous
ignite: ignited
ignore: ignoring
iii: iii
iliad: iliad
ilk: ilk
illegal: illegal
illinois: illinois
illness: illness
illuminate: illuminated,illuminating
illumination: illumination
illusion: illusion,illusions
image: image,images
imaginary: imaginary
imagination: imagination
imagine: imagine,imagined,imagining
imagining: imaginings
imam: imam
imbed: imbedded
imbue: imbued
imitate: imitate
immeasurably: immeasurably
immense: immense
immenseness: immenseness
immerse: immersed
immigrant: immigrants
imminent: imminent
immobility: immobility
immovable: immovable
immune: immune
impact: impact
impatience: impatience
impatient: impatient
impatiently: impatiently
impeccably: impeccably
impede: impede,impeded,impeding
impediment: impediments
impending: impending
impenetrable: impenetrable
imperative: imperative
imperceptible: imperceptible
imperceptibly: imperceptibly
imperfect: imperfect
imperfectly: imperfectly
imperial: imperial
imperialism: imperialism
imperialist: imperialist
impervious: impervious
implacable: implacable
import: import
impose: imposed,imposing
impossibility: impossibility
impossible: impossible
impossibly: impossibly
impression: impression,impressions
impressive: impressive
imprint: imprint
imprison: imprison,imprisoned,imprisoning,imprisons
imprisonment: imprisonment
improbable: improbable
improve: improved
improvement: improvement
impulsive: impulsive
impunity: impunity
inaccessible: inaccessible
inachus: inachus
inadequate: inadequate
inadmissible: inadmissible
inanimate: inanimate
inbound: inbound
incalculable: incalculable
incandescence: incandescence
incandescent: incandescent
incapable: incapable
incapacity: incapacity
incarcerate: incarcerating
incas: incas
inch: inch,inched,inches
incident: incident,incidents
incidentally: incidentally
incision: incision
incisor: incisors
incline: inclined
include: include,included,includes,including
incomparable: incomparable
incomplete: incomplete
incomprehensible: incomprehensible
incompressible: incompressible
inconceivable: inconceivable
incontestably: incontestably
inconvenience: inconvenience
inconvenient: inconvenient
inconveniently: inconveniently
increase: increase,increased,increases,increasing
increasingly: increasingly
incredible: incredible
incredibly: incredibly
incurable: incurable
indebted: indebted
indecisive: indecisive
indefinitely: indefinitely
independence: independence
independent: independent
independently: independently
indescribable: indescribable
indestructible: indestructible
india: india
indian: indian,indians
indication: indications
indies: indies
indifference: indifference
indigestion: indigestion
indignation: indignation
indigo: indigo
indiscreet: indiscreet
indiscriminately: indiscriminately
indisposition: indisposition
indisputable: indisputable
indisputably: indisputably
indistinct: indistinct
individual: individual,individuals
individually: individually
indomitable: indomitable
induce: induced,inducing
induction: induction
indulge: indulge
indulgence: indulgence
industrial: industrial
industrialist: industrialist
industrialized: industrialized
industriously: industriously
industry: industry
ineffective: ineffective
ineffectual: ineffectual
inert: inert
inertia: inertia
inevitably: inevitably
inexhaustible: inexhaustible
inexplicable: inexplicable
infallible: infallible
infection: infection
inferior: inferior
infernal: infernal
infest: infest
infiltrate: infiltrated
infinite: infinite
infinitely: infinitely
infinity: infinity
inflame: inflamed
inflammation: inflammation
inflate: inflate,inflated
inflict: inflict,inflicted,inflicting
influence: influence,influenced
influential: influential
influx: influx
inform: inform,informed,informing
informality: informality
informed: informed
infuriate: infuriated
infusoria: infusoria
infusorium: infusoria
ingenious: ingenious
ingeniously: ingeniously
ingenuity: ingenuity
ingot: ingot,ingots
ingratitude: ingratitude
inhabit: inhabit,inhabited,inhabiting,inhabits
inhabitant: inhabitants
inhalation: inhalation,inhalations
inhale: inhale,inhaled,inhaling
inhospitable: inhospitable
inigo: inigo
iniquitous: iniquitous
initial: initial
initially: initially
initiate: initiated
inject: injected
injection: injections
injudicious: injudicious
injury: injuries,injury
ink: ink
inkling: inkling
inlaid: inlaid
inland: inland
innermost: innermost
innocent: innocent
innuendo: innuendo
innumerable: innumerable
inordinately: inordinately
inquiry: inquiries,inquiry
inquisitive: inquisitive
inroad: inroads
insane: insane
insanity: insanity
insatiable: insatiable
inscription: inscription
inscrutable: inscrutable
insect: insects
insensitive: insensitive
inseparable: inseparable
insert: insert,inserted,inserting
inset: inset
insidious: insidious
insight: insight,insights
insinuate: insinuating
insist: insist,insisted
insistently: insistently
insoluble: insoluble
inspect: inspect,inspected
inspection: inspections
inspiration: inspiration
inspire: inspired
instance: instance
instant: instant
instantaneous: instantaneous
instantly: instantly
instinct: instinct,instincts
instinctively: instinctively
institute: institute
institution: institution
instruction: instructions
instrument: instrument,instruments
insulate: insulated
insult: insult,insults
insuperable: insuperable
insurance: insurance
insure: insure,insured,insuring
insurmountable: insurmountable
intellectual: intellectual
intelligent: intelligent
intelligible: intelligible
intemperance: intemperance
intend: intend,intended,intends
intense: intense
intensely: intensely
intensify: intensified
intensity: intensity
intent: intent
intention: intention,intentions
intently: intently
intercept: intercept
interchange: interchange
interior: interior
intermaxillary: intermaxillary
interminable: interminable
intermittent: intermittent
internal: internal
international: international
interpreter: interpreter
interrupt: interrupt,interrupted,interrupting
interrupted: interrupted
intersect: intersected,intersecting
intertropical: intertropical
intertwine: intertwining
interval: interval,intervals
intervene: intervene,intervened,intervening
interview: interview
intimate: intimate
intimidate: intimidate
intolerable: intolerable
intoxication: intoxication
intransigence: intransigence
introduce: introduced
introduction: introduction
invade: invaded,invading
invariable: invariable
invariably: invariably
invasion: invasion
invent: invented
inventor: inventor
investigate: investigated
investigation: investigations
investigator: investigator
investment: investment
investor: investors
invigorate: invigorating
invisible: invisible
invitation: invitation
invite: invited,invites,inviting
invoke: invoke,invoked
involuntarily: involuntarily
involuntary: involuntary
involve: involved,involving
involvement: involvements
invulnerable: invulnerable
iodine: iodine
ionian: ionian
irascible: irascible
ireland: ireland
iris: iris
irish: irish
irishmen: irishmen
iron: iron
ironclad: ironclad
ironic: ironic
ironwork: ironwork
irony: irony
irregular: irregular
irregularity: irregularity
irresistible: irresistible
irresistibly: irresistibly
irresolute: irresolute
irritability: irritability
irritable: irritable
irritated: irritated
irritating: irritating
irritation: irritation
isaac: isaac
isabella: isabella
isidore: isidore
isis: isis
island: island,islands
islander: islander,islanders
islands: islands
isle: isle
isles: isles
islet: islet,islets
isolate: isolated
isolation: isolation
isopod: isopods
isosceles: isosceles
israelites: israelites
issue: issue,issued
isthmus: isthmus
italian: italian,italians
italy: italy
itch: itched
itching: itching
item: items
itinerary: itineraries
ivory: ivory
ivy: ivy
jack: jack,jacks
jacket: jacket,jackets
jackfruit: jackfruit
jackson: jackson
jacques: jacques
jade: jaded
jagged: jagged
jail: jail
jailer: jailers
jam: jam,jammed
james: james
jammed: jammed
january: january
japan: japan
japanese: japanese
jar: jars
java: java
javanese: javanese
jaw: jaw,jaws
jealous: jealous
jean: jean
jelly: jelly
jellyfish: jellyfish
jellylike: jellylike
jeopardize: jeopardize
jeopardy: jeopardy
jerk: jerk
jersey: jersey
jet: jet,jets
jettison: jettisoned
jetty: jetties
jewel: jewel,jewels
jewelfish: jewelfish
jewelry: jewelry
jiggle: jiggled
job: job
john: john
joint: joint,joints
jointed: jointed
joke: joked
jolt: jolt,jolted,jolts
jonahs: jonahs
jorge: jorge
joseph: joseph
josephine: josephine
journal: journal,journals
journalist: journalists
journey: journey,journeys
joy: joy
juan: juan
judge: judge,judges,judging
judgment: judgment,judgments
juice: juice
jules: jules
julius: julius
july: july
jumble: jumble
jump: jump,jumped,jumping,jumps
jumper: jumpers
junction: junction
juncture: juncture
june: june
jungle: jungle,jungles
junket: junkets
jupiter: jupiter
justice: justice
justified: justified
justify: justified
justly: justly
jut: jutted,jutting
juvenile: juvenile
kaffir: kaffir
kaleidoscope: kaleidoscope
kangaroo: kangaroo,kangaroos
kate: kate
kea: kea
keel: keel,keels
keeling: keeling
keg: kegs
kelp: kelp
kestrel: kestrels
kettle: kettle
key: keyed
keyboard: keyboard
kick: kick,kicking,kicks
kill: kill,killed,killing
killer: killer
kilo: kilo,kilos
kilogram: kilogram,kilograms
kilometer: kilometer,kilometers
kindle: kindled
kindly: kindly
king: king
kingdom: kingdom,kingdoms
kingfisher: kingfishers
kit: kit
kitelike: kitelike
knack: knack
knapsack: knapsack
knee: knee,knees
kneel: kneeling,knelt
knife: knife,knifed
knight: knight,knights
knit: knitting
knob: knob
knock: knock,knocked
knot: knot,knots
knowledge: knowledge
knowledgeable: knowledgeable
kraken: kraken,krakens
kuroshio: kuroshio
label: labeled
labor: labored,labors
laborer: laborers
labyrinth: labyrinth
labyrinthine: labyrinthine
lace: lace,laced
lack: lack,lacked,lacking
lactified: lactified
lad: lad,lads
ladder: ladder
laden: laden
lady: ladies,lady
ladyfinger: ladyfingers
ladyfingers: ladyfingers
ladyfish: ladyfish
lag: lag,lagging
lagoon: lagoon
laid: laid
lair: lairs
laird: laird
lake: lake,lakes
lamentable: lamentable
lamp: lamp,lamps
lamprey: lamprey,lampreys
lance: lance
land: land,landed,landing
landing: landing
landlocked: landlocked
landmark: landmarks
landscape: landscape,landscapes
landslide: landslides
lane: lanes
langle: langle
language: language,languages
languedoc: languedoc
languish: languished
lantern: lantern,lanterns
lap: lapped
lapse: lapse
larder: larder
las: las
lash: lashed
lashing: lashings
lastly: lastly
late: late
lateral: lateral
latin: latin
latitude: latitude
latitudes: latitudes
laud: lauding
laugh: laugh,laughing
laughter: laughter
launch: launch,launched
laurencia: laurencia
lava: lava
lavish: lavished
law: law,laws
lawn: lawns
lawrence: lawrence
lay: laid,lay,laying,lays
layer: layer,layers
layover: layover
lazy: lazy
le: le
lead: lead,leading,leads,led
leader: leader
leadership: leadership
leading: leading
leaf: leaf,leafed,leaves
leaflike: leaflike
leafy: leafy
league: league,leagues
leagues: leagues
leak: leak
lean: lean,leaned,leaning
leaning: leaning
leap: leap,leaped,leaping,leaps
lear: lear
learn: learn,learned,learning
leather: leather
leatherback: leatherback
leatherjacket: leatherjacket
leathery: leathery
leave: leave,leaves,leaving,left
lecture: lecture
ledge: ledge
ledger: ledger
leeward: leeward
left: left
leg: leg,legs
legend: legend,legends
legged: legged
legible: legible
legion: legions
legislator: legislator
legitimate: legitimate
leguminous: leguminous
leisure: leisure
lemon: lemon
lengthen: lengthened
lengthwise: lengthwise
lens: lens,lenses
leonardo: leonardo
leone: leone
les: les
lesser: lesser
lesson: lesson
letter: letter
levant: levant
level: level,leveled,levels
lever: levers
leviathan: leviathan
leyden: leyden
liberator: liberator
liberty: liberty
library: library
libya: libya
libyan: libyan
lice: lice
lichen: lichens
lick: lick,licking
lid: lid,lids
lie: lie,lies,lying
lieutenant: lieutenant
life: life,lives
lifeless: lifeless
lifelong: lifelong
lifestyle: lifestyle,lifestyles
lift: lift,lifted,lifting,lifts
ligament: ligaments
light: light,lighter,lighting,lights,lit
lighten: lighten
lighthearted: lighthearted
lighthouse: lighthouse
lighting: lighting
lightly: lightly
lightning: lightning
lightship: lightship
likelihood: likelihood
likeness: likeness
likes: likes
liking: liking
lily: lilies
limb: limb,limbs
limestone: limestone
limit: limit,limited,limits
limited: limited
limitless: limitless
limpet: limpets
limpid: limpid
lincoln: lincoln
linen: linen
liner: liner,liners
linger: linger,lingering
linguistic: linguistic
link: link,linked,links
lion: lion,lions
lip: lips
lipped: lipped
liquid: liquid
liquor: liquor
list: list,listing
listen: listen,listened,listening
listener: listener
listing: listing
liter: liter,liters
literal: literal
literally: literally
literature: literature
litter: litter,littered
livable: livable
live: live,lived,lives,living
lively: lively
liver: liver,livers
liverpool: liverpool
living: living
lloyd: lloyd
loach: loach
load: load,loaded,loading
loading: loading
loaf: loaf
lobe: lobe,lobes
lobed: lobed
lobster: lobster,lobsters
local: local
locality: localities,locality
localize: localized
locate: locate,located
location: location
lock: locked,locks
locker: lockers
locomotion: locomotion
locomotive: locomotive
lodge: lodge,lodged
lofty: lofty
log: log,logged
logbook: logbooks
loggerhead: loggerhead
loggerheads: loggerheads
logic: logic
logical: logical
loin: loin
loiterer: loiterers
london: london
lone: lone
lonely: lonely
longboat: longboat,longboats
longitude: longitude
longleg: longlegs
longnose: longnose
longstanding: longstanding
lookout: lookout
loom: looming
loophole: loophole
loose: loose
loosen: loosen,loosened
lord: lord,lords
lory: lories
lose: lose,loses,losing,lost
loss: loss,losses
lost: lost
loud: loud,louder
louis: louis
lounge: lounge
love: love,loved,loves
lovely: loveliest,lovely
lowering: lowering
lowermost: lowermost
loyal: loyal
lucina: lucina
luck: luck
luckily: luckily
lucky: luckier
lucrative: lucrative
luggage: luggage
luis: luis
lukewarm: lukewarm
lull: lulled,lulls
luminescent: luminescent
luminous: luminous
lumpfish: lumpfish
lunatic: lunatics
lunch: lunch
lung: lungs
lunge: lunge,lunged
lungfish: lungfish
lungful: lungful
lure: lure,lured
lurk: lurked,lurking,lurks
lush: lush
luster: luster
luxuriant: luxuriant
luxurious: luxurious
luxuriously: luxuriously
luxury: luxuries,luxury
lyonnais: lyonnais
lyre: lyre
lyricism: lyricism
machine: machine,machines
machinery: machinery
mackerel: mackerel
macrocystis: macrocystis
macrura: macrura
mad: madder
madagascar: madagascar
madame: madame
madcap: madcap
madeira: madeira
madman: madman
madness: madness
mado: mado
madonna: madonna
madrepore: madrepore
madreporic: madreporic
madrid: madrid
maelstrom: maelstrom
magellan: magellan
magi: magi
magic: magic
magical: magical
magnesia: magnesia
magnesium: magnesium
magnetic: magnetic
magnificent: magnificent
magnify: magnified,magnify
magnifying: magnifying
magnitude: magnitude
magnus: magnus
mahra: mahra
maiden: maidens
mail: mail
main: main
mainland: mainland
mainmast: mainmast
maintain: maintained,maintaining
majestic: majestic
majestically: majestically
majesty: majesty
major: major
majority: majority
maker: makers
makeshift: makeshift
malabar: malabar
malacca: malacca
malarkey: malarkey
malaysia: malaysia
malaysian: malaysian,malaysians
male: male,males
malo: malo
mammal: mammal,mammals
mammalia: mammalia
manage: manage,managed,managing
management: management
manatee: manatee,manatees
mandible: mandibles
maneuver: maneuver,maneuvered,maneuvers
mango: mangoes
mangrove: mangrove
manhole: manhole
mania: mania
maniac: maniac
manifest: manifest
mankind: mankind
manned: manned
manner: manner
mannered: mannered
manners: manners
manrope: manropes
manservant: manservant
manta: manta
mantle: mantle,mantles
manual: manual
manufacture: manufacture,manufactured
manuscript: manuscript
map: map,maps
marble: marble,marbled
marbled: marbled
march: march
mare: mare
margin: margin,margins
marinate: marinated
marine: marine,marines
mariner: mariners
maritime: maritime
mark: mark,marked,marks
marked: marked
market: market,markets
marketplace: marketplace,marketplaces
marking: markings
marlin: marlin
marmalade: marmalade
maroon: maroon
marrow: marrow
marry: married,marry
mars: mars
marseillais: marseillais
marseilles: marseilles
marsh: marsh
marsupial: marsupials
martin: martin
martingale: martingale
martyr: martyr
marvel: marvel,marveled,marveling
marveling: marveling
marvelous: marvelous
mask: masked,masks
masked: masked
masquerade: masquerading
mass: mass,masses
massage: massaged,massaging
mast: mast,masts
master: master,masters
masterpiece: masterpiece,masterpieces
masterwork: masterworks
masthead: mastheads
masting: masting
mat: mat,mats
matapan: matapan
match: match
matchless: matchless
mate: mate,mates
material: material,materials
mathematical: mathematical
mathematically: mathematically
mathematics: mathematics
matter: matter,mattered,matters
matting: matting
mattock: mattock,mattocks
mattress: mattress
maturity: maturity
maxillary: maxillary
maximum: maximum
maze: mazes
meager: meager
meal: meal,meals
mealtime: mealtime
meaning: meaning
meaningful: meaningful
measure: measure,measured,measures,measuring
meat: meat
meaty: meaty
mechanic: mechanic,mechanics
mechanical: mechanical
mechanically: mechanically
mechanism: mechanism,mechanisms
medal: medals
meddle: meddling
medical: medical
medicine: medicine
meditate: meditating
meditation: meditations
mediterranean: mediterranean
medium: medium
medusa: medusas
meekly: meekly
meet: meet,meeting,met
melancholy: melancholy
melanesia: melanesia
melanesian: melanesian
melbourne: melbourne
meleagrina: meleagrina
melodious: melodious
melody: melodies
melon: melon
melt: melted,melting
membrane: membrane,membranes
memento: mementos
memoirs: memoirs
memorable: memorable
memorial: memorial
memory: memories,memory
menagerie: menagerie
mental: mental
mention: mention,mentioned,mentioning,mentions
mentor: mentor
menu: menu
mercantile: mercantile
merchandise: merchandise
merchant: merchant
merciless: merciless
mercury: mercury
mercy: mercy
mere: mere
merge: merged,merges,merging
meridian: meridian,meridians
merit: merits
mermaid: mermaid,mermaids
merrily: merrily
mesh: meshes
mess: mess
message: message
messroom: messroom
metal: metal,metals
metallic: metallic
metamorphose: metamorphosing
mete: mete
meteorite: meteorites
meteorology: meteorology
meter: meter,meters
method: method,methods
methodically: methodically
meticulously: meticulously
metric: metric
mew: mews
mexico: mexico
mezzanine: mezzanine
mica: mica
michael: michael
microbiologist: microbiologist
microscopic: microscopic
midas: midas
middle: middle
midnight: midnight
midocean: midocean
midpoint: midpoint
midst: midst
mightily: mightily
mighty: mighty
migrate: migrated,migrating
migratory: migratory
mild: mild,mildest
mildly: mildly
mile: mile,miles
military: military
milk: milk
milky: milky
mille: mille
millennium: millennia
milligram: milligram
millimeter: millimeter,millimeters
millipede: millipedes
milo: milo
mimic: mimicked
mimosa: mimosas
minaret: minarets
mind: mind,minds
minded: minded
mindless: mindless
miner: miner,miners
mineral: mineral
mineralogical: mineralogical
minerva: minerva
mingle: mingle,mingled,mingling
miniature: miniature
minimum: minimum
mining: mining
minister: minister
minnow: minnows
minor: minor
minority: minority
mint: mint
minute: minute,minutes
miraculous: miraculous
miraculously: miraculously
mirror: mirror,mirrored,mirrors
mirroring: mirroring
misanthropic: misanthropic
misanthropy: misanthropy
miscalculate: miscalculated
miscarry: miscarried,miscarry
miscellaneous: miscellaneous
misery: misery
misfire: misfire,misfires,misfiring
misfortune: misfortune
mishap: mishap
mislead: misled
misplace: misplaced
misshapen: misshapen
mission: mission
mississippi: mississippi
missouri: missouri
mist: mist,mists
mistake: mistake,mistaken,mistaking,mistook
mistaken: mistaken
mistreat: mistreated
misty: misty
misunderstand: misunderstood
miter: miter
mix: mix,mixed,mixing
mixture: mixture
mizzen: mizzen
moan: moan,moaning
mocha: mocha
mock: mocking
mockery: mockery
mode: mode
model: model,modeled
moderate: moderate
moderately: moderately
moderation: moderation
modern: modern,moderns
modest: modest
modifier: modifiers
modulate: modulated
mohammed: mohammed
moist: moist
mold: mold,molded,molds
moldy: moldy
molecule: molecule
mollusca: mollusca
mollusk: mollusk,mollusks
molten: molten
molucca: molucca
moment: moment,moments
momentarily: momentarily
momentary: momentary
momentum: momentum
monastic: monastic
money: money
monitor: monitor,monitored
monk: monk
monkey: monkey
monodelphia: monodelphia
monogamy: monogamy
monogram: monogram
monomania: monomania
monotonous: monotonous
monotony: monotony
monroe: monroe
monsoon: monsoon,monsoons
monster: monster,monsters
monstrous: monstrous
montague: montague
month: month,months
montreal: montreal
monument: monument
monumental: monumental
mood: mood,moods
moon: moon,moons
moonbeam: moonbeams
moonfish: moonfish
moonlike: moonlike
moor: moored
mooring: mooring,moorings
moral: moral
moravian: moravian
moray: moray
morbid: morbid
morning: morning,mornings
morsel: morsel
mortal: mortal
mortally: mortally
mortician: morticians
mosaic: mosaic
moses: moses
mosque: mosques
moss: moss
mother: mother
motif: motifs
motion: motion,motioned,motions
motionless: motionless
motive: motives
motor: motor
mottled: mottled
motto: motto
mound: mound
mount: mounted,mounting
mountain: mountain,mountains
mountaineer: mountaineers
mountainous: mountainous
mountains: mountains
mounting: mounting,mountings
mouth: mouth,mouths
movable: movable
movement: movement,movements
moving: moving
mow: mow
mozambique: mozambique
mozart: mozart
mucilage: mucilage
mucilaginous: mucilaginous
mucus: mucus
mud: mud
muddle: muddled
muddled: muddled
muffled: muffled
mulberry: mulberry
mull: mulling
mullet: mullet
multilobed: multilobed
multiple: multiple
multiply: multiply
mumble: mumbled
murder: murder
murderous: murderous
murex: murex
murillo: murillo
murky: murky
murmur: murmur,murmured
murmuring: murmuring
murray: murray
muscat: muscat
muscle: muscle,muscled,muscles
muscular: muscular
muse: mused,musing
museum: museum,museums
mushroom: mushroom,mushrooms
music: music
musical: musical
musician: musician
musing: musings
musky: musky
mussel: mussel,mussels
mustache: mustache
muster: muster
mute: mute
mutilate: mutilated
mutiny: mutiny
mutter: mutter,muttered,muttering
muzzle: muzzle
myosotis: myosotis
myriad: myriads
myriameter: myriameter
myrtle: myrtle
mysid: mysid
mysteries: mysteries
mysterious: mysterious
mysteriously: mysteriously
mystery: mysteries,mystery
mystifying: mystifying
myth: myth,myths
mythological: mythological
nag: nagged
nail: nailed,nails
naked: naked
napoleon: napoleon
narrate: narrate
narrative: narrative,narratives
narrator: narrator
narrow: narrow,narrower,narrows
narwhale: narwhale,narwhales
nasal: nasal
nasty: nasty
nation: nation,nations
national: national
nationality: nationalities,nationality
native: native,natives
natural: natural
naturalist: naturalist,naturalists
naturally: naturally
nature: nature
natured: natured
nausea: nausea
nautical: nautical
nautilus: nautilus
naval: naval
navel: navel
navigable: navigable
navigate: navigate,navigated,navigates,navigating
navigation: navigation
navigational: navigational
navigator: navigator,navigators
navy: navies,navy
nea: nea
nearer: nearer
neat: neat
neatly: neatly
nebraska: nebraska
necessity: necessities
neck: neck,necks
necklace: necklace,necklaces
ned: ned
needle: needle,needles
needless: needless
needlessly: needlessly
negative: negative
neglect: neglect,neglected,neglecting
negotiate: negotiate,negotiated
negro: negro
negroes: negroes
neighbor: neighboring,neighbors
neighborhood: neighborhood,neighborhoods
neighboring: neighboring
nemo: nemo
neptune: neptune
nereocystis: nereocystis
nerve: nerve,nerves
nervous: nervous
nest: nest,nested,nests
nether: nether
nettle: nettles
network: network,networks
neutralize: neutralize
newcastle: newcastle
newfoundland: newfoundland
newly: newly
news: news
newspaper: newspaper,newspapers
nice: nice
nicely: nicely
nick: nick
nickname: nickname,nicknamed,nicknames
nicolas: nicolas
nicotine: nicotine
night: night,nights
nightfall: nightfall
nightmare: nightmares
nighttime: nighttime
nil: nil
nile: nile
nimble: nimble
nimbleness: nimbleness
nimbly: nimbly
nineteen: nineteen
ninth: ninth
nip: nip
nipple: nipples
nitrogen: nitrogen
nobility: nobility
nobleman: nobleman
noctiluca: noctiluca
nocturnal: nocturnal
nodule: nodules
noise: noise,noises
noiselessly: noiselessly
noisily: noisily
noisy: noisy
nonexistent: nonexistent
noon: noon
noonday: noonday
noontime: noontime
noose: noose
normal: normal
normandy: normandy
north: north
northbound: northbound
northeast: northeast
northeasterly: northeasterly
northerly: northerly
northern: northern
northernmost: northernmost
northward: northward
northwest: northwest
northwestern: northwestern
norway: norway
norwegian: norwegian,norwegians
nose: nose,noses
nostril: nostrils
nostrum: nostrum
notable: notable
note: note,notes
notice: notice,noticed,notices,noticing
noticeable: noticeable
noticeably: noticeably
notion: notion,notions
notorious: notorious
nourish: nourishes
nourishing: nourishing
nourishment: nourishment
nova: nova
novelty: novelty
november: november
nowadays: nowadays
noxious: noxious
nubile: nubile
nucleus: nucleus
nudge: nudged
nuisance: nuisance
numb: numb
numbering: numbering
numerous: numerous
nurse: nurse
nurture: nurtured
nut: nuts
nutmeg: nutmeg,nutmegs
nutrient: nutrients
nutritious: nutritious
nuts: nuts
nutshell: nutshell
nyctalopic: nyctalopic
nymph: nymph,nymphs
oaken: oaken
oar: oar,oars
oarsman: oarsmen
ob: ob
obedience: obedience
obedient: obedient
obediently: obediently
obelisk: obelisk
obey: obey,obeyed,obeying
obituary: obituary
object: object,objected,objecting,objects
objection: objection,objections
oblige: oblige,obliged
oblique: oblique
obliquely: obliquely
obliterate: obliterate
oblivion: oblivion
oblivious: oblivious
oblong: oblong
obscure: obscure
observation: observation,observations
observatory: observatory
observe: observe,observed,observing
observer: observers
obsess: obsessed
obsession: obsessions
obsessive: obsessive
obsidian: obsidian
obstacle: obstacle,obstacles
obstinate: obstinate
obstruct: obstruct,obstructed
obvious: obvious
occasion: occasion,occasions
occasional: occasional
occasionally: occasionally
occupant: occupants
occupation: occupation
occupational: occupational
occupy: occupied,occupies,occupy,occupying
occur: occur,occurred,occurring,occurs
occurrence: occurrence
ocean: ocean,oceans
oceania: oceania
oceanic: oceanic
oceanographer: oceanographer
oceans: oceans
octagonal: octagonal
october: october
oculina: oculina
odd: odd
odor: odor
oedipus: oedipus
offense: offense
offensive: offensive
offer: offer,offered,offering,offers
offhand: offhand
office: office
officer: officer,officers
official: official
offshore: offshore
oho: oho
oil: oil
oily: oily
olden: olden
oliva: oliva
olive: olive
oman: oman
omar: omar
ongoing: ongoing
onward: onward
ooze: ooze,oozed,oozing
opah: opahs
opalescent: opalescent
opaline: opaline
opaque: opaque
openly: openly
operate: operate,operated,operates,operating
operation: operation,operations
operative: operative
operator: operator
opinion: opinion
oppian: oppian
opponent: opponent,opponents
opportunity: opportunities,opportunity
oppose: opposed
oppressed: oppressed
oppressor: oppressor,oppressors
optical: optical
option: option
opulent: opulent
orange: orange
orator: orators
orb: orb
orbital: orbital
orchid: orchids
ordeal: ordeal
ordinarily: ordinarily
ordinary: ordinary
organ: organ,organs
organic: organic
organism: organism,organisms
organization: organization
organize: organized,organizing
orient: orient
oriental: oriental
orientals: orientals
origin: origin,origins
original: original,originals
originally: originally
originate: originate,originated,originating
orion: orion
orpheus: orpheus
osprey: ospreys
ostracod: ostracod,ostracods
ostrea: ostrea
otherworldly: otherworldly
otter: otter,otters
ottoman: ottoman
ounce: ounce
outbound: outbound
outburst: outburst,outbursts
outcome: outcome
outdistance: outdistanced
outdo: outdoing
outer: outer
outfit: outfits
outflow: outflow
outgrowth: outgrowths
outlandish: outlandish
outlet: outlet
outline: outline,outlined,outlines
outlook: outlook
outpace: outpace
outpouring: outpouring,outpourings
output: output
outrageous: outrageous
outright: outright
outrun: outrun
outset: outset
outskirts: outskirts
outstanding: outstanding
outstretched: outstretched
outstrip: outstrip
outward: outward
outweigh: outweigh
outwit: outwit
oval: oval
oven: oven
overboard: overboard
overcast: overcast
overcome: overcame,overcome
overdo: overdo
overflow: overflowing
overhang: overhang,overhanging,overhangs
overhaul: overhauling
overhead: overhead
overhear: overhears
overjoy: overjoyed
overlap: overlap,overlapping
overlay: overlaid
overload: overloaded
overpower: overpower,overpowered
override: override
overriding: overriding
overrun: overran,overrun
oversleep: overslept
overstate: overstating
overtake: overtake,overtaken,overtook
overturn: overturned
overwhelm: overwhelming
overwhelmed: overwhelmed
overwhelming: overwhelming
overwrought: overwrought
owe: owe,owed
ownership: ownership
oxygen: oxygen
oxyrhynchus: oxyrhynchus
oyster: oyster,oysters
pace: pace,paces
pacific: pacific
pacing: pacing
pack: pack,packed,packing,packs
packed: packed
padded: padded
padding: padding
paddle: paddle
paddlefish: paddlefish
paddler: paddlers
pain: pain,pains
painful: painful
painfully: painfully
paint: paint,painted
painter: painter,painters
painting: paintings
pair: pair,pairs
palace: palace,palaces
palate: palate
pale: pale
palea: palea
palette: palette
pallbearer: pallbearers
pallid: pallid
pallor: pallor
palm: palm,palms
palmistry: palmistry
pamper: pampered
pamphlet: pamphlets
pan: pan
panama: panama
pandora: pandora
pane: panes
panel: panel,panels
paneling: paneling
panels: panels
panoply: panoplies
panther: panthers
panting: panting
pantry: pantry
pants: pants
paper: paper,papers
papua: papua
papuan: papuan,papuans
parade: paraded
paradise: paradise
paragon: paragons
parakeet: parakeet,parakeets
parallel: parallel
paralysis: paralysis
paralyze: paralyzed,paralyzes,paralyzing
paralyzed: paralyzed
paramatta: paramatta
parasitic: parasitic
parasol: parasols
parching: parching
pardon: pardon
parent: parents
paris: paris
parker: parker
parody: parodied
parrot: parrot,parrots
parrotfish: parrotfish
parthenon: parthenon
parthenope: parthenope
participate: participated,participating
particle: particles
partition: partitions
partly: partly
partner: partner
partridge: partridge
party: party
pass: pass,passed,passes,passing
passably: passably
passage: passage,passages
passageway: passageway,passageways
passenger: passenger,passengers
passing: passing
passion: passion,passions
passionate: passionate
pasta: pasta
pastime: pastimes
pastry: pastry
pasture: pasture
patagonia: patagonia
patagonian: patagonian
patch: patch,patched,patches
patent: patent
path: path,paths
patience: patience
patient: patient
patrick: patrick
patriot: patriot
patriotic: patriotic
patronize: patronize,patronizes
patter: patter,pattering
pattern: pattern
paul: paul
pause: paused,pauses,pausing
pave: paved
paw: paws
pay: paid,pay,payed,paying,pays
peace: peace
peaceful: peaceful
peacefully: peacefully
peacock: peacock
peak: peak,peaks
pear: pear
pearl: pearl,pearls
pearly: pearly
pebble: pebbles
peck: pecks
pectinibranchia: pectinibranchia
pectoral: pectoral,pectorals
peculiar: peculiar
peculiarity: peculiarities
pedestal: pedestal,pedestals
peer: peer,peered,peering,peers
peg: pegs
pelican: pelicans
pelt: pelt
pelvic: pelvic
pelvis: pelvises
pen: pen
pencil: pencil
penetrate: penetrate,penetrated,penetrates,penetrating
penguin: penguin
peninsula: peninsula
peninsular: peninsular
pennant: pennant
penny: penny
people: peoples
peppery: peppery
percent: percent
perceptible: perceptible
perception: perception
perch: perch,perched
percha: percha
percival: percival
perdition: perdition
perennial: perennial
perfect: perfect,perfected
perfection: perfection
perfectly: perfectly
perforate: perforate,perforating
perform: perform,performed
performance: performance
perfume: perfumes
perfumed: perfumed
peril: perils
perimeter: perimeter
period: period
periodic: periodic
periodical: periodicals
perish: perish,perished,perishes,perishing
periwinkle: periwinkles
perk: perk
permanent: permanent
permanently: permanently
permeability: permeability
permeate: permeated,permeating
permission: permission
permit: permit,permitted
perpendicular: perpendicular
perpendicularity: perpendicularity
perpendicularly: perpendicularly
perpetual: perpetual
perpetually: perpetually
perplexed: perplexed
perplexing: perplexing
persecute: persecuted
persecutor: persecutor
persia: persia
persian: persian
persist: persisted
persistence: persistence
person: people,person,persons
personal: personal
personality: personality
personally: personally
personification: personification
perspiration: perspiration
perspire: perspire
persuade: persuade,persuading
persuasion: persuasion
pertinent: pertinent
pet: pets
petal: petals
peter: peter,petered
petrel: petrel,petrels
petrification: petrification
petrified: petrified
phaedra: phaedra
phaeton: phaeton
phantasmagoric: phantasmagoric
phantom: phantoms
pharaoh: pharaoh
phase: phase
pheasant: pheasant,pheasants
phenomenal: phenomenal
phenomenon: phenomena,phenomenon
philanthropy: philanthropy
philip: philip
philippe: philippe
philological: philological
philosopher: philosopher,philosophers
philosophical: philosophical
philosophically: philosophically
philosophize: philosophize
phosphate: phosphate
phosphorescence: phosphorescence
phosphorescent: phosphorescent
phosphorous: phosphorous
photograph: photograph,photographed
photographic: photographic
phrase: phrase,phrases
phrasing: phrasing
physalia: physalia
physeter: physeter
physical: physical
physician: physician
physicist: physicist
physics: physics
physiological: physiological
piano: piano
pick: pick,picked,picking,picks
pickle: pickling
picture: picture,pictures
picturesque: picturesque
picturesqueness: picturesqueness
pie: pie
piece: piece,pieces
pier: pier
pierce: pierce,pierced,pierces,piercing
pierre: pierre
pig: pig,pigs
pigeon: pigeon,pigeons
pigment: pigments
pike: pike
pile: pile,piled,piles,piling
pilgrim: pilgrim
pillar: pillars
pillars: pillars
pillow: pillow
pilot: pilot,piloting
pilothouse: pilothouse
pin: pin,pinned
pincer: pincer
pincers: pincers
pinch: pinch
pine: pine,pines
pineapple: pineapples
pinecone: pinecone
pink: pink
pinkish: pinkish
pinnipedia: pinnipedia
pinpoint: pinpoint,pinpointed
pioneer: pioneer
pioneering: pioneering
pious: pious
pipe: pipe,pipes
pipefish: pipefish
piper: pipers
piping: piping
pirate: pirates
pisang: pisang
piston: pistons
pit: pit,pits,pitted
pitch: pitch,pitched,pitching
pitching: pitching
pitiful: pitiful
pitiless: pitiless
pitter: pitter
pity: pity
placate: placate
placid: placid
placidly: placidly
plague: plague,plagued
plaice: plaice
plain: plain,plains
plainly: plainly
plains: plains
plan: plan,planned,plans
plane: plane
planet: planet,planets
plank: planks
planking: planking
plant: plant,planted,plants
plaque: plaque
plaster: plastered
plate: plate,plated,plates
plateau: plateau
plates: plates
platform: platform
plating: plating
platinum: platinum
plato: plato
platter: platter,platters
plausible: plausible
play: play,played,playing
playful: playful
playing: playing
playwright: playwright
plea: plea
plead: pleaded
pleading: pleadings
pleasant: pleasant
pleased: pleased
pleasure: pleasure
pledge: pledge
plenty: plenty
pliers: pliers
pliny: pliny
plot: plot,plots
plow: plow,plowed,plowing
pluck: plucked
plug: plugged
plumage: plumage
plummet: plummet
plump: plump
plumularia: plumularia
plunge: plunge,plunged,plunging
pluto: pluto
plutonic: plutonic
ply: plied,plying
pneumatic: pneumatic
po: po
poacher: poachers
pock: pocked
pocket: pocket,pockets
poe: poe
poem: poem
poet: poet,poets
poetic: poetic
poetically: poetically
poetry: poetry
pointless: pointless
poise: poised
poison: poison,poisoned
poisonous: poisonous
poke: poked,poking
poland: poland
polar: polar
pole: pole,poles
poles: poles
policy: policy
polish: polish,polished
polished: polished
polite: polite
politeness: politeness
political: political
polyp: polyp,polyps
polypary: polyparies,polypary
pompeii: pompeii
ponder: pondered,pondering
ponderously: ponderously
pool: pool
poor: poor,poorer
pop: pop,popped,popping
popular: popular
populate: populate,populated,populating
populated: populated
populous: populous
porcelain: porcelain
porcupine: porcupines
pore: pore,pored,pores
porgy: porgies,porgy
pork: pork
porphyra: porphyra
porphyry: porphyry
porpita: porpita
porpoise: porpoise,porpoises
port: port,ports
portfolio: portfolio
portland: portland
portrait: portrait,portraits
portray: portray,portrayed,portrays
portrayal: portrayal
portugal: portugal
portuguese: portuguese
pose: poses
position: position,positioned,positioning,positions
positive: positive
positively: positively
possess: possess,possessed
possession: possession
possessive: possessive
possibility: possibility
post: post,posted
postal: postal
postpone: postpone
posture: posture,postures
pot: pot
potassium: potassium
potent: potent
potential: potential
potshot: potshots
potter: potter
pouch: pouch,pouches
poultice: poultice
pounce: pounce,pounced
pound: pound,pounding,pounds
pounder: pounder
pour: poured,pouring
powder: powder,powdered
power: power,powers
powerful: powerful
powerfully: powerfully
powerless: powerless
practical: practical
practically: practically
practice: practice,practices
prairie: prairie,prairies
praise: praise,praised
praiseworthy: praiseworthy
prance: prancing
prankster: pranksters
prawn: prawns
pray: pray,praying
prayer: prayer
preamble: preamble
prearrange: prearranged
precaution: precaution,precautions
precious: precious
precise: precise
precisely: precisely
precision: precision
predate: predating
predator: predators
predetermine: predetermined
predicament: predicament
predict: predict,predicted,predicts
predominate: predominated,predominates
prefer: prefer,preferred,prefers
preferable: preferable
preference: preference
pregnant: pregnant
prehistoric: prehistoric
preliminary: preliminary
premature: premature
prematurely: prematurely
premium: premium
preoccupied: preoccupied
preparation: preparations
prepare: prepare,prepared,preparing
prepared: prepared
preposition: preposition
presence: presence
preservation: preservation
preserve: preserve,preserved,preserves,preserving
president: president
press: press,pressed,pressing
pressure: pressure,pressures
presume: presume
pretend: pretended
pretty: pretty
prevail: prevailing
prevent: prevent,prevented
previous: previous
prey: prey
price: price,priced,prices
prickle: prickles
prickly: prickly
pride: pride
prime: prime
primitive: primitive
primo: primo
primordial: primordial
prince: prince
principle: principle
print: print
prior: prior
prism: prism,prisms
prison: prison,prisons
prisoner: prisoner,prisoners
privacy: privacy
private: private
privilege: privilege
privy: privy
prize: prize,prized
pro: pros
probable: probable
probe: probe,probing
proboscis: proboscis
procedure: procedure,procedures
proceed: proceed,proceeded,proceeding
proceeds: proceeds
procellaria: procellaria
process: process,processes
processor: processor
prod: prodded
prodigious: prodigious
prodigiously: prodigiously
prodigy: prodigy
produce: produce,produced,produces,producing
product: products
productive: productive
productively: productively
profane: profane
profess: professed
profession: profession
professional: professional
professor: professor
professorial: professorial
profile: profile
profit: profit,profits
profound: profound
profoundly: profoundly
profusion: profusion
program: program
progress: progress
progression: progression
progressive: progressive
progressively: progressively
project: project,projects
projectile: projectile
proliferate: proliferating
prolong: prolonged
prominence: prominence
prominent: prominent
prominently: prominently
promise: promise,promised,promises,promising
promising: promising
promontory: promontory
promote: promote
prompt: prompted
promptness: promptness
prone: prone
pronged: pronged
pronounce: pronounce,pronounced,pronouncing
pronounced: pronounced
proof: proof
prop: propped
propagate: propagating
propagation: propagation
propel: propel,propelled
propeller: propeller,propellers
proper: proper
properly: properly
property: properties,property
proportion: proportion,proportioned,proportions
proportionate: proportionate
propose: propose,proposed
proposition: proposition
pros: pros
prospect: prospect
protect: protect,protected,protects
protection: protection
protectorate: protectorate
protein: protein
protest: protest
protestant: protestants
proteus: proteus
prototype: prototype
protract: protracted
protrude: protrude,protrudes,protruding
protrusion: protrusion
protuberance: protuberances
protuberant: protuberant
prove: prove,proved,proven,proves,proving
provence: provence
provide: provide,providing
province: province,provinces
provision: provision,provisions
proviso: proviso
provoke: provoke,provoked,provoking
prow: prow
proximity: proximity
prudent: prudent
prussia: prussia
pry: prying
psychic: psychic
pteropod: pteropods
ptolemy: ptolemy
public: public
publish: published
publisher: publisher
pucker: puckering
pudding: pudding
puff: puff
puffer: puffers
puffin: puffins
pull: pull,pulled,pulling,pulls
pulley: pulleys
pulp: pulp,pulps
pulsation: pulsations
pulse: pulse
pulverize: pulverize
pumice: pumice
pump: pump,pumps
punch: punch
punctilious: punctilious
puncture: puncture,punctured,punctures
punish: punished
punishment: punishment
puny: puny
pupil: pupils
purchase: purchase,purchased
pure: pure
purely: purely
purgative: purgative
purge: purge,purged
purification: purification
purple: purple
purplish: purplish
purpose: purpose,purposes
pursed: pursed
pursue: pursue,pursued,pursuing
pursuit: pursuit,pursuits
push: push,pushed,pushing
putty: puttied
puzzle: puzzled
puzzled: puzzled
pyramid: pyramid,pyramids
pyrenees: pyrenees
quadrangle: quadrangle
quadrangular: quadrangular
quadrilateral: quadrilateral
quadruped: quadruped,quadrupeds
quake: quaked
qualify: qualify
quality: qualities,quality
quantity: quantities,quantity
quarrel: quarreled
quart: quart
quarter: quarter,quartered,quarters
quartet: quartet
quarto: quarto
quartz: quartz
quash: quashed
queasiness: queasiness
quebec: quebec
queen: queen
query: queried
quest: quest
question: question,questioned,questioning,questions
questionable: questionable
quick: quick,quicker
quickness: quickness
quicksand: quicksand
quicksilver: quicksilver
quiet: quiet
quietus: quietus
quill: quill,quills
quintillion: quintillion
quinto: quinto
quit: quit
quiver: quivered,quivering
quote: quote,quoted
quotient: quotient
rabbit: rabbit
rabbitfish: rabbitfish
rabelais: rabelais
rabelaisian: rabelaisian
race: race,raced,races,racing
racer: racers
racing: racing
radiance: radiance
radiant: radiant
radiate: radiated,radiating
radiation: radiation
radius: radius
rag: rags
rage: rage,raging
ragged: ragged
rail: rail
railing: railing,railings
railroad: railroad
railway: railways
rain: rain,raining,rains
rainbow: rainbow
rainfall: rainfall
rainy: rainy
raise: raise,raised,raises,raising
raja: rajahs
rally: rallied
ram: ram,rammed,rams
ramble: rambled
ramming: ramming
rampage: rampaging
ramrod: ramrod
rancorous: rancorous
rand: rand
random: random
range: range,ranging
rank: rank,ranked,ranks
ransack: ransack
rant: ranted
raphael: raphael
rare: rare,rarest
rarely: rarely
rarity: rarities,rarity
ras: ras
rascal: rascal
rash: rash
rat: rat
rate: rate,rates
rating: rating
ratio: ratio
ration: ration
rattle: rattle,rattling
raucously: raucously
ravage: ravage
raw: raw
ray: ray,rays
rays: rays
reach: reach,reached,reaches,reaching
reaction: reaction
read: read,reading
readable: readable
reader: reader
readiness: readiness
reading: reading,readings
readjust: readjusted
ready: ready
real: real
realism: realism
reality: realities,reality
realize: realize,realized
realm: realm
reap: reaps
reappear: reappear,reappeared
reappearance: reappearance
rear: rear,reared,rearing
reason: reason,reasoned,reasons
reasonable: reasonable
reassure: reassure,reassured
rebel: rebel,rebelled,rebels
rebellion: rebellion
rebuild: rebuilt
rebuke: rebuked
recalcitrant: recalcitrant
recall: recall,recalled
recapture: recaptured
recede: recede,receding
receive: receive,received,receives
receptacle: receptacles
reception: reception
recipient: recipient
recite: reciting
reckless: reckless
recklessly: recklessly
recklessness: recklessness
reckon: reckoning
reckoning: reckoning,reckonings
reclusiveness: reclusiveness
recognize: recognize,recognized,recognizes
recoil: recoil,recoiled
recollection: recollection
recommend: recommend,recommended
recommendation: recommendation
reconcile: reconcile,reconciled
reconstruct: reconstruct
record: record,recorded
recover: recover,recovered,recovering
recruit: recruit
recur: recurring
red: red,reds
redden: reddened
reddish: reddish
redemption: redemption
redheaded: redheaded
redo: redid
reduce: reduce,reduced
reduction: reduction
reed: reed
reef: reef,reefs
reek: reeking
reel: reel,reeling
reenact: reenacted
reenter: reenter,reentered,reentering
reexamination: reexamination
refer: referred,referring
refine: refined
refined: refined
refining: refining
reflect: reflect,reflected,reflecting
reflection: reflection,reflections
reflector: reflector
refract: refracted
refraction: refraction
refrain: refrain,refrained
refresh: refreshed,refreshing
refuge: refuge
refuse: refuse,refused
refute: refuted
regain: regain,regained
regard: regard,regarded
regeneration: regeneration
regime: regime
regiment: regiment
region: region,regions
register: register
regret: regret,regrets,regretted
regrettable: regrettable
regular: regular
regularity: regularity
regularly: regularly
regulate: regulated
regulation: regulation,regulations
regulator: regulators
reign: reign,reigned,reigning,reigns
rein: rein
reincarnation: reincarnation
reinforce: reinforced
reinstate: reinstated
reject: rejected,rejecting
rejoin: rejoin,rejoined,rejoining
rekindle: rekindled
relate: relate,relates
relation: relation,relations
relationship: relationship
relative: relative,relatives
relay: relayed
release: release,released,releasing
relegate: relegated,relegating
relentlessly: relentlessly
relevance: relevance
relevant: relevant
reliability: reliability
reliable: reliable
relic: relics
relief: relief
relieve: relieved,relieving
religious: religious
relinquish: relinquish
relish: relish
relive: relive,reliving
relocate: relocate
reluctant: reluctant
rely: rely,relying
remain: remain,remained,remaining,remains
remains: remains
remark: remark,remarked,remarks
remarkable: remarkable
remember: remember,remembered
remind: remind,reminded,reminding
remiss: remiss
remnant: remnants
remora: remora,remoras
remorse: remorse
remote: remote
remotely: remotely
remove: remove,removed,removing
renaissance: renaissance
rename: renaming
render: render,rendered
rendering: rendering
renegade: renegade
renew: renew,renewed,renewing
renounce: renounced
renowned: renowned
reopen: reopen,reopened
repair: repair,repaired,repairs
repay: repay
repeat: repeat,repeated,repeating
repeatedly: repeatedly
repent: repent
repentance: repentance
replace: replace,replaced
replenish: replenish,replenished
reply: replied,replies,reply,replying
report: report,reported,reports
reposition: repositioned
reprehensible: reprehensible
represent: represent,represented
representative: representative,representatives
reprint: reprinted
reprisal: reprisals
reproduce: reproduce,reproduces
reproduction: reproduction
reptile: reptile,reptiles
republic: republic
repulse: repulsing
repulsive: repulsive
reputation: reputation,reputations
reputedly: reputedly
request: request
requiem: requiem
requin: requin
require: required
requirement: requirement
requisite: requisite
reread: reread,rereading
rescue: rescue,rescued
resemble: resemble,resembled,resembling
resent: resented
resentment: resentment
reservation: reservations
reserve: reserve,reserves
reside: reside,resided
residence: residence
resident: resident,residents
residue: residue
resign: resign,resigned
resignation: resignation
resin: resin
resist: resist,resisting,resists
resistance: resistance
resistant: resistant
resisting: resisting
resolutely: resolutely
resolve: resolve
resonant: resonant
resonantly: resonantly
resonate: resonating
resort: resort,resorted
resound: resounded
resource: resource,resources
respect: respect
respectable: respectable
respectful: respectful
respiratory: respiratory
respond: respond
responsibility: responsibility
responsible: responsible
rest: rest,rested,resting,rests
restaurant: restaurant
resting: resting
restore: restore,restored,restoring
restrict: restrict,restricting
resubmerge: resubmerged
result: result
resume: resume,resumed,resumes
resurrect: resurrected
resurrection: resurrection
retaliation: retaliation
reticular: reticular
retina: retina
retire: retire
retrace: retracing
retract: retracted
retreat: retreat,retreated,retreating
retrieve: retrieve,retrieved
return: return,returned,returning,returns
reveal: reveal,revealed,reveals
revenge: revenge,revenged
reverberate: reverberated,reverberating
reverently: reverently
reverie: reverie
reverse: reverse,reversing
revert: reverted
review: review,reviewed,reviewing
revive: revive,revived,reviving
revolution: revolution,revolutions
revolutionary: revolutionary
revolving: revolving
revulsion: revulsion
reward: rewards
rewarding: rewarding
rework: reworked
rewrite: rewriting
rhine: rhine
rhinoceros: rhinoceroses
rhizostome: rhizostome
rhodes: rhodes
rhodymenia: rhodymenia
rhomboid: rhomboid
rhumb: rhumb
rib: ribs
ribald: ribald
ribbon: ribbon,ribbons
riblike: riblike
rich: rich,richest
richard: richard
richly: richly
ricochet: ricochet,ricocheted
rid: rid
riddle: riddled
riddled: riddled
ride: ride,rides,riding,rode
rider: rider,riders
ridge: ridge,ridges
ridicule: ridiculed
ridiculous: ridiculous
ridiculously: ridiculously
rifle: rifle,rifles
rift: rift
rig: rigged
rigging: rigging
rightfully: rightfully
rigid: rigid
rigidity: rigidity
rigorous: rigorous
rigorously: rigorously
riled: riled
rim: rim
rima: rima
ringdove: ringdove,ringdoves
rio: rio
riot: riot
rip: rip,ripped,ripping
ripe: ripe
ripen: ripening,ripens
ripple: rippled,ripples
rise: rise,risen,rises,rising,rose
risk: risk,risked,risks
ritual: ritual
rival: rival,rivaled,rivaling
river: river,rivers
rivet: riveted,rivets
road: road,roads
roam: roam
roar: roar,roaring,roars
roast: roast
roasted: roasted
rob: robbed
robber: robber
robert: robert
robin: robins
robust: robust
rock: rock,rocked,rocking,rocks
rocking: rocking
rocky: rockier,rocky
rod: rod,rods
rogue: rogues
roguedom: roguedom
role: role,roles
roll: roll,rolled,rolling,rolls
rolling: rolling
roman: roman,romans
rome: rome
roof: roof,roofs
roost: roosting
root: root,rooted,roots
rope: rope,ropes
roque: roque
rorqual: rorqual
rose: rose
rosetangle: rosetangle
rosewood: rosewood
ross: ross
rot: rots,rotted,rotting
rotation: rotation
rotational: rotational
roti: roti
rotten: rotten
rough: rough
roughly: roughly
roughness: roughness
rounded: rounded
rouse: rouse
route: route
routine: routine
rove: roving
row: rowed,rows
rower: rowers
rowing: rowing
rowlock: rowlocks
royal: royal
rub: rubbed,rubbing
rubber: rubber
rubble: rubble
rubens: rubens
ruby: ruby
rudder: rudder
rudderfish: rudderfish
ruddy: ruddy
rudimentary: rudimentary
rugged: rugged
ruin: ruin,ruined,ruining,ruins
rule: rule
ruler: rulers
rumble: rumble
rumbling: rumblings
rumor: rumors
runaway: runaway
running: running
rupture: rupture
rush: rush,rushed,rushing
russet: russet
russia: russia
russian: russian
rust: rust
rusting: rusting
ruthless: ruthless
saber: saber
sabrina: sabrina
sack: sack
sacred: sacred
sacrifice: sacrifice,sacrificed,sacrifices,sacrificing
sad: sad
sadden: saddened
saddle: saddle
sadly: sadly
sadness: sadness
safe: safe,safer
safeguard: safeguard
safely: safely
safety: safety
sagely: sagely
sago: sago
sail: sail,sailed,sails
sailboat: sailboats
sailfish: sailfish
sailing: sailing
sailmaker: sailmaker
sailor: sailor,sailors
saint: saint
sainte: sainte
sake: sake
salamander: salamanders
saline: saline
salinity: salinity
salmon: salmon
salp: salps
salt: salt,salts
saltpeter: saltpeter
saltwater: saltwater
salty: saltier,salty
salute: salute,salutes
salvation: salvation
samoa: samoa
samphire: samphire
sample: sample,sampled,samples
san: san
sanctuary: sanctuaries
sand: sand,sands
sandbank: sandbanks
sandy: sandy
sanitize: sanitize
sanity: sanity
santa: santa
sap: sap
sapphire: sapphire,sapphires
sarcasm: sarcasm
sarcastic: sarcastic
sarcastically: sarcastically
sardine: sardines
sargasso: sargasso
satellite: satellite,satellites
satirical: satirical
satisfaction: satisfaction
satisfactory: satisfactory
satisfied: satisfied
satisfy: satisfied,satisfy
saturate: saturate,saturated,saturates,saturating
saturation: saturation
saturn: saturn
saunter: saunter
saurian: saurians
savage: savage,savages
save: save,saved,saves
savings: savings
savor: savoring
sawfish: sawfish
saxifrage: saxifrage
saxon: saxon
saxony: saxony
scale: scale,scaled,scales,scaling
scallop: scallops
scaly: scaly
scamper: scampered
scan: scan,scanned
scarce: scarce,scarcer
scarcely: scarcely
scare: scare,scared
scarlet: scarlet
scatter: scattered
scattered: scattered
scene: scene,scenes
scenery: scenery
scenic: scenic
scent: scent,scented,scents
schedule: schedule
scheme: scheme,schemes
scholar: scholars
scholarly: scholarly
school: school,schools
schooner: schooner,schooners
sci: sci
science: science
sciences: sciences
scientific: scientific
scientist: scientist,scientists
scleroderma: scleroderma
scomber: scomber
scoot: scooted
scope: scope
score: score,scored
scorn: scorn,scorning
scorpion: scorpion,scorpions
scorpionfish: scorpionfish
scotia: scotia
scotland: scotland
scott: scott
scottish: scottish
scour: scour,scoured,scouring
scourge: scourge
scramble: scrambles
scrap: scrap
scrape: scraped
scrapings: scrapings
scrawl: scrawl,scrawled,scrawling
screech: screeching
screen: screened
screw: screw,screwed,screwing
script: script
scrollwork: scrollwork
scruff: scruff
scrupulous: scrupulous
scrutinize: scrutinize,scrutinized
scud: scudded
scull: sculls
scullery: scullery
sculling: sculling
sculpt: sculpted
scum: scum
scuttle: scuttled
sea: sea,seas
seafare: seafaring
seafarer: seafarer
seafaring: seafaring
seafloor: seafloor
seagoing: seagoing
seahorse: seahorse
seal: seal,sealed,sealing,seals
sealskin: sealskin
seaman: seaman,seamen
seamen: seamen
seamless: seamless
seaport: seaports
search: search,searched,searching
seas: seas
seascape: seascapes
seashell: seashell,seashells
season: season,seasoned
seasoned: seasoned
seat: seat,seated,seats
seated: seated
seawater: seawater
seaweed: seaweed
seclusion: seclusion
secrecy: secrecy
secret: secret,secrets
secretary: secretary
secrete: secrete,secreted,secretes,secreting
secretion: secretion,secretions
secretive: secretive
secretly: secretly
sector: sector
secure: secure,secured
securely: securely
sedimentation: sedimentation
seed: seed,seeds
seedless: seedless
seek: seek,seeking,sought
seeker: seeker,seekers
seemingly: seemingly
seesaw: seesawed
seethe: seething
seething: seething
seize: seize,seized
seizure: seizure
seldom: seldom
select: selected
selfish: selfish
selfishness: selfishness
selfsame: selfsame
sell: sell,sells,sold
semblance: semblance
semicircle: semicircle
semidarkness: semidarkness
semifluid: semifluid
semiliquid: semiliquid
semiphosphorescent: semiphosphorescent
semispheric: semispheric
send: send,sending,sends
seneca: seneca
senegal: senegal
sensation: sensation,sensations
sense: sense,sensed
sensitive: sensitive
sentence: sentence,sentences
sentinel: sentinels
separate: separate,separated,separates,separating
separately: separately
sepia: sepia
september: september
sequel: sequel
sequence: sequence
sequester: sequestered
serenade: serenade
serene: serene
serenely: serenely
serial: serial
series: series
seriousness: seriousness
serpent: serpent,serpents
serpentine: serpentine
serrano: serrano
servant: servant,servants
serve: serve,served,serves,serving
service: service,services
session: session
sesterce: sesterces
set: set,sets,setting
setback: setbacks
setting: setting,settings
settle: settle,settled,settling
seventeen: seventeen
sever: sever,severed
sextant: sextant
sexto: sexto
shackle: shackle
shad: shad
shade: shade,shaded
shades: shades
shading: shadings
shadow: shadow,shadows
shadows: shadows
shady: shady
shaft: shaft,shafts
shaggy: shaggy
shah: shah
shake: shake,shaken,shaking,shook
shakespeare: shakespeare
shale: shale
shallow: shallow,shallowest
shallows: shallows
shame: shame
shanghai: shanghai
shannon: shannon
shape: shape,shaped,shapes
shaped: shaped
share: share,shared
shark: shark,sharks
sharp: sharp
sharpen: sharpen
sharply: sharply
shatter: shatter,shattered,shatters
shawl: shawl
sheaf: sheaves
shear: shorn
shears: shears
sheath: sheath,sheaths
sheen: sheen
sheep: sheep
sheer: sheer
sheet: sheet,sheets
shelf: shelf,shelves
shellfish: shellfish
shelter: sheltered,shelters
shelve: shelved
shepherd: shepherd
sherlock: sherlock
shetland: shetland
shield: shield,shielded,shields
shift: shift,shifted,shifting
shifting: shifting
shimmer: shimmer
shimmering: shimmering
shine: shine,shines,shining,shone
shiny: shiny
ship: ship,shipped,shipping,ships
shipboard: shipboard
shipowner: shipowner
shipping: shipping
shipside: shipside
shipwreck: shipwreck,shipwrecks
shipwrecked: shipwrecked
shirt: shirts
shiver: shivered,shivering,shivers
shoal: shoal
shock: shock
shod: shod
shoot: shoot,shooting,shoots,shot
shooting: shooting
shore: shore,shores
shoreline: shoreline
short: short
shortage: shortage
shorten: shorten
shot: shot
shoulder: shoulder,shouldered,shoulders
shout: shout,shouted,shouting,shouts
shove: shoved
shower: shower,showering,showers
shred: shred,shredded
shrewd: shrewd,shrewdest
shrewdly: shrewdly
shrimp: shrimp,shrimps
shrink: shrank,shrinking,shrunk
shroud: shrouded,shrouds
shrub: shrubs
shrubbery: shrubbery
shrug: shrug,shrugged,shrugging
shudder: shudder,shuddered
shut: shut,shutting
shutter: shutters
siberia: siberia
siberian: siberian
sicily: sicily
sick: sick
sickle: sickle
sickly: sickly
sickness: sickness
sideboard: sideboards
sidestep: sidestep
sideways: sideways
siege: siege
sierra: sierra
sieve: sieves
sift: sifting
sigh: sigh
sight: sight,sighted,sighting,sights
sighting: sighting
sign: sign,signed,signs
signal: signal,signaled,signaling,signals
significance: significance
silence: silence,silenced
silent: silent
silently: silently
silhouette: silhouette,silhouettes
silica: silica
silk: silk
silken: silken
silkworm: silkworms
silly: silliest,silly
silurian: silurian
silver: silver
silvery: silvery
similarity: similarity
simon: simon
simple: simple,simpler
simply: simply
simultaneous: simultaneous
simultaneously: simultaneously
sin: sin
sincerely: sincerely
sincerity: sincerity
sing: sang
singer: singers
singhalese: singhalese
singing: singing
single: single
sink: sank,sink,sinking,sinks,sunk,sunken
sinker: sinkers
sinking: sinking
siphonula: siphonula
sir: sir
siren: siren
sirenia: sirenia
sirloin: sirloin
sit: sat,sit,sitting
situate: situated
situation: situation
sixteen: sixteen
sixth: sixth
size: size,sizes
sizeable: sizeable
sized: sized
skate: skates
skeleton: skeletons
skelter: skelter
skeptic: skeptics
skeptical: skeptical
skepticism: skepticism
sketch: sketch,sketches,sketching
skewer: skewered
skid: skidding
skiff: skiff
skill: skills
skilled: skilled
skillful: skillful
skillfully: skillfully
skim: skimmed,skimming
skin: skin,skinned,skins
skip: skip
skipper: skippers
skirt: skirted,skirting,skirts
skull: skull
skulled: skulled
sky: skies,sky
skylight: skylight
slab: slabs
slack: slacking
slag: slag
slant: slant,slanting
slantwise: slantwise
slap: slapped
slash: slashed
slate: slate
slaughter: slaughter,slaughtered
slave: slave
slavery: slavery
slavs: slavs
slay: slain,slay,slays
slayer: slayer
slaying: slaying
sleek: sleek
sleep: sleep,sleeping,slept
sleeping: sleeping
sleeve: sleeves
slender: slender,slenderest
slice: slice,sliced,slices
slicing: slicing
slide: slid,slide,sliding
slight: slight,slightest
slim: slim
slime: slime
slimy: slimy
sling: sling,slings
slip: slip,slipped,slipping,slips
slipper: slipper
slippery: slippery
slipup: slipup
slit: slit,slits,slitting
slither: slithered
sloop: sloop,sloops
slope: slope,slopes
slow: slow,slowed,slower
slowly: slowly
slug: slug,slugs
sluggishly: sluggishly
slumber: slumber,slumbered,slumbering
smack: smack
smart: smart,smarter
smash: smash,smashed
smell: smell,smelt
smelter: smelter
smile: smile,smiled,smiling
smith: smith
smithsonian: smithsonian
smoke: smoke,smoked
smoker: smoker
smoking: smoking
smooth: smooth
smother: smother,smothered
snack: snacks
snail: snail,snails
snake: snake,snaked,snakes,snaking
snap: snap,snapped,snapping
snapper: snappers
snare: snares
snarl: snarl,snarls
snatch: snatch,snatched,snatching
sniff: sniffing
snipe: snipe
snipefish: snipefish
snook: snooks
snort: snorts
snout: snout,snouted,snouts
snouted: snouted
snow: snow,snowing
soak: soaked
soap: soap
soapbox: soapbox
soapy: soapy
soar: soared,soaring
sob: sob,sobs
sociable: sociable
social: social
socialism: socialism
society: societies,society
sock: socks
socket: socket
sodium: sodium
soft: soft,softest
soften: softened
softly: softly
soil: soil
solar: solar
solder: solder
soldier: soldier,soldiers
sole: sole,soles
solely: solely
solemn: solemn
solemnly: solemnly
solid: solid
solidarity: solidarity
solidification: solidification
solidify: solidified,solidifies,solidify,solidifying
solidly: solidly
solitary: solitary
solitude: solitude
solomon: solomon
solon: solon
solstice: solstice
solution: solution,solutions
solve: solved
somersault: somersaults
somersaulting: somersaulting
son: son,sons
sonar: sonar
sonority: sonority
sonorous: sonorous
sooner: sooner
soot: soot
soothe: soothe
sooty: sooty
sore: sores
sort: sort,sorting,sorts
sorter: sorters
soul: soul,souls
sound: sound,sounded,sounding,sounds
sounding: soundings
soundless: soundless
soundly: soundly
soup: soup
source: source,sources
sous: sous
south: south
southbound: southbound
southeast: southeast
southeasterly: southeasterly
southeastern: southeastern
southerly: southerly
southern: southern
southernmost: southernmost
southward: southward
southwest: southwest
southwesterly: southwesterly
southwestern: southwestern
sovereign: sovereign
sow: sown
space: space,spaced
spain: spain
spangle: spangled,spangling
spaniards: spaniards
spanish: spanish
spare: spare,spared,spares
sparingly: sparingly
spark: spark,sparks
sparkle: sparkle,sparkled,sparkles,sparkling
sparkling: sparkling
sparrow: sparrow
sparse: sparse
sparta: sparta
sparus: sparus
spasm: spasm,spasms
spatter: spattered
spatula: spatula
speak: speak,speaking,speaks,spoke,spoken
speaking: speaking
spear: spear
special: special
specialist: specialist
specially: specially
species: species
specific: specific
specification: specifications
specimen: specimen,specimens
speck: specks
speckle: speckles
speckled: speckled
spectator: spectator,spectators
spectrum: spectrum
speculation: speculation
speech: speech
speechifying: speechifying
speechless: speechless
speed: sped,speed,speeding,speeds
speedy: speedy
spell: spells
spend: spend,spending,spent
sperm: sperm
spermaceti: spermaceti
spew: spewed
sphere: sphere
spherical: spherical
sphinx: sphinx
spice: spice
spider: spider
spiderweb: spiderweb
spigot: spigot,spigots
spiky: spiky
spill: spilled,spilling
spin: spin,spun
spindle: spindle
spine: spine,spines
spinning: spinning
spiny: spiny
spiral: spiral,spirals
spire: spires
spirit: spirit,spiriting,spirits
spirited: spirited
spirorbis: spirorbis
spit: spit
spite: spite
spitting: spitting
splash: splashed,splashes
splendid: splendid
splendidly: splendidly
splendor: splendors
splice: splice
split: split,splitting
spoil: spoiling,spoils
spokesman: spokesman
sponge: sponge,sponges
spoon: spoon
sporades: sporades
sport: sport,sported,sporting,sports
sporting: sporting
spot: spot,spots,spotted,spotting
spotted: spotted
spout: spout,spouting,spouts
sprawl: sprawled,sprawling
spray: spray,sprayed
spread: spread,spreading,spreads
spring: sprang,spring,springs
springtime: springtime
sprinkle: sprinkled
sprinkled: sprinkled
sprout: sprout,sprouted
spur: spur,spurred,spurring
spurge: spurges
spurn: spurning
spurt: spurt
spy: spied
spyglass: spyglass,spyglasses
spyglasses: spyglasses
squadron: squadron
squall: squall,squalls
squalus: squalus
square: square
squashed: squashed
squat: squat
squeeze: squeeze,squeezed
squid: squid
squirm: squirming
squirrelfish: squirrelfish
stab: stab,stabs
stabilize: stabilizing
stabilizer: stabilizer
stable: stable
stack: stacks
staff: staff
stage: stages
stagger: staggered,staggers
staggering: staggering
stair: stair
staircase: staircases
stake: stake,staked
stalk: stalks
stalklike: stalklike
stalwart: stalwart
stamp: stamped,stamping
stance: stance
stand: stand,standing,stands,stood
standard: standard
standpoint: standpoint,standpoints
star: star,stars
starboard: starboard
starch: starch
stare: stare,stared,stares,staring
starfish: starfish
stark: stark
start: start,started,starting,starts
starting: starting
startle: startle,startled,startles,startling
startled: startled
startling: startling
starvation: starvation
starve: starve
stash: stashing
stateroom: stateroom
static: static
station: stationed
stationary: stationary
statistics: statistics
statue: statues
stature: stature
status: status
stave: stave,staved
stay: stay,stayed,staying
steadily: steadily
steadiness: steadiness
steady: steadier,steady
steak: steaks
steal: steal,stealing,stole
steam: steam,steaming
steamboat: steamboat,steamboats
steamer: steamer,steamers
steamship: steamship
steel: steel
steep: steep,steeper,steepest
steeply: steeply
steer: steer,steered,steering,steers
steering: steering
stellar: stellar
stem: stem,stems
stempost: stempost
step: step,stepped,stepping,steps
stepmother: stepmother
sterile: sterile
stern: stern
sterna: sterna
sternpost: sternpost
stew: stew,stewed,stews
steward: steward
stick: stick,sticking,sticks,stuck
stiff: stiff
stiffen: stiffened
stifle: stifle,stifling
stiltlike: stiltlike
stimulus: stimulus
sting: sting,stings
stinger: stingers
stingray: stingrays
stink: stink
stipple: stippled
stippled: stippled
stir: stir,stirred
stirring: stirring
stirrup: stirrups
stock: stock,stocking
stockbroker: stockbroker
stocking: stockings
stocky: stocky
stoic: stoic
stoke: stoke,stoked,stoking
stoker: stokers
stomach: stomach,stomachs
stone: stone,stoned,stones
stones: stones
stony: stony
stool: stools
stoop: stooped
stopcock: stopcock,stopcocks
stopping: stopping
storage: storage
store: store,stored,stores,storing
storm: storm,storms
storms: storms
stormy: stormy
story: stories,story
storyteller: storytellers
stove: stoves
stow: stow,stowed
stowing: stowing
straddle: straddling
straight: straight,straightest
straighten: straighten,straightened,straightening
strain: strain
strained: strained
strainer: strainer,strainers
strait: strait
strand: strand,stranded,strands
strange: strange,strangest
strangely: strangely
stranger: stranger,strangers
strangle: strangled
strap: strapping,straps
strata: strata
strategy: strategy
straw: straw
stray: stray,strayed,straying
streak: streak,streaked,streaking,streaks
stream: stream,streamed,streams
streaming: streaming
streamlined: streamlined
strength: strength
strengthen: strengthen,strengthened
strenuous: strenuous
stress: stress
stretch: stretch,stretched,stretches,stretching
strew: strewn
striation: striations
stricken: stricken
strict: strict,strictest
strictly: strictly
stride: strides,strode
strike: strike,strikes,striking,struck
string: strings
strip: strip,striped,stripped,stripping,strips
stripe: stripes
striped: striped
stroke: stroke,strokes
stroll: stroll,strolled,strolling,strolls
strong: strong,stronger,strongest
structural: structural
structure: structure
struggle: struggle,struggled,struggles,struggling
stubborn: stubborn
stubbornly: stubbornly
stubbornness: stubbornness
student: student
studio: studio
study: studied,studies,study,studying
stuff: stuff,stuffed
stumble: stumbled
stump: stumps
stun: stunned
stunned: stunned
stupendous: stupendous
stupidly: stupidly
sturdy: sturdy
sturgeon: sturgeon,sturgeons
style: style
stylish: stylish
subbrachian: subbrachian
subclass: subclass,subclasses
subdivide: subdivided
subdivision: subdivision,subdivisions
subdue: subdued
subdued: subdued
subgenera: subgenera
subgenus: subgenus
subgroup: subgroups
subject: subject,subjects
sublieutenant: sublieutenant
sublime: sublime
submarine: submarine
submerge: submerge,submerged,submerging
submergence: submergence
submersible: submersible
submit: submit,submitted,submitting
suborder: suborder
subordinate: subordinate
subpolar: subpolar
subscribe: subscribe
subsequently: subsequently
subside: subsided,subsiding
substance: substance,substances
substantive: substantive
substructure: substructures
subtitle: subtitle
subtle: subtle,subtlest
subtlety: subtleties,subtlety
subtly: subtly
succeed: succeed,succeeded
success: success
succession: succession
successive: successive
successively: successively
succulent: succulent
suck: suck,sucked,sucking
sucker: suckers
suckerfish: suckerfish
suckling: suckling
suction: suction
sudden: sudden
suddenly: suddenly
suez: suez
suffer: suffer,suffered,suffering
suffering: sufferings
suffice: suffice
sufficient: sufficient
suffocate: suffocated,suffocating
sugar: sugar
sui: sui
suicidally: suicidally
suit: suit,suited,suits
suitable: suitable
suitcase: suitcase
sulfate: sulfate
sulfur: sulfur
sulfurous: sulfurous
sullen: sullen
sum: sum
summary: summary
summer: summer
summit: summit,summits
summon: summon,summoned
summons: summons
sumptuous: sumptuous
sun: sun
sunlight: sunlight
sunrise: sunrise,sunrises
sunshine: sunshine
superabundant: superabundant
superb: superb
superhuman: superhuman
superimpose: superimposed
superior: superior,superiors
superiority: superiority
superman: superman
supervise: supervised,supervising
supervision: supervision
supper: supper
supple: supple
supplementary: supplementary
supplier: suppliers
supply: supplied,supplies,supply,supplying
support: support,supported,supporting
supporter: supporters
suppose: suppose,supposed
supposedly: supposedly
supposition: supposition
supreme: supreme
supremely: supremely
surely: surely
surf: surf
surface: surface,surfaced,surfaces
surge: surged,surging
surgeonfish: surgeonfish
surinam: surinam
surpass: surpassed
surplus: surplus
surprise: surprise,surprises
surprised: surprised
surprising: surprising
surprisingly: surprisingly
surrender: surrender,surrendered
surround: surrounded,surrounding,surrounds
surroundings: surroundings
surveillance: surveillance
survey: survey,surveyed,surveying,surveys
survive: survived,surviving
suspect: suspect,suspected
suspend: suspended
suspension: suspension
suspicion: suspicion,suspicions
suspicious: suspicious
sustain: sustain,sustained,sustaining,sustains
sustenance: sustenance
suture: suture,sutures
swallow: swallow,swallowed,swallowing,swallows
swamp: swamped
swarm: swarm,swarmed,swarming,swarms
swathe: swathed
sway: sway,swayed,swaying
swaying: swaying
swear: swear,swearing,swore,sworn
sweat: sweat
sweden: sweden
sweep: sweep,sweeping,sweeps,swept
sweeper: sweepers
sweet: sweet
sweeten: sweetens
swell: swell,swelled,swelling,swells,swollen
swerve: swerved,swerves,swerving
swift: swift,swifter,swiftest
swiftly: swiftly
swiftness: swiftness
swim: swam,swim,swimming
swimmer: swimmer
swimming: swimming
swing: swing,swung
swinging: swinging
swirl: swirl,swirls
swiss: swiss
switch: switch
swivel: swivel
swollen: swollen
swoop: swooped
sword: sword
swordfish: swordfish
sydney: sydney
syllable: syllable
symbolism: symbolism
symbolize: symbolized
symmetrical: symmetrical
symmetry: symmetry
sympathy: sympathy
symptom: symptoms
syria: syria
systematically: systematically
table: table,tables
tableware: tableware
tabloid: tabloids
tacit: tacit
tack: tack,tacked,tacking,tacks
tackle: tackle,tackled
tactic: tactic,tactics
tad: tad
tadpole: tadpole
tag: tag
tahiti: tahiti
tail: tail,tailed,tails
tale: tale,tales
talent: talent,talents
talk: talk,talked,talking
tall: tall,taller
tally: tallies
tan: tan
tangle: tangle,tangled,tangles
tangled: tangled
tangy: tangy
tank: tank,tanks
tantamount: tantamount
tantrum: tantrum,tantrums
tantrums: tantrums
tap: tapped
taper: tapering
tapered: tapered
tapestry: tapestries
tapiro: tapiro
target: target
tart: tart
task: task,tasks
tassel: tassels
taste: taste,tasted,tastes,tasting
tasteless: tasteless
tasty: tastiest,tasty
tat: tat
tattered: tattered
tatters: tatters
tavern: tavern
tax: tax,taxing
tea: tea
teach: taught,teach
teaching: teachings
teakwood: teakwood
team: teamed
tear: tear,tearing,tears,tore,torn
technicolor: technicolor
technology: technologies,technology
teem: teem
teenager: teenager
telegram: telegram,telegrams
telegraph: telegraph,telegraphed
telescope: telescope
telltale: telltale
temper: temper,tempered
temperament: temperament
temperate: temperate
temperature: temperature,temperatures
tempered: tempered
tempest: tempest,tempests
tempests: tempests
temple: temple,temples
temporarily: temporarily
temporary: temporary
tempt: tempt,tempted
temptation: temptations
tenacious: tenacious
tenacity: tenacity
tendency: tendency
tender: tender,tendered,tenders
tenderly: tenderly
tendril: tendrils
tenfold: tenfold
tension: tension
tent: tent
tentacle: tentacle,tentacles
tenth: tenth,tenths
teratological: teratological
term: term,termed,terms
terminology: terminology
tern: terns
terrace: terraces
terrain: terrain
terrestrial: terrestrial
terribly: terribly
terrific: terrific
terrify: terrified
terrifying: terrifying
terrifyingly: terrifyingly
territory: territories,territory
terror: terror
tertio: tertio
testacea: testacea
testify: testified
testimony: testimony
testis: testes
tether: tether
textile: textile
texture: textured,textures
thaddeus: thaddeus
theater: theater,theaters
thee: thee
theory: theories,theory
thereabout: thereabouts
thermometer: thermometer
thermometric: thermometric
thicken: thickened
thicket: thicket,thickets
thickness: thickness
thinker: thinkers
thinking: thinking
thirst: thirsting
thirteen: thirteen
thomas: thomas
thoracic: thoracic
thorax: thorax
thorn: thorns
thoroughfare: thoroughfares
thousandfold: thousandfold
thrash: thrashed,thrashing
thread: thread,threaded,threads
threadlike: threadlike
threat: threat,threats
threaten: threaten,threatened,threatening
threatening: threatening
thresher: thresher
thrill: thrill
thrilling: thrilling
thrive: thrive
throat: throat,throats
throb: throbbed,throbbing
throe: throes
throne: throne
throw: threw,throw,throwing,thrown
thrust: thrust,thrusts
thumb: thumbed,thumbing
thumbnail: thumbnail
thunder: thunder
thunderclap: thunderclaps
thunderstorm: thunderstorms
thwart: thwart,thwarted,thwarts
tidal: tidal
tide: tide,tides
tie: tie,tied,ties
tiered: tiered
tiger: tiger,tigers
tight: tight,tighter
tighten: tighten
tightly: tightly
tightness: tightness
tile: tiles
tiling: tiling
tilled: tilled
tiller: tiller
tilt: tilted
timaeus: timaeus
timber: timber
timberline: timberline
time: time,timed,times
timely: timely
timepiece: timepiece
timetable: timetable
timid: timid
timidly: timidly
timing: timing
timor: timor
tin: tin
tinderbox: tinderbox
tinkle: tinkling
tint: tint,tinted,tints
tinted: tinted
tiny: tiniest,tiny
tipsy: tipsy
tire: tire
tired: tired
tireless: tireless
tirelessly: tirelessly
tiresome: tiresome
tissue: tissue
tit: tit
titanic: titanic
titian: titian
title: title,titles
toad: toad
toadfish: toadfish
toast: toasted
tobacco: tobacco
togetherness: togetherness
toil: toil
toiler: toilers
token: token
tokyo: tokyo
tolerably: tolerably
tolerate: tolerate,tolerating
toll: toll
tomb: tomb
tomorrow: tomorrow
ton: ton,tons
tone: tone
tonga: tonga
tongue: tongue,tongues
tonight: tonight
tonnage: tonnage
tool: tool,tools
tooth: teeth,tooth
toothless: toothless
topaz: topaz
tope: topes
topgallant: topgallant
topic: topic
topmost: topmost
topple: topple,toppled,toppling
topside: topside
torch: torch,torches
tornado: tornadoes
torpedo: torpedo,torpedoes
torpor: torpor
torrent: torrent,torrents
torrential: torrential
torrid: torrid
tortuous: tortuous
torture: torture,tortured
toss: toss,tossed,tossing
total: total,totaling,totals
totality: totality
totally: totally
touch: touch,touched,touching
tough: tough
toughness: toughness
tour: tour
tourist: tourists
tow: tow,towed,towing
tower: towering,towers
towing: towing
town: town,towns
toxic: toxic
trace: trace,traced,traces,tracing
trachyte: trachyte
track: track,tracks
tract: tract,tracts
trade: trade
trader: traders
tradesman: tradesmen
tradition: tradition,traditions
traffic: traffic
trail: trail,trailed,trailing,trails
train: train,trained,trains
traipse: traipse
trait: traits
trajectory: trajectory
trance: trance
tranquil: tranquil
tranquility: tranquility
transaction: transactions
transatlantic: transatlantic
transfer: transfer,transferred
transfigure: transfigured
transfix: transfixed
transform: transformed,transforming
transit: transit
translate: translated
translation: translation
translucency: translucency
translucent: translucent
transmission: transmission
transmit: transmit,transmitted,transmitting
transoceanic: transoceanic
transparency: transparency
transparent: transparent
transplant: transplanted
transport: transport,transporting,transports
transportation: transportation
trap: trap,trapped
trapped: trapped
trappings: trappings
travel: travel,traveled,traveling,travels
traveler: traveler
traveling: traveling
travelog: travelog,travelogs
travels: travels
trawl: trawl
tread: tread,treading,trod
treasure: treasure,treasures
treasury: treasury
treat: treat
treatment: treatment
treaty: treaty
tree: tree,trees
treelike: treelike
trek: trek
trellis: trellis
tremble: tremble,trembled,trembling
tremendous: tremendous
tremendously: tremendously
tremor: tremors
trench: trench
tress: tresses
trial: trial
triangle: triangle
triangular: triangular
tribe: tribes
tribunal: tribunal
trick: trick,tricked,tricks
trickle: trickle
trigger: trigger
triggerfish: triggerfish
trim: trim,trimmed
trinket: trinket
trip: trip,trips
triple: triple,tripled
triton: triton
triumph: triumph,triumphed
triumphant: triumphant
triumphantly: triumphantly
trod: trod
troops: troops
tropic: tropic
tropical: tropical
trouble: trouble,troubled
troubled: troubled
trough: troughs
true: true
truffle: truffles
trumpet: trumpet
trumpetfish: trumpetfish
trunk: trunk,trunks
trunkfish: trunkfish
trust: trust,trusted
truth: truth
tsar: tsar
tsarist: tsarist
tuamotu: tuamotu
tube: tube,tubes
tubifex: tubifex
tubular: tubular
tuff: tuff
tuft: tuft,tufts
tug: tugged
tumble: tumble,tumbled,tumbling
tuna: tuna
tune: tune
tunic: tunic,tunics
tunisia: tunisia
tunnel: tunnel
tur: tur
turban: turban
turbo: turbo
turbot: turbot
turbulent: turbulent
turkey: turkey
turks: turks
turmoil: turmoil
turret: turret
turtle: turtle,turtles
tuscan: tuscan
tusk: tusk,tusks
twentieth: twentieth
twig: twigs
twilight: twilight
twine: twined
twinkle: twinkle,twinkled,twinkling
twist: twist,twisted,twisting
twisting: twisting
twitching: twitching
twofold: twofold
type: type,types
typical: typical
typify: typifies
tyrannical: tyrannical
tyrant: tyrant,tyrants
udder: udders
ugh: ugh
ugly: ugly
uh: uh
ulcer: ulcers
ultimate: ultimate
ultimately: ultimately
ultra: ultra
ultramarine: ultramarine
umbelliferous: umbelliferous
umbellularia: umbellularia
umbrella: umbrella
unabashed: unabashed
unable: unable
unabridged: unabridged
unacceptable: unacceptable
unaccustomed: unaccustomed
unadulterated: unadulterated
unaggressive: unaggressive
unanimous: unanimous
unanimously: unanimously
unappreciated: unappreciated
unattainable: unattainable
unaware: unaware
unballast: unballast
unbearable: unbearable
unbelievable: unbelievable
unblinking: unblinking
unbroken: unbroken
unceasingly: unceasingly
uncertain: uncertain
unchanging: unchanging
uncharted: uncharted
unchecked: unchecked
uncoiled: uncoiled
uncommon: uncommon
uncomplaining: uncomplaining
unconcern: unconcern
unconcerned: unconcerned
unconscious: unconscious
unconsciously: unconsciously
uncontrollable: uncontrollable
uncover: uncovered
undamaged: undamaged
undecided: undecided
undefinable: undefinable
undeniable: undeniable
undeniably: undeniably
underbelly: underbelly
underbrush: underbrush
underfoot: underfoot
undergo: undergo,undergoing
underground: underground
underhanded: underhanded
underlie: underlying
underpinning: underpinning
undersea: undersea
underside: underside,undersides
understand: understand,understood
understandable: understandable
undertake: undertake
undertaking: undertaking
underwater: underwater
undeveloped: undeveloped
undo: undid,undo,undone
undoubtedly: undoubtedly
undreamed: undreamed
undress: undressed
undulate: undulating
undulated: undulated
undulating: undulating
undulation: undulations
undying: undying
unearthly: unearthly
uneasiness: uneasiness
uneasy: uneasy
unemotional: unemotional
unenthusiastic: unenthusiastic
unequal: unequal
uneven: uneven
unevenly: unevenly
unexpected: unexpected
unexpectedly: unexpectedly
unexpectedness: unexpectedness
unexplained: unexplained
unexplored: unexplored
unfair: unfair
unfamiliar: unfamiliar
unfathomable: unfathomable
unfeigned: unfeigned
unfit: unfit
unfixed: unfixed
unflaggingly: unflaggingly
unflappable: unflappable
unflappably: unflappably
unflinching: unflinching
unfold: unfolded
unforeseen: unforeseen
unforgivable: unforgivable
unfortunate: unfortunate
unfurl: unfurled,unfurling
unfurled: unfurled
unguiculata: unguiculata
unheard: unheard
unhinge: unhinged
unicorn: unicorn,unicorns
uniform: uniform
uniformity: uniformity
uniformly: uniformly
unifying: unifying
unimpeachable: unimpeachable
unimportant: unimportant
uninhabited: uninhabited
uninjured: uninjured
unintelligent: unintelligent
unintentionally: unintentionally
uninterested: uninterested
union: union
unique: unique
uniqueness: uniqueness
unison: unison
unit: unit,units
unite: united
united: united
universal: universal
universally: universally
universe: universe
university: university
unjustly: unjustly
unknown: unknown
unleash: unleashed
unlimited: unlimited
unlivable: unlivable
unload: unloading
unloading: unloading
unlock: unlocked,unlocking
unlucky: unlucky
unmatched: unmatched
unmercifully: unmercifully
unmistakable: unmistakable
unnecessary: unnecessary
unpleasant: unpleasant
unpopulated: unpopulated
unprecedented: unprecedented
unpredictability: unpredictability
unpredictable: unpredictable
unpredictably: unpredictably
unprintable: unprintable
unpurse: unpursed
unquestionable: unquestionable
unquestioning: unquestioning
unravel: unravel
unreachable: unreachable
unreasoning: unreasoning
unreel: unreeled,unreeling
unrivaled: unrivaled
unroll: unrolled,unrolling
unruffled: unruffled
unsanitary: unsanitary
unsatisfied: unsatisfied
unscrew: unscrew
unscrewed: unscrewed
unseen: unseen
unshakeable: unshakeable
unshaken: unshaken
unsinkable: unsinkable
unsociable: unsociable
unsolicited: unsolicited
unsolved: unsolved
unstable: unstable
untangle: untangled,untangling
untenable: untenable
unthinkable: unthinkable
untimely: untimely
untold: untold
untroubled: untroubled
unusable: unusable
unusual: unusual
unusually: unusually
unveil: unveil,unveiled
unwilling: unwilling
unwise: unwise
unworkable: unworkable
upbringing: upbringing
upheaval: upheaval,upheavals
upheaving: upheaving
upholster: upholstered
upper: upper
upright: upright
uprising: uprising
uproar: uproar
upset: upset
upshot: upshot
upside: upside
upstage: upstage
upstanding: upstanding
upward: upward
urchin: urchins
urge: urge,urged,urges
urgency: urgency
urgent: urgent
uruguay: uruguay
useless: useless
uselessness: uselessness
usnea: usnea
usual: usual
utensil: utensil,utensils
utilize: utilize
utmost: utmost
utter: utter,uttered
utterly: utterly
vacuum: vacuum,vacuums
vain: vain
vainly: vainly
valiant: valiant
valiantly: valiantly
valley: valley
valuable: valuable
valve: valve,valves
valved: valved
van: van
vanish: vanish,vanished,vanishes,vanishing
vapor: vapor
variation: variations
varied: varied
variety: varieties,variety
variously: variously
varnish: varnish
vary: varied,varying
vast: vast
vastly: vastly
vault: vault,vaults
veal: veal
veer: veered,veering
vegetable: vegetable,vegetables
vegetate: vegetating
vegetation: vegetation
vehemence: vehemence
vehement: vehement
vehemently: vehemently
vehicle: vehicle
veil: veiled
vein: vein,veins
veinlike: veinlike
velocity: velocity
velvet: velvet
venerate: venerated
veneration: veneration
vengeance: vengeance
venice: venice
venison: venison
venom: venom
vent: vent
ventilate: ventilating
ventilation: ventilation
ventilator: ventilators
venture: venture,ventured,ventures,venturing
venturesome: venturesome
venus: venus
verde: verde
verify: verified,verify,verifying
vermin: vermin
veronese: veronese
versa: versa
verse: verse,versed
version: versions
vertebra: vertebrae
vertebrata: vertebrata
vertebrate: vertebrate,vertebrates
vertical: vertical
verticality: verticality
vertically: vertically
verve: verve
vessel: vessel,vessels
vestibule: vestibule
vestment: vestments
vesuvius: vesuvius
vibrate: vibrating
vibration: vibrations
vice: vice
vicinity: vicinity
vicious: vicious
vicissitude: vicissitudes
victim: victim,victims
victimize: victimized
victor: victor
victoria: victoria
victorious: victorious
victory: victory
video: video
view: view,viewed,views
viewpoint: viewpoint
vigil: vigil
vigor: vigor
vigorous: vigorous
vigorously: vigorously
viii: viii
village: village,villages
villager: villagers
villainous: villainous
vincent: vincent
vinci: vinci
vinegar: vinegar
vingt: vingt
violate: violate
violation: violation
violence: violence
violent: violent
violently: violently
violet: violet,violets
virgil: virgil
virgin: virgin
virginal: virginal
virgularia: virgularia
virtually: virtually
virtue: virtue,virtues
viscous: viscous
visible: visible
visibly: visibly
vision: vision,visions
visit: visit,visited,visiting,visits
visitor: visitors
vista: vista
vital: vital
vitality: vitality
viti: viti
vivid: vivid
viviparous: viviparous
vocabulary: vocabulary
vocation: vocation
voice: voice,voiced,voices,voicing
voices: voices
volatile: volatile
volcanic: volcanic
volcano: volcano,volcanoes
volga: volga
voltage: voltage
volume: volume,volumes
voluntarily: voluntarily
voluntary: voluntary
volunteer: volunteer
volute: volute
vomit: vomit,vomited,vomiting
voracious: voracious
voracity: voracity
vortex: vortex
vouch: vouch
vow: vow,vowed
vowel: vowels
voyage: voyage,voyaged,voyages,voyaging
vulture: vultures
wade: wading
waft: wafting
wag: wag,wags
wage: wage,waged
wagner: wagner
waist: waist,waists
waistband: waistbands
wait: wait,waited,waiting
waiter: waiter
wake: wake,wakes,waking,woke,woken
wales: wales
walk: walk,walked,walking
walking: walking
wall: wall,walls
walled: walled
wallop: wallop,walloped
walnut: walnut
walrus: walruses
walter: walter
wander: wander,wandered,wandering
war: war,wars
ward: ward,warding
warden: wardens
wardrobe: wardrobe
warfare: warfare
warlike: warlike
warm: warm,warmed,warmer,warms
warmly: warmly
warmth: warmth
warn: warn,warned
warning: warning,warnings
warp: warping
warship: warship,warships
wash: washed,washes,washing
washington: washington
washstand: washstand
waste: waste,wasted,wasting
watch: watch,watched,watches,watching
water: water,watered,waters
watercolorist: watercolorist
watercourse: watercourses
watering: watering
waterline: waterline
waterproof: waterproof
waters: waters
waterside: waterside
waterspout: waterspout,waterspouts
watertight: watertight
waterway: waterways
watery: watery
wave: wave,waves,waving
wax: wax
waylay: waylaid
weak: weak,weaker
weaken: weaken,weakened,weakens
weakness: weakness
wealth: wealth
wealthy: wealthiest
weapon: weapon,weapons
wear: wear,wearing,wears,wore,worn
weariness: weariness
weary: weary
weather: weather
weave: woven
weber: weber
wedge: wedge
weed: weed,weeds
week: week,weeks
weep: weeping,wept
weever: weevers
weigh: weigh,weighed,weighing,weighs
weight: weight,weighted
weighty: weighty
wellnigh: wellnigh
wentletrap: wentletrap
wessel: wessel
west: west
westerly: westerly
western: western
westward: westward
wet: wet
whale: whale,whales,whaling
whaleboat: whaleboat
whalebone: whalebone
whaler: whaler,whalers
whales: whales
whaling: whaling
wharf: wharf,wharves
wheat: wheat
wheel: wheel,wheeled,wheels
wheeler: wheeler
wheelhouse: wheelhouse
whelk: whelk,whelks
whiff: whiffs
whimsical: whimsical
whimsically: whimsically
whip: whip
whirl: whirl,whirled,whirling
whirlpool: whirlpool
whisker: whiskers
whistle: whistled,whistling
white: white
whiten: whitened,whitening
whitened: whitened
whiteness: whiteness
whitish: whitish
whiz: whizzed
wholehearted: wholehearted
wholeheartedly: wholeheartedly
wholesome: wholesome
wick: wick,wicks
wicked: wicked
wide: wide,wider,widest
widen: widens
wield: wielded,wielding
wife: wife
wild: wild
wilderness: wilderness
wildest: wildest
wildfowl: wildfowl
wildly: wildly
william: william
win: win,winning
wince: wincing
wind: wind,winding,winds,wound
winded: winded
windedness: windedness
winding: windings
window: window,windowed,windows
windowpane: windowpane
windward: windward
wine: wine
wing: wing,winged,wings
winged: winged
wingspan: wingspan,wingspans
wink: wink
winter: winter
wipe: wipe,wiped
wire: wire,wires
wiring: wiring
wisdom: wisdom
wise: wise,wiser
wisely: wisely
wisp: wisps
wit: wit
withdraw: withdraw,withdrawn,withdrew
withstand: withstand,withstanding,withstood
witness: witness,witnessed
witticism: witticism,witticisms
witty: witty
wobble: wobbling
woe: woe,woes
wolf: wolf,wolfing,wolves
wolffish: wolffish
woman: woman,women
womb: womb
wonderful: wonderful
wonderfully: wonderfully
wonderment: wonderment
wondrous: wondrous
wondrously: wondrously
wood: wood,woods
woodcock: woodcocks
wooded: wooded
wooden: wooden
woolly: woolly
word: word,worded
wording: wording
workday: workday
worker: workers
workman: workman,workmen
workshop: workshops
worktable: worktable
worldwide: worldwide
worm: worms
wormfish: wormfish
worn: worn
worried: worried
worry: worried,worries,worry
worship: worshipping
worth: worth
worthless: worthless
worthwhile: worthwhile
worthy: worthy
wound: wound,wounded,wounds
wounded: wounded
wow: wow
wrack: wrack
wrap: wrapped
wrasse: wrasse
wreath: wreaths
wreathe: wreathed,wreathing
wreck: wreck,wrecked
wreckage: wreckage
wrecked: wrecked
wrench: wrench,wrenched
wrest: wrest,wrested,wresting
wretched: wretched
wretchedly: wretchedly
wrinkle: wrinkled,wrinkles
writ: writs
write: write,writes,writing,written,wrote
writer: writer,writers
writhe: writhed,writhing
writing: writing
wrong: wrong
xanthid: xanthid
xiphias: xiphias
xiv: xiv
xvi: xvi
yachtsman: yachtsman
yam: yams
yank: yanked
yankee: yankee
yard: yard
yardarm: yardarm,yardarms
yarn: yarns
yawn: yawning
yawns: yawns
yearly: yearly
yell: yell,yelled,yelling,yells
yellow: yellow,yellowed,yellowing
yellowish: yellowish
yelp: yelped
yeoman: yeoman
yesterday: yesterday
yield: yield,yielded,yielding
yikes: yikes
yoke: yoke
yonder: yonder
york: york
yorkers: yorkers
youngster: youngsters
youthful: youthful
yuletide: yuletide
zeal: zeal
zealand: zealand
zealot: zealots
zealous: zealous
zenith: zenith
zest: zest
zigzag: zigzags
zinc: zinc
zoantharia: zoantharia
zodiacal: zodiacal
zone: zone,zones
zones: zones
zoo: zoo
zoological: zoological
zoophyte: zoophyte,zoophytes
