abandon: abandon,abandoned,abandoning,abandons
abide: abide,abides,abiding
ability: ability
abode: abode
abolish: abolish
abortive: abortive
abound: abounds
abridge: abridge
absence: absence
absent: absent
absolute: absolute
absolutely: absolutely
absolve: absolves
absorbent: absorbent
abstain: abstain,abstains
abstract: abstract,abstracted,abstracting,abstracts
abstraction: abstraction
absurd: absurd
absurdity: absurdities,absurdity
abundant: abundant
abundantly: abundantly
abuse: abuse,abused
abut: abut,abuts
abyss: abyss
academical: academical
accept: accept,accepted,accepting,accepts
acceptable: acceptable
acceptance: acceptance
acceptation: acceptation
access: access,accessed
accessible: accessible
accession: accessions
accident: accident,accidents
accidental: accidental
accidentally: accidentally
accompaniment: accompaniment
accompany: accompanied,accompanies,accompany,accompanying
accomplish: accomplish,accomplished
accord: accord,accorded,accords
accordant: accordant
account: account,accounted
accredit: accredit
accrue: accrued
accumulate: accumulated
accumulation: accumulation
accuracy: accuracy
accurate: accurate
accurately: accurately
accusation: accusation
accuse: accuse,accused,accusing
accustom: accustom,accustomed
accustomed: accustomed
achieve: achieve
acid: acids
acknowledge: acknowledge,acknowledged,acknowledges
acquaint: acquaint,acquainted
acquaintance: acquaintance
acquainted: acquainted
acquire: acquire,acquired
acquisition: acquisition
acroamatic: acroamatic
action: action,actions
active: active
activity: activity
actual: actual
actuality: actuality
acute: acute
acuteness: acuteness
adapt: adapted
add: add,adding,adds
addition: addition,additions
additional: additional
address: address,addressed,addresses,addressing
adduce: adduce,adduced,adduces
adduced: adduced
adequate: adequate
adequately: adequately
adequateness: adequateness
adhere: adhere,adhering
adherence: adherence
adjacent: adjacent
adjective: adjective
adjunct: adjunct
adjust: adjusted,adjusting
administer: administers
administration: administration
admirable: admirable
admiration: admiration
admirer: admirers
admissibility: admissibility
admissible: admissible
admission: admission
admit: admit,admits,admitted,admitting
admixture: admixture,admixtures
admonition: admonition
adopt: adopt,adopting,adopts
adorn: adorn,adorned
advance: advance,advanced,advances,advancing
advanced: advanced
advancement: advancement
advantage: advantage,advantages
advantageous: advantageous
adventure: adventures
adversary: adversaries,adversary
adverse: adverse
advice: advice
advisable: advisable
advisedly: advisedly
advocate: advocate
affair: affair,affairs
affect: affect
affection: affection,affections
affinity: affinity
affirm: affirm,affirmed,affirming,affirms
affirmation: affirmation,affirmations
affirmative: affirmative,affirmatives
affirmatively: affirmatively
affix: affixed
afford: afford,afforded,affords
aforesaid: aforesaid
age: age,ages
aged: aged
agency: agency
agendum: agendum
agent: agent,agents
aggregate: aggregate,aggregated,aggregates
aggregation: aggregation
agree: agree,agreed,agrees
agreeable: agreeable
agreeably: agreeably
agreement: agreement
aid: aid,aids
aim: aim,aimed,aims
air: air,airs
airless: airless
alarm: alarm
alexander: alexander
algebra: algebra
alike: alike
alive: alive
alkalis: alkalis
allege: alleged,alleges,alleging
allo: allo
allowable: allowable
allure: allured,allures
ally: allied
alter: alter,altered,altering
alteration: alteration,alterations
alternate: alternate,alternating
alternately: alternately
alternation: alternation
alternative: alternative
altogether: altogether
ambiguity: ambiguities,ambiguity
ambiguous: ambiguous
ambitious: ambitious
amphiboly: amphiboly
ample: ample
amplify: amplify
amply: amply
amusement: amusement
analogical: analogical
analogies: analogies
analogon: analogon
analogous: analogous
analogously: analogously
analogy: analogies,analogy
analysation: analysation
analyse: analyse,analysed,analysing
analysis: analyses,analysis
analyst: analyst,analysts
analytic: analytic
analytical: analytical
analytically: analytically
anarchy: anarchy
anatomist: anatomist
ancestor: ancestors
anchor: anchor
ancient: ancient,ancients
angle: angle,angles
angled: angled
anima: anima
animadversion: animadversions
animal: animal,animals
animality: animality
animate: animated,animates
annex: annex,annexed,annexes
annihilate: annihilate,annihilated,annihilates
annihilation: annihilation
annul: annulled
anomaly: anomaly
answer: answer,answered,answering,answers
answerable: answerable
antagonistic: antagonistic
antecede: antecede,antecedes
antecedent: antecedent
antecedently: antecedently
anterior: anterior
anthropological: anthropological
anthropology: anthropology
anthropomorphic: anthropomorphic
anthropomorphism: anthropomorphism
anticipate: anticipate,anticipated,anticipates,anticipating
anticipation: anticipation,anticipations
anticipations: anticipations
anticipatory: anticipatory
antinomy: antinomies,antinomy
antiquated: antiquated
antiquity: antiquity
antithesis: antithesis
antithetic: antithetic
anxiety: anxiety
apagogic: apagogic
apodeictic: apodeictic
apodeictical: apodeictical
apodeictically: apodeictically
apologize: apologize
apology: apology
apparent: apparent
appeal: appeal,appealing,appeals
appearance: appearance,appearances
appellation: appellation,appellations
append: append,appended
appendix: appendix
apperception: apperception
appertain: appertain,appertaining
appetite: appetite
applicability: applicability
applicable: applicable
application: application,applications
apply: applied,applies,apply,applying
appoint: appointed
appointment: appointment
appreciation: appreciation
apprehend: apprehend,apprehended,apprehending
apprehension: apprehension,apprehensions
approach: approach,approached,approaching
approbation: approbation,approbations
appropriation: appropriation
approval: approval
approve: approve
approximate: approximate,approximates
approximating: approximating
approximation: approximation,approximations
april: april
aptitude: aptitudes
arbitrarily: arbitrarily
arbitrary: arbitrary
archetypal: archetypal
archetype: archetype,archetypes
architect: architect
architectonic: architectonic
architectonically: architectonically
archive: archive,archives
ardent: ardent
arena: arena
argue: arguing
argument: argument,arguments
argumentation: argumentation
argumentative: argumentative
arguments: arguments
argumentum: argumentum
aristotle: aristotle
arithmetic: arithmetic
arithmetical: arithmetical
arm: armed,arms
armistice: armistice
armoury: armoury
army: army
arrange: arrange,arranged,arranges,arranging
arrangement: arrangement,arrangements
array: array
arrive: arrive,arrived,arrives,arriving
arrogant: arrogant
arrogate: arrogate,arrogates
art: art,arts
article: article,articles
articulation: articulation
artifice: artifice,artifices
artificial: artificial
artificially: artificially
artist: artist,artists
artistic: artistic
ascend: ascend,ascending,ascends
ascension: ascension
ascent: ascent
ascertain: ascertain,ascertaining
ascii: ascii
ascribe: ascribe,ascribed,ascribing
ash: ashes
aspect: aspects
aspiration: aspirations
assemble: assemble,assembled
assent: assent
assert: assert,asserted,asserting,asserts
assertion: assertion,assertions
assertor: assertor
assertorical: assertorical
assertorically: assertorically
assign: assign,assigned,assigns
assist: assist,assisting,assists
assistance: assistance
association: association
assume: assume,assumed,assumes,assuming
assumed: assumed
assumption: assumption,assumptions
assurance: assurance
assure: assure,assured,assures,assuring
assuredly: assuredly
astonishing: astonishing
astonishment: astonishment
astray: astray
astronomer: astronomer,astronomers
astronomy: astronomy
asymptotic: asymptotic
atheism: atheism
atheistic: atheistic
atomistic: atomistic
attach: attach,attached,attaches,attaching
attack: attack,attacked,attacking,attacks
attain: attain,attained,attaining,attains
attainable: attainable
attainment: attainment
attempt: attempt,attempted,attempting,attempts
attempted: attempted
attend: attend,attended,attending,attends
attention: attention
attentive: attentive
attest: attested
attract: attract,attracted
attraction: attraction
attractive: attractive
attribute: attribute,attributed,attributes,attributing
aught: aught
augment: augment,augmented,augmenting
augmentation: augmentation
augmentative: augmentative
authenticity: authenticity
author: author,authors
authority: authority
authorize: authorize,authorized,authorizes,authorizing
auxiliary: auxiliary
avail: avail,availing,avails
avoid: avoid,avoided
avow: avow
await: awaits
awake: awakes
awaken: awaken,awakened
awakening: awakening
aware: aware
awe: awe
axiom: axiom,axioms
axiomatic: axiomatic
axioms: axioms
axis: axis
bacon: bacon
bad: bad,worse
badly: badly
balance: balanced
ball: ball,balls
band: bands
bane: bane
banish: banish,banished,banishes
bank: bank
bar: bar
barbaric: barbaric
barbarism: barbarism
bare: bare
barrier: barriers
base: base,based,bases,basing
baseless: baseless
basis: basis
battle: battle
bear: bear,bears,born,borne
beat: beat
beautiful: beautiful
beauty: beauty
beckon: beckoning
befit: befits
befits: befits
beg: beg
behalf: behalf
behaviour: behaviour
behoof: behoof
belief: belief
belong: belong,belonged,belonging,belongs
beloved: beloved
bend: bend
beneath: beneath
beneficial: beneficial
benefit: benefit,benefited,benefits
bequeath: bequeath
bequest: bequest
berkeley: berkeley
beset: beset
bestow: bestowed
bet: bet
betray: betray,betrayed
bide: bide
binary: binary
bind: binding,bound
birth: birth
birthplace: birthplace
blame: blame,blamed
blameless: blameless
blemish: blemish
blessedness: blessedness
blind: blind,blinding
blindly: blindly
blindness: blindness
block: block
bloodless: bloodless
blow: blow,blows
blunder: blunder
boast: boast,boasts
boastful: boastful
boasting: boasting
bodily: bodily
body: bodies,body
bold: bold,boldest
boldly: boldly
boldness: boldness
bonnet: bonnet
bonum: bonum
book: book,books
borrow: borrow,borrowed,borrowing,borrows
bosom: bosom
bound: bounded,bounds
boundary: boundaries,boundary
boundless: boundless
brain: brain
branch: branch,branches
breach: breach
break: break,breaking,broke
breast: breast
brevity: brevity
bridge: bridge
brilliant: brilliant
bring: bring,bringing,brings,brought
broad: broad
build: build,built
building: building
bulwark: bulwarks
bungle: bungles
bungler: bungler
burden: burden
burn: burnt
business: business
busy: busy
calculate: calculate,calculated
calculation: calculations
calling: calling
calm: calm
caloric: caloric
canon: canon
capability: capabilities,capability
capable: capable
capacity: capacity
cape: cape
capital: capital
card: card
cardinal: cardinal
care: care
careful: careful
carefully: carefully
carelessly: carelessly
carelessness: carelessness
carry: carried,carries,carry,carrying
cart: cart
cartesian: cartesian
cash: cash
cast: cast,casting,casts
castle: castles
casus: casus
catalogue: catalogue
categorical: categorical
category: categories,category
cathartic: cathartic
causal: causal
causality: causality
caution: caution
cautious: cautious
cease: cease,ceased,ceases,ceasing
ceaseless: ceaseless
celebrate: celebrated
celebrated: celebrated
celestial: celestial
censor: censor
censure: censure
central: central
centre: centre,centred
century: centuries,century
certainty: certainties,certainty
certificate: certificate
certify: certify
certitude: certitude
chain: chain,chains
chair: chair
challenge: challenge,challenged,challenges
champion: champion,champions
chance: chance
change: change,changed,changing
changeable: changeable
chaos: chaos
chapter: chapter,chapters
character: character,characters
characteristic: characteristic,characteristics
characterize: characterize,characterized,characterizes
charge: charge,charges
chargeable: chargeable
charitable: charitable
charity: charities
charles: charles
charm: charm
chart: chart
chasm: chasm
check: check,checks
chemical: chemical
chemist: chemist,chemists
chemists: chemists
cherish: cherished,cherishes
chicanery: chicaneries
chief: chief
chiefly: chiefly
child: child
chimera: chimera,chimeras
chimerical: chimerical
choice: choice
choose: choose,chooses,choosing,chosen
cicero: cicero
circle: circle
circuit: circuit
circular: circular
circulate: circulate
circumference: circumference
circumscribe: circumscribe,circumscribed,circumscribes
circumspection: circumspection
circumstance: circumstance,circumstances
citizen: citizen,citizens
city: city
civil: civil
civilized: civilized
claim: claim,claims
claimant: claimants
class: class,classed,classes
clay: clay
clearness: clearness
cleave: cleaves,cleaving
clement: clement
cloak: cloak
clock: clock
close: close,closer,closing
closely: closely
clue: clue
coalesce: coalesce
coalition: coalition
coat: coat
cobweb: cobweb
cobwebs: cobwebs
code: code,codes
coerce: coerce
coercion: coercion
coexist: coexist
coexistence: coexistence
coexistent: coexistent
cogitable: cogitable
cogitate: cogitate,cogitated,cogitates,cogitating
cogitated: cogitated
cogitation: cogitation
cogito: cogito
cognate: cognate
cognition: cognition
cognizable: cognizable
cognizant: cognizant
cognize: cognize,cognized,cognizes,cognizing
cohere: cohere,coheres,cohering
coherence: coherence
coin: coin,coins
coincide: coincide,coincides
cold: cold
collateral: collateral
collect: collect,collected,collects
collectedness: collectedness
collection: collection
collective: collective
colour: colour,colours
coloured: coloured
colouring: colouring
column: column
combat: combat
combatant: combatant,combatants
combative: combative
combination: combination
combine: combine,combined,combines,combining
comet: comets
comfort: comfort
command: command,commands
commence: commence,commenced,commences,commencing
commencement: commencement
commend: commend
commensurate: commensurate
commercial: commercial
commercium: commercium
commit: commit,committed
common: common,commonest
commonly: commonly
commune: commune
communicate: communicate,communicated,communicates,communicating
communication: communication
communion: communion
communis: communis
community: communities,community
company: company
comparative: comparative
comparatively: comparatively
compare: compare,compared,compares,comparing
comparison: comparison,comparisons
compartment: compartments
compass: compass
compel: compel,compelled,compels
compelling: compelling
compendium: compendium
compensate: compensate,compensated,compensates
compensation: compensation
competent: competent
compilation: compilation
complain: complain
complaint: complaint,complaints
complemental: complemental
complete: complete,completed,completing
completely: completely
completeness: completeness
completion: completion
complex: complex
compliance: compliance
comply: comply,complying
component: component
compose: compose,composed
composita: composita
composite: composite
composition: composition
compound: compound,compounded
comprehend: comprehend,comprehended,comprehending,comprehends
comprehending: comprehending
comprehensibility: comprehensibility
comprehensible: comprehensible
comprehension: comprehension
comprehensive: comprehensive
compress: compressed
comprise: comprise,comprised,comprises
compulsion: compulsion
compute: compute
concatenation: concatenation
concave: concave
conceal: conceal,concealed
concealment: concealment
concede: concede,conceded
conceit: conceit
conceivable: conceivable
conceive: conceive,conceived,conceiving
conceived: conceived
concept: concept
conception: conception,conceptions
conceptions: conceptions
conceptus: conceptus
concern: concern,concerned,concerns
concerned: concerned
concernment: concernment
concession: concession,concessions
conclude: conclude,concluded,concludes,concluding
concluding: concluding
conclusion: conclusion,conclusions
conclusive: conclusive
conclusiveness: conclusiveness
concordant: concordant
concrete: concrete
condemn: condemn,condemned
condition: condition,conditioned,conditions
conditionally: conditionally
conditioned: conditioned
conduce: conduce
conducive: conducive
conduct: conduct,conducted,conducting,conducts
cone: cone
confer: confer,conferred
confess: confess,confessed,confesses,confessing
confession: confession
confidence: confidence
confident: confident
confidently: confidently
confine: confine,confined,confining
confines: confines
confirm: confirm,confirmed,confirms
confirmation: confirmation
conflict: conflict,conflicting,conflicts
conflicting: conflicting
confluence: confluence
conform: conform,conformed,conforms
conformability: conformability
conformable: conformable
conformably: conformably
conformity: conformity
confound: confound,confounded,confounding
confront: confront
confuse: confuse
confused: confused
confusedly: confusedly
confusing: confusing
confusion: confusion,confusions
confutation: confutation
confute: confuted,confuting
congeries: congeries
congruent: congruent
conjecture: conjecture,conjectured,conjectures
conjoin: conjoin,conjoined,conjoining,conjoins
conjoined: conjoined
conjunction: conjunction
connect: connect,connected,connecting,connects
connected: connected
connection: connection,connections
conquer: conquered
conqueror: conqueror
conquest: conquests
conscious: conscious
consciously: consciously
consciousness: consciousness
consequence: consequence,consequences
consequent: consequent
consequential: consequential
considerable: considerable
consideration: consideration,considerations
consist: consist,consisting,consists
consistence: consistence
consistency: consistency
consistent: consistent
console: console
consoling: consoling
consonant: consonant
constant: constant
constantly: constantly
constituent: constituent
constitute: constitute,constituted,constitutes,constituting
constitution: constitution
constitutive: constitutive
constrain: constrained,constraining
constraint: constraint
construct: construct,constructed,constructing,constructs
construction: construction,constructions
consult: consult,consulted
contact: contact
contagious: contagious
contemplate: contemplate,contemplated,contemplates
contemplation: contemplation
contemporaneous: contemporaneous
contemporaneously: contemporaneously
contempt: contempt
contemptuous: contemptuous
contend: contending
content: content
contented: contented
contentless: contentless
contentment: contentment
contents: contents
contest: contest,contests
context: context
contiguity: contiguity
contiguous: contiguous
continent: continent,continents
contingence: contingence
contingency: contingencies,contingency
contingent: contingent
contingently: contingently
continua: continua
continual: continual
continually: continually
continuance: continuance
continuation: continuation,continuations
continue: continue,continued,continues,continuing
continued: continued
continuity: continuity
continuous: continuous
continuum: continuum
contract: contract,contracted
contraction: contraction
contradict: contradict,contradicted,contradicts
contradiction: contradiction,contradictions
contradictorily: contradictorily
contradictory: contradictories,contradictory
contradistinction: contradistinction
contrariwise: contrariwise
contrary: contrary
contrast: contrast
contribute: contribute,contributed,contributes,contributing
contribution: contributions
control: control
controversy: controversies,controversy
convenience: convenience
convenient: convenient
conveniently: conveniently
conventionalism: conventionalism
conversation: conversation
converse: converse
conversely: conversely
conversion: conversion
convert: convert,converted,converting
convey: convey,conveyed
convict: convict
conviction: conviction,convictions
convince: convince,convinced,convinces,convincing
convinced: convinced
convincing: convincing
convulsion: convulsion
copernican: copernican
copernicus: copernicus
copula: copula
copying: copying
copyright: copyright
corner: corner
corporation: corporation
corporeal: corporeal
corpus: corpus
correct: correct,corrected,correcting,corrects
correction: correction,corrections
corrective: corrective
correctly: correctly
correctness: correctness
correlate: correlate,correlates
correlative: correlative
correspond: correspond,corresponds
correspondence: correspondence
corroborate: corroborating
corrupt: corrupt,corrupts
corruption: corruption
cosmical: cosmical
cosmological: cosmological
cosmologically: cosmologically
cosmology: cosmology
cost: cost,costs
counsel: counsel
countenance: countenance
counter: counter,counters
counterbalance: counterbalancing
country: countries,country
couple: coupled
courage: courage
court: court
courtesy: courtesy
covering: covering
covertly: covertly
create: create,created,creates,creating
creation: creation,creations
creative: creative
creator: creator,creators
creature: creature
credential: credential
credentials: credentials
credit: credit
credulity: credulity
creep: creep
crime: crime
criterion: criteria,criterion
critic: critic,critics
critical: critical
criticism: criticism
criticize: criticize,criticized
critique: critique
crowd: crowd,crowded
crown: crown,crowned,crowns
crucible: crucible
crude: crude
cubic: cubic
culpable: culpable
culprit: culprit
cultivate: cultivated
cultivation: cultivation
culture: culture
cum: cum
cure: cure
curiosity: curiosity
current: current
cursory: cursory
curvature: curvature
curved: curved
curvilinear: curvilinear
cushion: cushion
custom: customs
customary: customary
cut: cut,cutting
damage: damage
damaged: damaged
damages: damages
danger: danger
dangerous: dangerous
dark: dark,darkest
darkness: darkness
darling: darling
datum: data,datum
david: david
dawn: dawned
day: day,days
dead: dead
deaf: deaf
deal: deal,dealing,deals,dealt
dealing: dealing
death: death
debar: debarred
decade: decade
decay: decay
deceit: deceit
deceitful: deceitful
deceive: deceive,deceived
deception: deceptions
deceptive: deceptive
decide: decide,decided,decides,deciding
decidedly: decidedly
decision: decision
decisive: decisive
declaration: declaration,declarations
declare: declare,declared,declares,declaring
decline: decline,declined
decompose: decompose
decomposition: decomposition
decrease: decrease,decreases
decried: decried
decry: decried,decry
deduce: deduce,deduced,deducing
deducible: deducible
deductible: deductible
deduction: deduction,deductions
deed: deed
deem: deem
deep: deep,deeper,deepest
deeply: deeply
defect: defect,defects
defective: defective
defence: defence,defences
defend: defend,defended
defender: defenders
defensive: defensive
defer: defer
deficiency: deficiencies,deficiency
deficient: deficient
define: define,defined,defines,defining
definite: definite
definition: definition,definitions
degrading: degrading
degree: degree,degrees
deist: deist
deistic: deistic
deity: deity
delay: delay
deletion: deletions
delineate: delineate,delineated
deliver: delivered,delivers
deliverance: deliverance
delivery: delivery
delude: deludes,deluding
delusion: delusion,delusions
delusive: delusive
demand: demand,demanded,demanding,demands
demarcation: demarcation
demerit: demerit
demonstrable: demonstrable
demonstrate: demonstrate,demonstrated,demonstrates,demonstrating
demonstration: demonstration,demonstrations
demonstrative: demonstrative
demonstratively: demonstratively
demur: demur,demurred
denial: denial
denominate: denominate,denominated
denomination: denomination
denote: denote,denoted,denotes
denounce: denounce
deny: denied,denies,deny,denying
depart: depart,departs
department: department,departments
departure: departure
depend: depend,depending,depends
dependence: dependence
dependent: dependent
depict: depicted
deposit: deposit
depositor: depositor
depreciate: depreciated
depress: depressed
deprive: deprive,deprives,depriving
depths: depths
derivable: derivable
derivation: derivation
derivative: derivative
derive: derive,derived,derives,deriving
descartes: descartes
descend: descend,descending
descendant: descendants
descent: descent
description: description
desert: desert,deserted,deserts
deserve: deserve,deserves
deserving: deserving
design: design,designed,designing,designs
designate: designate,designated,designates,designating
designation: designation
desirable: desirable
desire: desire,desired,desires,desiring
desirous: desirous
desist: desist
despairing: despairing
desperate: desperate
despicable: despicable
despise: despise,despising
despotic: despotic
despotism: despotism
destination: destination
destine: destined
destiny: destiny
destitute: destitute
destroy: destroy,destroyed,destroying,destroys
destruction: destruction
destructive: destructive
detach: detach
detailed: detailed
detain: detain,detaining
detect: detect,detected,detecting
detection: detection
deter: deter
determinability: determinability
determinable: determinable
determinate: determinate
determinately: determinately
determination: determination,determinations
determinative: determinative
determine: determine,determined,determines,determining
determined: determined
detract: detract
detriment: detriment
detrimental: detrimental
develop: develop,developed
development: development
deviate: deviate,deviating
deviation: deviations
device: devices
devise: devised,devises
devoid: devoid
devote: devote,devoted,devoting
devoted: devoted
diagonal: diagonal
dialectic: dialectic,dialectics
dialectical: dialectical
dialectically: dialectically
dialectician: dialectician
diameter: diameter
dichotomy: dichotomy
dictate: dictate,dictated,dictates
dictation: dictation
dictatorial: dictatorial
dictum: dictum
didactically: didactically
die: die
difference: difference,differences
difficult: difficult
difficulty: difficulties,difficulty
dignity: dignity
digression: digressions
dilemma: dilemma
dim: dim
dimension: dimension,dimensions
diminish: diminish,diminished
diminution: diminution
diogenes: diogenes
direct: direct,directed,directing,directs
directed: directed
direction: direction,directions
disadvantage: disadvantage
disagreement: disagreement
disallow: disallowed
disappear: disappear,disappeared,disappears
disappearance: disappearance
disappointed: disappointed
disappointment: disappointment
disapproval: disapproval
disarrange: disarranging
discern: discerned
discipline: discipline
disclaim: disclaim
disclaimer: disclaimer,disclaimers
disclose: disclose,disclosed,discloses
disconcert: disconcert
disconnected: disconnected
discontinue: discontinue,discontinued,discontinuing
discord: discord
discover: discover,discovered,discovering,discovers
discoverable: discoverable
discoverer: discoverer
discovery: discoveries,discovery
discursive: discursive
discursively: discursively
discuss: discuss,discussed,discussing
discussion: discussion,discussions
disease: disease
disengage: disengage
disfigure: disfigure
disguise: disguise,disguised
disjoin: disjoin
disjunctive: disjunctive
disk: disk
dislike: dislike
dismay: dismay
dismiss: dismiss,dismissed,dismissing
disparage: disparage,disparaging
dispassionate: dispassionate
dispel: dispelled
dispensable: dispensable
dispense: dispense,dispensed,dispenses
display: display,displayed,displaying,displays
displeasure: displeasure
dispose: disposed,disposing
disposition: disposition,dispositions
disproportionate: disproportionate
disprove: disproved,disproving
disputant: disputants
dispute: dispute,disputes,disputing
disquiet: disquiet
disregard: disregard
disrepute: disrepute
dissatisfaction: dissatisfaction
dissect: dissect,dissecting
dissection: dissection
dissension: dissension
dissimilar: dissimilar
dissimilarity: dissimilarity
dissipate: dissipate
dissolution: dissolution
dissolve: dissolves
distance: distance,distances
distant: distant
distinct: distinct
distinction: distinction,distinctions
distinctive: distinctive
distinctness: distinctness
distinguish: distinguish,distinguished,distinguishes,distinguishing
distinguishable: distinguishable
distinguished: distinguished
distinguishing: distinguishing
distract: distract
distribute: distribute,distributed,distributing
distribution: distribution
distributive: distributive
distributor: distributor
distrust: distrust
distrustful: distrustful
disturb: disturb
disunion: disunion
disunited: disunited
disuse: disuse
diver: divers
diverse: diverse
diversified: diversified
diversity: diversities,diversity
divert: diverted
divest: divest,divested
divide: divide,divided,divides,dividing
divided: divided
divine: divine
divinity: divinity
divisibility: divisibility
divisible: divisible
division: division,divisions
docile: docile
doctrinal: doctrinal
doctrine: doctrine,doctrines
dog: dog
dogma: dogma,dogmas
dogmata: dogmata
dogmatic: dogmatic
dogmatical: dogmatical
dogmatically: dogmatically
dogmatism: dogmatism
dogmatist: dogmatist,dogmatists
dogmatize: dogmatizing
dollar: dollars
domain: domain,domains
dominion: dominion
donate: donate
donation: donation,donations
donor: donors
door: door
double: double
doubt: doubt,doubted,doubting,doubts
dove: dove
downfall: downfall
download: downloading
downward: downward
draught: draughts
draw: draw,drawing,drawn,draws,drew
drawing: drawing
dread: dread
dream: dream,dreaming,dreams
dress: dress
drink: drinks
drive: drive,driven,drives
drop: drop,drops
dry: driest,dry
ducat: ducat
dull: dull,dullest
dumb: dumb
duration: duration
duty: duties,duty
dwell: dwell
dwelling: dwelling
dynamical: dynamical
dynamically: dynamically
dynamics: dynamics
ear: ear
earnest: earnest
earnestly: earnestly
earth: earth,earths
earthly: earthly
ease: ease
easily: easily
easy: easy
economical: economical
economize: economize
economy: economy
ectypal: ectypal
edifice: edifice,edifices
edifying: edifying
edition: edition,editions
education: education
educational: educational
effective: effective
efficiency: efficiency
efficient: efficient
effort: effort,efforts
ego: ego
egyptian: egyptians
elaborate: elaborate,elaborating
elaboration: elaboration
elapse: elapsed
elect: elect
electronic: electronic
electronically: electronically
elegance: elegance
element: element,elements
elemental: elemental
elementary: elementary
elements: elements
elenchi: elenchi
elevate: elevate,elevated,elevating
elevated: elevated
elevation: elevation,elevations
eliminate: eliminate,eliminating
ellipse: ellipse
ellipsis: ellipses
eloquent: eloquent
elucidate: elucidate
elucidation: elucidation,elucidations
elude: elude,eluded
email: email
embarrass: embarrass,embarrassing
embarrassment: embarrassment,embarrassments
embellishment: embellishments
embrace: embrace,embraced,embraces,embracing
emend: emended
eminent: eminent
empire: empire
empirical: empirical
empirically: empirically
empiricism: empiricism
empiricist: empiricist,empiricists
employ: employ,employed,employing,employs
employee: employee,employees
employment: employment
empower: empower
en: ens
enable: enable,enabled,enables,enabling
enact: enacted
enclose: enclose,enclosed,enclosing
encode: encoding
encounter: encounter,encounters
encourage: encourage,encourages
encroach: encroaching
endeavour: endeavour,endeavoured,endeavouring
endless: endless
endow: endowed
endure: endure,enduring
enemy: enemies
energetic: energetic
engage: engage,engaged,engages
engaged: engaged
english: english
engraft: engraft
enigma: enigma
enigmatical: enigmatical
enjoin: enjoined
enjoy: enjoyed,enjoys
enlarge: enlarge,enlarged,enlarges,enlarging
enlarged: enlarged
enlargement: enlargement
enlighten: enlightened
enlightened: enlightened
enounce: enounce,enounced,enounces,enouncing
enouncement: enouncement
ens: ens
ensemble: ensemble
ensue: ensues
ensure: ensure,ensured,ensures,ensuring
enter: enter,entered,entering,enters
entertain: entertain,entertained,entertains
entertained: entertained
entia: entia
entire: entire
entitle: entitle,entitled
entity: entities,entity
entrust: entrust,entrusted
enumerate: enumerate,enumerated
enumeration: enumeration
enunciate: enunciated
enunciation: enunciation
epicurean: epicurean
epicureanism: epicureanism
epigenesis: epigenesis
epithet: epithet
epoch: epoch,epochs
equal: equal,equals
equality: equality
equally: equally
equation: equations
equator: equator
equilibrium: equilibrium
equip: equipped
equipment: equipment
equitable: equitable
equivalent: equivalent
equivocal: equivocal
eradicate: eradicated
ere: ere
erect: erect,erected,erecting,erects
erection: erection
ergo: ergo
err: err
erroneous: erroneous
erroneously: erroneously
error: error,errors
escape: escape,escaped,escaping
especial: especial
essay: essay
esse: esse
essence: essence
essential: essential
essentially: essentially
est: est
establish: establish,established,establishes,establishing
establishment: establishment
estimate: estimate,estimated,estimates,estimating
estimation: estimation
estrange: estranged
eternal: eternal
eternity: eternity
ethic: ethics
ethical: ethical
ethics: ethics
eulogize: eulogize
european: european
euthanasia: euthanasia
evade: evade,evading
evasion: evasion,evasions
evasive: evasive
event: event,events
everyday: everyday
evidence: evidence,evidences,evidencing
evident: evident
evidently: evidently
evil: evil,evils
evolve: evolve,evolved
exact: exact
exactness: exactness
exaggerate: exaggerates
exaggerated: exaggerated
exaggeration: exaggerations
examination: examination
examine: examine,examined,examining
exceed: exceeding
exceedingly: exceedingly
excellence: excellence
excellent: excellent
exception: exception,exceptions
exchange: exchange
excite: excite,excited,excites
excited: excited
exciting: exciting
exclude: exclude,excluded,excludes,excluding
exclusion: exclusion
exclusive: exclusive
exclusively: exclusively
excogitate: excogitate
excusable: excusable
excuse: excuse,excuses
execute: executed,executes
execution: execution
executive: executive
exemplification: exemplification
exemplify: exemplifies
exempt: exempt,exempted
exemption: exemption
exercise: exercise,exercised,exercises,exercising
exert: exert,exerted,exerts
exertion: exertions
exhaust: exhausted
exhibit: exhibit,exhibited,exhibiting,exhibits
exhibition: exhibition
exhort: exhort
exist: exist,existed,existing,exists
existence: existence,existences
existences: existences
existent: existent
existential: existential
existing: existing
expand: expanded
expansion: expansion
expect: expect,expected,expecting,expects
expectation: expectation,expectations
expedient: expedient
expend: expend
expense: expense,expenses
experience: experience,experiences
experiment: experiment,experimented,experimenting,experiments
experimental: experimental
explain: explain,explained,explaining,explains
explanation: explanation,explanations
explication: explication
explicative: explicative
explore: explore
exponent: exponent,exponents
export: exporting
expose: expose,exposed,exposes,exposing
exposition: exposition,expositions
exposure: exposure
express: express,expressed,expresses,expressing
expressed: expressed
expression: expression,expressions
expressive: expressive
expressly: expressly
extend: extend,extended,extending,extends
extended: extended
extension: extension
extensive: extensive
extensively: extensively
extent: extent
exterior: exterior
external: external
externally: externally
extinct: extinct
extinction: extinction
extirpate: extirpate
extract: extract,extracted
extraction: extraction
extraneously: extraneously
extraordinary: extraordinary
extravagance: extravagance
extravagant: extravagant
extreme: extreme,extremes
extremely: extremely
exul: exul
eye: eye,eyes
facia: facia
facilitate: facilitate
facility: facility
factitious: factitious
facto: facto
faculty: faculties,faculty
fail: fail,failed,failing,fails
failure: failure
faint: faint
fair: fair
fairness: fairness
faith: faith
fall: fall,fallen,falling,falls,fell
fallacious: fallacious
fallacy: fallacies,fallacy
fallible: fallible
false: false
falsehood: falsehood
falsely: falsely
falseness: falseness
falsification: falsification
falsify: falsify
falsity: falsity
fame: fame
familiar: familiar
family: family
famous: famous
fanaticism: fanaticism
fancied: fancied
fanciful: fanciful
fancy: fancies,fancy
fantastic: fantastic
fantasy: fantasy
fare: fare
farth: farthest
fashion: fashion
fashionable: fashionable
fast: fast
fatal: fatal
fatalism: fatalism
fate: fate
father: father
fault: fault
faultiness: faultiness
faultless: faultless
faulty: faulty
favour: favour,favoured,favouring,favours
favourable: favourable
favourite: favourite
fear: fear
fecundity: fecundity
federal: federal
fee: fee,fees
feel: feel,feels
feeling: feeling,feelings
fetter: fetters
fiction: fiction,fictions
fictitious: fictitious
field: field,fields
fierce: fierce
fiery: fiery
fight: fight,fighting,fought
figurae: figurae
figurative: figurative
figuratively: figuratively
figure: figure,figures
file: file,files
filings: filings
filling: filling
final: final
finalis: finalis
finality: finality
finally: finally
financial: financial
finespun: finespun
finger: fingers
finish: finish,finishing
finite: finite
finitude: finitude
firm: firm
firmly: firmly
firmness: firmness
firstly: firstly
fit: fit,fitted,fitting
fitness: fitness
flash: flashed
flat: flat,flatter
flatten: flattened,flattening
flatter: flatters
flattering: flattering
flight: flight
fling: fling
float: float
flow: flow,flowing
fluency: fluency
fluid: fluid
fluidity: fluidity
focus: focus
fog: fog
follow: follow
follower: follower,followers
foot: feet,foot,footing
footed: footed
footing: footing
footpath: footpath
footstep: footsteps
forbid: forbid,forbidden,forbidding,forbids
force: force,forced,forces,forcing
forcibly: forcibly
fore: fore
forego: foregoing
foregone: foregone
foreign: foreign
foresee: foreseen
forestall: forestall
forethought: forethought
forget: forgets,forgetting
forlorn: forlorn
form: form,formed,forming,forms
formal: formal
formaliter: formaliter
format: format,formats
formation: formation
formative: formative
formidable: formidable
formula: formula,formulae,formulas
forsake: forsaken
forthcoming: forthcoming
fortified: fortified
fortuitous: fortuitous
fortunate: fortunate
fortunately: fortunately
fortune: fortune
foster: fosters
foundation: foundation,foundations
fountain: fountain
fourfold: fourfold
fourth: fourth
fourthly: fourthly
fragmentary: fragmentary
frame: frame,framed,framing
frankly: frankly
fraternal: fraternal
freedom: freedom
freely: freely
freezing: freezing
frequent: frequent
frequently: frequently
fresh: fresh
friend: friends
frivolity: frivolity
fruitful: fruitful
fruitfulness: fruitfulness
fruitless: fruitless
frustrate: frustrate,frustrated
fulfil: fulfil,fulfilled,fulfils
function: function,functions
fund: fund
fundamental: fundamental
furnish: furnish,furnished,furnishes
furnishing: furnishing
futility: futility
future: future
gain: gain,gained,gaining,gains
gainer: gainer
galilei: galilei
game: game
genealogical: genealogical
genealogy: genealogy
genera: genera
generality: generality
generalness: generalness
generate: generate,generated,generates,generating
generating: generating
generation: generation,generations
generic: generic
generis: generis
genesis: genesis
genius: genius
genuine: genuine
genuineness: genuineness
genus: genera,genus
geographer: geographers
geometrical: geometrical
geometrician: geometrician,geometricians
geometry: geometry
germ: germ,germs
german: german,germans
germany: germany
gift: gift,gifts
gladly: gladly
glance: glance
glass: glass
glimmer: glimmer
glimpse: glimpses
glorious: glorious
goal: goal,goals
goat: goat
god: god
gold: gold
goodness: goodness
govern: govern,governs
government: government,governments
governor: governor
grace: grace
gradation: gradation,gradations
gradual: gradual
gradually: gradually
graduate: graduated
graduation: graduation
grand: grand
grandeur: grandeur
grant: grant,granted,granting,grants
grasp: grasp
gratefully: gratefully
gratified: gratified
gratuitous: gratuitous
gravitation: gravitation
gravity: gravity
greatly: greatly
greatness: greatness
greek: greek,greeks
grind: ground
grope: groping
gross: gross
grossly: grossly
ground: ground,grounded,grounding
groundless: groundless
grounds: grounds
groundwork: groundwork
grow: grow,grown,grows
growth: growth
guarantee: guarantee,guaranteed,guaranteeing,guarantees
guard: guard,guarded,guarding,guards
guardianship: guardianship
guess: guess,guesses
guest: guest
guidance: guidance
guide: guide,guided,guides,guiding
guilty: guilty
habit: habit,habits
habitation: habitation
habitually: habitually
hair: hair
halve: halved
hand: hand,hands
handle: handles
haphazard: haphazard
happen: happen,happened,happening
happily: happily
happiness: happiness
happy: happy
hard: hard
harden: hardens
hardness: hardness
harm: harm
harmless: harmless
harmonious: harmonious
harmoniously: harmoniously
harmonize: harmonize,harmonizes
harmony: harmony
harsh: harsh
hart: hart
haste: haste
hasten: hastens
hasty: hasty
hate: hate
hateful: hateful
hazard: hazard
head: head,heads
healthy: healthy
heap: heap
hear: hear,heard,hears
hearing: hearing
heart: heart
heat: heat
heaven: heaven
heavenly: heavenly
heavy: heavy
hecuba: hecuba
height: height,heights
hem: hemmed
henceforward: henceforward
hereditary: hereditary
hero: heroes
herr: herr
hesitate: hesitate,hesitates
hesitation: hesitation
heterogeneity: heterogeneity
heterogeneous: heterogeneous
heuristic: heuristic
hew: hew
hiatus: hiatus
hidden: hidden
hide: hidden
highly: highly
highway: highway
hinder: hinder,hinders
hindrance: hindrance
hint: hint
historian: historian
historical: historical
history: history
hitherto: hitherto
hold: held,hold,holding,holds
holder: holder
holding: holding
hole: hole
hollow: hollow
homogeneity: homogeneity
homogeneous: homogeneous
honest: honest
honestly: honestly
honesty: honesty
honour: honour,honoured
hope: hope,hoped,hopes,hoping
hopeless: hopeless
horizon: horizon,horizons
horizontal: horizontal
hostile: hostile
house: house
hover: hovering,hovers
human: human
humanity: humanity
humble: humble
humbly: humbly
hume: hume
humiliating: humiliating
humiliation: humiliation
hunt: hunted
hurry: hurry
hurtful: hurtful
hyperbolic: hyperbolic
hyperphysical: hyperphysical
hypocrisy: hypocrisy
hypostatic: hypostatic
hypostatization: hypostatization
hypostatize: hypostatize,hypostatized,hypostatizing
hypostatizing: hypostatizing
hypothesis: hypotheses,hypothesis
hypothetical: hypothetical
hypothetically: hypothetically
iceberg: iceberg
idea: idea,ideas
ideal: ideal,ideals
idealism: idealism
idealistic: idealistic
ideality: ideality
idealize: idealizing
ideas: ideas
identical: identical
identification: identification
identify: identify
identity: identity
idle: idle
idolater: idolaters
ignorance: ignorance
ignorant: ignorant
ignore: ignore,ignoring
iii: iii
illegitimate: illegitimate
illimitable: illimitable
illimitableness: illimitableness
illuminate: illuminated
illuminations: illuminations
illusion: illusion,illusions
illusory: illusory
illustrate: illustrate,illustrated,illustrating
illustration: illustration,illustrations
illustrative: illustrative
image: image,images
imaginary: imaginary
imagination: imagination
imagine: imagine
imitate: imitate,imitated,imitating
imitation: imitation
imitative: imitative
immanence: immanence
immanent: immanent
immanuel: immanuel
immaterial: immaterial
immateriality: immateriality
immeasurable: immeasurable
immeasurably: immeasurably
immense: immense
immensity: immensity
imminently: imminently
immoral: immoral
immortal: immortal
immortality: immortality
immovable: immovable
immutable: immutable
impair: impaired
impart: impart,imparted,imparts
impartial: impartial
impartiality: impartiality
impassable: impassable
impatient: impatient
impede: impedes
impediment: impediment,impediments
impel: impelled,impelling,impels
impenetrability: impenetrability
impenetrable: impenetrable
imperative: imperative,imperatives
imperatively: imperatively
imperfect: imperfect
imperfection: imperfection
imperfectly: imperfectly
imperil: imperilled
impetus: impetus
implant: implanted
imply: implied,implies,imply
import: import
impose: impose,imposed,imposes,imposing
impossibility: impossibility
impossible: impossible
impotent: impotent
impracticability: impracticability
impracticable: impracticable
impregnation: impregnation
impression: impression,impressions
improperly: improperly
improve: improved
improvement: improvement,improvements
improvidently: improvidently
improvise: improvising
impugn: impugned
impulse: impulse,impulses
impure: impure
imputable: imputable
imputation: imputation
impute: imputing
imputed: imputed
inability: inability
inaccurate: inaccurate
inaction: inaction
inactive: inactive
inadequacy: inadequacy
inadequate: inadequate
inadmissible: inadmissible
inadvertently: inadvertently
inane: inane
inanimate: inanimate
inapplicable: inapplicable
inappropriate: inappropriate
incapable: incapable
incapacitate: incapacitate,incapacitates
incapacity: incapacity
incautious: incautious
incessantly: incessantly
inch: inch
incidental: incidental
incite: incite,incited
incitement: incitement
inclination: inclination,inclinations
incline: inclined
inclined: inclined
include: include,included,includes,including
including: including
incogitable: incogitable
incognizable: incognizable
incompatible: incompatible
incompetent: incompetent
incomplete: incomplete
incompletely: incompletely
incompleteness: incompleteness
incomprehensibility: incomprehensibility
incomprehensible: incomprehensible
inconceivable: inconceivable
incongruity: incongruity
inconsequently: inconsequently
inconsiderable: inconsiderable
inconsiderateness: inconsiderateness
inconsistency: inconsistency
inconsistent: inconsistent
incontestably: incontestably
incontrovertible: incontrovertible
incontrovertibly: incontrovertibly
inconvenience: inconvenience
incorporate: incorporated
incorporeal: incorporeal
incorrect: incorrect
incorrectly: incorrectly
incorruptibility: incorruptibility
increase: increase,increased,increases,increasing
increment: increment
inculcate: inculcate
incumbent: incumbent
indebted: indebted
indefinite: indefinite
indefinitely: indefinitely
indemnify: indemnify
indemnity: indemnity
indemonstrable: indemonstrable
independence: independence
independent: independent
independently: independently
indescribably: indescribably
indestructible: indestructible
indeterminable: indeterminable
indeterminate: indeterminate
indeterminateness: indeterminateness
indication: indication,indications
indicative: indicative
indifference: indifference
indifferent: indifferent
indifferentism: indifferentism
indirect: indirect
indirectly: indirectly
indiscernible: indiscernible
indispensable: indispensable
indispensably: indispensably
indisputable: indisputable
indisputably: indisputably
indissoluble: indissoluble
indissolubly: indissolubly
indistinct: indistinct
individual: individual,individuals
individuality: individuality
individually: individually
individuum: individuum
indivisible: indivisible
indolence: indolence
indubitable: indubitable
indubitably: indubitably
induce: induce,induced,induces
inducement: inducement
induction: induction
indulge: indulge
indulgence: indulgence
inefficient: inefficient
inequality: inequality
inertiae: inertiae
inestimable: inestimable
inevitable: inevitable
inevitably: inevitably
inexhaustible: inexhaustible
inexperienced: inexperienced
inextinguishable: inextinguishable
inextricable: inextricable
infallible: infallible
infallibly: infallibly
infancy: infancy
infer: infer,inferred,inferring,infers
inference: inference,inferences
infinite: infinite
infinitely: infinitely
infinitude: infinitude
infinitum: infinitum
infinity: infinity
infit: infit
inflammable: inflammable
influence: influence,influenced,influences,influencing
inform: inform
informed: informed
infringement: infringement
ingenious: ingenious
inhabit: inhabited
inhabitant: inhabitants
inhere: inhere,inheres
inherence: inherence
inherent: inherent
inimical: inimical
initial: initial
initiation: initiation
injure: injure,injured,injuring
injurious: injurious
injury: injury
injustice: injustice
innate: innate
innermost: innermost
innocent: innocent
innumerable: innumerable
inorganic: inorganic
inquire: inquire,inquires,inquiring
inquirer: inquirer,inquirers
inquiry: inquiries,inquiry
insatiable: insatiable
inscrutable: inscrutable
insecure: insecure
insecurity: insecurity
insensate: insensate
inseparable: inseparable
inseparably: inseparably
insert: inserted
insight: insight
insignia: insignia
insignificant: insignificant
insist: insist,insisted,insisting
insoluble: insoluble
insomuch: insomuch
instance: instance,instances
instant: instant
instantaneous: instantaneous
instil: instilling
instinct: instincts
institute: institute,instituted
institution: institution,institutions
instruct: instruct,instructed,instructs
instruction: instruction
instructor: instructors
instructress: instructress
instrument: instrument,instruments
instrumentality: instrumentality
insufficiency: insufficiency
insufficient: insufficient
insuperable: insuperable
insure: insured
insurmountable: insurmountable
intact: intact
intellect: intellect
intellectual: intellectual
intellectualize: intellectualized
intelligence: intelligence,intelligences
intelligent: intelligent
intelligently: intelligently
intelligibility: intelligibility
intelligible: intelligible
intemperance: intemperance
intend: intend,intended
intensive: intensive
intention: intention,intentions
intentional: intentional
inter: inter
interchange: interchange,interchanged
interfere: interfere,interfered
interference: interference
interior: interior
intermediate: intermediate
internal: internal
internally: internally
international: international
interne: interne
interpret: interpreted
interpretation: interpretation
interrogate: interrogate
interrogation: interrogation
interrupt: interrupted
intervention: intervention
interwoven: interwoven
intestine: intestine
intimidation: intimidation
intolerable: intolerable
intrinsic: intrinsic
intrinsically: intrinsically
introd: introd
introduce: introduce,introduced,introduces,introducing
introduction: introduction
introductory: introductory
introspection: introspections
intrude: intrude
intrusive: intrusive
intuit: intuited,intuiting
intuition: intuition,intuitions
intuitional: intuitional
intuitive: intuitive
intuitively: intuitively
invalid: invalid
invalidate: invalidate
invalidity: invalidity
invariably: invariably
invent: invent,invented
inventor: inventors
inventory: inventory
inverse: inverse
investigate: investigate,investigated,investigating
investigation: investigation,investigations
invincible: invincible
inviolable: inviolable
invisible: invisible
invite: invites,inviting
involve: involve,involved,involves,involving
involved: involved
inwardly: inwardly
ipso: ipso
irrational: irrational
irreconcilable: irreconcilable
irrefutable: irrefutable
irremediable: irremediable
irreparable: irreparable
irresistible: irresistible
irresistibly: irresistibly
irrespective: irrespective
irs: irs
island: island
ism: ism
isolate: isolate,isolated
isolated: isolated
isosceles: isosceles
issue: issue
iv: iv
ix: ix
jealous: jealous
judge: judge,judged,judges,judging
judgement: judgement,judgements
judgements: judgements
judging: judging
judicial: judicial
judicium: judicium
juggling: juggling
july: july
jump: jumping
junction: junction
juridical: juridical
juris: juris
jurisdiction: jurisdiction
jurisprudence: jurisprudence
jurists: jurists
jury: jury
justice: justice
justification: justification
justified: justified
justify: justified,justifies,justify
justly: justly
kai: kai
kant: kant
kantian: kantian
kat: kat
key: key
kingdom: kingdom,kingdoms
knot: knot
knowledge: knowledge
laborious: laborious
labour: labour,labours
labourer: labourers
ladder: ladder
lake: lake
lambert: lambert
lame: lame
lamentable: lamentable
land: land
language: language,languages
lapse: lapse
lapsus: lapsus
lasting: lasting
lastly: lastly
late: late
latent: latent
latin: latin
laugh: laughed
law: law,laws
lawgiver: lawgiver
lawless: lawless
lawlessness: lawlessness
lawsuit: lawsuits
lay: laid,lay,laying,lays
lead: lead,leading,leads,led
leaden: leaden
leap: leap,leaping
learn: learn,learned,learnt
learner: learner
leave: leave,leaves,leaving,left
left: left
legacy: legacy
legal: legal
legally: legally
legis: legis
legislating: legislating
legislation: legislation
legislative: legislative
legislator: legislators
legitimacy: legitimacy
legitimate: legitimate
legitimately: legitimately
leibnitzian: leibnitzian
lend: lend
lessen: lessened
lesson: lesson
level: level
levity: levity
lex: lex
liability: liability
liable: liable
liberate: liberate
liberty: liberty
liberum: liberum
libitum: libitum
library: library
licence: licence
license: license
licensed: licensed
lie: lie,lies,lying
lieu: lieu
life: life,lives
lift: lifts
light: light
limb: limb
lime: lime
limit: limit,limited,limiting,limits
limitation: limitation,limitations
limitative: limitative
limited: limited
linear: linear
link: link,linked,links
liquet: liquet
liquid: liquid
list: list
listen: listen,listens
listener: listener
literary: literary
live: live,living
living: living
locale: locale
locate: located
location: locations
logic: logic
logical: logical
logically: logically
logician: logician,logicians
logicians: logicians
loose: loose
loosely: loosely
loquacious: loquacious
lose: lose,loses,losing,lost
loss: loss
lot: lot
loth: loth
loud: loud
lucid: lucid
lurk: lurk,lurking,lurks
machine: machine,machines
madness: madness
magical: magical
magnet: magnet
magnetic: magnetic
magnificent: magnificent
magnify: magnified
magnitude: magnitude
main: main
maintain: maintain,maintained,maintaining,maintains
maintainer: maintainer
maintenance: maintenance
majestic: majestic
majesty: majesty
major: major
majority: majority
malevolent: malevolent
malleability: malleability
manager: manager
manhood: manhood
manifest: manifest,manifests
manifestation: manifestation,manifestations
manifestly: manifestly
manifold: manifold
manifoldness: manifoldness
mankind: mankind
manner: manner
manners: manners
manual: manuals
mar: marred
march: march
mariner: mariner
mark: mark,marked,marks
mass: mass,masses
master: master,mastered,masters
material: material,materials
materialism: materialism
materialist: materialist
materially: materially
mathematic: mathematic
mathematical: mathematical
mathematically: mathematically
mathematician: mathematician,mathematicians
mathematics: mathematics
matron: matron
matter: matter,matters
mature: matured
maturity: maturity
maxim: maxim,maxims
maximum: maxima,maximum
maze: mazes
meaning: meaning,meanings
meaningless: meaningless
measure: measure,measured,measures
measurement: measurement
mechanic: mechanics
mechanical: mechanical
mechanically: mechanically
mechanism: mechanism
mecum: mecum
mediate: mediate,mediates,mediating
mediately: mediately
mediation: mediation
medical: medical
meditate: meditate,meditating
meditation: meditation
medium: medium
meet: meet,meets,met
melancholy: melancholy
melior: melior
melt: melts
memory: memory
menace: menace
mendelssohn: mendelssohn
mental: mental
mention: mention,mentioned
merchant: merchant
merchantability: merchantability
mercury: mercury
mere: mere
merge: merge
merit: merit,merits
metabasis: metabasis
metal: metal,metals
metamorphose: metamorphosed
metamorphoses: metamorphoses
metaphysic: metaphysic
metaphysical: metaphysical
metaphysician: metaphysician,metaphysicians
metaphysics: metaphysics
method: method,methods
methodical: methodical
methodology: methodology
michael: michael
microscopical: microscopical
middle: middle
midst: midst
midway: midway
mighty: mighty
militate: militates
milk: milking
mind: mind,minds
minded: minded
mineral: minerals
mingle: mingled,mingles
minor: minor
minority: minority
miracle: miracle
mirror: mirror
misapplication: misapplication
misapply: misapplied
misapprehension: misapprehension,misapprehensions
miscarriage: miscarriage
mischievous: mischievous
misconceived: misconceived
misconception: misconception,misconceptions
misemployment: misemployment
miserable: miserable
miserably: miserably
misfortune: misfortune
misinterpretation: misinterpretation
mislead: mislead,misleads,misled
misleading: misleading
misology: misology
misrepresentation: misrepresentation
mission: mission
mississippi: mississippi
mistake: mistake,mistaken,mistakes,mistaking
mistaken: mistaken
mistakenly: mistakenly
mistress: mistress
mistrust: mistrust
mistrustful: mistrustful
misunderstand: misunderstood
misunderstanding: misunderstanding
misuse: misuse,misused
mix: mixed
mixture: mixture
mob: mob
mock: mock,mocked,mocking,mocks
modality: modality
mode: mode,modes
model: model,models
moderate: moderate
moderation: moderation
modern: modern,moderns
modest: modest
modesty: modesty
modi: modi
modification: modification,modifications
modify: modified,modifying
modo: modo
modus: modus
moment: moment,moments
momenta: momenta
momentary: momentary
momentum: momentum
mona: monas
monad: monads
monadology: monadology
money: money
monogram: monogram
monopoly: monopoly
monotheism: monotheism
month: month
moon: moon
moral: moral,morals
moralist: moralist,moralists
morality: morality
moralize: moralized
morally: morally
morrow: morrow
mortal: mortal
mother: mother
motion: motion,motions
motive: motive,motives
motto: motto
mount: mount
mountain: mountain,mountains
mourn: mourns
movable: movable
movement: movements
mover: mover
multiplicity: multiplicity
multitude: multitude
music: music
musician: musician
mutable: mutable
mutation: mutation
mutual: mutual
mutually: mutually
mysterious: mysterious
mystery: mystery
mystical: mystical
mysticism: mysticism
naked: naked
narrow: narrow
narrowly: narrowly
narrowness: narrowness
nation: nation,nations
national: national
native: native
natura: natura
natural: natural
naturalist: naturalist,naturalists
naturalistic: naturalistic
naturally: naturally
nature: nature,natures
naught: naught
necessitate: necessitate,necessitated,necessitates,necessitating
necessity: necessities,necessity
needful: needful
needless: needless
negation: negation,negations
negative: negative,negatived,negatives
negatively: negatively
neglect: neglect
negligence: negligence
nervus: nervus
nest: nest
network: network
neutrality: neutrality
newsletter: newsletter
newtonian: newtonian
nexus: nexus
nigh: nigh
night: night
nihil: nihil
nihilum: nihilum
nil: nil
noble: noble
nomadic: nomadic
nonentity: nonentities,nonentity
nonproprietary: nonproprietary
nonsense: nonsense
north: north
notation: notation
note: notes
nothingness: nothingness
notice: notice
notify: notifies
notion: notion,notions
notional: notional
nought: nought,noughts
noumena: noumena
noumenon: noumenon
nourish: nourishing
novelty: novelty
novo: novo
nowadays: nowadays
nugatory: nugatory
nullify: nullifies,nullifying
nullity: nullity
nullo: nullo
numeration: numeration
numerical: numerical
numerically: numerically
numero: numero
numerous: numerous
nunc: nunc
obedience: obedience
obedient: obedient
obey: obey,obeying
object: object,objected,objects
objection: objection,objections
objective: objective
objectively: objectively
objectivize: objectivized
objector: objector
obligation: obligation
obligatory: obligatory
oblige: obliged,obliges
obliterate: obliterated
oblivion: oblivion
obnoxious: obnoxious
obscure: obscure,obscured
obscurely: obscurely
obscurity: obscurities,obscurity
observable: observable
observance: observance
observation: observation,observations
observe: observe,observed,observes,observing
observer: observer,observers
obsolete: obsolete
obstacle: obstacle,obstacles
obstinacy: obstinacy
obstinate: obstinate
obstinately: obstinately
obtuseness: obtuseness
obviate: obviate
obvious: obvious
occasion: occasion,occasioned,occasioning,occasions
occasionally: occasionally
occupation: occupation
occupy: occupied,occupies,occupy,occupying
occur: occur,occurred,occurs
occurrence: occurrence
ocean: ocean
ocular: ocular
offence: offence
offender: offender
offer: offer,offering,offers
office: office
official: official
offspring: offspring
omission: omission
omit: omit
omni: omni
omnipotence: omnipotence
omnipotent: omnipotent
omnipresence: omnipresence
omnipresent: omnipresent
omniscient: omniscient
oneself: oneself
online: online
onset: onset
ontological: ontological
ontology: ontology
onwards: onwards
openly: openly
operate: operate,operates,operating
operating: operating
operation: operation,operations
operative: operative
opinion: opinion,opinions
opponent: opponent,opponents
opportunity: opportunities,opportunity
oppose: oppose,opposed,opposing
opposed: opposed
opposition: opposition
optical: optical
oration: oration
orbit: orbits
ordain: ordaining,ordains
ordinary: ordinary
organ: organ,organs
organic: organic
organism: organism
organization: organization
organize: organized
organized: organized
organon: organon
organum: organum
origin: origin
original: original
originally: originally
originate: originate,originated,originates,originating
origination: origination
originator: originator
ostensive: ostensive
otherwhere: otherwhere
outbreak: outbreak
outdated: outdated
outline: outline,outlines
outlook: outlook
outset: outset
outward: outward
overbalance: overbalance
overborne: overborne
overcome: overcome,overcoming
overflow: overflow
overgrown: overgrown
overlook: overlook,overlooked,overlooking
overstep: overstep,oversteps
overtake: overtake,overtakes
overthrow: overthrow,overthrown
overturn: overturn,overturning
ovid: ovid
owe: owe,owed
owner: owner
pain: pain
painter: painters
pair: pair
palingenesis: palingenesis
palpable: palpable
paper: paper
paperwork: paperwork
parabola: parabola
parade: paraded,parading
paradox: paradox
paradoxical: paradoxical
paragraph: paragraph,paragraphs
parallel: parallel
parallelism: parallelism
paralogism: paralogism
parent: parent,parents
parsimony: parsimony
parte: parte
partial: partial
partiality: partiality
partially: partially
participant: participant
participation: participation
particularity: particularity
particularize: particularize
partisan: partisans
partly: partly
party: parties,party
pass: pass,passed,passes,passing
passage: passage,passages
passing: passing
passion: passion,passions
passive: passive
path: path,paths
pathological: pathological
pathologically: pathologically
patient: patient
pause: pause
pay: paid,pay,paying,pays
payment: payments
peace: peace
peculiar: peculiar
peculiarity: peculiarities,peculiarity
peculiarly: peculiarly
pendant: pendant
penetrate: penetrate,penetrated,penetrating
penetration: penetration
perceive: perceive,perceived,perceives,perceiving
perceptible: perceptible
perception: perception,perceptions
perceptive: perceptive
perfect: perfect,perfects
perfectibility: perfectibility
perfection: perfection
perfectly: perfectly
perform: perform,performed,performing,performs
performance: performances
perfume: perfume
period: period,periods
periodic: periodic
perish: perish
permanence: permanence
permanency: permanency
permanent: permanent
permanently: permanently
permissible: permissible
permission: permission
permissive: permissive
permit: permit,permits,permitted
pernicious: pernicious
perpendicular: perpendicular
perpetual: perpetual
perpetually: perpetually
perplexity: perplexities,perplexity
persist: persist,persisted
persistence: persistence
person: people,person,persons
personal: personal
personality: personality
personify: personified
perspicuity: perspicuity
persuade: persuade,persuaded,persuading
persuasion: persuasion
pertain: pertain,pertaining,pertains
perversion: perversion
pervert: pervert
perverted: perverted
petitio: petitio
petty: petty
phaedo: phaedo
phaenomenon: phaenomenon
phantom: phantom,phantoms
pharmacopoeia: pharmacopoeia
phenomena: phenomena
phenomenal: phenomenal
phenomenize: phenomenized
phenomenon: phenomena,phenomenon
philosopher: philosopher,philosophers
philosophic: philosophic
philosophical: philosophical
philosophize: philosophize,philosophized,philosophizing
philosophy: philosophies,philosophy
phrase: phrase
phthisis: phthisis
physical: physical
physician: physician
physics: physics
physiocracy: physiocracy
physiological: physiological
physiology: physiology
pick: pick,picked
picture: picture
piece: piece,pieces
pilgrimage: pilgrimage
pillar: pillars
pious: pious
pitiful: pitiful
plain: plain,plainer,plainest
plainly: plainly
plan: plan,plans
plane: plane
planet: planets
plant: plant,plants
plaster: plaster
plate: plate
plato: plato
platonic: platonic
platonism: platonism
plausibility: plausibility
plausible: plausible
play: play,played,plays
plea: plea
pleading: pleading
pleasant: pleasant
pleasure: pleasure
plurality: plurality
pneumatism: pneumatism
poison: poison,poisons
pole: poles
polemic: polemic
polemics: polemics
police: police
political: political
polytheism: polytheism
pomp: pomp
pompous: pompous
poor: poorest
popular: popular
popularity: popularity
popularly: popularly
portion: portion,portions
pose: posed
posit: posit,posited,positing,posits
positing: positing
position: position,positions
positive: positive,positives
positively: positively
posse: posse,posses
possess: possess,possessed,possesses,possessing
possession: possession,possessions
possessor: possessor
possibility: possibilities,possibility
post: post,posted
posteriori: posteriori
posterity: posterity
posthumous: posthumous
postpone: postpone,postponed
postulate: postulate,postulated,postulates
postulatum: postulatum
potential: potential
poverty: poverty
power: power,powers
powerful: powerful
powerless: powerless
practicability: practicability
practicable: practicable
practical: practical
practically: practically
practice: practice
practise: practised
practised: practised
practitioner: practitioners
pragmatical: pragmatical
praise: praise
praiseworthy: praiseworthy
prating: prating
pravity: pravity
precede: precede,preceded,precedes,preceding
precedence: precedence
precept: precept,precepts
preception: preception
precise: precise
precisely: precisely
precision: precision
preclude: preclude
preconceived: preconceived
precondition: precondition
predecessor: predecessors
predetermine: predetermine,predetermined
predicable: predicable
predicament: predicaments
predicate: predicate,predicated,predicates,predicating
preface: preface
prefer: prefer,preferred,preferring,prefers
preferable: preferable
preference: preference
preformation: preformation
prejudice: prejudice,prejudices
prejudicial: prejudicial
preliminary: preliminaries,preliminary
prelude: prelude
premier: premier
premise: premise,premises
premiss: premiss,premisses
premonition: premonition
preparation: preparation,preparations
prepare: prepare,prepared,prepares,preparing
prepared: prepared
preponderance: preponderance
preponderate: preponderate
prerogative: prerogative
prescribe: prescribe,prescribed,prescribes,prescribing
prescription: prescription
presence: presence
presentable: presentable
presentation: presentation
presently: presently
preservation: preservation
preserve: preserve,preserved,preserving
press: press,pressing
presume: presume,presumed
presumption: presumption
presumptuous: presumptuous
presuppose: presuppose,presupposed,presupposes,presupposing
presupposition: presupposition
pretence: pretence
pretend: pretend,pretended,pretending
pretension: pretension,pretensions
pretext: pretext
pretty: pretty
prevail: prevailed
prevalent: prevalent
prevent: prevent,prevented,preventing,prevents
prevention: prevention
previous: previous
pride: pride
primal: primal
primary: primary
prime: prime
primeval: primeval
primitive: primitive
primitively: primitively
prince: prince
principal: principal
principally: principally
principium: principium
principle: principle,principles
principles: principles
print: print,printed
prior: prior
priori: priori
prius: prius
private: private
privation: privation
privilege: privilege
prize: prize,prized
probability: probability
probable: probable
probandi: probandi
probity: probity
problematic: problematic
problematical: problematical
problematically: problematically
procedure: procedure
proceed: proceed,proceeded,proceeding,proceeds
proceeding: proceeding
proceeds: proceeds
process: process,processes
processing: processing
procession: procession
procure: procuring
produce: produce,produced,produces,producing
product: product,products
production: production,productions
productive: productive
profess: profess,professed,professes,professing
profession: profession,professions
professor: professor
profit: profits
profitable: profitable
profound: profound
profoundly: profoundly
profundity: profundity
programme: programme
progress: progress,progresses,progressing
progression: progression
progressive: progressive
progressively: progressively
prohibit: prohibiting
prohibition: prohibition
prohibitive: prohibitive
project: project,projected
prolixity: prolixity
prolong: prolonged,prolonging
prolongation: prolongation
prominently: prominently
promise: promise,promises,promising
promote: promote,promoted,promoting
promotion: promotion
promotive: promotive
prompt: prompted
pronounce: pronounce,pronounces
proof: proof,proofs
proofread: proofread
proofs: proofs
propensity: propensity
proper: proper
properly: properly
property: properties,property
proportion: proportion,proportioned,proportions
proportionate: proportionate
propose: propose,proposed,proposes,proposing
proposition: proposition,propositions
propound: propound,propounded
proprietary: proprietary
propriety: propriety
prospect: prospect
prospects: prospects
prosyllogism: prosyllogism
protect: protect,protected
protensive: protensive
protest: protest
prototype: prototype
protuberance: protuberance
prove: prove,proved,proves,proving
proverbial: proverbial
provide: provide,providing
providence: providence
providential: providential
province: province
provision: provision,provisions
provisionary: provisionary
proximity: proximity
prudence: prudence
prudent: prudent
prudential: prudential
psychological: psychological
psychologist: psychologist
psychology: psychology
public: public
publish: publish,published
punish: punished
punishment: punishments
punitive: punitive
pupil: pupil
pupilage: pupilage
pure: pure
purely: purely
purify: purified,purify
purity: purity
purpose: purpose,purposed,purposes
purposeless: purposeless
purposely: purposely
pursue: pursue,pursued,pursues,pursuing
pursuit: pursuit,pursuits
push: push,pushed
qua: qua
quaestio: quaestio
qualitative: qualitative
quality: qualities,quality
quam: quam
quando: quando
quanta: quanta
quanti: quanti
quantitative: quantitative
quantity: quantities,quantity
quantum: quantum
quarrel: quarrel
quarter: quarter
queen: queen
question: question,questions
quibble: quibble,quibbling
quibus: quibus
quicken: quicken,quickened
quid: quid
quit: quit
quoad: quoad
quod: quod
quodlibet: quodlibet
race: race,races
radiate: radiating
radical: radical
radius: radius
rain: rain
rainbow: rainbow
raindrop: raindrops
raise: raise,raised,raises,raising
random: random
range: range
rank: rank,ranked,ranks
rapid: rapid
rapidly: rapidly
rare: rare
rarely: rarely
rash: rash
rashly: rashly
ratio: ratio
rational: rational
rationalist: rationalist
rationalistic: rationalistic
ravages: ravages
raw: raw
ray: rays
reach: reach,reached,reaches,reaching
react: react,reacts
reaction: reaction
read: read,reading
readable: readable
reader: reader,readers
ready: ready
real: real
realist: realist
reality: realities,reality
realization: realization
realize: realize,realized,realizes,realizing
realm: realm
reap: reap,reaped
rear: rear
rearrange: rearranges
reason: reason,reasoned,reasons
reasonable: reasonable
reasonableness: reasonableness
reasoner: reasoner,reasoners
reasoning: reasoning
recall: recall
recapitulate: recapitulate
recapitulation: recapitulation
recede: recede
receipt: receipt
receive: receive,received,receives,receiving
reception: reception
receptivity: receptivity
reciprocal: reciprocal
reciprocally: reciprocally
reciprocity: reciprocity
reckon: reckon,reckoned,reckoning
recognition: recognition
recognizable: recognizable
recognize: recognize,recognized,recognizes,recognizing
recollection: recollection
recommence: recommencing
recommend: recommended,recommending
recommendation: recommendation,recommendations
reconcile: reconcile,reconciled,reconciling
reconvert: reconverted
record: record
recourse: recourse
rectification: rectification
recur: recurs
red: red
redistribute: redistribute,redistributing
redistributing: redistributing
redistribution: redistribution
redness: redness
reduce: reduce,reduced,reducing
reduction: reduction
refer: refer,referred,referring,refers
referable: referable
reference: reference,references
reflect: reflect,reflected,reflecting
reflection: reflection,reflections
reflective: reflective
reform: reform
refrain: refrain,refrained
refund: refund
refusal: refusal
refuse: refuse,refused,refuses,refusing
refutation: refutation,refutations
refute: refute,refuted
regard: regard,regarded
region: region,regions
register: register,registered
regnum: regnum
regress: regress
regression: regression
regressive: regressive
regressively: regressively
regular: regular
regularity: regularity
regularly: regularly
regulate: regulate,regulated,regulates,regulating
regulation: regulation
regulative: regulative
reign: reign,reigns
reinstallation: reinstallation
reject: reject,rejected,rejecting
rejection: rejection
relate: relate,relates,relating
relation: relation,relations
relationship: relationship
relative: relative
release: release
reliable: reliable
reliance: reliance
religion: religion
religious: religious
relinquish: relinquish,relinquishing
reluctant: reluctant
rely: rely
remain: remain,remained,remaining,remains
remainder: remainder,remainders
remains: remains
remark: remark,remarked,remarking,remarks
remarkable: remarkable
remarkably: remarkably
remarks: remarks
remedy: remedies,remedy
remember: remembered
remind: remind
reminiscence: reminiscence
remote: remote
remove: remove,removed,removes,removing
rename: renamed
render: render,rendered,rendering,renders
renew: renew,renewed
renounce: renounce,renounces,renouncing
renowned: renowned
renunciation: renunciation
repair: repaired
repay: repay
repeat: repeat,repeated
repeatedly: repeatedly
repel: repel
repetition: repetition
replace: replace
replacement: replacement
reply: replies,reply
report: reported,reports
repose: repose,reposed
reprehensible: reprehensible
represent: represent,represented,representing,represents
representable: representable
representation: representation,representations
representative: representative
repress: repress
reprimand: reprimanded
reproach: reproach
reproduction: reproduction
reproductive: reproductive
republic: republic
repugnance: repugnance
repulse: repulsed
repulsion: repulsion
reputation: reputation
request: request
require: require,required,requires,requiring
requirement: requirement,requirements
requisite: requisite,requisites
resemblance: resemblances
resemble: resemble
reserve: reserve
reside: reside,resides,residing
resist: resist,resisting,resists
resistance: resistance
resolution: resolution
resolve: resolve,resolved,resolves
respect: respect,respected,respecting
respectability: respectability
respective: respective
respects: respects
responsibility: responsibilities,responsibility
rest: rest,rested,resting,rests
resting: resting
restless: restless
restore: restores,restoring
restrain: restrain,restrained
restraint: restraint
restrict: restrict,restricted,restricting,restricts
restricted: restricted
restriction: restriction,restrictions
restrictive: restrictive
result: result
resurrection: resurrection
retain: retain,retaining,retains
retort: retort,retorted
retrace: retrace
retrogressively: retrogressively
return: return,returned,returns
reveal: reveal,revealed,reveals
revelation: revelation
revenue: revenue
reverence: reverence
reverse: reverse,reversed,reverses
review: review,reviewing,reviews
revolution: revolution,revolutions
revolutionize: revolutionized
revolve: revolve,revolved,revolves
rewarding: rewarding
rhapsodically: rhapsodically
rhapsodistic: rhapsodistic
rhapsody: rhapsody
rhetoric: rhetoric
rhetorician: rhetoricians
rich: rich,richer
rid: rid
ridicule: ridicule,ridicules
ridiculous: ridiculous
righteous: righteous
rightful: rightful
rightly: rightly
rigid: rigid
rigorous: rigorous
rigour: rigour
ripen: ripened
rise: rise,risen,rises,rising
risk: risk
rival: rival
river: river
road: road,roads
rob: rob,robbed
rock: rock,rocks
romance: romance
rood: rood
roof: roof
root: root,rooted,roots
rose: rose
rotten: rotten
rough: rough
roughness: roughness
roundness: roundness
rouse: rouse,roused
route: route
royal: royal
royalty: royalties,royalty
rude: rude
rudeness: rudeness
ruin: ruined,ruins
ruinous: ruinous
rule: rule,rules
ruler: ruler
rust: rust
sacred: sacred
sacredness: sacredness
sacrifice: sacrifice
sadly: sadly
safe: safe
safeguard: safeguard
safely: safely
safety: safety
sagacity: sagacity
sake: sake
salt: salt,salts
saltus: saltus
sap: sap
sarcastic: sarcastic
satis: satis
satisfaction: satisfaction
satisfactorily: satisfactorily
satisfactory: satisfactory
satisfied: satisfied
satisfy: satisfied,satisfies,satisfy,satisfying
saturn: saturn
save: save,saved
scandal: scandal
scarcely: scarcely
scatter: scattered
sceptic: sceptic,sceptics
sceptical: sceptical
scepticism: scepticism
schema: schema
schemata: schemata
schematism: schematism
scholar: scholar,scholars
scholastic: scholastic
scholastically: scholastically
school: school,schools
schoolman: schoolman
schoolmen: schoolmen
science: science,sciences
sciences: sciences
scientific: scientific
scope: scope
scorn: scorn
scrutiny: scrutiny
sea: sea,seas
search: search,searching
searching: searching
seat: seat
secret: secret,secrets
secure: secure,secured,secures,securing
securely: securely
security: security
seduce: seduced,seducing
seduction: seduction
seductive: seductive
seek: seek,seeking,seeks,sought
seemingly: seemingly
seize: seize
seldom: seldom
select: select
selfish: selfish
semblance: semblance
send: send,sending
sensation: sensation,sensations
sense: sense
senseless: senseless
sensibility: sensibility
sensual: sensual
sensualist: sensualists
sensualize: sensualized
sensuous: sensuous
sensuously: sensuously
sensuousness: sensuousness
sentence: sentence
sentiment: sentiment,sentiments
separate: separate,separated,separates,separating
separately: separately
separation: separation,separations
sequel: sequel
sequence: sequence
serially: serially
series: series
serve: serve,served,serves
service: service
serviceable: serviceable
set: set,sets,setting
settle: settle,settled,settling
settled: settled
settlement: settlement
sever: severed
severe: severe,severest
severely: severely
severity: severity
shadow: shadow,shadows
shadowy: shadowy
shake: shake
shallowness: shallowness
shame: shame
shameless: shameless
shape: shape,shapes,shaping
share: share,shared,sharing
sharpen: sharpen
shield: shield
shift: shifting
shine: shines
ship: ship
shoot: shoots
shore: shore
short: short,shorter,shortest
shortness: shortness
shower: shower
shut: shut
sided: sided
sieve: sieve
sight: sight
sighted: sighted
sign: signs
signal: signal
signalize: signalize,signalized
significance: significance
significancy: significancy
signification: signification,significations
signify: signifies,signify
silence: silenced
silently: silently
silly: silly
silver: silver
similarity: similarities,similarity
simple: simple,simpler,simplest
simplicity: simplicity
simplify: simplify,simplifying
simply: simply
simul: simul
simultaneity: simultaneity
simultaneous: simultaneous
sine: sine
single: single
singular: singular
sink: sink,sinks
sit: sit
situation: situation
situs: situs
size: size
sketch: sketch,sketching
skilful: skilful
skill: skill
slight: slight,slightest
slip: slips
slumber: slumber
smell: smell,smelling
smoke: smoke
smooth: smooth
soar: soar
social: social
society: society
socratic: socratic
soever: soever
softness: softness
solar: solar
sole: sole
solely: solely
solicit: solicit
solicitation: solicitation
solid: solid
solidity: solidity
solus: solus
solution: solution,solutions
solve: solve,solved,solving
son: son
sooner: sooner
sophism: sophism,sophisms
sophist: sophist,sophists
sophistical: sophistical
sophistry: sophistries,sophistry
sorrow: sorrow
sort: sort,sorts
soul: soul,souls
soulless: soulless
sound: sound
source: source,sources
sovereignty: sovereignty
space: space,spaces
spacious: spacious
spare: spare,sparing
spark: sparks
speak: speak,speaking,speaks,spoken
speaking: speaking
special: special
specially: specially
species: species
specific: specific
specification: specification
specious: specious
spectacle: spectacle
spectator: spectator,spectators
speculate: speculate
speculation: speculation,speculations
speculative: speculative
speculator: speculators
speech: speech
spell: spelling
spend: spend,spent
sphere: sphere,spheres
spherical: spherical
spheroid: spheroid
spin: spinning
spirit: spirit
spiritual: spiritual
spiritualism: spiritualism
spiritualist: spiritualist
spirituality: spirituality
spite: spite
splendour: splendour
spontaneity: spontaneity
spontaneous: spontaneous
spontaneously: spontaneously
sport: sport
spring: spring,springs,sprung
spurious: spurious
square: square
stability: stability
staff: staff
stage: stage
stagger: staggered
stake: stake
stamp: stamps
stand: stand,standing,stands,stood
standard: standard,standards
standpoint: standpoint
standstill: standstill
star: star,stars
starry: starry
start: start,started
starting: starting
startle: startle,startles
startling: startling
statement: statement,statements
statesman: statesman
stationary: stationary
status: status
statute: statute,statutes
stay: stay
steadily: steadily
steel: steel,steeled
stem: stem
step: step,stepping,steps
stock: stock
stoics: stoics
stone: stone,stones
store: stored
stormy: stormy
story: story
straight: straight
strange: strange
stranger: stranger
stratagem: stratagem
stray: stray,strayed
stream: stream
strength: strength
strengthen: strengthen,strengthening
stretch: stretch,stretches
strict: strict,strictest
strictly: strictly
strictness: strictness
strife: strife
strike: strike,strikes,struck
striking: striking
string: strings
strive: strive,strives,striving
strong: strong,stronger,strongest
structure: structure,structures
struggle: struggle,struggles,struggling
student: student
study: studies,study
stumble: stumble,stumbling
stumbling: stumbling
stupidity: stupidity
style: style
subaltern: subaltern
subdivide: subdivided
subdivision: subdivision,subdivisions
subdue: subdued
subdued: subdued
subject: subject,subjected,subjecting,subjects
subjection: subjection
subjective: subjective
subjectively: subjectively
subjoin: subjoined
sublime: sublime
sublunary: sublunary
submit: submit,submits,submitted,submitting
subordinate: subordinate,subordinated
subordination: subordination
subreption: subreption
subscribe: subscribe
subsequent: subsequent
subservient: subservient
subsidiary: subsidiary
subsist: subsisting,subsists
subsistence: subsistence
subsistent: subsistent
substance: substance,substances
substantia: substantia,substantiae
substantial: substantial
substantiality: substantiality
substantiate: substantiate
substantive: substantive
substitute: substituted,substituting
substitution: substitution
substratum: substratum
subsume: subsume,subsumed,subsuming
subsumption: subsumption
subterfuge: subterfuge
subterranean: subterranean
subtle: subtle,subtlest
subtlety: subtlety
subtract: subtract
subtraction: subtraction
subvert: subverted
succeed: succeed,succeeded,succeeding,succeeds
success: success
successful: successful
succession: succession,successions
successive: successive
successively: successively
successor: successors
sudden: sudden
suddenly: suddenly
suffer: suffer,suffers
sufferance: sufferance
suffice: sufficed
sufficiency: sufficiency
sufficient: sufficient
suggestion: suggestions
suggestive: suggestive
suit: suit,suited,suits
suitable: suitable
sum: sum,sums
summa: summa
summary: summary
summit: summit
summons: summons
sun: sun
sunny: sunny
sunt: sunt
supellex: supellex
superannuated: superannuated
superficial: superficial
superfluous: superfluous
superfluousness: superfluousness
superhuman: superhuman
superior: superior
superiority: superiority
supernatural: supernatural
supersensible: supersensible
superstition: superstition
supplant: supplant
supplement: supplemented
supply: supplied,supplies,supply,supplying
support: support,supported,supporting,supports
supporter: supporters
suppose: suppose,supposed,supposes,supposing
supposition: supposition,suppositions
supposititious: supposititious
suppress: suppress,suppressed
suppression: suppression
supreme: supreme
supremely: supremely
surely: surely
surface: surface,surfaces
surmise: surmise
surmount: surmounted
surpass: surpass,surpasses
surprising: surprising
surrender: surrender,surrendering
surreptitious: surreptitious
surreptitiously: surreptitiously
surround: surrounded,surrounds
surveillance: surveillance
survey: survey,surveyed
survive: survive
susceptibility: susceptibility
susceptible: susceptible
suspect: suspect
suspicion: suspicion
sustain: sustain,sustained,sustains
sustenance: sustenance
swallow: swallowed
swamp: swamp
swear: sworn
swell: swelling
swim: swim
syllogism: syllogism,syllogisms
syllogisms: syllogisms
syllogistic: syllogistic
symbol: symbol,symbols
symbolical: symbolical
sympathize: sympathize
symptom: symptoms
synonym: synonym,synonyms
synonymous: synonymous
synthesis: syntheses,synthesis
synthetic: synthetic
synthetical: synthetical
synthetically: synthetically
systematic: systematic
systematical: systematical
systematically: systematically
systems: systems
table: table
tabular: tabular
talent: talent,talents
talk: talk,talked,talks
tangible: tangible
tantamount: tantamount
task: task,tasks
taste: taste
tautological: tautological
tautology: tautology
tax: tax,taxes
teach: taught,teach,teaches,teaching
teacher: teacher,teachers
teaching: teaching,teachings
tear: tears,torn
technical: technical
technically: technically
technique: technique
tecum: tecum
tedious: tedious
teleological: teleological
teleology: teleology
tellus: tellus
temperament: temperament
temperate: temperate
temporal: temporal
temptation: temptation
tempus: tempus
tend: tend
tendency: tendencies,tendency
tenth: tenth
term: term,termed,terming,terms
termination: termination
terrestrial: terrestrial
terrible: terrible
territory: territory
terror: terror
tertio: tertio
tertium: tertium
testimony: testimony
testing: testing
thankfulness: thankfulness
thee: thee
theist: theist
theistic: theistic
theme: theme
theologian: theologians
theological: theological
theology: theology
theorem: theorem,theorems
theoretical: theoretical
theoretically: theoretically
theory: theories,theory
therefrom: therefrom
thereon: thereon
therewith: therewith
thermometer: thermometer
thesis: thesis
thetic: thetic
thew: thew
thinker: thinker,thinkers
thinking: thinking
thirdly: thirdly
thirteen: thirteen
thoroughgoing: thoroughgoing
thoroughness: thoroughness
thread: thread
threat: threats
threaten: threaten,threatens
threefold: threefold
threshold: threshold
throw: throw,throwing,thrown,throws
tie: tied
time: time,times
timid: timid
title: title,titles
toil: toil
tolerably: tolerably
tolerate: tolerate
tone: tone
tongue: tongues
topic: topic
tortuous: tortuous
tot: tot
total: total
totality: totality
totally: totally
toto: toto
totum: totum
touch: touch,touches,touching
touchstone: touchstone
tourney: tourney
tower: tower
trace: traced,traces
track: track,tracks
trademark: trademark
train: trained,trains
training: training
trample: trampled
tranquil: tranquil
tranquility: tranquility
transcend: transcend,transcended,transcending,transcends
transcendent: transcendent
transcendental: transcendental
transcendentalism: transcendentalism
transcendentally: transcendentally
transcendently: transcendently
transcribe: transcribe
transcription: transcription
transference: transference
transform: transform,transformed
transgress: transgress,transgresses,transgressing
transgression: transgression
transition: transition
transitory: transitory
translate: translated
translator: translator
transport: transport
travel: travel
traverse: traversed
treason: treason
treasure: treasure,treasures
treat: treat,treated,treating,treats
treatise: treatise,treatises
treatment: treatment
tree: tree
tremble: trembles
triad: triad
trial: trial
triangle: triangle,triangles
tribe: tribes
tribunal: tribunal
trick: trick
trifle: trifling
trifling: trifling
triumph: triumph
triumphant: triumphant
trivial: trivial
trouble: trouble,troubling
troubling: troubling
true: true,truest
trust: trust
trustworthy: trustworthy
truth: truth,truths
truthful: truthful
tuition: tuition
turbulent: turbulent
tween: tween
twist: twist
twisting: twisting
twofold: twofold
type: type,types
ubi: ubi
ultimate: ultimate
ultimately: ultimately
umpire: umpires
unable: unable
unaccompanied: unaccompanied
unadvisable: unadvisable
unalloyed: unalloyed
unalterable: unalterable
unaltered: unaltered
unanimously: unanimously
unanswerable: unanswerable
unanswered: unanswered
unascertained: unascertained
unassailable: unassailable
unattainable: unattainable
unattained: unattained
unattempted: unattempted
unattended: unattended
unauthorized: unauthorized
unavoidable: unavoidable
unavoidably: unavoidably
unaware: unaware
unbecoming: unbecoming
unbelief: unbelief
unbiased: unbiased
unbounded: unbounded
unbroken: unbroken
uncaused: uncaused
unceasing: unceasing
unceasingly: unceasingly
uncertain: uncertain
uncertainty: uncertainty
unchangeable: unchangeable
unchangeably: unchangeably
unchanged: unchanged
unchanging: unchanging
uncivilized: uncivilized
uncommon: uncommon
uncompensated: uncompensated
unconcerned: unconcerned
unconditional: unconditional
unconditionally: unconditionally
unconditioned: unconditioned
unconnected: unconnected
unconquerable: unconquerable
unconscious: unconscious
unconsciously: unconsciously
unconvincing: unconvincing
uncritical: uncritical
undecided: undecided
undemonstrated: undemonstrated
undeniable: undeniable
undeniably: undeniably
undergo: undergoes
undermine: undermine,undermined,undermines,undermining
understand: understand,understanding,understands,understood
understanding: understanding,understandings
undertake: undertake,undertaken,undertakes
undertaking: undertaking
undervalue: undervalue
undeserving: undeserving
undetermined: undetermined
undeterred: undeterred
undeveloped: undeveloped
undeviating: undeviating
undiminished: undiminished
undiscovered: undiscovered
undisturbed: undisturbed
undivided: undivided
undoubted: undoubted
undoubtedly: undoubtedly
undoubtingly: undoubtingly
uneducated: uneducated
unenforceability: unenforceability
unessential: unessential
unexceptionable: unexceptionable
unexceptionably: unexceptionably
unexpected: unexpected
unfair: unfair
unfairly: unfairly
unfavourable: unfavourable
unfitness: unfitness
unfold: unfold,unfolds
unfortunate: unfortunate
unguarded: unguarded
unguardedly: unguardedly
unhappily: unhappily
unhappy: unhappy
uni: uni
uniform: uniform
uniformity: uniformity
uniformly: uniformly
unilaterally: unilaterally
unimportant: unimportant
uninfluenced: uninfluenced
uninterrupted: uninterrupted
union: union
unit: unit,units
unite: unite,united,unites,uniting
united: united
unity: unity
universal: universal
universality: universality
universally: universally
universe: universe
universitas: universitas
unjust: unjust
unknown: unknown
unlimited: unlimited
unlink: unlink
unluckily: unluckily
unmistakable: unmistakable
unmixed: unmixed
unnamed: unnamed
unnecessarily: unnecessarily
unnecessary: unnecessary
unobserved: unobserved
unperceived: unperceived
unphilosophical: unphilosophical
unpleasant: unpleasant
unpopular: unpopular
unprepared: unprepared
unprofitable: unprofitable
unprotected: unprotected
unqualified: unqualified
unquestionably: unquestionably
unreal: unreal
unreasonable: unreasonable
unrestrained: unrestrained
unrestricted: unrestricted
unrighteous: unrighteous
unsafe: unsafe
unsatisfactory: unsatisfactory
unsearchable: unsearchable
unseen: unseen
unsettled: unsettled
unshaken: unshaken
unskillful: unskillful
unsolicited: unsolicited
unsophisticated: unsophisticated
unsuccessful: unsuccessful
unsuited: unsuited
unsusceptible: unsusceptible
unthinkingly: unthinkingly
untravelled: untravelled
untrue: untrue
unum: unum
unusual: unusual
unvarying: unvarying
unveil: unveil,unveiling
unwarrantable: unwarrantable
unwilling: unwilling
unwise: unwise
unworthy: unworthy
update: updated
uphold: uphold
upholder: upholders
upright: upright
uprightness: uprightness
urge: urged
usage: usage
useless: useless
user: user
usual: usual
usurp: usurped
usurpation: usurpation
ut: ut
utility: utility
utmost: utmost
utter: utter,uttering,utters
utterly: utterly
vacant: vacant
vacillate: vacillating
vacuum: vacuum
vagabond: vagabond
vague: vague
vain: vain
vainly: vainly
valid: valid
validity: validity
valueless: valueless
vanilla: vanilla
vanish: vanish,vanishes,vanishing
vanity: vanity
variable: variable
variance: variance
variation: variation,variations
variegated: variegated
variety: varieties,variety
variously: variously
vary: varying
vast: vast
vegetable: vegetable
vehement: vehement
vehicle: vehicle
vehicula: vehicula
vel: vel
venture: venture,ventured,venturing
veracious: veracious
verbal: verbal
verbiage: verbiage
verge: verge
veritable: veritable
versa: versa
version: version
vessel: vessel
vestibule: vestibule
veto: veto
vice: vice
vicious: vicious
viciousness: viciousness
victory: victories,victory
view: view,viewed,viewing,views
vigorously: vigorously
vigour: vigour
vii: vii
viii: viii
vindicate: vindicated
vindication: vindication
violate: violates
violence: violence
virtue: virtue
virus: virus
vis: vis
visible: visible
vision: vision,visions
visionary: visionary
visit: visit,visited
visual: visual
vitally: vitally
vocabulary: vocabulary
vocation: vocation
voice: voice
void: void
volition: volition
volume: volume
voluntary: voluntary
volunteer: volunteer,volunteers
von: von
vote: vote
vouchsafe: vouchsafed
voyage: voyage
vulgar: vulgar
wait: waited
walhalla: walhalla
walk: walks
wander: wandering
wanderings: wanderings
war: war,wars
ward: ward
warm: warmest
warn: warn,warning,warns
warning: warning,warnings
warrant: warrant,warranted,warrants
warranty: warranties,warranty
waste: wasting
watch: watch,watching
water: water
waver: waver,wavering
wax: wax
weak: weak,weaker
weaken: weaken
weakness: weakness,weaknesses
weal: weal
wealth: wealth
weapon: weapons
weariness: weariness
weary: wearied
weed: weed
weigh: weigh,weighed
weight: weight
weighty: weightiest
welfare: welfare
west: west
whatsoever: whatsoever
wherefore: wherefore
whereof: whereof
whereon: whereon
wholly: wholly
wicked: wicked
wide: wide,wider,widest
widen: widen,widening
widespread: widespread
wildest: wildest
willed: willed
willingly: willingly
windy: windy
wing: wings
wisdom: wisdom
wise: wise,wisest
wisely: wisely
wisest: wisest
wit: wit
withdraw: withdraw,withdrawn
withstand: withstand
witness: witness,witnesses
wolf: wolf
wolfian: wolfian
wonderful: wonderful
wondrous: wondrous
wood: wood
word: word
worm: worms
worth: worth
worthiness: worthiness
worthlessness: worthlessness
worthy: worthy
write: writing,written
writer: writer
writing: writing
writings: writings
wrong: wrong
xiii: xiii
yield: yield
youth: youth
youthful: youthful
zeal: zeal
zealous: zealous
