abide: abide
abnormal: abnormal
abode: abode
absence: absence
absolutely: absolutely
abuse: abusing
accent: accent
accept: accept,accepted,accepting
access: access,accessed
accessible: accessible
accompany: accompany
accomplice: accomplice
accomplished: accomplished
account: account,accounts
accuse: accuse,accused
achieve: achieved
acquaint: acquainted
acquaintance: acquaintance,acquaintances
active: active
actual: actual
acutely: acutely
addict: addicted
addition: addition,additions
additional: additional
address: address,addressed,addresses,addressing
adjacent: adjacent
adjective: adjective
adjoining: adjoining
admirable: admirable
admirably: admirably
admiration: admiration
admire: admire
admirer: admirer
admit: admit,admitted,admitting
advance: advance,advanced,advancing
advantage: advantage
adventure: adventure
advice: advice
advise: advise
affair: affair,affairs
affect: affect
affection: affection
affirm: affirm,affirmed
affirmative: affirmative
afraid: afraid
afternoon: afternoon
afterward: afterward
age: age
aged: aged
agent: agent
agitated: agitated
agree: agree,agreed
agreeable: agreeable
agreeably: agreeably
agreement: agreement
aid: aid
air: air
ak: ak
alarmed: alarmed
alarmingly: alarmingly
allude: alluded
allusion: allusion
almond: almond
alpenstock: alpenstock
alps: alps
alteration: alteration
alternate: alternate
altogether: altogether
amazement: amazement
ambiguity: ambiguity
america: america
american: american,americans
amiable: amiable
amoroso: amoroso
amuse: amused,amusing
amused: amused
amusement: amusement
analogy: analogies,analogy
analyze: analyzing
ancestor: ancestors
ancient: ancient
angle: angle
angrily: angrily
angry: angry
animated: animated
annals: annals
annie: annie
announcement: announcement
annoy: annoyed
annoyed: annoyed
answer: answer,answered
antique: antique
antiquity: antiquities,antiquity
apartment: apartment
apologize: apologized
apparent: apparent
appeal: appealing
appearance: appearance
applicable: applicable
apply: applied,apply
appoint: appointed
appreciation: appreciation
apprehension: apprehension
approach: approach,approached,approaching
approachable: approachable
approbation: approbation
approve: approve
april: april
arch: arch,arches
archive: archive
archway: archway,archways
ardently: ardently
arena: arena
arm: arm,arms
arrange: arrange,arranged
arrangement: arrangements
array: array
arrival: arrival
arrive: arrive,arrived,arriving
artfully: artfully
artist: artist
ascertain: ascertained
ascii: ascii
askance: askance
asleep: asleep
aspect: aspect
asperity: asperity
assemble: assembled
assent: assented
assign: assigned
assistance: assistance
assume: assumes
assure: assure,assured
astride: astride
atmosphere: atmosphere
attach: attached
attache: attache
attachment: attachment
attack: attacked
attempt: attempt
attend: attended
attendance: attendance
attendant: attendant
attention: attention,attentions
attentive: attentive
attitude: attitude
audacious: audacious
audacity: audacity
audibleness: audibleness
aunt: aunt
author: author
avoid: avoided
awake: awake
aware: aware
awkward: awkward
axiom: axiom
bad: bad,worse
baker: baker
balance: balanced
balcony: balconies
banker: banker
bar: bars
barber: barber
barehead: bareheaded
bargain: bargain,bargained
base: base,based
bear: bore,born
beautiful: beautiful
beautifully: beautifully
beauty: beauties,beauty
beckon: beckoning
bed: bed
beg: beg
behavior: behavior
behold: beheld
behoove: behooves
belief: belief
bench: bench,benches
bend: bending,bent
beneath: beneath
benefit: benefit
bestow: bestowed
bet: bet
bewilder: bewildered
bid: bade
binary: binary
bind: bound
bit: bit
blaze: blazes
bless: bless
block: block
bloom: bloom
blossom: blossom
blow: blowing
blue: blue
blush: blushed,blushing
boat: boat,boats
bold: bold
bologna: bologna
bonnet: bonnet
book: book,booked
border: border,bordered
borghese: borghese
bosom: bosom
boss: boss
boston: boston
bother: bother,bothered
bottle: bottle
bouquet: bouquet
bow: bow,bowed,bowing
boy: boy,boys
brace: bracing
breach: breach
break: broke
breakfast: breakfast
breeze: breeze
bright: bright,brightest
brightly: brightly
brilliancy: brilliancy
brilliant: brilliant
bring: bring,brings,brought
broad: broad
brother: brother
brutally: brutally
burst: burst
bury: buried
business: business
button: buttoning
buttonhole: buttonhole
byron: byron
cab: cab
cabinet: cabinet,cabinets
caelian: caelian
calculate: calculate,calculated
calmly: calmly
calvinism: calvinism
camphor: camphor
candidly: candidly
candy: candy
cane: cane
cap: cap
capital: capital
caprice: caprices
car: cars
card: card,cards
care: care,cared
career: career
carefully: carefully
carriage: carriage,carriages
carry: carried,carry,carrying
cast: cast
castle: castle,castles
catch: catch,catching
category: categories,category
cautious: cautious
cavalier: cavalier,cavaliers
cavaliere: cavaliere
cavernous: cavernous
cease: cease,ceased,ceasing
celestial: celestial
cemetery: cemetery
center: center
certainty: certainty
certitude: certitude
chaff: chaffing
chain: chain
chair: chair
chalk: chalk
chamber: chambers
chambermaid: chambermaid
chance: chance
chandler: chandler
change: change
chant: chants
character: character
characteristic: characteristics
charge: charge,charges
charitable: charitable
charitably: charitably
charity: charities
charm: charmed
charmer: charmer
charming: charming
chateau: chateau
chatter: chatter,chattered,chattering
check: check,checked,checks
cheek: cheek
cheerfully: cheerfully
chief: chief
chiefly: chiefly
child: child,children
childish: childish
chin: chin
choice: choice
choir: choir
choose: choose,chose,chosen
chop: chopping
christian: christian
church: church
cicerone: cicerone
cigarette: cigarette
circle: circle,circles
circumstance: circumstances
circus: circus
city: city
civility: civility
claim: claim,claiming,claims
clasped: clasped
class: class
classical: classical
clever: clever
cleverly: cleverly
cleverness: cleverness
climate: climate
close: close,closing
clothes: clothes
cloud: cloud
cluster: clusters
coachman: coachman
coat: coat
code: codes
coffee: coffee
cold: cold
collect: collected
collection: collection
college: college
colonist: colonists
color: color,colored
colored: colored
colosseum: colosseum
comanche: comanche
combination: combination
comfort: comfort
comfortable: comfortable
comme: comme
comment: commented
commercial: commercial
commission: commission
commit: commit,committed
common: common
commonness: commonness
communicate: communicate
companion: companion,companions
companionship: companionship
company: company
compatriot: compatriot,compatriots
compilation: compilation
completely: completely
complexion: complexion
compliance: compliance
compliment: compliment,compliments
comply: comply,complying
compose: composed
compress: compressed
compromise: compromise
concept: concept
conception: conception
conclude: concluded
conclusion: conclusion
concourse: concourse
condition: conditions
conduct: conducted
confess: confessed
confide: confiding
confidence: confidence
confirm: confirmed
confirmation: confirmation
congress: congress
conscience: conscience
conscientiously: conscientiously
conscious: conscious
consciousness: consciousness
consequential: consequential
considerable: considerable
consideration: consideration
consign: consign
consistency: consistency
consolatory: consolatory
constant: constant
constantine: constantine
constantly: constantly
constitution: constitution
contact: contact
contemplate: contemplating
contemplative: contemplative
contents: contents
contingency: contingencies
continue: continue,continued,continues
contract: contract
contradictory: contradictory
contrary: contrary
contribution: contributions
conversation: conversation
conversationally: conversationally
converse: converse
convert: convert,converted
convey: conveyed
conviction: conviction
cool: cool
copying: copying
copyright: copyright
coquette: coquette,coquettes
corkscrew: corkscrew
corner: corner,corners
corporation: corporation
correspond: corresponds
corrupt: corrupt
corso: corso
cost: cost,costs
costume: costume
count: count,counted
countenance: countenance
country: countries,country
countryman: countryman
countrywoman: countrywoman
couple: couple
courier: courier,couriers
cousin: cousins
cover: covered
coveted: coveted
crack: crack,cracked
cravat: cravat
craziness: craziness
crazy: crazy
create: created,creating
creation: creation
creature: creatures
credence: credence
credit: credit
crest: crest
crimson: crimson
critical: critical
criticism: criticism
cross: cross,crossed
crowd: crowd
crowded: crowded
crudity: crudity
cruel: cruel
culture: culture
cup: cup
cure: cure
curiosity: curiosities,curiosity
curl: curl,curled,curling
current: current
cursory: cursory
curtain: curtain
custodian: custodian
custom: custom
cut: cut,cuts
cynical: cynical
cynicism: cynicism
cypress: cypresses
daisy: daisies,daisy
damage: damage
damaged: damaged
damages: damages
dance: dance,dancing
dancing: dancing
danger: danger
dangerous: dangerous
dangerously: dangerously
dark: dark
darkness: darkness
datum: data
daughter: daughter
david: david
davis: davis
day: day,days
daylight: daylight
deal: deal
death: death
decide: decided
decidedly: decidedly
decision: decision
deck: deck
declare: declare,declared
decline: decline
decorate: decorated,decorating
deductible: deductible
deep: deep,deeper
deeply: deeply
defect: defect,defects
defective: defective
deferential: deferential
defiance: defiance
defiant: defiant
definite: definite
defy: defied
degree: degree
delay: delayed
deletion: deletions
delicacy: delicacy
delicate: delicate
delighted: delighted
delightfully: delightfully
deliver: delivered
delusive: delusive
demand: demand,demanded
demonstrative: demonstrative
dent: dent
deny: denied,deny
depart: depart,departed
depend: depend,depends
deportment: deportment
deposit: depositing
deprecate: deprecated
derisive: derisive
derivative: derivative
derive: derive,derived
descend: descended
description: description
design: design
designing: designing
desire: desire,desired
desolation: desolation
dessert: dessert
destroy: destroy
desultory: desultory
detach: detach,detached
determine: determine,determined
deucedly: deucedly
devil: devil
devoted: devoted
devoutly: devoutly
diamond: diamonds
dictate: dictate
die: die,died,dying
difference: difference,differences
difficult: difficult
diffuse: diffuse
dignity: dignity
diminutive: diminutive
dimly: dimly
dimple: dimples
dine: dine,dined,dines
dinner: dinner,dinners
direct: direct
director: director
disagreeable: disagreeable
disagreeably: disagreeably
disappointed: disappointed
disapprove: disapproved
disclaim: disclaim
disclaimer: disclaimer,disclaimers
disclosure: disclosures
discontinue: discontinue
discover: discover,discovered
discretion: discretion
disgusted: disgusted
dishabituated: dishabituated
disk: disk
dislike: dislike
dismiss: dismissed
disorder: disorder
dispassionate: dispassionate
display: display,displayed,displaying
displease: displease
displeasure: displeasure
dispose: disposed
disposed: disposed
dissuade: dissuade
distance: distance
distant: distant
distinction: distinction
distinctly: distinctly
distinguish: distinguish,distinguished
distinguished: distinguished
distribute: distribute,distributed,distributing
distribution: distribution
distributor: distributor
diversely: diversely
divide: divided
docility: docility
doctor: doctors
dollar: dollars
domain: domain
donate: donate
donation: donation,donations
donor: donors
door: door
doria: doria
doubt: doubt
dover: dover
download: downloading
downstairs: downstairs
dozen: dozen
drag: dragging
draw: draw,drawing,drawn,drew
drawing: drawing
dreadful: dreadful
dreadfully: dreadfully
dream: dreams
dress: dress,dressed,dresses
dressed: dressed
drink: drinking
drive: drive,driving,drove
driver: driver
drop: drop,dropped
du: du
dusk: dusk
dusky: dusky
duty: duty
dying: dying
dyspepsia: dyspepsia
ear: ear,ears
earnest: earnest
earnestly: earnestly
earnestness: earnestness
earth: earth
easily: easily
easy: easy
eat: eat
eccentricity: eccentricities
echo: echo
edge: edge,edges
edify: edified
edition: edition,editions
education: education
educational: educational
efficient: efficient
effort: effort,efforts
ejaculate: ejaculated
ejaculation: ejaculation
elder: elder
elect: elect
electronic: electronic
electronically: electronically
elegance: elegance
elegant: elegant
element: element
elle: elle
elope: elope
eloquence: eloquence
email: email
embank: embanked
embark: embarked
embarrassed: embarrassed
embarrassing: embarrassing
embrasure: embrasure,embrasures
embroider: embroidered
embroidery: embroidery
emerge: emerged
eminently: eminently
emphasis: emphasis
emphatic: emphatic
employee: employee,employees
enable: enables
enchanting: enchanting
encircle: encircles
enclosure: enclosure
encode: encoding
encounter: encounter,encountered
endeavor: endeavored
endow: endowed
enemy: enemies
engage: engaged
engaged: engaged
engagement: engagements
england: england
english: english
enjoy: enjoy,enjoyed,enjoying
enormous: enormous
enshrine: enshrined
ensure: ensuring
enter: enter,entered,enters
enterprise: enterprise
entertain: entertained
entertainment: entertainment
entity: entity
entrance: entrance
enumerate: enumerated
equalize: equalize
equipment: equipment
error: errors
escapade: escapade
escort: escort
essentially: essentially
establish: established
establishment: establishments
esteem: esteem
europe: europe
european: european,europeans
evade: evaded
evening: evening
event: events
evidence: evidence
evident: evident
evidently: evidently
evoke: evoke
exacting: exacting
examine: examining
exceed: exceeded
exceedingly: exceedingly
excellent: excellent
exchange: exchange,exchanging
excite: excited
excited: excited
exciting: exciting
exclaim: exclaim,exclaimed
exclamation: exclamation
exclusion: exclusion
exclusive: exclusive
excursion: excursion
executive: executive
exempt: exempt
exert: exerted
exhilarate: exhilarated
exiguous: exiguous
exist: exist,exists
existence: existence
expect: expect,expected,expecting,expects
expectation: expectation
expend: expend
expense: expense,expenses
expensiveness: expensiveness
expire: expire
explain: explain,explained
explanation: explanation
export: exporting
expose: expose,exposed
express: express,expressed,expressing
expression: expression
expressive: expressive
expressly: expressly
exquisite: exquisite
extent: extent
extraordinary: extraordinary
extreme: extreme
extremely: extremely
eye: eye,eyes
eyebrow: eyebrows
eyeglass: eyeglass
ezra: ezra
facility: facility
fair: fair
fairbanks: fairbanks
familiar: familiar
familiarity: familiarities
familiarly: familiarly
family: family
famous: famous
fan: fan,fanning
fancy: fancied,fancy
farewell: farewell
fashion: fashion
fast: fast
fastidious: fastidious
fatal: fatal
father: father
fault: fault
faut: faut
favor: favor
favorable: favorable
fear: fear,fears
fearful: fearful
fearfully: fearfully
feasible: feasible
feature: features
federal: federal
fee: fee,fees
feel: feel,feeling,feels
fellow: fellow
feminine: feminine
feudal: feudal
fever: fever
figure: figure
file: file,files
financial: financial
fine: fine,finest
finger: fingering
finish: finish,finished
fireplace: fireplace
fitness: fitness
flag: flags
flash: flashed
flat: flat,flatter
flatter: flattered
flattered: flattered
flattering: flattering
flirt: flirt,flirted,flirting,flirts
flit: flitted,flitting
floor: floor
florence: florence
florid: florid
flounce: flounces
flourish: flourish
flower: flower,flowering,flowers
flush: flush,flushed
flutter: fluttered
fly: flying
fold: folded
follow: follow
folly: folly
fond: fond
foot: feet,foot
force: force
forefront: forefront
forehead: forehead
foreign: foreign
foreigner: foreigner,foreigners
forget: forget,forgot,forgotten
forgivingly: forgivingly
form: form,formed,forming,forms
formal: formal
format: format,formats
formula: formula
fortunate: fortunate
fortune: fortune
forum: forum
foundation: foundation
fragment: fragments
frankly: frankly
frankness: frankness
frederick: frederick
freedom: freedom
freely: freely
freight: freighted
frequently: frequently
fresh: fresh
freshly: freshly
freshness: freshness
friday: friday
friend: friend,friends
friendly: friendliest
friendship: friendships
frightened: frightened
frightful: frightful
frigidity: frigidity
frigidly: frigidly
frill: frills
frizzle: frizzled
fro: fro
function: functions
functionary: functionary
funeral: funeral
furbelow: furbelows
fuss: fuss
future: future
gaiety: gaiety
gallantly: gallantly
gallantry: gallantry
gallery: gallery
garden: garden
gardens: gardens
garrulity: garrulity
gate: gate
gather: gathered
gay: gay
gaze: gazing
generation: generations
generic: generic
generous: generous
generously: generously
geneva: geneva
gentleman: gentleman,gentlemen
gently: gently
german: german,germans
gigantic: gigantic
girl: girl,girls
glad: glad
glance: glance,glanced,glancing
glass: glass
gleam: gleaming
gloom: gloom
glove: gloves
goal: goals
gold: gold
golden: golden
goodbye: goodbye
goodness: goodness
goose: goose
gossip: gossip
govern: govern
governor: governors
grace: grace
graceful: graceful
gracious: gracious
gradually: gradually
grand: grand
granddaughter: granddaughters
grant: granted
grateful: grateful
gratefully: gratefully
gratification: gratification
gratified: gratified
grave: grave
gravel: gravel
gravely: gravely
greatly: greatly
greeting: greeting
gregory: gregory
grimly: grimly
grin: grin,grinning
gross: gross
ground: ground
grow: grown
guarantee: guarantee
guard: guard
guess: guess
guest: guests
guide: guide,guiding
guilty: guilty
habit: habit,habits
habitual: habitual
hair: hair
hall: hall
hamburg: hamburg
hand: hand,hands
handsome: handsome,handsomest
hang: hanged,hangs
hannibal: hannibal
happen: happened
happily: happily
happy: happy
hard: hard
harm: harm
harmless: harmless
harmony: harmony
harshness: harshness
hart: hart
hasten: hastened
hasty: hasty
hat: hat
hate: hate
head: head,heads
headache: headache,headaches
health: health
healthy: healthy
hear: hear,heard,hearing
hearing: hearing
heart: heart
heaven: heaven
heed: heed
heiress: heiresses
henry: henry
hesitate: hesitated
hesitation: hesitation
hide: hidden
hierarchical: hierarchical
highly: highly
hilarity: hilarity
hill: hill
hint: hint
hire: hired
historian: historian
historic: historic
history: history
hitherto: hitherto
hold: held,hold,holding
holder: holder
honest: honest
honor: honor
hope: hope,hoped,hopes
hopelessly: hopelessly
hornpipe: hornpipe
horrible: horrible
horrid: horrid
horror: horror
hospitable: hospitable
hostess: hostess
hotel: hotel,hotels
hour: hour,hours
house: house,houses
hover: hovered
hum: humming
humbly: humbly
humid: humid
humility: humility
humor: humor
hungry: hungry
hunter: hunters
hurry: hurried,hurrying
hurt: hurt
husband: husbands
idea: idea,ideas
identification: identification
identify: identify
idiom: idiom
idle: idle
idly: idly
ignorant: ignorant
illumination: illumination
image: image
imagination: imagination
imagine: imagine,imagined
imbecile: imbecile
imbibe: imbibed
imitation: imitation
immature: immature
immensely: immensely
immodest: immodest
impartial: impartial
impatience: impatience
impatient: impatient
imperial: imperial
imperious: imperious
impertinent: impertinent
imperturbable: imperturbable
impiety: impiety
imply: implied,imply
impose: imposed
impossible: impossible
impregnate: impregnated
impress: impress
impression: impression
impressive: impressive
impressively: impressively
improper: improper
impulse: impulse
imputation: imputation
inaccurate: inaccurate
inaudibly: inaudibly
incapable: incapable
incident: incidents
incidental: incidental
inclination: inclination
incline: inclined
include: include,included,includes,including
including: including
incomplete: incomplete
incongruous: incongruous
inconsequent: inconsequent
increase: increasing
indebtedness: indebtedness
indelicate: indelicate
indemnify: indemnify
indemnity: indemnity
indication: indications
indifference: indifference
indifferent: indifferent
indignation: indignation
indirect: indirect
indirectly: indirectly
indiscretion: indiscretion
indispensable: indispensable
indispose: indisposed
indistinct: indistinct
individual: individual
indolent: indolent
indoors: indoors
induce: induce
induction: induction
ineffaceable: ineffaceable
inevitable: inevitable
inexhaustible: inexhaustible
infancy: infancy
infant: infant
inform: inform,informing
informant: informant
infringement: infringement
ingenious: ingenious
inhale: inhaling
initiate: initiating
injure: injured
injury: injury
injustice: injustice
inn: inn
innocence: innocence
innocent: innocent
inquire: inquired
inquiry: inquiries
inscribe: inscribed
inscription: inscriptions
inscrutable: inscrutable
insipid: insipid
inspect: inspected
instance: instance
instant: instant
instantly: instantly
instinct: instinct
instinctive: instinctive
instinctively: instinctively
instruction: instruction
instrument: instrument
intellectual: intellectual
intellectually: intellectually
intelligent: intelligent
intend: intend,intending,intends
intensely: intensely
intention: intentions
intently: intently
intercourse: intercourse
interfere: interfere
interference: interference
interfusion: interfusion
interior: interior
interlocutor: interlocutor
internal: internal
international: international
interpose: interposed
interpret: interpreted
interrogation: interrogation
interrupt: interrupted
interval: interval
interview: interview,interviews
intimacy: intimacy
intimate: intimate,intimated
intimation: intimation
intime: intime
intrigue: intrigue
introduce: introduce,introduced,introducing
introduction: introduction,introductions
invalidity: invalidity
invidious: invidious
invisible: invisible
invite: invite
ironical: ironical
ironically: ironically
irony: irony
irrelevant: irrelevant
irrelevantly: irrelevantly
irresponsible: irresponsible
irs: irs
italian: italian,italians
italy: italy
james: james
january: january
jealous: jealous
jest: jested
jocosely: jocosely
joke: joke
journey: journey
judge: judged
judicious: judicious
judith: judith
july: july
jump: jump,jumped,jumping
june: june
justice: justice
justly: justly
kick: kicking
kindly: kindly
kinswoman: kinswoman
kiss: kiss,kissed
knee: knee
knickerbockers: knickerbockers
knock: knocking
knot: knot,knots
lady: ladies,lady
lake: lake
lance: lance
land: land,landed
landing: landing
language: language
lap: lap
largeness: largeness
late: late
laugh: laugh,laughed,laughing
law: law,laws
lawless: lawless
laxity: laxity
lead: led
lean: leaned,leaning
learn: learn,learned,learning
learning: learning
leave: leave,leaving,left
ledge: ledge
legal: legal
legally: legally
legation: legation
lesson: lessons
letter: letter,letters
lettering: lettering
level: leveled
liability: liability
liable: liable
liberal: liberal
liberty: liberty
library: library
license: license
licensed: licensed
lieu: lieu
life: life
lift: lifted
light: light,lights,lit
lighted: lighted
lightly: lightly
limit: limited
limitation: limitation,limitations
limited: limited
linger: linger,lingered
link: linked,links
lion: lions
lip: lips
listen: listen,listened
literally: literally
literary: literary
live: live,lived,lives
lived: lived
lively: lively
liver: liver
locate: located
location: locations
logic: logic
logical: logical
lonesome: lonesome
loose: loose
lose: losing,lost
lot: lot,lots
loud: loud
loudly: loudly
lounge: lounging
lounger: loungers
love: love
loveliness: loveliness
lovely: lovely
lover: lover
lucidly: lucidly
luck: luck
luminous: luminous
lump: lump,lumps
luncheon: luncheon
luxury: luxury
machine: machine
madam: madam
madame: madame
mademoiselle: mademoiselle
magnificent: magnificent
magnitude: magnitude
main: main
maintain: maintaining
majestically: majestically
malaria: malaria
mamma: mamma
manage: managed
manfred: manfred
manifest: manifesting
manner: manner
manners: manners
marble: marble
marchese: marchese
margin: margin
mark: marked
married: married
marry: married,marry,marrying
martyr: martyrs
mass: massed
master: master
maternity: maternity
matrimony: matrimony
matron: matrons
matter: matter,mattered,matters
maturity: maturity
maximum: maximum
meaning: meaning
measure: measure
meddle: meddle
medicine: medicine
meditate: meditated
meditation: meditations
meditatively: meditatively
medium: medium
meet: meet,meeting,met
melancholy: melancholy
menial: menials
mental: mental
mentally: mentally
mention: mentioned
mere: mere
merit: merit
message: message,messages
metaphysician: metaphysicians
method: method,methods
metropolis: metropolis
miasma: miasma
michael: michael
middle: middle
midi: midi
midnight: midnight
mila: mila
mild: mild
miller: miller
mind: mind,minds
minded: minded
mingle: mingled
minute: minute,minutes
minutely: minutely
misfortune: misfortune
mission: mission
mississippi: mississippi
mistake: mistake
mixture: mixture
mockery: mockery
modest: modest
modification: modification
modify: modified
moment: moment,moments
monde: monde
money: money
monotone: monotone
monotonous: monotonous
monstrous: monstrous
month: month
monument: monuments
monumental: monumental
moon: moon
moonlight: moonlight
moonshine: moonshine
moor: moored
morning: morning
morrow: morrow
morsel: morsels
mortal: mortals
mortify: mortified
mossy: mossy
mother: mother
motive: motives
mound: mounds
mountain: mountain,mountains
mourner: mourners
movement: movement,movements
moving: moving
muffle: muffled
murmur: murmur,murmured
music: music
muslin: muslin
mustache: mustache
mysterious: mysterious
mystery: mystery
mystifying: mystifying
narrate: narrated
national: national
native: native,natives
natural: natural
naturally: naturally
neat: neat
negligence: negligence
neighbor: neighbors
neighboring: neighboring
nephew: nephew
nervous: nervous
nest: nest
network: network
newport: newport
news: news
newsletter: newsletter
nice: nice,nicer
night: night
nocturnal: nocturnal
nod: nodded
nonproprietary: nonproprietary
nonsense: nonsense
nook: nook
north: north
nose: nose
nosegay: nosegay
notice: notice,noticed,noticing
notify: notifies
numerous: numerous
nurse: nurse,nursing
obey: obey
object: object,objects
objection: objection
objective: objective
oblige: obliged
obsequious: obsequious
observance: observance
observant: observant
observation: observation,observations
observe: observe,observed,observing
obsolete: obsolete
obvious: obvious
occasion: occasion,occasions
occupation: occupations
occupy: occupied
occur: occur,occurred,occurring
ocean: ocean
odd: odd
odor: odors
offend: offended
offended: offended
offense: offense
offensively: offensively
offer: offer,offered,offering,offers
office: office
official: official
online: online
opinion: opinion
opportunity: opportunities,opportunity
opposition: opposition
oppressively: oppressively
optical: optical
opulence: opulence
organ: organ
organism: organism
organize: organized
original: original
originator: originator
ornament: ornamented
ornamental: ornamental
ostracism: ostracism
oubliette: oubliettes
outdated: outdated
overhang: overhangs
overlook: overlooked,overlooks
overmuch: overmuch
overtake: overtook
owe: owed
owner: owner
pain: pains
painful: painful
pair: pair,paired
palace: palace
palatine: palatine
pale: pale
papal: papal
paper: paper
paperwork: paperwork
paragraph: paragraph,paragraphs
parapet: parapet
parasol: parasol
pardon: pardon
parent: parent
parental: parental
paris: paris
parlor: parlor
partisan: partisan
partner: partners
party: parties,party
pass: passed,passing
passe: passe
passion: passion,passions
passionate: passionate
pat: pats
patch: patches
paternally: paternally
path: path
pathological: pathological
patience: patience
patient: patient
pause: pause,paused
pave: paved
pavement: pavement
pay: paid,pay,paying
payment: payments
pebble: pebbles
peculiar: peculiar
pedestrian: pedestrians
penetrate: penetrating
penny: penny
pension: pension
pensive: pensive
pensiveness: pensiveness
perceive: perceive,perceived
perfect: perfect
perfection: perfection
perfectly: perfectly
perform: perform,performed,performing
performance: performance,performances
perfume: perfume
perilous: perilous
period: period
periodic: periodic
permanent: permanent
permissible: permissible
permission: permission
permit: permitted
perpetually: perpetually
perplexed: perplexed
perplexing: perplexing
persiflage: persiflage
person: people,person,persons
personage: personage
personal: personal
personality: personality
persuade: persuade
peter: peter
philosophic: philosophic
phrase: phrase
physical: physical
piano: piano
pick: pick,picked
picture: picture,pictures
picturesque: picturesque
piece: piece
pilaster: pilasters
pill: pills
pincian: pincian
pine: pine
pink: pink
pitched: pitched
pitiful: pitiful
pity: pity
placidity: placidity
placidly: placidly
plaguy: plaguy
plain: plain
play: play,played
pleadingly: pleadingly
pleasant: pleasant
pleasanter: pleasanter
pleasantry: pleasantries
pleased: pleased
pleasure: pleasure
plenty: plenty
pluck: pluck
pocket: pocket
poet: poets
poise: poised
poke: poked,poking
poky: poky
pole: pole
polish: polish
polite: polite
politeness: politeness
poor: poor
portable: portable
porter: porter
portrait: portrait
possess: possessed
possession: possession
possibility: possibilities,possibility
post: posted
potential: potential
practically: practically
practice: practice,practiced
prattle: prattle
pray: pray
preach: preaching
precede: preceded
prefer: prefer,preferred
preference: preference
pregnantly: pregnantly
preoccupy: preoccupied
prepare: prepare,prepared
prepared: prepared
presence: presence
presently: presently
preserve: preserve
presume: presume
pretend: pretending,pretends
pretext: pretext,pretexts
prettily: prettily
prettiness: prettiness
pretty: prettier,prettiest,pretty
prevail: prevailed
prevent: prevent
previous: previous
princess: princess,princesses
principal: principal
print: print,printed
private: private
privilege: privilege
privileged: privileged
probable: probable
proceed: proceeded
processing: processing
proclaim: proclaimed
produce: produce,produced
production: production
profess: professed
professor: professor
profit: profit,profits
profundity: profundity
program: program
progress: progress
prohibition: prohibition
project: project,projected
prolong: prolonged
prominently: prominently
promise: promise,promised,promising
promote: promoting
promotion: promotion
pronounce: pronounce,pronounced,pronouncing
pronounced: pronounced
proof: proof
proofread: proofread
proper: proper
property: property
proportion: proportion
propose: propose,proposed
proprietary: proprietary
prospect: prospect
protect: protect
protest: protested,protesting
protestant: protestant
protestation: protestations
protuberance: protuberance
prove: prove,proved
provide: provide,providing
provincial: provincial
provision: provision,provisions
prudent: prudent
public: public
publicity: publicity
publicly: publicly
puerility: puerility
puff: puffs
pull: pulling
punctiliously: punctiliously
punitive: punitive
purely: purely
purpose: purpose,purposes
pursue: pursued
pursuit: pursuit
push: pushed
puzzle: puzzled
puzzled: puzzled
quaint: quaint
quarter: quarter
queer: queer
queerest: queerest
querulous: querulous
question: question,questions
qui: qui
quick: quick
quicken: quickened
quiet: quiet
quit: quitted
quotation: quotation
racket: rackets
radiance: radiance
radiant: radiant
raise: raise,raised
randolph: randolph
rapid: rapid
rapidity: rapidity
rapidly: rapidly
rarely: rarely
rate: rate
rattle: rattle
raw: raw
reach: reached,reaching
read: read,reading
readable: readable
reader: reader
ready: ready
reaffirm: reaffirm
real: real
reason: reason
reasonable: reasonable
reassure: reassure,reassured
rebuke: rebuke
receipt: receipt
receive: receive,received,receiving
reciprocate: reciprocated
reckless: reckless
recklessness: recklessness
recommend: recommended
record: recorded
recur: recurred
red: red
redistribute: redistribute,redistributing
redistributing: redistributing
redistribution: redistribution
reduce: reduced
refer: referring
reference: references
reflect: reflected,reflecting
reflection: reflections
refund: refund
refusal: refusal
refuse: refused
regard: regard,regarded
region: region
register: registered
regret: regret
regular: regular
regulate: regulating
rejoin: rejoin,rejoined
relate: relate
relation: relations
release: release,released
relief: relief
relieve: relieve
relish: relish
remain: remain,remained,remaining
remark: remark,remarked,remarks
remarkable: remarkable
remarkably: remarkably
remedy: remedies
remember: remember,remembered
remind: reminding
remonstrate: remonstrate
remotely: remotely
remove: remove,removed
rename: renamed
rendezvous: rendezvous
repair: repaired
repeat: repeated,repeating
replace: replace
replacement: replacement
reply: replied,reply
report: report,reported,reports
representation: representations
representative: representative
reproach: reproaches
reprobate: reprobate
reputation: reputation
request: request
require: require,required
requirement: requirements
reside: reside,residing
residence: residence
resolve: resolved
respect: respect
respectability: respectability
respectable: respectable
respectfully: respectfully
respond: responded,responding
response: response
rest: rest,rested,resting
restriction: restrictions
resume: resumed,resuming
retire: retired
retort: retort
retrace: retraced
retreat: retreat
return: return,returned,returns
revenge: revenge
revenue: revenue
revert: reverted
revolving: revolving
revulsion: revulsion
reward: reward
ribbon: ribbon,ribbons
rich: rich
richmond: richmond
rid: rid
riddle: riddle
ride: ride
rise: rise,risen,rose
risk: risk,risked
roll: roll,rolled
roman: roman
romancer: romancers
romantic: romantic
rome: rome
roof: roof
rough: rough
rouleaux: rouleaux
row: row
royalty: royalties,royalty
rub: rubbing
rude: rude
ruefully: ruefully
rug: rug
rugged: rugged
ruin: ruin
rule: rules
rumor: rumor
russian: russian
rustle: rustled
rustling: rustling
sacrifice: sacrifice
safe: safe
safely: safely
sail: sail
sake: sake
salon: salon
salt: salt
salute: salute
sanctity: sanctity
sanders: sanders
sanitary: sanitary
saratoga: saratoga
satisfaction: satisfaction
savage: savage
save: save
scale: scale
scandal: scandal
scandalous: scandalous
scatter: scattered,scattering
scene: scene
scent: scented
school: school
scientifically: scientifically
scold: scold
scorn: scorn
search: search
season: season
seat: seat,seated,seating,seats
secluded: secluded
secret: secrets
secretary: secretaries
secure: secure
select: select,selected
send: send,sending
sensation: sensation
sense: sense
sensibility: sensibility
sentence: sentence
sentiment: sentiment,sentiments
sentimental: sentimental
september: september
serenely: serenely
serenity: serenity
series: series
servant: servant,servants
serve: serve,served
service: service
set: set
settle: settle,settled
seventeen: seventeen
shade: shade
shadow: shadow,shadows
shaft: shaft
shake: shook
shank: shanks
shape: shaped
share: share,shared,sharing
sharp: sharp
sharply: sharply
shawl: shawl
sheen: sheen
ship: ship
shocked: shocked
shocking: shocking
shore: shore
short: short
shoulder: shoulder,shoulders
shrewd: shrewd
shudder: shudder
shut: shut
shyly: shyly
sick: sick
sickness: sickness
sight: sights
sign: sign,signs
signorina: signorina
silence: silence
silent: silent
simple: simple
simplify: simplify
simply: simply
sing: sang,sing,sings
singing: singing
single: single
singular: singular
singularly: singularly
sir: sir
sister: sister
sit: sat,sit,sits,sitting
situation: situation
skepticism: skepticism
skiff: skiff
skirt: skirts
sky: sky
slap: slap
sleep: sleep,sleeping,sleeps
slender: slender
slight: slight,slightest
slippery: slippery
slow: slow
slowly: slowly
smart: smart
smartly: smartly
smell: smelling
smile: smile,smiled,smiling
smoke: smokes
smooth: smoothed,smoothing
sniff: sniffed
soberly: soberly
sociable: sociable
social: social
society: society
soft: soft
softly: softly
softness: softness
sojourn: sojourn
solemnly: solemnly
solicit: solicit
solicitation: solicitation
son: son,sons
song: songs
sore: sore
sort: sort
sound: sound,sounded,sounds
source: source
southern: southern
spare: spare
speak: speak,speaking,speaks,spoke,spoken
special: special
specific: specific
specimen: specimens
speech: speeches
spend: spent
spending: spending
sphere: sphere
spin: spun
spindle: spindle
spirit: spirit,spirits
spite: spite
splendid: splendid
splendidly: splendidly
splendor: splendor
spoil: spoiled
spot: spot
spread: spread
sprig: sprig
spring: spring,springing
spurious: spurious
squeeze: squeezing
staff: staff
stage: stage
staircase: staircase,staircases
stand: stand,standing,stands,stood
stare: stare,stared,staring
starlight: starlight
starlit: starlit
start: start
statement: statements
station: stationed
status: status
stay: stay,stayed,staying
steamboat: steamboats
steamer: steamer
step: step,stepped,steps
stiff: stiff,stiffer
stocking: stockings
stool: stool
store: stored
story: stories
straight: straight
straighten: straightening
straightway: straightway
strange: strange
straw: straw
street: streets
stretch: stretching
strict: strict
strike: struck
striking: striking
strikingly: strikingly
stroll: strolled,strolling
structure: structure
study: study,studying
style: style
stylish: stylish
subject: subject
subjective: subjective
subjoin: subjoined
subscribe: subscribe
substantial: substantial
subtle: subtle
succeed: succeeds
sudden: sudden
suddenly: suddenly
suffer: suffer,suffers
sufficient: sufficient
sugar: sugar
suggestion: suggestions
summer: summer
summerhouse: summerhouse
summons: summons
sun: sun
sunday: sunday
sunny: sunny
sunshine: sunshine
superb: superb
superficial: superficial
superior: superior
supply: supply,supplying
support: support
suppose: suppose
surface: surface
surprise: surprise,surprises
surround: surrounded
surveillance: surveillance
survive: survive
suspect: suspect
swamp: swamp
sway: sway
sweet: sweet,sweetest
sweetly: sweetly
sweetness: sweetness
swinging: swinging
swiss: swiss
switzerland: switzerland
sylph: sylph
sympathetically: sympathetically
synonymous: synonymous
table: table
tact: tact
talent: talent
talk: talk,talked,talking
tall: tall
taste: taste,tastes
tax: tax,taxes
tea: tea
teach: taught,teach
teacher: teacher,teachers
tear: tears
tease: teasing
temper: temper
temple: temples
tender: tender
term: term,terms
terrible: terrible
testify: testify
tete: tete
textbook: textbooks
thinking: thinking
thither: thither
threshold: threshold
throng: throng
throw: threw,throw,throwing
thrust: thrust
thump: thump
tiger: tigers
time: time,times
timid: timid
tiptoe: tiptoe
tired: tired
tiresome: tiresome
title: title
tomorrow: tomorrow
tone: tone,tones
tooth: teeth
topic: topics
torment: tormenting
toss: toss
touch: touched
tourist: tourist,tourists
tournure: tournure
tout: tout
tower: towers
town: town
trademark: trademark
tradition: traditions
train: train,trains
tranquil: tranquil
transcribe: transcribe
transcription: transcription
transport: transported
travel: travel,traveling
traveler: travelers
travels: travels
traverse: traversed,traversing
treat: treat,treated
treatment: treatment
tree: tree
tremendous: tremendous
tremendously: tremendously
tremor: tremor
trip: tripped,tripping
triumphantly: triumphantly
trois: trois
trouble: trouble
troubled: troubled
true: true
trustworthy: trustworthy
truth: truth
tuck: tuck
twist: twist
type: type,types
umbrella: umbrella
unable: unable
unacquainted: unacquainted
unattended: unattended
unbecomingly: unbecomingly
unbroken: unbroken
unconscious: unconscious
uncultivated: uncultivated
undefended: undefended
understand: understand,understood
understanding: understanding
undertake: undertake
uneasily: uneasily
unenforceability: unenforceability
unexpected: unexpected
unhappy: unhappy
uniform: uniform
united: united
universally: universally
unkind: unkind
unknown: unknown
unlink: unlink
unmarried: unmarried
unpleasant: unpleasant
unprecedented: unprecedented
unprotected: unprotected
unreasoning: unreasoning
unremittingly: unremittingly
unscrupulous: unscrupulous
unshrinking: unshrinking
unsolicited: unsolicited
unsophisticated: unsophisticated
unwonted: unwonted
update: updated
uppermost: uppermost
upstart: upstart
urbane: urbane
urbanity: urbanity
urchin: urchin
urge: urged
urgently: urgently
user: user
usual: usual
ut: ut
utter: uttering
utterly: utterly
vacation: vacation
vague: vague
vaguely: vaguely
vanilla: vanilla
variance: variance
variety: variety
vault: vaulted
vaulting: vaulting
vehicle: vehicle,vehicles
veil: veiled
velvet: velvet
venture: venture,ventured
verdure: verdure
version: version
vesper: vesper
vex: vexed
victoria: victoria
view: view,viewed,viewing
vigil: vigil
vigilance: vigilance
vigilant: vigilant
villa: villa
villainous: villainous
violate: violates
violation: violation
violent: violent
virus: virus
visage: visage
visible: visible
visibly: visibly
vision: vision
visit: visit,visited,visits
visitor: visitors
vivacious: vivacious
vivacity: vivacity
vocalize: vocalizing
voice: voice,voices
void: void
volunteer: volunteer,volunteers
vulgar: vulgar
wait: wait,waited
waiter: waiter,waiters
walk: walk,walked,walking,walks
walker: walker,walkers
walking: walking
wall: wall,walls
wander: wander,wandering
wane: waning
warm: warm
warranty: warranties,warranty
watch: watch,watching
water: water
watering: watering
waver: wavering
weak: weak
weakness: weakness
wear: wear,wearing,wore
week: week,weeks
west: west
western: western
whatsoever: whatsoever
whip: whip
whisker: whiskers
white: white
wide: wide,widest
widow: widow
wild: wild
window: window
winter: winter,winters
winterbourne: winterbourne
wise: wise
woman: woman,women
wonderful: wonderful
wonderfully: wonderfully
wooer: wooer
word: word
worth: worth
wound: wounded
wretched: wretched
write: write,writing,written,wrote
writing: writing
wrong: wrong
yard: yards
yellow: yellow
yesterday: yesterday
york: york
youthful: youthful
zeal: zeal
zurich: zurich
