abandon: abandon
abandonment: abandonment
abasement: abasement
abba: abba
abhor: abhor
abide: abide,abides,abiding
ability: ability
abnormal: abnormal
abode: abode
abound: abound,abounded,abounding
abounding: abounding
abraham: abraham
abreast: abreast
absence: absence
absent: absent
absolute: absolute
absolutely: absolutely
absurd: absurd
abundant: abundant
abundantly: abundantly
abuse: abused
accept: accept,accepted,accepting,accepts
acceptable: acceptable
acceptance: acceptance
access: access,accessed
accessible: accessible
accompany: accompanied,accompany
accomplish: accomplish,accomplishes
accord: accord
account: account,accounts
accuracy: accuracy
accurate: accurate
accurately: accurately
accuse: accusing
accuser: accuser
achieve: achieve
acknowledge: acknowledge,acknowledging
acorn: acorns
acquaintance: acquaintance
acquittal: acquittal
action: action,actions
active: active
actively: actively
activity: activities,activity
acts: acts
actual: actual
adam: adam
adapt: adapted
add: adds
addition: addition,additions
additional: additional
address: address,addressed,addresses
adhere: adhered
adjust: adjusted
admiration: admiration
admit: admit
admonish: admonished
adoniram: adoniram
adoption: adoption
advance: advance,advances
advancement: advancement
adverse: adverse
advert: adverts
advice: advice
advocate: advocate,advocates
affair: affairs
affection: affection,affections
affectionate: affectionate
affectionately: affectionately
afflict: afflicted
affliction: affliction,afflictions
afford: afford
afraid: afraid
africa: africa
african: african
age: age,ages
aged: aged
agency: agency
agent: agent,agents
ages: ages
agonising: agonising
agony: agony
agree: agree,agreed
agreement: agreement
aid: aid
air: air
ak: ak
alarmed: alarmed
alas: alas
alike: alike
alive: alive
allure: allure
almighty: almighty
aloft: aloft
alps: alps
altar: altar
alter: alter
alteration: alteration
alternate: alternate
alway: alway
amazement: amazement
amazing: amazing
ambassador: ambassador,ambassadors
ambition: ambition,ambitions
amen: amen
amendment: amendment
american: american
amiss: amiss
amuse: amused
amusement: amusement
ananias: ananias
anchor: anchored
anew: anew
angel: angel,angels
anger: anger
angry: angry
anguish: anguish
anoint: anointed,anointing
anointing: anointing
answer: answer,answered,answering,answers
ant: ants
antagonism: antagonism
anxiety: anxiety
anxious: anxious
anxiously: anxiously
apace: apace
apology: apology
apostle: apostle,apostles
apostles: apostles
appeal: appeal,appealed,appeals
appearance: appearance
appetite: appetite,appetites
applause: applause
applicable: applicable
apply: applied,applies,apply
appoint: appointed,appoints
apprehend: apprehend
approach: approach,approaching
approval: approval
approve: approved
apt: apt
aptitude: aptitude
arc: arc
archangel: archangel
archer: archer
archive: archive
ardent: ardent
ardour: ardour
argue: argue,argued
argument: argument
arithmetic: arithmetic
ark: ark
arm: arm,arms
armed: armed
armour: armour
army: army
arnold: arnold
arouse: arouse,aroused,arouses
arrange: arranges
array: array
arrest: arrest
arrive: arrive,arrived
arrow: arrow
art: art
asa: asa
ascend: ascend
ascension: ascension
asceticism: asceticism
ascii: ascii
ashamed: ashamed
asia: asia
asleep: asleep
ass: ass
assail: assail,assailed
assembly: assembly
assent: assent
assertion: assertion
assimilate: assimilated
assist: assist
assistance: assistance
assume: assume,assumes
assurance: assurance,assurances
assure: assure,assured,assures,assuring
assured: assured
astonishing: astonishing
astray: astray
atlantic: atlantic
atmosphere: atmosphere
atoning: atoning
attach: attached
attack: attack,attacked
attain: attain,attained
attempt: attempt,attempting
attend: attended
attention: attention
attentive: attentive
attentively: attentively
attitude: attitude
attractive: attractive
attribute: attributed
augean: augean
aught: aught
august: august
austere: austere
author: author
authority: authority
avail: avail,availed
avenue: avenues
avocation: avocations
avoid: avoid,avoided,avoids
await: awaiting
awaken: awaken
awakening: awakening
awe: awe,awed
awed: awed
awful: awful
aye: aye
babe: babe,babes
bach: bach
backslider: backslider
bacon: bacon
bad: bad,worse,worst
badly: badly
bag: bag
balance: balance
ball: ball
balloon: balloon
balm: balm
banish: banishes
banishment: banishment
baptise: baptised,baptising
baptism: baptism
baptist: baptist
bare: bare
barely: barely
bargain: bargain
barley: barley
barn: barn,barns
barnabas: barnabas
barrel: barrels
barren: barren
bartholomew: bartholomew
basal: basal
base: base,based
baseball: baseball
basis: bases
bath: bathed
battle: battle,battling
baxter: baxter
beam: beams
bear: bear,bearing,bears,bore,born
bearer: bearer
bearing: bearing
beast: beast,beasts
beat: beat,beaten,beating
beating: beating
beautiful: beautiful
beautify: beautify
beauty: beauty
becloud: becloud
becometh: becometh
bed: bed
bedding: bedding
beelzebub: beelzebub
beethoven: beethoven
befall: befalls,befell
beget: begets,begotten
beggar: beggar
begotten: begotten
begrime: begrimed
beguile: beguiled
behalf: behalf
behold: beheld,behold,beholding
belief: belief
believer: believer
believeth: believeth
belittle: belittle
bellow: bellowing
belly: belly
belong: belong,belonged,belongs
bemean: bemeaned
bench: bench
beneath: beneath
benediction: benediction
beneficent: beneficent
benefit: benefit,benefits
benevolence: benevolence
bent: bent
beseech: beseech,besought
beset: beset
bestow: bestow,bestowed,bestows
bestowing: bestowing
betray: betray,betrayed
betrayal: betrayal
beware: beware
bezaleel: bezaleel
bible: bible
bid: bids
bigoted: bigoted
billow: billows
binary: binary
bind: bind,bound
bird: bird
birth: birth
birthright: birthright
bishop: bishop
bit: bit
bitter: bitter
bitterness: bitterness
black: black
blackness: blackness
blank: blank
blaspheme: blaspheme
blasphemy: blasphemies,blasphemy
blend: blended
bless: bless,blessed
blessed: blessed
blessedness: blessedness
blessing: blessing,blessings
blest: blest
blind: blind,blinds
blindly: blindly
blindness: blindness
block: block
blood: blood
bloom: bloom
blossom: blossoms
blot: blot,blotted
board: board
boast: boast,boasts
boat: boats
bodily: bodily
body: bodies,body
bold: bold
boldly: boldly
boldness: boldness
bolt: bolt
bond: bond
bondage: bondage
book: book,books
boot: boots
booth: booth
border: borders
borderland: borderland
bow: bow,bowed
bower: bowers
box: box
boy: boy
boyish: boyish
boys: boys
brain: brain
branch: branch,branches
brand: brand
brass: brass
bravado: bravado
brave: brave
breach: breach
bread: bread
break: break,breaking,broke,broken
breakfast: breakfast
breast: breast
breath: breath
breathless: breathless
brethren: brethren
brick: brick
bride: bride
bridegroom: bridegroom
bridle: bridle
bright: bright
brighten: brightened
brightness: brightness
brilliant: brilliant
brim: brim,brimmed,brimming
bring: bring,bringing,brings,brought
bringeth: bringeth
brink: brink
broad: broad,broader
broaden: broadened,broadening
broken: broken
brother: brother
brotherly: brotherly
bruise: bruised
brushwood: brushwood
brutality: brutalities
bubble: bubbled,bubbles
buckler: buckler
build: build,building,builds,built
builder: builders
building: building,buildings
bullet: bullet,bullets
bunyan: bunyan
buoyant: buoyant
burden: burden,burdened,burdens
burdensome: burdensome
burn: burn,burned,burning
burst: bursts
bush: bush
business: business
busy: busier,busy
butchery: butchery
button: button
cadet: cadets
cake: cake
calamity: calamities
calculate: calculate,calculated
caleb: caleb
calling: calling
calm: calm,calms
calmly: calmly
camp: camp
campaign: campaigns
canaan: canaan
canada: canada
candidate: candidates
canst: canst
cap: cap
captain: captain
captive: captive,captives
captivity: captivity
carcase: carcase
card: card
care: care
careful: careful
carefully: carefully
careless: careless
carelessly: carelessly
carelessness: carelessness
carnal: carnal
carnality: carnality
carpenter: carpenter
carpet: carpets
carriage: carriage
carry: carried,carry,carrying
cast: cast,casting,casts
castaway: castaways
casteth: casteth
catastrophe: catastrophe
catch: catch,caught
catechism: catechism
cattle: cattle
cease: cease,ceased,ceases,ceasing
ceaseless: ceaseless
ceaselessly: ceaselessly
cedar: cedar
celluloid: celluloid
censorious: censorious
censure: censure
cent: cent
central: central
centurion: centurion
century: centuries,century
ceremony: ceremonies
chamber: chamber
chance: chance
change: change,changed,changing
channel: channel,channels
chap: chap
chapter: chapter
character: character
characteristic: characteristics
charge: charge,charged,charges
charitable: charitable
charity: charities,charity
charles: charles
chastening: chastening
chastise: chastised
check: check,checking,checks
cheek: cheek
cheer: cheer
cheerful: cheerful
cheerfully: cheerfully
cherish: cherished
chicago: chicago
chief: chief
chiefly: chiefly
child: child,children
childhood: childhood
childlike: childlike
chime: chime
china: china
chip: chips
choice: choice
choose: choose,chooses,chosen
chord: chord,chords
chosen: chosen
christ: christ
christian: christian,christians
christlike: christlike
church: church,churches
circumstance: circumstance,circumstances
citadel: citadel
citizen: citizen,citizens
citizenship: citizenship
city: cities,city
civil: civil
claim: claim,claims
clamour: clamour
clang: clanging
clasp: clasp
class: class,classes
clay: clay
clean: clean
cleanness: cleanness
cleanse: cleanse,cleansed,cleanses
cleansing: cleansing
cleave: cleave
cleft: cleft
client: client
cloak: cloak
clod: clod
close: close
clothe: clad,clothed
clothes: clothes
cloud: cloud,clouds
cloudless: cloudless
cloven: cloven
club: club
coal: coal
coast: coast
coat: coat
code: codes
cog: cogs
cold: cold
collar: collars
collection: collection
college: colleges
colonel: colonel
colossians: colossians
colt: colt
cometh: cometh
comfort: comfort,comforted,comforting,comforts
comforter: comforter
command: command,commanded,commands
commanding: commanding
commandment: commandments
commence: commenced
commend: commend
commercial: commercial
commission: commission,commissioned,commissions
commissioner: commissioner
commit: commit,committed
common: common
commonplace: commonplace
communication: communication
communion: communion
community: communities,community
compact: compact
companion: companion
company: company
comparative: comparative
compare: compared,comparing
compass: compass
compassion: compassion
compassionate: compassionate
compassionately: compassionately
compel: compel,compelled,compels
compilation: compilation
complacent: complacent
complain: complaining,complains
complaint: complaint
complete: complete,completed,completes
completely: completely
complex: complex
compliance: compliance
comply: comply,complying
compose: composed
comprehensive: comprehensive
compress: compressed
computation: computation
comrade: comrade,comrades
conceal: conceal
conceit: conceit,conceits
conceive: conceive
concept: concept
concern: concerned
conclude: conclude
conclusion: conclusion
condemn: condemn,condemned,condemning,condemns
condemnation: condemnation
condescend: condescended
condition: condition,conditions
conduct: conduct
confer: conferred
confess: confess,confessed
confession: confession
confidence: confidence
confident: confident
confidently: confidently
confine: confine,confined
confirm: confirmed,confirms
confirmation: confirmation
conflict: conflict
conform: conform
conformity: conformity
confound: confound
confront: confronted
confuse: confuse
confusion: confusion
congregation: congregation
congregationalists: congregationalists
conquer: conquer,conquered,conquers
conqueror: conquerors
conquest: conquest
conscience: conscience,consciences
conscious: conscious
consciousness: consciousness
consecrate: consecrated
consecration: consecration
consent: consent,consented
consequence: consequences
consequent: consequent
consequential: consequential
considerable: considerable
considerate: considerate
consideration: consideration,considerations
consign: consign
consolation: consolations
console: console
constant: constant
constantinople: constantinople
constantly: constantly
constitute: constitute,constitutes
constrain: constrained
constructive: constructive
consult: consult
consume: consume,consumed,consumes,consuming
contact: contact
contagious: contagious
contend: contending
content: content
contention: contention
contentious: contentious
contents: contents
continent: continent
contingent: contingent
continually: continually
continuance: continuance
continue: continue,continued,continues,continuing
continued: continued
continuous: continuous
contract: contract
contradiction: contradictions
contrary: contrary
contribution: contributions
control: control,controlled,controlling
controversy: controversy
convent: convents
conversation: conversation
conversion: conversion
convert: convert,converted,converts
converted: converted
convey: conveys
convict: convict,convicted,convicting,convicts
conviction: conviction,convictions
convince: convince,convinced,convinces,convincing
convinced: convinced
cony: conies
cool: cooling
copying: copying
copyright: copyright
cor: cor
corinthian: corinthians
corn: corn
cornelius: cornelius
cornfield: cornfield
corporation: corporation
corps: corps
corpse: corpse
correct: correct,corrected,corrects
correction: correction
corrective: corrective
corroborate: corroborate
corrupt: corrupt,corrupts
corruptible: corruptible
corruption: corruption
cost: cost,costs
council: council,councils
counsel: counsel
count: count,counted,counting,counts
countenance: countenance
counterfeit: counterfeit
countless: countless
country: countries,country
courage: courage
courageous: courageous
court: court,courts
courteous: courteous
courts: courts
covenant: covenant
cover: covered
covetous: covetous
covetousness: covetousness
cow: cow
cower: cowering
cowper: cowper
create: create,created,creating
creation: creation
creator: creator
creature: creature,creatures
credit: credit
creed: creed
creep: creeping
crew: crew
crib: crib
crime: crime
cringe: cringe
crisis: crisis
critical: critical
criticise: criticise,criticising
criticism: criticism,criticisms
croak: croaking
cross: cross
crowd: crowd,crowds
crowded: crowded
crown: crown,crowned
crowning: crowning
crucifixion: crucifixion
crucify: crucified
cruel: cruel
cruelly: cruelly
crush: crushed
cultivate: cultivating
cultivation: cultivation
cup: cup
curb: curbed
cure: cure,cured
current: current,currents
curse: cursed
curtain: curtains
curtis: curtis
custom: custom
cut: cut,cuts,cutting
cymbal: cymbals
cyrus: cyrus
daily: daily
dainty: dainty
daisy: daisies
damage: damage
damaged: damaged
damages: damages
damn: damn
damnation: damnation
damp: damp
dan: dan
dance: dances
danger: danger,dangers
dangerous: dangerous
daniel: daniel
dark: dark,darkest
darken: darkened
darkness: darkness
darts: darts
dastardly: dastardly
datum: data
daughter: daughter,daughters
david: david
dawn: dawn,dawned,dawns
day: day,days
dead: dead
deadly: deadly
deadness: deadness
deaf: deaf
deal: deal,dealing,deals,dealt
dealing: dealing
death: death
debauchery: debauchery
debt: debt
decay: decay
deceit: deceit
deceitfully: deceitfully
deceitfulness: deceitfulness
deceive: deceive,deceived
decide: decided
decision: decisions
declamation: declamation
declare: declare,declared,declares
deductible: deductible
deed: deed,deeds
deep: deep,deeper,deepest
deepen: deepened,deepening,deepens
deeply: deeply
defame: defamed
defect: defect,defects
defective: defective
defence: defence
defenceless: defenceless
defend: defend,defended
defer: deferred
defiance: defiance
defiant: defiant
defile: defiles
definite: definite
deflect: deflect,deflected
deform: deformed
degradation: degradation
degrade: degrades
degraded: degraded
delay: delay
deletion: deletions
delicacy: delicacy
delight: delight
deliver: deliver,delivered
deliverance: deliverance
delude: deluded
demand: demand,demands
den: den
denial: denial
denounce: denounce,denounced
dense: dense
denunciation: denunciations
deny: denied,deny
depart: depart,departed
departure: departure
depend: depend,depends
dependence: dependence
dependent: dependent
depress: depressed
depression: depression
depths: depths
derivative: derivative
derive: derive,derived
descend: descend
descent: descent
desert: desert
desirable: desirable
desire: desire,desires
desirous: desirous
desolate: desolate
despairing: despairing
desperate: desperate
despise: despise,despised,despising
destitute: destitute
destroy: destroy,destroyed,destroying,destroys
destruction: destruction
destructive: destructive
detach: detach
determine: determine,determined
determinedly: determinedly
develop: develop
development: development
devil: devil,devils
devoid: devoid
devote: devote,devoting
devoted: devoted
devotion: devotion
devour: devour
devout: devout
devoutly: devoutly
dew: dew
di: dis
dictation: dictation
dictatorial: dictatorial
die: die,died,dying
difference: difference
difficult: difficult
difficulty: difficulties,difficulty
dig: digged
diligence: diligence
diligently: diligently
dim: dim,dimmed
dimness: dimness
dinner: dinner
direct: direct,directed,directing,directs
direction: direction
director: director
dirt: dirt
disappointed: disappointed
disappointment: disappointment,disappointments
disaster: disaster,disasters
disastrous: disastrous
discern: discern,discerned,discerning
discernment: discernment
discharge: discharge,discharged
disciple: disciples
discipline: discipline
disclaim: disclaim
disclaimer: disclaimer,disclaimers
discontented: discontented
discontinue: discontinue
discourage: discourage
discouragement: discouragement
discourteous: discourteous
discover: discover,discovered
discredit: discredit
discuss: discussed,discusses
disease: disease,diseases
diseased: diseased
dish: dish
disk: disk
dislike: dislike
dismay: dismayed
disobedient: disobedient
disparagement: disparagement
dispensation: dispensation
display: display,displayed,displaying
displease: displease,displeased,displeasing
displeasure: displeasure
disposition: disposition,dispositions
dispute: dispute,disputed,disputes,disputing
disputer: disputer
disquiet: disquieted
dissatisfied: dissatisfied
distinct: distinct
distinction: distinction
distinctly: distinctly
distinguish: distinguishes
distinguished: distinguished
distortion: distortions
distract: distract
distracted: distracted
distress: distress,distresses
distressed: distressed
distribute: distribute,distributed,distributing
distribution: distribution
distributor: distributor
distrust: distrust
divide: divide,divided,dividing
divine: divine
divinely: divinely
divinity: divinity
divorce: divorce
doctor: doctor,doctors
doctrinal: doctrinal
doctrine: doctrine,doctrines
doer: doer
doest: doest
doeth: doeth
doings: doings
doleful: doleful
doll: doll
dollar: dollars
domain: domain
dominion: dominion
donate: donate
donation: donation,donations
donor: donors
doom: doom
door: door,doors
doorway: doorway
dost: dost
doth: doth
double: double
doubt: doubt,doubted,doubting,doubts
doubtless: doubtless
dove: dove
download: downloading
downward: downward
draught: draught
draw: draw,drawn,draws,drew
dread: dread
dreadful: dreadful
dream: dreamed
dress: dress
drift: drift
drink: drink
drive: driven
droop: droop,drooped
drop: dropped
dross: dross
drown: drown
drunkard: drunkard
drunkenness: drunkenness
dry: dry
dryness: dryness
dull: dull,dulled
dullness: dullness
dumb: dumb
dungeon: dungeon
dusky: dusky
dust: dust
dutiful: dutiful
duty: duties,duty
dwell: dwell,dwelling,dwells
dwelling: dwelling
dynamite: dynamite
eager: eager
eagerly: eagerly
ear: ear,ears
earn: earning
earnest: earnest
earnestly: earnestly
earnestness: earnestness
earth: earth
earthly: earthly
earthquake: earthquake
ease: ease
easily: easily
easy: easy
eat: eat,eaten
ebony: ebony
echo: echo
ecstasy: ecstasies,ecstasy
ecstatic: ecstatic
eden: eden
edged: edged
edify: edifying
edifying: edifying
edit: edited
edition: edition,editions
education: education
educational: educational
edwards: edwards
effective: effective
effectively: effectively
effectually: effectually
efficacy: efficacy
effort: effort,efforts
egypt: egypt
egyptian: egyptian,egyptians
elbow: elbow,elbowing
elder: elder
elect: elect
electric: electric
electricity: electricity
electronic: electronic
electronically: electronically
element: element
elevator: elevator
elijah: elijah
eloquent: eloquent
email: email
embolden: emboldened
embrace: embrace,embraced,embracing
eminent: eminent
emotion: emotion
emphasis: emphasis
emphasise: emphasise
empire: empire
employee: employee,employees
employment: employment,employments
empower: empowered,empowering
enable: enable,enabled,enables,enabling
encode: encoding
encompass: encompassed
encourage: encourage,encouraged,encourages,encouraging
encouragement: encouragement
encumbrance: encumbrance
endanger: endangered
endless: endless
endue: enduing
endurance: endurance
endure: endure,endured,enduring
enemy: enemies,enemy
energy: energy
enforce: enforced
engagement: engagement
engender: engenders
english: english
enjoy: enjoy,enjoyed,enjoying
enkindle: enkindles
enlarge: enlarged
enlighten: enlighten,enlightened,enlightens
enrage: enraging
enraged: enraged
enrol: enrolled
enslave: enslaved,enslaves
enslavement: enslavement
ensure: ensuring
enter: enter,entered,enters
enterprise: enterprise,enterprises
entertaining: entertaining
enthrone: enthrone,enthroned
entire: entire
entitle: entitled
entity: entity
entrance: entrance
entreat: entreated,entreats
entreaty: entreaties
entrust: entrusted
enumerate: enumerating
envy: envy
ephesian: ephesian
ephesians: ephesians
epistle: epistle,epistles
epochal: epochal
equal: equal
equally: equally
equip: equip,equipped
equipment: equipment
err: err
erroneously: erroneously
error: error,errors
escape: escape,escaped
espouse: espoused
essay: essay
essential: essential,essentials
establish: establish,established
estate: estate
esteem: esteem,esteemed,esteeming,esteems
estrange: estrange
estrangement: estrangement
eternal: eternal
eternally: eternally
eternity: eternity
evangelisation: evangelisation
evangelist: evangelist,evangelists
evening: evening,evenings
eventful: eventful
everlasting: everlasting
everyday: everyday
evidence: evidence,evidences
evidently: evidently
evil: evil
exacting: exacting
exalt: exalted
examination: examination
examine: examine
exceed: exceeded,exceeding,exceeds
exceedingly: exceedingly
excellent: excellent
excess: excesses
exchange: exchanged
excitement: excitement
exclaim: exclaim
exclusion: exclusion
exclusive: exclusive
exclusively: exclusively
exclusiveness: exclusiveness
excuse: excuse,excuses
execute: execute
execution: execution
executive: executive
exemplify: exemplified
exempt: exempt
exercise: exercise,exercised
exhaustless: exhaustless
exhort: exhorted,exhorts
exhortation: exhortation
exist: exist,existing,exists
existence: existence
exodus: exodus
expand: expanding
expect: expect,expected
expectant: expectant
expectation: expectation
expedient: expedient
expel: expelled
expend: expend
expense: expense,expenses
experience: experience,experiences
experienced: experienced
experimental: experimental
explain: explain,explained
explanation: explanation,explanations
explosive: explosive
export: exporting
expound: expound
expounder: expounders
express: express,expressed,expresses
expression: expression
extent: extent
external: external
extinguish: extinguished
extract: extracts
extreme: extreme
exultingly: exultingly
eye: eye,eyes
ezekiel: ezekiel
fabled: fabled
facility: facility
factor: factors
faculty: faculties,faculty
fade: fading
fail: fail,failing,fails
failure: failure,failures
fain: fain
faint: faint,faintest,fainting
fair: fair
fairbanks: fairbanks
faith: faith
faithful: faithful
faithfully: faithfully
faithfulness: faithfulness
fall: fall,fallen,falling,falls,fell
false: false
falsehood: falsehoods
fame: fame
familiar: familiar
family: families,family
fanaticism: fanaticism
fancy: fancies,fancy
farmer: farmer,farmers
fashion: fashion,fashioned,fashioning
fashionable: fashionable
fast: fast,fasted
fasting: fasting
fat: fat
fatal: fatal
fate: fate
father: father,fathers
fatten: fattened
fault: fault
faulty: faulty
favour: favour,favouring
fawn: fawn,fawning
fear: fear,feared,fearing,fears
fearful: fearful
fearfulness: fearfulness
fearless: fearless
fearlessly: fearlessly
feast: feast
feather: feather
federal: federal
fee: fee,fees
feeble: feeble,feeblest
feebly: feebly
feed: fed,feed,feeding
feel: feel,feels
feeling: feeling,feelings
feign: feigned
fellow: fellow,fellows
fellowman: fellowmen
fellowship: fellowship
fence: fence,fences
fervently: fervently
fervour: fervour
fever: fever
field: field,fields
fierce: fierce,fiercest
fiery: fiery
fifteenth: fifteenth
fiftieth: fiftieth
fight: fight,fighting,fights,fought
fighter: fighter
fighting: fighting
figure: figures
file: file,files
filial: filial
filling: filling
filthiness: filthiness
filthy: filthy
final: final
finally: finally
financial: financial
finding: finding,findings
finish: finish,finished
fir: fir
firm: firm,firmest
firmly: firmly
fish: fish,fishes
fishing: fishing
fist: fist
fit: fit,fits,fitted,fitting
fitly: fitly
fitness: fitness
flame: flame,flames,flaming
flash: flash,flashes
flatly: flatly
flattering: flattering
flattery: flattery
flee: fled,flee
fleece: fleece
fleeting: fleeting
flesh: flesh
fleshly: fleshly
fletcher: fletcher
flight: flight
flinty: flinty
float: float
flock: flocks
flood: flood,flooded,floods
floor: floor
flourish: flourish
flourishing: flourishing
flow: flowing,flows
fluid: fluid
fly: flew,fly
foal: foal
foam: foam
foe: foe,foes
fog: fog
folk: folks
follow: follow
follower: followers
folly: folly
food: food
foolish: foolish
foolishness: foolishness
foot: feet
footstep: footsteps
forbearance: forbearance
forbearing: forbearing
forbid: forbid,forbidden,forbidding
force: force,forced,forces
forefront: forefront
foreign: foreign
foreigner: foreigners
forerunner: forerunner
foresee: foresee
forest: forest
foretell: foretold
foreword: foreword
forget: forget,forgets,forgetting,forgot,forgotten
forgetful: forgetful
forgive: forgive,forgiven,forgiving
forgiveness: forgiveness
forgo: forgo
form: form,formed,forms
formalism: formalism
format: format,formats
forsake: forsake,forsaken,forsook
fortify: fortified
fortitude: fortitude
foul: foul
foundation: foundation
fount: fount
fountain: fountain,fountains
fourteen: fourteen
fourteenth: fourteenth
fourth: fourth
fox: fox,foxes
frail: frail
frank: frank
franks: franks
fraught: fraught
freedom: freedom
freely: freely
frequent: frequent
frequently: frequently
fresh: fresh
friction: friction
friend: friend,friends
friendship: friendship
frivolity: frivolity
frown: frown
fruit: fruit
fruitful: fruitful
fulfil: fulfil,fulfilled,fulfilling
fullness: fullness
fundamental: fundamental
funeral: funeral
furnace: furnace
furnish: furnish,furnishes
furniture: furniture
furrow: furrowed
fury: fury
future: future
gain: gain
gal: gal
gall: gall
garden: garden
garment: garment,garments
garrison: garrison
gate: gate
gather: gather,gathered
generation: generation,generations
generosity: generosity
generous: generous
generously: generously
genesis: genesis
gentile: gentile
gentiles: gentiles
gentle: gentle
gentleman: gentleman
gentleness: gentleness
gently: gently
genuflection: genuflections
genuine: genuine
german: german
gethsemane: gethsemane
ghost: ghost
giant: giant,giants
gideon: gideon
gift: gift,gifts
girdle: girdle,girdled
glad: glad
gladden: gladdening,gladdens
gladdest: gladdest
gladly: gladly
gladness: gladness
glance: glances,glancing
glass: glass
glimpse: glimpse,glimpses
glitter: glittering
globe: globe
gloom: gloom
glorify: glorified,glorify
glorious: glorious
gloriously: gloriously
glory: glories,glory
glow: glow,glows
goal: goal,goals
god: god
godhead: godhead
godless: godless
godly: godly
gold: gold
goliath: goliath
goodness: goodness
goodwill: goodwill
goose: goose
gospel: gospel
gospels: gospels
gossamer: gossamer
gossip: gossip
govern: govern,governing
government: government
governor: governor
grace: grace,graces
graceful: graceful
gracious: gracious
gradually: gradually
grain: grain
granary: granaries
grant: grant,granted
grasp: grasp,grasped
grass: grass
gratefully: gratefully
gratification: gratification
gratify: gratify
grave: grave
gravestone: gravestone
greatly: greatly
grecian: grecian
greed: greed
greek: greek
gregory: gregory
grey: grey
grief: grief
grieve: grieve,grieved,grieving
grieving: grieving
grievous: grievous
grim: grim
groove: groove,grooves
gross: gross
ground: ground
grow: grew,grow
grown: grown
growth: growth
grudge: grudges
grumble: grumbling
guarantee: guaranteeing
guard: guard,guarded
guardian: guardians
guidance: guidance
guide: guide,guided,guides
guile: guile
guilt: guilt
guilty: guilty
guise: guise
gun: gun
gush: gush,gushing
habit: habit
hair: hairs
hall: hall
hallelujah: hallelujah
hand: hand,handed,hands
hang: hang,hangs,hung
happiness: happiness
happy: happiest,happy
harass: harassed
harbour: harbour
hard: hard,hardest
harden: harden,hardened
hardness: hardness
hardship: hardship
harmless: harmless
harmonise: harmonise,harmonised
harmony: harmonies,harmony
harp: harp
harsh: harsh
hart: hart
harvest: harvest,harvests
hast: hast
haste: haste
hastily: hastily
hate: hate,hated
hated: hated
hateful: hateful
hath: hath
haunch: haunches
haunt: haunted
havoc: havoc
head: head,heads
headlong: headlong
headquarters: headquarters
heal: heal,healed,healing
healing: healing
health: health
healthfully: healthfully
healthy: healthy
heap: heaped
hear: hear,heard,hears
hearer: hearers
hearing: hearing
heart: heart,hearts
hearted: hearted
heartedness: heartedness
hearty: hearty
heat: heat,heated
heathen: heathen
heaven: heaven,heavens
heavenly: heavenly
heavens: heavens
heavy: heavier,heavy
hebrews: hebrews
hedge: hedge,hedged
heed: heed,heeded,heeding,heeds
heel: heels
height: heights
helper: helper
helpful: helpful
helpfully: helpfully
helpless: helpless
henceforth: henceforth
henry: henry
hercules: hercules
herd: herds
heretofore: heretofore
herewith: herewith
heritage: heritage
hero: hero,heroes
heroic: heroic
hesitate: hesitating
hidden: hidden
hide: hidden,hide,hides
hideousness: hideousness
highly: highly
highway: highway,highways
highwayman: highwayman
hilariously: hilariously
hill: hill,hills
hinder: hinder,hindered,hinders
hindrance: hindrance
historical: historical
history: history
hoar: hoar
hoary: hoary
hold: held,hold,holds
holder: holder
hole: hole
holiness: holiness
holy: holies,holy
homelessness: homelessness
honest: honest
honesty: honesty
honey: honey
honour: honour,honoured
hope: hope,hoped,hopes
hopeful: hopeful
horace: horace
horrible: horrible
horror: horrors
horse: horse
hospital: hospitals
host: host,hosts
hosts: hosts
hot: hot,hotter
hour: hour,hours
house: house,houses
household: household
hudson: hudson
huge: huge
hugh: hugh
human: human
humanise: humanised
humble: humble,humbled,humbling
humbleness: humbleness
humbly: humbly
humility: humility
hunger: hunger,hungered
hungry: hungry
hunt: hunting
hurl: hurled,hurling
hurricane: hurricane
hurry: hurry
hurt: hurt
hurtful: hurtful
husband: husband
huss: huss
hymn: hymn,hymns
hypnotise: hypnotising
hypothesis: hypothesis
idea: idea,ideas
ideal: ideal
identification: identification
identify: identify
idle: idle
idleness: idleness
idol: idols
idolise: idolised
ignominiously: ignominiously
ignorance: ignorance
ignorant: ignorant
iii: iii
illness: illness
illuminate: illuminate,illuminated,illuminates
illumination: illumination
illuminations: illuminations
illustrate: illustrated,illustrates
illustration: illustrations
imagination: imagination
imagine: imagined
immeasurable: immeasurable
immeasurably: immeasurably
immense: immense
immortalise: immortalised
impaired: impaired
impart: imparted
impatience: impatience
impenetrable: impenetrable
impenitence: impenitence
imperative: imperative
imperceptibly: imperceptibly
imperfect: imperfect
imperil: imperils
impersonal: impersonal
impetuous: impetuous
imply: implied,imply
impolite: impolite
impose: imposed
impossible: impossible
impostor: impostor
impracticable: impracticable
impress: impress
impression: impression
imprison: imprison,imprisoned
imprisonment: imprisonment,imprisonments
impure: impure
inaccurate: inaccurate
inattention: inattention
inaugural: inaugural
inbreathe: inbreathe
inbred: inbred
incapable: incapable
incense: incensed
incidental: incidental
inclined: inclined
include: include,included,includes,including
including: including
incoming: incoming
incomplete: incomplete
inconsistency: inconsistency
inconsistent: inconsistent
increase: increase,increased,increases,increasing
indefinite: indefinite
indemnify: indemnify
indemnity: indemnity
independently: independently
indescribably: indescribably
indian: indian
indifference: indifference
indignation: indignation
indirect: indirect
indirectly: indirectly
individual: individual,individuals
indulgence: indulgences
indwell: indwelling,indwelt
indwelling: indwelling
ineffable: ineffable
inexperienced: inexperienced
infallibility: infallibility
infancy: infancy
infant: infant
infer: infer
infinite: infinite
infinitely: infinitely
infirmity: infirmities
inflict: inflicting
influence: influence,influences
infringement: infringement
ingratitude: ingratitude
inhabitant: inhabitants
inherit: inheriting
inheritance: inheritance
iniquity: iniquities,iniquity
initial: initial
injustice: injustice,injustices
inmost: inmost
innocent: innocent
inordinate: inordinate
inquire: inquiring
inquiry: inquiry
inquisition: inquisition
inscribe: inscribed
insect: insect
insensibility: insensibility
insensible: insensible
insignificance: insignificance
inspiration: inspiration
inspire: inspire,inspired,inspires,inspiring
inspired: inspired
instance: instance
instant: instant
instantaneous: instantaneous
instantly: instantly
instinct: instinct
instruct: instruct,instructed,instructing,instructs
instruction: instruction
instructive: instructive
instrument: instruments
insult: insulted
insuperable: insuperable
integrity: integrity
intellectual: intellectual
intelligence: intelligence
intelligent: intelligent
intelligently: intelligently
intend: intended
intense: intense
intention: intention,intentions
intentional: intentional
intentionally: intentionally
intercede: interceded,intercedes
intercession: intercession
intercessory: intercessory
intercourse: intercourse
interfere: interfere
interminably: interminably
intermingle: intermingled
intermittent: intermittent
internal: internal
international: international
interpret: interpreted
interval: interval
interweave: interwoven
intimately: intimately
intolerance: intolerance
intolerant: intolerant
intreat: intreat
intrench: intrenched
introduce: introduce
invalid: invalid
invalidity: invalidity
invincible: invincible
invitation: invitation
invite: invited,inviting
inwrought: inwrought
iron: iron
irregular: irregular
irreparable: irreparable
irrevocable: irrevocable
irs: irs
isaac: isaac
isaiah: isaiah
iso: iso
israel: israel
israelites: israelites
issue: issues
isthmus: isthmus
itching: itching
iv: iv
ix: ix
jailer: jailer
james: james
january: january
japanese: japanese
jaw: jaws
jealous: jealous
jealousy: jealousies
jehovah: jehovah
jelly: jelly
jeremiah: jeremiah
jerusalem: jerusalem
jesus: jesus
jew: jew
jews: jews
joan: joan
job: job
joel: joel
john: john
jonah: jonah
jonathan: jonathan
jordan: jordan
joseph: joseph
joshua: joshua
journey: journey
joy: joy,joys
joyful: joyful
joylessness: joylessness
joyous: joyous
joyously: joyously
judas: judas
judge: judge
judges: judges
judgment: judgment,judgments
judicial: judicial
july: july
jump: jump,jumped
justified: justified
justify: justified
justly: justly
keen: keen,keenest
kick: kick,kicked,kicks
kill: kill,killed,killing
killer: killers
kindle: kindles
kindly: kindly
kindness: kindness
king: king,kings
kingdom: kingdom,kingdoms
kingly: kinglier
kingship: kingship
kitchen: kitchen
kneel: knelt
knife: knife
knock: knock,knocked
knoweth: knoweth
knowledge: knowledge
laborious: laborious
labour: labour,laboured,labouring,labours
lack: lack,lacking
lad: lad
lady: lady
laggard: laggards
lake: lake
lam: lam
lamb: lamb,lambs
lamentation: lamentations
land: land
lane: lane
language: language
lash: lashes
lasting: lasting
late: late
latimer: latimer
laughable: laughable
laughter: laughter
law: law,laws
lawful: lawful
lawfully: lawfully
lawyer: lawyer
lay: laid,lay,laying,lays
lead: lead,leading,leads,led
leader: leader,leaders
leadership: leadership
leadeth: leadeth
leading: leading,leadings
league: league
lean: lean,leaning
leap: leap,leaped,leaping,leaps
learn: learn,learned,learning
learning: learning
leave: leave,leaves,leaving,left
lebanon: lebanon
lecture: lectures
left: left
legal: legal
legally: legally
leper: lepers
lesson: lesson,lessons
letter: letter,letters
level: level
liability: liability
liable: liable
liberty: liberty
library: library
license: license
licensed: licensed
lid: lids
lie: lie,lies,lying
lieu: lieu
lieutenant: lieutenant
life: life,lives
lifeless: lifeless
lifelong: lifelong
lift: lift,lifted,lifts
light: light,lighted,lights
lighten: lightening
lightness: lightness
lightning: lightning
likeness: likeness
limit: limited
limitation: limitation
limited: limited
lincoln: lincoln
link: linked,links
lion: lion,lions
lip: lips
lisp: lisped
listen: listen,listened,listening
listlessly: listlessly
literary: literary
littleness: littleness
live: live,lived,lives,living
liveth: liveth
living: living
lo: lo
load: loaded
loaf: loaves
loathsome: loathsome
locate: located
location: locations
lock: locked
lodge: lodged
lodging: lodging
log: logs
logic: logic
logically: logically
london: london
loneliness: loneliness
longing: longing
longsuffering: longsuffering
loose: loose
lord: lord
lordship: lordship
lose: lose,losing,lost
loss: loss
lost: lost
lot: lot
loud: loud
loudly: loudly
love: love,loved,loves,loving
lovely: lovely
loving: loving
lovingkindness: lovingkindness
lovingly: lovingly
lowliness: lowliness
lowly: lowly
loyal: loyal
loyalty: loyalty
luke: luke
lukewarmness: lukewarmness
lurk: lurks
lust: lust,lusts
lute: lute
luther: luther
lying: lying
machine: machine
magnet: magnet
magnetic: magnetic
magnetism: magnetism
maid: maid
mail: mailed
main: main,mains
maintain: maintain,maintained,maintaining
majesty: majesty
malachi: malachi
malaria: malaria
malice: malice
malignant: malignant
manage: managed
manger: manger
manhood: manhood
manifest: manifest,manifesting
manifestation: manifestation
manifold: manifold
mankind: mankind
manly: manly
manner: manner
manners: manners
mansioned: mansioned
mar: mar,marred
march: march
margin: margin
mark: mark,marked,marks
market: market
marquis: marquis
marriage: marriage
married: married
mart: mart
martha: martha
martyr: martyr,martyrs
martyrdom: martyrdom
marvellous: marvellous
mary: mary
mass: mass
massachusetts: massachusetts
massacre: massacre
master: master,masters
mastery: mastery
matchless: matchless
material: material
matter: matter,matters
matthew: matthew
mature: mature
maturity: maturity
maximum: maximum
meal: meal,meals
measure: measure,measured
meat: meat
meditate: meditated
meditation: meditation
medium: medium
meek: meek
meekly: meekly
meekness: meekness
meet: meet,meeting,meets,met
meeting: meeting,meetings
melody: melodies,melody
melt: melted
memory: memory
mental: mental
mention: mentioning
merchantability: merchantability
merciless: merciless
mercilessly: mercilessly
mercy: mercies,mercy
mere: mere
merit: merits
meritorious: meritorious
merry: merry
message: message,messages
messenger: messengers
messiah: messiah
metal: metal
method: method,methods
methodists: methodists
michael: michael
mid: mid
middle: middle
midnight: midnight
midst: midst
mightily: mightily
mighty: mightiest,mighty
mild: milder
mile: mile,miles
military: military
milk: milk,milking
millennium: millennium
millrace: millrace
milton: milton
mind: mind,minds
minded: minded
mingle: mingled
minister: minister,ministered,ministering,ministers
ministers: ministers
ministry: ministry
minor: minor
minute: minute,minutes
miracle: miracles
mire: mire
mirth: mirth
misdirect: misdirect
miserable: miserable
misery: miseries
misguided: misguided
mislead: misled
mission: mission,missions
missionary: missionaries,missionary
mississippi: mississippi
mist: mists
mistake: mistake,mistakes
mistaken: mistaken
mistress: mistress
misuse: misuse
mock: mock,mocked,mocking,mocks
modesty: modesty
modification: modification
modify: modified
modulate: modulating
moment: moment
momentous: momentous
monarch: monarch
monastery: monasteries
money: money
montgomery: montgomery
month: months
moody: moody
moon: moon
moral: moral
morning: morning
morrow: morrow
mortal: mortal
moses: moses
moss: moss
mother: mother
motive: motives
mould: mould
moulder: mouldered
mount: mount,mounts
mountain: mountain,mountains
mountainous: mountainous
mourn: mourn
mouth: mouth
mouthed: mouthed
mouthful: mouthful
multiplication: multiplication
multiply: multiplied,multiply
multitude: multitude,multitudes
murder: murder,murders
murmur: murmur,murmurs
music: music
musket: muskets
mutilate: mutilated
mutual: mutual
mysterious: mysterious
mystery: mystery
mystic: mystic
mythology: mythology
nail: nail,nailed
naked: naked
narrow: narrow
nathan: nathan
nation: nation,nations
national: national
natural: natural
naturally: naturally
naturalness: naturalness
nature: nature,natures
naval: naval
navy: navy
necessity: necessities,necessity
needful: needful
needless: needless
needlessly: needlessly
needy: needy
negative: negative
neglect: neglect,neglected,neglecting
negligence: negligence
neighbour: neighbour,neighbours
nervous: nervous
nest: nest
nestle: nestle,nestling
network: network
nevermore: nevermore
newsletter: newsletter
newton: newton
nick: nick
nicodemus: nicodemus
nigh: nigh
night: night,nights
noah: noah
noise: noise
noiselessly: noiselessly
noisome: noisome
noisy: noisy
nonproprietary: nonproprietary
noon: noon
north: north
note: note
notice: notice
notification: notification
notify: notified,notifies,notify
november: november
numerous: numerous
nurse: nurse,nursing
nursery: nursery
nursing: nursing
oak: oak
obedience: obedience
obedient: obedient
obediently: obediently
obey: obey,obeyed,obeying
object: object,objects
obligation: obligation,obligations
observer: observers
obsolete: obsolete
obstacle: obstacles
obstinacy: obstinacy
obstinate: obstinate
obstruct: obstruct
obstruction: obstructions
occasion: occasion
occasionally: occasionally
occupation: occupations
occupy: occupied
occur: occur
ocean: ocean,oceans
offence: offence,offences
offend: offend,offended
offer: offer,offered,offers
offering: offering
office: office,offices
officer: officer,officers
official: official
oftentimes: oftentimes
oil: oil
omission: omission
omit: omit
omnipotent: omnipotent
oneness: oneness
online: online
operation: operation
opiate: opiate
opinion: opinion
opportunity: opportunities,opportunity
oppose: oppose,opposing
opposition: opposition
oppress: oppressed
oppression: oppression
oppressive: oppressive
ordain: ordained
orderly: orderly
ordinary: ordinary
oregon: oregon
organ: organ
organic: organic
organisation: organisation
organise: organised
organize: organized
original: original
originator: originator
orphanage: orphanages
orthodox: orthodox
ounce: ounce
outcast: outcast
outdated: outdated
outer: outer
outflow: outflow
outgoing: outgoing
outing: outing
outpouring: outpouring
outward: outward
outwit: outwits
oven: oven
overcome: overcame,overcome,overcomes
overflow: overflow,overflowed,overflowing,overflows
override: override
oversight: oversight
overtake: overtake,overtaken,overtakes,overtaking,overtook
overthrow: overthrew,overthrow,overthrowing
overwhelm: overwhelm
overwhelming: overwhelming
overwork: overwork
owe: owe,owed
owner: owner
pacific: pacific
pack: packed
pail: pail
pain: pain
painful: painful
pale: pale
palm: palm
panama: panama
pang: pang
papa: papa
paper: paper,papers
paperwork: paperwork
paraclete: paraclete
paragraph: paragraph,paragraphs
paralyze: paralyzes
pardon: pardon,pardoned,pardoning
parent: parents
paris: paris
parker: parker
parrot: parrot
partaker: partakers
partner: partner,partners
partnership: partnership
party: party
pass: pass,passed,passes,passing
passage: passage,passages
passenger: passengers
passion: passion,passions
passionate: passionate
passionately: passionately
passive: passive
passover: passover
pastor: pastor,pastors
pat: patted
path: path
patience: patience
patient: patient
patiently: patiently
patriotic: patriotic
pattern: pattern
paul: paul
pay: paid,pay,paying
payment: payments
peace: peace
peaceably: peaceably
peaceful: peaceful
peacefully: peacefully
pearl: pearl
peasant: peasant
pebble: pebbles
peculiar: peculiar
peer: peers
pelt: pelt
penalty: penalties
penitence: penitence
penitent: penitent
pentecost: pentecost
pentecostal: pentecostal
penury: penury
peradventure: peradventure
perfect: perfect,perfected,perfecting
perfecting: perfecting
perfection: perfection
perfectly: perfectly
perfectness: perfectness
perform: perform,performed,performing
performance: performances
peril: peril,perils
period: periods
periodic: periodic
perish: perish,perished,perishing
permanent: permanent
permission: permission
permit: permit,permitted
perpetual: perpetual
perplex: perplex
perplexity: perplexity
persecute: persecuted
persecution: persecution,persecutions
persist: persisted
persistently: persistently
person: people,person,persons
personal: personal
personality: personality
persuade: persuaded
persuasion: persuasion
persuasive: persuasive
pessimist: pessimist
pet: pet
peter: peter
petty: petty
petulant: petulant
pharaoh: pharaoh
pharisees: pharisees
phase: phases
phil: phil
philip: philip
philippians: philippians
philistine: philistine
philistines: philistines
philosopher: philosopher
philosophise: philosophising
phrase: phrase
physical: physical
physically: physically
physician: physician
piano: piano
pick: picked
picture: picture,pictured,pictures
piece: piece
pierce: pierce,pierced,piercing
pilate: pilate
pilgrim: pilgrim
pillar: pillar
pin: pins
pipe: pipes
pit: pit
pitch: pitch
pitchy: pitchy
pitiless: pitiless
pity: pitied,pity,pitying
plague: plagues
plain: plain,plainer
plainly: plainly
plan: plan,plans
plant: plant,planted
planting: planting
plash: plash
platform: platform
plato: plato
play: play,played,playing
plea: plea
plead: plead
pleasant: pleasant
pleased: pleased
pleasing: pleasing
pleasure: pleasure
pledge: pledged
plenty: plenty
plight: plighted
pluck: plucked
plunge: plunged
ply: plying
poet: poet
pointless: pointless
poison: poison
pole: pole
polish: polish
polished: polished
political: political
pomp: pomps
poor: poor
pope: pope
popular: popular
popularity: popularity
portion: portion,portions
portrait: portrait
portray: portrayed
position: position,positions
positive: positive
possess: possess,possessed
possession: possession,possessions
possibility: possibility
post: posted,posts
posting: posting
posture: posture
potter: potter
pottery: potteries
pour: pour,poured,pours
poverty: poverty
powder: powder
power: power,powers
powerful: powerful
practical: practical
practically: practically
practise: practising
praise: praise,praised,praises,praising
pray: pray,prayed,praying,prays
prayer: prayer,prayers
prayerful: prayerful
prayerfully: prayerfully
preach: preach,preached,preaches,preaching
preacher: preacher,preachers
preaching: preaching
precede: preceded
precious: precious
precipice: precipice
precision: precision
predecessor: predecessor
preface: preface
prefer: prefer,preferring
prejudice: prejudice
preoccupy: preoccupied
preparation: preparation
preparatory: preparatory
prepare: prepare,prepared,preparing
presbyterian: presbyterian
presence: presence
presentation: presentation
preserve: preserve,preserved
press: press,pressed,pressing
pressure: pressure
prestige: prestige
presumption: presumption
pretence: pretence
pretender: pretender
prevail: prevail,prevailed
prevent: prevent
previous: previous
price: price
prick: pricked
pride: pride
priest: priest,priests
prim: prim
primary: primary
prime: primed
prince: prince
principal: principal
principally: principally
principle: principle,principles
print: print,printed,prints
prison: prison
private: private
privilege: privilege,privileges
prize: prize
probable: probable
proceed: proceed
processing: processing
procession: procession
proclaim: proclaim
proclamation: proclamation
prodigal: prodigal
produce: produce,produced,producing
production: production
profess: professes,professing
profession: profession,professions
professor: professor
profit: profit,profits
profound: profound,profoundest
programme: programme
progress: progress
prohibition: prohibition
project: project
prolong: prolongs
prominently: prominently
promise: promise,promised,promises
promising: promising
promote: promoting
promotion: promotion
prompt: prompts
prompter: prompter
promptness: promptness
pronounced: pronounced
proof: proof
proofread: proofread
proofreading: proofreading
propensity: propensity
proper: proper
properly: properly
property: property
prophecy: prophecies,prophecy
prophesy: prophesy
prophet: prophet,prophets
proportion: proportion
proprietary: proprietary
proprietorship: proprietorship
prosecute: prosecuted
proselytise: proselytising
prosper: prosper,prospers
prosperity: prosperity
protect: protect
prove: prove,proved,proves,proving
proverbs: proverbs
provide: provide,providing
providence: providence
providential: providential
province: province
provision: provision,provisions
provocation: provocations
prudence: prudence
psalm: psalm,psalms
psalmist: psalmist
public: public
publican: publicans
publish: publishing
puff: puffed
pull: pull,pulls
pulpit: pulpit
punish: punish,punished
punishment: punishment
punitive: punitive
purchase: purchase,purchases
pure: pure,purest
purgatory: purgatory
purge: purged
purification: purification
purify: purified,purifies,purifying
purifying: purifying
puritan: puritan
purity: purity
purpose: purpose,purposes
purse: purse
pursue: pursued
push: push,pushed,pushing
putty: putty
puzzle: puzzle,puzzling
puzzling: puzzling
quaint: quaint
quaker: quaker
quaking: quaking
quarrel: quarrels
quench: quench,quenched,quenches,quenching
question: question,questioned,questions
questioning: questioning,questionings
quick: quick,quicker
quicken: quicken,quickened,quickens
quicksand: quicksand
quiet: quiet
quietly: quietly
quotation: quotation,quotations
quote: quoted,quotes
rabbi: rabbi
race: race
racer: racer
rack: racked
radiance: radiance
rage: rage,raging
rail: rail
raimented: raimented
rain: rain,rained,rains
raise: raise,raised,raises
ram: ram,ramming
rank: ranks
ransack: ransacking
ransom: ransom
rapture: rapture
rapturous: rapturous
rash: rash
rationalism: rationalism
ravenous: ravenous
razor: razor
reach: reach,reached,reaches,reaching
read: read,reading,reads
readable: readable
reader: reader,readers
readiness: readiness
reading: reading
readjust: readjust
ready: ready
real: real
realise: realise,realised,realises,realising
reality: reality
realize: realizing
realm: realms
rear: rear
reason: reason,reasoned,reasons
reasonable: reasonable
reassure: reassure,reassuring
reassuring: reassuring
rebel: rebelled
rebellion: rebellion
rebellious: rebellious
rebuild: rebuild
rebuke: rebuke,rebuked
recede: recedes
receipt: receipt
receive: receive,received,receives,receiving
reckon: reckon,reckoned,reckons
reckoning: reckoning
recognise: recognised,recognising
recommend: recommend,recommended
reconcile: reconciled
record: record,recorded
recount: recounts
recover: recover
recovery: recovery
rectify: rectified
rectitude: rectitude
recur: recurring
red: red
redeem: redeemed
redeemer: redeemer
redemption: redemption
redistribute: redistribute,redistributing
redistributing: redistributing
redistribution: redistribution
reduce: reduced
refer: referred
reference: references
reform: reforms
refrain: refrain
refresh: refreshed,refreshes
refreshment: refreshment
refund: refund
refusal: refusal
refuse: refuse,refused,refuses,refusing
regard: regard,regarded
regeneration: regeneration
register: registered
regret: regrets,regretting
regulate: regulates,regulating
rehearsal: rehearsal
rehoboth: rehoboth
reign: reign,reigned,reigning,reigns
reinforce: reinforced,reinforces
reinforcement: reinforcement
reiterate: reiterated
reject: reject,rejected
rejection: rejection
rejoice: rejoice,rejoiced,rejoices,rejoicing
rejoicing: rejoicing
relation: relation,relations
relationship: relationship
release: release
relentless: relentless
reliance: reliance
relief: relief
religion: religion
religious: religious
relish: relish
rely: rely
remain: remain,remaining,remains
remarkable: remarkable
remedy: remedies,remedy
remember: remember,remembered,remembering
remembrance: remembrance
remission: remission
remove: remove,removed
rename: renamed
render: render
renew: renew,renewed
renewal: renewal
renounce: renounce,renouncing
rent: rent
renunciation: renunciation
repeat: repeat,repeated
repel: repel
repellent: repellent
repent: repent,repented
repentance: repentance
repine: repine,repining
replace: replace
replacement: replacement
reply: replied,replies,reply
report: report,reported,reports
represent: represent,represents
representation: representations
reproach: reproaches
reprobate: reprobates
reproduce: reproduced
reputation: reputation
request: request
require: require,required,requires
requirement: requirements
rescue: rescue
rescuer: rescuer
resemble: resembled
reservoir: reservoir
resist: resist,resisted,resisting
resistance: resistance
resistless: resistless
resolutely: resolutely
resolution: resolution
respect: respect
respectable: respectable
respond: respond,responded,responds
responsibility: responsibility
responsible: responsible
responsive: responsive
rest: rest
restore: restore,restores
restrain: restrain
restriction: restrictions
result: result
resurrection: resurrection
retain: retained
retainer: retainer
retort: retort
return: return,returned,returns
reveal: reveal,revealed,revealing,reveals
revelation: revelation,revelations
revenue: revenue
reverential: reverential
revile: reviled
revise: revised
revision: revision
revival: revival,revivals
revive: revives
revolution: revolution
reward: reward
riband: ribands
rich: rich,richest
riches: riches
richly: richly
rid: rid
ride: ride,riding,rode
righteous: righteous
righteousness: righteousness
rightly: rightly
ripe: ripe
ripen: ripening
rise: rise,risen,rising,rose
risk: risk
ritualistic: ritualistic
rival: rival
rivalry: rivalry
river: river,rivers
road: road
roar: roaring
rob: rob,robbed,robs
robber: robber
robbery: robbery
robe: robe
robust: robust
rock: rock
rocky: rocky
rolling: rolling
roman: roman,romans
roof: roof
root: root,rooted
rose: rose
rote: rote
rough: rough
roughly: roughly
rounded: rounded
rousseau: rousseau
route: routed
row: row
royalty: royalties,royalty
rub: rubbing
rugby: rugby
rugged: rugged
ruin: ruin,ruined
rule: rule,ruled,rules
rush: rushes,rushing
russian: russian
rut: rut,ruts
sabbath: sabbath
sacrament: sacraments
sacred: sacred
sacrifice: sacrifice,sacrificed,sacrifices,sacrificing
sad: sad
sadly: sadly
safe: safe,safer
safeguard: safeguarded
safely: safely
safety: safety
sail: sail
saint: saints
saith: saith
sake: sake
salaried: salaried
salt: salt
salvation: salvation
salvationist: salvationist
samaria: samaria
samaritan: samaritan
sample: sample
samuel: samuel
sanctification: sanctification
sanctified: sanctified
sanctifier: sanctifier
sanctify: sanctified,sanctifies,sanctify,sanctifying
sanctifying: sanctifying
sanctity: sanctity
sap: sap
sapphira: sapphira
saron: saron
satan: satan
satisfaction: satisfaction
satisfactory: satisfactory
satisfy: satisfies,satisfy
satisfying: satisfying
saul: saul
savagely: savagely
save: save,saved,saves,saving
saving: saving
saviour: saviour,saviours
scale: scale,scales
scar: scar
scarcely: scarcely
scatter: scattered
scene: scenes
sceptre: sceptre
schismatic: schismatic
scholar: scholars
school: school,schools
schoolmaster: schoolmaster
science: science
scientific: scientific
score: scores
scorn: scorn
scourging: scourging
scribe: scribe,scribes
scribes: scribes
scriptural: scriptural
scripture: scripture,scriptures
scrub: scrubs
sea: sea,seas
seal: sealed
seamless: seamless
sear: sears
search: search,searched,searches,searching
searcher: searcher
searching: searching
season: season,seasons
seat: seat,seated,seats
secondary: secondary
secret: secret
sectarian: sectarian
secular: secular
secure: secure,secured
security: security
seed: seed,seeds
seek: seek,seeking,seeks,sought
seeker: seeker,seekers
seldom: seldom
seleucia: seleucia
selfish: selfish
selfishly: selfishly
selfishness: selfishness
sell: sell,sells,sold
send: send,sending,sends
seneca: seneca
sense: sense
senseless: senseless
sensual: sensual
sentence: sentence,sentenced
separate: separate,separated
separation: separation,separations
september: september
seraphim: seraphims
series: series
sermon: sermon,sermons
servant: servant,servants
serve: serve
server: server
service: service
set: set,sets
settle: settles
severe: severe
shadow: shadow,shadowing,shadows
shake: shook
shakespeare: shakespeare
shalt: shalt
shame: shame
shameful: shameful
share: share,shared,sharing
sharp: sharp
sheath: sheath
sheathed: sheathed
shedding: shedding
sheep: sheep
shelter: shelters
shepherd: shepherd
shield: shield
shine: shine,shines,shining,shone
ship: ship
shipwreck: shipwreck,shipwrecks
shock: shock
shod: shod
shoot: shoot,shot
shop: shop
shore: shore
short: short
shorten: shortened
shortly: shortly
shortness: shortness
shot: shot
shoulder: shoulder,shoulders
shouldst: shouldst
shout: shout,shouts
shrink: shrank,shrink
shut: shut
sick: sick
sickness: sickness
siege: siege
sigh: sigh
sight: sight,sights
sightedness: sightedness
sign: sign,signs
silas: silas
silence: silence
silent: silent
silken: silken
silver: silver
simple: simple
simplicity: simplicity
simply: simply
simpson: simpson
sin: sin,sinned,sinning,sins
sincerity: sincerity
sinful: sinful
sing: sang,sing,singing
singing: singing
single: single
singleness: singleness
sink: sink,sinks
sinless: sinless
sinner: sinner,sinners
sinners: sinners
sir: sir
sister: sister,sisters
sit: sat,sit,sitting
sixth: sixth
sized: sized
skilfully: skilfully
skill: skill
skilled: skilled
sky: skies
slander: slander,slandered,slanders
slap: slap
slaughter: slaughter
slave: slave,slaves
slavery: slavery
slay: slain
sleep: sleep,sleeping,slept
sleepiness: sleepiness
sleepless: sleepless
slight: slighted
slip: slip
sloth: sloth
slothfulness: slothfulness
slow: slow
slowly: slowly
slowness: slowness
slum: slum,slums
slumber: slumber
smile: smile,smiles,smiling
smite: smite,smites,smiting,smitten
smooth: smooth
smote: smote
snare: snare,snared
snatch: snatch
sob: sobbed
soberly: soberly
sociable: sociable
social: social
society: society
sodom: sodom
soever: soever
soft: soft
soften: soften
softly: softly
soil: soil
soldier: soldier,soldiers
solemn: solemn
solemnly: solemnly
solicit: solicit
solicitation: solicitation
solomon: solomon
solve: solving
son: son,sons
song: song,songs
sooner: sooner
soothe: soothe,soothes
sore: sore,sores
sorely: sorely
sorrow: sorrow
sorrowing: sorrowing
soul: soul,souls
sound: sound,sounding
southern: southern
sovereign: sovereign
spare: spare
spark: spark
sparkling: sparkling
spasmodically: spasmodically
speak: spake,speak,speaking,speaks,spoke,spoken
speaking: speaking
special: special
specific: specific
spectator: spectator
speculation: speculation
speech: speech
speed: speed
spend: spend,spent
sphere: sphere
spill: spilt
spin: spinning
spire: spires
spirit: spirit,spirits
spiritless: spiritless
spiritual: spiritual
spiritually: spiritually
spite: spite
splendid: splendid
splendidly: splendidly
splendour: splendour
spoil: spoil,spoils
spontaneous: spontaneous
sportsman: sportsman
spot: spot
spread: spread
spring: spring,springing
sprinkle: sprinkle,sprinkles
square: square
stable: stables
stablish: stablish
staff: staff
stain: stain,stains
stake: stake
stalk: stalks
stammer: stammered
stand: stand,stands,stood
standard: standard
standing: standing
standpoint: standpoint
star: star
starless: starless
starry: starry
start: start
statement: statement,statements
station: stations
status: status
statute: statutes
stay: stay
steadfast: steadfast
steadfastly: steadfastly
steadfastness: steadfastness
steadily: steadily
steal: steal,stole,stolen
steel: steel
steele: steele
steer: steer
stem: stem
step: step,steps
stephen: stephen
stern: stern
steward: steward
stick: stick
stillness: stillness
sting: sting
stir: stir,stirred,stirring,stirs
stirring: stirrings
stock: stocks
stoically: stoically
stone: stone,stoned
stony: stony
stool: stool
store: store,stored
storehouse: storehouse
storm: storm,storms
stormy: stormy
story: story
stout: stoutest
straighten: straighten
straightforward: straightforward
strain: strain
strange: strange
stranger: stranger,strangers
strangle: strangled
straw: straw
stray: straying
stream: stream
street: street
strength: strength
strengthen: strengthen,strengthened,strengthening,strengthens
strengthener: strengthener
stretch: stretch,stretching
stricken: stricken
strict: strict
strictly: strictly
strife: strife
strike: strike
striking: striking
strip: stripped,strips
stripe: stripes
strive: strive,striving,strove
striving: strivings
stroke: stroke
strong: strong,stronger
struggle: struggle,struggled,struggles,struggling
stubborn: stubborn
study: studied,studies,study,studying
stultified: stultified
stumble: stumble
stumbling: stumbling
stunning: stunning
stupendous: stupendous
sty: sty
subdue: subdue,subdued
subject: subject,subjected,subjects
sublime: sublime
submission: submission
submit: submit,submitted,submitting
subordinate: subordinates
subscribe: subscribe
subsequent: subsequent
substitute: substitute,substitutes,substituting
subtle: subtle
succeed: succeeding,succeeds
success: success,successes
successful: successful
succession: succession
successor: successor
succour: succour
sudden: sudden
suddenly: suddenly
suffer: suffer,suffered,suffering
sufferer: sufferer,sufferers
suffering: suffering,sufferings
sufficiency: sufficiency
sufficient: sufficient
suggestion: suggestion
suit: suit
sum: sums
sun: sun
sunbeam: sunbeams
sunday: sunday
sunlight: sunlight
sunny: sunny
sunshine: sunshine
superhuman: superhuman
superior: superior
superiority: superiority
supplication: supplication
supply: supply
support: support,supported,supports
suppose: suppose,supposed,supposing
suppress: suppress
supreme: supreme
surely: surely
surety: surety
surface: surface
surpass: surpassing
surprise: surprise
surrender: surrender
surround: surrounded,surrounding
surroundings: surroundings
survive: survive
suspect: suspect
suspicion: suspicions
sustain: sustained,sustains
swaddle: swaddling
swallow: swallow,swallowed
swamp: swamp
swear: swear,swore,sworn
sweat: sweat
sweep: sweep,sweeps,swept
sweet: sweet,sweetest
sweetly: sweetly
sweetness: sweetness
swell: swelling
swift: swift
swiftly: swiftly
swing: swings
swish: swish
switch: switch
swollen: swollen
sword: sword
sympathise: sympathise,sympathising
sympathy: sympathy
synonymous: synonymous
tabernacle: tabernacle
table: table
tail: tail
taint: taint
talent: talents
talk: talk,talked,talking,talks
talking: talking
tame: tamed
tangible: tangible
tarry: tarry
task: task,tasks
taste: taste
tax: tax,taxes
taylor: taylor
teach: taught,teach,teaches,teaching
teachable: teachable
teacher: teacher,teachers
teaching: teaching,teachings
team: team
tear: tear,tears
tearfully: tearfully
telegram: telegram
telegraphic: telegraphic
temper: temper,tempers
temperance: temperance
tempest: tempest
temple: temple
temporal: temporal
tempt: tempted
temptation: temptation
tempting: tempting
tendency: tendency
tender: tender
tenderly: tenderly
tenderness: tenderness
tent: tents
term: term,terms
terrible: terrible
terribly: terribly
terror: terror,terrors
testament: testament
testify: testify,testifying
testimony: testimony
testing: testing
thankful: thankful
thankfulness: thankfulness
thanksgiving: thanksgiving
thee: thee
theologian: theologian
theoretical: theoretical
theory: theory
thessalonians: thessalonians
thine: thine
thirst: thirsted
thirsty: thirsty
thong: thongs
thorn: thorns
thoughtful: thoughtful
thoughtless: thoughtless
threaten: threatened
thrilling: thrilling
thrive: thrives
throat: throats
throb: throb,throbbing
throbbing: throbbing
throne: throne
throng: throng
throw: threw,throw,thrown
thrust: thrust
thwart: thwarted
thy: thy
thyself: thyself
tickle: tickle
tide: tide,tides
tiding: tidings
tim: tim
timber: timber
time: time,times
timid: timid
timidity: timidity
timothy: timothy
tiny: tiny
tithe: tithes
title: title,titles
titus: titus
tobacco: tobacco
toil: toil,toiling
token: tokens
tolerant: tolerant
ton: tons
tone: tone,tones
tong: tongs
tongue: tongue,tongues
torch: torch
torture: tortured
toss: tossed
totter: tottering
touch: touch,touched,touches
touchy: touchy
tower: tower,towering
toy: toy,toyed,toys
trademark: trademark
train: train,trained,trains
training: training
transcribe: transcribe
transcription: transcription
transfiguration: transfiguration
transfigure: transfigure
transform: transform,transformed
transformation: transformation
transgress: transgressed
transgression: transgressions
transmit: transmitted
transparently: transparently
trap: traps
travail: travail
treat: treat,treated
treatment: treatment
tree: tree,trees
tremble: trembling
trespass: trespasses
trial: trial,trials
tribe: tribe
tribulation: tribulation
trifle: trifle,trifled,trifles
trinity: trinity
triumph: triumph,triumphing
triumphant: triumphant
triumphantly: triumphantly
trouble: trouble,troubled,troubles
troubled: troubled
true: true,truest
trust: trust,trusted,trusting,trusts
trusted: trusted
trustful: trustful
truth: truth,truths
tumble: tumbling
tumultuous: tumultuous
turmoil: turmoil
twill: twill
type: type,types
typhoid: typhoid
ultimate: ultimate
unable: unable
unarmed: unarmed
unbelief: unbelief
unbelieving: unbelieving
uncertain: uncertain
uncertainty: uncertainties,uncertainty
unchanging: unchanging
uncharitable: uncharitable
unclean: unclean
uncleanness: uncleanness
uncommon: uncommon
uncomplaining: uncomplaining
uncompromising: uncompromising
unconditional: unconditional
uncouth: uncouth
unction: unction
underlie: underlies,underlying
understand: understand,understood
understanding: understanding
undertake: undertake
undertaking: undertaking
undisputed: undisputed
undo: undone
undue: undue
unenforceability: unenforceability
unexplained: unexplained
unfailing: unfailing
unfit: unfit
unfitness: unfitness
unfold: unfold
unforgiving: unforgiving
unfulfilled: unfulfilled
ungainsayable: ungainsayable
unheralded: unheralded
unholy: unholy
uniform: uniform
unimportant: unimportant
unintentionally: unintentionally
union: union
unite: united,uniting
united: united
unity: unity
universal: universal
universe: universe
unjustly: unjustly
unkindness: unkindness
unknown: unknown
unlawful: unlawful
unlearned: unlearned
unlikeness: unlikeness
unlink: unlink
unloving: unloving
unmarried: unmarried
unmixed: unmixed
unmoved: unmoved
unnoticed: unnoticed
unpardonable: unpardonable
unpopular: unpopular
unprogressive: unprogressive
unquenchable: unquenchable
unrepentant: unrepentant
unrequited: unrequited
unrevealed: unrevealed
unrighteousness: unrighteousness
unsanctified: unsanctified
unsaved: unsaved
unselfish: unselfish
unselfishly: unselfishly
unshaken: unshaken
unsolicited: unsolicited
unspeakable: unspeakable
unspiritual: unspiritual
unsteadiness: unsteadiness
unsteady: unsteady
untimely: untimely
untoward: untoward
untroubled: untroubled
unusually: unusually
unutterable: unutterable
unwary: unwary
unwavering: unwavering
unwilling: unwilling
unwise: unwise
unworthiness: unworthiness
update: updated
uphold: upheld,uphold,upholds
upper: upper
upright: upright
uprightness: uprightness
uprising: uprising
upward: upward
urge: urge,urged,urges,urging
urgently: urgently
user: user
usual: usual
usurp: usurp
ut: ut
utmost: utmost
utter: utter,uttered
utterly: utterly
uttermost: uttermost
vacillate: vacillating
vague: vague
vain: vain
vainglory: vainglory
vainly: vainly
valley: valley
valuable: valuable
vanilla: vanilla
vanish: vanishes,vanishing
vanity: vanity
vanquish: vanquishes
variety: variety
vast: vast
vegetable: vegetables
vein: veins
vengeance: vengeance
vent: vent
venture: venture
verbal: verbal
verily: verily
verity: verity
verse: verse
version: version
vestibule: vestibule
veteran: veteran
vex: vexed
vice: vice
vicious: vicious
victory: victory
view: view,viewed,viewing,views
vigorous: vigorous
vii: vii
viii: viii
vile: vile
village: village
vine: vine,vines
vinegar: vinegar
vineyard: vineyard,vineyards
violate: violates
violation: violation
violence: violence
violent: violent
violently: violently
virgin: virgin
virtue: virtue,virtues
virus: virus
visible: visible
vision: vision,visions
visit: visit
vital: vital
vivid: vivid
voice: voice
void: void
volition: volitions
volley: volley
volume: volume
voluntarily: voluntarily
volunteer: volunteer,volunteers
vote: votes
vouchsafe: vouchsafes
vow: vows
voyage: voyage
wag: wagged
wagon: wagon
wait: wait,waited,waiting
waiting: waiting
wake: wake,wakes,waking
waken: wakened
walk: walk,walked,walking,walks
walled: walled
wallow: wallows
war: war,warring,wars
warm: warm,warms
warn: warn,warned,warning,warns
warning: warning
warranty: warranties,warranty
warrior: warriors
wash: washed,washes
washing: washing
washington: washington
waste: waste,wastes,wasting
watch: watch
watchful: watchful
watchfulness: watchfulness
water: water,waters
wave: wave,waves
waver: wavering,wavers
wax: wax
weak: weak
weakness: weakness
wealthy: wealthy
weapon: weapons
wear: wear,wore
wearily: wearily
weariness: weariness
weary: weary
weather: weather
weed: weed,weeds
week: weeks
weep: weep,weeping,wept
weigh: weighed
weight: weight
weld: welded
welfare: welfare
wellnigh: wellnigh
wesley: wesley
west: west
wet: wet
whatsoever: whatsoever
wheel: wheel,wheels
whereof: whereof
whereunto: whereunto
wherewith: wherewith
whimper: whimper
whip: whip
whipping: whippings
whisper: whisper,whispered
whit: whit
white: white
wholehearted: wholehearted
wholesome: wholesome
wholly: wholly
whosoever: whosoever
wicked: wicked
wickedness: wickedness
wide: wide,widest
wield: wield
wife: wife
wild: wild
wilderness: wilderness
wildest: wildest
wilful: wilful
wilfully: wilfully
willed: willed
william: william
willingness: willingness
wily: wily
win: win,winning,wins
wind: wind,winds
window: windows
wine: wine
wing: winged,wings
wink: wink
winner: winner,winners
winsome: winsome
wire: wire
wireless: wireless
wisdom: wisdom
wise: wise,wiser
wisely: wisely
wit: wit
withdraw: withdraw,withdrawn
withhold: withhold,withholding
witness: witness,witnessed,witnesses,witnessing
woe: woe,woes
wolf: wolves
woman: woman,women
womb: womb
wonderful: wonderful
wonderfully: wonderfully
wondrous: wondrous
wood: woods
word: word
worker: workers
workings: workings
workman: workman,workmen
workmanship: workmanship
worldliness: worldliness
worldly: worldly
worm: worm
wormwood: wormwood
worn: worn
worship: worship,worshipped,worships
worth: worth
worthy: worthy
wouldst: wouldst
wound: wounded
wounded: wounded
wrangle: wrangling
wrath: wrath
wreck: wrecked
wrestling: wrestling
write: write,writes,writing,written,wrote
writer: writer
writing: writing
writings: writings
wrong: wrong,wronged,wrongs
xi: xi
xii: xii
xiii: xiii
xiv: xiv
xix: xix
xvi: xvi
xvii: xvii
xviii: xviii
xx: xx
xxi: xxi
xxii: xxii
xxiii: xxiii
xxv: xxv
yard: yard
yea: yea
yearn: yearns
yearning: yearning
yield: yield,yielded,yielding
yoke: yoke
york: york
youth: youth
zeal: zeal
zealous: zealous
zion: zion
