abashed: abashed
abbreviated: abbreviated
abide: abide
ability: abilities,ability
abject: abject
abnormal: abnormal
abnormally: abnormally
aboard: aboard
abruptly: abruptly
absently: absently
absolute: absolute
accelerate: accelerating
accept: accept,accepted,accepting
acceptable: acceptable
acceptance: acceptance
access: access,accessed
accessible: accessible
accident: accident,accidents
accompany: accompanied
accomplish: accomplish
account: account
accusation: accusation
accuse: accuse
accustomed: accustomed
achieve: achieve,achieved
acknowledge: acknowledge
acknowledgment: acknowledgment
acquaint: acquainted
acquire: acquire
acrid: acrid
action: action
activate: activated
active: active
activity: activities,activity
actual: actual
acute: acute
acutely: acutely
adapt: adapt,adapted
adaptable: adaptable
add: add,adds
addition: addition,additions
additional: additional
address: address,addresses,addressing
adherence: adherence
adjust: adjust
administer: administered,administering
administrative: administrative
administrator: administrator
admission: admission
admit: admit,admitted
advance: advance
advanced: advanced
advancement: advancement
advantage: advantage,advantages
affair: affair
affect: affect
affectionate: affectionate
afflict: afflicted,afflicting
affliction: affliction
afford: afford,affording
afraid: afraid
afterhold: afterhold
afternoon: afternoon
afterward: afterward
aged: aged
agent: agent,agents
agonizing: agonizing
agree: agree,agreed
agreement: agreement
aid: aid
ailing: ailing
aimlessly: aimlessly
air: air
airborne: airborne
aircraft: aircraft
airlock: airlock
airport: airport
ak: ak
alan: alan
alarm: alarm
alarmingly: alarmingly
alarum: alarums
alaska: alaska
alcohol: alcohol
aldebaran: aldebaran
alert: alert
alertness: alertness
alien: alien
alienness: alienness
alive: alive
aloft: aloft
aloud: aloud
alteration: alteration,alterations
alternate: alternate
alternative: alternative
altogether: altogether
amass: amassed
amaze: amazes
amazement: amazement
amazing: amazing
ambassador: ambassador
america: america
american: american
ammonia: ammonia
amphitheater: amphitheater
ample: ample
amuse: amused
anaesthesia: anaesthesia
anaesthetic: anaesthetic,anaesthetics
anaesthetize: anaesthetized
analysis: analysis
anatomical: anatomical
anatomically: anatomically
anatomy: anatomy
ancestry: ancestry
anchor: anchoring
ancient: ancient
anger: anger
angrily: angrily
angry: angrier,angry
anguish: anguish
animal: animal,animals
ankle: ankles
announcer: announcer
annoy: annoy
annoyingly: annoyingly
answer: answer,answered,answers
antagonism: antagonism
anteroom: anteroom
antibiotic: antibiotic,antibiotics
antibody: antibodies,antibody
anticipate: anticipate,anticipated,anticipating
antidote: antidote
antisepsis: antisepsis
antiseptic: antiseptic
antiviral: antiviral
apathetic: apathetic
apologetic: apologetic
appal: appalled
apparatus: apparatus
apparent: apparent
appeal: appeal
appearance: appearance
appendectomy: appendectomy
apple: apple
applicable: applicable
applicant: applicant,applicants
application: application,applications
apply: applied,apply
appoint: appointed
appointment: appointment,appointments
apprehension: apprehension
apprehensively: apprehensively
approach: approach,approached
approval: approval
april: april
aquatic: aquatic
archive: archive
argue: argue,argued,arguing
argument: argument
arm: arm,arms
armed: armed
army: army
arrange: arranged,arranging
arrangement: arrangements
array: array
arrival: arrival
arrive: arrive,arrived,arrives,arriving
article: articles
artificially: artificially
ascii: ascii
ashamed: ashamed
askew: askew
aspect: aspect
assault: assault
assign: assign,assigned
assignment: assignment,assignments
assist: assisted,assisting
assistance: assistance
assistant: assistant,assistants
assume: assume,assumed,assuming
assure: assure,assured,assuring
astronomical: astronomical
atlas: atlas
atmosphere: atmosphere
atmospheric: atmospheric
atomic: atomic
attach: attached
attachment: attachment
attack: attack,attacked,attacking
attempt: attempt,attempted,attempting,attempts
attend: attend
attendance: attendance
attendant: attendant
attention: attention
attitude: attitude
audacity: audacity
aura: aura
austere: austere
author: author
authority: authorities,authority
authorization: authorization
autoclave: autoclave
automatic: automatic
automatically: automatically
automaton: automaton
autopsy: autopsies,autopsy
auxiliary: auxiliary
avoid: avoid,avoided
await: awaiting
awake: awake
awakening: awakening
aware: aware
awareness: awareness
awful: awful
awkward: awkward
backdrop: backdrop
bacterial: bacterial
bacteriological: bacteriological
bacterium: bacteria
bad: bad,worse,worst
badly: badly
baffle: baffled
bag: bag
baggage: baggage
bah: bah
bail: bail
balance: balance
ball: ball
bang: bang
bank: bank,banks
banner: banner
bar: bar
bare: bare
barely: barely
bargain: bargains
bargainer: bargainers
bargaining: bargaining
barracks: barracks
barrage: barrage
barren: barren
barrier: barrier
base: base,based
basic: basic
basically: basically
basin: basin
basis: basis
batch: batch
bath: bath
beaker: beaker,beakers
beam: beam,beamed,beaming
bear: bear,bears,born,borne
bearer: bearers
beat: beat
beating: beating
beautiful: beautiful
bed: bed
bedside: bedside
beetle: beetle,beetles
befriend: befriended
beg: beg
behalf: behalf
behave: behave,behaves
belabor: belabor
bell: bell,bells
belong: belong
bench: bench
beneath: beneath
benefit: benefit
bent: bent
bet: bet
betelgeuse: betelgeuse
bigness: bigness
billing: billings
bin: bin
binary: binary
bind: bind,bound
biochemical: biochemical
biochemist: biochemists
biochemistry: biochemistry
biological: biological
biomedical: biomedical
biped: biped
biscuit: biscuit
bit: bit,bits
bite: bit,bites
bitter: bitter
bitterly: bitterly
bitterness: bitterness
black: black
blade: blade
blame: blame,blamed
blandly: blandly
blank: blank
blanket: blanket
blankly: blankly
blare: blared,blaring
blast: blast
blessing: blessing
blind: blind
blindfold: blindfolded
blindly: blindly
blink: blinked,blinking
blissful: blissful
blistering: blistering
blizzard: blizzard
blob: blob
block: block,blocks
blockage: blockage
blood: blood
blooded: blooded
bloodstream: bloodstream
blooper: bloopers
blow: blow
blower: blowers
blue: blue
bluish: bluish
blunder: blundered
board: board
boarding: boarding
boat: boat
body: bodies,body
boiler: boiler
bolt: bolt
bone: bone,bones
book: book,books
bookshelf: bookshelves
boomerang: boomerang
boot: booted,boots
booth: booth
bored: bored
boring: boring
botch: botched
bother: bother,bothered,bothering
bottle: bottles
bound: bound
bow: bowed
box: box
boy: boy
brace: brace
bracket: brackets
braid: braid
brand: brand
breach: breach
break: break,breaks,broke,broken
breath: breath
breathe: breathe,breathing
breather: breather,breathers
breathing: breathing
breathless: breathless
breathlessly: breathlessly
breeze: breeze
bridge: bridge
briefing: briefing
bright: bright,brighter
brightly: brightly
bring: bring,bringing,brought
brink: brink
broad: broad
broadcast: broadcasts
broth: broth
brother: brother
bruiser: bruiser
brush: brushed,brushing
brutal: brutal
budge: budge,budged
build: build,building,built
building: building,buildings
bulletin: bulletins
bunch: bunches
bundle: bundling
bungle: bungled
bungler: bungler
bungling: bungling
bunk: bunk,bunks
burden: burden
burst: burst,bursts
bury: buried
business: business
bustle: bustle
busy: busied,busy
button: button,buttons
buyer: buyers
buzz: buzz,buzzed,buzzing
buzzer: buzzer
cabin: cabin,cabins
cabinet: cabinet
caduceus: caduceus
cage: cage,cages
calculate: calculate,calculated
california: california
caller: caller
calling: calling
camel: camel
camera: camera
camp: camp
cancel: cancel,canceled
cancer: cancer
canister: canister
cap: cap
capable: capable
cape: cape,capes
capillary: capillary
capsule: capsule
capture: captured
car: car,cars
card: card,cards
cardiac: cardiac
cardiogram: cardiogram
cardiograph: cardiograph
care: care,cared,cares
career: career
careful: careful
carefully: carefully
cargo: cargo
carrier: carriers
carry: carried,carry,carrying
cart: cart
cascade: cascade
cast: cast
catalog: catalog
catastrophic: catastrophic
catch: catch,caught
causative: causative
caution: caution
cease: cease,ceased
ceiling: ceiling
celebration: celebration
cell: cell,celled,cells
cellular: cellular
cent: cent
centennial: centennial
center: center,centered,centering,centers
central: central
century: centuries
ceremony: ceremonies,ceremony
chair: chair
challenge: challenge,challenged
chamber: chamber,chambers
chance: chance,chances
change: change,changed,changing
changer: changers
channel: channel,channeled,channels
chaos: chaos
chapter: chapter
character: character
characteristic: characteristic,characteristics
characteristically: characteristically
charge: charge,charges
charitable: charitable
charity: charities
charles: charles
chart: charted
chat: chatting
chatter: chatter,chattering
check: check,checked,checking,checks
cheek: cheeks
cheer: cheer
chemical: chemical,chemicals
chemistry: chemistries,chemistry
chest: chest
chicago: chicago
chief: chief
child: child
chill: chills
chilled: chilled
chip: chipping
chlorine: chlorine
choice: choice
choke: choke,choking
cholesterol: cholesterol
choose: choose,chooses,chose
chore: chore
chuckle: chuckled
circle: circle,circles
circuit: circuit
circulation: circulation
circulatory: circulatory
circumstance: circumstances
citizen: citizen
city: cities,city
civil: civil
civilization: civilization
civilized: civilized
clack: clacking
clad: clad
claim: claim,claiming,claims
clamp: clamp,clamps
clamped: clamped
clan: clans
clang: clanging
clarity: clarity
clash: clash
class: class
classification: classification
classify: classify
classmate: classmate,classmates
clause: clause
clearance: clearance
clench: clenched
clerk: clerk
cleveland: cleveland
clever: clever
climate: climate
climb: climb,climbed,climbing
cling: cling,clinging
clinic: clinic,clinics
clinically: clinically
cloak: cloak,cloaked
clock: clock
close: close,closed,closer,closest
closed: closed
closely: closely
closing: closing
cloth: cloth
clothes: clothes
cloud: cloud,clouds
clue: clue
clumsy: clumsy
clung: clung
clutch: clutched,clutching
coalesce: coalesced
coat: coat,coated
coating: coating
cocked: cocked
code: code,coded,codes
coffee: coffee
cohesive: cohesive
coincide: coincide
coincidence: coincidence
cold: cold
coldness: coldness
collapse: collapse
collar: collar
colleague: colleague
collect: collected
collection: collection
collide: collided
collision: collision
colloid: colloid
colonization: colonization
colony: colony
color: color,colored,colors
colorful: colorful
comb: comb
combination: combination
combine: combine
comfort: comfort
comfortable: comfortable
comfortably: comfortably
command: command,commanding
commandeer: commandeer
commander: commander
comment: comment
commercial: commercial
commit: commit,committed
common: common
commonplace: commonplace
communication: communication,communications
company: company
comparatively: comparatively
compare: compared,comparing
comparison: comparison
compartment: compartments
compelling: compelling
competent: competent
compilation: compilation
complain: complain,complained
complete: complete,completed,completing
completely: completely
complex: complex
complexity: complexities
compliance: compliance
compliment: compliments
comply: comply,complying
compound: compound
comprehensible: comprehensible
compress: compressed
conceal: conceal,concealed
conceivably: conceivably
concept: concept
concern: concern,concerned
conclave: conclave,conclaves
concoct: concocted
concourse: concourse
condition: condition,conditions
condone: condoned
conduct: conduct,conducting
confederation: confederation
conference: conference,conferences
confidence: confidence
confident: confident
confine: confined
confirm: confirm,confirmed
confirmation: confirmation
conflict: conflict
confuse: confused
confusing: confusing
congratulation: congratulation,congratulations
congress: congress
connect: connecting
connection: connection,connections
conscious: conscious
consciously: consciously
consent: consent
consequential: consequential
conservative: conservative
considerable: considerable
consideration: considerations
constant: constant
constantly: constantly
constellation: constellation
consult: consult
consume: consumed,consuming
contact: contact,contacted,contacts
contamination: contamination
contempt: contempt
contented: contented
contention: contention
contents: contents
continent: continent
contingent: contingent
continual: continual
continue: continued
continuously: continuously
continuum: continuum
contour: contour
contra: contra
contract: contract,contracts
contribute: contribute,contributed
contribution: contributions
control: control,controlled,controlling,controls
conventional: conventional
conversation: conversation,conversations
conversion: conversion
convert: convert,converting
conviction: conviction,convictions
convince: convince,convinced
convinced: convinced
convincing: convincing
cool: cool,cooled
cooling: cooling
coolly: coolly
cope: cope
copying: copying
copyright: copyright
cord: cords
cordial: cordial
core: core
corner: corner,corners
coronary: coronary
corporation: corporation
correct: correct
corridor: corridor,corridors
corrupt: corrupt
cost: cost,costs
cough: coughed,coughing
council: council
count: count,counting,counts
counter: counter
country: countries,country
countryman: countryman
countryside: countryside
couple: couple
courage: courage
cover: cover,covered
coverage: coverage
coveted: coveted
cowl: cowl
crack: crack
craft: craft
cram: crammed
cramp: cramped
cramped: cramped
crane: crane
cranny: cranny
crash: crash,crashed
crate: crate
crawl: crawl,crawled
crazy: crazy
crease: creased
create: create,created,creating
creation: creation
creature: creature,creatures
credit: credit
creep: creeping,crept
crew: crew,crews
crewman: crewman,crewmen
cripple: cripple
crippling: crippling
crisis: crisis
criterion: criteria,criterion
critical: critical
croak: croaked
crook: crook
cross: cross,crossed
crouch: crouch
crouching: crouching
crowd: crowd,crowded,crowding,crowds
crude: crude
cruel: cruel
cruise: cruise
crush: crushed
crutch: crutch,crutches
cryptically: cryptically
crystal: crystal
cubby: cubby
cubicle: cubicle
cuff: cuff
culture: culture,cultures
cure: cure
curious: curious
current: current,currents
curse: curse,cursed
curtly: curtly
custom: customs
customary: customary
cut: cut
cycle: cycle
cyclic: cyclic
daily: daily
dal: dal
damage: damage,damaged,damaging
damaged: damaged
damages: damages
damp: damp
dampness: dampness
dangerous: dangerous
dark: dark,darker
darken: darkened,darkening
darkly: darkly
dash: dashed
data: data
datum: data
david: david
dawn: dawn
day: day,days
dazed: dazed
dazzling: dazzling
dead: dead
deadly: deadly
deafen: deafened
deal: deal,dealing
death: death
deathly: deathly
debate: debate
debride: debriding
decade: decades
decent: decent
decide: decide,decided,deciding
decimate: decimated
decision: decision,decisions
decode: decoded
decontaminate: decontaminated
decontamination: decontamination
decorative: decorative
deductible: deductible
deep: deep,deeper
deeply: deeply
defect: defect,defects
defective: defective
defend: defend,defended,defending
defense: defense
defer: deferred
defiantly: defiantly
define: define
degenerative: degenerative
delay: delay,delayed,delaying,delays
delegate: delegates
delegation: delegation,delegations
deletion: deletions
deliberate: deliberate
deliberately: deliberately
delicate: delicate
delight: delight
delinquent: delinquent
delirious: delirious
demand: demand,demanded,demands
demonstrate: demonstrate,demonstrated
dense: densest
densely: densely
deny: deny
depart: departed
depend: depend,depended,depends
depths: depths
derivative: derivative
derive: derive,derived
derrick: derrick
descend: descended,descending
description: description
desert: desert
desertion: desertion
design: design,designed
designate: designated
desire: desired,desires
desk: desk
desolate: desolate
desolation: desolation
despair: despair
despaired: despaired
desperate: desperate
desperately: desperately
desperation: desperation
destination: destination
destroy: destroy,destroyed,destroying,destroys
destruction: destruction
detach: detach
detailed: detailed
detainment: detainment
deteriorate: deteriorating
determination: determination,determinations
determine: determine,determined
develop: develop,developed,developing
device: device,devices
diagnose: diagnose
diagnosis: diagnosis
diagnostic: diagnostic
diagnostician: diagnostician
dial: dials
dictate: dictating
die: die,died,dies,dying
difference: difference,differences
difficult: difficult
difficulty: difficulties,difficulty
dig: dig,digging,digs,dug
digest: digest
digestive: digestive
digit: digits
dignitary: dignitaries
diligently: diligently
dim: dim
diminutive: diminutive
dinner: dinner
dip: dip
diplomacy: diplomacy
direct: direct,directed,directing
direction: direction,directions
director: director
dirty: dirty
disable: disabling
disappear: disappeared
disappoint: disappointed
disappointed: disappointed
disappointingly: disappointingly
disappointment: disappointment
disaster: disaster
disastrous: disastrous
discharge: discharge
discipline: discipline,disciplines
disclaim: disclaim
disclaimer: disclaimer,disclaimers
discontinue: discontinue
discourage: discouraging
discover: discover,discovered,discovering
discreetly: discreetly
discuss: discuss,discussing
disease: disease,diseases
diseased: diseased
disembark: disembarked
disgrace: disgrace
disgust: disgust
disgusted: disgusted
dishonest: dishonest
dishonor: dishonor
disinfectant: disinfectants
disk: disk
dislike: disliked,dislikes
dismay: dismay
disorganized: disorganized
dispatch: dispatch,dispatched
dispatcher: dispatcher
display: display,displayed,displaying,displays
disposal: disposal
dissect: dissect
dissension: dissension
dissimilar: dissimilar
dissolve: dissolved
distance: distance,distances
distant: distant
distinction: distinction
distress: distress
distribute: distribute,distributed,distributing
distribution: distribution
distributor: distributor
disturb: disturbed
ditch: ditch
divert: divert
divide: divide,divided,dividing
division: division
doc: doc
docile: docile
doctor: doctor,doctors
dodge: dodging
dog: dog,dogs
domain: domain
dominant: dominant
donate: donate
donation: donation,donations
donor: donors
doodle: doodling
doom: doomed
door: door,doors
dope: dope
dosage: dosage
dose: doses
double: double
doubt: doubt
doubtfully: doubtfully
doubtless: doubtless
download: downloading
downright: downright
doze: doze
dozen: dozen,dozens
drab: drab
drachma: drachma
drag: drag,dragging
drain: drain
dramatic: dramatic
draw: draw,drawing,drawn,drew
drawer: drawer
dread: dread,dreaded
dreadful: dreadful
dreadfully: dreadfully
dream: dream,dreamed,dreams
dregs: dregs
dress: dress,dressed
dressing: dressing
drift: drifted
drink: drink
drip: dripped,dripping
drive: drive,driven,driving,drove
drop: drop,dropped
drug: drug,drugs
drum: drummed
dry: dry
duck: duck
duckling: ducklings
duffel: duffel
dull: dull
dummy: dummy
dump: dumped
duplicate: duplicated
duplication: duplication
dust: dust
duty: duties,duty
dwarf: dwarfed
eager: eager
eagerly: eagerly
ear: ear,ears
earn: earn,earned
earnestly: earnestly
earphone: earphones
earshot: earshot
earth: earth
earthman: earthman
earthmen: earthmen
ease: ease,eased
easily: easily
easy: easier,easy
eat: eat,eating
eavesdropping: eavesdropping
echo: echo
edge: edge,edges
edition: edition,editions
education: education
educational: educational
efface: effacing
effective: effective
effectively: effectively
efficiently: efficiently
effort: effort,efforts
egad: egad
eighteen: eighteen
eighth: eighth
eisenhower: eisenhower
elbow: elbow
elect: elect,elected
electrical: electrical
electro: electro
electrocardiograph: electrocardiograph
electron: electron
electronic: electronic
electronically: electronically
electronics: electronics
electrophoresis: electrophoresis
elevate: elevated
elevator: elevator,elevators
elude: elude,eluded
email: email
embarkation: embarkation
embellishment: embellishments
emblazon: emblazoned
emblem: emblem
embrace: embraced
embryonic: embryonic
emerge: emerge
emergency: emergency
emissary: emissary
emotion: emotions
emotional: emotional
emphasize: emphasize
employee: employee,employees
emptiness: emptiness
enable: enabling
encapsulate: encapsulated
encase: encased
enclosure: enclosure,enclosures
encode: encoding
encounter: encountered
endless: endless
endow: endowed
endure: endure
energy: energy
engage: engaged
engine: engine,engines
engineer: engineer
english: english
engross: engrossed
engulf: engulfed
enjoy: enjoy,enjoys
enormous: enormous
enormously: enormously
ensue: ensued
ensure: ensuring
entail: entailed
enter: enter,entered,entering
enthusiastic: enthusiastic
entire: entire
entity: entity
entrance: entrance
envelope: envelope
environment: environment,environments
envy: envy
enzyme: enzyme
epidemic: epidemic
equal: equal
equator: equator
equatorial: equatorial
equip: equip,equipped
equipment: equipment
erect: erect
error: error,errors
escort: escorted
essential: essential
establish: establish,established
estimate: estimate
evasively: evasively
evening: evening
event: event,events
evidence: evidence
evil: evil
evolutionary: evolutionary
exact: exact
exaggerate: exaggerated
exam: exams
examination: examination,examinations
examine: examine,examined,examining
exceedingly: exceedingly
excel: excel
excellent: excellent
excepting: excepting
exception: exceptions
excess: excess
exchange: exchange,exchanging
excite: excite
excited: excited
excitedly: excitedly
excitement: excitement
exciting: exciting
exclusion: exclusion
excretion: excretion
excursion: excursions
excuse: excuse
execute: executing
executive: executive
exempt: exempt
exhaust: exhausted
exhausted: exhausted
exhausting: exhausting
exist: existed,exists
existence: existence
exonerate: exonerate
exoskeleton: exoskeleton
exotic: exotic
expect: expect,expected
expel: expelled
expend: expend,expended
expense: expense,expenses
expensive: expensive
experience: experience,experienced
experienced: experienced
expert: expert
expire: expire
explain: explain,explains
explanation: explanation
explode: explode,exploded
exploration: exploration
exploratory: exploratory
explore: explore,explored,exploring
explorer: explorers
export: exporting
expose: exposed
express: express
expression: expression,expressions
extend: extended
extended: extended
extensive: extensive
extent: extent
extract: extracted
extracurricular: extracurricular
extreme: extreme
extremely: extremely
eye: eye,eyes
eyepiece: eyepiece
fabric: fabrics
faced: faced
facial: facial
facility: facilities,facility
factor: factors
fade: fade,faded,fading
fail: fail,failed
failure: failure,failures
faint: faint
faintly: faintly
fair: fair
fairbanks: fairbanks
fairness: fairness
faith: faith
faithful: faithful
faithfully: faithfully
fall: fall,falling,fell
false: false
falsehood: falsehood
falter: falter,faltered
familiar: familiar
family: family
famous: famous
fan: fan,fanned
fancy: fancy
fanfare: fanfare
farewell: farewells
fascinating: fascinating
fashion: fashion
fast: fast,faster
fat: fat
fatal: fatal
fate: fate
father: father
fatigue: fatigues
fault: fault
faulty: faulty
favor: favor
favorable: favorable
favorably: favorably
favorite: favorite
fear: fear,fears
fearful: fearful
fearfully: fearfully
feast: feast
feather: feather
federal: federal
fee: fee,fees
feebly: feebly
feed: fed,feeding
feel: feel,feeling
feeling: feeling,feelings
fellow: fellow,fellows
fervently: fervently
feverish: feverish
feverishly: feverishly
fiasco: fiasco
fiction: fiction
field: field,fields
fiercely: fiercely
fiftieth: fiftieth
fight: fight,fighting,fought
fighting: fighting
figure: figure,figured
file: file,filed,files
filing: filing
film: film
filter: filter,filtered,filtering
filtrate: filtrates
filtration: filtration
final: final,finals
finality: finality
finally: finally
financial: financial
fine: fine,finest
finger: finger,fingered,fingers
finish: finish,finished,finishing
firm: firms
firmly: firmly
fist: fist,fists
fit: fit,fits,fitted,fitting
fitness: fitness
fitting: fitting
flag: flagged
flagship: flagship
flair: flair
flare: flare,flared
flask: flasks
flat: flat
flatly: flatly
flattened: flattened
flaw: flaws
flawless: flawless
fledged: fledged
fledgling: fledgling
flee: fled
fleet: fleet
flesh: flesh
flick: flicked
flicker: flicker,flickered,flickering
flight: flight
flimsy: flimsy
flip: flipped
flood: flooded
floodlight: floodlight
floor: floor
flop: flopped
florid: florid
flounder: floundering
flourish: flourish
flow: flowing
fluid: fluid,fluids
flush: flushed,flushing
flutter: fluttering
fly: flying
focus: focus
fog: fog
folder: folder
follow: follow
fondness: fondness
food: food,foods
fool: fool,fooled,fooling,fools
foolish: foolish
foolishly: foolishly
foolishness: foolishness
foot: feet,foot
footing: footing
footstep: footsteps
forbid: forbidden
force: force,forced
forehead: forehead
foreign: foreign
foreleg: forelegs
forget: forget,forgot,forgotten
form: form,formed,forming,forms
formal: formal
formaldehyde: formaldehyde
formalin: formalin
formality: formalities
formally: formally
format: format,formats
formation: formation
formidable: formidable
formless: formless
fortunately: fortunately
fortune: fortune
foul: fouled
foundation: foundation
fraction: fractions
fragile: fragile
fragment: fragment
frail: frail
frame: frame
frank: frank
frantic: frantic
frantically: frantically
frazzle: frazzled
freely: freely
freeze: frozen
freezer: freezer
freighter: freighters
frequency: frequency
frequent: frequent
frequently: frequently
fresh: fresh
freshen: freshen
freshman: freshman
friday: friday
friend: friend,friends
friendliness: friendliness
friendly: friendly
friendship: friendship
fright: fright
frightened: frightened
frightening: frightening
frighteningly: frighteningly
frigid: frigid
frost: frost
frown: frown,frowned,frowning,frowns
frozen: frozen
fruit: fruit
fuel: fuel
fulfil: fulfilled,fulfilling
fulfill: fulfill
fulfillment: fulfillment
fumble: fumbled,fumbles
fun: fun
function: function,functions
fundamental: fundamental,fundamentals
funnel: funnel
funny: funny
fur: fur,furs
furious: furious
furiously: furiously
furniture: furniture
furry: furry
fury: fury
fuss: fuss
future: future
fuzz: fuzz
fuzzy: fuzzy
gain: gain,gaining
galactic: galactic
galaxy: galaxy
gale: gale
gamble: gamble
game: game,games
gantry: gantry
garage: garages
garb: garbed
gargantuan: gargantuan
gas: gas,gases
gasp: gasped,gasping,gasps
gather: gather,gathered,gathering
gathering: gathering
gawky: gawky
gear: gear
gene: genes
generation: generation,generations
genetic: genetic
gentle: gentle
gentleman: gentlemen
gently: gently
genuinely: genuinely
geographically: geographically
germ: germ
gesture: gesture
ghost: ghost
giant: giant
gibberish: gibberish
gift: gift
gigantic: gigantic
girder: girder
girth: girth
glad: glad
glance: glance,glanced,glancing
glare: glare,glared,glaring
glaring: glaring
glass: glass,glasses
gleam: gleamed,gleaming
glimpse: glimpse,glimpsed
glint: glinted,glinting
glisten: glistened,glistening
glitter: glittered,glittering
globule: globule
globulin: globulin,globulins
gloomily: gloomily
gloomy: gloomy
glove: gloves
glow: glowed,glowing
glower: glowered
glumly: glumly
glutted: glutted
gnarled: gnarled
goal: goal,goals
gold: gold
golden: golden
goof: goof
govern: govern
government: government
governmental: governmental
governor: governors
gown: gown,gowned
grab: grab
gracefully: gracefully
grade: grade
gradually: gradually
graduate: graduates
graduation: graduation
graft: graft,grafting,grafts
grand: grand
grant: granted
grapevine: grapevine
graphically: graphically
grapple: grapple,grappled
grappler: grapplers
grasp: grasp
grate: grate
grateful: grateful
gratefully: gratefully
grave: graves
gravely: gravely
gravity: gravity
gray: gray
green: green
greenhorn: greenhorn
greet: greet,greeted,greeting
greeting: greeting
greg: greg
gregory: gregory
grim: grim
grimly: grimly
grin: grin,grinned,grinning
grind: grind
grip: grip,gripped
grope: groping
gross: gross
ground: ground
groundless: groundless
grounds: grounds
grow: grew,grow,growing,grown
growl: growl,growled,growling
growth: growth
grudging: grudging
grudgingly: grudgingly
grunt: grunted
guarantee: guarantee
guard: guard
guess: guess,guessed
guidance: guidance
guide: guide,guiding
guinea: guinea
gulf: gulf
gulp: gulped
gutter: gutters
guy: guy,guys
gym: gym
gymnasium: gymnasium
habitable: habitable
habitual: habitual
hair: hair
haired: haired
hairless: hairless
halfway: halfway
hallway: hallway
halt: halt
hammer: hammer
hand: hand,handed,hands
handed: handed
handle: handle,handled,handling
handsomely: handsomely
hang: hanging,hung
happen: happen,happened,happening
happily: happily
happiness: happiness
happy: happy
harbor: harboring
hard: hard,harder,hardest
harden: hardened
harm: harm,harming
harmless: harmless
harness: harness
harsh: harsh
hart: hart
haste: haste
hatch: hatch
hate: hate,hated
hatred: hatred
hazing: hazing
head: head,headed,heading,heads
headquarters: headquarters
heal: healed
health: health
healthy: healthy
heap: heap,heaped
hear: hear,heard,hearing
hearing: hearing
heart: heart
heartedly: heartedly
heartedness: heartedness
heat: heat
heated: heated
heatedly: heatedly
heave: heaved
heavily: heavily
heavy: heavy
height: height
helpless: helpless
helplessly: helplessly
helplessness: helplessness
herd: herded
hesitant: hesitant
hesitantly: hesitantly
hesitate: hesitate,hesitated
hesitation: hesitation
hey: hey
hibernate: hibernate
hibernation: hibernation
hide: hide
highly: highly
hill: hills
hind: hind
hint: hint
hip: hips
history: history
hit: hit
hoarse: hoarse
hoarsely: hoarsely
hold: held,hold,holding,holds
holder: holder
hole: hole,holes
holler: holler,hollering
homeland: homeland
homesickness: homesickness
honest: honest
honestly: honestly
honor: honor,honored
honored: honored
hood: hood
hook: hook
hope: hope,hoped,hopes,hoping
hopefulness: hopefulness
hopeless: hopeless
hopelessly: hopelessly
hopelessness: hopelessness
horizon: horizon
horn: horn
horrible: horrible
horror: horror
hospital: hospital,hospitals
host: host,hosts
hostile: hostile
hostility: hostility
hot: hot
hotly: hotly
hound: hounds
hour: hour,hours
house: house,houses
housekeep: housekeeping
housing: housing
hover: hovered
howl: howl,howled,howling
hub: hub
huddle: huddle,huddled
hug: hugged,hugging
huge: huge
hugo: hugo
hulk: hulk
hull: hull
hum: hum
human: human
humanoid: humanoid
hungrily: hungrily
hungry: hungry
hurl: hurled
hurry: hurried,hurry,hurrying
hurt: hurt
hurtle: hurtled
hush: hushed
hydrogen: hydrogen
hyperspace: hyperspace
ice: ice
icy: icy
idea: idea,ideas
ideal: ideal
identifiable: identifiable
identification: identification
identify: identified,identify
idiot: idiot,idiots
idiotic: idiotic
idle: idle
ignore: ignore,ignoring
iii: iii
illness: illness
image: image
imagine: imagine
imbed: imbedded
immense: immense
immerse: immersed
immune: immune
immunity: immunity
immunization: immunization
immunize: immunize
impact: impact
impartial: impartial
impassive: impassive
impassively: impassively
impatient: impatient
impatiently: impatiently
imply: implied
impose: imposed
impossible: impossible
impregnable: impregnable
impress: impressed
impressed: impressed
impression: impression,impressions
improve: improve
inaccurate: inaccurate
inadvertent: inadvertent
inarguable: inarguable
inbred: inbred
inch: inch
incident: incident
incidental: incidental
include: include,included,includes,including
including: including
incoming: incoming
incompetence: incompetence
incompetent: incompetent
incomplete: incomplete
increase: increased,increasing
increasingly: increasingly
incredible: incredible
incredibly: incredibly
incredulously: incredulously
incubator: incubators
indefensible: indefensible
indefinitely: indefinitely
indemnify: indemnify
indemnity: indemnity
indication: indication
indifferently: indifferently
indirect: indirect
indirectly: indirectly
indistinguishable: indistinguishable
individual: individual,individuals
induce: induced
inept: inept
inert: inert
inevitable: inevitable
inexpert: inexpert
infallible: infallible
infect: infected
infected: infected
infection: infection
infectious: infectious
inferior: inferior
infestation: infestation
infinitely: infinitely
infringement: infringement
ingeniously: ingeniously
ingenuity: ingenuity
inhabit: inhabited,inhabiting
inhabitant: inhabitants
initial: initial
inject: inject,injected
injection: injection,injections
inkling: inkling
inlay: inlaid
inoculate: inoculated,inoculating
inoculation: inoculation,inoculations
inoculum: inoculum
inquisition: inquisition
insert: inserted
insignia: insignia
insignificant: insignificant
insist: insist,insisted
insistence: insistence
insolence: insolence
inspect: inspecting
inspection: inspection
inspector: inspector,inspectors
instantly: instantly
instinct: instincts
instinctive: instinctive
instinctively: instinctively
institute: institute
instruct: instructed
instruction: instruction,instructions
instrument: instrument,instruments
insure: insure
insurmountable: insurmountable
integrate: integrated
intellectual: intellectual
intelligence: intelligence
intelligent: intelligent
intend: intended
intense: intense
intensely: intensely
intensify: intensified
intensity: intensity
intensive: intensive
intention: intention
intercom: intercom
interior: interior
intermediary: intermediary
internal: internal
international: international
internist: internist
internists: internists
interplanetary: interplanetary
interpret: interpreted
interrogate: interrogated
interrupt: interrupting
interstellar: interstellar
interval: interval
intervene: intervened
interview: interview
intestine: intestine
intolerable: intolerable
intolerant: intolerant
intruder: intruder
invade: invade,invading
invader: invaders
invalidity: invalidity
invariably: invariably
inventory: inventoried,inventories
investigation: investigation
investment: investment
invitation: invitation
invite: invite
involve: involve,involved
inwardly: inwardly
irascible: irascible
ironically: ironically
irreparable: irreparable
irrevocable: irrevocable
irs: irs
island: islands
iso: iso
isolate: isolated
isolation: isolation
isotope: isotopes
isotopes: isotopes
issue: issue,issues
item: item,items
ivory: ivory
jack: jack
jacket: jacket
jai: jai
jam: jam,jammed,jamming
jamming: jamming
jar: jar
jaw: jaw,jaws
jelly: jelly
jeopardize: jeopardize,jeopardizing
jeopardy: jeopardy
jerk: jerked
jet: jet,jets
jewel: jewel
jibe: jibe
jitney: jitney
job: job,jobs
joint: joint
joke: joke,jokes,joking
jolt: jolted
jolting: jolting
journal: journal
joy: joy
joyful: joyful
jubilantly: jubilantly
judge: judge,judged,judges
judgment: judgment
jug: jugs
jump: jump,jumped,jumping
june: june
jungle: jungle
justify: justified
key: key
kick: kick,kicked,kicking
kill: kill,killed,killing
knock: knocked,knocking
knowledge: knowledge
kodiak: kodiak
lab: lab
labor: labor,labored,laboring
laboratory: laboratories,laboratory
ladder: ladder
lake: lake
lamb: lambs
lancet: lancet
land: land,landed,landing,lands
landing: landing,landings
language: language
lapse: lapse
late: late
laugh: laugh,laughed,laughing
launch: launching
launching: launching
law: law,laws
lay: laid,lay
layer: layer,layers
lead: lead,leading,led
leader: leader
leadership: leadership
leaf: leafed
lean: lean,leaned,leaning
leap: leap,leaped,leaping
learn: learn,learned
lease: lease
leave: leave,leaving,left
lecture: lecture
left: left
leg: legs
legal: legal
legally: legally
leisure: leisure
letter: letter,letters
level: level
liability: liability
liable: liable
liberty: liberty
library: library
license: license
licensed: licensed
lid: lid
lie: lie,lies,lying
lieu: lieu
life: life
lifeboat: lifeboat,lifeboats
lifetime: lifetime
lift: lifted,lifting
light: light,lights
lighten: lighten
likeable: likeable
likes: likes
limbo: limbo
limit: limited,limits
limitation: limitation
limited: limited
limp: limp
lineage: lineage
linger: lingering
lining: lining
link: linked,links
lip: lips
lipped: lipped
liquid: liquid
list: list,listed
listen: listen,listened,listening
liter: liters
literally: literally
literary: literary
live: live,lived,living
load: load,loaded,loading
loading: loading
loathing: loathing
lobby: lobby
local: local
locate: located
location: location,locations
lock: lock
locker: locker,lockers
lodge: lodged
lodging: lodging
log: log
loneliness: loneliness
lonely: lonely
longevity: longevity
loose: loose
lop: lop
lose: lose,losing,lost
loss: loss
lost: lost
lot: lot,lots
loud: loudest
loudly: loudly
loudspeaker: loudspeaker
lounge: lounge,lounges
loyalty: loyalty
luck: luck
lucky: lucky
lump: lump
lunch: lunch
luncheon: luncheon
lung: lung,lungs
lurch: lurched
luxury: luxuries,luxury
lying: lying
machine: machine
mad: mad
magic: magic
magnificent: magnificent
main: main
maintain: maintain,maintained,maintaining
maintenance: maintenance
major: major
maker: makers
malaria: malaria
male: male
maliciously: maliciously
malpractice: malpractice
mammal: mammals
mammoth: mammoth
manage: manage,managed
maneuver: maneuvered,maneuvers
manhood: manhood
manipulate: manipulating
manufacture: manufactured,manufacturing
manufacturing: manufacturing
manuscript: manuscript
map: map
march: march,marched
marine: marine
mark: mark,marked,marking
marrow: marrow
martin: martin
mask: mask,masks
mass: mass,masses
massage: massaging
massive: massive
master: master,mastered
match: match
material: material
materialize: materialized
matrix: matrix
matter: matter
maximum: maximum
maze: maze
mckay: mckay
meal: meals
meaning: meaning
measure: measure,measures
mechanical: mechanical
mechanism: mechanism,mechanisms
meddle: meddle
media: media
medical: medical
medication: medication,medications
medicine: medicine
mediocre: mediocre
medium: medium
meet: meet,meeting,met
meeting: meeting
mellow: mellow
melt: melted
membership: membership
memorize: memorized
memory: memory
menagerie: menagerie
mental: mental
mention: mention,mentioned
mere: mere
mess: mess
message: message,messages
metabolism: metabolism
metal: metal,metals
methane: methane
method: method,methods
metropolitan: metropolitan
michael: michael
micro: micro
microphone: microphone
microscope: microscope
microscopic: microscopic
middle: middle
midnight: midnight
midst: midst
midsummer: midsummer
mile: mile,miles
milling: milling
mind: mind,minds
minded: minded
mindless: mindless
minimum: minimum
minor: minor
minute: minute,minutes
miraculous: miraculous
miserable: miserable
miserably: miserably
misery: misery
misinform: misinforming
misjudge: misjudged
missing: missing
mission: mission
mississippi: mississippi
misstep: misstep
mistake: mistake,mistaken,mistakes
mistaken: mistaken
misunderstanding: misunderstanding
mix: mixed
mixed: mixed
mob: mob
moderately: moderately
modern: modern
modification: modification
modify: modified,modify
mold: mold
molecular: molecular
moment: moment,moments
money: money
monkey: monkey,monkeys
monstrous: monstrous
month: months
moon: moons
mop: mop
morning: morning
mother: mother
motion: motion,motioned,motioning,motions
motionless: motionless
motor: motor,motors
mountain: mountain
mountains: mountains
mouth: mouth
movement: movement
mud: mud
muddy: muddied
mull: mull
multitude: multitude,multitudes
murmur: murmur,murmured
museum: museum
music: music
muster: muster
mute: mute
mutter: muttered,muttering
mutually: mutually
mysterious: mysterious
nail: nailing
naked: naked
narrow: narrow
native: native,natives
natural: natural
naturally: naturally
nature: nature
navigation: navigation
nearby: nearby
neatly: neatly
neck: neck
needle: needle,needles
negative: negative
neglect: neglected
negligence: negligence
negotiator: negotiator
nerve: nerve,nerves
nervous: nervous
network: network
neutralize: neutralized
newly: newly
news: news
newsletter: newsletter
nibble: nibbling
nice: nice
nicely: nicely
nickname: nickname
night: night,nights
nightmare: nightmare
nimble: nimble
nitrogen: nitrogen
nod: nod,nodded,nodding
nodal: nodal
noise: noise,noises
nonproprietary: nonproprietary
nonsense: nonsense
normal: normal
north: north
northbound: northbound
nose: nose,noses
nosed: nosed
note: note,notes
notice: notice,noticed,noticing
notification: notification
notify: notifies,notify
nuclear: nuclear
numb: numb
numerous: numerous
nurse: nurses
nursing: nursing
nutrient: nutrient
object: object
objection: objections
oblige: obliging
obligingly: obligingly
observation: observation
observe: observe,observed,observing
obsolete: obsolete
obstacle: obstacle
obstructive: obstructive
obvious: obvious
occasion: occasion,occasions
occasional: occasional
occasionally: occasionally
occupy: occupied
occur: occur,occurred
ocean: oceans
odd: odd
oddness: oddness
odds: odds
offer: offer,offered,offers
office: office
official: official,officials
officially: officially
officiate: officiate
ominous: ominous
ominously: ominously
online: online
onslaught: onslaught
operate: operating
operating: operating
operation: operation,operations
operative: operative
opinion: opinion,opinions
opportunity: opportunities,opportunity
oppose: opposing
oration: oration
orbit: orbit,orbits
ordeal: ordeal
orderly: orderlies,orderly
ordinary: ordinary
organ: organ,organs
organism: organism,organisms
organization: organization
organize: organize,organized,organizing
organized: organized
origin: origin
original: original
originally: originally
originator: originator,originators
ounce: ounce
outbreak: outbreak,outbreaks
outburst: outburst
outdated: outdated
outer: outer
outfit: outfitted
outgoing: outgoing
outline: outline
outpost: outpost,outposts
outstretched: outstretched
outstrip: outstripped,outstripping
overhead: overhead
overload: overload
overlook: overlook
override: overrides
overwhelming: overwhelming
owe: owed
owlishly: owlishly
owner: owner,owners
oxygen: oxygen
oxygenation: oxygenation
pace: paced
pack: pack,packs
pad: pad
paging: paging
pain: pain,pains
painfully: painfully
painless: painless
painstaking: painstaking
pair: pair
pal: pal
pale: pale
palm: palm,palms
panel: panel,paneled
pang: pang,pangs
panic: panic
panorama: panorama
pant: panted
pants: pants
paper: paper,papers
paperwork: paperwork
paragraph: paragraph,paragraphs
paralyze: paralyze,paralyzing
parasite: parasite,parasites
parasitic: parasitic
paroxysm: paroxysms
partner: partner,partners
partnership: partnership
party: parties,party
pass: pass,passed,passing
passage: passage
passenger: passenger,passengers
passing: passing
pastry: pastries
pat: pat
patchwork: patchwork
path: paths
pathologist: pathologist,pathologists
pathology: pathology
patience: patience
patient: patient,patients
patiently: patiently
patrol: patrol,patrolling
pattern: pattern
pause: pause,paused,pausing
pay: paid,pay,paying
payment: payment,payments
peace: peace
peaceful: peaceful
peculiar: peculiar
peculiarity: peculiarities
peddler: peddlers
peddlers: peddlers
peel: peeled
peer: peered,peering
penetrate: penetrated
perch: perch,perched
perfect: perfect
perfectly: perfectly
perform: perform,performed,performing
performance: performance,performances
perfunctory: perfunctory
period: period,periods
periodic: periodic
periphery: periphery
peritoneum: peritoneum
perk: perk
permanent: permanent
permission: permission
permit: permit,permitted
perplexity: perplexity
persistently: persistently
person: people,person
personal: personal
personally: personally
perspiration: perspiration
pestilence: pestilence
pet: pet,pets
petty: petty
pharmacology: pharmacology
pharmacy: pharmacies
philadelphia: philadelphia
photo: photo
phrase: phrase
physical: physical
physically: physically
physician: physician,physicians
physicians: physicians
physiological: physiological
physiology: physiology
pick: pick,picked,picking
picture: picture
pie: pie
piece: piece,pieces,piecing
pig: pig,pigs
pile: pile,piled,piles
pill: pill
pilot: pilot,piloting
pinch: pinch,pinched
pink: pink
pinpoint: pinpoint
piracy: piracy
pit: pit
pitch: pitch
plague: plague,plagues
plain: plain
plan: plan,planned,planning,plans
plane: plane
planet: planet,planets
planetary: planetary
planning: planning
plate: plate,plates
platform: platform
platinum: platinum
plausible: plausible
play: play,played
plea: plea
pleasant: pleasant
pleased: pleased
pleasure: pleasure
plenty: plenty
pleomorph: pleomorph
plexus: plexus
plight: plight
plop: plopping
plow: plows
plug: plugged
plumbing: plumbing
plume: plumes
ply: plied
pneumatic: pneumatic
pneumonia: pneumonia
pocket: pocket
poison: poison,poisoned
poisonous: poisonous
poke: poked
policy: policy
polished: polished
politics: politics
pond: pond
ponder: ponder
ponderously: ponderously
poor: poor
pop: popped,popping,pops
popular: popular
populate: populated
population: population,populations
porcelain: porcelain
pore: pored,poring
port: port
portion: portion
portly: portly
pose: posed
position: position,positions
possess: possessed
possession: possession
possibility: possibility
post: post,posted
postpone: postponed
pot: pot
pound: pounds
pour: poured
powdery: powdery
power: power,powers
powerful: powerful
practically: practically
practice: practice
pray: praying
precaution: precautions
preceptor: preceptors
precious: precious
precisely: precisely
prefer: preferred
preliminary: preliminary
preparation: preparation,preparations
prepare: prepare,prepared,preparing
prescribe: prescribed
presence: presence
presently: presently
preserve: preserve
preside: presiding
press: press,pressed,pressing
pressed: pressed
pressure: pressure
pretend: pretending,pretends
pretense: pretense
pretty: pretty
prevail: prevail,prevailed
prevent: prevent
preventative: preventative
previous: previous
price: price,prices
pride: pride
primeval: primeval
primitive: primitive
principal: principal
principle: principle,principles
print: print,printed
printing: printing
priority: priority
private: private
probational: probational
probationary: probationary
probationer: probationer,probationers
probe: probed
procedure: procedure,procedures
proceed: proceed,proceeded
proceedings: proceedings
process: process,processes
processing: processing
procyon: procyon
produce: produce,produced
product: products
production: production
profession: profession
professor: professor,professors
profit: profit,profits
profound: profound
program: program
programmer: programmers
progress: progress,progressed
progressive: progressive
progressively: progressively
prohibition: prohibition
project: project
prolong: prolonged
prominently: prominently
promise: promise,promised,promises
promising: promising
promote: promoting
promotion: promotion
pronounce: pronounce
proof: proof
proofread: proofread
proofreading: proofreading
proper: proper
properly: properly
property: properties,property
prophylactic: prophylactic
proportion: proportions
propose: propose,proposes
proprietary: proprietary
proprietorship: proprietorship
prosthetic: prosthetic
protect: protect
protection: protection
protective: protective
protein: protein
proteins: proteins
protest: protest,protested
protoplasm: protoplasm
proudly: proudly
prove: prove,proved,proven,proving
proverb: proverb
provide: provide,providing
provision: provision,provisions
pseudopod: pseudopod
psychological: psychological
public: public
publication: publication
publish: published
puget: puget
pull: pull,pulled
pump: pumps
pumping: pumping
punch: punched,punching
punitive: punitive
punk: punk
puppy: puppies
purchase: purchase
pure: pure
purely: purely
purify: purified
purpose: purpose
push: push,pushed
puzzle: puzzled
puzzled: puzzled
qualification: qualification,qualifications
qualified: qualified
qualifying: qualifying
quantity: quantity
quarantine: quarantine
quarter: quarters
quarters: quarters
quench: quench
question: question,questioning,questions
questioning: questioning
quick: quick
quicken: quickened
quiet: quiet,quieted
quietly: quietly
quit: quit
quiver: quiver,quivered,quivering
race: race,raced,races
racial: racial
rack: rack
radiation: radiation
radio: radio,radioed,radios
radioactive: radioactive
radiological: radiological
radiologist: radiologist
radiologists: radiologists
radiology: radiology
rage: rage,rages,raging
ragged: ragged
rail: rail
raise: raise,raised
rally: rally
ram: ram
ramp: ramp
range: range,ranges
rank: rank,ranking,ranks
rapid: rapid
rapidly: rapidly
rapture: raptures
rare: rare
rarity: rarities
rate: rate
ratification: ratification
ratify: ratified
rating: rating
rational: rational
ravages: ravages
raw: raw
reach: reach,reached,reaches,reaching
react: reacted,reacting
reaction: reaction,reactions
reactor: reactors
read: read,reading
readable: readable
reader: reader
ready: ready
reagent: reagents
real: real
realization: realization
realize: realize,realized
reappear: reappeared
rear: rear
reason: reason,reasons
reasonable: reasonable
reassurance: reassurance
reassure: reassuring
rebuild: rebuild,rebuilt
recall: recall
receipt: receipt
receive: receive,received,receiving
receiver: receiver
reception: reception
receptive: receptive
recheck: rechecked,rechecking
recognition: recognition
recognize: recognize,recognized,recognizing
reconversion: reconversion
reconvert: reconvert,reconverted
record: record,recorded,records
recorder: recorder
records: records
recount: recounted
recover: recover,recovered,recovering
recovery: recovery
red: red
redistribute: redistribute,redistributing
redistributing: redistributing
redistribution: redistribution
reduce: reduced
rees: rees
refer: refer
reference: reference,references
refile: refiling
reflection: reflection
refund: refund
refusal: refusal
refuse: refused,refusing
regard: regarded
regenerate: regenerate,regenerated
regeneration: regeneration
regenerative: regenerative
regiment: regimenting
region: regions
register: registered
regulate: regulating
relate: relate
relation: relations
relationship: relationship
relaxing: relaxing
relay: relay
release: release,released
relief: relief
relieve: relieve,relieved,relieving
relieved: relieved
reluctant: reluctant
reluctantly: reluctantly
rely: relying
remain: remain,remained,remaining
remarkable: remarkable
remarkably: remarkably
remedy: remedies
remember: remember,remembered
remote: remote,remotest
remove: remove,removed
renal: renal
rename: renamed
render: render
renew: renewed
rent: rents
repair: repair,repairing
repave: repaved
repeat: repeat,repeated
repetition: repetitions
replace: replace,replaced,replacing
replacement: replacement
reply: replied,reply
report: report,reported,reports
represent: represented,representing,represents
representation: representations
representative: representative,representatives
reprimand: reprimand
reproach: reproach
reproduce: reproduce
reproduction: reproductions
reputation: reputation
request: request,requested,requesting
require: require,required
required: required
requirement: requirements
rescuer: rescuers
resemblance: resemblance
resemble: resembling
resent: resented
resentful: resentful
resentment: resentment
reservation: reservation,reservations
resident: resident
residential: residential
resign: resigned
resistant: resistant
resolve: resolved
resort: resort
resounding: resounding
resource: resources
respect: respect
respectful: respectful
respiration: respiration,respirations
respiratory: respiratory
resplendent: resplendent
respond: responding
response: response,responses
responsibility: responsibilities,responsibility
responsible: responsible
rest: rest,rested,resting
restlessly: restlessly
restriction: restrictions
result: result
retain: retained
retch: retching
reticence: reticence
retinue: retinue,retinues
retire: retire,retired,retiring
retrace: retraced
retract: retract
retraction: retraction
retreat: retreat
return: return,returned,returning,returns
reveal: reveal,revealed,revealing
revenue: revenue
reverse: reverse
review: review,reviewed,reviewing
ribbon: ribbons
rich: richest
rid: rid
ride: ridden,riding,rode
ridiculous: ridiculous
ridiculously: ridiculously
rig: rig,rigged
rigid: rigid
rigidly: rigidly
rim: rim
rimmed: rimmed
rip: ripped
ripple: ripples
rise: rise,risen,rising,rose
risk: risk
road: roads
roam: roamed
roar: roared
robe: robe
rocket: rocket
roll: roll
rope: roped
rotten: rotten
rounds: rounds
routine: routine
rove: roved
royal: royal
royalty: royalties,royalty
rub: rub,rubbed,rubbing
ruddy: ruddy
ruefully: ruefully
ruin: ruined
rule: rule,ruled,rules
rumble: rumbled
rush: rush
rustle: rustled
rusty: rusty
rutted: rutted
sadly: sadly
safe: safe,safer
safely: safely
sag: sagging
sake: sake
salary: salaries
saline: saline
salt: salt
sample: sampling
satellite: satellites
satisfied: satisfied
satisfy: satisfied
save: save,saved
scale: scale
scan: scan,scanning
scanner: scanner
scarce: scarcer
scared: scared
scarf: scarf
scarlet: scarlet
scatter: scattered,scattering
scavengers: scavengers
schedule: schedule
school: school,schools
science: science,sciences
scientific: scientific
scientist: scientists
scooter: scooter
scorn: scorn
scornful: scornful
scornfully: scornfully
scour: scouring
scowl: scowled,scowling
scramble: scrambled
scrap: scraps
scrape: scraped,scraping
scratch: scratch,scratched
scream: screaming
screen: screen,screened
screening: screening
scribble: scribbled
scrub: scrub,scrubbed
scrutiny: scrutiny
scurry: scurried
scuttle: scuttle
sea: sea
seal: seal,sealed
search: search,searched,searching
season: seasons
seat: seat,seated,seats
seattle: seattle
secret: secret
secretary: secretary
sector: sector,sectors
secure: secure,secured
securely: securely
security: security
sedentary: sedentary
seek: seek,seeking,sought
segment: segment,segments
seldom: seldom
select: selected
selection: selection
selfishness: selfishness
sell: sell,selling
semicircular: semicircular
send: send,sending
sensation: sensations
sense: sense,sensed
sentence: sentence
separate: separated,separating
sequence: sequence
serial: serial
series: series
serum: serum
serve: serve,served,serving
service: service,services
services: services
session: session,sessions
set: set,sets,setting
settle: settle,settled,settles,settling
setup: setup
seventh: seventh
severe: severe
severely: severely
sew: sew
shack: shack
shadow: shadow
shaggy: shaggy
shake: shake,shaken,shaking,shook
shakedown: shakedown
shapeless: shapeless
share: share,shared,shares,sharing
sharp: sharp
sharply: sharply
shatter: shattered
sheaf: sheaf
sheet: sheet,sheets
shelf: shelf
shelter: shelter
shield: shield
shift: shift,shifted,shifting
ship: ship,ships
shipboard: shipboard
shipment: shipment
ships: ships
shirt: shirt
shiver: shiver,shivered,shivering
shock: shock,shocked
shoe: shoe
shoot: shot
shop: shop,shops
short: short
shot: shot,shots
shoulder: shoulder,shouldered,shouldering,shoulders
shout: shout,shouted,shouting
showdown: showdown
shower: shower
shriek: shriek
shrill: shrill
shrink: shrank
shrug: shrugged
shuffle: shuffled
shuffling: shuffling
shut: shut
shuttle: shuttle
shy: shy
shyness: shyness
sick: sick
sickbay: sickbay
sickening: sickening
sicker: sicker
sickly: sickly
sickness: sickness
sift: sifted,sifting
sigh: sigh,sighed
sight: sight,sighted
sighting: sighting
sign: sign,signed,signing,signs
signal: signal,signaled,signaling,signals
signature: signature,signatures
significance: significance
signify: signified
silence: silence
silent: silent
silently: silently
silly: silly
silver: silver
silvery: silvery
similarity: similarities
simple: simple
simply: simply
single: single
singular: singular
sink: sank,sinking,sunk
sir: sir
siren: siren
sit: sat,sit,sitting
situation: situation,situations
sixteenth: sixteenth
sixth: sixth
size: size
sketchy: sketchy
skill: skill,skills
skilled: skilled
skillful: skillful
skim: skimming
skin: skin
skull: skull
sky: sky
slack: slack
slam: slammed
slamming: slamming
slap: slapped
slaughter: slaughtered,slaughtering
slavery: slavery
sledge: sledge
sleek: sleek
sleep: sleep,sleeping,slept
sleepily: sleepily
sleepless: sleepless
slender: slender
slide: slides
slight: slight,slightest,slights
slip: slip,slipped,slips
slot: slot,slots
slow: slow,slowed
slowly: slowly
slump: slumped,slumping
sly: sly
smallpox: smallpox
smart: smart
smell: smell
smile: smile,smiled,smiles,smiling
smoothly: smoothly
snap: snap,snapped
snarl: snarled
snatch: snatched
sneer: sneer,sneered
snore: snoring
snort: snorted
snow: snow
snowball: snowball
snuggle: snuggle,snuggled
snuggling: snuggling
soberly: soberly
social: social
soft: soft
soften: soften
softly: softly
soil: soil
sol: sol
solar: solar
sole: sole
solemnity: solemnity
solicit: solicit
solicitation: solicitation
solicitously: solicitously
solid: solid
solution: solution,solutions
solve: solve,solved
son: son
sophisticated: sophisticated
sort: sort,sorts
sound: sound,sounded,sounds
soundly: soundly
soup: soup
sour: sour
source: source
sourly: sourly
south: south
space: space
spatula: spatula
speak: speak,speaking,speaks,spoke,spoken
speaker: speaker
spear: speared
special: special
specialist: specialists
specialize: specialized
specialized: specialized
specially: specially
specialty: specialties,specialty
species: species
specific: specific
specification: specifications
specimen: specimen,specimens
speed: speed
spend: spend,spent
spending: spending
spherical: spherical
spin: spinning
spindly: spindly
spite: spite
splatter: splatter
splendor: splendors
split: split,splits,splitting
spokesman: spokesman
sponge: sponges
spool: spools
sporadically: sporadically
spore: spores
sport: sports
spot: spot,spots,spotted
sprawl: sprawling
spray: sprays
spread: spread,spreading
spring: sprang,spring
sprout: sprouted
squad: squad
square: square
squarely: squarely
squeeze: squeezing
squirm: squirmed
squirt: squirted,squirts
stab: stabbing
stabilize: stabilized
staff: staff
stage: stage,stages
stagger: staggered
staggering: staggering
stake: stake
stalk: stalked,stalking
stall: stalling
stammer: stammered
stand: stand,standing,stood
standard: standard
staple: staple
star: star,stars
stare: stare,stared,stares,staring
start: start,started,starting,starts
startle: startled
statement: statement,statements
static: static
station: station
status: status
stay: stay,stayed
steadily: steadily
steady: steadied
steal: stole
steam: steam,steaming
steel: steel
stem: stem
step: step,stepped,stepping,steps
sterile: sterile
sterilize: sterilized
stick: stick,stuck
stillness: stillness
stimulator: stimulator
stir: stir,stirred
stock: stocked
stockade: stockades
stockroom: stockroom
stolidly: stolidly
stomach: stomach
stone: stone,stones
stooge: stooge
stool: stool,stools
storage: storage
store: stored,stores
storeroom: storeroom,storerooms
storm: storm,stormed
story: stories,story
straight: straight
straighten: straighten
strain: strain,straining
strange: strange
stranger: stranger,strangers
strap: strapped
straw: straw
street: street,streets
strength: strength
stretch: stretching
stretcher: stretcher,stretchers
stricken: stricken
strict: strict
stride: strode
strike: strike,strikes,striking,struck
strip: strip,stripped
stroke: stroke,stroked
strong: strong,stronger
structure: structure
struggle: struggle,struggled,struggling
stubborn: stubborn
stubbornly: stubbornly
student: student,students
study: studied,studies,study,studying
stuff: stuff
stumble: stumble,stumbled,stumbling
stupid: stupid
style: styled
subdued: subdued
subject: subject,subjected
submicroscopic: submicroscopic
subscribe: subscribe
substance: substance
substitute: substituted
subtle: subtle
subway: subway,subways
succeed: succeed,succeeded,succeeding
success: success
successful: successful
successive: successive
succinct: succinct
succumb: succumbed
suck: sucked
suction: suction
sudden: sudden
suddenly: suddenly
suffer: suffered
sufficient: sufficient
suffuse: suffused
sugar: sugar
suggestion: suggestion
suit: suit,suits
suite: suite
suited: suited
sulk: sulked
sullenly: sullenly
summer: summer
sun: sun
sunlight: sunlight
superior: superior
supervise: supervising
supplemental: supplemental
supply: supplies,supply
support: support,supporting
suppose: suppose,supposed
surely: surely
surface: surface
surge: surged
surgeon: surgeon,surgeons
surgeons: surgeons
surgery: surgeries,surgery
surgical: surgical
surpass: surpassing
surprise: surprise
surprised: surprised
surprising: surprising
surprisingly: surprisingly
surround: surrounded
surroundings: surroundings
survey: survey,surveys
survival: survival
survive: survive,survived,surviving
suspect: suspect,suspected
suspension: suspension
suspicion: suspicion,suspicions
suspicious: suspicious
suspiciously: suspiciously
sustain: sustaining
suture: suture,sutured
swallow: swallow,swallowed
swamp: swamp
swarm: swarming
sway: swaying
swear: swear
sweat: sweat
sweep: sweeping,swept
swiftly: swiftly
swiftness: swiftness
swim: swam,swim
swing: swing,swung
swinging: swinging
switch: switch,switches
swivel: swivel
syllable: syllables
symbiosis: symbiosis
symbiotic: symbiotic
symbol: symbol,symbols
symbolize: symbolized
sympathize: sympathize
symptom: symptoms
synonymous: synonymous
synthesize: synthesize,synthesized
syringe: syringes
table: table
tacit: tacit
tag: tags
tail: tail
tailor: tailor,tailored
talent: talent,talents
talk: talk,talked,talking
tall: tall
tank: tank,tanks
tanner: tanner
tape: tape,tapes
tapered: tapered
task: task
tax: tax,taxes
teach: taught,teach
teaching: teaching
team: team,teams
tear: tear,tore,torn
technicality: technicality
technician: technician,technicians
technique: technique,techniques
technology: technology
teddy: teddy
teem: teeming
telepathic: telepathic
telepathy: telepathy
telephone: telephone
telescope: telescope
telescopic: telescopic
teletype: teletype,teletyped
temper: temper
tempera: tempera
temperature: temperature,temperatures
tempered: tempered
temple: temples
temporary: temporary
tempt: tempting
temptation: temptation
tension: tension
tentatively: tentatively
tenuous: tenuous
term: term,terms
terminal: terminal
terran: terran
terrene: terrene
terrible: terrible
terrify: terrified
territory: territory
terror: terror
terse: terse
testimony: testimony
testing: testing
textbook: textbooks
thankful: thankful
thaw: thaw
theoretically: theoretically
theory: theory
therapeutic: therapeutic
therapy: therapy
thinking: thinking
thinning: thinning
thirst: thirst
thirsty: thirsty
thoughtfully: thoughtfully
thread: thread
threat: threat,threats
threaten: threaten,threatened
throat: throat,throats
throe: throes
throw: threw,throw,throwing,thrown
thrust: thrust
thud: thudding
thumb: thumb
thundercloud: thundercloud
tick: ticked
tid: tid
tide: tide
tie: tie,tied
tiger: tiger
tight: tight
tightly: tightly
time: time,times
timorously: timorously
tinge: tinge
tiny: tiniest,tiny
tired: tired
tissue: tissue,tissues
title: title
todd: todd
tolerance: tolerance
tolerant: tolerant
tolerate: tolerate
tomorrow: tomorrow
tongue: tongue
tool: tool
tooth: teeth
toothed: toothed
topic: topic
torture: torture
toss: tossed,tossing
total: total
totally: totally
touch: touch,touched,touches
tough: tough,tougher
tour: tour
tower: tower,towered,towering
town: town,towns
toxic: toxic
trace: trace,traced
tracing: tracing
track: tracking,tracks
tract: tract,tracts
trade: trade
trademark: trademark
trader: trader,traders
tradesman: tradesmen
trading: trading
tradition: tradition,traditions
traditionally: traditionally
trail: trailing
train: train,trained,trains
training: training
traitor: traitors
tramp: tramped
trample: trampled
transcribe: transcribe
transcriber: transcriber
transcript: transcript
transcription: transcription
transfer: transfer
transit: transit
translator: translator
transmitter: transmitter
transplant: transplant,transplants
transplantation: transplantation
transport: transport
trap: trap,trapped
travel: travel,traveled,traveling,travels
traveler: travelers
travels: travels
treasure: treasure,treasures
treatment: treatment
tremble: tremble,trembled,trembling
trial: trial
tricky: tricky
trifle: trifles
trimming: trimming
trip: trip,tripped,tripping,trips
triumph: triumph
triumphantly: triumphantly
trivial: trivial
tropical: tropical
trouble: trouble,troubles
trousers: trousers
trove: trove
truce: truce
truck: truck
true: true
trump: trumped
trust: trust
trustingly: trustingly
truth: truth
tube: tube,tubes
tubing: tubing
tubule: tubules
tuck: tuck,tucked
tuesday: tuesday
tumble: tumbling
tumor: tumor
twin: twin
twist: twisted
type: type,types
typer: typer
typical: typical
typography: typography
ugly: ugly
ultimate: ultimate
ultimately: ultimately
unable: unable
unaccompanied: unaccompanied
unaffected: unaffected
unafflicted: unafflicted
unavailable: unavailable
unavoidable: unavoidable
unbearably: unbearably
unbecoming: unbecoming
unbelievable: unbelievable
unbelieving: unbelieving
uncanny: uncanny
unclenched: unclenched
uncomfortably: uncomfortably
unconcerned: unconcerned
uncontacted: uncontacted
uncover: uncover
undercurrent: undercurrent
undergo: undergo
underlie: underlies
underling: underlings
understand: understand,understands,understood
understanding: understanding
undertake: undertaken,undertaking
uneasiness: uneasiness
uneasy: uneasy
unenforceability: unenforceability
unexpected: unexpected
unfair: unfair
unfamiliar: unfamiliar
unforgivable: unforgivable
unfortunate: unfortunate
unhappy: unhappy
unharmed: unharmed
unidentified: unidentified
uniform: uniform
unimaginably: unimaginably
uninfected: uninfected
uninhabited: uninhabited
unintelligent: unintelligent
uninvestigated: uninvestigated
unique: unique
unit: unit,units
united: united
universal: universal
universally: universally
universe: universe
unleash: unleashed
unlink: unlink
unload: unloading
unmistakable: unmistakable
unmistakably: unmistakably
unobtrusively: unobtrusively
unpaid: unpaid
unparalleled: unparalleled
unpleasant: unpleasant
unpleasantly: unpleasantly
unpronounceable: unpronounceable
unquestionably: unquestionably
unrelated: unrelated
unsolicited: unsolicited
unsuspected: unsuspected
unsympathetically: unsympathetically
unthinkably: unthinkably
untold: untold
untouched: untouched
untoward: untoward
untrained: untrained
untranslatable: untranslatable
unusually: unusually
unwarranted: unwarranted
unwelcome: unwelcome
unwitting: unwitting
unworthy: unworthy
update: updated
uphold: uphold
upright: upright
uproar: uproar
upset: upset
urge: urged
urgent: urgent
ursine: ursine
useless: useless
user: user
usher: ushered
usual: usual
ut: ut
utmost: utmost
utter: utter
vacancy: vacancy
vaguely: vaguely
vain: vain
valid: valid
valley: valleys
valuable: valuable
van: van
vanilla: vanilla
vanish: vanished
vapor: vapor
variety: varieties,variety
vascular: vascular
vast: vast
vegetarian: vegetarian
vegetation: vegetation
vehicle: vehicle,vehicles
velvet: velvet
venous: venous
vent: vent
ventilation: ventilation
verge: verge
version: version
vessel: vessel,vessels
vestige: vestige
veto: veto
vibrate: vibrating
vibration: vibration
vicinity: vicinity
viciously: viciously
victim: victim
view: view,viewed,viewing
viewer: viewer
vigilantly: vigilantly
vigorously: vigorously
vii: vii
viii: viii
village: village,villages
vindicate: vindicated
violate: violates
violent: violent
violently: violently
virological: virological
virologist: virologists
virtual: virtual
virtually: virtually
virulence: virulence
virus: virus,viruses
visible: visible
visibly: visibly
vision: vision
visit: visit,visited,visiting,visits
visitor: visitor
vital: vital
vividly: vividly
vocal: vocal
voice: voice,voices
void: void
voluminous: voluminous
volunteer: volunteer,volunteers
voraciously: voraciously
vote: vote,votes
wade: waded,wading
wail: wailed
waist: waist
wait: wait,waited,waiting
waiting: waiting
wake: woke
walk: walk,walked,walking,walks
wall: wall,walls
wander: wandered,wandering
war: war
ward: ward,wards
wares: wares
warm: warm,warming
warn: warn,warned,warning
warning: warning
warrant: warrant
warranty: warranties,warranty
wash: wash,washed,washing
waste: waste,wasting
watch: watch,watched,watches,watching
water: water
wave: wave,waved,waving
waver: wavered
weak: weak,weaker
weakly: weakly
weakness: weakness
wealth: wealth
weapon: weapon
wear: wear,wearing,worn
wearily: wearily
weary: weary
weather: weather
weave: woven
weed: weed
week: week,weeks
weekly: weekly
weigh: weighing
weight: weight
west: west
whatsoever: whatsoever
wheeze: wheeze,wheezed,wheezing
whip: whipped
whir: whirring
whisper: whispered,whispering
whistle: whistle,whistles,whistling
white: white
whoop: whoop
wide: wide,widest
widen: widened,widening
widespread: widespread
wilderness: wilderness
wilfully: wilfully
willingly: willingly
win: win,wins
wind: wind,winded,wound
wink: wink
winter: winter
wipe: wipe,wiped
wise: wise
wispy: wispy
wistful: wistful
wistfully: wistfully
wit: wit
withdraw: withdrew
woman: women
wood: woods
word: word
workable: workable
worker: workers
workman: workmen
worlds: worlds
worn: worn
worried: worried
worry: worried,worry
worth: worth
worthy: worthy
wound: wound
wrap: wrapped
wrench: wrenched
wriggle: wriggled,wriggling
write: writing,written,wrote
writing: writing
wrong: wrong
wryly: wryly
xiv: xiv
xix: xix
yellow: yellow
yelp: yelp
yield: yield,yielded
york: york
youth: youth
zone: zones
zoom: zoomed
