abate: abate,abated
abbot: abbot
abet: abet
abhor: abhor,abhorred,abhorring
abhorrence: abhorrence
abide: abide
ability: abilities
abject: abject
ablest: ablest
aboard: aboard
abode: abode
abolish: abolishing
abominable: abominable
abominate: abominate
aborigine: aborigines
abortive: abortive
abound: abound,abounded,abounding
abraham: abraham
abreast: abreast
absence: absence,absences
absent: absent
absolute: absolute
absolutely: absolutely
absorb: absorbed
abstinence: abstinence
abstract: abstract
abstracted: abstracted
abstraction: abstractions
absurd: absurd
absurdity: absurdities,absurdity
abundance: abundance
abuse: abused,abuses,abusing
academy: academy
accent: accent
accept: accept,accepted,accepting
access: access,accessed
accessible: accessible
accident: accident,accidents
accidental: accidental
accidentally: accidentally
accommodate: accommodated
accompany: accompanied,accompany
accomplished: accomplished
account: account,accounts
accusation: accusations
accuse: accuse,accused,accusing
accuser: accuser,accusers
accustom: accustom,accustomed
ache: ache
achievement: achievements
acknowledge: acknowledge,acknowledged
acknowledgement: acknowledgements
acknowledgment: acknowledgment,acknowledgments
acorn: acorns
acoustic: acoustics
acquaint: acquainted
acquaintance: acquaintance
acquire: acquire,acquired,acquires,acquiring
acquirement: acquirements
acquit: acquitted
acre: acre,acres
acrostic: acrostics
action: action,actions
actium: actium
active: active
activity: activity
actual: actual
acute: acute
acuteness: acuteness
adamant: adamant
adamantine: adamantine
adapt: adapted
add: add,adding
addition: addition,additions
additional: additional
address: address,addressed,addresses
adhere: adhere
adjoin: adjoining
adjoining: adjoining
adjourn: adjourn
adjust: adjust,adjusting
administer: administer
administration: administration
admirable: admirable
admirably: admirably
admiral: admiral
admiration: admiration
admire: admire,admired,admiring
admirer: admirer
admit: admit,admitted
admittance: admittance
ado: ado
adore: adored
adorn: adorn,adorned
adrift: adrift
advance: advance,advanced,advancing
advanced: advanced
advancement: advancement,advancements
advancer: advancers
advantage: advantage,advantages
advantageous: advantageous
adventitious: adventitious
adventure: adventure,adventures
adventurer: adventurer
adversary: adversary
advice: advice
advisable: advisable
advise: advise,advised,advising
advocate: advocate,advocates
affair: affair,affairs
affect: affect
affectation: affectation
affection: affection
affirm: affirm,affirmed
affirmative: affirmative
afflict: afflict,afflicted
afford: afford,afforded,affords
aforesaid: aforesaid
afraid: afraid
aft: aft
afternoon: afternoon
afterward: afterward
age: age,ages
aged: aged
agent: agent
aggravate: aggravate,aggravated
aggravation: aggravation
agility: agility
agitate: agitated
agitation: agitation
agony: agonies
agree: agree,agreed
agreeable: agreeable
agreeably: agreeably
agreement: agreement
agriculture: agriculture
ague: ague
aid: aid,aiding
ail: ail
aim: aim,aimed
air: air,aired
airy: airy
alacrity: alacrity
alarm: alarmed
alban: alban
alcoran: alcoran
ale: ale
alexander: alexander
alight: alight,alighted
alighting: alighting
alive: alive
allege: allege,alleged,alleging
alley: alleys
alliance: alliance
allot: allotted
allowance: allowance,allowances
allure: allured
allusion: allusion
ally: ally
aloft: aloft
aloud: aloud
alphabet: alphabet
alphabetical: alphabetical
alps: alps
alter: alter,altered
alteration: alteration
altered: altered
alternate: alternate
altitude: altitude
altogether: altogether
amazed: amazed
amazement: amazement
ambassador: ambassador,ambassadors
ambition: ambition
amboyna: amboyna
amendment: amendment
america: america
american: americans
amiable: amiable
amiss: amiss
amity: amity
ample: ample
amply: amply
amsterdam: amsterdam
amuse: amuse
amusement: amusement,amusements
anagram: anagrams
anagrammatic: anagrammatic
analogy: analogy
analyse: analysed
ancestor: ancestor,ancestors
anchor: anchor,anchors
ancient: ancient,ancients
anecdote: anecdotes
anger: anger,angered
angle: angle,angles
angling: angling
angry: angry
animal: animal,animals
animosity: animosities
anne: anne
annex: annexed
annihilate: annihilated
annoying: annoying
annual: annual
answer: answer,answered,answering,answers
answerable: answerable
answerers: answerers
ant: ant,ants
antechamber: antechamber
antelope: antelope
anterior: anterior
antic: antic
anticipate: anticipate
antipathy: antipathy
antiquity: antiquity
antony: antony
anus: anus
apartment: apartment,apartments
apology: apologies
apothecary: apothecaries
apparent: apparent
appeal: appeal,appealed
appearance: appearance,appearances
appellation: appellation
appetite: appetite,appetites
applaud: applaud
apple: apple,apples
applicable: applicable
application: application,applications
apply: applied,applies,apply,applying
appoint: appoint,appointed
appointment: appointment
apprehend: apprehend,apprehended
apprehension: apprehension,apprehensions
apprehensive: apprehensive
apprentice: apprentice,apprentices
apprise: apprised
approach: approach,approached,approaches,approaching
approbation: approbation
approve: approve,approved
april: april
apron: apron
apt: apt
aqueous: aqueous
arabian: arabians
arbela: arbela
arbitress: arbitress
arch: arch,arched
arched: arched
architect: architect
architecture: architecture
archive: archive
argue: argue,argued
argument: argument,arguments
aristotle: aristotle
arithmetic: arithmetic
arm: arm,armed,arms
armed: armed
army: armies,army
array: array
arrival: arrival
arrive: arrive,arrived,arrives
arrow: arrow,arrows
art: art,arts
artery: arteries
artful: artful
artfully: artfully
article: article,articles
articulate: articulate
artificial: artificial
artificially: artificially
artist: artist,artists
ascend: ascended,ascending
ascii: ascii
ascribe: ascribe,ascribed
ash: ashes
ashamed: ashamed
ashore: ashore
asiatic: asiatic
aslant: aslant
asleep: asleep
aspect: aspect
aspire: aspiring
ass: ass,asses
assembly: assemblies,assembly
assert: assert,asserted
asserter: asserters
assertion: assertion
assessment: assessments
assign: assign,assigned,assigning
assignment: assignments
assist: assist,assisted,assisting,assists
assistance: assistance
assistant: assistant
assume: assumed
assurance: assurance
assure: assured,assuring
astonish: astonished
astonished: astonished
astonishing: astonishing
astonishment: astonishment
astride: astride
astrolabe: astrolabes
astrology: astrology
astronomer: astronomer,astronomers
astronomical: astronomical
astronomy: astronomy
asunder: asunder
atheist: atheists
atlas: atlas
attach: attached
attachment: attachment
attack: attack,attacked,attacks
attain: attaining
attempt: attempt,attempted,attempting,attempts
attend: attend,attended,attending,attends
attendance: attendance
attendant: attendant,attendants
attention: attention
attest: attested
attorney: attorney,attorneys
attract: attracted,attracting
attraction: attraction
attractive: attractive
audience: audience,audiences
auditor: auditor
august: august
augustus: augustus
auspicious: auspicious
austere: austere
austrian: austrian
author: author,authors
authority: authorities,authority
autumn: autumn
avarice: avarice
avenue: avenues
averse: averse
aversion: aversion
avoid: avoid,avoided
avow: avow,avowed
avowed: avowed
awake: awake,awaked
awe: awe
awhile: awhile
awkward: awkward
awkwardness: awkwardness
awl: awl
axis: axes
axle: axle
babe: babe
baby: baby
backbiter: backbiters
bad: bad,worse,worst
badge: badges
bag: bag
baggage: baggage
bagpipe: bagpipes
bake: bake
balance: balance
ball: ball,balls
ballot: ballot
balnibarbi: balnibarbi
bamboo: bamboo
banbury: banbury
bandage: bandages
bang: banged,banging,bangs
banish: banish,banished
banishment: banishment,banishments
bank: bank
bar: bars
barbadoes: barbadoes
barbarian: barbarians
barbarity: barbarity
barbarous: barbarous
barber: barber
bare: bare
barefoot: barefoot
bargain: bargain
bark: bark,barks
barley: barley
barrel: barrel,barrels
barren: barren
barrow: barrows
base: based
bashfulness: bashfulness
basin: basin,basins
basket: baskets
bass: bass
bates: bates
bath: bathed
bathe: bathe
battalia: battalia
batter: batter,battering
battle: battle,battles
bawd: bawds
bay: bay
bayonet: bayonets
bead: bead
beak: beak
beam: beam
bear: bear,bearing,bore,born,borne
beard: beard,beards
bearer: bearers
bearing: bearing,bearings
beast: beast,beasts
beat: beat,beaten,beating
beautiful: beautiful
beautifully: beautifully
beauty: beauties,beauty
beckon: beckoning
bed: bed,beds
bedchamber: bedchamber
bedstead: bedstead
bee: bee,bees
beef: beef,beeves
befall: befalls
befit: befits
beg: beg,begged,begging
beget: begat,beget,begetting
beggar: beggar,beggars
beggarly: beggarly
beggary: beggary
behalf: behalf
behave: behave,behaved
behaviour: behaviour
beheld: beheld
behold: beheld,behold,beholding
beholder: beholders
belay: belayed
belief: belief
believer: believers
bell: bells
bellow: bellows
belly: belly
belong: belong,belonged,belonging,belongs
beloved: beloved
belt: belt
bemire: bemired
bemoan: bemoaned
bench: bench,benches
bend: bending,bent
beneath: beneath
benefactor: benefactor
benefit: benefit
benevolence: benevolence
bent: bent
berry: berries,berry
besiege: besieging
bespeak: bespeak
bestow: bestow,bestowed
betray: betray,betraying
betrayer: betrayers
betty: betty
betwixt: betwixt
bevel: bevel
bias: bias
bid: bade,bid,bidding
bigness: bigness
binary: binary
bind: bind,binding,bound
bird: bird,birds
birth: birth,births
biscuit: biscuit
bishop: bishops
bit: bit,bits
bite: bite,bites,biting
black: black
bladder: bladder,bladders
blade: blade,blades
blame: blame,blamed
blameless: blameless
blanket: blanket,blankets
blast: blast
blaze: blazing
bleed: bleeding
blessing: blessing
blind: blind,blinding
blindness: blindness
blister: blisters
blood: blood
bloody: bloody
blot: blotted
blow: blew,blow,blowing,blown
blue: blue
blunt: blunt
blurred: blurred
boar: boar
board: board,boarded,boards
boast: boast
boat: boat,boats
bodily: bodily
body: bodies,body
boil: boiled
bold: bold,boldest
boldly: boldly
boldness: boldness
bolus: bolus
bomb: bombs
bombardment: bombardments
bond: bonds
bone: bone,bones
book: book,books
border: border
bore: bore
bored: bored
borrow: borrow,borrowed
bosom: bosom,bosoms
boss: bosses
bottomless: bottomless
bounce: bounce,bouncing
bound: bound,bounded,bounds
bow: bow,bowed,bowing,bows
bowels: bowels
bowl: bowl
bowlful: bowlful
bowling: bowling,bowlings
box: box,boxes
boy: boy,boys
brace: braces
bracelet: bracelet,bracelets
brain: brain,brains
brained: brained
branch: branches
brandish: brandish
brandy: brandy
brass: brass
brave: brave
bravely: bravely
braying: braying
breach: breach,breaches
bread: bread
breadth: breadth
break: break,breaking,breaks,broke,broken
breakfast: breakfast
breaking: breaking
breast: breast,breasts
breath: breath
breech: breech
breeches: breeches
breed: bred,breed
breeding: breeding
brethren: brethren
brevity: brevity
bribe: bribe,bribing
bribery: bribery
bridge: bridge
bridle: bridle
bright: bright
brim: brim
bring: bring,bringing,brings,brought
bristle: bristles
bristol: bristol
britain: britain
britannia: britannia
british: british
broad: broad,broader
brobdingnag: brobdingnag
broken: broken
brood: brood
brook: brook,brooks
broom: broom
broth: broth
brother: brother
brotherhood: brotherhood
brow: brows
brown: brown
brownness: brownness
bruise: bruised,bruises
brush: brush
brutal: brutal
brutality: brutality
brute: brute,brutes
brutus: brutus
buccaneer: buccaneers
bucket: bucket,buckets
buckle: buckle,buckled
buff: buff
buffet: buffets
buffoon: buffoons
build: build,building,builds,built
building: building,buildings
bulk: bulk
bull: bull,bulls
bullet: bullets
bully: bullies
bulwark: bulwark
bundle: bundle,bundles
burden: burdening,burdens
burgundy: burgundy
burial: burials
burn: burning,burnt
burrow: burrows
burst: burst,bursting
burthen: burthen
burton: burton
bury: buried,bury
bush: bush
business: business
busy: busy
butcher: butcher,butchers
butler: butlers
butt: butt
butter: butter
buttock: buttocks
buying: buying
buzz: buzzing
buzzard: buzzard
cabal: cabal
cabin: cabin
cabinet: cabinet,cabinets
cable: cable,cables
cadence: cadence
cage: cages
cake: cake
calamity: calamity
calcine: calcine
calculate: calculate,calculated
calculation: calculation,calculations
california: california
calin: calin
calling: calling
calm: calm
cambridge: cambridge
camp: camp
canal: canal
canary: canary
cancer: cancer
candid: candid
candidate: candidates
candidly: candidly
candour: candour
cane: cane
canine: canine
cannon: cannons
canoe: canoe
cap: cap
capable: capable
capacity: capacities,capacity
cape: cape
caper: caper
capital: capital
caprice: caprice,caprices
captain: captain,captains
carabine: carabines
carcase: carcases
carcass: carcass
card: card
cardinal: cardinals
care: care
careful: careful
carefully: carefully
careless: careless
carelessness: carelessness
caress: caressed
cargo: cargo
carnivorous: carnivorous
carpenter: carpenter,carpenters
carriage: carriage,carriages
carrier: carrier,carriers
carrion: carrion
carry: carried,carry,carrying
cart: cart
carve: carved
cashier: cashiered
cast: cast
castrate: castrated,castrating
casually: casually
casualty: casualties,casualty
cat: cat,cats
catalogue: catalogue
cataract: cataract
catastrophe: catastrophe
catch: catch,catching,caught
cattle: cattle
caution: caution,cautioned
cavalier: cavalier
cave: cave,caves
cavity: cavity
cease: cease,ceased
ceiling: ceiling
celebrate: celebrate,celebrated,celebrating
celestial: celestial
cell: cell,cells
cellar: cellars
censure: censure,censured
censurer: censurers
cent: cent
centre: centre
century: century
cephalic: cephalic
ceremony: ceremonies,ceremony
chaff: chaff
chain: chain,chained,chains
chair: chair,chairs
chairman: chairmen
challenge: challenge,challenged,challenging
chamber: chamber
chamberlain: chamberlain
chambermaid: chambermaids
champion: champions
chance: chance,chanced
chancellor: chancellor
chancery: chancery
change: change,changed,changing
channel: channel
chap: chaps
chaplain: chaplains
chapter: chapter
character: character,characters
characteristic: characteristics
charge: charge,charged,charges,charging
chargeable: chargeable
chariot: chariot,chariots
charitable: charitable
charity: charities
charles: charles
chart: charts
chase: chased
chasm: chasm
chastity: chastity
chatter: chatter,chattering
cheap: cheap
cheat: cheat,cheating
check: check,checks
cheerful: cheerful
cheerfully: cheerfully
cheerfulness: cheerfulness
chest: chest
chestnut: chestnuts
chicken: chicken
chief: chief
chiefly: chiefly
child: child,children
childhood: childhood
chimera: chimeras
chimney: chimneys
chin: chin
chinese: chinese
chink: chinks
choice: choice,choicest
choke: choked
choose: choose,choosing,chose,chosen
chop: chop
christendom: christendom
christian: christian,christians
christianity: christianity
chronicle: chronicles
churchyard: churchyard
cicero: cicero
cider: cider
circle: circle,circles
circuit: circuit
circular: circular
circularly: circularly
circulate: circulate
circumference: circumference
circumlocution: circumlocutions
circumspection: circumspection
circumspectly: circumspectly
circumstance: circumstance,circumstances
circumstantial: circumstantial
cistern: cistern
cite: cited
citizen: citizen,citizens
city: cities,city
civil: civil
civilised: civilised
civility: civilities,civility
civilize: civilize,civilizing
civilized: civilized
civilly: civilly
claim: claim
clamber: clambered
clamour: clamour
clapping: clapping
claw: claws
clay: clay
clean: clean,cleaned,cleaning
cleanliness: cleanliness
cleanly: cleanly
clearness: clearness
cleft: clefts
clemency: clemency
clench: clenched
clergy: clergy
clerk: clerks
client: client
climate: climate
climb: climb,climbed,climbing
climbing: climbing
cloak: cloak
clock: clock
clog: clog
close: close,closed
closeness: closeness
closet: closet,closets
cloth: cloth
clothe: clad
clothes: clothes
clothing: clothing
cloud: cloud,clouds
club: club
clumsy: clumsy
clutch: clutches
clyster: clyster
coach: coach,coaches
coachman: coachman,coachmen
coal: coal
coarse: coarse,coarser,coarsest
coarseness: coarseness
coast: coast,coasting,coasts
coat: coat,coats
cobwebs: cobwebs
cock: cock
code: codes
codshead: codshead
coffer: coffers
cogitation: cogitation
coin: coin,coined,coining,coins
coincide: coincide
cold: cold,colder
coldness: coldness
colic: colic
collar: collar
collect: collected,collecting
collection: collection,collections
college: college,colleges
colonel: colonel
colony: colonies,colony
colossus: colossus
colour: colour,coloured,colours
coloured: coloured
colt: colt,colts
column: columns
comb: comb,combs
combing: combings
combustible: combustible
comeliness: comeliness
comely: comelier,comely
comet: comet,comets
comfort: comfort,comforted
comfortable: comfortable
command: command,commanded,commanding,commands
commander: commander,commanders
commanding: commanding
commence: commences,commencing
commend: commended
commendable: commendable
comment: comment
commentator: commentators
commerce: commerce
commercial: commercial
commission: commission
commit: commit,committed,committing
committee: committee,committees
commodious: commodious
common: common
commoner: commoners
commonly: commonly
commons: commons
commotion: commotions
communicate: communicate,communicated,communicating
communicativeness: communicativeness
companion: companion,companions
company: company
compare: compare,compared,comparing
comparison: comparison,comparisons
compass: compass,compasses
compel: compelled
compelling: compelling
competent: competent
compilation: compilation
complain: complain,complained,complaining
complaint: complaint,complaints
complaisant: complaisant
complete: complete,completed
complexion: complexion
compliance: compliance
complicated: complicated
complier: compliers
compliment: compliment,compliments
comply: complied,comply,complying
compose: compose,composed
composition: composition
composure: composure
compound: compounding
comprehend: comprehend,comprehended
comprehension: comprehension
compress: compressed
compromise: compromised
computation: computation
compute: compute,computed,computing
computing: computing
comrade: comrade,comrades
concave: concave
conceal: conceal,concealed,concealing
conceit: conceit
conceited: conceited
conceive: conceive,conceived,conceiving
concept: concept
conception: conception,conceptions
concern: concern,concerned,concerns
concerned: concerned
concert: concerts
concerted: concerted
conclude: conclude,concluded,concludes,concluding
conclusion: conclusion
concourse: concourse
concupiscence: concupiscence
condemn: condemn,condemned
condense: condensing
condescend: condescend
condition: condition,conditions
conduct: conduct,conducted,conducting
conductor: conductor
cone: cones
confederacy: confederacy
confer: confer,conferred,confers
confess: confess,confessed
confession: confession
confide: confide,confided
confidence: confidence
confident: confident
confine: confine,confined
confinement: confinement
confirm: confirm,confirmed,confirming
confirmation: confirmation
confound: confound,confounded,confounding
confront: confronted
confused: confused
confusion: confusion
congratulate: congratulate
congruity: congruity
conjecture: conjecture,conjectured,conjectures,conjecturing
conjunction: conjunction
conjuncture: conjunctures
conjure: conjured
conjurer: conjurers
conjuring: conjuring
connive: connived
conquer: conquered,conquering
conquest: conquests
conscience: conscience,consciences
conscious: conscious
consciousness: consciousness
consent: consent,consented
consequence: consequence,consequences
consequential: consequential
considerable: considerable
considerably: considerably
consideration: consideration,considerations
consist: consist,consisted,consisting,consists
consistence: consistence
consistent: consistent
consort: consort,consorts
conspiracy: conspiracies,conspiracy
conspire: conspire,conspired
constancy: constancy
constant: constant
constantly: constantly
constellation: constellation
constitute: constitutes
constitution: constitution
consult: consult,consulted,consulting
consultation: consultation,consultations
consume: consume,consumed
consummate: consummate
contact: contact
contemn: contemn
contemplation: contemplation
contemporary: contemporaries
contempt: contempt
contemptible: contemptible
contemptuous: contemptuous
contemptuously: contemptuously
contend: contend,contended,contending
content: content
contented: contented
contents: contents
continent: continent
continual: continual
continually: continually
continuance: continuance
continuation: continuation
continue: continue,continued,continues,continuing
contract: contract,contracted,contracts
contraction: contractions
contradict: contradict
contradiction: contradictions
contrary: contrary
contribute: contribute,contributed,contributes
contribution: contribution,contributions
contrivance: contrivance,contrivances
contrive: contrive,contrives
contrived: contrived
contriver: contriver
contriving: contriving
controversy: controversies,controversy
convenience: convenience,conveniences
conveniency: conveniency
convenient: convenient
conveniently: conveniently
conversant: conversant
conversation: conversation,conversations
converse: converse,conversed,conversing
convert: convert
convey: convey,conveyed,conveying
conviction: conviction
convince: convince,convinced,convincing
convinced: convinced
convulsion: convulsions
cook: cook,cooks
copious: copious
copper: copper
copse: copse
copulate: copulating
copying: copying
copyright: copyright
coquetry: coquetry
cord: cord,cords
cordage: cordage
cordial: cordial,cordials
corking: corking
corn: corn,corns
corner: corner,corners
cornish: cornish
corporation: corporation,corporations
correct: correct,corrected,correcting
correction: corrections
corrosion: corrosion
corrosive: corrosives
corrupt: corrupt,corrupted
corrupted: corrupted
corruption: corruption,corruptions
cortez: cortez
cost: cost,costs
costly: costly
cottager: cottagers
cotton: cotton
council: council,councils
counsel: counsel
counsellor: counsellors
count: counted,counts
countenance: countenance,countenanced,countenances
counterfeit: counterfeit
counterpoise: counterpoise
counterview: counterview
country: countries,country
countryman: countrymen
county: county
couple: couple,couples
courage: courage
courser: courser
court: court,courts
courteous: courteous
courtesy: courtesy
courtier: courtier,courtiers
courtly: courtly
courtship: courtship
cousin: cousin
cover: cover,covered,covering
covered: covered
covering: covering
coverlet: coverlet,coverlets
covetous: covetous
cow: cow,cows
coward: cowards
cowardice: cowardice
cowardly: cowardly
crack: crack
cradle: cradle
cram: crammed,cramming
cranny: crannies,cranny
craunch: craunch
crawl: crawl,crawling
crazy: crazy
cream: cream
create: created,creating
creation: creation
creature: creature,creatures
credentials: credentials
credit: credit,credited
creditor: creditors
credulity: credulity
creek: creek
creep: creep,creeping,crept
crest: crest
crew: crew
crier: crier
crime: crime,crimes
criminal: criminal,criminals
critic: critic
critical: critical
crop: crop
cross: cross,crossed
crowd: crowd,crowded,crowding
crowded: crowded
crown: crown,crowned
crucifix: crucifix
crudeness: crudeness
cruel: cruel
cruelly: cruelly
cruelty: cruelty
crumble: crumbled
crust: crust
cub: cub,cubs
cube: cubes
cucumber: cucumbers
cudgel: cudgel,cudgels
cull: culled
cultivate: cultivate,cultivated
culverin: culverins
cumbersome: cumbersome
cunning: cunning
cunningly: cunningly
cup: cup
cupola: cupola
curb: curb
cure: cure,cured,cures,curing
curiosity: curiosities,curiosity
curious: curious
current: current
curse: curses
cursed: cursed
curtain: curtains
cushion: cushion,cushions
custody: custody
custom: custom,customs
cut: cut,cuts,cutting
cycloid: cycloid
cylinder: cylinder,cylinders
daily: daily
damage: damage,damaged,damaging
damaged: damaged
damages: damages
damp: damp
dance: dance,danced,dancing
dancer: dancers
dancing: dancing
danger: danger,dangers
dangerous: dangerous
dapple: dapple
dark: dark
darken: darkened
darling: darling
dart: darting
darts: darts
dash: dash,dashed,dashing
datum: data
daub: daubed,daubing
daughter: daughter,daughters
daunted: daunted
david: david
day: day,days
daytime: daytime
dazzle: dazzled
dead: dead
deadly: deadly
deafen: deafened
deal: deal,dealing,dealt
dealer: dealer
dealings: dealings
dean: dean
dearth: dearth
death: death,deaths
debase: debased
debate: debate,debated,debates
debauch: debauched
debt: debt
decay: decay
decayed: decayed
deceive: deceived,deceiving
december: december
decency: decency
decent: decent
decide: decide
decipher: decipher,deciphered
decipherer: decipherer
decision: decision,decisions
decisive: decisive
deck: deck
declaration: declaration
declare: declare,declared
declension: declensions
decline: decline,declining
declivity: declivity
decree: decree,decreed,decrees
deducible: deducible
deductible: deductible
deep: deep,deeper,deepest
deeply: deeply
deface: defaced
defeat: defeated
defect: defect,defects
defective: defective
defectiveness: defectiveness
defence: defence
defend: defend,defended,defending
defendant: defendant
deficient: deficient
defile: defile
define: define
deform: deformed
deformity: deformities,deformity
defray: defray
defy: defy
degeneracy: degeneracy
degenerate: degenerate,degenerated,degenerating
degrading: degrading
degree: degree,degrees
dejected: dejected
deletion: deletions
deliberate: deliberating
delicious: delicious
delight: delight,delighted,delighting
delighted: delighted
delightful: delightful
delighting: delighting
delineate: delineate
delirium: deliriums
deliver: deliver,delivered,delivering,delivers
deliverance: deliverance
demand: demand,demanded,demands
demeanour: demeanour
demesne: demesne,demesnes
demigod: demigods
demonstrate: demonstrate,demonstrated
demonstration: demonstration
denomination: denominations
denote: denote
deny: deny
depart: depart
departure: departure
depend: depend,depended,depends
dependence: dependence
deplorable: deplorable
deportment: deportment
depose: depose
depress: depressed
depressed: depressed
depression: depression
deprive: deprive,deprived
depth: depth
deputy: deputies,deputy
derivation: derivation
derivative: derivative
derive: derive,derived,derives
descant: descant,descanting
descartes: descartes
descend: descend,descended,descending,descends
descent: descent
description: description,descriptions
descry: descried
desert: deserting
deserve: deserve,deserved,deserves,deserving
deservedly: deservedly
design: design,designed,designs
desire: desire,desired,desires,desiring
desirous: desirous
desolate: desolate
desolation: desolation
despair: despair
despatch: despatch,despatched
despatched: despatched
desperate: desperate
despicable: despicable
despise: despise,despised
desponding: desponding
destiny: destiny
destroy: destroy,destroyed,destroying
destroyer: destroyers
destruction: destruction
destructive: destructive
detach: detach
detect: detecting
detector: detectors
determinate: determinate
determination: determination,determinations
determine: determine,determined,determining
determined: determined
detestable: detestable
detestation: detestation
detract: detract
detractor: detractors
device: device
devilishly: devilishly
devote: devote,devoted
devotion: devotion
devour: devour,devoured
devout: devout
dew: dews
dexterity: dexterity
dexterous: dexterous
dexterously: dexterously
diadem: diadems
dial: dial
dialect: dialect
diameter: diameter,diameters
diamond: diamond,diamonds
dictate: dictate,dictated,dictates
dictionary: dictionary
didymus: didymus
die: die,died,dying
diet: diet
difference: difference,differences
difficult: difficult
difficulty: difficulties,difficulty
diffuse: diffused
dig: dig,digging,dug
digest: digested
digestion: digestion
dignity: dignity
digression: digression
diligence: diligence
diligent: diligent
diligently: diligently
dim: dim
dimension: dimensions
diminish: diminish,diminished,diminishing
diminution: diminution
diminutive: diminutive
dine: dine,dined
dining: dining
dinner: dinner
direct: direct,directed,directing,directs
direction: direction,directions
director: director,directors
dirt: dirt
dirty: dirty
disadvantage: disadvantage,disadvantages
disaffection: disaffection
disagreeable: disagreeable
disappear: disappeared
disappointed: disappointed
disappointment: disappointment,disappointments
disapprobation: disapprobation
disapprove: disapproved
disarm: disarmed
disbelief: disbelief
disburden: disburdened
discard: discarded
discern: discern
discharge: discharge,discharged,discharging
discipline: discipline
disclaim: disclaim
disclaimer: disclaimer,disclaimers
discolour: discoloured
discompose: discompose,discomposed
discomposed: discomposed
disconsolate: disconsolate
discontent: discontent,discontents
discontented: discontented
discontinue: discontinue
discount: discount
discourage: discouraged
discourse: discourse,discoursed,discourses,discoursing
discoursing: discoursing
discover: discover,discovered,discovering,discovers
discoverer: discoverers
discovery: discoveries,discovery
discreet: discreet
disdain: disdain,disdaining
disease: disease,diseases
diseased: diseased
disengage: disengaged
disgrace: disgrace
disgraceful: disgraceful
disgracer: disgracers
disguise: disguise
disgust: disgust,disgusted
disgusted: disgusted
disgustful: disgustful
dish: dish,dishes
dishonourable: dishonourable
disk: disk
dislike: dislike,disliked
dismiss: dismissed,dismissing
dismount: dismount
disobey: disobey
disorder: disorder
disown: disown
dispair: dispair
dispatch: dispatched
dispenser: dispensers
dispirited: dispirited
display: display,displayed,displaying
displeased: displeased
displeasing: displeasing
displeasure: displeasure
disposal: disposal
dispose: dispose,disposed
disposed: disposed
disposition: disposition,dispositions
dispossess: dispossess
disputable: disputable
dispute: dispute,disputed,disputes,disputing
disquiet: disquiet,disquiets
disquietude: disquietudes
dissatisfied: dissatisfied
dissect: dissect
dissension: dissensions
dissent: dissenting
dissolve: dissolved
distance: distance,distances
distant: distant
distinct: distinct
distinction: distinction,distinctions
distinctly: distinctly
distinguish: distinguish,distinguished,distinguishing
distinguished: distinguished
distort: distorted
distorted: distorted
distract: distracted
distress: distress,distresses
distressed: distressed
distribute: distribute,distributed,distributing
distribution: distribution
distributive: distributive
distributor: distributor
district: district,districts
disturb: disturb,disturbed
disturbance: disturbance,disturbances
diuretic: diuretic
diurnal: diurnal
diversion: diversion,diversions
divert: divert,diverted,diverting,diverts
divide: divide,divided
divider: divider
divine: divine
division: division,divisions
docible: docible
docility: docility
doctor: doctor
doctrine: doctrine
dog: dog,dogs
domain: domain
dome: dome
domestic: domestic,domestics
dominion: dominion,dominions
donate: donate
donation: donation,donations
donor: donors
door: door,doors
dose: dose
dotage: dotage
double: double,doubled
doubt: doubt,doubted,doubting,doubts
download: downloading
downward: downward
dozen: dozen
drag: drag,dragged
dram: dram
draught: draught
draw: draw,drawing,drawn,drew
drawer: drawer
drayman: draymen
dread: dread,dreaded
dreadful: dreadful
dream: dream,dreams,dreamt
dress: dress,dressed,dressing
dressed: dressed
dressing: dressing
drink: drank,drink,drinking,drinks
drinking: drinking
drive: drive,driven,drives,drove
drone: drones
drop: drop,dropped
drown: drown,drowned
drudgery: drudgery
drug: drugs
drum: drum,drums
drunk: drunk
drunkard: drunkards
dry: dried,dry
dubious: dubious
dublin: dublin
duck: ducks
dug: dugs
duke: duke,dukes
dullness: dullness
duly: duly
dunce: dunces
dung: dung
dungeon: dungeon
dunstable: dunstable
durable: durable
durst: durst
dust: dust
dutch: dutch
dutchman: dutchman
duty: duties,duty
dwarf: dwarf
dwell: dwell,dwelling,dwelt
dwindle: dwindled
dyeing: dyeing
eager: eager
eagerness: eagerness
eagle: eagle,eagles
ear: ear,ears
earl: earls
earnest: earnest
earnestly: earnestly
earnestness: earnestness
earth: earth
earthen: earthen
ease: ease,eased
easily: easily
east: east
eastern: eastern
eastward: eastward
easy: easy
eat: ate,eat,eaten,eating
eating: eating
eaves: eaves
ebullient: ebullient
eclipse: eclipses
economy: economy
edge: edge,edges
edict: edict
edifice: edifice
edition: edition,editions
edmund: edmund
educate: educated,educating
education: education
educational: educational
effectual: effectual
effectually: effectually
effluvia: effluvia
effort: effort,efforts
egg: egg,eggs
eighteen: eighteen
ejection: ejection
elapse: elapsed
elbow: elbow
eld: eldest
elder: elder
elderly: elderly
elect: elect,electing
election: elections
electronic: electronic
electronically: electronically
elegant: elegant
element: element
elephant: elephant,elephants
ellipsis: ellipses
eloquent: eloquent
elude: eluded,eluding
email: email
embargo: embargo
embassy: embassy
embrace: embrace,embraced,embraces
embroider: embroidered
embroil: embroiled
embryo: embryo
eminent: eminent
emotion: emotion,emotions
emperor: emperor,emperors
empire: empire,empires
employ: employ,employed,employing
employee: employee,employees
employment: employment,employments
empress: empress
enable: enable,enabled,enables
enact: enacted,enacting
enclose: enclosed
enclosure: enclosures
encode: encoding
encomium: encomiums
encompass: encompassed
encounter: encounters
encourage: encouraged
encouraged: encouraged
encouragement: encouragement
encourager: encouragers
encrust: encrusted
encumbrance: encumbrance
endanger: endanger
endeavour: endeavour,endeavoured,endeavouring
endless: endless
endow: endowed
endowment: endowments
endue: endued
endure: endure
enemy: enemies,enemy
energy: energy
enforce: enforce,enforced
engage: engage,engaged
engaged: engaged
engagement: engagement
engender: engendered
engine: engine,engines
engineer: engineers
england: england
english: english
englishman: englishman,englishmen
engross: engross,engrossed
enjoin: enjoined
enjoy: enjoy,enjoyed,enjoying
enlarge: enlarge,enlarged
enliven: enlivened
enmity: enmity
ennoble: ennobled
enormity: enormities
enormous: enormous
enrich: enriched
enslave: enslaved
enslaving: enslaving
ensue: ensue,ensued
ensure: ensuring
enter: enter,entered,entering
enterprise: enterprise,enterprises
enterprising: enterprising
entertain: entertain,entertained,entertaining
entertained: entertained
entertaining: entertaining
entertainment: entertainment,entertainments
entire: entire
entitle: entitled
entity: entities,entity
entrance: entrance
entreat: entreat,entreated
entreaty: entreaties,entreaty
entrust: entrusted
entry: entry
enumerate: enumerated
envoy: envoy
envy: envy
epithet: epithet
equal: equal,equalled
equality: equality
equally: equally
equilateral: equilateral
equinox: equinox
equip: equipped
equipage: equipage
equipment: equipment
equitable: equitable
equity: equity
equivocate: equivocating
erase: erased
erect: erect,erected,erecting
erection: erection
errand: errand
erroneously: erroneously
error: error,errors
erudition: erudition
escape: escape,escaped
espalier: espalier
espy: espied
essence: essence
essential: essential
establish: established
establishment: establishment
estate: estate,estates
esteem: esteem,esteemed
esteemed: esteemed
etiam: etiam
etymology: etymology
europe: europe
european: european,europeans
evacuation: evacuation,evacuations
evade: evaded
evasion: evasion
evening: evening
event: event,events
everlasting: everlasting
evidence: evidence,evidences
evident: evident
evidently: evidently
evil: evil,evils
evince: evince
ewe: ewes
exact: exact
exactness: exactness
exalt: exalted
examination: examination
examine: examine,examined
examiner: examiner
exceed: exceed,exceeded,exceeding
exceedingly: exceedingly
excel: excel,excelled,excelling
excellence: excellences
excellency: excellencies,excellency
excellent: excellent
excelling: excelling
excess: excess
excessive: excessive
exchequer: exchequer
exclude: excluded
exclusion: exclusion
excrement: excrement,excrements
excusable: excusable
excuse: excuse,excused,excuses
execrable: execrable
execute: executed,executing
execution: execution
exempt: exempt,exempted
exercise: exercise,exercised,exercises,exercising
exert: exerting
exhale: exhale,exhaled
exhaust: exhausted
exhort: exhort,exhorted
exhortation: exhortation
exile: exile,exiles
exist: exists
existence: existence
expect: expect,expected,expecting
expectation: expectation
expedient: expedient,expedients
expedite: expedited
expedition: expedition
expend: expend
expense: expense,expenses
expensive: expensive
experience: experience,experienced
experienced: experienced
experiment: experiment,experiments
expert: expert
explain: explain,explained
explanation: explanation
explode: exploded
exploit: exploit,exploits
export: exporting
expose: expose,exposed,exposing
expostulate: expostulate,expostulated
expostulation: expostulations
express: express,expressed,expressing
expression: expression,expressions
expressive: expressive
expressly: expressly
extend: extend,extended,extending,extends
extended: extended
extent: extent
extenuate: extenuate,extenuated
extenuation: extenuation
exterminate: exterminated
external: external
extinct: extinct
extinguish: extinguish,extinguished,extinguishing
extort: extorted
extract: extract,extracted,extracting
extraordinary: extraordinary
extravagancy: extravagancies
extravagant: extravagant
extreme: extreme
extremely: extremely
extremity: extremities,extremity
eye: eye,eyes
eyebrow: eyebrow
fabulous: fabulous
facility: facility
faction: faction,factions
faculty: faculty
fail: fail,failed,fails
failure: failure
faint: faint
fair: fair,fairer,fairest
faith: faith
faithful: faithful
faithfully: faithfully
fall: fall,fallen,falling,falls,fell
fallen: fallen
falling: fallings
falls: falls
false: false
falsehood: falsehood
falsely: falsely
falsity: falsities
fame: fame
familiar: familiar
familiarity: familiarities
familiarized: familiarized
family: families,family
famine: famine
famish: famished
famous: famous
fan: fans
fancied: fancied
fancy: fancied,fancy
fangled: fangled
fare: fare
farewell: farewell
farm: farm
farmer: farmer,farmers
farth: farthest
farthing: farthing
fashion: fashion,fashions
fast: fast,fasted,faster
fasten: fasten,fastened,fastening
fasting: fasting
fat: fat
fatal: fatal
fate: fate
father: father,fathers
fatherless: fatherless
fatigued: fatigued
fault: fault,faults
faulty: faulty
favour: favour,favouring,favours
favourable: favourable
favourite: favourite
fawn: fawning
fear: fear,feared,fearing,fears
fearfulness: fearfulness
feat: feat,feats
feather: feathers
feature: feature,features
february: february
federal: federal
fee: fee,fees
feed: fed,feed,feeding
feeding: feeding
feel: feel,feeling
felicity: felicity
fell: felled
fellow: fellow,fellows
female: female,females
fence: fence,fenced
fencer: fencers
fertility: fertility
festival: festival
fetch: fetch
fetid: fetid
fetlock: fetlock
fetter: fetter
fever: fever
fiction: fiction
fiddle: fiddles
fiddler: fiddlers
fidelity: fidelity
field: field,fields
fierce: fierce,fiercest
fiercely: fiercely
fierceness: fierceness
fiery: fiery
fight: fight,fights,fought
figure: figure,figures
file: file,files
filth: filth
filthily: filthily
filthy: filthy
final: final
financial: financial
fine: fine,finer,finest
finely: finely
fineness: fineness
finery: finery
finger: finger,fingers
finish: finish,finished,finishes
firm: firm
firmly: firmly
firmness: firmness
fish: fish,fishes,fishing
fisherman: fisherman
fist: fist
fit: fit,fitted,fitter
fitness: fitness
flail: flail
flame: flame,flames
flank: flanked
flap: flap,flapped,flaps
flapper: flapper,flappers
flash: flashes
flat: flat
flatness: flatness
flatter: flattered
flatterer: flatterers
flattering: flattering
flatus: flatus
flee: fled
fleece: fleeces
fleet: fleet
flesh: flesh
flight: flight
flint: flint,flints
float: floated,floating
flock: flock,flocking
flood: flood
floor: floor,floors
florid: florid
flourish: flourish,flourished,flourishing
flow: flowing
flower: flowers
fluid: fluid
flurry: flurry
flute: flutes
flutter: flutter
flux: flux
fly: flew,flies,fly,flying
flying: flying
foal: foal,foals
fob: fob,fobs
fold: fold,folded,folds
folio: folio,folios
folk: folk,folks
follow: follow
follower: followers
folly: follies,folly
foment: fomented
fond: fond,fondest
fonder: fonder
fondle: fondling
fondness: fondness
food: food
fool: fool,fools
foolish: foolish
foot: feet,foot
footman: footman,footmen
footnote: footnotes
footstool: footstool
fop: fops
foppery: fopperies
forbear: forbear
forbid: forbid,forbidden,forbids
forboding: forboding
force: force,forced,forces,forcing
forcibly: forcibly
fore: fore
forefather: forefathers
forefoot: forefeet
forehead: forehead
foreign: foreign
foreigner: foreigner,foreigners
foremast: foremast
foremention: forementioned
forepaw: forepaws
foresight: foresight
forfeiture: forfeitures
forge: forge,forging
forgery: forgery
forget: forget,forgot,forgotten
forgetfulness: forgetfulness
forgive: forgive
fork: fork,forks
forlorn: forlorn
form: form,formed,forming,forms
formal: formal
formality: formality
format: format,formats
forsake: forsake,forsaken
forswear: forswearing
fort: fort
fortify: fortified
fortis: fortis
fortitude: fortitude
fortnight: fortnight
fortunate: fortunate
fortunately: fortunately
fortune: fortune,fortunes
forwards: forwards
foul: foul
foundation: foundation
founder: foundered,foundering
fountain: fountain,fountains
fours: fours
fourscore: fourscore
fourteen: fourteen
fourteenth: fourteenth
fourth: fourth,fourths
fowl: fowl,fowls
fox: fox
frailty: frailties
frame: frame,framed,frames
franca: franca
france: france
fraternity: fraternity
fraud: fraud
freckle: freckles
freedom: freedom
freely: freely
freethink: freethinking
freight: freight
french: french
frequent: frequent
frequently: frequently
fresh: fresh
friend: friend,friends
friendship: friendship
fright: fright,frighted
frighten: frighten
frightened: frightened
frightful: frightful
frisking: frisking
frizzle: frizzled
fro: fro
frog: frog,frogs
frolicsome: frolicsome
frontier: frontiers
froth: froth
frothy: frothy
frozen: frozen
fruit: fruit,fruits
fruitful: fruitful
fuel: fuel
fulsome: fulsome
fund: fund,funds
fundament: fundament
fundamental: fundamental
funeral: funeral
furious: furious
furiously: furiously
furnish: furnish,furnished
furnishing: furnishing
furniture: furniture
furred: furred
fury: fury
future: future
gain: gain,gained,gains
gait: gait
gale: gale
gall: gall
gallant: gallant,gallants
gallery: galleries,gallery
gallon: gallons
gallop: galloping
gamester: gamester,gamesters
gaming: gaming
gange: ganges
gap: gap
garden: garden,gardens
gardener: gardener,gardeners
gardening: gardening
garment: garments
garret: garret
gate: gate,gates
gather: gather,gathered
gaze: gaze,gazed,gazing
generation: generation,generations
generosity: generosity
generous: generous
genius: genius
gentle: gentle
gentleman: gentleman,gentlemen
gentleness: gentleness
gentlewoman: gentlewoman
gently: gently
gentry: gentry
geographer: geographers
geometrical: geometrical
geometry: geometry
george: george
german: german
gesture: gesture,gestures
ghastliness: ghastliness
ghost: ghost,ghosts
giant: giant,giants
gibbet: gibbet,gibbets
giber: gibers
giddiness: giddiness
gift: gift
gimlet: gimlet
girdle: girdle,girdles
girl: girl,girls
girt: girt
glad: glad
gladly: gladly
glass: glass,glasses
glimmering: glimmerings
globe: globe,globes
glorious: glorious
glory: glory
gloss: glossing
glove: gloves
glowing: glowing
glutinous: glutinous
goal: goals
goat: goats
god: god,gods
gold: gold
golden: golden
goodness: goodness
goose: geese,goose
gout: gout
govern: govern,governed,governing
governess: governess
governing: governing
government: government
governor: governor,governors
grace: grace,graces
graceful: graceful
gracious: gracious
graciously: graciously
gradation: gradations
gradual: gradual
gradually: gradually
grain: grain,grains
grammar: grammar
grand: grand
grandchild: grandchildren
grandee: grandee,grandees
grandeur: grandeur
grandfather: grandfather
grandmother: grandmother
grant: grant,granted
grasp: grasp
grass: grass
grate: grate,grating
gratefully: gratefully
gratify: gratify
gratis: gratis
gratitude: gratitude
grave: grave,graves
gravitation: gravitation
gravity: gravity
gray: gray
graze: graze,grazed,grazing
grease: greasing
greatness: greatness
greedily: greedily
greediness: greediness
greek: greek
green: green
greenland: greenland
greenwich: greenwich
greyhound: greyhound
grief: grief
grievance: grievances
grieving: grieving
grievous: grievous
grievously: grievously
grimace: grimaces
grin: grin,grinning
grind: grinding,ground
groan: groan,groaning,groans
groaning: groaning
groom: groom
groove: groove
grooved: grooved
gross: gross,grosser,grossest
ground: ground,grounded
groundless: groundless
grounds: grounds
grove: groves
grovel: groveling,grovelling
grow: grew,grow,growing,grown,grows
grown: grown
growth: growth
guard: guard,guards
guardian: guardians
gue: gue
guess: guess,guessed
guest: guest
guide: guide,guided,guides
guilt: guilt
guilty: guilty
guinea: guinea,guineas
guitar: guitars
gulliver: gulliver
gum: gums
gun: gun,guns
gunpowder: gunpowder
gut: guts
gutter: gutters
habit: habit,habits
habituate: habituate
hail: hail,hailed
hailstone: hailstone,hailstones
hair: hair,hairs
haired: haired
hairiness: hairiness
hairy: hairy
hall: hall
ham: hams
hammer: hammers
hammock: hammock
hamper: hampers
hand: hand,handed,hands
handicraft: handicrafts
handkerchief: handkerchief
handle: handle
handling: handling
handsome: handsome,handsomest
handy: handy
hang: hang,hanged,hanging,hung
hanger: hanger
hannibal: hannibal
happen: happen,happened,happening
happily: happily
happiness: happiness
happy: happiest,happy
harbour: harbour
hard: hard,harder
harden: harden
hardiness: hardiness
hardness: hardness
hardship: hardship,hardships
hardy: hardy
harm: harm
harmless: harmless
harness: harness
harp: harp,harps
harpsichord: harpsichords
hart: hart
harvest: harvest
haste: haste
hasten: hasten
hat: hat
hate: hate,hated
hateful: hateful
hatred: hatred
haul: haul,hauled
haunch: haunches
hautboy: hautboys
havoc: havoc
hay: hay
hazard: hazard,hazards
hazel: hazel
hazy: hazy
head: head,heads
health: health
healthy: healthy
heap: heap,heaps
hear: hear,heard,hearing
hearer: hearer
hearing: hearing
heart: heart
hearted: hearted
heartily: heartily
hearty: hearty
heat: heat,heated
heath: heath
heathen: heathen
heave: heaved
heavenly: heavenly
heaving: heaving
heavy: heavy
hectoring: hectoring
hedge: hedge
heel: heels
height: height
heir: heir,heirs
heliogabalus: heliogabalus
helm: helm
helmet: helmet
helot: helot
helpless: helpless
hemp: hemp
hempen: hempen
henceforth: henceforth
herb: herbs
herd: herd,herds
heresy: heresy
herman: herman
hermetically: hermetically
hero: heroes
hesitation: hesitation
hew: hewn
hide: hide,hides
hideous: hideous
hiding: hiding
highly: highly
highness: highness
highway: highway
highwayman: highwaymen
hill: hill,hills
hillock: hillock
hilt: hilt
hind: hind,hinds
hinder: hinder,hindered
hinge: hinges
hint: hint,hinted,hints
hire: hire,hired
historian: historian
historical: historical
history: histories,history
hit: hit
hitherto: hitherto
hoarse: hoarse
hobble: hobble
hobgoblin: hobgoblins
hog: hogs
hogshead: hogshead,hogsheads
hoist: hoisted
hold: held,hold,holding,holds
holder: holder
hole: hole,holes
holla: holla
holland: holland
hollander: hollander
hollanders: hollanders
hollow: hollow,hollowed
holy: holy
homer: homer
honest: honest
honesty: honesty
honey: honey
honour: honour,honoured
honourable: honourable
honourably: honourably
hoof: hoof,hoofs
hook: hook,hooks
hooked: hooked
hoop: hoop
hooped: hooped
hop: hop,hopped
hope: hope,hoped,hopes,hoping
hopeful: hopeful
horizon: horizon
horizontally: horizontally
horn: horns
horrible: horrible
horribly: horribly
horror: horror
horse: horse,horses
horseback: horseback
horseman: horseman
hosier: hosier
hospitable: hospitable
hospitably: hospitably
hospital: hospitals
hospitality: hospitality
hostile: hostile
hot: hot
hound: hound
hour: hour,hours
house: house,houses
housebreaker: housebreakers
household: household
houyhnhnm: houyhnhnm
hover: hovered,hovering
howl: howl,howled,howling
hue: hue,hues
hug: hug
huge: huge
hull: hull,hulling
hum: humming
human: human
humanity: humanity
humankind: humankind
humble: humble,humblest
humbly: humbly
humility: humility
humour: humour,humours
hung: hung
hunger: hunger
hungry: hungry
hunt: hunt
hunting: hunting
huntsman: huntsmen
hurry: hurried
hurt: hurt,hurting,hurts
husband: husband,husbands
husbandman: husbandman
husbandry: husbandry
hush: hushed
husk: husks
hut: huts
huzza: huzzas
hypocrisy: hypocrisy
ice: ice
icteric: icterics
idea: idea,ideas
identification: identification
identify: identify
idle: idle
idleness: idleness
idolatrous: idolatrous
idolatry: idolatry
ignominious: ignominious
ignominy: ignominy
ignorance: ignorance
ignorant: ignorant
iii: iii
illegal: illegal
illiterate: illiterate
illustrious: illustrious
image: image
imaginable: imaginable
imaginary: imaginary
imagination: imagination,imaginations
imagine: imagine,imagined,imagining
imbecility: imbecilities,imbecility
imitate: imitate,imitated,imitating
imitation: imitation
immense: immense
immoderate: immoderate
immortal: immortal,immortals
immunity: immunities
imp: imp
impair: impaired
impartially: impartially
impassable: impassable
impatience: impatience
impatient: impatient
impeachment: impeachment
impediment: impediment
impending: impending
imperfect: imperfect
imperfection: imperfections
imperfectly: imperfectly
imperial: imperial
impertinence: impertinence
implement: implements
imply: implied
import: imported,imports
importunate: importunate
impose: impose,imposed
impossible: impossible
impotent: impotent
impression: impression,impressions
imprimis: imprimis
imprison: imprison,imprisoned
imprisonment: imprisonment
improbable: improbable
impropriety: improprieties
improve: improve,improved,improving
improvement: improvement,improvements
imprudently: imprudently
impudence: impudence
impudently: impudently
impulse: impulse
imputation: imputation
impute: impute
imputed: imputed
inaccurate: inaccurate
inadvertence: inadvertence
incapable: incapable
incessant: incessant
incessantly: incessantly
incest: incest
inch: inch,inches
incident: incident
incidental: incidental
incite: incite,incited
incitement: incitement
inclemency: inclemencies
inclement: inclement
inclination: inclination,inclinations
incline: inclined,inclining
inclined: inclined
include: include,included,includes,including
including: including
incognito: incognito
incomplete: incomplete
inconsiderable: inconsiderable
inconsistently: inconsistently
inconstancy: inconstancy
inconvenience: inconvenience
inconveniency: inconveniency
inconvenient: inconvenient
increase: increase,increased,increasing
incredible: incredible
incur: incur,incurring
indemnify: indemnify
indemnity: indemnity
indian: indian,indians
indication: indication
indies: indies
indifference: indifference
indifferent: indifferent
indifferently: indifferently
indignation: indignation
indignity: indignity
indirect: indirect
indirectly: indirectly
indispose: indisposed
indisposition: indisposition
individual: individual
indocible: indocible
inducement: inducements
indulgence: indulgence
indulgent: indulgent
industry: industry
inevitably: inevitably
inexpressible: inexpressible
infallible: infallible
infallibly: infallibly
infamous: infamous
infamy: infamy
infancy: infancy
infant: infants
infected: infected
infection: infection
inferior: inferior,inferiors
infernal: infernal
infest: infest,infested
infinite: infinite
infinitely: infinitely
infirmity: infirmities,infirmity
infirmly: infirmly
inflame: inflamed
inflict: inflicted
influence: influence,influences
inform: inform,informed,informing,informs
informed: informed
informer: informer,informers
infringement: infringement
infuse: infused
ingenious: ingenious
ingeniously: ingeniously
ingenuity: ingenuity
ingratiate: ingratiate
ingratitude: ingratitude
ingredient: ingredients
inhabit: inhabit,inhabited
inhabitant: inhabitants
inhuman: inhuman
inhumanity: inhumanity
inimitable: inimitable
iniquitous: iniquitous
initial: initial
injure: injure,injured,injuring
injured: injured
injurious: injurious
injuriously: injuriously
injury: injuries,injury
injustice: injustice,injustices
ink: ink
inmost: inmost
inn: inn
innermost: innermost
innocence: innocence
innocent: innocent
innovation: innovation
innuendo: innuendo
innumerable: innumerable
inquire: inquire,inquired,inquires,inquiring
inquiry: inquiries,inquiry
inquisition: inquisition
inquisitive: inquisitive
inroad: inroads
insatiable: insatiable
insect: insect,insects
insert: insert,inserted
insight: insight
insignificant: insignificant
insinuate: insinuating
insinuation: insinuation
insipid: insipid
insist: insist,insisted
insolence: insolence
insolent: insolent
insomuch: insomuch
instance: instance
instant: instant
instigate: instigated
instinct: instinct
institute: instituted
institution: institution,institutions
instruct: instruct,instructed,instructing
instruction: instruction,instructions
instructor: instructor,instructors
instrument: instrument,instruments
instrumental: instrumental
insufficiency: insufficiency
insuperable: insuperable
insupportable: insupportable
insurrection: insurrection,insurrections
integrity: integrity
intellect: intellects
intellectual: intellectual,intellectuals
intelligence: intelligence
intelligible: intelligible
intemperance: intemperance
intend: intend,intended,intending
intended: intended
intense: intense
intent: intent
intention: intention,intentions
intercede: intercede,interceding
interchange: interchanged,interchanging
intercourse: intercourse
interfere: interfere
intermingle: intermingled
intermingled: intermingled
intermission: intermission,intermissions
internal: internal
international: international
interpolator: interpolator
interpose: interposed,interposing
interposition: interposition
interpret: interpret,interpreted
interpretation: interpretation,interpretations
interpreter: interpreter,interpreters
interpreting: interpreting
interrupt: interrupt,interrupted
interruption: interruption
interval: intervals
intervention: intervention
interwoven: interwoven
intestine: intestine
intimate: intimate
intolerable: intolerable
intolerably: intolerably
intrepidity: intrepidity
intrigue: intrigue
introduce: introduced
intromission: intromission
inundation: inundation
inure: inured
invade: invade,invading
invader: invader,invaders
invalidity: invalidity
invasion: invasion
invent: invent,invented
inventor: inventor
inventory: inventory
inviolable: inviolable
invisible: invisible
invitation: invitation
invite: invite,invited
involved: involved
iron: iron
irrational: irrational
irreconcilable: irreconcilable
irregular: irregular
irregularly: irregularly
irs: irs
island: island,islands
islands: islands
isle: isle
issue: issue,issued,issues
italian: italian,italians
iv: iv
ivory: ivory
ix: ix
jabber: jabber,jabbering
jackdaw: jackdaw
jail: jail
james: james
japan: japan
japanese: japanese
jargon: jargon
jealous: jealous
jealousy: jealousy
jerkin: jerkin
jet: jet
jewel: jewels
jewry: jewry
jig: jig
job: jobs
jockey: jockeys
john: john
johnny: johnny
joiner: joiner
joint: joint,joints
jointure: jointures
jolt: jolt,jolts
jonathan: jonathan
jostle: jostle
journal: journal
journey: journey,journeys
joy: joy
judge: judge,judges
judgment: judgment,judgments
judicature: judicature
judicial: judicial
judicious: judicious
juice: juice,juices
juicy: juicy
jump: jumped,jumps
juncture: juncture
june: june
junius: junius
junto: junto
jury: jury
justest: justest
justice: justice
justiciary: justiciary
justifiable: justifiable
justification: justification
justified: justified
justify: justified,justify
justle: justled,justling
justly: justly
justness: justness
jut: jutting
keen: keen
keeper: keeper
kennel: kennel,kennels
kentish: kentish
kettle: kettles
key: key
kick: kick
kill: kill,killed,kills
kindle: kindle,kindled
kindly: kindly
kindness: kindness
kindred: kindred
king: king,kings
kingdom: kingdom,kingdoms
kingly: kingly
kinsman: kinsman
kiss: kiss,kissed,kissing
kitchen: kitchen
kite: kite
kitten: kitten,kittens
knave: knave,knaves
knee: knee,knees
kneel: kneeled
knife: knife,knives
knitting: knitting
knock: knocked,knocking
knot: knot,knotted
knowledge: knowledge
laborious: laborious
labour: labour,labouring,labours
labourer: labourers
lackey: lackeys
lad: lad,lads
ladder: ladder,ladders
laden: laden
lading: lading
lady: ladies,lady
ladyship: ladyship
lake: lake
lamb: lamb,lambs
lame: lame,lamed
lament: lament,lamented,lamenting
lamenting: lamenting
lamp: lamps
land: land,landed,lands
landing: landing
landlord: landlord
lane: lane,lanes
language: language,languages
laniard: laniard
lank: lank
lap: lap,lapped
lappet: lappet,lappets
laputa: laputa
larboard: larboard
largeness: largeness
lark: lark
lastly: lastly
late: late
lather: lather
latin: latin
latins: latins
latitude: latitude
latitudes: latitudes
lattice: lattice,latticed,lattices
laudable: laudable
laugh: laugh,laughed,laughing
laughter: laughter
lavender: lavender
law: law,laws
lawfully: lawfully
lawn: lawn
lawsuit: lawsuits
lawyer: lawyer,lawyers
laxative: laxatives
lay: laid,lay,laying,lays
lazy: lazy
lead: lead,leading,leads,led
leader: leader,leaders
leading: leading
leaf: leaf,leaves
league: league,leagues
leak: leak,leaking,leaks
leaky: leaky
lean: lean,leaning
leap: leap,leaped,leaping
learn: learn,learned,learning,learnt
learning: learning
lease: lease,leases
leather: leather
leathern: leathern
leave: leave,leaves,leaving,left
lecture: lectures
ledge: ledges
lee: lee
leeward: leeward
left: left
leg: leg,legs
legal: legal
legally: legally
legislative: legislative
legislator: legislator
legislature: legislature
leisure: leisure
lemon: lemon
lemuel: lemuel
lend: lend,lent
lenitive: lenitives
lenity: lenity
lessen: lessen,lessened
lessening: lessening
lesson: lesson,lessons
letter: letter,letters
levant: levant
levee: levee,levees
level: level
levy: levied
lewd: lewd
lewdness: lewdness
leyden: leyden
liability: liability
liable: liable
libel: libelling,libels
liberal: liberal
libertine: libertine
liberty: liberties,liberty
libidinous: libidinous
library: libraries,library
lice: lice
license: license
licensed: licensed
licentiousness: licentiousness
lick: lick,licked
lie: lie,lies,lying
lieu: lieu
life: life,lives
lift: lift,lifted,lifting,lifts
ligature: ligatures
light: light
lightning: lightning
lilliput: lilliput
lilliputian: lilliputian,lilliputians
limb: limb,limbs
limit: limited,limits
limitation: limitation
limited: limited
limpet: limpets
lineage: lineages
lineally: lineally
lineament: lineament,lineaments
linen: linen
lingua: lingua
link: linked,links
linnet: linnet
lip: lip,lips
liquid: liquid,liquids
liquor: liquor,liquors
lisbon: lisbon
listen: listen,listened
listless: listless
literally: literally
literary: literary
literature: literature
littleness: littleness
live: live,lived,lives,living
livelihood: livelihood
liverpool: liverpool
livery: livery
living: living
load: load,loaded,loading,loads
loadstone: loadstone
loaf: loaves
loathing: loathing
loathsome: loathsome
local: local
locate: located
location: locations
lock: lock,locked
lodge: lodge,lodged,lodges
lodging: lodging
lodgings: lodgings
lofty: lofty
logwood: logwood
loin: loins
london: london
longitude: longitude,longitudes
loose: loose
loosen: loosened,loosens
lord: lord,lords
lordship: lordship
lose: lose,lost
loser: losers
loss: loss,losses
lot: lot,lots
loud: loud,louder
louse: louse
love: love,loved,loving
lover: lover,lovers
lucid: lucid
luck: luck
luckily: luckily
lucky: luckiest,lucky
lug: lug
luggage: luggage
luggnagg: luggnagg
luminary: luminaries
lump: lump
lung: lungs
lurk: lurking
lust: lust
lusus: lusus
luxurious: luxurious
luxury: luxury
lying: lying
machine: machine,machines
mad: mad
madagascar: madagascar
madness: madness
magic: magic
magician: magicians
magistrate: magistrate,magistrates
magnanimous: magnanimous
magnet: magnet
magnetic: magnetic
magnificence: magnificence
magnificent: magnificent
magnificently: magnificently
magnify: magnify
magnifying: magnifying
magnitude: magnitude
maid: maid,maids
maim: maimed,maims
main: main
mainmast: mainmast
mainsail: mainsail
maintain: maintain,maintained,maintaining
maintenance: maintenance
majestic: majestic
majesty: majesties,majesty
majority: majority
maker: maker,makers
malady: maladies,malady
male: male,males
malefactor: malefactor
malice: malice
malicious: malicious
maliciously: maliciously
maligner: maligners
malignity: malignity
malleability: malleability
mamma: mamma
manage: manage,managed,managing
management: management
manager: manager,managers
mane: manes
manger: manger,mangers
manhood: manhood
manifest: manifest
manifestly: manifestly
mankind: mankind
manned: manned
manner: manner
manners: manners
mannikin: mannikin
manufacture: manufacture,manufactures
manure: manuring
manuscript: manuscript
map: map,maps
marble: marble
march: march
mare: mare,mares
mariner: mariner,mariners
maritime: maritime
mark: mark,marked,marking,marks
market: market,markets
marquis: marquis,marquises
marriage: marriage,marriages
marriageable: marriageable
married: married
marrow: marrow
marry: married,marries,marry
mars: mars
marsi: marsi
mary: mary
masculine: masculine
mash: mash
mass: mass
massacre: massacres
massy: massy
mast: mast,masts
master: master,masters
mastiff: mastiff
mat: mat,mats
match: match
mate: mates
material: material,materials
mathematical: mathematical
mathematician: mathematicians
mathematics: mathematics
matron: matron
matter: matter,matters
mature: mature
maturely: maturely
maturity: maturity
maxim: maxim,maxims
maximum: maximum
meadow: meadow,meadows
meagre: meagre
meal: meal,meals
meaning: meaning,meanings
meanness: meanness
measure: measure,measured,measures
meat: meat,meats
mechanic: mechanic,mechanics
mechanical: mechanical
mechanically: mechanically
meddle: meddle
medicine: medicine,medicines
meditate: meditating
medium: medium
meet: meet,meeting,meets,met
meeting: meeting
melancholy: melancholy
memoirs: memoirs
memorandum: memorandums
memorial: memorial,memorials
memory: memories,memory
mend: mend
menial: menial
mention: mention,mentioned,mentioning
mercenary: mercenary
merchant: merchant,merchants
merchantability: merchantability
merchantman: merchantman
merciful: merciful
mercurial: mercurial
mercy: mercy
mere: mere
merit: merit,merits
merrily: merrily
merry: merry
message: message
messenger: messenger
metal: metal,metals
metamorphose: metamorphosed
method: method,methods
metropolis: metropolis
michael: michael
microscope: microscope
mid: mid
middle: middle
midnight: midnight
midst: midst
mighty: mighty
mild: mild,mildest
mildly: mildly
mile: mile,miles
military: military
militia: militia
milk: milk,milked
mimic: mimicked
mince: minced
mind: mind,minds
mineral: mineral,minerals
mingle: mingled,mingling
miniature: miniature
minion: minion
minister: minister,ministers
ministry: ministry
minute: minute,minutes
minuteness: minuteness
mirth: mirth
miscarry: miscarried,miscarry
mischief: mischief
mischievous: mischievous
miser: miser
miserable: miserable
miserably: miserably
misery: miseries,misery
misfortune: misfortune,misfortunes
mislead: misled
misrepresent: misrepresented
mission: mission
mississippi: mississippi
missive: missive
mistake: mistake,mistaken,mistakes
mistaken: mistaken
mistress: mistress,mistresses
mix: mix
mixture: mixture
mizen: mizen
mock: mock
mode: mode
model: model
moderation: moderation
modern: modern
modest: modest
modesty: modesty
modification: modification
modify: modified
moidore: moidores
mole: mole
moll: moll
molucca: molucca
moment: moment
momentous: momentous
monarch: monarch,monarchs
monarchs: monarchs
monarchy: monarchy
money: money
monkey: monkey,monkeys
monsoon: monsoon
monster: monster,monsters
monstrous: monstrous
month: month,months
monthly: monthly
monument: monument,monuments
mood: moods
moon: moon,moons
moonshine: moonshine
moral: moral,morals
moralist: moralists
morality: morality
morning: morning
morose: morose
moroseness: moroseness
morsel: morsel
mortal: mortal,mortals
mortals: mortals
mortification: mortification
mortified: mortified
mortify: mortified
mortifying: mortifying
mother: mother,mothers
motion: motion,motions
motive: motive,motives
mould: mould
mount: mount,mounted,mounting,mounts
mountain: mountain,mountains
mountainous: mountainous
mouse: mice,mouse
mouth: mouth,mouths
mouthful: mouthful,mouthfuls
movable: movable
moveable: moveable
movingly: movingly
mud: mud
mule: mule,mules
multiply: multiplied,multiply,multiplying
mummy: mummy
murder: murder,murdered,murdering,murders
murderer: murderers
muscle: muscles
music: music
musical: musical
musket: musket,muskets
mutiny: mutiny
mutton: mutton
mutual: mutual
mutually: mutually
muzzle: muzzle
mysterious: mysterious
mystery: mystery
nag: nag,nags
nail: nail,nails
naked: naked
nakedness: nakedness
nameless: nameless
nap: nap
narrow: narrow
narrowly: narrowly
narrowness: narrowness
nastiness: nastiness
nation: nation,nations
national: national
native: native,natives
nativity: nativity
natural: natural
naturalist: naturalists
naturally: naturally
nature: nature,natures
natured: natured
nauseous: nauseous
navigation: navigation
nearer: nearer
neat: neat
neatly: neatly
necessaries: necessaries
necessity: necessities,necessity
neck: neck
necklace: necklace
necromancy: necromancy
needle: needle,needles
needless: needless
needlework: needlework
neglect: neglect,neglected
negligence: negligence
negotiation: negotiations
neigh: neighed,neighing
neighbour: neighbour,neighbouring,neighbours
neighbourhood: neighbourhood
nephew: nephew
nerve: nerves
nest: nests
nettle: nettled
network: network
newark: newark
newgate: newgate
newly: newly
news: news
newsletter: newsletter
niagara: niagara
nice: nice
nicely: nicely
nicety: nicety
niche: niches
nicholas: nicholas
night: night,nights
nile: nile
nimble: nimble
nimbly: nimbly
ninth: ninth
nipple: nipple,nipples
nitre: nitre
nobility: nobility
noble: noble,nobles,noblest
nobleman: nobleman,noblemen
nod: nod
noise: noise
noisome: noisome
noisy: noisy
nonproprietary: nonproprietary
noon: noon
north: north
northerly: northerly
northern: northern
northward: northward
nose: nose
nostril: nostril
note: note,notes
notice: notice
notify: notifies
notion: notion,notions
notorious: notorious
noun: nouns
nourishing: nourishing
nourishment: nourishment
november: november
noxious: noxious
nucleus: nucleus
numberless: numberless
numerous: numerous
nurse: nurse,nurses
nursery: nurseries,nursery
nut: nut
nutriment: nutriment
nuzzle: nuzzling
oak: oak
oar: oar,oars
oat: oat
oath: oath,oaths
oats: oats
obedience: obedience
obeisance: obeisances
obey: obey,obeyed
object: object,objected,objects
objection: objection,objections
obligation: obligation,obligations
oblige: oblige,obliged,obliging
obliged: obliged
oblique: oblique
obliquely: obliquely
obliquity: obliquity
oblivion: oblivion
obnoxious: obnoxious
obscure: obscure,obscured
obscurest: obscurest
obsequious: obsequious
observation: observation,observations
observe: observe,observed,observing
observer: observers
obsolete: obsolete
obstinacy: obstinacy
obstinate: obstinate
obtrude: obtrude
obvious: obvious
occasion: occasion,occasioned,occasions
occiput: occiput,occiputs
occult: occult
occupation: occupations
occur: occur,occurred
ocean: ocean
october: october
odd: odd
oddly: oddly
odious: odious
odiousness: odiousness
odour: odour
offence: offence
offend: offended,offending
offended: offended
offensive: offensive
offensively: offensively
offer: offer,offered,offering,offers
office: office,offices
officer: officer,officers
official: official
officiously: officiously
oils: oils
ointment: ointment
olive: olive
ominous: ominous
omission: omission
omit: omit
online: online
ooze: ooze
opaque: opaque
operate: operate,operated
operation: operation,operations
operator: operator,operators
opinion: opinion,opinions
opinionated: opinionated
opinionative: opinionative
opportunity: opportunities,opportunity
oppose: oppose,opposed
opposition: opposition
oppressed: oppressed
oppression: oppression
oppressive: oppressive
optics: optics
oracle: oracle
orange: orange
oration: oration
orator: orator,orators
oratory: oratory
orderly: orderly
ordinary: ordinary
ordure: ordure
organ: organs
organize: organized
orifice: orifice
original: original,originals
originally: originally
originator: originator
ornament: ornament,ornaments
ornamental: ornamental
orthography: orthography
outdated: outdated
outer: outer
outermost: outermost
outline: outlines
outlive: outlive,outliving
outward: outward
outwardly: outwardly
oven: oven
overbearing: overbearing
overblow: overblow
overboard: overboard
overburdened: overburdened
overcome: overcome
overflow: overflowing
overhear: overheard
overlook: overlooked
overmatch: overmatch
overmatched: overmatched
overrun: overrun,overrunning
overset: overset
overstock: overstocked
overt: overt
overtake: overtake,overtaken,overtook
overthrow: overthrew
overturn: overturned,overturning
overwhelming: overwhelming
owe: owe,owed
owner: owner,owners
ox: ox
oxen: oxen
oxford: oxford
oyster: oysters
pace: pace,paced,paces
pacific: pacific
pacify: pacify
pack: pack,packs
packthread: packthread,packthreads
paddle: paddle,paddled,paddles,paddling
padlock: padlocks
pail: pail
pain: pain,pains
painful: painful
paint: painted
painter: painters
pair: pair
palace: palace
palatable: palatable
pale: pale
palm: palm,palms
pane: pane
panegyric: panegyric
pannel: pannel
papa: papa
paper: paper,papers
paperwork: paperwork
par: par
paragraph: paragraph,paragraphs
parallel: parallel
parallelogram: parallelograms
parasite: parasites
parcel: parcel
parched: parched
pardon: pardon,pardoned
pare: paring
parent: parent,parents
parish: parish
parity: parity
park: park
parliament: parliament
partial: partial
partiality: partialities,partiality
participle: participles
particle: particles
particulars: particulars
partition: partition,partitions
partly: partly
partridge: partridges
party: parties,party
pass: pass,passed,passes,passing
passage: passage,passages
passenger: passengers
passing: passing
passion: passion,passions
passionately: passionately
paste: paste,pasted
pasteboard: pasteboard
pastern: pastern
pastime: pastimes
pastor: pastors
pat: patting
patch: patch
patent: patent
path: path,paths
patience: patience
patient: patient,patients
patrick: patrick
patrimony: patrimonies
patron: patron
pattern: pattern
paul: paul
pavement: pavements
paw: paw,pawing,paws
pawn: pawned
pay: paid,pay,paying
payment: payment,payments
pea: peas
peace: peace
peaceably: peaceably
pearl: pearls
pebble: pebbles
peccant: peccant
peck: peck
peculiar: peculiar
pecuniary: pecuniary
pedant: pedants
pedlar: pedlars
pedro: pedro
peep: peeped
peeping: peeping
peers: peers
peevish: peevish
peg: pegs
pelt: pelt,pelted
pen: pen,penning
penalty: penalties
pence: pence
pencil: pencil
peninsula: peninsula
penknife: penknife
penny: penny
pension: pension
people: peoples
perceivably: perceivably
perceive: perceive,perceived,perceiving
perception: perception
perch: perch
percolate: percolate
perfect: perfect
perfection: perfection
perfectly: perfectly
perfidiousness: perfidiousness
perform: perform,performed,performing,performs
performance: performance,performances
performer: performers
perfume: perfumes
perihelion: perihelion
peril: peril
period: period,periods
periodic: periodic
periodical: periodical
perjury: perjury
permanent: permanent
permission: permission
permit: permit,permitted
pernicious: pernicious
perpendicularly: perpendicularly
perpetual: perpetual
perpetually: perpetually
perpetuity: perpetuity
perplex: perplex
perplexed: perplexed
perplexity: perplexities,perplexity
persecute: persecuted
persecution: persecution
persecutor: persecutors
persian: persian
person: people,person,persons
personal: personal
personally: personally
perspective: perspective
persuade: persuade,persuaded,persuading
pert: pert
peruse: perused
perverse: perverse
perverseness: perverseness
pervert: pervert,perverting
perverting: perverting
pester: pestered
pestilence: pestilence
peter: peter
petition: petition,petitions
petrify: petrifying
petticoat: petticoat
petulancy: petulancy
phaeton: phaeton
phenomenon: phenomenon
phial: phials
philosopher: philosopher,philosophers
philosophical: philosophical
philosophise: philosophise
philosophy: philosophy
phrase: phrase,phrases
phraseology: phraseology
physic: physic
physical: physical
physician: physician,physicians
pick: pick,picked,picking
pickpocket: pickpocket,pickpockets
picture: picture
piece: piece,pieces
piecemeal: piecemeal
pierce: pierce,pierced,piercing
piety: piety
pigmy: pigmies
pike: pike,pikes
pile: pile,piles
pillage: pillage
pillar: pillar,pillars
pillion: pillion
pillory: pillories
pillow: pillows
pilot: pilot,pilots
pimp: pimping,pimps
pimping: pimping
pimple: pimples
pin: pin,pins
pinch: pinch,pinched
pine: pine
pinion: pinioned
pink: pinks
pinnacle: pinnacle
pint: pint
pious: pious
pipe: pipes
pippin: pippin
pirate: pirate,pirates
pistol: pistols
pistole: pistoles
pit: pit,pits
pitch: pitched
pittance: pittance
pity: pity
plague: plague
plain: plain,plainest
plainly: plainly
plaintiff: plaintiff
plane: plane,planes
planet: planet,planets
plank: plank
plant: planted,planting,plants
plantation: plantations
plaster: plastered
plate: plate,plates
plato: plato
plausibility: plausibility
plausible: plausible
play: play,played,playing,plays
player: players
plaything: plaything
plead: plead,pleaded,pleading
pleader: pleaders
pleading: pleading
pleasant: pleasant
pleasantly: pleasantly
pleased: pleased
pleasing: pleasing
pleasure: pleasure,pleasures
pledge: pledges
plentifully: plentifully
plenty: plenty
plot: plot,plots
plough: ploughing,ploughs
plumb: plumb,plumbed
plume: plume
plunder: plunder,plundering
pocket: pocket,pockets
poet: poet
poetry: poetry
poise: poised
poison: poison,poisoned,poisons
poisoning: poisoning
poisonous: poisonous
poke: poked
polar: polar
pole: pole,poles
policy: policy
polish: polish
polite: polite,politest
politeness: politeness
politer: politer
political: political
politician: politician,politicians
politics: politics
pollute: polluted
polysyllable: polysyllables
pomp: pomp
pompey: pompey
pond: pond
ponderous: ponderous
poor: poor
populous: populous
pork: pork
port: port,ports
portend: portending
porter: porters
portion: portion
portuguese: portuguese
position: position,positions
positive: positive
positiveness: positiveness
possess: possess,possessed
possession: possession,possessions
possibility: possibility
post: post,posted,posts
posterior: posterior,posteriors
posterity: posterity
postillion: postillion
posture: posture
pot: pot,pots
potent: potent
potion: potion
pouch: pouch
pound: pounds
pour: poured
poverty: poverty
powder: powder
power: power,powers
powerful: powerful
pox: pox,poxes
practical: practical
practically: practically
practice: practice,practices
practise: practise,practised,practising
practising: practising
praise: praise,praises
prate: prating
pravity: pravity
pray: pray
precede: preceded,preceding
precedent: precedents
precept: precept,precepts
precinct: precincts
precious: precious
precipice: precipice
precipitancy: precipitancy
precipitate: precipitated
predecessor: predecessor,predecessors
predict: predicted
prediction: predictions
preface: preface
prefer: prefer,preferred,preferring
preferable: preferable
preferment: preferment
pregnant: pregnant
prejudice: prejudice,prejudices
prejudicial: prejudicial
prelate: prelate
preparation: preparations
prepare: prepare,prepared,preparing
prepared: prepared
prescribe: prescribed
prescription: prescription,prescriptions
presence: presence
presently: presently
preservation: preservation
preserve: preserve,preserved,preserving
preside: preside,presided,presides,presiding
press: press,pressed
pressure: pressure
presume: presume,presumed
presumptuous: presumptuous
pretence: pretence
pretend: pretend,pretended,pretending
pretension: pretensions
pretty: pretty
prevail: prevail,prevailed,prevailing
prevent: prevent,prevented,prevents
previous: previous
prey: prey
price: price
prick: pricked
pride: pride,priding
priest: priest,priests
priesthood: priesthood
primary: primary
prime: prime
primitive: primitive
prince: prince,princes
princess: princess,princesses
principal: principal,principals
principally: principally
principle: principle,principles
print: print,printed
printer: printer
printing: printing
prison: prison
prisoner: prisoner
private: private
privately: privately
privilege: privilege,privileges
privy: privy
prize: prizes
probability: probability
probable: probable
problematical: problematical
proceed: proceed,proceeded,proceeding,proceeds
proceeding: proceeding
proceedings: proceedings
proceeds: proceeds
process: process
processing: processing
proclamation: proclamation,proclamations
procure: procure,procured,procures
procurement: procurement
prodigious: prodigious
prodigiously: prodigiously
prodigy: prodigy
produce: produce,produced,producing
production: production,productions
profane: profane
profess: professed,professing
profession: profession
professor: professor,professors
proficiency: proficiency
profit: profit,profits
profitable: profitable
profound: profound
profusion: profusion
prognostic: prognostics
progress: progress,progresses
progressive: progressive
prohibition: prohibition
project: project,projecting,projects
projector: projector,projectors
prominence: prominence
prominent: prominent
prominently: prominently
promise: promise,promised,promises
promote: promoted,promoting
promotion: promotion
prompt: prompted
pronounce: pronounce,pronounced,pronouncing
pronounced: pronounced
proof: proof,proofs
proofread: proofread
propagate: propagate,propagated,propagating
propensity: propensity
proper: proper
properly: properly
property: properties,property
prophet: prophet,prophets
proportion: proportion,proportioned
proportionable: proportionable
proportionably: proportionably
proposal: proposal,proposals
propose: proposed,proposes,proposing
proposition: proposition,propositions
proprietary: proprietary
proprietor: proprietor,proprietors
prose: prose
prosecute: prosecuting
prosecutor: prosecutors
prospect: prospect
prosperity: prosperity
prosperous: prosperous
prostitute: prostitute,prostituted
prostituting: prostituting
prostrate: prostrate,prostrating
protect: protect,protected
protection: protection
protector: protector
protest: protested,protesting
protestant: protestants
prouder: prouder
prove: prove,proved,proving
proverb: proverb
provide: provide,providing
providence: providence
province: province,provinces
provincial: provincial
provision: provision,provisions
provocation: provocation
provocative: provocative
provoke: provoked
prow: prow
prudence: prudence
prudent: prudent
public: public
publication: publication
publicly: publicly
publish: publish,published,publishing
publisher: publisher
pudding: pudding,puddings
pudenda: pudenda
puissant: puissant
pull: pull,pulled,pulling
pulley: pulleys
pulse: pulses
pump: pump
pumpkin: pumpkin
punish: punish,punished
punishment: punishment,punishments
punitive: punitive
pupil: pupils
puppy: puppy
purchase: purchase,purchased
pure: pure
purely: purely
purge: purge
purpose: purpose
purring: purring
purse: purse,purses
pursuant: pursuant
pursue: pursue,pursued,pursuing
pursuit: pursuit
purulent: purulent
push: push,pushed,pushing
pyramid: pyramids
quadrangular: quadrangular
quadrant: quadrant,quadrants
quadruped: quadruped,quadrupeds
quadruply: quadruply
qualification: qualifications
qualified: qualified
qualify: qualify,qualifying
quality: qualities,quality
quantity: quantity
quantum: quantum
quarrel: quarrel,quarrels
quarrelling: quarrelling
quarrelsome: quarrelsome
quarry: quarry
quart: quart
quarter: quarter,quarters
quasi: quasi
queen: queen
quell: quelled
quench: quench
query: queries
question: question,questions
quick: quick
quiet: quiet
quietly: quietly
quilt: quilt,quilted
quilted: quilted
quilting: quilting
quit: quitted
quiver: quiver
rabbit: rabbit,rabbits
rabble: rabble
race: race,races,racing
rack: rack
raffle: raffle,raffling
rag: rags
rage: rage
ragged: ragged
rail: railing
raillery: raillery
rain: rain,rains
raise: raise,raised,raising
rally: rallied,rally
ram: rammed,rams
ramus: ramus
rancid: rancid
range: range
rank: rank,ranked,ranks
ranting: ranting
rap: rapping
rape: rapes
rapine: rapine
rapt: rapt
rapture: rapture
rare: rare
rarely: rarely
rarity: rarities,rarity
rascal: rascal,rascals
rashness: rashness
rat: rat,rats
rate: rate,rated
rational: rational
rattle: rattle
rave: raving
ravenous: ravenous
ravish: ravishing
ravisher: ravishers
raw: raw
ray: rays
razor: razor
reach: reach,reached,reaches,reaching
read: read,reading
readable: readable
reader: reader,readers
readiness: readiness
reading: reading
ready: ready
real: real
reality: reality
realm: realm,realms
reap: reap,reaping
reaper: reapers
rear: reared
reason: reason,reasons
reasonable: reasonable
reasoner: reasoners
reasoning: reasoning,reasonings
rebellion: rebellion,rebellions
rebellious: rebellious
rebuild: rebuild
recapitulate: recapitulate
receipt: receipt
receive: receive,received,receives,receiving
reception: reception
reckon: reckoned,reckoning
reckoning: reckonings
recline: reclined
recluse: recluse
recollect: recollected
recollection: recollections
recommend: recommend,recommended,recommends
recommendation: recommendation
recompense: recompensed
reconcile: reconcile,reconciled
reconcilement: reconcilement
record: record,recorded
recount: recounting
recover: recover,recovered,recovering
recovery: recovery
recruit: recruits
red: red
redistribute: redistribute,redistributing
redistributing: redistributing
redistribution: redistribution
redound: redound
redress: redress
reduce: reduce,reduced,reducing
redundant: redundant
reed: reed
reef: reefed
reek: reeking
reel: reel
refer: refer,referred
reference: references
refine: refine
refined: refined
refinement: refinement
reflect: reflect,reflected,reflecting
reflection: reflection,reflections
reflector: reflectors
reform: reforming
reformation: reformations
refresh: refresh,refreshed
refreshment: refreshment
refuge: refuge
refund: refund,refunding
refusal: refusal
refuse: refuse,refused
regard: regard,regarded
regarded: regarded
regimen: regimen
regiment: regiment
region: region,regions
register: register,registered
regret: regret,regretting
regular: regular
regularity: regularity
regularly: regularly
regulate: regulating
regulation: regulation
reign: reign,reigned,reigning,reigns
reject: reject,rejected,rejects
rejoice: rejoiced
relapse: relapsing
relate: relate,relates,relating
relation: relation,relations
relative: relative
relax: relaxed,relaxing
release: release
relief: relief
relieve: relieve,relieved
relieved: relieved
religion: religion
religious: religious
relish: relish
reluctance: reluctance
reluctancy: reluctancy
rely: rely
remain: remain,remained,remaining
remainder: remainder
remark: remark,remarked,remarks
remarkable: remarkable
remarker: remarkers
remedy: remedies,remedy
remember: remember,remembered,remembering
remembrance: remembrance
remote: remote,remotest
remove: remove,removed,removing
rename: renamed
render: render,rendered,rendering,renders
renew: renewed
renounce: renounce
renown: renown
renowned: renowned
repair: repair,repaired,repairing
repartee: repartees
repast: repast
repeal: repealed
repeat: repeat,repeated,repeating
repel: repelling
repent: repent
repetition: repetition,repetitions
repine: repine
repining: repining
replace: replace
replacement: replacement
replenish: replenish
repletion: repletion
reply: replied,reply
report: report,reported,reports
repose: reposed
repository: repository
represent: represent,represented
representation: representation,representations
representative: representative,representatives
reprimand: reprimanded
reproach: reproach
reprobate: reprobate
repulsive: repulsive
reputation: reputation
request: request,requested
require: require,required,requires,requiring
required: required
requirement: requirements
requisite: requisite
requite: requite
resemblance: resemblance
resemble: resemble,resembled,resembling
resent: resent,resented
resentment: resentment,resentments
reserve: reserve
reside: resided
residence: residence
resist: resist
resistance: resistance
resolutely: resolutely
resolution: resolution
resolve: resolve,resolved,resolving
resort: resort
respect: respect
respectful: respectful
respects: respects
rest: rest,rested
restiff: restiff
resting: resting
restive: restive
restless: restless
restore: restore,restored
restorer: restorers
restriction: restrictions
result: result
resume: resume,resumed
resurrection: resurrection
retain: retain,retained
retinue: retinue
retire: retire,retired,retires
retirement: retirement
retreat: retreat,retreated,retreats
return: return,returned,returning,returns
revenge: revenge
revengeful: revengeful
revenue: revenue
reverence: reverence
reverend: reverend
review: review
revise: revised
revive: revive,revived
revolution: revolution,revolutions
revolve: revolve,revolves
reward: reward,rewarded,rewards
rewarding: rewarding
rhomb: rhombs
rich: rich,richer,richest
richard: richard
riches: riches
rickety: rickety
rid: rid
ride: ride,riding,rode
rider: rider,riders
ridge: ridge,ridges
ridicule: ridicule,ridiculed
ridiculous: ridiculous
riding: riding
rigging: rigging
rightly: rightly
rigorous: rigorous
rim: rim
ringleader: ringleaders
rip: rip
rise: rise,risen,rising,rose
rising: risings
rival: rival
river: river,rivers
rivulet: rivulet,rivulets
road: road,roads
roar: roar,roared,roaring
roast: roast
roasted: roasted
rob: rob,robbing
robber: robbers
robbery: robbery
robert: robert
robinson: robinson
robust: robust
rock: rock,rocks
rocky: rocky
rod: rods
rogue: rogue,rogues
roguery: roguery
roll: rolled,rolling
roman: roman
romance: romance
rome: rome
roof: roof,roofs
root: root,rooted,roots
rope: rope,ropes
rotten: rotten
rottenness: rottenness
rough: rough
rouse: rouse,roused
row: row,rowed,rows
rowing: rowing
royal: royal
royalty: royalties,royalty
rub: rub,rubbed
rubbish: rubbish
rude: rude
rudiment: rudiments
rue: rue
ruin: ruin,ruined,ruins
ruinous: ruinous
rule: rule,rules,ruling
rummage: rummaging
rush: rush,rushing
rust: rust
rustic: rustic
sabbath: sabbath
sack: sacks
sackcloth: sackcloth
sacred: sacred
sacrifice: sacrificing
sad: sad
saddle: saddle
safe: safe,safer
safely: safely
safety: safety
sagacity: sagacity
sage: sages
sail: sail,sailed,sails
sailing: sailing
sailor: sailor,sailors
sake: sake
salad: salads
salary: salary
salisbury: salisbury
saliva: saliva
sallow: sallow
salt: salt,salts
salutation: salutation,salutations
sample: sample
san: san
sanctity: sanctity
sash: sash,sashes
satellite: satellites
satisfaction: satisfaction
satisfied: satisfied
satisfy: satisfied,satisfy
sauce: sauces
sausages: sausages
savage: savage,savages
save: save,saved,saving
scabbard: scabbard
scaffold: scaffold
scald: scalded
scale: scale
scandal: scandal
scandalous: scandalous
scanty: scanty
scarce: scarce
scarcely: scarcely
scared: scared
scene: scene,scenes
scent: scent
scheme: scheme,schemes
schism: schism,schisms
scholar: scholars
school: school,schools
schoolboy: schoolboys
science: science,sciences
scimitar: scimitar
score: score
scott: scott
scoundrel: scoundrels
scourge: scourge
scout: scouts
scrap: scraps
scrape: scraping
scratch: scratch
scratching: scratching
scream: scream,screamed
screw: screw,screwed
scribble: scribbles,scribbling
scribe: scribes
scrofulous: scrofulous
scruple: scruple,scruples
scrupulous: scrupulous
scrutoire: scrutoire
scud: scudded
scull: sculls
scum: scumming
scurvy: scurvy
scythe: scythe,scythes
sea: sea,seas
seal: seal,sealed
seaman: seamen
seamen: seamen
seaport: seaport
search: search,searched,searching
searcher: searchers
seas: seas
seaside: seaside
season: season
seasonable: seasonable
seat: seat,seated,seats
secluded: secluded
secret: secret,secrets
secretary: secretaries,secretary
sect: sect,sects
secure: secure,secured
security: security
sedan: sedan
seduce: seduce,seduced
seducement: seducement
seed: seeds
seek: seek,seeking,sought
seize: seize,seized,seizes,seizing
seizure: seizure
seldom: seldom
sell: sell,selling,sold
selling: selling
semicircle: semicircle
seminal: seminal
seminary: seminary
senate: senate,senates
senator: senator,senators
send: send,sending,sends
senior: seniors
sense: sense
sensibly: sensibly
sensitive: sensitive
sensuality: sensuality
sentence: sentence,sentences
sentiment: sentiments
sentry: sentry
separate: separated,separating
september: september
serene: serene
series: series
seriousness: seriousness
serpent: serpents
servant: servant,servants
serve: serve,served
service: service,services
serviceable: serviceable
servile: servile
servilely: servilely
servitude: servitude
set: set,sets,setting
setting: setting
settle: settle,settled,settling
settlement: settlements
seventh: seventh
severe: severe
severely: severely
severity: severities,severity
sew: sewn
sex: sex,sexes
sextant: sextants
sextumvirate: sextumvirate
shade: shade
shake: shake,shaken,shaking,shook
shallow: shallow,shallower
shame: shame
shape: shape,shaped,shapes
shapen: shapen
share: share,shared,sharing
sharp: sharp
sharpen: sharpened
sharper: sharpers
sharpness: sharpness
shave: shave,shaved
sheaf: sheaves
sheathe: sheathed
sheep: sheep
sheet: sheet,sheets
shelf: shelf
shellfish: shellfish
shelter: shelter
shift: shift,shifted
shilling: shilling,shillings
shin: shin
shine: shining,shone
ship: ship,ships
shipping: shipping
shipwreck: shipwreck,shipwrecked
shipwrecked: shipwrecked
shirt: shirt,shirts
shoal: shoals
shock: shock
shocking: shocking
shoe: shoe,shoes
shoot: shoot,shooting,shot
shop: shop,shops
shopkeeper: shopkeepers
shore: shore
short: short,shorter,shortest
shorten: shorten,shortened
shortening: shortening
shortness: shortness
shot: shots
shoulder: shoulder,shoulders
shout: shout,shouted,shouts
shouting: shouting
shove: shove,shoved
shower: shower
shriek: shriek
shrill: shrill,shriller
shropshire: shropshire
shudder: shuddering
shuffling: shuffling
shut: shut,shutting
shuttle: shuttle
shy: shy
sick: sick
sickness: sickness
sidle: sidling
siege: siege,sieges
sieve: sieve
sift: sifted
sigh: sigh
sight: sight
sighted: sighted
sign: sign,signed,signs
signal: signal
signet: signet
signification: signification
signify: signifies,signify,signifying
silence: silence
silent: silent
silk: silk,silks
silken: silken
silkworm: silkworms
silly: silly
silver: silver
similarity: similarity
simile: similes
simple: simple,simplest
simplicity: simplicity
sincerity: sincerity
sinew: sinews
singe: singed
single: single
singular: singular
singularity: singularity
sinister: sinister
sink: sink,sinking,sunk
sir: sir
sirloin: sirloin
sister: sister
sit: sat,sit,sitting
sitting: sitting
situate: situated
situation: situation
sixteen: sixteen
sixth: sixth
size: size
skeleton: skeleton
skilful: skilful
skilfully: skilfully
skill: skill
skilled: skilled
skin: skin,skins
skip: skip
skipper: skipper
skirmish: skirmishes
skirt: skirts
skull: skull,skulls
sky: sky
slacken: slacken,slackened
slash: slash
slave: slave,slaves
slavery: slavery
slavish: slavish
sledge: sledge
sleep: sleep,sleeping,slept
sleepy: sleepy
sleeve: sleeve,sleeves
slender: slender
slight: slight
slime: slime
sling: slung
slip: slip,slipped,slipping
slit: slits
sloe: sloe
sloop: sloop
slope: sloping
sloth: sloth
slow: slow
slowly: slowly
smart: smart
smattering: smattering
smell: smell,smelling,smelt
smile: smile,smiling
smite: smitten
smith: smith
smithfield: smithfield
smock: smocks
smoke: smoke
smooth: smooth,smoother,smoothest,smoothing
smoothness: smoothness
snail: snail,snails
snatch: snatch,snatched
sneeze: sneeze,sneezing
snout: snouts
snuff: snuff
sober: sober
society: society
socrates: socrates
sodomite: sodomites
sodomy: sodomy
soever: soever
soft: soft,softest
soften: softening
softly: softly
softness: softness
soil: soil
sojourn: sojourned
soldier: soldier,soldiers
sole: sole,soled
soled: soled
solemn: solemn
solemnly: solemnly
solicit: solicit,solicited
solicitation: solicitation,solicitations
solid: solid,solids
solitary: solitary
solitude: solitude
solution: solution
solve: solve,solved
son: son,sons
song: song
sooty: sooty
soporiferous: soporiferous
sorcerer: sorcerers
sordid: sordid
sore: sore
sorrel: sorrel
sorrow: sorrow,sorrows
sort: sort,sorts
soul: souls
sound: sound,sounded,sounder,sounding
soundly: soundly
sour: sour
south: south
southern: southern
southward: southward
sovereign: sovereign
sow: sow
sowing: sowing
space: space
spangle: spangle
spaniards: spaniards
spaniel: spaniel
spanish: spanish
spare: spare,spared
spark: spark
sparrow: sparrow,sparrows
spartan: spartan
spawn: spawn
speak: speak,speaking,speaks,spoke,spoken
speaker: speaker
speaking: speaking
spear: spears
special: special
species: species
specific: specific
spectacle: spectacle
spectacles: spectacles
spectator: spectator,spectators
spectre: spectres
speculation: speculation,speculations
speculative: speculative
speech: speech,speeches
speed: speed
speedy: speedier,speedy
spell: spelt
spend: spend,spent
spending: spending
sphere: spheres
spider: spider,spiders
spin: spin
spinet: spinet
spire: spire,spires
spirit: spirit,spirits
spiritual: spiritual
spit: spit,spits
spite: spite
spleen: spleen
splendid: splendid
splinter: splinters
split: split
spoil: spoiled,spoiling,spoils
spoiled: spoiled
spoon: spoons
spoonful: spoonful
spooning: spooning
sport: sports
spot: spot,spots
spout: spouted
spread: spread
spring: sprang,spring,springs
springe: springes
sprit: sprit
spruce: spruce
sprug: sprugs
spur: spur
spurn: spurn
spy: spied
squall: squall
squalling: squalling
square: square,squares
squash: squash
squashed: squashed
squeeze: squeeze,squeezed,squeezes,squeezing
squirrel: squirrel
stable: stable,stables
staff: staff
stag: stag
stage: stage
staid: staid
stair: stairs
stake: stakes
stale: stale
stalk: stalks
stamp: stamp,stamping
stand: stand,standing,stands,stood
standard: standard
standing: standing
stang: stang
staple: staples
star: star,stars
starboard: starboard
stare: stare,stared
stark: stark
start: start,started,starting
startle: startled
starve: starve,starved,starving
statement: statements
statesman: statesmen
station: station
statue: statues
stature: stature
status: status
statute: statute
staunch: staunch
stay: stay,stayed
steal: steal,stealing,steals,stole
stealth: stealth
steed: steed
steel: steel
steep: steep
steeple: steeple
steer: steer,steered
steering: steering
stem: stem
stench: stench
step: step,stepped,stepping,steps
stept: stept
steward: steward
stick: stick,sticking,sticks,stuck
stiff: stiff
stifle: stifle,stifled
stile: stile
sting: stings,stung
stink: stink
stipulate: stipulates
stir: stir,stirring
stitch: stitched
stock: stock,stocking
stocking: stockings
stomach: stomach
stomacher: stomacher
stone: stone,stones
stony: stony
stool: stool,stools
stoop: stoop,stooped
store: store,stored,stores
storm: storm,storms
story: stories,story
stout: stout
stow: stowed
straggler: stragglers
straight: straight
strain: strain,strained
strained: strained
strait: strait,straits
straits: straits
strand: strand
strange: strange
strangely: strangely
stranger: stranger,strangers
stratagem: stratagem
straw: straw
stray: stray
stream: stream
street: street,streets
strength: strength
strengthen: strengthening
strew: strew,strewed,strewing
strict: strict,strictest
strictly: strictly
strictness: strictness
stride: stride,strides
strike: strike,strikes,striking,struck
string: string,strings,strung
strip: strip,stripped,stripping
strive: strive,striving,strove
stroke: stroke,stroked,strokes,stroking
stroll: strolling
strong: strong,stronger,strongest
structure: structure
struggle: struggle,struggling
struldbrug: struldbrug
strut: strutting
stubborn: stubborn
student: student,students
studious: studious
studiously: studiously
study: studied,studies,study
stuff: stuff
stumble: stumble
stump: stumps
stumps: stumps
stun: stunned
stunned: stunned
stupid: stupid
style: style
subaltern: subaltern
subdivision: subdivisions
subdue: subdue
subject: subject,subjects
sublime: sublime
sublunary: sublunary
submissive: submissive
submit: submit,submits,submitted
subornation: subornation
suborner: suborner
suborning: suborning
subscribe: subscribe,subscribed
subservience: subservience
subservient: subservient
subsidy: subsidies
substance: substance,substances
substantial: substantial
succeed: succeed,succeeding,succeeds
success: success
successful: successful
succession: succession,successions
successively: successively
successor: successor,successors
suck: suck
suckle: suckle
sudden: sudden
suddenly: suddenly
suds: suds
sue: sue
suffer: suffer,suffered,suffering
sufferer: sufferer
suffering: sufferings
suffice: suffice
sufficient: sufficient
sugar: sugar
suit: suit,suited,suits
suitable: suitable
sullen: sullen
sum: sum,sums
summary: summary
summer: summer,summers
summerset: summerset
summon: summoned
sun: sun,suns
sunbeam: sunbeams
sunburnt: sunburnt
sunrise: sunrise
sunset: sunset
sunshine: sunshine
superficies: superficies
superior: superior
superiority: superiority
supper: supper
supplicate: supplicating
supplicating: supplicating
supply: supplied,supply,supplying
support: support,supported,supporting
supportable: supportable
suppose: suppose,supposed,supposing
supposition: supposition,suppositions
suppress: suppressing
surat: surat
surface: surface
surgeon: surgeon,surgeons
surprise: surprise,surprised
surprised: surprised
surprising: surprising
surround: surround,surrounded
survey: survey,surveyed
survive: survive
suspect: suspect,suspected,suspecting
suspend: suspended
suspicion: suspicion,suspicions
sustain: sustain,sustained
sustenance: sustenance
swagger: swagger
swallow: swallow,swallowed
swam: swam
swamp: swamp
swan: swan
sway: swayed
swear: swear,swearing,swore
swearer: swearers
sweat: sweat
sweep: swept
sweet: sweet,sweeter
sweetmeat: sweetmeats
swell: swelled
swerve: swerve,swerved
swift: swift
swiftness: swiftness
swim: swam,swim,swimming,swims
swimmer: swimmer
swimming: swimming
swine: swine
swoon: swoon,swooned
sword: sword,swords
syllable: syllable,syllables
synonymous: synonymous
table: table,tables
tack: tack,tacks
tackle: tackling
taction: taction
tail: tail,tails
tailor: tailor,tailors
tale: tales
talent: talent,talents
talk: talk,talked,talking
talkative: talkative
talker: talkers
tall: tall,taller,tallest
tallow: tallow
tally: tally
talon: talons
tame: tame
tameness: tameness
tangible: tangible
tartary: tartary
taste: taste,tasted
tax: tax,taxed,taxes
teach: taught,teach,teaches,teaching
teachable: teachable
teachableness: teachableness
teaching: teaching
tear: tear,tearing,tears,tore,torn
teat: teats
tedious: tedious
tediousness: tediousness
telescope: telescopes
temper: temper,tempered
temperance: temperance
temperature: temperature
tempest: tempest,tempests
temple: temple
tempt: tempted
temptation: temptation
tempting: tempting
tenant: tenants
tend: tended,tending
tendency: tendency
tender: tender
tenderness: tenderness
teneriffe: teneriffe
tennis: tennis
tense: tenses
tent: tents
tenth: tenth
tenure: tenure
term: term,terms
terminate: terminate,terminated,terminating
terrible: terrible
terribly: terribly
terrified: terrified
terrify: terrify
territory: territory
terror: terror
thames: thames
thankfulness: thankfulness
theatre: theatre
thee: thee
theft: theft
thenceforward: thenceforward
theology: theology
theory: theory
thereabout: thereabouts
thereon: thereon
therewith: therewith
thicket: thicket
thickness: thickness
thief: thieves
thigh: thighs
thimble: thimble,thimbles
thinking: thinking
thirst: thirst
thirteen: thirteen
thither: thither
thomas: thomas
thoughtful: thoughtful
thread: thread,threading,threads
threaten: threatened,threatening
threepence: threepence
threescore: threescore
thrice: thrice
thrift: thrift
thrifty: thrifty
throat: throat,throats
throne: throne
throw: threw,throw,throwing,thrown
thrush: thrush
thrust: thrust,thrusting
thumb: thumb
thunder: thunder
thyme: thyme
thyself: thyself
ticking: ticking
tickle: tickled
tide: tide,tides
tie: tied
tight: tight
tile: tile
tillage: tillage
timber: timber
time: time,times
tincture: tincture
tired: tired
title: title,titles
toad: toad,toads
toast: toasted
tobacco: tobacco
toe: toe
toil: toil
toilet: toilet
token: token,tokens
tolerable: tolerable
tolerably: tolerably
tolerate: tolerate
tom: tom
tomb: tombs
ton: tons
tone: tone
tong: tongs
tongue: tongue,tongues
tool: tools
tooth: teeth,tooth
topic: topics
topmast: topmast
tops: tops
torch: torches
torrent: torrent
tortoise: tortoise
torture: torture,tortured
tory: tory
toss: tossed
touch: touch,touched,touching
tough: tough
tour: tour
tow: tow,towed
towardly: towardly
tower: tower,towers
town: town,towns
toy: toy,toys
trace: trace
tract: tract,tracts
tractable: tractable
trade: trade,traded,trades
trademark: trademark
trader: traders
tradesman: tradesmen
trading: trading
tradition: tradition,traditions
traditional: traditional
traffic: traffic
train: train,trained
traitor: traitor,traitors
traitorously: traitorously
trample: trample,trampled,trampling
tranquillity: tranquillity
transact: transact,transacted
transaction: transactions
transcendental: transcendentals
transcribe: transcribe,transcribed
transcription: transcription
translate: translate,translated
translation: translation,translations
transmit: transmitted
transparent: transparent
transport: transporting,transports
transpose: transposing
trap: trap
travel: travel,travelled,travelling,travels
traveller: traveller,travellers
travelling: travelling
travels: travels
tray: tray
treacherous: treacherous
treachery: treachery
tread: tread,treading,trod
treason: treason
treasure: treasure
treasurer: treasurer
treasury: treasury
treat: treat,treated,treating,treats
treatise: treatise
treatment: treatment
treaty: treaty
treble: treble,trebled
tree: tree,trees
tremble: trembled,trembling
trencher: trencher
trial: trial,trials
triangle: triangle
tribe: tribe,tribes
tribute: tribute
trick: trick,tricks
trickle: trickling
trifle: trifle
trifling: trifling
trinket: trinkets
trip: trip,tripping
triumph: triumph
trod: trod
troop: troop
troops: troops
tropics: tropics
trot: trot,trotted,trotting
trouble: trouble,troubled,troubles
troubled: troubled
troublesome: troublesome
troubling: troubling
trough: trough
true: true,truest
trumpet: trumpet,trumpets
truss: trussed
trust: trust,trusted
trusty: trusty
truth: truth
tube: tube,tubes
tuft: tufts
tug: tugging
tulip: tulips
tumble: tumble,tumbling
tumbril: tumbril
tumour: tumours
tun: tun,tuns
tune: tune,tunes
tunnel: tunnels
turkey: turkey,turkeys
turret: turret
tutor: tutor,tutors
tutus: tutus
tweak: tweak
twelfth: twelfth
twist: twisted,twisting
type: types
tyranny: tyranny
tyrant: tyrant,tyrants
ugly: ugly
unable: unable
unacceptable: unacceptable
unaccountable: unaccountable
unaccountably: unaccountably
unacquainted: unacquainted
unacquaintedness: unacquaintedness
unanimity: unanimity
unanimous: unanimous
unanimously: unanimously
unarmed: unarmed
unartfully: unartfully
unavoidable: unavoidable
unbecoming: unbecoming
unbind: unbound
unbound: unbound
unbrace: unbraced
unbutton: unbuttoned
uncertain: uncertain
unchastity: unchastity
uncle: uncle
uncleanly: uncleanly
uncomfortable: uncomfortable
uncommon: uncommon
unconcerned: unconcerned
uncorrect: uncorrect
uncouth: uncouth
uncover: uncovered
undeceive: undeceive
undeceived: undeceived
undergo: undergo,undergone,underwent
underground: underground
undermine: undermines,undermining
understand: understand,understanding,understood
understanding: understanding,understandings
undertake: undertake,undertaken,undertook
undistinguishing: undistinguishing
undo: undone
undoubtedly: undoubtedly
undress: undress
uneasiness: uneasiness
uneasy: uneasy
unenforceability: unenforceability
unerring: unerring
uneven: uneven
unexpected: unexpected
unfortunate: unfortunate
unhandy: unhandy
unhappily: unhappily
unhappiness: unhappiness
unhappy: unhappy
unharnessed: unharnessed
uniform: uniform
uninhabited: uninhabited
unintelligible: unintelligible
united: united
universal: universal
universally: universally
universe: universe
university: university
unjust: unjust
unjustly: unjustly
unknown: unknown
unlink: unlink
unlock: unlock,unlocked
unluckily: unluckily
unlucky: unlucky
unmoved: unmoved
unnatural: unnatural
unnecessary: unnecessary
unperceived: unperceived
unpleasant: unpleasant
unprotected: unprotected
unqualified: unqualified
unreasonable: unreasonable
unscrew: unscrew
unseasonable: unseasonable
unskilful: unskilful
unskilled: unskilled
unsolicited: unsolicited
unsound: unsound
unspeakable: unspeakable
unteachable: unteachable
untie: untie
unused: unused
unusual: unusual
unversed: unversed
unwary: unwary
unwillingness: unwillingness
unwise: unwise
update: updated
upholsterer: upholsterer
upper: upper
uppermost: uppermost
upright: upright
uproar: uproar
upside: upside
upward: upward
urchin: urchin
urge: urged,urging
urgency: urgency
urine: urine
usage: usage
useless: useless
user: user
usher: usher
usual: usual
usurper: usurpers
ut: ut
utensil: utensils
utmost: utmost
utopia: utopia
utter: utter
utterly: utterly
vacancy: vacancy
vacant: vacant
vain: vain
valet: valet,valets
valour: valour
valuable: valuable
van: van
vanilla: vanilla
vanish: vanished
vanity: vanity
vapours: vapours
variance: variance
variation: variations
varied: varied
variety: variety
variously: variously
varlet: varlet
vary: vary,varying
vassal: vassal
vast: vast
vault: vaulted,vaults
veal: veal
vegetable: vegetables
vehemence: vehemence
vehemently: vehemently
vehicle: vehicle,vehicles
vein: veins
vend: vend
venerable: venerable
veneration: veneration
venice: venice
venture: venture,ventured,venturing
veracity: veracity
verb: verbs
verbal: verbal
verge: verge
verify: verify
verily: verily
vermin: vermin
vernal: vernal
versailles: versailles
verse: verse,versed,verses
version: version
vertical: vertical
vertigo: vertigos
vessel: vessel,vessels
vex: vexed
vexation: vexation
vexatious: vexatious
vial: vials
vice: vice,vices
viceroy: viceroy
vicious: vicious
victor: victor,victors
victorious: victorious
victory: victory
victuals: victuals
view: view,viewed,viewing,views
vigilance: vigilance
vigilant: vigilant
vigour: vigour
vii: vii
viii: viii
vile: vile,vilest
village: village,villages
villain: villains
vindicate: vindicate,vindicated
vindication: vindication
vinegar: vinegar
vineyard: vineyards
violate: violated,violates
violation: violation
violence: violence
violent: violent
violently: violently
virgil: virgil
virtue: virtue,virtues
virtuosi: virtuosi
virtuoso: virtuosos
virtuous: virtuous
virus: virus
visage: visage
viscous: viscous
visible: visible
visibly: visibly
vision: vision,visions
visionary: visionary
visit: visit,visited,visits
vista: vista
vivacity: vivacity
vocabulary: vocabulary
vogue: vogue
voice: voice,voices
void: void,voided
volatile: volatile
volcano: volcanoes
volley: volley
volume: volume,volumes
volunteer: volunteer,volunteers
vomit: vomit
vortex: vortices
vote: vote,votes
voter: voters
voting: voting
voucher: vouchers
vow: vowing
voyage: voyage,voyages
vulgar: vulgar
wade: waded,wading
wafer: wafer
waft: wafted
wag: wagging
wages: wages
waggoner: waggoners
waist: waist
waistband: waistband
waistcoat: waistcoat
wait: wait,waited,waiting
waiter: waiters
waiting: waiting
wake: waked,waking
walk: walk,walked,walking,walks
walking: walking
wall: wall,walls
walled: walled
wallow: wallowing
wander: wandered
wapping: wapping
war: war,wars
warden: warden
warm: warm
warn: warning
warning: warning
warrant: warrant
warranty: warranties,warranty
warrior: warriors
wash: washed,washing
wasp: wasp,wasps
waste: waste,wasted
watch: watch,watched,watching
watchful: watchful
water: water
wattle: wattled,wattles
wave: wave,waved,waves,waving
weak: weak,weaker,weakest
weaken: weakened
weakness: weakness
weal: weal
wealth: wealth
wealthy: wealthiest
weapon: weapons
wear: wear,wore,worn
weariness: weariness
weary: weary
weasel: weasel,weasels
weather: weather
weathercock: weathercock
weave: weave,wove
weaver: weaver,weavers
wedge: wedged,wedges
wednesday: wednesday
weed: weed,weeded
week: week,weeks
weekly: weekly
weep: weeping
weigh: weigh
weight: weight,weights
weighty: weighty
welch: welch
wen: wen
wench: wench
west: west
westerly: westerly
western: western
westminster: westminster
westward: westward
wet: wet,wetting
whale: whale,whales
whatsoever: whatsoever
wheel: wheel,wheels
whereat: whereat
whereof: whereof
wherewith: wherewith
wherry: wherry
whey: whey
whig: whig
whip: whip,whipped
whipping: whipping
whipt: whipt
whisper: whisper,whispered,whispering
whistle: whistle,whistling
white: white,whiter,whitest
whiteness: whiteness
wholesome: wholesome
wholesomer: wholesomer
wholly: wholly
whore: whore,whores
whoremonger: whoremonger
whoring: whoring
wide: wide,widest
wideness: wideness
widespread: widespread
widow: widow
wife: wife,wives
wight: wight
wild: wild
wildly: wildly
wilful: wilful
wilfulness: wilfulness
william: william
williams: williams
willingly: willingly
wind: wind,winds
window: window,windows
windward: windward
windy: windy
wine: wine
wing: wing,wings
wink: winked
winnow: winnow
winter: winter,wintered
wipe: wipe,wiped,wiping
wire: wire,wires
wisdom: wisdom
wise: wise,wiser,wisest
wisp: wisp
wistful: wistful
wit: wit,wits
withdraw: withdraw,withdrew
withe: withes
wither: withered
witness: witness,witnesses
woful: woful
wolf: wolves
woman: woman,women
womankind: womankind
wonderful: wonderful
wood: wood,woods
wooden: wooden
woodman: woodmen
woody: woody
wool: wool
woollen: woollen
word: word
workman: workman,workmen
workmanship: workmanship
worm: worms
worship: worships
worth: worth
worthy: worthy
wound: wound,wounded,wounds
wrap: wrapped
wrench: wrench
wrestle: wrestle
wretched: wretched
wring: wrung
wrist: wrist
writ: writ
write: write,writing,written,wrote
writer: writer,writers
writing: writing
writings: writings
wrong: wrong,wronged
xi: xi
xii: xii
yahoo: yahoo,yahoos
yard: yard,yards
yellow: yellow
yeoman: yeoman,yeomen
yerk: yerks
yield: yield,yielded,yields
youth: youth
zeal: zeal
zealot: zealots
zealous: zealous
zenith: zenith
zodiac: zodiac
