aback: aback
abandon: abandon,abandoned,abandoning
abase: abasing
abasement: abasement
abashed: abashed
aberration: aberration
ability: abilities,ability
abject: abject
abnegation: abnegation
abnormal: abnormal
abnormality: abnormalities,abnormality
abode: abode
abolish: abolish,abolished
abolition: abolition
abominable: abominable
abraham: abraham
abreast: abreast
abrupt: abrupt
abruptly: abruptly
absence: absence
absent: absent
absolute: absolute
absolutely: absolutely
absolution: absolution
absolve: absolve,absolved
absorb: absorbed,absorbing
absorption: absorption
abstinence: abstinence
abstract: abstract
absurd: absurd
absurdity: absurdities,absurdity
abundance: abundance
abundant: abundant
abuse: abuse,abused,abuses,abusing
abusive: abusive
abyss: abyss
academy: academy
accede: accede
accent: accent
accentuate: accentuated
accept: accept,accepted,accepting
acceptable: acceptable
access: access
accessory: accessory
accident: accident
accidentally: accidentally
acclaim: acclaim,acclaimed
accommodate: accommodating
accompany: accompanied,accompanies,accompany,accompanying
accomplice: accomplice,accomplices
accomplish: accomplish,accomplished,accomplishing
accord: accord
account: account,accounts
accumulate: accumulated,accumulating
accumulation: accumulation
accurately: accurately
accurse: accursed
accursed: accursed
accusation: accusation,accusations
accuse: accuse,accused,accuses,accusing
accustom: accustomed
accustomed: accustomed
ace: ace
ach: ach
ache: ache,ached,aches,aching
achieve: achieve
achievement: achievement,achievements
acknowledge: acknowledge,acknowledged,acknowledging
acquaint: acquainted
acquaintance: acquaintance,acquaintances
acquiesce: acquiesced
acquiescence: acquiescence
acquire: acquire,acquired
acquirement: acquirements
acquisitive: acquisitive
acquit: acquit,acquitted
acquittal: acquittal
acre: acres
action: action,actions
active: active
actively: actively
activity: activity
actor: actor,actors
acts: acts
actual: actual
actuality: actuality
actuate: actuated
acute: acute
acutely: acutely
acutest: acutest
adam: adam
add: add,adding,adds
addition: addition
additional: additional
address: address,addressed,addressing
adept: adept
adequate: adequate
adhere: adhered,adheres
adherent: adherents
adjoin: adjoining
adjoining: adjoining
adjourn: adjourned
administer: administered,administering
administrative: administrative
admiration: admiration
admire: admire,admired,admiring
admirer: admirer
admission: admission
admit: admit,admits,admitted,admitting
admonish: admonished
admonition: admonition,admonitions
adopt: adopt,adopting
adoption: adoption
adoration: adoration
adore: adore,adored,adores,adoring
adored: adored
adorn: adorning
adrift: adrift
adroitly: adroitly
advance: advance,advanced,advances,advancing
advanced: advanced
advantage: advantage
advantageous: advantageous
adventure: adventure,adventures
adversary: adversary
advertise: advertise
advice: advice
advise: advise,advised,advising
adviser: adviser
advocate: advocate
afar: afar
affable: affable
affably: affably
affair: affair,affairs
affaire: affaire
affect: affect
affectation: affectation
affectedly: affectedly
affection: affection,affections
affectionate: affectionate
affectionately: affectionately
affirm: affirm,affirmed,affirms
affirmative: affirmative
afflict: afflicted
affront: affront,affronted
aflame: aflame
afraid: afraid
afresh: afresh
afternoon: afternoon
age: age,aged,ages
aged: aged
agent: agent
aggressive: aggressive
aggrieved: aggrieved
aghast: aghast
agile: agile
agility: agility
agitate: agitated
agitated: agitated
agitation: agitation
agonized: agonized
agonizing: agonizing
agonizingly: agonizingly
agony: agonies,agony
agree: agree,agreed
agreeable: agreeable
agreement: agreement,agreements
aha: aha
aid: aid
ail: ailing
aim: aim,aimed,aiming,aims
aimless: aimless
air: air,airs
airily: airily
ajar: ajar
akim: akim
akin: akin
alacrity: alacrity
alarm: alarm,alarmed
alarmed: alarmed
alarming: alarming
alas: alas
album: album
alert: alert
alexander: alexander
alight: alight
alike: alike
alive: alive
allay: allay
allege: alleged,alleges
allegory: allegory
alleviate: alleviate
alley: alley,alleys
allowance: allowance,allowances
allude: allude,alluded
allure: allure,allured
allurement: allurements
alluring: alluring
allusion: allusion,allusions
almighty: almighty
alms: alms
almshouse: almshouse
aloft: aloft
aloof: aloof
aloud: aloud
altar: altar
alter: alter,altered
altercation: altercations
alternative: alternative
altogether: altogether
amass: amassing
amazed: amazed
amazement: amazement
amazing: amazing
amazingly: amazingly
ambitious: ambitious
ambush: ambush
amend: amend,amends
america: america
amethyst: amethyst
amiable: amiable
amicably: amicably
amiss: amiss
amorous: amorous
ample: ample
amply: amply
amulet: amulet
amuse: amuse,amused,amusing
amused: amused
amusement: amusement
amusing: amusing
analogous: analogous
analysis: analysis
analyze: analyze,analyzed,analyzing
anarchism: anarchism
anarchist: anarchists
anathema: anathema
anchor: anchor
ancient: ancient
anecdote: anecdote,anecdotes
anew: anew
angel: angel,angels
angelic: angelic
anger: anger,angered,angering
angle: angles
angrily: angrily
angry: angrier,angry
anguish: anguish
angular: angular
animal: animal,animals
animated: animated
animation: animation
ankle: ankles
anna: anna
annex: annexed
annihilate: annihilated
annihilation: annihilation
anno: anno
announcement: announcement
annoy: annoy,annoyed,annoys
annoyance: annoyance
annoyed: annoyed
annoying: annoying
anonymous: anonymous
answer: answer,answered,answering,answers
answerable: answerable
ant: ant
antagonist: antagonist
antagonistic: antagonistic
anthem: anthem
antic: antics
anticipate: anticipate,anticipated,anticipating
anticipation: anticipation
antipathy: antipathies,antipathy
antiquity: antiquities
anxiety: anxieties,anxiety
anxious: anxious
anxiously: anxiously
apartment: apartment,apartments
ape: ape
apiary: apiary
apocryphal: apocryphal
apologetically: apologetically
apologize: apologize,apologized,apologizing
apology: apologies,apology
apostle: apostle
apostles: apostles
apothecary: apothecary
appalling: appalling
appallingly: appallingly
apparent: apparent
apparition: apparition
appeal: appeal,appealed,appealing,appeals
appealing: appealing
appearance: appearance,appearances
appease: appease
appetite: appetite
applaud: applauded,applauding
applause: applause
apple: apple,apples
apply: applied,apply,applying
appoint: appointed
appointment: appointment
apportion: apportioned
appreciable: appreciable
apprehend: apprehend
apprehension: apprehension,apprehensions
apprehensive: apprehensive
apprehensively: apprehensively
approach: approach,approached,approaching
approbation: approbation
appropriation: appropriation
approval: approval
approve: approve,approved,approves,approving
approvingly: approvingly
april: april
apropos: apropos
aptitude: aptitude
aquarium: aquarium
aquiline: aquiline
arabian: arabian
arbiter: arbiters
arbitrarily: arbitrarily
arbor: arbor
arcade: arcade
arch: arch
archangel: archangel,archangels
archbishop: archbishop
archimandrite: archimandrite
architect: architect
ardent: ardent
ardently: ardently
ardor: ardor
argue: argue,argued,argues,arguing
argument: argument,arguments
argumentative: argumentative
aright: aright
aristocracy: aristocracy
aristocrat: aristocrats
aristocratic: aristocratic
arithmetic: arithmetic
arm: arm,arming,arms
armor: armor
army: armies,army
arouse: arouse,aroused,arousing
arrange: arrange,arranged,arranging
arrangement: arrangement,arrangements
arrest: arrest,arrested
arrival: arrival
arrive: arrive,arrived,arrives,arriving
arrogant: arrogant
arrogate: arrogate
arrow: arrow
art: art
artful: artful
artfulness: artfulness
article: article,articles
articulate: articulate,articulated
artificially: artificially
artisan: artisans
artist: artist,artists
artistic: artistic
artistically: artistically
artless: artless
ascend: ascend
ascension: ascension
ascertain: ascertain,ascertained,ascertaining
ascetic: ascetic,ascetics
ascribe: ascribed
ash: ash,ashes
ashamed: ashamed
asia: asia
askance: askance
asleep: asleep
aspect: aspect
aspen: aspen
asperse: asperse,aspersed
aspiration: aspirations
ass: ass,asses
assail: assailed
assailant: assailant
assemble: assembled,assembling
assembly: assembly
assent: assent,assented
assert: assert,asserted,asserting,asserts
assertion: assertion
assign: assigned
assist: assist
assistance: assistance
assistant: assistants
associate: associate
assume: assume,assumed,assuming
assurance: assurance
assure: assure,assured,assures,assuring
assured: assured
asthma: asthma
astonish: astonished
astonished: astonished
astonishing: astonishing
astonishment: astonishment
astound: astound
astounded: astounded
astounding: astounding
astray: astray
astride: astride
astronomer: astronomers
astute: astute
asunder: asunder
asylum: asylum
atheism: atheism
atheist: atheist,atheists
atheistic: atheistic
athirst: athirst
athletic: athletic
atom: atoms
atone: atone,atoned
atonement: atonement
atrocious: atrocious
attach: attach,attached,attaching
attachment: attachment
attack: attack,attacked,attacking,attacks
attain: attain,attained,attaining
attempt: attempt,attempted
attend: attend
attendance: attendance
attendant: attendant
attention: attention,attentions
attentive: attentive
attentively: attentively
attitude: attitude
attract: attract,attracted,attracting,attracts
attraction: attraction
attractive: attractive
attribute: attribute,attributed
audacious: audacious
audacity: audacity
audible: audible
audibly: audibly
audience: audience
aught: aught
august: august
aunt: aunt,aunts
auntie: auntie
austere: austere
austerely: austerely
authentic: authentic
author: author,authors
authority: authorities,authority
auto: auto
autumn: autumn
avail: avail
avenge: avenge,avenged,avenges,avenging
average: average
aversion: aversion
avert: avert,averted
avoid: avoid,avoided,avoiding
avow: avow,avowing
avowal: avowal,avowals
avowed: avowed
await: await,awaited,awaiting,awaits
awake: awake
awaken: awakened
awakening: awakening
aware: aware
awe: awe
awful: awful
awhile: awhile
awkward: awkward
awkwardly: awkwardly
ax: ax
axiom: axiom,axioms
babble: babbled,babbling
babe: babe,babes
babel: babel
baby: babies,baby
babyish: babyish
bachelor: bachelor,bachelors
background: background
bad: bad,worse,worst
badly: badly,worse
badness: badness
baffle: baffling
bag: bag,bags
bah: bah
baked: baked
balaam: balaam
balance: balance
balcony: balcony
bald: bald
ball: ball,balls
ballad: ballads
ballet: ballet
balsam: balsam
balustrade: balustrade
band: band
bandage: bandage,bandaged,bandaging
banish: banished
bank: bank,banks
banker: banker
banknote: banknote,banknotes
banner: banner
banquet: banquet
bar: barred,barring
barbarous: barbarous
bare: bare,barest
barefaced: barefaced
barefoot: barefoot
barefooted: barefooted
bareheaded: bareheaded
bargain: bargain
bargaining: bargaining
barge: barge
bark: bark,barked,barking
barrel: barrels
barreled: barreled
barren: barren
barricade: barricade,barricades
barrier: barriers
barrister: barrister
base: base,based,basest
baseness: baseness
baser: baser
bashful: bashful
bashfully: bashfully
basin: basin
basis: basis
bath: bath,bathed,baths
battalion: battalion
batter: battered
battery: battery
battle: battle,battles
battlefield: battlefield
bawl: bawl,bawled,bawling
bay: bay
bayonet: bayonets
bead: beads
beak: beak
beam: beamed,beaming,beams
bear: bear,bearing,bears,bore,born,borne
beard: beard,beards
bearing: bearing,bearings
bearskin: bearskin
beast: beast,beasts
beastly: beastly
beat: beat,beaten,beating,beats
beating: beating,beatings
beautiful: beautiful
beautifully: beautifully
beauty: beauty
beck: beck
beckon: beckoned,beckoning
becomingly: becomingly
bed: bed,beds
bedridden: bedridden
bedroom: bedroom
bedside: bedside
bedstead: bedstead
bee: bee
beef: beef
beekeeper: beekeeper
beetle: beetle,beetles
befall: befell
befitting: befitting
befoul: befouled
beg: beg,begged,begging,begs
beget: beget
beggar: beggar,beggars
beggarly: beggarly
behalf: behalf
behave: behave,behaved,behaving
behavior: behavior
behold: behold,beholding,beholds
belief: belief
believer: believer,believers
bell: bell,bells
belle: belle
bellow: bellowed
belly: belly
belong: belong,belonged,belonging,belongs
belongings: belongings
beloved: beloved
belt: belts
bench: bench,benches
bend: bend,bending,bends,bent
beneath: beneath
benefactor: benefactor,benefactors
benefactress: benefactress
beneficence: beneficence
benefit: benefit,benefits
benevolence: benevolence
benevolent: benevolent
benevolently: benevolently
benjamin: benjamin
bent: bent
benumb: benumbed
bequeath: bequeathed,bequeathing
bereave: bereaved
bernard: bernard
berry: berries
beseech: beseech,beseeches,beseeching,besought
besmirch: besmirched
besought: besought
bespeak: bespoken
bestial: bestial
bestiality: bestiality
bestow: bestowed
bet: bet
bethink: bethink,bethinking,bethought
betray: betray,betrayed,betraying
betroth: betrothed
betrothal: betrothal
betters: betters
beware: beware
bewilder: bewildered,bewildering
bewitch: bewitch,bewitched,bewitching
bias: biased
bible: bible
bid: bade,bid,bidden,bidding,bids
bidding: bidding
bigot: bigots
billiard: billiard
billiards: billiards
bind: bind,binding,binds,bound
biographical: biographical
biography: biographies,biography
birch: birch,birches
birchwood: birchwood
bird: bird,birds
birdlike: birdlike
birth: birth
birthday: birthday
bishop: bishop,bishops
bit: bit,bits
bite: bit,bite,biting,bitten
bitter: bitter,bitterer,bitterest
bitterly: bitterly
bitterness: bitterness
black: black
blacken: blackened
blacker: blacker
blackguard: blackguard,blackguards
blade: blade
blame: blame,blamed,blames,blaming
blanc: blanc
blandly: blandly
blank: blank
blankly: blankly
blaspheme: blaspheming
blasphemously: blasphemously
blasphemy: blasphemy
blast: blasted
bleed: bled,bleed,bleeding,bleeds
bleeding: bleeding
blend: blended,blending,blends
bless: bless,blessed,blesses,blessing
blessed: blessed
blessedness: blessedness
blessing: blessing
blind: blind,blinded
blindly: blindly
blindness: blindness
blink: blink
bliss: bliss
blissful: blissful
blissfully: blissfully
bloated: bloated
block: block,blocked
blockhead: blockhead
blonde: blonde
blood: blood
bloodless: bloodless
bloodshed: bloodshed
bloodshot: bloodshot
bloodstain: bloodstains
bloodstained: bloodstained
bloodthirsty: bloodthirsty
bloody: bloody
bloom: blooming
blossom: blossoms
blow: blew,blow,blowing,blown,blows
blubber: blubbered,blubbering
blue: blue
blunder: blunder,blunders
blunt: blunt
blurt: blurt,blurted,blurting
blush: blush,blushed,blushing
board: board
boarding: boarding
boast: boast,boasted,boasting
boasting: boasting
bobbery: bobbery
bodily: bodily
body: bodies,body
bodyguard: bodyguard
boil: boiled,boiling,boils
boiling: boiling
bold: bold,bolder
boldly: boldly
boldness: boldness
bolt: bolt,bolted
bombard: bombarded
bon: bon
bond: bond
bondage: bondage
bone: bone,bones
bony: bony
booby: booby
book: book,books
bookcase: bookcase
boom: boomed
boon: boon
boot: boot,boots
booth: booths
booty: booty
border: bordered,bordering
bore: bore,bored,bores
bored: bored
boredom: boredom
borrow: borrow,borrowed,borrowing
bosom: bosom
bother: bother,bothered
bottle: bottle,bottled,bottles
boudoir: boudoir
bound: bounded,bounding,bounds
boundary: boundaries
boundless: boundless
bounteous: bounteous
bourgeois: bourgeois
bout: bout
bow: bow,bowed,bowing,bows
bowels: bowels
bowl: bowled
box: box
boy: boy,boys
boyhood: boyhood
boyish: boyish
boys: boys
brace: brace,braces
brag: brag,bragged
braggart: braggart
brain: brain,brains
branch: branches
brand: brand
brandish: brandished,brandishing
brandy: brandy
brass: brass
brat: brat
bravado: bravado
brave: brave
bravely: bravely
bravery: bravery
bravo: bravo
brawl: brawls
brawler: brawler,brawlers
brazen: brazen
breach: breach
bread: bread
breadth: breadth
break: break,breaking,breaks,broke,broken
breakfast: breakfast
breaking: breaking
breast: breast,breasts
breath: breath
breathe: breathe,breathed,breathing
breathing: breathing
breathless: breathless
breathlessly: breathlessly
breeches: breeches
breed: bred,breed
breeding: breeding
brevity: brevity
brew: brewed
brewing: brewing
bribe: bribe,bribed,bribes
brick: brick
bride: bride
bridegroom: bridegroom
bridge: bridge
bridle: bridle
bright: bright,brighter
brighten: brightened
brightly: brightly
brightness: brightness
brilliance: brilliance
brilliant: brilliant
brim: brim,brimming
bring: bring,bringing,brings,brought
bringeth: bringeth
brink: brink
briskly: briskly
broad: broad
broke: broke
broken: broken
bronze: bronze
brooch: brooch
brood: brood,brooding,broods
brooding: brooding
brook: brooked
broom: broom
brosse: brosse
brother: brother,brothers
brotherhood: brotherhood
brotherly: brotherly
brothers: brothers
brow: brows
browed: browed
brown: brown
brownish: brownish
bruise: bruise,bruised,bruises
brush: brush,brushed,brushing
brutal: brutal
brute: brute,brutes
bubble: bubbling
bucketful: bucketfuls
bud: bud
budge: budge,budging
buffet: buffet
buffoon: buffoon,buffoons
buffoonery: buffoonery
bug: bug,bugs
build: build,building,built
builder: builders
building: building,buildings
bulgaria: bulgaria
bulgarian: bulgarian
bulge: bulging
bulkin: bulkin
bull: bull
bullet: bullet
bully: bullied,bully
bun: bun
bunch: bunch
bundle: bundle
burden: burden,burdened,burdening
burdensome: burdensome
burdock: burdocks
bureau: bureau
burglar: burglar
burial: burial
burlesque: burlesque
burn: burn,burned,burning,burns,burnt
burning: burning
burst: burst,bursting,bursts
bury: buried,bury,burying
bush: bush,bushes
busily: busily
business: business
businesslike: businesslike
bustle: bustle,bustled,bustling
busy: busied,busiest,busy,busying
button: button,buttoned,buttoning
buxom: buxom
cabbage: cabbage,cabbages
cabinet: cabinet
cackle: cackled
cad: cad
caddish: caddish
cadet: cadet
cain: cain
cake: cakes
calamity: calamities,calamity
calculate: calculate,calculated,calculating
calculation: calculation
calendar: calendar
calf: calf
calico: calico
calling: calling
callous: callous
callously: callously
calm: calm,calmed,calmer,calmest
calmly: calmly
calmness: calmness
calumniate: calumniated
calumny: calumny
cambric: cambric
camel: camels
camp: camp
cana: cana
canary: canary
candid: candid
candide: candide
candle: candle,candles
candlestick: candlestick
candy: candy
canine: canine
cannibalism: cannibalism
cannon: cannon
canst: canst
canticle: canticle
cap: cap,caps
capable: capable
capacity: capacity
caper: capering
capital: capital,capitals
capitalist: capitalist
capon: capons
caprice: caprice,caprices
capricious: capricious
captain: captain
captivate: captivate,captivated,captivating
captive: captive
carcass: carcass
card: card,cards
cardinal: cardinal,cardinals
care: care,cared,cares,caring
career: career,careers
careful: careful
carefully: carefully
careless: careless
carelessly: carelessly
carelessness: carelessness
caress: caress,caresses
caressing: caressing
carol: caroled
carousal: carousal
carouse: caroused,carousing
carpet: carpet
carriage: carriage,carriages
carry: carried,carries,carry,carrying
cart: cart,carts
carve: carved
carving: carving
cash: cash
cashmere: cashmere
cassock: cassock
cast: cast,casting
castigation: castigation
castle: castle
casual: casual
casually: casually
casuist: casuist
casuistry: casuistry
cat: cat,cats
cataclysm: cataclysm
catacombs: catacombs
catastrophe: catastrophe
catch: catch,catches,catching,caught
catcher: catcher
cathedral: cathedral
catherine: catherine
catholic: catholic
catholicism: catholicism
catholics: catholics
catlike: catlike
catskin: catskin
cattle: cattle
caucasian: caucasian
caucasus: caucasus
caustic: caustic
caution: caution
cautious: cautious
cautiously: cautiously
cavalry: cavalry
cavern: cavern
caviare: caviare
ce: ce
cease: cease,ceased,ceases,ceasing
ceiling: ceiling
celebrate: celebrate,celebrating
celebrated: celebrated
cell: cell
cellar: cellar
cemetery: cemetery
censer: censer
censorious: censorious
censorship: censorship
censure: censure
cent: cent
center: center,centered
centipede: centipede
centripetal: centripetal
century: centuries,century
cere: ceres
ceremony: ceremony
ceres: ceres
certainty: certainty
chain: chain,chains
chair: chair,chairs
chalk: chalk
challenge: challenge,challenged,challenging
champagne: champagne
champion: champion,championed,champions
chance: chance,chanced
chanced: chanced
chandelier: chandeliers
change: change,changed,changing
changeable: changeable
changed: changed
changing: changing
chant: chanting
chaos: chaos
chaotic: chaotic
chap: chap
chapel: chapel
chaperon: chaperons
chapter: chapter
character: character,characters
characteristic: characteristic,characteristics
characteristically: characteristically
characterize: characterized
charcoal: charcoal
chare: charing
charge: charge,charged,charges
charitable: charitable
charity: charity
charlatanism: charlatanism
charm: charm,charmed,charms
charming: charming
charmingly: charmingly
charred: charred
charwoman: charwoman
chase: chasing
chaste: chaste
chastise: chastise
chastisement: chastisement
chastity: chastity
chat: chat
chattel: chattel
chatter: chattered,chattering
chauvinism: chauvinism
cheap: cheap,cheapest
cheat: cheat,cheated,cheating
cheating: cheating
check: check,checked,checking
checkmate: checkmate
cheek: cheek,cheeked,cheeks
cheekbone: cheekbones
cheer: cheer,cheered
cheerful: cheerful
cheerfully: cheerfully
cheerfulness: cheerfulness
cheese: cheese
chef: chef
chemical: chemical
chemist: chemist
chemistry: chemistry
cherish: cherish,cherished
cherry: cherry
cherub: cherub
cherubim: cherubim
chest: chest
chevalier: chevalier
chick: chicks
chicken: chicken,chickens
chief: chief
chiefly: chiefly
chien: chien
child: child,children
childbirth: childbirth
childhood: childhood
childish: childish
childishly: childishly
childless: childless
childlike: childlike
chill: chill
chilling: chilling
chilly: chilly
chime: chimed
chimney: chimney
chin: chin
china: china
chinaman: chinaman
chinese: chinese
chip: chipping
chirp: chirped
chirrup: chirruping
chisel: chiseling
chivalrous: chivalrous
chivalrously: chivalrously
chocolate: chocolate,chocolates
choice: choice
choir: choir
choke: choking
choose: choose,choosing,chose,chosen
chop: chop,chopped
chord: chords
chorus: chorus
christ: christ
christen: christened
christening: christening
christian: christian,christians
christianity: christianity
christmas: christmas
chronological: chronological
chronometer: chronometer
chuckle: chuckle,chuckled
church: church,churches
churlish: churlish
cigar: cigar,cigars
cigarette: cigarette,cigarettes
cinder: cinders
circle: circle,circles
circulate: circulated,circulating
circumscribe: circumscribed
circumspectly: circumspectly
circumstance: circumstance,circumstances
circumstantial: circumstantial
circumstantially: circumstantially
circumvent: circumvented
citizen: citizen
city: city
civic: civic
civil: civil
civilian: civilian,civilians
civility: civility
civilization: civilization
civilly: civilly
claim: claim,claimed,claiming,claims
clamber: clambered,clambering
clamor: clamor,clamors
clank: clanking
clap: clapped
clapping: clapping
clasp: clasping
clasped: clasped
class: class,classes
classic: classic,classics
classical: classical
classification: classification
claude: claude
clean: clean,cleaning
cleanliness: cleanliness
cleanse: cleansed
clearness: clearness
cleave: cleave
clench: clench,clenched,clenching
clenched: clenched
clergy: clergy
clerical: clerical,clericals
clerk: clerk,clerks
clever: clever,cleverer
cleverly: cleverly
cleverness: cleverness
clew: clew
client: client
climatic: climatic
climax: climax
climb: climb,climbed,climbing
cling: cling,clinging,clung
clink: clink
cloak: cloak
clock: clock
cloister: cloistered
close: close,closed,closer,closing
closed: closed
closely: closely
closet: closets
closing: closing
cloth: cloth
clothe: clothe,clothed
clothes: clothes
cloud: cloud,clouded,clouds
cloudberry: cloudberry
clown: clown
club: club
clumsy: clumsy
clung: clung
clutch: clutch,clutched,clutches,clutching
coach: coach
coachman: coachman
coal: coal
coarse: coarse,coarser,coarsest
coarsely: coarsely
coarseness: coarseness
coast: coast
coat: coat,coats
cocher: cocher
cock: cock,cocks
cockade: cockade
cockroach: cockroaches
code: code
coffee: coffee
coffin: coffin,coffins
coherent: coherent
coherently: coherently
coil: coil
coin: coins
coincidence: coincidence,coincidences
cold: cold,colder
coldly: coldly
coldness: coldness
collapse: collapsed
collar: collar
colleague: colleague
collect: collect,collected,collecting
collection: collection
collectively: collectively
collision: collision
colonel: colonel
color: color,colored,colors
colored: colored
colt: colt
column: column
comb: combed,combing
combat: combat
combatant: combatants
combination: combination
combine: combining
comedy: comedies,comedy
comer: comer
comet: comet
cometh: cometh
comfort: comfort,comforted,comforts
comfortable: comfortable
comforting: comforting
comic: comic
coming: coming
command: command,commanded,commanding,commands
commander: commander
commanding: commanding
commandingly: commandingly
commemorate: commemorate
commend: commends
comment: comment,commented,comments
commercial: commercial
commissariat: commissariat
commission: commission,commissioned
commit: commit,commits,committed,committing
committal: committal
common: common
commonly: commonly
commonplace: commonplace
commune: commune
communicate: communicate,communicated,communicates
communication: communication
communion: communion
community: community
compact: compact
companion: companion,companions
companionable: companionable
companionship: companionship
company: company
comparatively: comparatively
compare: compare,compared,compares,comparing
comparison: comparison,comparisons
compassion: compassion
compassionate: compassionate
compassionately: compassionately
compel: compels
compelled: compelled
compensation: compensation
competent: competent
complacency: complacency
complacent: complacent
complain: complain,complained,complaining
complaint: complaint,complaints
complete: complete,completed,completing
completely: completely
completion: completion
complex: complex
complexion: complexion
complicated: complicated
complicity: complicity
compliment: compliments
compose: compose,composed,composing
composed: composed
composite: composite
composition: composition
composure: composure
compote: compote
comprehend: comprehend
comprehension: comprehension
compress: compressed
compromise: compromise,compromised,compromises,compromising
compromising: compromising
comrade: comrade,comrades
conceal: conceal,concealed,concealing
concede: conceded,concedes
conceit: conceit
conceited: conceited
conceitedly: conceitedly
conceivable: conceivable
conceivably: conceivably
conceive: conceive,conceived,conceiving
concentrate: concentrated
concentrated: concentrated
conception: conception,conceptions
concern: concern,concerned
concerned: concerned
conciliate: conciliating
conclude: conclude,concluded,concluding
conclusion: conclusion,conclusions
conclusive: conclusive
conclusively: conclusively
conclusiveness: conclusiveness
condemn: condemn,condemned,condemning
condemnation: condemnation
condescend: condescend,condescends
condescending: condescending
condescendingly: condescendingly
condescension: condescension
condition: condition,conditions
conduct: conduct,conducted,conducting
conductor: conductor
confess: confess,confessed,confessing
confession: confession,confessions
confessional: confessionals
confidant: confidant
confide: confided,confides,confiding
confidence: confidence
confident: confident
confidential: confidential
confidentially: confidentially
confidently: confidently
confine: confine,confined,confining
confinement: confinement
confirm: confirm,confirmed,confirming
confirmation: confirmation
conflict: conflict,conflicting
conflicting: conflicting
confound: confound,confounded
confront: confront,confronted,confronting
confused: confused
confusedly: confusedly
confusion: confusion
congratulate: congratulated
conjecture: conjecture
conjunction: conjunction
connect: connected,connecting
connection: connection,connections
connoisseur: connoisseur,connoisseurs
conquer: conquer,conquered
conquering: conquering
conqueror: conqueror,conquerors
conquest: conquest
conscience: conscience
conscientious: conscientious
conscious: conscious
consciously: consciously
consciousness: consciousness
consecutively: consecutively
consent: consent,consented,consenting
consequence: consequence,consequences
considerable: considerable
considerably: considerably
consideration: consideration
consist: consisted,consisting,consists
consistency: consistency
consistent: consistent
consolation: consolation
console: console,consoled
consoling: consoling
conspicuous: conspicuous
conspicuously: conspicuously
constable: constables
constance: constance
constant: constant
constantinople: constantinople
constantly: constantly
constellation: constellation
constitute: constitute,constitutes
constitution: constitution
consult: consult,consulted
consultation: consultation
consume: consumed,consuming
consumption: consumption
consumptive: consumptive
contact: contact
contemplate: contemplate,contemplated,contemplating
contemplation: contemplation
contemplative: contemplative
contemporary: contemporary
contempt: contempt
contemptible: contemptible
contemptibly: contemptibly
contemptuous: contemptuous
contemptuously: contemptuously
contend: contend
content: content
contention: contention
contents: contents
contest: contest,contested
continent: continents
continual: continual
continually: continually
continue: continue,continued
contorted: contorted
contra: contra
contract: contracted
contradict: contradict,contradicted,contradicts
contradiction: contradiction,contradictions
contrary: contraries,contrary
contrast: contrast
contravention: contravention
contrive: contrives
contrived: contrived
control: control,controlled,controlling
controversy: controversy
convalescence: convalescence
convenient: convenient
conveniently: conveniently
conventional: conventional
conventual: conventual
conversation: conversation,conversations
converse: converse
conversion: conversion
convert: convert,converted
convey: convey
conveyance: conveyance
convict: convict,convicted,convicts
conviction: conviction,convictions
convince: convince,convinced,convincing
convinced: convinced
convincing: convincing
convincingly: convincingly
convulsion: convulsion,convulsions
convulsively: convulsively
cook: cook,cooked
cookery: cookery
cooking: cooking
cool: cool
coolly: coolly
coolness: coolness
copeck: copeck,copecks
copper: copper
copse: copse
copying: copying
coquettishly: coquettishly
cord: cord
cordial: cordial
cordiality: cordiality
cordially: cordially
core: core
cork: cork,corks
corn: corn
corner: corner,cornered,corners
cornered: cornered
corporal: corporal
corps: corps
corpse: corpse
correct: correct,corrected,correcting,corrects
correction: correction,corrections
correctly: correctly
correspond: correspond
correspondence: correspondence
corridor: corridor
corrupt: corrupt,corrupted
corrupter: corrupter
corrupting: corrupting
corruption: corruption
cost: cost,costs
costermonger: costermonger
costly: costly
cottage: cottage
cotton: cotton,cottons
couch: couch
cough: cough,coughing
couldst: couldst
council: council
councilor: councilor
counsel: counsel
count: count,counted,counting,counts
countenance: countenance,countenances
counter: counter
counterfeit: counterfeit
counting: counting
country: countries,country
coup: coup
couple: couple
coupon: coupons
courage: courage
courageous: courageous
court: court,courting,courts
courteous: courteous
courteously: courteously
courtesy: courtesy
courtyard: courtyard
cousin: cousin,cousins
covenant: covenant
coventry: coventry
cover: cover,covered,covering
covered: covered
covering: covering
covet: coveted,coveting
covetousness: covetousness
cow: cow,cowed,cows
coward: coward
cowardice: cowardice
cowardliness: cowardliness
cowardly: cowardly
cowhouse: cowhouse
coxcomb: coxcomb
crab: crab
crack: crack,cracked,cracks
crackling: crackling
cradle: cradle
crafty: crafty
cram: cramming
cranny: cranny
crape: crape
crash: crash
crave: crave,craved
craving: craving
crawl: crawl,crawled
craze: craze
crazily: crazily
craziness: craziness
crazy: crazy
creak: creaked,creaking
cream: cream
crease: creases
create: create,created,creating
creation: creation
creator: creator
creature: creature,creatures
credible: credible
credit: credit
creditable: creditable
credo: credo
credulity: credulity
credulous: credulous
creed: creed,creeds
creep: creep,creeping,crept
crest: crest
crestfallen: crestfallen
crevice: crevice
crew: crew
cricket: cricket
crime: crime,crimes
criminal: criminal,criminals
crimson: crimson,crimsoned,crimsoning
cringe: cringing
cringing: cringing
cringingly: cringingly
cripple: cripple,cripples
crippled: crippled
crisis: crisis
critical: critical
critically: critically
criticism: criticism
criticize: criticize,criticized,criticizing
croak: croak
crockery: crockery
crone: crone
crooked: crooked
crop: cropped
cross: cross,crossed,crossing
crossly: crossly
crossroads: crossroads
crow: crow
crowd: crowd,crowded,crowding,crowds
crowded: crowded
crown: crown
crucible: crucible
crucifixion: crucifixion
crucify: crucified
crude: crude
crudely: crudely
cruel: cruel
cruelly: cruelly
cruelty: cruelty
crumple: crumple,crumpled
crumpled: crumpled
crush: crush,crushed,crushing
crust: crust,crusted,crusts
crutch: crutches
crystal: crystal
cue: cue
cuff: cuff,cuffs
culprit: culprit
cultivate: cultivated
culture: culture,cultured
cultured: cultured
cumber: cumbered
cunning: cunning
cunningly: cunningly
cup: cup,cups
cupboard: cupboard,cupboards
cupola: cupola
cur: cur
cure: cure,cured,cures,curing
curiosity: curiosity
curious: curious
curiously: curiously
curl: curled,curls
curly: curly
currant: currant,currants
current: current
curse: curse,cursed,cursing
cursed: cursed
cursorily: cursorily
cursory: cursory
curt: curt
curtain: curtain,curtains
curtly: curtly
curtsey: curtsey
curve: curve,curves
curved: curved
cushion: cushion
custodian: custodian
custom: custom,customs
customary: customary
customer: customer
cut: cut,cuts,cutting
cutlet: cutlets
cutting: cutting
cycle: cycle
cymbal: cymbals
cynical: cynical
cynicism: cynicism
da: da
daddy: daddy
dagger: dagger,daggers
daily: daily
dainty: dainty
damage: damage,damaged
damaging: damaging
dame: dame
damn: damn
damnable: damnable
damnation: damnation
damned: damned
damning: damning
damp: damp
dance: dance,danced,dances,dancing
dancer: dancer
dancing: dancing
dandified: dandified
dandy: dandy
danger: danger
dangerous: dangerous
danish: danish
dank: dank
dante: dante
daresay: daresay
daring: daring
dark: dark,darkest
darken: darkened,darkens
darkly: darkly
darkness: darkness
darling: darling,darlings
dart: dart,darted,darting
dash: dash,dashed,dashes,dashing
daughter: daughter,daughters
dauphin: dauphin
dawn: dawn,dawned,dawning
day: day,days
daybreak: daybreak
daylight: daylight
daze: dazed
dazed: dazed
deacon: deacon
dead: dead
deadly: deadly
deaf: deaf
deal: deal,dealing,dealt
dearly: dearly
death: death
deathbed: deathbed
deathlike: deathlike
debate: debated
debauchee: debauchee
debauchery: debaucheries,debauchery
debt: debt,debts
decadent: decadent
decanter: decanter
decay: decay,decayed
decayed: decayed
decaying: decaying
decease: deceased
deceased: deceased
deceit: deceit
deceitful: deceitful
deceitfulness: deceitfulness
deceive: deceive,deceived,deceives,deceiving
deceiver: deceiver
december: december
decency: decencies
decent: decent
decently: decently
deception: deception
decide: decide,decided,deciding
decision: decision,decisions
decisive: decisive
deck: deck
declaim: declaimed
declaration: declaration
declare: declare,declared,declares,declaring
decline: decline,declined,declining
decoction: decoction
decomposition: decomposition
decorate: decorated
decoration: decoration
decorous: decorous
decorum: decorum
decree: decree,decreed,decrees
decrepit: decrepit
dedan: dedans
dedicate: dedicate
dedication: dedication
deduction: deduction
deed: deed,deeds
deem: deemed
deep: deep,deepest
deeply: deeply
defend: defend,defended,defending
defender: defender
defense: defense
defenseless: defenseless
defenselessness: defenselessness
defer: defer
defiance: defiance
defiant: defiant
defiantly: defiantly
deficit: deficit
defile: defile,defiling
define: define,defined
definite: definite
definition: definition
deform: deformed
defraud: defraud
defy: defying
degenerate: degenerate
degradation: degradation
degrade: degrade,degraded
degraded: degraded
degrading: degrading
degree: degree,degrees
dei: dei
deign: deign,deigned,deigns
dejected: dejected
dejection: dejection
delay: delay,delayed,delaying
deliberate: deliberate,deliberated,deliberating
deliberately: deliberately
deliberation: deliberation
delicacy: delicacy
delicate: delicate
delicately: delicately
delicious: delicious
delight: delight,delights
delighted: delighted
delightful: delightful
delightfully: delightfully
delirious: delirious
delirium: delirium
deliver: delivered,delivering,delivers
deliverer: deliverer
delusion: delusion
demand: demand,demanded
demeanor: demeanor
demon: demon
demonstration: demonstrations
demonstrative: demonstrative
demoralizing: demoralizing
demur: demur
demurely: demurely
den: den
denial: denial
dent: dents
dentist: dentist
deny: denied,deny,denying
depart: depart,departed,departing,departs
department: department,departments
departure: departure
depend: depend,depended,depends
dependent: dependent,dependents
depict: depicted
deplore: deplore
depraved: depraved
depravity: depravity
deprecate: deprecating
depreciate: depreciated
depreciation: depreciation
depress: depress,depressed
depressed: depressed
depression: depression
deprive: deprive,deprived,deprives,depriving
depth: depth
depths: depths
deputy: deputy
der: der
derange: deranged
derangement: derangement
deride: derided
derision: derision
derisively: derisively
derive: derived
descend: descend,descended,descending
description: description,descriptions
desert: desert,deserted
deserted: deserted
deserve: deserve,deserved,deserves
deserved: deserved
design: design,designs
designate: designated
desire: desire,desired,desires,desiring
desiring: desiring
desirous: desirous
desist: desist
desk: desk
despair: despair
despairing: despairing
despairingly: despairingly
desperate: desperate
desperately: desperately
desperation: desperation
despicable: despicable
despise: despise,despised,despises,despising
despondency: despondency
despondent: despondent
despondently: despondently
despotic: despotic
despotism: despotism
dessert: dessert
destine: destined
destiny: destiny
destitute: destitute
destitution: destitution
destroy: destroy,destroyed,destroying
destruction: destruction
destructive: destructive
detailed: detailed
detain: detained
detect: detect,detected
detective: detective,detectives
deter: deter
determination: determination
determine: determine,determined
determined: determined
deterrent: deterrent
detest: detest,detested
detriment: detriment
deuce: deuce
develop: develop,developed,developing,develops
development: development
devil: devil,devils
devilish: devilish
devilishly: devilishly
devilry: devilry
devote: devote,devoted
devoted: devoted
devotion: devotion
devotional: devotional
devour: devour,devoured,devouring,devours
devourer: devourers
devout: devout
devoutly: devoutly
devoutness: devoutness
diable: diable
diabolical: diabolical
diagnose: diagnose,diagnosed
diamond: diamond
dice: dice
dictate: dictated
dictionary: dictionary
didst: didst
die: die,died,dies,dying
dietary: dietary
difference: difference,differences
difficult: difficult
difficulty: difficulties,difficulty
diffidence: diffidence
diffusely: diffusely
dig: dig,digging
dignified: dignified
dignity: dignity
digress: digress
dilapidated: dilapidated
dilettante: dilettanti
dilettanti: dilettanti
dim: dimmer
dimension: dimensions
diminish: diminish,diminished,diminishing
dimly: dimly
din: din
dine: dine,dined,dining
dining: dining
dinner: dinner,dinners
diocesan: diocesan
diogenes: diogenes
dip: dipped
diplomacy: diplomacy
diplomat: diplomat
diplomatic: diplomatic
direct: direct,directed
direction: direction,directions
directness: directness
dirge: dirge
dirt: dirt
dirty: dirtier,dirty
disabled: disabled
disadvantage: disadvantage
disagree: disagree,disagreed
disagreeable: disagreeable
disappear: disappear,disappeared
disappearance: disappearance
disappoint: disappoint,disappointed
disappointed: disappointed
disappointing: disappointing
disastrous: disastrous
disavowal: disavowal
disbelief: disbelief
disbelieve: disbelieve,disbelieved
discard: discard,discarded
discern: discerned,discerning,discerns
discharge: discharge,discharged
disciple: disciples
discipline: discipline
disclaim: disclaim
disclose: disclose
discomfiture: discomfiture
discomfort: discomfort
disconcert: disconcerted
disconcerted: disconcerted
disconnected: disconnected
disconnectedly: disconnectedly
disconsolately: disconsolately
discord: discord
discordant: discordant
discount: discount
discourse: discourse
discover: discover,discovered,discovers
discovery: discovery
discredit: discredited
discreditable: discreditable
discreditably: discreditably
discreet: discreet
discreetly: discreetly
discriminate: discriminate
discuss: discuss,discussed,discussing
discussion: discussion,discussions
disdain: disdain,disdained
disdainful: disdainful
disdainfully: disdainfully
disease: disease,diseases
diseased: diseased
disgrace: disgrace,disgraced
disgraced: disgraced
disgraceful: disgraceful
disgracefully: disgracefully
disguise: disguise
disgust: disgust,disgusts
disgusted: disgusted
disgusting: disgusting
dish: dish,dishes
dishearten: disheartened
disheveled: disheveled
dishonest: dishonest
dishonestly: dishonestly
dishonesty: dishonesty
dishonor: dishonor,dishonored,dishonoring
dishonorable: dishonorable
dishonorably: dishonorably
dishonored: dishonored
disillusion: disillusioned
disillusionment: disillusionment
disintegrate: disintegrated
disinterested: disinterested
disinterestedness: disinterestedness
disjointed: disjointed
dislike: dislike,disliked,dislikes
dismal: dismal
dismay: dismay,dismayed
dismayed: dismayed
dismiss: dismiss,dismissed,dismisses,dismissing
disobedience: disobedience
disobedient: disobedient
disorder: disorder
disordered: disordered
disorderly: disorderly
disown: disown
disparagement: disparagement
disparity: disparity
dispatch: dispatch,dispatched
dispel: dispel
disperse: dispersed
dispirited: dispirited
display: display,displayed,displaying,displays
displeased: displeased
displeasure: displeasure
disposal: disposal
dispose: dispose,disposed
disposition: disposition
disprove: disproved
dispute: dispute,disputed,disputes,disputing
disreputable: disreputable
disrespectful: disrespectful
disrespectfully: disrespectfully
dissatisfied: dissatisfied
dissect: dissecting
dissension: dissension,dissensions
dissertation: dissertation
dissipate: dissipate,dissipated
dissipation: dissipation
dissolute: dissolute
dissolve: dissolved,dissolving
dissuade: dissuade,dissuaded
distance: distance
distant: distant
distinct: distinct
distinction: distinction,distinctions
distinctly: distinctly
distinctness: distinctness
distinguish: distinguish,distinguished
distinguished: distinguished
distort: distort,distorted,distorting
distorted: distorted
distract: distract,distracting,distracts
distracted: distracted
distractedly: distractedly
distress: distress,distresses
distressed: distressed
distressing: distressing
distribute: distributed
district: district
distrust: distrust,distrusted
distrustful: distrustful
distrustfulness: distrustfulness
disturb: disturb,disturbed,disturbing,disturbs
disturbance: disturbance,disturbances
disturbing: disturbing
ditch: ditch,ditches
dive: dived
diversion: diversion
divert: divert,diverted,diverting
divide: divide,divided
dividing: dividing
divine: divine,divined,divining
divinity: divinity
division: division
divorce: divorced
doctor: doctor,doctored,doctors
doctrine: doctrine,doctrines
document: document,documents
documentary: documentary
dodge: dodges
doer: doer,doers
dog: dog,dogs
doggerel: doggerel
doglike: doglike
dogma: dogma
doings: doings
dole: doles
dolt: dolt
domain: domain
dome: domes
domestic: domestic
dominate: dominate,dominated
domination: domination
domineer: domineers
domini: domini
dominion: dominion
donation: donation
doom: doom,doomed
door: door,doors
doorway: doorway
dose: dosed,doses
dost: dost
doth: doth
double: double,doubled,doubles
doubt: doubt,doubted,doubting,doubts
doubtless: doubtless
dove: dove
downcast: downcast
downfall: downfall
downright: downright
downstairs: downstairs
dowry: dowry
doze: doze,dozed,dozing
dozen: dozen,dozens
drag: drag,dragged,dragging
dragon: dragon
drain: drained
drama: drama
dramatically: dramatically
draught: draught
draw: draw,drawing,drawn,draws,drew
drawer: drawer,drawers
drawing: drawing
drawl: drawled,drawling
dread: dread,dreaded,dreading
dreaded: dreaded
dreadful: dreadful
dreadfully: dreadfully
dream: dream,dreamed,dreaming,dreams,dreamt
dreamer: dreamer
dreamily: dreamily
dreamy: dreamy
dreary: dreary
drench: drench,drenched
dress: dress,dressed,dresses,dressing
dressed: dressed
dressing: dressing
dressmaker: dressmaker
dressy: dressy
drill: drill
drink: drank,drink,drinking,drinks,drunk
drinking: drinking
drip: dripping
dripping: dripping
drive: drive,driven,drives,driving,drove
drivel: driveling
driveling: driveling
driver: driver,drivers
driving: driving
drone: drone
drop: drop,dropped,dropping,drops
dropsy: dropsy
drown: drown,drowning
drowsiness: drowsiness
drowsy: drowsy
drum: drum,drummed
drunk: drunk
drunkard: drunkard,drunkards
drunken: drunken
drunkenness: drunkenness
dry: dried,dry,drying
dryly: dryly
du: du
dubiously: dubiously
duck: duck
duel: duel,dueling,duels
dull: dull,duller
dumb: dumb
dumbfounded: dumbfounded
dumbly: dumbly
dun: dun
dungeon: dungeons
dupe: dupe
duration: duration
dusk: dusk
dust: dust
dutiful: dutiful
duty: duties,duty
dwarfish: dwarfish
dwell: dwell,dwelling,dwelt
dweller: dweller
dwelling: dwelling
dyed: dyed
dying: dying
dyspeptic: dyspeptic
eager: eager
eagerly: eagerly
eagerness: eagerness
eagle: eagle,eagles
ear: ear,ears
earn: earn,earned
earnest: earnest
earnestly: earnestly
earnestness: earnestness
earth: earth
earthly: earthly
earthy: earthy
ease: ease
easily: easily
east: east
easter: easter
easy: easier,easiest,easy
eat: ate,eat,eaten,eating
eating: eating
eavesdropping: eavesdropping
eccentric: eccentric
ecclesiastic: ecclesiastic,ecclesiastics
ecclesiastical: ecclesiastical
echo: echo,echoed,echoing
economically: economically
economist: economist
economize: economizing
ecstasy: ecstasy
ecstatic: ecstatic
ecstatically: ecstatically
edge: edge,edged
edification: edification
edifice: edifice
edifying: edifying
editor: editors
educate: educate,educated,educating
educated: educated
education: education
efface: efface,effaced
effacement: effacement
effective: effective
effectual: effectual
efficient: efficient
effort: effort,efforts
effrontery: effrontery
effusive: effusive
effusively: effusively
egg: egged,egging,eggs
ego: ego
egoism: egoism
egoist: egoist,egoists
egoistic: egoistic
egypt: egypt
egyptian: egyptian
eighteen: eighteen
eighteenth: eighteenth
ejaculate: ejaculated
eject: ejected
elaborate: elaborate,elaborated
elaborately: elaborately
elbow: elbow,elbows
eld: elder,eldest
elder: elder,elders
elderly: elderly
elders: elders
eldership: eldership
elect: elect,elected
electrify: electrified
elegance: elegance
elegant: elegant
elegantly: elegantly
element: element,elements
elemental: elemental
elementary: elementary
elevate: elevating
elevation: elevation
elicit: elicited
elijah: elijah
eliminate: eliminated
elm: elm
elope: elope
elopement: elopement
eloquence: eloquence
eloquent: eloquent
elude: elude
emanation: emanation
emancipate: emancipating
emancipation: emancipation
emasculate: emasculate
embankment: embankment
embarrassed: embarrassed
embarrassment: embarrassment
embellishment: embellishments
ember: embers
embitter: embitters
embittered: embittered
embrace: embrace,embraced,embraces,embracing
embroider: embroidered
emergency: emergencies,emergency
emotion: emotion,emotions
emotional: emotional
emperor: emperor
emphasis: emphasis
emphasize: emphasize,emphasizing
emphatic: emphatic
emphatically: emphatically
empire: empire
empirical: empirical
employ: employ,employed,employing
employer: employers
empress: empress
enable: enable,enabled
enact: enacted
encamp: encamped
enchant: enchanted
enchanted: enchanted
enchantress: enchantress
enclose: enclosed
encounter: encountering,encounters
encourage: encourage,encouraged,encouraging
encouragement: encouragement
encroach: encroach,encroaching
endearment: endearments
endless: endless
endlessly: endlessly
endow: endowed
endurance: endurance
endure: endure,endured,enduring
enemy: enemies,enemy
energy: energies,energy
enfin: enfin
enfold: enfolded
engage: engaged
engagement: engagement
english: english
englishman: englishmen
engraving: engravings
enigma: enigma
enigmatic: enigmatic
enigmatically: enigmatically
enjoy: enjoy,enjoyed,enjoying
enjoyment: enjoyment
enlarge: enlarge
enlightened: enlightened
enlightenment: enlightenment
enormous: enormous
enrage: enraged
enrich: enrich
ensign: ensign
enslave: enslave,enslaved
ensnare: ensnared
enter: enter,entered,entering
enterprise: enterprise,enterprises
enterprising: enterprising
entertain: entertain,entertained
entertainment: entertainment,entertainments
enthusiasm: enthusiasm
enthusiast: enthusiast
enthusiastic: enthusiastic
enthusiastically: enthusiastically
entice: enticed,enticing
entitle: entitled,entitling
entrance: entrance
entreat: entreat,entreated,entreating,entreats
entreaty: entreaties,entreaty
entrust: entrusted
entry: entry
enumerate: enumerated
enunciate: enunciated
envelope: envelope,envelopes
envious: envious
environment: environment
envy: envied,envy,envying
epigram: epigram,epigrams
epilepsy: epilepsy
epileptic: epileptic,epileptics
epilogue: epilogue
episode: episode
epistle: epistle
epitaph: epitaph
epitome: epitome
epoch: epoch
equal: equal,equals
equality: equality
equally: equally
equanimity: equanimity
equation: equation,equations
eradicate: eradicate
erase: erased
erect: erect
erection: erection
err: erring
errand: errand,errands
error: error,errors
erudition: erudition
escapade: escapade
escape: escape,escaped,escaping
escort: escort,escorted
essence: essence
essential: essential
essentially: essentially
est: est
establish: establish,established
established: established
establishment: establishment
estate: estate,estates
esteem: esteem,esteemed,esteeming,esteems
esteemed: esteemed
esther: esther
esthetic: esthetic
esthetically: esthetically
estimable: estimable
estrange: estrange
etcetera: etcetera
eternal: eternal
eternity: eternity
ethereal: ethereal
ethic: ethics
ethics: ethics
etiquette: etiquette
euclid: euclid
euclidian: euclidian
europe: europe
european: european,europeans
europeanism: europeanism
evade: evading
evangelical: evangelical
evasion: evasions
evasively: evasively
eve: eve
evening: evening,evenings
evenings: evenings
event: event,events
everlasting: everlasting
everlastingly: everlastingly
everyday: everyday
evidence: evidence
evident: evident
evidently: evidently
evil: evil
evildoer: evildoer
evince: evinced,evinces
evoke: evoked
evolve: evolved
exact: exact,exacting
exactness: exactness
exaggerate: exaggerate,exaggerated,exaggerating
exaggerated: exaggerated
exalt: exalt,exalted
exaltation: exaltation
examination: examination
examine: examine,examined,examining
exasperate: exasperate,exasperated
exasperated: exasperated
exasperation: exasperation
exceed: exceed
exceedingly: exceedingly
excel: excelled
excellency: excellencies,excellency
excellent: excellent
exception: exception,exceptions
exceptional: exceptional
exceptionally: exceptionally
excess: excess
excessive: excessive
excessively: excessively
exchange: exchange,exchanged
excite: excited
excited: excited
excitedly: excitedly
excitement: excitement
exciting: exciting
exclaim: exclaim,exclaimed,exclaiming,exclaims
exclamation: exclamation,exclamations
exclude: exclude,excluded
exclusion: exclusion
exclusively: exclusively
excommunicate: excommunicate
excommunication: excommunication
excrement: excrement
excusable: excusable
excuse: excuse
execute: executed
execution: execution
executive: executive
exemplary: exemplary
exercise: exercise,exercised
exert: exerted,exerting
exertion: exertions
exhaust: exhaust,exhausted,exhausting
exhausted: exhausted
exhaustion: exhaustion
exhaustively: exhaustively
exhilarated: exhilarated
exhort: exhorted
exhortation: exhortation,exhortations
exile: exile,exiled
exist: exist,existed,existing,exists
existence: existence
existent: existent
expansive: expansive
expect: expect,expected,expecting,expects
expectant: expectant
expectation: expectation,expectations
expedition: expedition
expense: expense,expenses
expensive: expensive
experience: experience,experiences
experienced: experienced
expert: expert,experts
expiate: expiate,expiated
expire: expire
explain: explain,explained,explaining,explains
explanation: explanation,explanations
explode: explode
exploit: exploit,exploits
explore: explore
explosion: explosion
expose: expose,exposed,exposing
exposition: exposition
exposure: exposure
expound: expound,expounded
express: express,expressed,expressing
expression: expression,expressions
expressive: expressive
expressly: expressly
exquisite: exquisite
exquisitely: exquisitely
extant: extant
extend: extending
extension: extension
extent: extent
extenuate: extenuates
external: external
externally: externally
extinct: extinct
extinguish: extinguished
extort: extort
extortionate: extortionate
extra: extra
extract: extract
extraneous: extraneous
extraordinarily: extraordinarily
extraordinary: extraordinary
extreme: extreme,extremes
extremely: extremely
eye: eye,eyeing,eyes
eyebrow: eyebrows
eyed: eyed
eyelash: eyelash,eyelashes
fable: fable
fabric: fabric
fabrication: fabrication
faced: faced
factor: factors
factory: factories
faculty: faculties,faculty
fade: faded
fag: fagging
fail: fail,failed,failing
failure: failure
fain: fain
faint: faint,fainted,faintest,fainting
fainting: fainting
faintly: faintly
fair: fair,fairs
fairy: fairy
fait: fait
faith: faith
faithful: faithful
faithlessness: faithlessness
falcon: falcon
fall: fall,fallen,falling,falls,fell
fallen: fallen
false: false
falsehood: falsehood
falsely: falsely
falseness: falseness
falsetto: falsetto
falsity: falsity
falter: faltered,faltering
fame: fame
familiar: familiar
familiarity: familiarity
familiarly: familiarly
family: families,family
famished: famished
famous: famous
fanatic: fanatic,fanatics
fanatical: fanatical
fanatically: fanatically
fanaticism: fanaticism
fancied: fancied
fanciful: fanciful
fancy: fancied,fancies,fancy,fancying
fantastic: fantastic
fantastical: fantastical
fantasy: fantasy
farce: farce
fare: fare,fared
farewell: farewell
farmer: farmer
faro: faro
farth: farthest
farthing: farthing,farthings
fascinate: fascinate,fascinated
fascinated: fascinated
fascinating: fascinating
fascination: fascination
fashion: fashion
fashionable: fashionable
fashioned: fashioned
fast: fast,fasts
fasten: fastened,fastening
fastidiousness: fastidiousness
fasting: fasting
fat: fat
fatal: fatal
fate: fate,fated,fates
fateful: fateful
father: father,fathers
fatherly: fatherly
fathom: fathomed
fathomless: fathomless
fatigue: fatigue,fatiguing
fatigued: fatigued
fatten: fattened
fault: fault,faults
faust: faust
favor: favor,favors
favorable: favorable
favorably: favorably
favorite: favorite
fawn: fawned,fawning
fear: fear,feared,fearing,fears
fearful: fearful
fearfully: fearfully
fearless: fearless
fearlessly: fearlessly
fearlessness: fearlessness
feast: feast,feasted,feasts
feasting: feasting
feat: feat
feather: feather
feature: feature,features
february: february
feeble: feeble
feebleness: feebleness
feebly: feebly
feed: fed,feed,feeding,feeds
feel: feel,feeling,feels
feeling: feeling,feelings
feigned: feigned
fell: felled
fellow: fellow,fellows
fellowship: fellowship
female: female
feminine: feminine
femme: femmes
fence: fence,fences
ferment: ferment
ferocious: ferocious
ferociously: ferociously
ferocity: ferocity
fertile: fertile
fervent: fervent
fervently: fervently
fervor: fervor
festering: festering
festival: festival
fetch: fetch
fetter: fetter
feud: feud
fever: fever,fevers
fevered: fevered
feverish: feverish
feverishly: feverishly
fib: fib,fibbing
fichu: fichu
fickle: fickle
fiction: fiction
fiddle: fiddle,fiddles
fidelity: fidelity
fidget: fidgeted
fidgetiness: fidgetiness
fido: fido
fie: fie
field: field,fields
fiend: fiend
fiendishly: fiendishly
fierce: fierce,fiercest
fiercely: fiercely
fiery: fiery
fight: fight,fighting,fights,fought
fighting: fighting
figurative: figurative
figuratively: figuratively
figure: figure,figures
filch: filch
filial: filial
fille: filles
filth: filth
filthy: filthy
final: final
finale: finale
finally: finally
finance: finance
financial: financial
finding: finding
fine: fine,finest
finery: finery
finger: finger,fingering,fingers
finish: finish,finished,finishes,finishing
finishing: finishing
firm: firm
firmament: firmament
firmly: firmly
firmness: firmness
firstborn: firstborn
fish: fish
fisherman: fishermen
fishery: fishery
fishing: fishing
fist: fist,fists
fit: fit,fits,fitted,fitting
fitting: fitting
fixed: fixed
fixedly: fixedly
fixity: fixity
fizzle: fizzle
flagellants: flagellants
flagging: flagging
flake: flakes
flame: flame,flamed,flames,flaming
flap: flapping
flare: flare,flared
flash: flash,flashed,flashing
flashing: flashing
flask: flask
flat: flat,flats,flatter
flatly: flatly
flatter: flattered
flattered: flattered
flattering: flattering
flattery: flattery
flax: flax
flaxen: flaxen
flay: flay,flayed
fleeting: fleeting
flesh: flesh
fleshly: fleshly
fleshy: fleshy
flight: flight,flights
flinch: flinch,flinching
fling: fling,flinging,flings,flung
flint: flint
flit: flitted,flitting
float: floated,floating
flock: flock,flocked,flocking
flog: flog,flogged,flogging
flood: flood,flooding
floor: floor
flop: flopped
flopping: flopping
flourish: flourish,flourished
flow: flow,flowed,flowing,flows
flower: flower,flowers
fluctuate: fluctuating
fluently: fluently
fluffy: fluffy
flung: flung
flunkey: flunkey
flurried: flurried
flush: flush,flushed,flushing
flustered: flustered
flutter: flutter,fluttered
fly: flew,flies,flown,fly,flying
foam: foam,foaming
foe: foe,foes
foggy: foggy
fold: fold,folded
folding: folding
folk: folk,folks
follow: follow
folly: follies,folly
fond: fond
fondant: fondants
font: font
food: food
fool: fool,fooled,fooling,fools
foolery: foolery
fooling: fooling
foolish: foolish
foolishly: foolishly
foolishness: foolishness
foot: feet,foot
footed: footed
footing: footing
footman: footman
footnotes: footnotes
footstep: footsteps
forage: forage
forbid: forbade,forbid,forbidden,forbidding
forbidden: forbidden
forbidding: forbidding
force: force,forced,forces,forcing
forcibly: forcibly
foreboding: foreboding,forebodings
forefather: forefathers
forefinger: forefinger
forego: forego
foreground: foreground
forehead: forehead
foreign: foreign
foreigner: foreigner,foreigners
foremost: foremost
foresee: foresaw,foresee,foreseeing,foreseen
foresight: foresight
forest: forest,forests
forester: forester
foretell: foretell,foretelling,foretold
forge: forge
forget: forget,forgets,forgetting,forgot,forgotten
forgetful: forgetful
forgetfulness: forgetfulness
forgive: forgave,forgive,forgiven,forgives,forgiving
forgiveness: forgiveness
fork: fork
form: form,formed,forming,forms
formal: formal
formality: formalities
formally: formally
formidable: formidable
formula: formula
formulate: formulate,formulated
fornication: fornication
forsake: forsaken,forsaking
forsooth: forsooth
fortieth: fortieth
fortify: fortify
fortitude: fortitude
fortnight: fortnight
fortress: fortress
fortunate: fortunate
fortunately: fortunately
fortune: fortune,fortunes
foster: foster,fostered
foul: foul,fouled
foulness: foulness
foundation: foundation,foundations
foundations: foundations
founder: foundered,founders
foundling: foundling
foundry: foundry
fourteen: fourteen
fourth: fourth
fowl: fowl,fowls
fox: fox
fragment: fragment,fragments
fragmentary: fragmentary
fragrance: fragrance
fragrant: fragrant
frail: frail
frame: frame,frames
framework: framework
france: france
frank: frank
frankly: frankly
frankness: frankness
frantic: frantic
frantically: frantically
franz: franz
fraternity: fraternity
fraud: fraud
fraudulently: fraudulently
fraught: fraught
fray: frayed
freak: freak
freckled: freckled
freedom: freedom
freely: freely
freethinker: freethinker,freethinkers
freethinking: freethinking
freeze: freeze,freezes,freezing,frozen
french: french
frenchman: frenchman,frenchmen
frenzied: frenzied
frenzy: frenzy
frequent: frequent
frequently: frequently
fresh: fresh,fresher
freshness: freshness
fret: fret,fretted,fretting
fretted: fretted
friday: friday
friend: friend,friends
friendly: friendly
friendship: friendship
fright: fright
frighten: frighten,frightened
frightened: frightened
frightful: frightful
frightfully: frightfully
frigid: frigid
frivolity: frivolity
frivolous: frivolous
frivolously: frivolously
fro: fro
frock: frock
frontier: frontier
frost: frost
frosty: frosty
frown: frowned,frowning,frowns
frozen: frozen
fruit: fruit,fruits
fruitful: fruitful
fry: fried,frying
fuel: fuel
fulfil: fulfilled
fulfill: fulfill
fulfillment: fulfillment
fullness: fullness
fumble: fumbled,fumbling
fume: fumed,fumes,fuming
fun: fun
fund: funds
fundamental: fundamental
funeral: funeral
funk: funk
funking: funking
funny: funnier,funny
fur: fur
furious: furious
furiously: furiously
furnish: furnish,furnished
furnished: furnished
furnishing: furnishing
furniture: furniture
furore: furore
fury: fury
fuss: fuss,fussed,fussing
fussy: fussy
fut: fut
future: future
gabble: gabbled
gain: gain,gained,gaining,gains
gait: gait
galilee: galilee
gallant: gallant
gallantly: gallantly
gallery: gallery
gallop: gallop,galloped,galloping
galloping: galloping
gallows: gallows
gambler: gambler
game: game,games
gander: gander
gap: gaps
garb: garb
garden: garden,gardens
garment: garment,garments
garnett: garnett
garret: garret
garter: garter
gasp: gasp,gasped,gasping,gasps
gate: gate,gates
gateway: gateway
gather: gather,gathered,gathering
gatherer: gatherer
gathering: gathering
gauge: gauged
gauze: gauze
gay: gay
gayety: gayety
gayly: gayly
gaze: gaze,gazed,gazes,gazing
geist: geist
generality: generalities
generation: generation,generations
generosity: generosity
generous: generous
generously: generously
geneva: geneva
genially: genially
genius: genius
genteel: genteel
gentility: gentility
gentle: gentle
gentlefolk: gentlefolk
gentleman: gentleman,gentlemen
gentlemanly: gentlemanly
gentleness: gentleness
gently: gently
gentry: gentry
genuine: genuine
genuinely: genuinely
genuineness: genuineness
geological: geological
geometrical: geometrical
geometrician: geometricians
geometry: geometry
geranium: geranium
german: german,germans
germany: germany
gesticulate: gesticulating
gesture: gesture,gestures
ghost: ghost,ghosts
giant: giant,giants
gibe: gibes,gibing
giddiness: giddiness
giddy: giddy
gift: gift,gifts
gifted: gifted
giggle: giggle,giggling
gilt: gilt
gingerbread: gingerbread
girl: girl,girls
girlish: girlish
girt: girt
gist: gist
glad: glad
gladden: gladden,gladdened
gladly: gladly
gladness: gladness
glance: glance,glanced,glances,glancing
glare: glaring
glaring: glaring
glass: glass,glasses
gleam: gleam,gleamed
glee: glee
gleefully: gleefully
glimpse: glimpse
glisten: glistened,glistens
glitter: glittered,glittering
gloat: gloat,gloating
gloom: gloom
gloomily: gloomily
gloomy: gloomy
gloriam: gloriam
glorification: glorification
glorify: glorified,glorify,glorifying
glorious: glorious
glory: glory
gloss: gloss
glove: gloves
gloved: gloved
glow: glow,glowed,glowing,glows
glum: glum
glutton: gluttons
gluttony: gluttony
gnash: gnashing
gnaw: gnaws
goad: goading
goal: goal
gobble: gobble
god: god,gods
goddess: goddess
godfather: godfather
godmother: godmother
godsend: godsend
goiter: goiter
gold: gold
golden: golden
goldfinch: goldfinch
golosh: goloshes
goodness: goodness
goodwill: goodwill
goose: geese,goose
gooseberry: gooseberries
gore: gore
gorgeous: gorgeous
gospel: gospel
gospels: gospels
gossip: gossip,gossiping
gout: gout
governess: governesses
government: government
governor: governor
gown: gown
grab: grabbed
grace: grace
graceful: graceful
gracefully: gracefully
gracious: gracious
graciously: graciously
gradually: gradually
grain: grain,grains
grand: grand
grandchild: grandchildren
granddaughter: granddaughter
grandeur: grandeur
grandfather: grandfather
grandmother: grandmother
granny: granny
grant: grant,granted,granting
grasp: grasp,grasped,grasping
grasping: grasping
grass: grass
grate: grating
grateful: grateful
gratify: gratify
gratis: gratis
gratitude: gratitude
gratuitous: gratuitous
grave: grave,graver,gravest
gravely: gravely
graveyard: graveyard
gravity: gravity
gray: gray
grayish: grayish
graze: grazed
greased: greased
greasy: greasy
greatcoat: greatcoat
greatly: greatly
greatness: greatness
greedily: greedily
greediness: greediness
greedy: greedy
greek: greek
green: green
greenish: greenish
greenness: greenness
greet: greet,greeted,greeting
greeting: greeting
gregory: gregory
grief: grief
grievance: grievance,grievances
grieve: grieve,grieved,grieves
grieving: grieving
grievously: grievously
grim: grim
grimace: grimace
grimly: grimly
grimy: grimy
grin: grin,grinned,grinning,grins
grind: grind,grinding
grip: gripped
grizzled: grizzled
groan: groan,groaned,groaning,groans
groaning: groaning
grocery: grocery
groove: groove
grope: groping
grotesque: grotesque
ground: ground
grounds: grounds
grouse: grouse
grovel: groveling,grovels
grow: grew,grow,growing,grown,grows
growl: growled,growling
grown: grown
growth: growth
grudge: grudges
grumble: grumbled,grumbling
grumpily: grumpily
grunt: grunt,grunts
guarantee: guarantee,guarantees
guard: guard,guarding,guards
guardian: guardian
gudgeon: gudgeon
guess: guess,guessed,guessing
guest: guest,guests
guffaw: guffawed
guidance: guidance
guide: guide,guided,guiding
guileless: guileless
guillotine: guillotine
guilt: guilt
guiltless: guiltless
guilty: guilty
guise: guise
guitar: guitar
gulf: gulf
gulp: gulp,gulped
gun: gun
gunpowder: gunpowder
gush: gushed,gushing
gust: gust
gutter: guttered
gymnasium: gymnasium
gypsy: gypsies,gypsy
ha: ha
habit: habit,habits
habitual: habitual
habitually: habitually
hadst: hadst
haggard: haggard
haggle: haggling
hail: hail
hair: hair
haired: haired
halfpenny: halfpenny
hall: hall,halls
hallo: hallo
hallucination: hallucination,hallucinations
halt: halt,halts
halter: halter
halting: halting
halve: halved
ham: ham
hamlet: hamlet,hamlets
hammer: hammer,hammered,hammering,hammers
hamper: hamper
hand: hand,handed,hands
handed: handed
handful: handful
handkerchief: handkerchief
handsome: handsome
handwriting: handwriting
handy: handy
hang: hang,hanged,hanging,hung
happen: happen,happened,happening
happily: happily
happiness: happiness
happy: happier,happiest,happy
harass: harass,harassed,harassing
hard: hard,harder
hare: hare
harem: harem
harking: harking
harlot: harlot,harlots
harlotry: harlotry
harm: harm
harmless: harmless
harmonious: harmonious
harmony: harmony
harness: harness,harnessed
harp: harp,harping
harsh: harsh
harshly: harshly
harshness: harshness
harvest: harvest
hast: hast
haste: haste
hasten: hasten,hastened,hastening,hastens
hastily: hastily
hasty: hasty
hat: hat
hatch: hatching
hate: hate,hated,hates
hateful: hateful
hatred: hatred
haughtily: haughtily
haughtiness: haughtiness
haughty: haughty
haul: hauled
haunt: haunted,haunting
haunted: haunted
haunting: haunting
hay: hay
hazard: hazard,hazarded
head: head,headed,heads
headache: headache
headed: headed
heading: heading
headlong: headlong
heal: heal,healed,healing
healer: healer
healing: healing
health: health
healthy: healthy
heap: heap,heaped,heaps
hear: hear,heard,hearing,hears
hearing: hearing
hearsay: hearsay
heart: heart,hearts
heartbroken: heartbroken
hearted: hearted
heartedness: heartedness
heartily: heartily
heartless: heartless
heartlessness: heartlessness
heartrending: heartrending
heat: heat,heated
heathen: heathen
heave: heaved
heaven: heaven,heavens
heavenly: heavenly
heavily: heavily
heaving: heaving
heavy: heavy
hebrews: hebrews
heed: heeding
heedless: heedless
heel: heel,heels
heigh: heigh
height: height,heights
heir: heir
heiress: heiress,heiresses
helper: helper
helpless: helpless
helplessly: helplessly
hem: hem,hemmed
hemp: hemp
hempen: hempen
hen: hen,hens
henceforth: henceforth
henceforward: henceforward
herb: herb
herculean: herculean
herd: herd
heresy: heresy
heretic: heretic,heretics
hermit: hermit,hermits
hermitage: hermitage
hero: hero,heroes
heroic: heroic
heroine: heroine
heroism: heroism
hesitate: hesitate,hesitated,hesitating
hesitation: hesitation
hetaira: hetaira
hey: hey
heyday: heyday
hidden: hidden
hide: hidden,hide,hides,hiding
hideous: hideous
hiding: hiding
highly: highly
highness: highness
highwayman: highwayman
hilarity: hilarity
hill: hills
hind: hind
hinder: hinder,hindering,hinders
hindrance: hindrance
hint: hint,hinted,hinting,hints
hire: hire,hired,hiring
hiss: hissed,hisses
hisses: hisses
historian: historians
historical: historical
history: histories,history
hit: hit,hitting
hitch: hitch
hitherto: hitherto
hoard: hoard,hoarded,hoards
hoarding: hoarding
hoarsely: hoarsely
hold: held,hold,holding,holds
hole: hole,holes
holiday: holidays
holiness: holiness
hollow: hollow
holy: holier,holiest,holy
homage: homage
homeless: homeless
homeopathic: homeopathic
homewards: homewards
honest: honest
honestly: honestly
honesty: honesty
honey: honey
honeyed: honeyed
honor: honor,honored,honors
honorable: honorable
honorably: honorably
honorary: honorary
honored: honored
hood: hood
hoodwink: hoodwinking
hook: hooks
hooked: hooked
hop: hop,hopping
hope: hope,hoped,hopes,hoping
hopeless: hopeless
hopelessly: hopelessly
hopelessness: hopelessness
horatio: horatio
horizon: horizon
horn: horn,horns
horny: horny
horrible: horrible
horribly: horribly
horrid: horrid
horrified: horrified
horrify: horrified,horrify
horrifying: horrifying
horror: horror,horrors
horse: horse,horses
horseback: horseback
hospitable: hospitable
hospital: hospital,hospitals
hospitality: hospitality
host: host
hostel: hostels
hostess: hostess
hostile: hostile
hostility: hostility
hot: hot
hotel: hotel
hotly: hotly
hound: hound,hounds
hour: hour,hours
hourly: hourly
house: house,houses
household: household
hover: hovering
howl: howl,howled,howls
hubbub: hubbub
huddle: huddle,huddling
hug: hug,hugged,hugging
huge: huge
hugely: hugely
hugo: hugo
hullo: hullo
hum: hum,humming
human: human
humane: humane
humanity: humanity
humble: humble,humbled,humbler,humbles,humblest
humbleness: humbleness
humbly: humbly
humiliate: humiliated
humiliating: humiliating
humiliation: humiliation
humility: humility
humor: humor,humored
humored: humored
hunch: hunching
hunchback: hunchback
hundredth: hundredth
hundredweight: hundredweight
hunger: hunger
hungering: hungering
hungry: hungry
hunk: hunk
hunt: hunt,hunting
hunter: hunter,hunters
hunting: hunting
huntsman: huntsmen
hurdle: hurdle,hurdles
hurrah: hurrah
hurricane: hurricanes
hurried: hurried
hurriedly: hurriedly
hurry: hurried,hurry,hurrying
hurt: hurt,hurting
husband: husband,husbands
hush: hush,hushed
husky: husky
hussar: hussar
hussy: hussies,hussy
hut: hut,huts
hymn: hymn
hypocrite: hypocrite
hypothesis: hypotheses,hypothesis
hypothetically: hypothetically
hysteria: hysteria
hysteric: hysterics
hysterical: hysterical
hysterically: hysterically
hysterics: hysterics
ice: ice
ich: ich
icy: icy
idea: idea,ideas
ideal: ideal,ideals
idealism: idealism
idealist: idealist
identify: identify
identity: identity
idiocy: idiocy
idiot: idiot
idiotic: idiotic
idiotically: idiotically
idle: idle
idleness: idleness
idler: idlers
idol: idol,idols
ignoble: ignoble
ignominious: ignominious
ignominy: ignominy
ignorance: ignorance
ignorant: ignorant
ignore: ignores
iii: iii
ikon: ikon,ikons
illegitimate: illegitimate
illiterate: illiterate
illness: illness
illogical: illogical
illogicality: illogicality
illuminate: illuminating
illustrate: illustrated
illustrious: illustrious
ilya: ilya
image: image,images
imagination: imagination
imagine: imagine,imagined,imagining
imbecile: imbecile
imitate: imitate
imitation: imitation
immaculate: immaculate
immeasurable: immeasurable
immeasurably: immeasurably
immemorial: immemorial
immense: immense
immensely: immensely
immolation: immolation
immoral: immoral
immortal: immortal
immortality: immortality
immovable: immovable
immovably: immovably
immutably: immutably
impair: impaired
impartial: impartial
impartiality: impartiality
impartially: impartially
impatience: impatience
impatient: impatient
impatiently: impatiently
impel: impelled
imperative: imperative
imperceptible: imperceptible
imperceptibly: imperceptibly
imperfect: imperfect
imperial: imperial
imperious: imperious
imperiously: imperiously
imperiousness: imperiousness
impertinence: impertinence
impertinent: impertinent
impetuous: impetuous
impetuously: impetuously
implicate: implicated
implicit: implicit
implicitly: implicitly
implore: implore,imploring
imploringly: imploringly
imply: implied
import: import
importantly: importantly
importunate: importunate
importunity: importunity
impose: imposed,imposing
impossibility: impossibility
impossible: impossible
impostor: impostor
imposture: imposture
impotence: impotence
impotent: impotent
impotently: impotently
impoverished: impoverished
impress: impress,impressed
impressed: impressed
impression: impression,impressions
impressionable: impressionable
impressive: impressive
impressively: impressively
impressiveness: impressiveness
imprint: imprinted
improbability: improbability
improbable: improbable
improper: improper
improve: improve,improved,improving
imprudent: imprudent
impudence: impudence
impudent: impudent
impudently: impudently
impulse: impulse,impulses
impulsive: impulsive
impulsively: impulsively
impulsiveness: impulsiveness
impunity: impunity
impure: impure
inappropriate: inappropriate
inarticulate: inarticulate
inattentively: inattentively
inaudible: inaudible
incapable: incapable
incarnate: incarnate
incarnation: incarnation
incautious: incautious
incense: incense
incessant: incessant
incessantly: incessantly
inch: inch,inches
incident: incident,incidents
incidental: incidental
incidentally: incidentally
incisive: incisive
incisively: incisively
incite: incited
inclination: inclination
incline: inclined,inclining
inclined: inclined
include: include,included,including
incognito: incognito
incoherence: incoherence
incoherent: incoherent
incoherently: incoherently
income: income
incomparable: incomparable
incomparably: incomparably
incompatible: incompatible
incomplete: incomplete
incomprehensible: incomprehensible
inconceivable: inconceivable
inconceivably: inconceivably
inconclusive: inconclusive
incongruous: incongruous
inconsecutively: inconsecutively
inconsistency: inconsistency
inconsistent: inconsistent
inconsolable: inconsolable
incontinence: incontinence
incorrect: incorrect
incorrectly: incorrectly
incorrigible: incorrigible
incorruptibility: incorruptibility
incorruptible: incorruptible
increase: increase,increased,increases,increasing
incredible: incredible
incredibly: incredibly
incredulity: incredulity
incur: incurring
incurable: incurable
incurably: incurably
indebt: indebted
indebted: indebted
indecent: indecent
indecision: indecision
indefatigably: indefatigably
indefensible: indefensible
indefinable: indefinable
indefinite: indefinite
indelicate: indelicate
independence: independence
independent: independent
indescribable: indescribable
indescribably: indescribably
indeterminate: indeterminate
indication: indication,indications
indifference: indifference
indifferent: indifferent
indigestion: indigestion
indignant: indignant
indignantly: indignantly
indignation: indignation
indignity: indignity
indirect: indirect
indirectly: indirectly
indirectness: indirectness
indiscreet: indiscreet
indiscretion: indiscretion
indiscriminately: indiscriminately
indispensable: indispensable
indisputable: indisputable
indissoluble: indissoluble
individual: individual,individuals
individualism: individualism
individuality: individuality
individually: individually
indolence: indolence
indolently: indolently
indoors: indoors
induce: induce,induced
indulge: indulged,indulging
inept: inept
inequality: inequality
inevitable: inevitable
inevitably: inevitably
inexcusable: inexcusable
inexhaustible: inexhaustible
inexperience: inexperience
inexperienced: inexperienced
inexplicable: inexplicable
inexpressibly: inexpressibly
inexpressive: inexpressive
infallible: infallible
infallibly: infallibly
infamous: infamous
infamy: infamy
infancy: infancy
infant: infant
infantry: infantry
inferior: inferior
infernal: infernal
infidel: infidel,infidels
infidelity: infidelity
infinite: infinite
infinitely: infinitely
infinity: infinity
inflict: inflict,inflicted,inflicting
influence: influence,influenced,influences
influential: influential
inform: inform,informed,informing,informs
infuriate: infuriate,infuriated
ingenuous: ingenuous
ingenuousness: ingenuousness
ingrained: ingrained
ingratiating: ingratiating
ingratitude: ingratitude
ingredient: ingredient
inhabit: inhabited
inhabitant: inhabitants
inharmonious: inharmonious
inherent: inherent
inherit: inherited
inheritance: inheritance
inhuman: inhuman
inhumanly: inhumanly
iniquity: iniquity
injure: injure,injured,injuring
injured: injured
injury: injuries,injury
injustice: injustice
ink: ink
inkling: inkling
inkstand: inkstand
inmate: inmates
inmost: inmost
inn: inn
innkeeper: innkeeper
innocence: innocence
innocent: innocent,innocents
innocently: innocently
innovation: innovation,innovations
innumerable: innumerable
inoculate: inoculated
inoffensive: inoffensive
inquire: inquire,inquired,inquiring
inquiringly: inquiringly
inquiry: inquiries,inquiry
inquisition: inquisition
inquisitive: inquisitive
inquisitively: inquisitively
inquisitor: inquisitor,inquisitors
inquisitors: inquisitors
insane: insane
insanity: insanity
insatiable: insatiable
inscribe: inscribed
inscription: inscription
inscrutable: inscrutable
insect: insect,insects
insensible: insensible
insert: insert,inserting
insight: insight
insignificance: insignificance
insignificant: insignificant
insincerity: insincerity
insinuate: insinuating
insinuatingly: insinuatingly
insinuation: insinuation
insist: insist,insisted,insisting,insists
insistence: insistence
insistent: insistent
insistently: insistently
insolence: insolence
insolent: insolent
insolently: insolently
insoluble: insoluble
inspect: inspecting
inspection: inspection
inspector: inspector
inspiration: inspiration
inspire: inspired
install: installed
installment: installment,installments
instance: instance,instances
instant: instant
instantaneous: instantaneous
instantly: instantly
instigation: instigation
instigator: instigator
instinct: instinct,instincts
instinctive: instinctive
instinctively: instinctively
institution: institution,institutions
instruct: instructed,instructing
instruction: instruction,instructions
instructive: instructive
instrument: instrument
insufferable: insufferable
insufferably: insufferably
insult: insult,insulted,insulting,insults
insulting: insulting
insultingly: insultingly
insuperable: insuperable
insupportable: insupportable
intact: intact
integrity: integrity
intellect: intellect,intellects
intellectual: intellectual
intelligence: intelligence
intelligent: intelligent
intelligible: intelligible
intelligibly: intelligibly
intemperance: intemperance
intend: intend,intended,intending,intends
intense: intense
intensely: intensely
intensest: intensest
intensify: intensified,intensify
intensity: intensity
intent: intent
intention: intention,intentions
intentional: intentional
intentionally: intentionally
intently: intently
intentness: intentness
intercept: intercept
intercession: intercession
interfere: interfere,interfering
interior: interior
interpose: interposed
interpret: interpreted,interpreting
interpretation: interpretation
interrogation: interrogation
interrupt: interrupt,interrupted,interrupting
interrupted: interrupted
interruption: interruption,interruptions
intersect: intersected
interval: interval,intervals
intervene: intervene,intervened
intervention: intervention
interview: interview,interviews
intimacy: intimacy
intimate: intimate
intimately: intimately
intimidate: intimidate,intimidated
intimidation: intimidation
intolerable: intolerable
intolerably: intolerably
intonation: intonation
intoxication: intoxication
intrigue: intrigue,intrigues
introduce: introduce,introduced
introduction: introduction
introductory: introductory
intrude: intrude
intruder: intruder
intrusion: intrusion
intuition: intuition
invade: invading
invalid: invalid
invalidish: invalidish
invariable: invariable
invariably: invariably
invasion: invasion
invent: invent,invented,inventing,invents
inventer: inventer
invest: invested,investing
investigate: investigate,investigating
investigation: investigation
inveterate: inveterate
invincible: invincible
invitation: invitation
invite: invite,invited,invites,inviting
involuntarily: involuntarily
involuntary: involuntary
involve: involve,involved,involves
inwardly: inwardly
irascible: irascible
irksome: irksome
iron: iron,irons
ironical: ironical
ironically: ironically
irony: irony
irrational: irrational
irrefutable: irrefutable
irregular: irregular
irregularity: irregularities,irregularity
irrelevant: irrelevant
irrepressible: irrepressible
irreproachably: irreproachably
irresistible: irresistible
irresistibly: irresistibly
irresolute: irresolute
irresponsible: irresponsible
irresponsiveness: irresponsiveness
irreverent: irreverent
irrevocably: irrevocably
irritability: irritability
irritable: irritable
irritably: irritably
irritate: irritate,irritates
irritated: irritated
irritating: irritating
irritation: irritation
isaac: isaac
islam: islam
isolate: isolated
isolation: isolation
ispravnik: ispravnik
italian: italian
italy: italy
item: item,items
iv: iv
ivan: ivan
ivory: ivory
ix: ix
jackal: jackals
jackanapes: jackanapes
jackdaw: jackdaw
jacket: jacket,jackets
jacob: jacob
jade: jade
jam: jam
january: january
jauntily: jauntily
jaunty: jaunty
jaw: jaw
jealous: jealous
jealousy: jealousy
jeer: jeer,jeered,jeering
jeering: jeering
jeeringly: jeeringly
jelly: jelly
jerk: jerked
jerusalem: jerusalem
jest: jest,jested,jests
jester: jester
jesting: jesting
jestingly: jestingly
jesuit: jesuit
jesuits: jesuits
jesus: jesus
jew: jew
jewel: jewels
jewish: jewish
jews: jews
job: job,jobs
john: john
joint: joint
joke: joke,jokes,joking
jolly: jolly
jolt: jolted
jolting: jolting
jonah: jonah
joseph: joseph
journal: journal,journals
journalist: journalists
journey: journey,journeyed
joy: joy,joys
joyful: joyful
joyfully: joyfully
joyous: joyous
joyously: joyously
judah: judah
judas: judas
judge: judge,judged,judges,judging
judgment: judgment
judicial: judicial
judicious: judicious
jug: jug
july: july
jump: jump,jumped,jumping,jumps
june: june
junior: junior
jurisdiction: jurisdiction
jurisprudence: jurisprudence
jury: jury
juryman: jurymen
justice: justice
justification: justification
justify: justifies,justify,justifying
justly: justly
kaftan: kaftan
karl: karl
kasha: kasha
keen: keen,keenest
keenly: keenly
keeper: keeper,keepers
keeping: keeping
ken: ken
kennel: kennels
kerchief: kerchief
key: key
khans: khans
kick: kick,kicked,kicking
kid: kid,kids
kiddie: kiddies
kidney: kidney
kiev: kiev
kill: kill,killed,killing,kills
kilometer: kilometers
kin: kin
kindle: kindled
kindliness: kindliness
kindly: kindly
kindness: kindness
kindred: kindred
king: king,kings
kingdom: kingdom,kingdoms
kinsman: kinsman
kiss: kiss,kissed,kisses,kissing
kissing: kissing
kitchen: kitchen
kite: kite,kites
kitten: kitten
knave: knave
knee: knee,knees
kneel: kneel,kneeling,knelt
knife: knife,knives
knight: knight,knights
knit: knits,knitted
knock: knock,knocked,knocking,knocks
knot: knots
knout: knout
knoweth: knoweth
knowledge: knowledge
kopeck: kopecks
laban: laban
labor: labor
laborer: laborer
laborious: laborious
lace: lace
lacerate: lacerated,lacerates,lacerating
lacerating: lacerating
laceration: laceration,lacerations
lack: lack,lacked,lacking
lackey: lackey
lad: lad,lads
ladder: ladder
lady: ladies,lady
laid: laid
lake: lake
lamb: lamb
lame: lame
lament: lamented
lamentation: lamentations
lamentations: lamentations
lamp: lamp,lamps
lamplight: lamplight
land: land,lands
landlady: landlady
landlord: landlord
landowner: landowner,landowners
lane: lane
language: language,languages
languish: languishing
lanky: lanky
lantern: lantern
laodicean: laodicean
lap: lap
lapse: lapse,lapsed
lash: lashed,lashes,lashing
latch: latch
late: late
latent: latent
latin: latin
latitude: latitude
lattice: lattice
laudable: laudable
laugh: laugh,laughed,laughing,laughs
laughingly: laughingly
laughter: laughter
laundress: laundress
laurel: laurel
lavish: lavish,lavished
lavishly: lavishly
law: law,laws
lawful: lawful
lawlessness: lawlessness
lawsuit: lawsuit
lawyer: lawyer,lawyers
lay: laid,lay,laying,lays
layman: layman
lazarus: lazarus
lazily: lazily
lazy: lazy
le: le
lead: lead,leading,leads,led
leader: leaders
leading: leading
leaf: leaf,leaves
league: league
lean: lean,leaned,leaning,leant
leaning: leanings
leap: leap,leaping,leapt
leapt: leapt
learn: learn,learned,learning,learns,learnt
learning: learning
leather: leather
leathern: leathern
leave: leave,leaves,leaving,left
leavings: leavings
lecture: lecture
left: left
leg: leg,legs
legacy: legacy
legal: legal
legally: legally
legend: legend,legends
legged: legged
legitimately: legitimately
leisure: leisure
lemon: lemon
lemonade: lemonade
lend: lend,lent
lender: lenders
lending: lending
lengthen: lengthened
lenient: lenient
lent: lent
lenten: lenten
leo: leo
les: les
lessen: lessened
lesson: lesson,lessons
letter: letter,letters
level: level
levity: levity
liable: liable
liar: liar,liars
libel: libel
libelous: libelous
liberal: liberal,liberals
liberalism: liberalism
liberally: liberally
liberals: liberals
liberator: liberator
liberty: liberties,liberty
librarian: librarian
lice: lice
license: license
licentious: licentious
licentiousness: licentiousness
lick: lick,licked,licking
lie: lain,lie,lied,lies,lying
lieutenant: lieutenant
life: life,lives
lifetime: lifetime
lift: lift,lifted,lifting
light: light,lighted,lighter,lights
lighted: lighted
lighten: lighten,lightened,lightening
lightheartedly: lightheartedly
lightly: lightly
lightness: lightness
lightning: lightning
likelihood: likelihood
likeness: likeness
liking: liking
lilac: lilac
limb: limbs
lime: lime,limes
limit: limit,limits
limitation: limitation
limp: limp,limping
limply: limply
linen: linen
linger: lingered,lingering
link: linking
lint: lint
lion: lion
lip: lip,lips
liqueur: liqueur,liqueurs
liquor: liquor
lise: lise
lisp: lisp,lisped
list: list,lists
listen: listen,listened,listening,listens
listener: listener,listeners
listening: listening
listless: listless
listlessly: listlessly
lite: lite
literal: literal
literally: literally
literary: literary
literature: literature
litigation: litigation
litter: litter
live: live,lived,lives,living
lively: lively
liver: liver
living: living
load: load,loaded,loading
loaded: loaded
loan: loan
loath: loath
loathe: loathe,loathed
loathing: loathing
loathsome: loathsome
loathsomeness: loathsomeness
local: local
locate: located
lock: lock,locked,locks
locked: locked
locker: locker
locket: locket
locust: locusts
lodge: lodge,lodged
lodger: lodger,lodgers
lodging: lodging
lodgings: lodgings
loft: loft
loftiness: loftiness
lofty: loftier,lofty
log: log
loggerheads: loggerheads
logic: logic
logical: logical
loll: lolling
loneliness: loneliness
lonely: lonely
longing: longing
longish: longish
loom: loomed
loophole: loophole,loopholes
loose: loose
lord: lord
lorgnette: lorgnette,lorgnettes
lose: lose,loses,losing,lost
loss: loss
lost: lost
lot: lot,lots
lotion: lotion
loud: loud,louder
loudly: loudly
louis: louis
lounge: lounges
lousy: lousy
loutish: loutish
love: love,loved,loves,loving
lovely: lovely
lover: lover,lovers
loving: loving
lovingly: lovingly
lowell: lowell
lowly: lowly
loyal: loyal
luck: luck
luckily: luckily
luckless: luckless
lucky: lucky
lucre: lucre
ludicrous: ludicrous
luggage: luggage
lui: lui
luke: luke
lukewarm: lukewarm
lullaby: lullabies
lumbago: lumbago
luminous: luminous
lunatic: lunatic
lunch: lunch
lurch: lurch,lurched
lure: lures
lurid: lurid
lust: lust
luster: lusters
lusterless: lusterless
lustful: lustful
luther: luther
lutheran: lutheran,lutherans
luxurious: luxurious
luxury: luxuries,luxury
lying: lying
macedon: macedon
machine: machine
machinery: machinery
mad: mad,maddest
madam: madam
madame: madame
madden: madden
madhouse: madhouse
madly: madly
madman: madman,madmen
madness: madness
madonna: madonna
magazine: magazine,magazines
magdalene: magdalene
magician: magician
magistrate: magistrate
magnanimous: magnanimous
magnificent: magnificent
mahogany: mahogany
mahomet: mahomet
maid: maid,maids
maiden: maiden
maidenly: maidenly
main: main
maintain: maintain,maintained,maintaining,maintains
majestic: majestic
majesty: majesty
major: major
majorem: majorem
majority: majority
maker: maker,makers
malice: malice
malicious: malicious
maliciously: maliciously
malignancy: malignancy
malignant: malignant
malignantly: malignantly
malinger: malingering
malt: malt
mamma: mamma,mammas
mammy: mammy
manage: manage,managed
management: management
mange: mange
mangy: mangy
mania: mania
maniac: maniac
manifest: manifest,manifested
manifestation: manifestation
mankind: mankind
manly: manly
manner: manner
manners: manners
mansion: mansion
mantle: mantle
manure: manure
manuscript: manuscript
map: map
maple: maples
marble: marble
marbled: marbled
march: march,marched,marching
margin: margins
maria: maria
marie: marie
mark: mark,marked,marks
marked: marked
markedly: markedly
market: market,markets
marketing: marketing
marquis: marquis
marred: marred
marriage: marriage,marriages
married: married
marry: married,marries,marry,marrying
marshal: marshal
martial: martial
martyr: martyr,martyred,martyrs
marvel: marvel,marveled,marvels
marvelous: marvelous
marvelously: marvelously
mary: mary
masculine: masculine
mash: mash
mask: mask
mason: mason
masons: masons
masquerade: masquerade
mass: mass,masses
massive: massive
master: master,mastering,masters
masters: masters
mastery: mastery
masticate: masticate
mastiff: mastiff
mat: mat
match: match
mater: mater
material: material
materialist: materialist,materialists
maternal: maternal
mathematical: mathematical
mathematics: mathematics
matrimonial: matrimonial
matter: matter,matters
mattress: mattress
mawkish: mawkish
mawkishly: mawkishly
maxim: maxim
mayest: mayest
mayor: mayor
maze: maze
mazurka: mazurka
mead: mead
meadow: meadows
meadows: meadows
meal: meal,meals
meaning: meaning
meanly: meanly
meanness: meanness
measure: measure,measured,measures
meat: meat
mechanical: mechanical
mechanically: mechanically
mechanism: mechanism
medal: medal
meddle: meddle,meddled,meddling
meddlesome: meddlesome
mediator: mediator
medical: medical
medicine: medicine,medicines
meditate: meditate,meditating
meditation: meditation
medium: medium
medley: medley
meek: meek
meekly: meekly
meekness: meekness
meet: meet,meeting,meets,met
meeting: meeting
melancholy: melancholy
melon: melon,melons
melt: melt,melting
melting: melting
memory: memories,memory
menace: menace
menacing: menacing
menacingly: menacingly
mend: mend,mends
menial: menials
mental: mental
mention: mention,mentioned
mephistopheles: mephistopheles
merchant: merchant,merchants
merci: merci
merciful: merciful
merciless: merciless
mercilessly: mercilessly
mercy: mercy
mere: mere
merit: merit
merrily: merrily
merriment: merriment
merry: merry
merrymaking: merrymaking
mess: mess
message: message,messages
messenger: messenger,messengers
messiah: messiah
metal: metal
mete: mete
method: method,methods
metric: metric
metropolis: metropolis
metropolitan: metropolitan
mettlesome: mettlesome
michael: michael
microscopically: microscopically
midday: midday
middle: middle
midnight: midnight
midst: midst
midwife: midwife
mighty: mighty
migration: migrations
milan: milan
mild: mild
mildew: mildew
mildewy: mildewy
mildly: mildly
mildness: mildness
mile: mile,miles
milfoil: milfoil
military: military
milk: milk
milky: milky
milo: milo
mimic: mimic,mimicking
mince: mincing
mincing: mincing
mind: mind,minds
minded: minded
mindedly: mindedly
mindedness: mindedness
mindful: mindful
mineral: mineral
mines: mines
mingle: mingle,mingled
mingling: mingling
miniature: miniature
minimize: minimize,minimizing
ministry: ministry
minority: minority
mint: mint
minute: minute,minutes
minutely: minutely
miracle: miracle,miracles
miraculous: miraculous
mirage: mirage
mirror: mirrors
mirth: mirth
mirthful: mirthful
mirthfully: mirthfully
mischief: mischief
mischievous: mischievous
miscreant: miscreant
miserable: miserable
miserably: miserably
miserly: miserly
misery: misery
misfortune: misfortune,misfortunes
misgiving: misgiving,misgivings
misplace: misplaced
missing: missing
mission: mission
missive: missive
mist: mist,mists
mistake: mistake
mistaken: mistaken
mistakenly: mistakenly
mistress: mistress,mistresses
mistrust: mistrust
mistrustful: mistrustful
mistrustfully: mistrustfully
mistrustfulness: mistrustfulness
misty: misty
misunderstand: misunderstand,misunderstood
misunderstanding: misunderstanding
mix: mix,mixed,mixing
mixed: mixed
mixture: mixture
moan: moaned,moaning,moans
mock: mock,mocking
mockery: mockery
mode: mode
model: model
modeling: modeling
moderate: moderate
moderately: moderately
modern: modern
modest: modest
modestly: modestly
modesty: modesty
modulation: modulation
mohammedan: mohammedan
moi: moi
moist: moist
moisten: moistened
mold: mold
mole: mole,moles
molecule: molecule
molehill: molehill
moment: moment,moments
momentariness: momentariness
momentary: momentary
mon: mon
monastery: monasteries,monastery
monastic: monastic
monday: monday
money: money
moneychanger: moneychanger
moneylender: moneylender
monk: monk,monks
monkey: monkey
monologue: monologue
monotonous: monotonous
monsieur: monsieur
monster: monster,monsters
monstrous: monstrous
monstrously: monstrously
month: month,months
monument: monument
moo: moo
mood: mood
moon: moon
moonlight: moonlight
moor: moor
mop: mopped
moral: moral
moralist: moralists
morality: morality
morally: morally
morass: morass
moravian: moravian
morbid: morbid
morbidly: morbidly
morn: morn
morning: morning
morose: morose
morosely: morosely
morrow: morrow
morsel: morsel
mort: mort
mortal: mortal,mortals
mortar: mortar
mortem: mortem
mortgage: mortgaged
mortification: mortification
mortified: mortified
mortify: mortified
mortifying: mortifying
moscow: moscow
moss: moss
mot: mot
mother: mother,mothers
motherly: motherly
motion: motion,motioned
motionless: motionless
motive: motive,motives
mount: mount,mounted,mounting
mountain: mountain,mountains
mountebank: mountebank
mourn: mourns
mourner: mourners
mournful: mournful
mournfully: mournfully
mourning: mourning
mouth: mouth,mouths
mouthed: mouthed
mouthful: mouthful
movable: movable
movement: movement,movements
mow: mown
mud: mud
muddle: muddle,muddled,muddles,muddling
muddy: muddy
muffle: muffled
mule: mule
multiplication: multiplication
multiply: multiply
multitude: multitude
mumble: mumble,mumbled
mummery: mummery
murder: murder,murdered,murdering,murders
murderer: murderer,murderers
murderous: murderous
murmur: murmur,murmured,murmuring,murmurs
murmuring: murmuring
muscular: muscular
muse: muse,mused,musing
mused: mused
mushroom: mushrooms
music: music
musical: musical
musically: musically
mustard: mustard
musty: musty
mute: mute
mutely: mutely
mutiny: mutiny
mutter: mutter,muttered,muttering
muttering: muttering
mutton: mutton
mutual: mutual
mysterious: mysterious
mysteriously: mysteriously
mystery: mysteries,mystery
mystic: mystic
mysticism: mysticism
mystify: mystifying
myth: myth
mythical: mythical
nag: nag
nagging: nagging
nail: nail,nailed,nailing,nails
naked: naked
napkin: napkin
napoleon: napoleon
narrative: narrative
narrow: narrow,narrowed,narrower
nastiness: nastiness
nasty: nastiest,nasty
nation: nation,nations
national: national
nationality: nationality
native: native
natural: natural
naturally: naturally
naturalness: naturalness
nature: nature,natures
natured: natured
naught: naught
naughtiness: naughtiness
naughty: naughty
nausea: nausea
navigable: navigable
nearer: nearer
nearness: nearness
neat: neat
neatly: neatly
necessity: necessities,necessity
neck: neck
needle: needle
needy: needy
negation: negation
negative: negative
neglect: neglect,neglected
negligence: negligence
neighbor: neighbor,neighbors
neighborhood: neighborhood
neighboring: neighboring
nephew: nephew
nerve: nerves
nervous: nervous
nervously: nervously
nervousness: nervousness
nestle: nestling
nestling: nestlings
nettle: nettles
network: network
newborn: newborn
newly: newly
news: news
newspaper: newspaper,newspapers
nice: nice
nicely: nicely
nicety: nicety
nicht: nicht
nick: nick
nickname: nickname
niece: niece,nieces
night: night,nights
nightcap: nightcap
nightfall: nightfall
nightmare: nightmare,nightmares
nightmarish: nightmarish
nihil: nihil
nihilists: nihilists
nina: nina
nineteen: nineteen
nineteenth: nineteenth
nobility: nobility
noble: noble,nobler,nobles,noblest
nobleman: nobleman,noblemen
noblesse: noblesse
nod: nod,nodded,nodding
noise: noise
noised: noised
noiseless: noiseless
noiselessly: noiselessly
noiselessness: noiselessness
noisily: noisily
nomad: nomad
nominal: nominal
nonchalance: nonchalance
nonsense: nonsense
nonsensical: nonsensical
noodle: noodle,noodles
noose: noose
normal: normal
norman: norman
north: north
nose: nose,noses
nostril: nostril
nostrum: nostrums
notary: notary
note: note,notes
notebook: notebook
notepaper: notepaper
noteworthy: noteworthy
nothingness: nothingness
notice: notice,noticed,noticing
noticeable: noticeable
noticed: noticed
notify: notifies
notion: notion,notions
notoriety: notoriety
notorious: notorious
notre: notre
nouveau: nouveau
novelty: novelty
november: november
novice: novice,novices
novitiate: novitiate
nowadays: nowadays
noxious: noxious
nudging: nudging
numb: numb
numerous: numerous
nunnery: nunnery
nurse: nurse,nursed
nut: nuts
oak: oak
oath: oath,oaths
oats: oats
obdurate: obdurate
obedience: obedience
obedient: obedient
obediently: obediently
obey: obey,obeyed,obeying
object: object,objected,objects
objection: objection
obligation: obligation,obligations
oblige: oblige,obliged,obliging
obligingly: obligingly
oblivion: oblivion
oblivious: oblivious
obnoxious: obnoxious
obscenity: obscenity
obscure: obscure
obscurely: obscurely
obscurity: obscurity
obsequious: obsequious
obsequiously: obsequiously
observant: observant
observation: observation,observations
observe: observe,observed,observing
observer: observer
obsession: obsession
obstacle: obstacle,obstacles
obstinacy: obstinacy
obstinate: obstinate
obstinately: obstinately
obtrude: obtrude
obtuse: obtuse
obvious: obvious
occasion: occasion,occasions
occasionally: occasionally
occupied: occupied
occupy: occupied,occupy
occur: occur,occurred,occurs
occurrence: occurrence
ocean: ocean
och: och
octangular: octangular
odd: odd
odessa: odessa
offend: offend,offended,offending,offends
offended: offended
offender: offender,offenders
offense: offense
offensive: offensive
offer: offer,offered,offering,offers
offering: offering,offerings
offhand: offhand
office: office,offices
officer: officer,officers
official: official,officials
officious: officious
offspring: offspring
oftener: oftener
ogle: ogle
oho: oho
oil: oil
oily: oily
olden: olden
olga: olga
olympus: olympus
omelette: omelette
ominous: ominous
ominously: ominously
omit: omit,omitting
oneself: oneself
onion: onion
online: online
onwards: onwards
ooze: oozed
opal: opal
openly: openly
openness: openness
opera: opera
ophelia: ophelia
opine: opined
opinion: opinion,opinions
opponent: opponent,opponents
opportune: opportune
opportunist: opportunist
opportunity: opportunity
oppose: oppose,opposed,opposing
opposed: opposed
opposition: opposition
oppress: oppressed
oppressed: oppressed
oppressive: oppressive
oppressor: oppressor,oppressors
optimism: optimism
opulent: opulent
orator: orator,orators
orchestra: orchestra
ordain: ordained
ordeal: ordeal
orderly: orderly
ordinance: ordinance
ordinary: ordinary
ore: ore
organ: organ
organism: organism
organization: organization
organize: organize
orgy: orgies,orgy
origin: origin
original: original
orphan: orphan,orphans
orthodox: orthodox
ostensibly: ostensibly
ostentation: ostentation
othello: othello
ough: ough
outbreak: outbreak,outbreaks
outbuilding: outbuildings
outburst: outburst,outbursts
outcome: outcome
outcry: outcries,outcry
outdoor: outdoor
outer: outer
outgrow: outgrown
outhouse: outhouse,outhouses
outlet: outlet
outlive: outlive
outlook: outlook
outpouring: outpouring
outrage: outrage,outraged
outraged: outraged
outright: outright
outset: outset
outshine: outshine
outskirts: outskirts
outstretched: outstretched
outstrip: outstripped
outward: outward
outwardly: outwardly
outweigh: outweighed
oval: oval
overawe: overawed
overbearing: overbearing
overcast: overcast
overcoat: overcoat,overcoats
overcome: overcame,overcome,overcomes
overcrowded: overcrowded
overdo: overdid,overdoing
overdriven: overdriven
overflow: overflow,overflowing
overgrown: overgrown
overhead: overhead
overhear: overhear,overheard
overheated: overheated
overlook: overlook,overlooked,overlooking
overmuch: overmuch
overpower: overpowered,overpowering
override: override
overseer: overseer
overspread: overspread
overstep: overstep,overstepped
overstrain: overstrained
overtake: overtake,overtaken,overtaking,overtook
overtax: overtaxed
overturn: overturn
overwhelm: overwhelmed,overwhelms
overwhelmed: overwhelmed
overwhelming: overwhelming
overwrought: overwrought
owe: owe,owed,owes
owner: owner
ox: ox
oyster: oysters
pace: pace,paced,paces
pacify: pacify
pacing: pacing
pack: pack,packed,packing
package: packages
packet: packet,packets
pagan: pagan
pail: pail
pain: pain,pains
pained: pained
painful: painful
painfully: painfully
paint: painted
painter: painter
pair: pair
palace: palace
pale: pale
paler: paler
pallor: pallor
palm: palm
paltry: paltry
pampered: pampered
pamphlet: pamphlet
pan: pan
pane: pane,panes
pang: pang,pangs
pani: pani
panic: panic
panting: panting
panus: pani
pap: paps
papa: papa
paper: paper,papers
parable: parable,parables
parade: parade
paradise: paradise
paradox: paradox
paradoxical: paradoxical
paragon: paragon
paragraph: paragraph,paragraphs
parallel: parallel
paralyze: paralyzed
paralyzed: paralyzed
paraphrased: paraphrased
parasitic: parasitic
parched: parched
pardon: pardon
pardonable: pardonable
parent: parent,parents
parentage: parentage
parental: parental
parenthesis: parenthesis
parenthetically: parenthetically
parfait: parfait
paris: paris
parisian: parisian
parliament: parliament
paroxysm: paroxysm,paroxysms
parricide: parricide
parry: parried
parsimony: parsimony
parti: parti
partially: partially
partition: partition
partly: partly
partner: partners
partnership: partnership
party: party
pas: pas
pass: pass,passed,passes,passing
passage: passage,passages
passer: passers
passing: passing
passion: passion,passions
passionate: passionate
passionately: passionately
passive: passive
paste: paste
pastime: pastime
pastor: pastors
pasture: pasture
pasty: pasties
pat: pat
patch: patch,patched,patches
patched: patched
pater: pater
paternal: paternal
path: path,paths
pathetic: pathetic
pathetically: pathetically
pathos: pathos
patience: patience
patient: patient,patients
patriarch: patriarch
patrician: patrician
patron: patron
patronage: patronage
patronizingly: patronizingly
patter: pattering
pattern: pattern,patterns
patty: patties
paul: paul
pause: pause,paused
pave: pave
pavement: pavements
paw: paw,paws
pawn: pawn,pawned
pay: paid,pay,paying,pays
payment: payment,payments
pea: peas
peace: peace
peaceably: peaceably
peaceful: peaceful
peacefully: peacefully
peak: peak
peaked: peaked
pear: pears
pearl: pearls
peasant: peasant,peasants
peasantry: peasantry
peasants: peasants
peculiar: peculiar
peculiarity: peculiarities,peculiarity
peculiarly: peculiarly
pedantic: pedantic
pedantry: pedantry
pedestal: pedestal
pedigree: pedigree
peel: peeling
peep: peep,peeped,peeping
peeping: peeping
peer: peered,peering
peevish: peevish
peevishly: peevishly
peine: peine
pen: pen
penalty: penalty
penance: penance
pence: pence
pencil: pencil
pendent: pendent
penetrate: penetrate,penetrated,penetrating
penetration: penetration
penitence: penitence
penitent: penitent
penknife: penknife
penniless: penniless
penny: penny
pense: pense
pensive: pensive
people: peoples
pepper: pepper
perceive: perceive,perceived,perceiving
perceptible: perceptible
perch: perch
peremptorily: peremptorily
peremptory: peremptory
perfect: perfect
perfectibility: perfectibility
perfection: perfection
perfectly: perfectly
perform: perform,performed,performing
performance: performance,performances
perfume: perfumes
peril: peril
perilous: perilous
period: period,periods
perish: perish,perished
permanent: permanent
permanently: permanently
permission: permission
permit: permit,permitted,permitting
pernicious: pernicious
peroration: peroration
perpetrate: perpetrated
perpetration: perpetration
perpetually: perpetually
perplex: perplexed
perplexed: perplexed
perplexing: perplexing
perplexity: perplexity
persecute: persecute,persecuted
persecution: persecution
persevere: persevere
persist: persist,persisted,persisting,persists
persistence: persistence
persistent: persistent
persistently: persistently
person: people,person,persons
personage: personage,personages
personal: personal
personality: personality
personally: personally
perspiration: perspiration
persuade: persuade,persuaded,persuading
persuasively: persuasively
perturb: perturbed
perverse: perverse
pervert: perverted
pessimist: pessimist
pester: pester,pestered,pestering
pestle: pestle
pet: pet
peter: peter
petersburg: petersburg
petition: petition
petrified: petrified
petticoat: petticoat
petty: petty
phantom: phantom,phantoms
phase: phase
phenomena: phenomena
phenomenal: phenomenal
phenomenon: phenomenon
philanthropic: philanthropic
philanthropist: philanthropists
philanthropy: philanthropy
philosopher: philosopher,philosophers
philosophic: philosophic
philosophical: philosophical
philosophy: philosophies,philosophy
phiz: phiz
phlegmatic: phlegmatic
photograph: photograph,photographs
phrase: phrase,phrases
phraseology: phraseology
physical: physical
physiognomist: physiognomist
physiognomy: physiognomy
piano: piano
pick: pick,picked,picking
pickpocket: pickpocket
picnic: picnic,picnics
picture: picture,pictured,pictures
picturesque: picturesque
pie: pies
piece: piece,pieces
pierce: pierce,pierced,piercing
pierrot: pierrot
piety: piety
pig: pig,pigs
pile: pile
pilgrim: pilgrim,pilgrims
pilgrimage: pilgrimage
pillar: pillar
pillow: pillow,pillows
pin: pin,pinned,pins
pinch: pinching
pine: pine,pines,pining
pineapple: pineapple
pink: pink
pinkish: pinkish
pinnacle: pinnacle
pious: pious
pipe: pipe
piping: piping,pipings
piquancy: piquancy
piquant: piquant
pique: piqued
pistol: pistol,pistols
pit: pit
pitch: pitch,pitched,pitching
piteous: piteous
pitiful: pitiful
pitiless: pitiless
pitilessly: pitilessly
pity: pitied,pity
plagiarism: plagiarism
plague: plague
plain: plain
plainly: plainly
plaintive: plaintive
plan: plan,planned,planning,plans
planet: planet
plank: planks
plans: plans
plant: planted,plants
plantation: plantations
plash: plash
plaster: plastered,plasters
plate: plate,plates
platform: platform
plausible: plausible
play: play,played,playing,plays
playful: playful
playfulness: playfulness
playing: playing
playtime: playtime
plead: plead,pleading
pleasant: pleasant
pleased: pleased
pleasing: pleasing
pleasure: pleasure,pleasures
pledge: pledge,pledged
plenty: plenty
pliable: pliable
plot: plot,plotted,plotting
pluck: plucks
plucky: plucky
plump: plump,plumped
plunge: plunge,plunged
pocket: pocket,pockets
poem: poem,poems
poet: poet,poets
poetry: poetry
poignant: poignant
poison: poison,poisons
poke: poked,pokes,poking
poland: poland
polar: polar
pole: pole
poles: poles
police: police
polish: polish
polished: polished
polite: polite
politely: politely
politeness: politeness
political: political
polonius: polonius
pomade: pomade,pomaded
pomatum: pomatum
pomp: pomp
pompous: pompous
pompously: pompously
ponder: ponder,pondered,pondering
pontiff: pontiff
poodle: poodle,poodles
pool: pool
poor: poor,poorer,poorest
pop: pop,popping
pope: pope,popes
popular: popular
population: population
porch: porch
pore: poring
port: port
porter: porter
portfolio: portfolio
portico: portico
portion: portion,portioned,portions
portrait: portrait,portraits
pose: pose
poseur: poseurs
position: position,positions
positive: positive
positively: positively
possess: possess,possessed
possession: possession,possessions
possibility: possibilities,possibility
post: post,posting,posts
posturing: posturing
pot: pot,pots
pounce: pounce,pounced,pouncing
pounced: pounced
pound: pound,pounded,pounding,pounds
pour: pour,poured
pouting: pouting
poverty: poverty
powder: powder
power: power,powers
powerful: powerful
pox: pox
practical: practical
practically: practically
practice: practice,practiced
praise: praise,praised,praises,praising
praiseworthy: praiseworthy
prance: prance,prancing
prank: prank,pranks
prate: prate,prating
prattle: prattled
pray: pray,prayed,praying,prays
prayer: prayer,prayers
pre: pre
preach: preach
preaching: preaching
precaution: precaution,precautions
precede: preceded,precedes,preceding
precept: precept
precinct: precinct,precincts
precious: precious
precipice: precipice
precise: precise
precisely: precisely
preciseness: preciseness
precision: precision
preclude: preclude
precocity: precocity
preconceived: preconceived
predicate: predicates
predict: predict,predicted
prediction: prediction
predispose: predisposed
predominant: predominant
preface: preface
prefer: prefer,preferred,prefers
preferably: preferably
preference: preference
prejudice: prejudice,prejudiced,prejudices
prejudiced: prejudiced
prejudicial: prejudicial
preliminary: preliminary
premature: premature
prematurely: prematurely
premeditate: premeditates
premeditated: premeditated
premeditation: premeditation
premise: premised
preoccupation: preoccupation
preoccupy: preoccupied
preparation: preparation,preparations
preparatory: preparatory
prepare: prepare,prepared,preparing
prepared: prepared
prepossess: prepossessed
prescribe: prescribed
prescription: prescription
presence: presence
presentiment: presentiment
presently: presently
preservation: preservation
preserve: preserve,preserved,preserves,preserving
president: president
press: press,pressed,pressing
presume: presume,presumed
presumption: presumption
pretend: pretend,pretended,pretending,pretends
pretense: pretense
pretext: pretext
pretty: prettier,pretty
prevail: prevail,prevails
prevalent: prevalent
prevaricate: prevaricate
prevent: prevent,prevented
previous: previous
prey: prey
price: price
priceless: priceless
prick: pricked
pride: pride,prided
priest: priest,priests
prime: primed
primitive: primitive
prince: prince,princes
princess: princess
principal: principal
principally: principally
principle: principle,principles
principled: principled
print: print,printed,prints
prison: prison
prisoner: prisoner,prisoners
private: private
privation: privation
privilege: privilege,privileges
privileged: privileged
privy: privy
prize: prize,prized,prizes,prizing
pro: pro
probability: probability
probable: probable
proceed: proceed,proceeded,proceeding
proceeding: proceeding
proceedings: proceedings
proceeds: proceeds
process: process
procession: procession
proclaim: proclaim,proclaimed
procrastinate: procrastinated
procure: procure
prodigal: prodigal
produce: produce,produced,producing
product: product
profanation: profanation
profane: profane
profess: professed,professing
profession: professions
professional: professional
professor: professors
profile: profile
profit: profit
profitable: profitable
profligate: profligate,profligates
profound: profound,profoundest
profoundly: profoundly
program: program
progress: progress
progressive: progressive
progressively: progressively
project: project
prolong: prolong,prolonged
prolonged: prolonged
prominent: prominent
promise: promise,promised,promises,promising
promising: promising
promote: promoted
promotion: promotion
prompt: prompt,prompted,prompting
prone: prone
pronounce: pronounce,pronounced,pronounces
pronounced: pronounced
pronouncement: pronouncement
proof: proof,proofs
prop: prop,propped
propensity: propensity
proper: proper
properly: properly
property: property
prophecy: prophecies,prophecy
prophesied: prophesied
prophesy: prophesied
prophet: prophet,prophets
propitiate: propitiate
proportion: proportion,proportions
proposal: proposal
propose: propose,proposed
proposition: proposition,propositions
propound: propound
propriety: proprieties,propriety
prosaic: prosaic
prose: prose
prosecute: prosecuted,prosecuting
prosecution: prosecution
prosecutor: prosecutor
prospect: prospect
prosperity: prosperity
prostrate: prostrate,prostrated
prostration: prostrations
protect: protect,protected
protection: protection
protector: protector
protest: protest,protested,protesting,protests
protocol: protocol
protoplasm: protoplasm
protracted: protracted
protrude: protruding
proudly: proudly
prove: prove,proved,proves,proving
proverb: proverb,proverbs
provide: provide,providing
providence: providence
province: province,provinces
provincial: provincial
provision: provision,provisions
provocative: provocative
provoke: provoke,provoked
prudent: prudent
prudently: prudently
pry: pry,prying
psalter: psalter
pseudo: pseudo
psychically: psychically
psychological: psychological
psychologically: psychologically
psychologist: psychologist
psychology: psychology
public: public
publication: publication
publicity: publicity
publicly: publicly
publish: publish,published
publishing: publishing
puckered: puckered
pudding: pudding
puddle: puddle
puff: puffed
puffy: puffy
pug: pug
puling: puling
pull: pull,pulled,pulling,pulls
pump: pumped
pun: pun,puns
punch: punch
punctilio: punctilio
punctual: punctual
punctuality: punctuality
punctually: punctually
punish: punish,punished,punishing
punishment: punishment,punishments
puny: puny
pup: pup
puppy: puppy
purchase: purchase,purchases
purchaser: purchaser,purchasers
pure: pure,purer,purest
purely: purely
purgatory: purgatory
purge: purge
purify: purified,purifies,purify
purity: purity
purple: purple
purpose: purpose,purposes
purposely: purposely
purse: purse
pursue: pursue,pursued
pursuit: pursuit
push: push,pushed
pusillanimous: pusillanimous
putrid: putrid
puzzle: puzzle,puzzled,puzzling
puzzled: puzzled
pyramid: pyramid,pyramids
qua: qua
quack: quack,quacks
quadrille: quadrille
quadrillion: quadrillion,quadrillions
quadrillionth: quadrillionth
quaking: quaking
qualification: qualifications
quality: qualities,quality
qualm: qualm,qualms
quantity: quantity
quarrel: quarrel,quarreled,quarreling,quarrels
quarrelsome: quarrelsome
quarter: quarter,quarters
quarters: quarters
queen: queen,queens
queer: queer
queerly: queerly
query: queried
question: question,questioned,questioning,questions
questioner: questioner
questioning: questioning
qui: qui
quick: quick,quicker
quiet: quiet,quieted,quieter,quieting
quietly: quietly
quilt: quilt,quilts
quit: quit
quiver: quiver,quivered,quivering
quote: quote,quoted,quoting
rabble: rabble
rabid: rabid
race: race,races
rachel: rachel
rack: rack,racking
radiance: radiance
radiant: radiant
radically: radically
rag: rag,rags
rage: rage,raging
ragged: ragged
rail: rails
railway: railway,railways
railwayman: railwayman
rain: rain
rainbow: rainbow
raise: raise,raised,raises,raising
raisin: raisins
rake: rake
ram: rammed
ramrod: ramrod
random: random
range: range
rank: rank,ranks
rankle: rankled,rankling
rap: rapped
rapacious: rapacious
rapid: rapid
rapidity: rapidity
rapidly: rapidly
rapture: rapture,raptures
rapturously: rapturously
rare: rare
rarely: rarely
rascal: rascal,rascals
rascally: rascally
raspberry: raspberries
rat: rats
rate: rate
ration: rations
rational: rational
rationally: rationally
rave: raved,raving
raven: raven
raving: raving
ravings: ravings
raw: raw
ray: ray,rays
razor: razor
reach: reach,reached,reaching
reaction: reaction
reactionary: reactionary
read: read,reading,reads
reader: reader,readers
readiness: readiness
reading: reading
ready: readiest,ready
real: real
realism: realism
realist: realist,realists
realistic: realistic
reality: reality
realization: realization
realize: realize,realized,realizes,realizing
realm: realms
reap: reap
reappear: reappeared
reason: reason,reasoned,reasons
reasonable: reasonable
reasoning: reasoning
reassure: reassure,reassured
rebecca: rebecca
rebel: rebel,rebelled,rebelling,rebels
rebellion: rebellion
rebellious: rebellious
rebuild: rebuilding
recall: recall,recalled,recalling
recede: recede,receding
receipt: receipt,receipts
receive: receive,received,receives,receiving
reception: reception
reckless: reckless
recklessly: recklessly
recklessness: recklessness
reckon: reckon,reckoned,reckoning
reckoning: reckoning
recline: reclining
recognition: recognition
recognize: recognize,recognized,recognizes,recognizing
recollect: recollect,recollected,recollecting
recollection: recollection,recollections
recommend: recommended,recommending
reconcile: reconcile,reconciled,reconciling
reconciliation: reconciliation
reconsider: reconsidering
record: record,recorded
recount: recounted
recourse: recourse
recover: recover,recovered,recovers
recovery: recovery
recreate: recreate
recross: recrossing
recruit: recruit
recur: recurred,recurring
red: red,redder
reddish: reddish
redeem: redeem
redouble: redouble,redoubled
reduce: reduce,reduced,reduces
reefer: reefer
reel: reel,reeling
refer: refer,referred,referring
reference: reference,references
refine: refined
refined: refined
refinement: refinement,refinements
reflect: reflect,reflected,reflecting
reflection: reflection,reflections
reflectively: reflectively
reform: reform,reformed,reforms
reformation: reformation
reformer: reformer
refrain: refrain,refrained
refresh: refresh,refreshed
refreshing: refreshing
refuge: refuge
refusal: refusal
refuse: refuse,refused,refuses,refusing
refutation: refutation
refute: refute,refuted
regain: regain,regained,regaining
regard: regard,regarded
regenerate: regenerate,regenerated,regenerating
regeneration: regeneration
regiment: regiment
region: regions
regret: regret,regrets,regretted,regretting
regretfully: regretfully
regular: regular
regularly: regularly
regulation: regulation,regulations
rehabilitate: rehabilitating
reign: reign,reigning
reiterate: reiterated
reject: reject,rejected,rejecting,rejects
rejoice: rejoice,rejoiced,rejoices,rejoicing
rejoicing: rejoicing
relapse: relapse,relapsed,relapsing
relate: relates,relating
relation: relation,relations
relationship: relationship
relative: relative,relatives
relax: relaxed
relaxed: relaxed
release: release,released,releasing
relentless: relentless
relentlessly: relentlessly
relevant: relevant
reliance: reliance
relic: relic,relics
relief: relief
relieve: relieve,relieved
relieved: relieved
religion: religion,religions
religious: religious
religiously: religiously
relinquish: relinquish
relish: relish
reluctantly: reluctantly
rely: relied,rely,relying
remain: remain,remained,remaining,remains
remainder: remainder
remains: remains
remark: remark,remarked,remarking,remarks
remarkable: remarkable
remarkably: remarkably
remedy: remedies,remedy
remember: remember,remembered,remembering,remembers
remembrance: remembrance,remembrances
remind: remind,reminded,reminding
reminder: reminder
reminiscence: reminiscences
remit: remitting
remorse: remorse
remorseful: remorseful
remote: remote,remotest
remoteness: remoteness
remove: remove,removed,removes,removing
rend: rend
render: render
renew: renew,renewed
renewal: renewal
renounce: renounce,renounced,renounces
renown: renown
rent: rent,rented
reopen: reopen
repay: repaid,repay,repaying
repayment: repayment
repeat: repeat,repeated,repeating
repeatedly: repeatedly
repel: repelled,repelling
repent: repent,repented,repents
repentance: repentance
repentant: repentant
repine: repine,repined
replace: replaced
reply: replied,reply,replying
report: report,reported,reporting
repose: repose
represent: represent,represented
repress: repress
reprimand: reprimand,reprimanding
reproach: reproach,reproached,reproaches
reproachful: reproachful
reproachfully: reproachfully
reproachfulness: reproachfulness
reprobate: reprobate
reproduce: reproduce
reproof: reproofs
reprove: reprove
reptile: reptile
republic: republic
repudiate: repudiate
repugnance: repugnance
repugnant: repugnant
repulsion: repulsion
repulsive: repulsive
reputation: reputation,reputations
request: request,requests
requiem: requiem,requiems
require: required,requires
rescue: rescue
resemblance: resemblance
resent: resented
resentful: resentful
resentfully: resentfully
resentment: resentment,resentments
reserve: reserve
reside: residing
resident: resident
resign: resign,resigned,resigning
resist: resist,resisted,resisting,resists
resistance: resistance
resolute: resolute
resolutely: resolutely
resolution: resolution
resolve: resolve,resolved
resonant: resonant
resort: resort,resorted
resounding: resounding
resource: resource
resourcefulness: resourcefulness
respect: respect,respected,respecting,respects
respectable: respectable
respected: respected
respectful: respectful
respectfully: respectfully
respectfulness: respectfulness
respects: respects
respite: respite
respond: respond,responded,responding
response: response
responsibility: responsibility
responsible: responsible
responsive: responsive
rest: rest,rested,resting,rests
restaurant: restaurant
restiveness: restiveness
restless: restless
restlessly: restlessly
restlessness: restlessness
restore: restore,restored,restoring
restrain: restrain,restrained,restraining
restraint: restraint
restrict: restricts
restriction: restrictions
result: result
resume: resumed
resurrection: resurrection
retain: retain,retained
retainer: retainers
retaliate: retaliate
reticence: reticence
retire: retire,retired,retiring
retired: retired
retirement: retirement
retort: retort,retorted
retreat: retreat,retreated,retreating
retribution: retribution
return: return,returned,returning,returns
reunite: reunite
reveal: reveal,revealed,revealing
revel: revel,revels
reveler: revelers
revenge: revenge,revenged
revengeful: revengeful
revenue: revenue,revenues
revere: revered
revered: revered
reverence: reverence,reverenced
reverend: reverend
reverent: reverent
reverently: reverently
reverie: reverie
review: reviews
reviewer: reviewer
revile: revile,reviling
revision: revision
revive: revive,revived,revives
revolting: revolting
revolution: revolution
revolutionary: revolutionaries
revolutionist: revolutionist,revolutionists
revolver: revolver,revolvers
revulsion: revulsion,revulsions
reward: reward,rewarded
rhetoric: rhetoric
rhetorical: rhetorical
rheumatic: rheumatic
rheumatism: rheumatism
rhine: rhine
rhyme: rhyme
rib: ribs
ribbon: ribbon,ribbons
rich: rich,richest
richard: richard
riches: riches
rickety: rickety
rid: rid
riddance: riddance
ridden: ridden
riddle: riddle,riddles
ride: ride,riding,rode
ridicule: ridicule,ridiculed
ridiculous: ridiculous
ridiculously: ridiculously
rig: rigged
righteous: righteous
righteousness: righteousness
rightful: rightful
rigid: rigid
rigidity: rigidity
rigmarole: rigmarole
rimmed: rimmed
riot: riot
rioting: rioting
riotous: riotous
rise: rise,risen,rises,rising,rose
risk: risk,risked
risky: risky
rite: rite
ritual: ritual
rival: rival,rivals
rivalry: rivalry
river: river
rivet: riveted
road: road,roads
roadway: roadway
roar: roar,roared,roaring,roars
roasted: roasted
rob: rob,robbed,robbing
robber: robber,robbers
robbery: robbery
robbing: robbing
robe: robes
robust: robust
rock: rock
rocket: rocket
rod: rod,rods
rogue: rogue,rogues
roguery: roguery
roll: roll,rolled,rolling,rolls
rollicking: rollicking
roman: roman,romans
romance: romance,romances,romancing
romancer: romancers
romantic: romantic
rome: rome
romish: romish
roo: roo
roof: roof
roomy: roomy
root: root,rooted,roots
rope: rope
rose: rose,roses
rosy: rosy
rot: rot,rotted,rotting
rotation: rotation
rotten: rotten
rouble: rouble,roubles
rough: rough,rougher,roughest
roughly: roughly
roundly: roundly
rouse: rouse,roused
rousing: rousing
routine: routine
row: row,rows
rowdy: rowdy
royal: royal
rub: rub,rubbed,rubbing,rubs
rubbish: rubbish
rude: rude
rudely: rudely
rudeness: rudeness
rudiment: rudiments
ruffian: ruffian
ruffle: ruffled
rug: rug
ruin: ruin,ruined,ruining
rule: rule,ruled,rules,ruling
ruler: ruler,rulers
rum: rum
rumble: rumble
rummage: rummage
rumor: rumor,rumored,rumors
runaway: runaway
running: running
rural: rural
rush: rush,rushed,rushes,rushing
russia: russia
russian: russian,russians
rustle: rustled
rustling: rustling
rye: rye
saber: saber
sable: sable
sack: sack
sacrament: sacrament
sacred: sacred
sacrifice: sacrifice,sacrificed,sacrifices,sacrificing
sacrilege: sacrilege
sad: sad
sades: sades
sadly: sadly
sadness: sadness
safe: safe
safety: safety
saffron: saffron
sagacious: sagacious
sage: sage,sages
saint: saint,saints
sainte: sainte
sainted: sainted
saintliness: saintliness
saintly: saintly
saints: saints
saith: saith
sake: sake
salary: salary
sale: sale
sallow: sallow
sallower: sallower
sallowness: sallowness
sally: sallies
salmon: salmon
salt: salt
saltpeter: saltpeter
salutary: salutary
salute: salute
salvation: salvation
samovar: samovar,samovars
sancta: sancta
sanctimoniousness: sanctimoniousness
sanction: sanction,sanctioned
sanctity: sanctity
sand: sand,sands
sandwich: sandwiches
sane: sane
sapphire: sapphire
sappho: sappho
sarafan: sarafan
sarah: sarah
sarcasm: sarcasm,sarcasms
sarcastic: sarcastic
sarcastically: sarcastically
sash: sash
satan: satan
satanic: satanic
satchel: satchel,satchels
satellite: satellite
satirical: satirical
satisfaction: satisfaction
satisfactorily: satisfactorily
satisfactory: satisfactory
satisfied: satisfied
satisfy: satisfied,satisfy,satisfying
saturday: saturday
sauce: sauces
saucer: saucer,saucers
saucy: saucy
sausage: sausage
savage: savage,savages
savagely: savagely
savant: savant
save: save,saved,saving
saving: saving
savings: savings
savior: saviors
saviour: saviour
savory: savories
scabbard: scabbard
scaffold: scaffold
scale: scales
scamp: scamp
scan: scanned,scanning
scandal: scandal,scandals
scandalous: scandalous
scanty: scanty
scapegoat: scapegoat
scapegrace: scapegrace
scar: scars
scarcely: scarcely
scare: scare,scared,scaring
scared: scared
scarf: scarf
scatter: scattered
scattered: scattered
scene: scene,scenes
scent: scent,scented,scenting
scheme: scheme,schemes
schiller: schiller
scholar: scholar
school: school,schools
schoolboy: schoolboy,schoolboys
schoolboys: schoolboys
schoolfellow: schoolfellow,schoolfellows
schoolmaster: schoolmaster
schultz: schultz
science: science,sciences
scientific: scientific
scissors: scissors
scoff: scoff,scoffed,scoffing
scoffer: scoffers
scold: scold,scolded,scolding
scope: scope
scorch: scorch,scorched
score: score,scores
scorn: scorn,scorned
scornful: scornful
scornfully: scornfully
scoundrel: scoundrel,scoundrels
scourge: scourge,scourges
scowl: scowled,scowling
scrap: scrap
scrape: scrape,scrapes,scraping
scrapings: scrapings
scratch: scratch,scratching
scrawl: scrawled
scream: scream,screamed,screaming,screams
screaming: screaming
screen: screen,screened
screw: screw,screwed
scribble: scribble,scribbled
scripture: scripture,scriptures
scriptures: scriptures
scruple: scrupled,scruples
scrupulous: scrupulous
scrupulously: scrupulously
scrutinize: scrutinize,scrutinized,scrutinizing
scrutiny: scrutiny
scythe: scythe
sea: sea
seal: seal,sealed,seals
sealing: sealing
sealskin: sealskin
seam: seams
search: search,searched,searching
searchingly: searchingly
season: season,seasons
seat: seat,seated,seating,seats
secluded: secluded
seclusion: seclusion
secondary: secondary
secrecy: secrecy
secret: secret,secrets
secretary: secretary
secretly: secretly
sect: sect
secular: secular
secularist: secularists
secure: secure,securing
security: security
seduce: seduce,seduced,seducing
seducer: seducer
seduction: seduction
seductive: seductive
seed: seed,seeds
seek: seek,seeking,seeks,sought
seemly: seemly
seer: seer
seething: seething
seize: seize,seized,seizing
seldom: seldom
select: selected,selecting
selection: selection
selfishness: selfishness
sell: sell,selling,sold
semblance: semblance
send: send,sending,sends
senior: senior
sensation: sensation,sensations
sensationally: sensationally
sense: sense
senseless: senseless
senselessly: senselessly
senselessness: senselessness
sensibility: sensibilities,sensibility
sensibly: sensibly
sensitive: sensitive
sensitively: sensitively
sensitiveness: sensitiveness
sensual: sensual
sensualist: sensualist,sensualists
sensualists: sensualists
sensuality: sensuality
sentence: sentence,sentenced,sentences
sentencing: sentencing
sententious: sententious
sententiously: sententiously
sentiment: sentiment,sentiments
sentimental: sentimental
sentimentalist: sentimentalists
sentimentality: sentimentality
sentry: sentry
separate: separate,separated
separately: separately
separation: separation
september: september
sequel: sequel
sequence: sequence
seraphim: seraphim
serene: serene
serenely: serenely
serenity: serenity
serf: serf,serfs
serfdom: serfdom
sergeant: sergeant
series: series
seriousness: seriousness
sermon: sermons
serpent: serpent
servant: servant,servants
serve: serve,served,serves,serving
service: service,services
servile: servile
set: set,sets,setting
settee: settees
setting: setting,settings
settle: settle,settled,settles,settling
settled: settled
settlement: settlement
seventeen: seventeen
seventh: seventh
severe: severe
severely: severely
severity: severities,severity
seville: seville
sew: sew,sewed,sewn
sewing: sewing
sex: sex,sexes
sha: sha
shabby: shabby
shades: shades
shadow: shadow,shadows
shady: shady
shaft: shafts
shaggy: shaggy
shake: shake,shaken,shakes,shaking,shook
shakespeare: shakespeare
shallow: shallow
shalt: shalt
sham: sham,shammed,shamming
shame: shame
shameful: shameful
shamefully: shamefully
shameless: shameless
shamelessly: shamelessly
shape: shape
shaped: shaped
shapeless: shapeless
share: share,shared,sharing
sharp: sharp
sharply: sharply
shatter: shattered
shaven: shaven
shaving: shavings
shawl: shawl
sheep: sheep
sheepish: sheepish
sheepskin: sheepskin
sheet: sheet
shelf: shelf
shelter: shelter,sheltered
shepherd: shepherd,shepherds
sherd: sherd
shift: shifted,shifting
shindy: shindy
shine: shine,shines,shining,shone
shiny: shiny
shirt: shirt
shiver: shiver,shivered,shivers
shock: shock,shocked
shocked: shocked
shocking: shocking
shoe: shoe,shoes
shoot: shoot,shoots,shot
shooting: shooting
shop: shop,shops
shopkeeper: shopkeeper
shopman: shopman
shopmen: shopmen
shore: shores
short: short,shorter,shortest
shorten: shortened
shortly: shortly
shot: shot
shoulder: shoulder,shoulders
shout: shout,shouted,shouting,shouts
shouting: shouting
shove: shove,shoved
shower: shower
shrewd: shrewd
shriek: shriek,shrieked,shrieking,shrieks
shrill: shrill
shrilly: shrilly
shrine: shrine
shrink: shrank,shrunk
shrivel: shriveled
shroud: shrouded
shrub: shrubs
shrug: shrugged
shudder: shudder,shuddered,shuddering
shuffle: shuffle,shuffled
shuffling: shuffling
shun: shun
shut: shut,shutting
shutter: shutter,shutters
shy: shy
shyly: shyly
shyness: shyness
siberia: siberia
sicily: sicily
sick: sick
sickly: sickly
sickness: sickness
sided: sided
sideways: sideways
sieve: sieve
sigh: sigh,sighed,sighing,sighs
sight: sight
sighted: sighted
sign: sign,signed,signing,signs
signal: signal,signals
signature: signature
significance: significance
signify: signified,signify
silence: silence,silenced
silent: silent
silently: silently
silenus: silenus
silk: silk
silken: silken
silky: silky
silliness: silliness
silly: silly
silver: silver
simile: simile
simper: simpering
simple: simple,simpler,simplest
simpleton: simpleton
simplicity: simplicity
simply: simply
simulate: simulated
simulated: simulated
simultaneously: simultaneously
sin: sin,sinned,sinning,sins
sincerely: sincerely
sincerity: sincerity
sine: sine
sinful: sinful
sinfulness: sinfulness
sing: sang,sing,singing,sings,sung
singing: singing
single: single
singular: singular
singularly: singularly
sinister: sinister
sink: sank,sink,sinking,sinks,sunk,sunken
sinking: sinking
sinless: sinless
sinner: sinner,sinners
sip: sip,sipped,sipping
sir: sir
sirius: sirius
sister: sister,sisters
sit: sat,sit,sits,sitting
situation: situation
sixpenny: sixpenny
sixteen: sixteen
sixteenth: sixteenth
sixth: sixth
size: size
skeptical: skeptical
skepticism: skepticism
sketch: sketch,sketched,sketches
skillful: skillful
skillfully: skillfully
skin: skin,skinned,skins
skip: skip,skipped,skipping
skirmish: skirmish,skirmishes
skirt: skirt,skirted,skirting,skirts
skull: skull
sky: skies,sky
skylight: skylight
slam: slam,slammed
slander: slander,slandered,slandering,slanders
slandered: slandered
slant: slanting
slap: slap,slapped,slaps
slash: slash
slaughter: slaughter
slave: slave,slaves
slavery: slavery
slavish: slavish
slavishly: slavishly
slavonic: slavonic
slavs: slavs
slay: slain,slay
sledge: sledges
sleep: sleep,sleeping,slept
sleeper: sleeper
sleeping: sleeping
sleepy: sleepy
sleet: sleet
sleeve: sleeve,sleeves
slender: slender
slight: slight,slighted,slightest
slighting: slighting
slim: slim
sling: slung
slip: slip,slipped,slipping
slipper: slipper,slippers
slit: slit
slobber: slobbered
slop: slop,slops
slothfulness: slothfulness
slow: slow
slowcoach: slowcoach
slowly: slowly
slowness: slowness
sluggard: sluggards
slum: slums
slumber: slumber,slumbering
slur: slur,slurred
slut: slut,sluts
sly: sly
slyly: slyly
slyness: slyness
smack: smack
smallness: smallness
smallpox: smallpox
smart: smart,smarting
smartly: smartly
smash: smash,smashed,smashes
smattering: smattering
smear: smeared
smell: smell,smelled,smelt
smile: smile,smiled,smiles,smiling
smilingly: smilingly
smite: smite,smote
smock: smock
smoke: smoke,smoked,smoking
smoky: smoky
smolder: smoldered
smooth: smooth,smoothed,smoothing
smother: smother,smothered
snap: snap,snapped,snapping
snare: snares
snarl: snarled,snarling
snatch: snatch,snatched,snatches,snatching
sneak: sneak
sneer: sneer,sneered,sneering
sneering: sneering
sneeze: sneeze,sneezed
sniff: sniff,sniffed,sniffing
snigger: snigger
snivel: sniveling
snore: snored,snoring
snow: snow
snowball: snowball
snowstorm: snowstorm
snowy: snowy
snub: snubs
snubbing: snubbing
snug: snug
soak: soak,soaked
soap: soaped,soaping
soar: soar
sob: sob,sobbed,sobbing,sobs
sober: sober,sobered
social: social
socialism: socialism
socialist: socialist,socialists
socialistic: socialistic
society: societies,society
sock: socks
sodom: sodom
sofa: sofa,sofas
soft: soft
soften: soften,softened,softening,softens
softened: softened
softening: softening
softly: softly
softness: softness
soil: soil,soiled,soiling
sojourn: sojourn
solar: solar
soldier: soldier,soldiers
soldierly: soldierly
sole: sole
solely: solely
solemn: solemn
solemnity: solemnity
solemnly: solemnly
solicitude: solicitude
solid: solid
solidarity: solidarity
solitary: solitary
solitude: solitude
solution: solution
solve: solve,solved
somber: somber
son: son,sons
song: song,songs
sonorous: sonorous
sooner: sooner
soothe: soothe,soothed,soothing
sorceress: sorceress
sorcery: sorcery
sordid: sordid
sore: sore,sores
sorrow: sorrow
sorrowful: sorrowful
sorrowfully: sorrowfully
sort: sort,sorts
sot: sot
sottish: sottish
soul: soul,souls
sound: sound,sounded,sounds
soundly: soundly
soup: soup
source: source,sources
south: south
southern: southern
sovereign: sovereign
sovereignty: sovereignty
sow: sow,sowed,sown
space: space,spaces
spacious: spacious
spain: spain
spangle: spangles
spare: spare,spared
sparingly: sparingly
spark: spark
sparkling: sparkling
spasm: spasm
spasmodic: spasmodic
spatter: spatter
speak: speak,speaking,speaks,spoke,spoken
speaker: speaker,speakers
speaking: speaking
spear: spear
special: special
specialist: specialist,specialists
speciality: speciality
specially: specially
species: species
specimen: specimen,specimens
spectacle: spectacle
spectacles: spectacles
spectator: spectators
speculation: speculation
speech: speech,speeches
speechless: speechless
speed: speed,speeding
speedy: speedy
spend: spend,spending,spends,spent
spending: spending
spendthrift: spendthrift
sphere: spheres
sphinx: sphinx
spider: spider,spiders
spill: spilt
spin: spin,spinning,spun
spine: spine
spinning: spinning
spirit: spirit,spirits
spiritual: spiritual
spiritualist: spiritualists
spiritually: spiritually
spit: spat,spit
spite: spite
spiteful: spiteful
spitefully: spitefully
spitfire: spitfire
spleen: spleen
splendid: splendid
splendidly: splendidly
split: split
spluttering: spluttering
spoil: spoil,spoiling,spoilt
spoiled: spoiled
spoilt: spoilt
sponge: sponge
spontaneous: spontaneous
spontaneously: spontaneously
spoon: spoon
spoonful: spoonful
sport: sport,sports
spot: spot,spots,spotted
spotless: spotless
spread: spread,spreading
spree: spree
spring: sprang,spring,springing,springs,sprung
sprinkle: sprinkled
sprinkling: sprinkling
spur: spur,spurring
spurt: spurt
spy: spy,spying
spying: spying
squander: squander,squandered,squandering
square: square
squash: squash
squeal: squeal,squealed,squealing
squeamish: squeamish
squeeze: squeeze,squeezed,squeezes,squeezing
squelch: squelch
squint: squint
stab: stab,stabbed,stabbing,stabs
stable: stable
stage: stage
stagger: stagger,staggered,staggering
staggering: staggering
staid: staid
stain: stain,stained
stair: stairs
staircase: staircase,staircases
stake: stake,stakes
stammer: stammered,stammering
stamp: stamp,stamped,stamping
stand: stand,standing,stands,stood
standing: standing
standpoint: standpoint
standstill: standstill
star: star,stars
stare: stare,stared,stares,staring
start: start,started,starting,starts
startle: startle,startled
startled: startled
startling: startling
starvation: starvation
starve: starving
stately: stately
statement: statement,statements
statesman: statesman
station: station,stationed
statistics: statistics
statue: statue
statute: statute
stay: stay,stayed,staying
steadfast: steadfast
steadfastly: steadfastly
steadily: steadily
steady: steady
steal: steal,stealing,steals,stole,stolen
stealer: stealers
stealing: stealing
stealthily: stealthily
steam: steam,steaming
steamer: steamers
steep: steep,steeped
stellar: stellar
stench: stench
step: step,stepped,stepping,steps
steppe: steppe,steppes
sterlet: sterlets
stern: stern,sternest
sterner: sterner
sternly: sternly
sternness: sternness
stew: stewed
steward: steward
stick: stick,sticking,sticks,stuck
sticky: sticky
stiff: stiff
stiffen: stiffened
stiffly: stiffly
stifle: stifle,stifling
stillness: stillness
sting: sting,stinging,stings,stung
stingy: stingy
stink: stink,stinking,stinks
stint: stint
stir: stir,stirred,stirring,stirs
stirabout: stirabout
stirring: stirring
stock: stock
stocking: stocking,stockings
stockingless: stockingless
stoical: stoical
stolid: stolid
stolidly: stolidly
stomach: stomach
stone: stone,stones
stony: stony
stool: stool,stools
stoop: stoop,stooped
store: store,stores,storing
storied: storied
storm: storm
stormy: stormy
story: stories,story
stout: stout
stoutish: stoutish
stoutly: stoutly
stove: stove
straight: straight
straightforward: straightforward
strain: strain,strained,strains
strained: strained
strait: straits
straiten: straitened
straitened: straitened
strand: stranded
strange: strange,strangest
strangely: strangely
strangeness: strangeness
stranger: stranger,strangers
strangle: strangle,strangled,strangling
strasburg: strasburg
stratagem: stratagem
straw: straw
stray: stray,strayed
streak: streaked
stream: stream,streamed,streaming,streams
street: street,streets
strength: strength
strengthen: strengthened
strenuous: strenuous
stress: stress
stretch: stretched,stretches,stretching
stricken: stricken
strict: strict,strictest
strictly: strictly
stride: stride,strides,striding,strode
strike: strike,strikes,striking,struck
striking: striking
strikingly: strikingly
string: string
strip: strip,stripped
striped: striped
strive: strive,striven,strives,striving,strove
stroke: stroked,strokes,stroking
stroll: strolling
strong: strong,stronger,strongest
stronghold: stronghold
struggle: struggle,struggled,struggles,struggling
strut: strutting
stubborn: stubborn
stubbornly: stubbornly
stuck: stuck
stud: studs
student: student,students
study: studied,studies,study,studying
stuff: stuff,stuffed,stuffing
stuffy: stuffy
stumble: stumble,stumbled,stumbling
stumbling: stumbling
stump: stump,stumps
stun: stun,stunned
stunned: stunned
stupefaction: stupefaction
stupefied: stupefied
stupefy: stupefied,stupefy
stupendous: stupendous
stupid: stupid,stupider,stupidest
stupidity: stupidity
stupidly: stupidly
sturdy: sturdy
style: style
stylish: stylish
stylishly: stylishly
suavely: suavely
subdue: subdue
subdued: subdued
subject: subject,subjected,subjects
subjection: subjection
subjective: subjective
sublimity: sublimity
submission: submission
submissive: submissive
submissiveness: submissiveness
submit: submit,submitted,submitting
subordinate: subordinate
subscribe: subscribed
subscription: subscription
subsequent: subsequent
subsequently: subsequently
subside: subsided
substance: substance
substantial: substantial
substitute: substitute,substituted
subterfuge: subterfuge
subtle: subtle,subtlest
subtlety: subtleties,subtlety
succeed: succeed,succeeded
success: success
successful: successful
succession: succession
successive: successive
suck: suck,sucked,sucking
sudden: sudden
suddenly: suddenly
sue: sue
suffer: suffer,suffered,suffering,suffers
sufferer: sufferer,sufferers
suffering: suffering,sufferings
sufferings: sufferings
suffice: suffice
sufficient: sufficient
suffocation: suffocation
suffuse: suffused
sugar: sugar
sugary: sugary
suggestion: suggestion,suggestions
suggestive: suggestive
suicide: suicide,suicides
suit: suit,suited,suits
suitable: suitable
suitor: suitor,suitors
sulk: sulked,sulking
sulky: sulky
sullen: sullen
sullenly: sullenly
sullenness: sullenness
sully: sullied
sulphur: sulphur
sum: sum,summed,sums
summarize: summarize
summer: summer
summon: summoned,summoning
summons: summons
sumptuous: sumptuous
sun: sun
sunburnt: sunburnt
sunday: sunday
sundays: sundays
sunk: sunk
sunken: sunken
sunlight: sunlight
sunrise: sunrise
sunshine: sunshine
super: super
supercilious: supercilious
superciliously: superciliously
superciliousness: superciliousness
superficial: superficial
superfluous: superfluous
superintendent: superintendent
superior: superior
superiority: superiority
superstition: superstition
superstitious: superstitious
supervision: supervision
supper: supper,suppers
supple: supple
supplicating: supplicating
support: support,supported,supporting,supports
suppose: suppose,supposed,supposing
supposition: supposition
suppress: suppress,suppressed
supreme: supreme
surely: surely
surface: surface
surge: surged,surging
surgeon: surgeon
surliness: surliness
surly: surly
surmise: surmise,surmises
surname: surname
surplice: surplice
surprise: surprise,surprised,surprises
surprised: surprised
surprising: surprising
surprisingly: surprisingly
surrender: surrender
surround: surround,surrounded,surrounding
surroundings: surroundings
survey: survey
survive: survive
susceptibility: susceptibilities
susceptible: susceptible
suspect: suspect,suspected,suspecting
suspense: suspense
suspicion: suspicion,suspicions
suspicious: suspicious
suspiciousness: suspiciousness
sustain: sustained
sustenance: sustenance
swagger: swagger
swaggerer: swaggerer
swallow: swallow,swallowed,swallowing
swan: swan
swarm: swarmed
sway: sway,swayed,swaying
swear: swear,swearing,swore,sworn
swearing: swearing
sweat: sweat
sweep: sweep,sweeps,swept
sweet: sweet,sweetest,sweets
sweetly: sweetly
sweetmeat: sweetmeat,sweetmeats
sweetness: sweetness
swell: swell,swelling,swells,swollen
swift: swift
swiftly: swiftly
swiftness: swiftness
swim: swim
swindle: swindle,swindled,swindling
swindler: swindler,swindlers
swing: swung
swinish: swinish
swinishness: swinishness
swiss: swiss
swollen: swollen
swoon: swoon,swooned
sword: sword
syllable: syllable,syllables
sylvester: sylvester
symbolic: symbolic
sympathetic: sympathetic
sympathetically: sympathetically
sympathize: sympathize
sympathy: sympathy
symptom: symptom,symptoms
synod: synod
syracuse: syracuse
syria: syria
syrian: syrian
systematic: systematic
table: table,tables
tableaux: tableaux
taciturn: taciturn
tact: tact
tactless: tactless
tail: tail,tails
tailor: tailor
tainted: tainted
taketh: taketh
tale: tale,tales
talent: talent,talents
talented: talented
talisman: talisman
talk: talk,talked,talking,talks
talkative: talkative
talking: talking
tall: tall,taller
tallow: tallow
tammy: tammy
tangibly: tangibly
tangle: tangle
tap: tap,tapped,tapping,taps
tape: tape
tartars: tartars
task: task
tassel: tassels
taste: taste,tasted,tastes,tasting
tatar: tatar
tattered: tattered
taunt: taunt,taunted,taunting
tauntingly: tauntingly
tavern: tavern,taverns
tax: tax
tea: tea
teach: taught,teach,teaches,teaching
teacher: teacher,teachers
teaching: teaching
team: team
tear: tear,tearing,tears,tore,torn
tearful: tearful
tearfully: tearfully
tease: tease,teased,teasing
tedious: tedious
telegram: telegram
telegraph: telegraph,telegraphed
teller: teller,tellers
telling: telling
temp: temps
temper: temper,tempered
temperament: temperament
tempered: tempered
tempest: tempest,tempests
temple: temple,temples
temporary: temporary
tempt: tempt,tempted,tempting,tempts
temptation: temptation,temptations
tempting: tempting
tend: tended
tendency: tendency
tender: tender,tenderer,tenderest
tenderer: tenderer
tenderly: tenderly
tenderness: tenderness
tenfold: tenfold
tenor: tenor
tense: tense
tension: tension
tenth: tenth
term: term,terms
terrible: terrible
terribly: terribly
terrified: terrified
terrify: terrify
terror: terror
testament: testament
testify: testified,testify
testimonial: testimonial
testimony: testimony
teucer: teucer
thankful: thankful
thankfulness: thankfulness
thaw: thaw
theater: theater
theatrical: theatrical
thee: thee
theft: theft
theme: theme
theologian: theologians
theological: theological
theoretically: theoretically
theory: theories,theory
thereabout: thereabout
thermometer: thermometer
thicket: thicket
thickly: thickly
thief: thief
thievish: thievish
thigh: thigh
thine: thine
thinker: thinker
thinking: thinking
thirdly: thirdly
thirst: thirst,thirsted,thirsting
thirsting: thirsting
thirteen: thirteen
thirteenth: thirteenth
thirtieth: thirtieth
thomas: thomas
thoughtful: thoughtful
thoughtfully: thoughtfully
thousandth: thousandth
thrash: thrash,thrashed,thrashes,thrashing
thread: thread,threads
threadbare: threadbare
threat: threat,threats
threaten: threaten,threatened,threatening
threateningly: threateningly
threshold: threshold
thrill: thrill
thrilled: thrilled
thrilling: thrilling
throat: throat
throb: throb,throbbed,throbbing,throbs
throbbing: throbbing
throne: throne
throng: thronged,thronging
throw: threw,throw,throwing,thrown,throws
thrum: thrum
thrush: thrush
thrust: thrust,thrusting
thud: thud
thumb: thumb
thump: thumped
thunder: thunder,thundered
thunderbolt: thunderbolt
thunderous: thunderous
thunderstruck: thunderstruck
thursday: thursday
thy: thy
thyself: thyself
ticket: ticket
tickle: tickle,tickled,tickling
ticklish: ticklish
tidy: tidy
tie: tie,tied,ties
tiger: tiger
tight: tight
tightly: tightly
tights: tights
tigress: tigress
tile: tiled
tilt: tilt
timber: timber
time: time,times
timid: timid
timidity: timidity
timidly: timidly
timorous: timorous
tinge: tinge
tinkle: tinkled
tinkling: tinkling
tint: tint
tiny: tiny
tipsy: tipsy
tiptoe: tiptoe
tirade: tirade
tire: tire
tired: tired
tit: tit
titanic: titanic
title: title,titles
titter: tittered,tittering
toadstool: toadstool
toady: toady
toast: toast
tobacco: tobacco
toe: toe,toes
toffee: toffee
toil: toil
token: token
tolerable: tolerable
tolstoy: tolstoy
tom: tom
tomb: tomb,tombs
tombstone: tombstone,tombstones
tone: tone,tones
tongue: tongue
tooth: teeth
toothache: toothache
topaz: topaz
topic: topic
topmost: topmost
topsy: topsy
torch: torch
torment: torment,tormented,tormenting,torments
tormenting: tormenting
tormentor: tormentor,tormentors
tormentress: tormentress
torn: torn
tortoise: tortoise
torture: torture,tortured,tortures,torturing
tortured: tortured
torturer: torturer,torturers
toss: toss,tossed,tossing
total: total
totter: tottering
touch: touch,touched,touches,touching
touching: touching
touchingly: touchingly
tour: tour
tout: tout
tow: tow
towel: towel
tower: tower,towering,towers
town: town,towns
townfolk: townfolk
townspeople: townspeople
toy: toy
trace: trace,traces
track: track,tracking,tracks
trade: trade
trader: trader
tradesman: tradesman
tradespeople: tradespeople
tradition: tradition,traditions
tragedy: tragedies,tragedy
tragic: tragic
tragically: tragically
train: train,trained,trains
trait: trait
trample: trample,trampled,trampling
tranquilly: tranquilly
transfer: transfer,transferred
transform: transform,transformed
transformation: transformation
transgress: transgressed
translate: translated,translating
translation: translation,translations
translator: translator
transparent: transparent
transport: transport,transported
trap: trap
travel: travel,traveled,traveling
traveler: traveler
travels: travels
tray: tray
treacherous: treacherous
treachery: treachery
tread: tread,trod
treasure: treasure
treat: treat,treated,treating,treats
treatise: treatise
treatment: treatment
treble: trebled
tree: tree,trees
tremble: tremble,trembled,trembles,trembling
tremendous: tremendous
tremendously: tremendously
tremor: tremor
trial: trial
tribe: tribe
tribune: tribune
trick: trick,tricks
trickery: trickery
tricky: tricky
trifle: trifle,trifles
trifling: trifling
trigger: trigger
trill: trilling
trim: trim,trimmed
trinity: trinity
trinket: trinkets
triumph: triumph,triumphs
triumphant: triumphant
triumphantly: triumphantly
trivial: trivial
triviality: trivialities,triviality
troglodyte: troglodyte
troika: troika
troop: troop
trouble: trouble,troubled,troubles,troubling
troubled: troubled
trouser: trouser
trousers: trousers
troy: troy
truckle: truckle
true: true,truer,truest
trump: trump,trumped
trumpet: trumpet
trunk: trunk,trunks
trust: trust,trusted,trusting,trusts
trustful: trustful
trustworthy: trustworthy
truth: truth,truths
truthful: truthful
truthfulness: truthfulness
tsar: tsar
tub: tub
tuck: tucking
tuesday: tuesday
tuft: tuft,tufts
tug: tug,tugged,tugs
tula: tula
tumble: tumble
tumbledown: tumbledown
tumbler: tumbler
tune: tune
turbulent: turbulent
turk: turk
turkey: turkey
turks: turks
tut: tut
tutor: tutor
twaddle: twaddle
twelfth: twelfth
twentieth: twentieth
twig: twigs
twilight: twilight
twinge: twinge
twinkle: twinkled
twist: twist,twisted,twisting
twisted: twisted
twitch: twitch,twitched,twitching
twitching: twitching
twixt: twixt
twofold: twofold
type: type,types
typhus: typhus
typical: typical
tyrannical: tyrannical
tyrannize: tyrannized
tyranny: tyranny
tyrant: tyrant
ugh: ugh
ugly: ugly
uhlan: uhlan
uhlans: uhlans
ultimate: ultimate
ultramontanism: ultramontanism
ulysses: ulysses
umbrella: umbrella
umph: umph
unable: unable
unaccountably: unaccountably
unaffected: unaffected
unalterable: unalterable
unanimous: unanimous
unanswerable: unanswerable
unanswerably: unanswerably
unanswered: unanswered
unapparent: unapparent
unappreciated: unappreciated
unapproachable: unapproachable
unasked: unasked
unassisted: unassisted
unattainable: unattainable
unattractive: unattractive
unavailing: unavailing
unavenged: unavenged
unavoidable: unavoidable
unaware: unaware
unawares: unawares
unbalanced: unbalanced
unbaptized: unbaptized
unbearable: unbearable
unbearably: unbearably
unbecoming: unbecoming
unbelief: unbelief
unbeliever: unbeliever,unbelievers
unbelieving: unbelieving
unbending: unbending
unbind: unbind,unbound
unbolt: unbolted
unborn: unborn
unbounded: unbounded
unbridled: unbridled
unbroken: unbroken
unbutton: unbuttoned
uncanny: uncanny
unceasing: unceasing
unceasingly: unceasingly
unceremonious: unceremonious
uncertain: uncertain
uncertainly: uncertainly
uncertainty: uncertainty
uncertificated: uncertificated
unchangeable: unchangeable
unchanged: unchanged
uncle: uncle
unclean: unclean
uncompromising: uncompromising
unconcealed: unconcealed
unconcern: unconcern
unconcerned: unconcerned
unconditionally: unconditionally
unconscious: unconscious
unconsciously: unconsciously
unconsciousness: unconsciousness
unconsoled: unconsoled
uncontrollable: uncontrollable
uncontrolled: uncontrolled
uncork: uncorked
uncorked: uncorked
uncover: uncovered,uncovering
unction: unction
uncultivated: uncultivated
undecided: undecided
undefiled: undefiled
underbred: underbred
underclothes: underclothes
undergo: undergoing,undergone,underwent
underground: underground
underhand: underhand
underlie: underlay,underlying
underline: underline,underlining
undersized: undersized
understand: understand,understanding,understands,understood
understanding: understanding
undertake: undertake,undertaken,undertook
undertaking: undertaking,undertakings
undertone: undertone,undertones
undeserved: undeserved
undeserving: undeserving
undeveloped: undeveloped
undignified: undignified
undisguised: undisguised
undisputed: undisputed
undisturbed: undisturbed
undo: undid,undone
undoubtedly: undoubtedly
undress: undress,undressed,undressing
undressed: undressed
undutiful: undutiful
uneasily: uneasily
uneasiness: uneasiness
uneasy: uneasy
uneducated: uneducated
unendurable: unendurable
unenviable: unenviable
uneven: uneven
unexampled: unexampled
unexpected: unexpected
unexpectedly: unexpectedly
unexpectedness: unexpectedness
unexpiated: unexpiated
unexplained: unexplained
unfair: unfair
unfairly: unfairly
unfasten: unfastening
unfathomable: unfathomable
unfavorable: unfavorable
unfeeling: unfeeling
unfinished: unfinished
unfitting: unfitting
unflagging: unflagging
unflinching: unflinching
unfold: unfolded,unfolding
unforeseen: unforeseen
unfortunate: unfortunate
unfriendly: unfriendly
unguarded: unguarded
unhappily: unhappily
unhappiness: unhappiness
unhappy: unhappy
unhealthy: unhealthy
unheard: unheard
unheed: unheeding
unhesitatingly: unhesitatingly
unhinge: unhinge,unhinged
uniform: uniform
unimportant: unimportant
uninhabited: uninhabited
uninjured: uninjured
unintentionally: unintentionally
uninterrupted: uninterrupted
uninviting: uninviting
union: union
unique: unique
unit: units
unite: unite,united,uniting
united: united
unity: unity
universal: universal
universe: universe
university: university
unjust: unjust
unjustly: unjustly
unknown: unknown
unlearned: unlearned
unlock: unlocked
unluckily: unluckily
unlucky: unlucky
unmannerly: unmannerly
unmarried: unmarried
unmask: unmask
unmistakable: unmistakable
unmistakably: unmistakably
unmoved: unmoved
unnatural: unnatural
unnaturally: unnaturally
unnecessary: unnecessary
unnoticed: unnoticed
unobserved: unobserved
unopened: unopened
unpardonable: unpardonable
unperturbed: unperturbed
unpick: unpick,unpicked
unpicked: unpicked
unpleasant: unpleasant
unprecedented: unprecedented
unprejudiced: unprejudiced
unpresentable: unpresentable
unpretentious: unpretentious
unprotected: unprotected
unproved: unproved
unprovoked: unprovoked
unquestionably: unquestionably
unquestioning: unquestioning
unquestioningly: unquestioningly
unreal: unreal
unreasonable: unreasonable
unrecognized: unrecognized
unresentful: unresentful
unrest: unrest
unruffled: unruffled
unruliness: unruliness
unruly: unruly
unrumpled: unrumpled
unsatisfactory: unsatisfactory
unsatisfied: unsatisfied
unseal: unsealed
unseemliness: unseemliness
unseemly: unseemly
unseen: unseen
unshakable: unshakable
unshaken: unshaken
unsociability: unsociability
unsociable: unsociable
unsolved: unsolved
unsophisticated: unsophisticated
unsound: unsound
unstable: unstable
unsuccessful: unsuccessful
unsuitable: unsuitable
unsuspected: unsuspected
unthinkable: unthinkable
untold: untold
untouched: untouched
untroubled: untroubled
untrue: untrue
untrustworthy: untrustworthy
untruth: untruth
unused: unused
unusual: unusual
unusually: unusually
unutterable: unutterable
unwary: unwary
unwashed: unwashed
unwell: unwell
unwilling: unwilling
unwillingly: unwillingly
unwise: unwise
unworthy: unworthy
upbraid: upbraid,upbraiding
update: updated
upheaval: upheaval
uphill: uphill
upholster: upholstered
upper: upper
uproar: uproar
upset: upset
upsetting: upsetting
upshot: upshot
upside: upside
upstairs: upstairs
upturned: upturned
urchin: urchin
urge: urge,urged
urgency: urgency
urgent: urgent
urgently: urgently
useless: useless
uselessness: uselessness
usher: usher
usual: usual
utility: utility
utmost: utmost
utopian: utopian
utter: utter,uttered,uttering
utterance: utterance,utterances
utterly: utterly
vacantly: vacantly
vaccinate: vaccinated
vague: vague,vaguest
vaguely: vaguely
vagueness: vagueness
vain: vain
vale: vale
valet: valet
valiantly: valiantly
valuable: valuable
van: van
vanilla: vanilla
vanish: vanish,vanished
vanity: vanity
vanquish: vanquished
varied: varied
variety: variety
vary: varied
vase: vase,vases
vast: vast
vault: vault,vaulted
vegetate: vegetated
vehemence: vehemence
veil: veil
vein: veins
velvet: velvet
venerable: venerable
veneration: veneration
vengeance: vengeance
venice: venice
venomous: venomous
vent: vent
venture: venture,ventured,ventures,venturing
venus: venus
verbosity: verbosity
verdict: verdict
verge: verge
verify: verify
verily: verily
verity: verity
verse: verse,versed,verses
version: version,versions
verst: verst,versts
vertical: vertical
vessel: vessels
veterinary: veterinary
vex: vex,vexed
vexation: vexation
vexatious: vexatious
vibrate: vibrates
vice: vice,vices
vicious: vicious
victim: victim,victims
victor: victor
victory: victory
vienna: vienna
view: view,views
vigilance: vigilance
vigilantly: vigilantly
vigor: vigor
vigorous: vigorous
vigorously: vigorously
vii: vii
viii: viii
vile: vile,vilest
vileness: vileness
village: village,villages
villain: villain,villains
ville: ville
vindicate: vindicate,vindicated
vindictive: vindictive
vindictively: vindictively
vindictiveness: vindictiveness
vinegar: vinegar
vineyard: vineyards
violence: violence
violent: violent
violently: violently
viper: viper
virgin: virgin
virginal: virginal
virtue: virtue,virtues
virtuous: virtuous
visibly: visibly
vision: vision,visions
visit: visit,visited,visiting,visits
visitor: visitor,visitors
vista: vista
vital: vital
vitality: vitality
vitally: vitally
vivacity: vivacity
vivant: vivants
vivid: vivid
vividly: vividly
vocation: vocation
vociferate: vociferated
vodka: vodka
vogue: vogue
voice: voice,voices
voltaire: voltaire
volume: volume,volumes
voluntarily: voluntarily
voluntary: voluntary
volunteer: volunteered
voluptuary: voluptuary
voluptuous: voluptuous
voluptuousness: voluptuousness
von: von
vouchsafe: vouchsafed
vow: vow,vowed,vows
vulgar: vulgar
wad: wadded
wadded: wadded
waddle: waddled
wag: wagged
wager: wagers
wages: wages
waggish: waggish
wagon: wagon,wagons
wail: wail,wailed,wailing
waist: waist
waistcoat: waistcoat
wait: wait,waited,waiting,waits
waiter: waiter,waiters
waiting: waiting
waive: waive
wake: wake,waked,wakes,waking,woke
waken: wakening
walk: walk,walked,walking,walks
wall: wall,walls
wallow: wallowing
wan: wan
wander: wander,wandered,wandering,wanders
wanderer: wanderer
wandering: wandering
wanderings: wanderings
wane: wane
wanton: wanton
wantonly: wantonly
war: war
ward: ward
warden: warden
warder: warder
warm: warm,warmed,warmer
warming: warming
warmly: warmly
warmth: warmth
warn: warn,warned,warning,warns
warning: warning,warnings
warrant: warrant,warranted
warsaw: warsaw
wash: wash,washed,washes,washing
washing: washing
waste: waste,wasted,wasting
watch: watch,watched,watches,watching
watchmaker: watchmaker
watchman: watchman
water: water,watered,watering,waters
wave: wave,waved,waves,waving
waver: waver,wavered,wavering
wax: wax
wayside: wayside
weak: weak,weaker
weaken: weaken
weakling: weakling
weakly: weakly
weakness: weakness,weaknesses
wealth: wealth
wealthy: wealthy
weapon: weapon,weapons
wear: wear,wearing,wears,wore,worn
wearily: wearily
weariness: weariness
weary: weary,wearying
weather: weather
weave: weave,weaving,woven
wedding: wedding,weddings
wedlock: wedlock
wednesday: wednesday
wee: wee
week: week,weeks
weekday: weekdays
weekly: weekly
weep: weep,weeping,weeps,wept
weigh: weigh,weighed,weighing
weight: weight
weighty: weighty
welfare: welfare
wench: wench,wenches
west: west
wet: wet,wets,wetted,wetting
whale: whale
whatsoever: whatsoever
wheat: wheat
wheaten: wheaten
wheel: wheel,wheeled,wheeling,wheels
wheeze: wheezed
whereabouts: whereabouts
wherefore: wherefore
wherewithal: wherewithal
whimper: whimpering
whimsical: whimsical
whimsically: whimsically
whine: whine,whined,whining
whip: whip,whipped,whipping
whipping: whipping
whirl: whirl,whirled,whirling
whisker: whiskers
whisper: whisper,whispered,whispering,whispers
whist: whist
whistle: whistle,whistled,whistles
white: white
whitebeam: whitebeam
whites: whites
wholemeal: wholemeal
wholeness: wholeness
wicked: wicked
wickedness: wickedness
wicker: wicker
wide: wide,wider,widest
widespread: widespread
widow: widow,widowed
widower: widower,widowers
wife: wife,wives
wig: wig
wild: wild
wilderness: wilderness
wildest: wildest
wildly: wildly
willed: willed
willful: willful
willow: willow
win: win,winning,wins
wince: winced
wind: wind,winds,wound
window: window,windows
windy: windy
wine: wine,wines
wineglass: wineglass
wing: wings
wink: wink,winked,winking
winter: winter
wipe: wipe,wiped,wiping
wisdom: wisdom
wise: wise,wiser,wisest
wisp: wisp
wit: wit,wits
witch: witch
witchcraft: witchcraft
withdraw: withdraw,withdraws,withdrew
wither: withered
withered: withered
witness: witness,witnessed,witnesses
witted: witted
witty: witty
woe: woe,woes
wolf: wolf
woman: woman,women
womanish: womanish
womb: womb
women: women
wonderful: wonderful
wonderfully: wonderfully
wonderingly: wonderingly
wood: wood,woods
wooden: wooden
woodwork: woodwork
wool: wool
word: word
wordy: wordy
workings: workings
workman: workman
workshop: workshop
worldly: worldly
worlds: worlds
worm: worm
worn: worn
worried: worried
worry: worried,worries,worry,worrying
worship: worship,worshiped
worshipper: worshippers
worth: worth
worthless: worthless
worthy: worthier,worthy
wouldst: wouldst
wound: wound,wounded,wounds
wounded: wounded
wrangling: wrangling
wrap: wrap,wrapped,wrapping
wrapper: wrapper,wrappers
wrath: wrath
wrathful: wrathful
wrathfully: wrathfully
wreath: wreath
wreck: wreck
wrestle: wrestled,wrestling
wretch: wretch,wretches
wretched: wretched
wriggle: wriggles
wring: wrung
wringing: wringing
wrinkle: wrinkled,wrinkles
wrist: wrist
write: write,writes,writing,written,wrote
writer: writer,writers
writhe: writhe,writhing
writing: writing
wrong: wrong,wronged,wronging,wrongs
wrongdoing: wrongdoing
wrongly: wrongly
wroth: wroth
wry: wry
xi: xi
xii: xii
xiii: xiii
xiv: xiv
yard: yard,yards
yearly: yearly
yearn: yearn,yearned
yearning: yearning
yell: yell,yelled,yells
yellow: yellow
yesterday: yesterday
yield: yield,yielded
yond: yonder
yonder: yonder
york: york
youngster: youngster
youth: youth,youths
youthful: youthful
youthfully: youthfully
zeal: zeal
zealous: zealous
zealously: zealously
zenith: zenith
zigzag: zigzags
zither: zithers
zurich: zurich
