abandon: abandon,abandoned,abandoning
abashed: abashed
abduction: abduction
aberration: aberration
ablutions: ablutions
aboard: aboard
abode: abode
abolish: abolishing
abominable: abominable
abominably: abominably
abraham: abraham
abridged: abridged
abrupt: abrupt
abruptly: abruptly
absence: absence
absent: absented
absolute: absolute
absolutely: absolutely
absorb: absorbed,absorbing
absurd: absurd
absurdly: absurdly
abundantly: abundantly
abuse: abuse
acacia: acacias
accept: accept,accepted
acceptation: acceptation
access: access
accident: accident,accidents
accidental: accidental
accidentally: accidentally
accommodation: accommodation
accompany: accompanied,accompany
accomplice: accomplice
accomplish: accomplish,accomplished,accomplishing
accomplished: accomplished
accost: accosted
account: account,accounted,accounts
accumulation: accumulation
accusation: accusations
accuse: accuse,accused,accusing
accustom: accustomed
accustomed: accustomed
acknowledge: acknowledged
acquaint: acquainted
acquaintance: acquaintance
acquire: acquired
acquit: acquitted
acrobat: acrobats
acrobatic: acrobatic
action: action
active: active
actively: actively
activity: activity
actual: actual
add: add,adding
additional: additional
address: address,addressed
aden: aden
adept: adept
adequate: adequate
adieu: adieu
adjoining: adjoining
administer: administered
admirable: admirable
admirably: admirably
admiration: admiration
admiringly: admiringly
admission: admission
admit: admit,admitted,admitting
ado: ado
adopt: adopt
adorn: adorn,adorned
adroit: adroit
adroitness: adroitness
advance: advance,advanced,advancing
advanced: advanced
advantage: advantage
adventure: adventure,adventures
adversary: adversaries,adversary
adversity: adversity
advice: advice
advise: advise
advocate: advocate,advocates
affair: affair,affairs
affect: affect
affix: affixed
afflict: afflict
afford: afforded,affords
afoot: afoot
afraid: afraid
africa: africa
african: african
aft: aft
afternoon: afternoon
age: age
agency: agency
agent: agent,agents
ages: ages
agile: agile
agility: agility
agitate: agitated
agitated: agitated
agitation: agitation
agony: agonies
agra: agra
agree: agree,agreed
agreeable: agreeable
agreement: agreement
aha: aha
aid: aid,aided,aiding
aids: aids
aimlessly: aimlessly
air: air
airily: airily
aisle: aisle,aisles
akin: akin
alabama: alabama
alacrity: alacrity
alarm: alarm
alarmed: alarmed
alarming: alarming
alas: alas
ale: ale
alike: alike
alive: alive
alligator: alligators
allowance: allowance
alluring: alluring
allusion: allusions
ally: allies,ally
almanac: almanac
alms: alms
aloud: aloud
alter: alter
altogether: altogether
amateur: amateur
amaze: amazed
amazed: amazed
amazement: amazement
amazing: amazing
ambassador: ambassadors
ambuscade: ambuscade
america: america
american: american,americans
amiable: amiable
amphion: amphion
ample: ample
amply: amply
amuse: amusing
amusement: amusement
analyse: analyse
anam: anam
anchor: anchor,anchored
ancient: ancient
andaman: andaman
andrew: andrew
anew: anew
angelica: angelica
anger: anger
angle: angles
anglo: anglo
angrily: angrily
angry: angry
anguish: anguish
animal: animal,animals
animate: animated
animated: animated
annals: annals
annex: annexed
announcement: announcement
annoy: annoyed
annoyance: annoyance
annoyed: annoyed
annoying: annoying
anon: anon
anonymously: anonymously
answer: answer,answered,answers
antagonist: antagonists
antipode: antipodes
antipodes: antipodes
antique: antique
anxiety: anxieties,anxiety
anxious: anxious
anxiously: anxiously
apartment: apartment
aperture: aperture
apex: apex
apiece: apiece
apologise: apologise
apoplectic: apoplectic
apparel: apparel
apparent: apparent
appearance: appearance,appearances
appease: appeased
appendage: appendages
appetite: appetite
applause: applause
apple: apple,apples
application: application
apply: applied,apply,applying
appoint: appoint,appointed
apprehension: apprehension,apprehensions
apprise: apprise,apprised
approach: approach,approached,approaching
aptness: aptness
arab: arabs
arabic: arabic
arc: arc
architecture: architecture
argue: argue,argued
arkansas: arkansas
arm: arm,armed,arms
armchair: armchair
armed: armed
armenian: armenian
armenians: armenians
army: army
arouse: aroused
arrange: arrange,arranged,arranging
arrangement: arrangements
array: arrayed
arrest: arrest,arrested,arresting
arrival: arrival,arrivals
arrive: arrive,arrived,arrives,arriving
arrow: arrows
arsenal: arsenal
art: art
artery: artery
article: article,articles
artisan: artisan,artisans
artist: artist,artists
artistic: artistic
arts: arts
ascend: ascended,ascends
ascertain: ascertain,ascertained
ashore: ashore
asia: asia
asian: asian
asleep: asleep
aspect: aspect
asphaltite: asphaltite
ass: ass
assassin: assassins
assassinate: assassinated
assassination: assassination
assemblage: assemblage
assemble: assembled
assent: assented
assert: assert,asserted
assiduously: assiduously
assist: assisted
assistance: assistance
association: association
assume: assumed
assure: assure,assured,assures
astonish: astonish,astonished
astonished: astonished
astonishing: astonishing
astonishment: astonishment
astound: astounds
astounded: astounded
astride: astride
astrologer: astrologers
astronomer: astronomers
astronomical: astronomical
athens: athens
atlantic: atlantic
atmosphere: atmosphere
attach: attached
attack: attack,attacked,attacks
attain: attain,attained
attempt: attempt,attempted,attempts
attend: attend,attended
attention: attention
attentively: attentively
attire: attired
attract: attract,attracted,attracting
attraction: attraction,attractions
auburn: auburn
audacity: audacity
audible: audible
audience: audience
auditor: auditor
austere: austere
authority: authorities,authority
automatic: automatic
automaton: automaton
autumn: autumn
avail: avail
avarice: avarice
avaricious: avaricious
avenge: avenge
avenue: avenues
average: average
avoid: avoid,avoided,avoiding
avowed: avowed
await: await,awaited,awaiting,awaits
awake: awoke
awaken: awakened
awakening: awakening
award: awarded
aware: aware
awhile: awhile
awkward: awkward
awkwardly: awkwardly
bab: bab
backer: backers
background: background
bad: bad,worse,worst
badly: badly
bag: bag
baggage: baggage
bah: bah
bail: bail,bails
balance: balance,balanced
balcony: balcony
ball: ball,balls
ballast: ballast
balloon: balloon
bamboo: bamboo,bamboos
banana: bananas
band: band,bands
banditti: banditti
bank: bank,banks
banker: banker,bankers
banknote: banknotes
banknotes: banknotes
bankruptcy: bankruptcy
banner: banners
banter: bantering
banyans: banyans
bar: bar,barred
barbarous: barbarous
barber: barber
bargain: bargain
baring: baring
barley: barley
barometer: barometer
baronet: baronet
barrel: barrelled,barrels
barricade: barricaded
barrier: barriers
barrow: barrows
basalt: basalt
base: base
basin: basin
basis: bases
bass: bass
bath: bathed,bathing
battery: battery
battle: battle
battledore: battledores
battlefield: battlefield
bay: bay
bazaar: bazaar,bazaars
beam: beam,beams
bear: bear,bearing,bears,bore,borne
beard: beard
bearded: bearded
bearer: bearer
beast: beast,beasts
beat: beat,beaten,beating
beautiful: beautiful
beautifully: beautifully
beauty: beauties,beauty
bed: bed
bedchamber: bedchamber
bedroom: bedroom
bedstead: bedsteads
bedtime: bedtime
beef: beef
beer: beer
beg: beg,begged,begging
beggar: beggar
behave: behaved
behaviour: behaviour
behold: beheld,behold
belated: belated
bell: bell,bells
belong: belong,belonged,belonging,belongs
bench: bench,benches
bend: bend,bending,bent
beneath: beneath
benevolent: benevolent
bengal: bengal
bequeath: bequeathed
berth: berth,berths
bespeak: bespoken
bestow: bestowed
bestride: bestride
bet: bet,bets,betting
betel: betel
betray: betray,betrayed,betraying,betrays
betrayal: betrayal
beverage: beverage,beverages
biblical: biblical
bid: bade,bid,bidding
billow: billows
bind: bound
bird: bird,birds
birmingham: birmingham
biscuit: biscuits
bit: bit,bits
bite: biting,bitten
bitter: bitter,bitterest
bitterly: bitterly
black: black
blacken: blackened
blame: blame,blamed,blaming
blank: blank
blanket: blanket
blind: blind
block: blocked,blocking,blocks
blood: blood
blossom: blossoms
blow: blew,blow,blowing,blows
blue: blue
bluffs: bluffs
blunder: blundering
blush: blush
blusterer: blusterers
boar: boar
board: board
boast: boasted
boat: boat,boats
bodily: bodily
body: body
boil: boiled
boiler: boiler,boilers
boisterous: boisterous
bold: bold,bolder
boldly: boldly
bolster: bolstering
bomb: bomb
bombay: bombay
bond: bond,bonds
bone: bones
bonnet: bonnet,bonnets
booby: booby
book: book,books
booming: booming
boot: boots
bordeaux: bordeaux
border: border,bordered,borders
bore: bore
borrow: borrowed
bosom: bosom
bottle: bottles
boulevard: boulevard
bounce: bounced,bouncing
bound: bound,bounded
boundary: boundary
bow: bow,bowed,bowing,bows
bowie: bowie
box: box,boxes
bracelet: bracelets
bradshaw: bradshaw
brahma: brahma
brahmin: brahmin,brahmins
brain: brain,brains
brake: brakes
branch: branch,branches
brand: brand
brandy: brandy
brass: brass
brave: brave,braved
bravely: bravely
brawny: brawny
brazil: brazil
bread: bread
breadth: breadth
break: break,breaks,broke,broken
breakage: breakage
breakfast: breakfast,breakfasted
breast: breast
breath: breath
breathe: breathe,breathed
breathless: breathless
breathlessly: breathlessly
breeze: breeze
brewer: brewer
bribe: bribed,bribes
bribery: bribery
brick: brick,bricks
bride: bride
bridge: bridge,bridges
bridger: bridger
brigade: brigade
brigadier: brigadier,brigadiers
brigantine: brigantine
bright: bright
brighten: brightened
brilliancy: brilliancy
brilliant: brilliant
brindisi: brindisi
bring: bring,bringing,brought
brisk: brisk
briskly: briskly
bristle: bristling
british: british
broad: broad
broadway: broadway
broil: broiled
broken: broken
broker: broker,brokers
brother: brother,brothers
brow: brows
brown: brown
bruise: bruise
brush: brush
bud: bud
buddhism: buddhism
buddhist: buddhist
budge: budge
buffalo: buffalo,buffaloes
build: built
bulge: bulged
bull: bull
bullet: bullets
bulletin: bulletin
bungalow: bungalow,bungalows
bunk: bunks
buoyancy: buoyancy
burden: burden
burglar: burglars
burlington: burlington
burn: burn,burned,burning
burner: burner
burst: burst,bursting
busby: busby
bush: bushes
business: business
bust: busts
bustle: bustled
bustling: bustling
busy: busied,busy
butcher: butcher,butchers
butter: butter
butterfly: butterflies
buttery: buttery
buzzing: buzzing
bye: bye
byron: byron
byronic: byronic
cab: cab
cabin: cabin,cabins
cable: cable
cabman: cabman
cadaverous: cadaverous
calais: calais
calculate: calculate,calculated,calculating
calcutta: calcutta
california: california
californian: californian
calm: calm,calmer
calmly: calmly
calmness: calmness
camellia: camellias
camp: camp
campaign: campaign
canal: canal
cancer: cancer
candidate: candidate
candle: candles
cane: canes
cannibal: cannibals
cannon: cannon
canton: canton
canvas: canvas
cap: caps
capable: capable
capacity: capacity
caparison: caparisoned
cape: cape
caper: capering
capital: capital
caprice: caprice
capricious: capricious
capriciously: capriciously
captain: captain
captor: captors
capture: captured
car: car,cars
card: card,cards
care: care,cared
careful: careful
carefully: carefully
careless: careless
caress: caressed,caressing
cargo: cargo
carnival: carnival
carpet: carpet
carriage: carriage,carriages
carry: carried,carry,carrying
carson: carson
cascade: cascade,cascades
cashier: cashier
cashmere: cashmere
cast: cast,casting
castle: castle
cat: cats
catch: catch,caught
catcher: catcher
cathedral: cathedral
cattle: cattle
cautiously: cautiously
cease: cease,ceased,ceasing
cedar: cedar,cedars
ceiling: ceiling
celebrate: celebrated,celebrates,celebrating
celebrated: celebrated
celestial: celestial
cellar: cellar
cent: cent
central: central
centre: centre,centred
century: centuries,century
cereal: cereals
ceremony: ceremonies,ceremony
ceylon: ceylon
ceylonese: ceylonese
chaff: chaff,chaffing
chagrin: chagrin
chain: chain,chains
chair: chair
chaise: chaise
chamber: chambers
champion: champions
champs: champs
chance: chance,chances
chancery: chancery
change: change,changed,changing
channel: channels
chapter: chapter
character: character,characters
characteristic: characteristic
charge: charge,charged,charges
charing: charing
charity: charities
charm: charm,charmed,charms
charming: charming
charter: charter
chary: chary
chat: chatted,chatting
cheap: cheap
check: checked,checking
checker: checker
checkered: checkered
cheek: cheeks
cheeked: cheeked
cheer: cheered,cheers
cheerless: cheerless
cheese: cheese
cheque: cheque,cheques
cherish: cherish,cherished
cherry: cherry
cheshire: cheshire
chest: chests
chicago: chicago
chief: chief,chiefs
child: child,children
chili: chili
chilled: chilled
chilly: chilly
chimney: chimneys
chin: chin
china: china
chinamen: chinamen
chinese: chinese
choose: choose,chose,chosen
chop: chop,chopping
chord: chord,chords
christian: christians
chronometer: chronometer,chronometers
chuckle: chuckled
church: church,churches
cigar: cigars
cinnamon: cinnamon
circuit: circuit,circuits
circular: circular
circulate: circulating
circulation: circulation
circumference: circumference
circumstance: circumstance,circumstances
circus: circus
cisco: cisco
cistern: cisterns
citizen: citizens
city: cities,city
civil: civil
civilian: civilians
civilisation: civilisation
civilised: civilised
claim: claim
clamber: clambering
clamorous: clamorous
clanging: clanging
claret: claret
clasp: clasp,clasping
clasped: clasped
class: class,classes
clay: clay
clean: clean
clearing: clearings
clenched: clenched
clergyman: clergyman
clerk: clerk
clever: clever
clime: clime
cling: clung
clipper: clippers
cloak: cloak,cloaks
clock: clock,clocks
clog: clogs
close: close,closed,closing
closed: closed
closely: closely
cloth: cloth
clothe: clad,clothed
clothes: clothes
clothing: clothing
cloud: cloud,clouds
clouds: clouds
clove: clove,cloves
clown: clown,clowns
club: club,clubs
clump: clump,clumps
cluster: clusters
coach: coach,coaches
coal: coal
coast: coast,coasting,coasts
coat: coat,coats
cochin: cochin
coconut: coconut
coffee: coffee
cogitate: cogitating
coin: coin
cold: cold
coldly: coldly
coldness: coldness
collapse: collapse
collar: collar,collaring
collect: collect,collected
collection: collection
collector: collector
collision: collision,collisions
colloquy: colloquy
colonel: colonel
colonise: colonise,colonising
colony: colonies,colony
colorado: colorado
colour: colour,coloured,colours
colouring: colouring
colt: colt
columbus: columbus
column: column,columns
comb: comb
combatant: combatants
combination: combination,combinations
combine: combines
comer: comer
comfort: comfort,comforted
comfortable: comfortable
comfortably: comfortably
command: command,commanded,commanding,commands
commander: commander
commanding: commanding
commence: commence,commenced
commendation: commendation
commerce: commerce
commercial: commercial
commiserate: commiserate
commission: commission
commissioner: commissioner
commit: committed
common: common
communication: communication
communicative: communicative
community: community
compact: compact
compactly: compactly
companion: companion,companions
company: company
comparable: comparable
comparatively: comparatively
compare: compare
compartment: compartments
compel: compelled
complacent: complacent
complain: complained
complainant: complainants
complaint: complaint
complement: complement
complete: complete,completed
completely: completely
completion: completion
complexion: complexion,complexions
complicated: complicated
complicity: complicity
compliment: compliment,compliments
compose: compose,composed
composure: composure
comprehend: comprehend,comprehended
comprise: comprise,comprised,comprises,comprising
conceal: conceal,concealed,concealing
concede: concede
conceit: conceit
conceive: conceive
concern: concern,concerned,concerns
concert: concert
conclude: conclude,concluded
concoct: concocted
concussion: concussion
condemn: condemn,condemned
condition: condition,conditions
conduct: conduct,conducted
conductor: conductor
confer: conferring
confess: confess,confessed
confidant: confidant
confide: confide,confided
confidence: confidence,confidences
confident: confident
confidently: confidently
confine: confined
confirm: confirmed
conflict: conflict
confound: confound,confounded
confucius: confucius
confuse: confused
confused: confused
confusion: confusion
congenial: congenial
congress: congress
conjecture: conjecture,conjectured,conjectures
connect: connect,connected,connecting
connection: connection
connivance: connivance
conquer: conquer,conquering
conquest: conquest
conscience: conscience
conscientiously: conscientiously
consecrate: consecrated
consent: consented
consequence: consequences
considerable: considerable
considerably: considerably
consideration: consideration
consign: consigned
consist: consisted
console: console,consoled
conspicuous: conspicuous
conspiracy: conspiracy
constable: constable
constant: constant
constantly: constantly
construct: constructed
construction: construction
consul: consul,consuls
consulate: consulate
consult: consult,consulted,consulting
consultation: consultation
consume: consumed
contempt: contempt
contemptible: contemptible
contemptuous: contemptuous
content: content
contented: contented
contents: contents
contest: contest,contesting
continent: continent
continental: continental
continually: continually
continue: continue,continued,continuing
contortion: contortions
contour: contour
contradict: contradicted
contrary: contrary
contrast: contrast,contrasted
contribute: contributed
control: control
convenient: convenient
conversation: conversation
convey: convey
conveyance: conveyance,conveyances
conviction: conviction
convince: convinced
convinced: convinced
convulse: convulsed
convulsively: convulsively
cook: cook
cool: cool,cooled
coolie: coolies
coolly: coolly
coolness: coolness
copper: copper
copse: copse,copses
cormorant: cormorants
corn: corn
corner: corner,corners
cornice: cornices
cornwallis: cornwallis
corps: corps
corpse: corpse,corpses
correct: corrected
cosily: cosily
cosiness: cosiness
cost: cost,costs
costume: costume,costumes
cosy: cosy
cot: cots
cotton: cotton
council: council
count: count,counted,counting,counts
countenance: countenance,countenances
counter: counters
countersign: countersigned
counting: counting
country: countries,country
county: county
courage: courage
courageous: courageous
courageously: courageously
court: court
courts: courts
cousin: cousin
cover: cover,covered,covering
cow: cow
crack: crack
craft: craft
crag: crags
craggy: craggy
crane: cranes
crash: crash
cravat: cravat
crave: craved
craving: cravings
cream: cream
create: create,created
creature: creature,creatures
credit: credit
creditor: creditors
creek: creek,creeks
creep: creeping,crept
crestfallen: crestfallen
crew: crew
crime: crime
criminal: criminal
crisp: crisp
crony: crony
cross: cross,crossed,crosses,crossing
crow: crows
crowd: crowd,crowded,crowds
crown: crown,crowned
crush: crushed,crushing
crusty: crusty
cudgel: cudgelled
cultivate: cultivate,cultivated
culvert: culverts
cumbrous: cumbrous
cup: cup,cups
curiosity: curiosity
curious: curious
curiously: curiously
curl: curled
current: current,currents
curse: curse,cursed,cursing
curtain: curtain,curtains
curve: curve,curves
curved: curved
cushion: cushions
custom: custom,customs
customary: customary
customer: customers
cut: cut,cuts
cutter: cutter
cymbal: cymbals
daily: daily
dairy: dairy
dam: dam
damages: damages
damascened: damascened
dame: dames
damsel: damsel
dance: dance,danced
dancer: dancers
dancing: dancing
danger: danger,dangers
dangerous: dangerous
dark: dark,darkest
darken: darkened,darkening
darkness: darkness
darksome: darksome
dart: darting
daughter: daughter
davenport: davenport
dawn: dawn
day: day,days
daybreak: daybreak
daylight: daylight
dazzle: dazzling
dazzling: dazzling
dead: dead
deafening: deafening
deal: deal,dealing,dealt
dealer: dealer,dealers
dearly: dearly
death: death
debtor: debtor
decamp: decamped
decanter: decanters
december: december
decide: decide,decided
decidedly: decidedly
decimus: decimus
decision: decision
deck: deck,decked,decks
declare: declared
decline: declined
declivity: declivity
decorate: decorated
decrease: decreasing
deduct: deducted
deep: deep
deepen: deepened,deepening
deeply: deeply
deer: deer
default: default
defective: defective
defend: defend,defended
defiant: defiant
defile: defiles
deflection: deflections
defy: defy
degree: degree,degrees
deign: deign
deity: deities
delay: delay,delayed,delaying,delays
deliberate: deliberate
deliberation: deliberations
delicate: delicate
delicately: delicately
delicious: delicious
delight: delight
delighted: delighted
delightful: delightful
deliver: deliver,delivered
deliverer: deliverers
delusion: delusion
demand: demand,demanded,demands
demolition: demolition
demonstrate: demonstrated,demonstrates
demonstration: demonstration
den: den,dens
denounce: denouncing
dense: dense
densely: densely
denver: denver
deny: deny
depart: depart,departed,departing,departs
departure: departure
depend: depends
depict: depicted
deposit: deposit,deposited
depot: depot
depress: depressed
depression: depression,depressions
deprive: deprive,deprived
depth: depth
depths: depths
derange: deranged
des: des
descend: descend,descended,descending,descends
descendant: descendants
description: description,descriptions
desecrator: desecrator
desert: desert,deserts
deserted: deserted
deserve: deserved
design: design,designed,designs
designate: designated
designation: designation
desire: desire,desired
desirous: desirous
desk: desk,desks
desolation: desolation
despair: despair
desperate: desperate
desperately: desperately
despicable: despicable
despise: despised
despotic: despotic
destination: destination
destine: destined
detach: detached
detached: detached
detachment: detachment
detain: detain,detained,detaining
detective: detective,detectives
detectives: detectives
determination: determination
determine: determined
determined: determined
deuce: deuce
develop: developed
deviate: deviate
deviation: deviation
devil: devil,devils
devote: devote,devoted
devoted: devoted
devotion: devotion
devour: devoured,devouring
dewdrop: dewdrops
dexterous: dexterous
diamond: diamond,diamonds
die: die,died,dies
difference: difference
difficult: difficult
difficulty: difficulties,difficulty
dignified: dignified
dim: dim
diminish: diminished,diminishing
diminutive: diminutive
din: din
dine: dined
dining: dining
dinner: dinner
diplomatic: diplomatic
direct: direct,directed,directing
direction: direction
director: director,directors
dirty: dirty
disadvantage: disadvantage
disappear: disappear,disappeared,disappearing
disappearance: disappearance
disappoint: disappointed
disappointed: disappointed
disappointment: disappointment
disaster: disaster
disc: disc
discern: discern
discernible: discernible
discharge: discharge
disciple: disciples
disclosure: disclosure
discomfort: discomfort,discomforts
disconcert: disconcert
disconnected: disconnected
discordant: discordant
discourage: discouraged
discouraged: discouraged
discover: discovered
discovery: discovery
discuss: discussed,discussing
discussion: discussion,discussions
disdain: disdaining
disembark: disembark,disembarked
disgorges: disgorges
disguise: disguise,disguised
dish: dish,dishes
dishevelled: dishevelled
disinclined: disinclined
dismal: dismal
dismantle: dismantled
dismiss: dismissed
disorder: disorder
disordered: disordered
disorderly: disorderly
dispatch: dispatch,dispatched
dispense: dispense,dispensed
disperse: dispersed
display: displayed,displays
displease: displeases
disposal: disposal
dispose: disposed
disposition: disposition
dispute: disputed,disputes
disregard: disregard
dissipate: dissipated
distance: distance,distances
distant: distant
distil: distilled
distinct: distinct
distinction: distinctions
distinctly: distinctly
distinguish: distinguished,distinguishes
distress: distress
distribute: distributed
district: district
distrustful: distrustful
disturb: disturb,disturbed
disturbance: disturbance,disturbances
disturbing: disturbing
divan: divan
diversified: diversified
divert: diverted
divide: divide,divided,dividing
divine: divine
divinity: divinities
division: divisions
divulge: divulge
dock: docks
document: document
dodge: dodge
dog: dog,dogs
dogmatically: dogmatically
dogskin: dogskin
dollar: dollars
dome: dome
domestic: domestic,domestics
domesticate: domesticated
domesticated: domesticated
domicile: domicile
dominion: dominion
doom: doom,doomed
door: door,doors
dormitory: dormitory
dot: dotted
double: double,doubles
doubt: doubt,doubted,doubts
doubtless: doubtless
dover: dover
dozen: dozen,dozens
drag: dragging
drama: drama
draw: drawing,drawn,drew
dream: dream,dreams
dreary: dreary
dress: dress,dressed,dresses,dressing
dressed: dressed
drink: drank,drink,drinking
drinkable: drinkables
drive: drive,driven,drives,driving,drove
driver: driver
drone: droning
drop: drop,dropped
drown: drowned
drowsiness: drowsiness
drug: drug
drum: drums
drunk: drunk
drunken: drunken
drunkenness: drunkenness
dry: dried,dry
dublin: dublin
duck: ducks
duel: duel
duelling: duelling
duellist: duellists
dull: dull
dummy: dummy
dunce: dunces
dupe: dupes
durant: durant
dusk: dusk
dust: dust
dutch: dutch
dutchmen: dutchmen
duty: duties,duty
dwarf: dwarf
dwell: dwelling
dweller: dwellers
dwelling: dwelling
dwindle: dwindled
eager: eager
eagerly: eagerly
eagerness: eagerness
eagle: eagles
ear: ears
earn: earn
earnest: earnest
earnestly: earnestly
earring: earrings
earth: earth
ease: ease
easily: easily
east: east
easterly: easterly
eastern: eastern
eastward: eastward
eastwardly: eastwardly
easy: easy
eat: ate,eat,eaten
ebony: ebony
eccentric: eccentric
eccentricity: eccentricity
ecclesiastical: ecclesiastical
echo: echoed
economical: economical
eddy: eddies
edge: edge,edges
edibles: edibles
edifice: edifice
edinburgh: edinburgh
education: education
efface: effaced
effort: effort,efforts
egypt: egypt
egyptian: egyptian,egyptians
eighteen: eighteen
eightieth: eightieth
el: el
elapse: elapsed
eld: elder
elder: elder
elderly: elderly
election: election
electric: electric
elegantly: elegantly
elephant: elephant,elephants
elephanta: elephanta
elevation: elevation
elicit: elicited
elopement: elopement
elude: elude
embalmed: embalmed
embark: embark,embarked,embarking
embarrass: embarrass
embarrassed: embarrassed
embassy: embassy
embrace: embraced,embraces
embroider: embroidered
emerge: emerge,emerged
emigrant: emigrants
emit: emitting
emotion: emotion,emotions
emperor: emperor
emphasise: emphasising
empire: empire
employ: employed
employment: employment
emporium: emporium
enable: enable
encamp: encamped
encase: encase
enchant: enchanted
encircle: encircle
enclose: enclosed
enclosure: enclosure,enclosures
encounter: encountered,encounters
encroach: encroached
encrust: encrusted
encumber: encumbered
endeavour: endeavour
endure: endured
enemy: enemy
energetic: energetic
energy: energy
enfield: enfield
engage: engage,engaged,engages
engagement: engagement
engine: engine,engines
engineer: engineer,engineers
england: england
english: english
englishman: englishman,englishmen
englishmen: englishmen
enigmatical: enigmatical
enjoy: enjoy,enjoyed
enlarge: enlarged
enlighten: enlightened
enormous: enormous
enrage: enraged
enraged: enraged
enrich: enrich,enriched
ensconce: ensconced
ensue: ensued
ensure: ensure
enter: enter,entered,entering,enters
enterprise: enterprise
enterprising: enterprising
entertain: entertained
entertainer: entertainer
enthusiast: enthusiast
enthusiastic: enthusiastic
entire: entire
entitle: entitled
entomologists: entomologists
entrance: entrance
entry: entry
entwine: entwined
envelop: enveloped
enviable: enviable
epithet: epithet
equal: equal
equally: equally
equanimity: equanimity
equinox: equinox,equinoxes
equip: equipped
equipage: equipages
equipped: equipped
ere: ere
erect: erect,erected
errand: errand,errands
error: error
escapade: escapade
escape: escape,escaped,escaping
escort: escort,escorted,escorting
espouse: espoused
espy: espied,espy,espying
esquire: esquire
essay: essayed
essence: essence
establish: establish,established
establishment: establishment,establishments
esteem: esteem
estimable: estimable
estimate: estimate,estimated
eternity: eternity
eulogy: eulogies
europe: europe
european: european,europeans
evans: evans
evasion: evasion
evening: evening
event: event,events
evidence: evidence,evidences
evident: evident
evidently: evidently
evil: evil
exact: exact
exactitude: exactitude
exaggerate: exaggerate
exaggerated: exaggerated
exalt: exalted,exalting
examination: examination
examine: examine,examined,examining
exasperate: exasperated
exceed: exceed,exceeding
exceedingly: exceedingly
excellent: excellent
exceptionally: exceptionally
excess: excess
excessive: excessive
excessively: excessively
exchange: exchange,exchanged
exchequer: exchequer
excite: excite
excited: excited
excitedly: excitedly
excitement: excitement
exciting: exciting
exclaim: exclaimed,exclaiming
exclamation: exclamation,exclamations
exclusive: exclusive
exclusively: exclusively
excursion: excursion
excuse: excuse,excused
execute: executed,executing
execution: execution
executioner: executioner,executioners
exercise: exercise,exercises
exertion: exertions
exhaust: exhaust,exhausted
exhausted: exhausted
exhaustless: exhaustless
exhibit: exhibit
exhibition: exhibition
exhilarate: exhilarating
exist: exist,existed,existing
existence: existence
expand: expanding
expanse: expanse
expect: expected
expectation: expectations
expedient: expedient
expend: expend,expended,expending
expense: expense,expenses
expensive: expensive
experience: experience,experienced,experiencing
experiment: experiment
expire: expired
explain: explain,explained
explanation: explanation
exploit: exploit
expose: expose,exposed
express: express,expressed,expresses,expressing
expression: expression
expressive: expressive
extend: extend,extended,extending,extends
extent: extent
exterior: exterior
extinguish: extinguished
extract: extracted
extradition: extradition
extreme: extreme
extremely: extremely
exultation: exultation
eye: eye,eyes
eyebrow: eyebrows
fabulous: fabulous
facilitate: facilitate
factory: factories
fade: faded
fahrenheit: fahrenheit
fail: fail,failed
failure: failure
fain: fain
fair: fair
faith: faith
faithful: faithful
faithfully: faithfully
fakir: fakirs
fall: fall,fallen,falling,fell
false: false
falter: faltered
familiar: familiar
familiarity: familiarity
familiarly: familiarly
family: family
famished: famished
famous: famous
famously: famously
fan: fan
fanatic: fanatics
fanatical: fanatical
fanaticism: fanaticism
fantastic: fantastic
fare: fare
farmer: farmer,farmers
farming: farming
farthing: farthing
fascinated: fascinated
fashion: fashion,fashioned
fashionably: fashionably
fast: fast,faster,fastest
fasten: fastened
fastidious: fastidious
fastness: fastnesses
fat: fat
fatal: fatal
fatally: fatally
fate: fate
father: father
fatigue: fatigue
fault: fault
favor: favors
favour: favour,favoured,favours
favourable: favourable
favoured: favoured
favourite: favourite
fear: fear,feared,fears
fearful: fearful
fearfully: fearfully
feasible: feasible
feat: feats
feather: feather,feathers
feature: feature,features
fee: fee
feed: fed,feed,feeding
feel: feel,feeling,feels
feeling: feeling
feign: feigning
fell: felled
fellah: fellahs
fellow: fellow,fellows
female: female
fermentation: fermentation
fern: ferns
ferocious: ferocious
ferocity: ferocity
ferryboat: ferryboat
fertile: fertile
fervent: fervent
festival: festival
fetch: fetch
feverish: feverish
feverishly: feverishly
fickle: fickle
field: fields
fields: fields
fierce: fierce
fiftieth: fiftieth
fight: fight,fighting,fought
figure: figure,figures
finally: finally
finance: finance
financial: financial
fine: fine,fines,finest
finger: finger,fingers
finish: finish,finished,finishing
fir: fir
fireman: fireman
fireplace: fireplace
firework: fireworks
firmly: firmly
firmness: firmness
fish: fish,fishes,fishing
fisherman: fishermen
fishing: fishing
fist: fist,fists
fit: fit,fitted
fitfully: fitfully
fitting: fittings
flag: flag,flags
flagging: flagging
flame: flame
flank: flank,flanks
flash: flash
flat: flat
flee: fled
flesh: flesh
flight: flight
float: float,floating
flock: flocked,flocks
floor: floor
flooring: flooring
flotilla: flotilla
flounder: floundered
flourish: flourished
flourishing: flourishing
flow: flowed,flows
flower: flower,flowers
flunkey: flunkey
flurried: flurried
flush: flush,flushed
flute: flutes
fly: flew,flies,fly,flying
flying: flying
foam: foaming
fob: fob
foe: foes
fog: fogs
fold: folded,folds
foliage: foliage
folk: folk,folks
follow: follow
folly: follies,folly
food: food
fool: fool
foolhardy: foolhardy
foolish: foolish
foot: feet,foot
foothold: foothold
footlights: footlights
footstep: footsteps
forbid: forbidden
force: force,forced,forces,forcing
ford: ford
foreboding: forebodings
foreground: foreground
forehead: forehead
foreign: foreign
foresail: foresail
foresee: foresaw,foreseen
forest: forest,forests
forge: forged
forget: forget,forgetting,forgot,forgotten
forgive: forgive
form: form,formed,forming
formality: formalities
formidable: formidable
fort: fort,forts
forthwith: forthwith
fortieth: fortieth
fortification: fortifications
fortified: fortified
fortunate: fortunate
fortunately: fortunately
fortune: fortune,fortunes
foundation: foundation
founder: founder
foundry: foundries
fourteen: fourteen
fourth: fourth
frail: frail
frame: frame,framed,frames
france: france
francis: francis
francisco: francisco
frank: frank
frankly: frankly
frantic: frantic
fray: fray
freely: freely
freeze: frozen
freezing: freezing
freight: freight
french: french
frenchman: frenchman
frenchmen: frenchmen
frequent: frequent,frequented
frequently: frequently
fresh: fresh
freshen: freshened
freshness: freshness
friar: friars
friction: friction
friday: friday
friend: friend,friends
friendly: friendly
friendship: friendships
fright: fright
frighten: frightened
frightening: frightening
frightful: frightful
fro: fro
frolic: frolicked
frothy: frothy
frozen: frozen
fruit: fruit,fruits
fuel: fuel,fuelling
fugitive: fugitives
fulfil: fulfil
fume: fumes
functionary: functionary
fund: fund,funds
funeral: funeral
funnel: funnel
funny: funny
fur: furred,furs
furious: furious
furl: furled
furnace: furnace,furnaces
furnish: furnish,furnished
furrow: furrowed
fury: fury
future: future
gaiety: gaiety
gaily: gaily
gain: gain,gained,gaining,gains
gainsay: gainsay
gait: gait
gale: gale,gales
gallant: gallant
gallery: gallery
galley: galleys
gallop: gallop
galvanise: galvanised
gamble: gambled
gambler: gamblers
game: game,games
gamut: gamut
gange: ganges
ganges: ganges
gape: gaping
garden: garden,gardens
gardens: gardens
garment: garments
garnish: garnished
garret: garret
garrison: garrison
gas: gas
gasp: gasped
gate: gate,gates
gather: gathered
gaunt: gaunt
gauze: gauze
gaze: gaze,gazed,gazing
gem: gems
generosity: generosity
generous: generous
generously: generously
genial: genial
genius: genius
gentile: gentiles
gentleman: gentleman,gentlemen
gentlemanly: gentlemanly
gentleness: gentleness
gentler: gentler
gently: gently
genuine: genuine
genuineness: genuineness
geographical: geographical
geography: geography
germany: germany
gesture: gesture,gestures
ghaut: ghauts
ghostly: ghostly
giant: giant
giblet: giblet
gibraltar: gibraltar
gift: gifted
gigantic: gigantic
gilded: gilded
gin: gin
girl: girls
glad: glad
glade: glade
glance: glance,glances
glare: glare
glasgow: glasgow
glass: glass,glasses
glide: glided
glimpse: glimpse,glimpses
glisten: glistened,glistening
glitter: glitter,glittering
globe: globe
glorious: glorious
glove: gloves
glow: glow,glowing
gnash: gnashed
goa: goa
goal: goal
goat: goat
god: god,gods
goddess: goddess
godlike: godlike
golconda: golconda
gold: gold
golden: golden
gong: gongs
goodly: goodly
goodness: goodness
gooseberry: gooseberry
gorgeous: gorgeous
gorgeously: gorgeously
gothic: gothic
gour: gour
gourmand: gourmands
govern: governed
government: government
governor: governor,governors
gown: gowns
gowned: gowned
graceful: graceful
gracefully: gracefully
gracious: gracious
grade: grade,grades
gradually: gradually
grand: grand
grandfather: grandfather
grant: grant,granted
grasp: grasp,grasped
grateful: grateful
gratefully: gratefully
grating: gratings
gratitude: gratitude
grave: grave,gravest
gravitate: gravitated
gray: gray
greatly: greatly
green: green,greenest
greenness: greenness
greenwich: greenwich
greeting: greeting
grenadier: grenadier
grey: grey
greyish: greyish
grief: grief,griefs
grimace: grimace,grimaces
grin: grin,grinning
groan: groans
groin: groin
grossly: grossly
grotto: grottoes
ground: ground
grounds: grounds
grove: groves
grow: grew,grow,growing,grown,grows
growl: growl,growls
growling: growling
grudge: grudge,grudges
grumble: grumbled
grunt: grunted
guard: guard,guards
guess: guess,guessed
guest: guest,guests
guidance: guidance
guide: guide,guided
guilty: guilty
guinea: guineas
gulf: gulf,gulfs
gull: gulls
gun: guns
gunshot: gunshots
gust: gusts
gymnast: gymnast,gymnasts
gymnastic: gymnastic
gymnastics: gymnastics
habiliment: habiliments
habit: habit,habited,habits
habitual: habitual
hack: hack
hag: hag
haggard: haggard
hail: hailed
hair: hair,hairs
hall: hall
halt: halt,halted
hamburg: hamburg
hamlet: hamlet
hand: hand,handed,handing,hands
handful: handful,handfuls
handsome: handsome
handsomely: handsomely
hang: hanging,hung
happen: happen,happened
happily: happily
happiness: happiness
happy: happiest,happy
harbour: harbour
hard: hard
harden: hardened
hardened: hardened
hardship: hardships
hardy: hardy
harm: harm
harmonic: harmonic
harmonious: harmonious
harmonise: harmonised
harmony: harmony
harvest: harvest
haste: haste
hasten: hasten,hastened
hastily: hastily
hasty: hasty
hat: hat,hats
hatless: hatless
hauberk: hauberks
haul: hauled
haunt: haunted
hawk: hawks
haymarket: haymarket
hazard: hazards
head: head,headed,heads
headless: headless
headquarters: headquarters
headway: headway
healthy: healthy
heap: heaped
hear: hear,heard,hearing
hearer: hearers
hearing: hearing
heart: heart,hearts
heartily: heartily
heartless: heartless
hearty: hearty
heat: heated
heaven: heaven,heavens
heavens: heavens
heavenward: heavenward
heavily: heavily
heavy: heavy
hedge: hedges
heel: heel,heels
heh: heh
height: height
heighten: heightened
heinous: heinous
helm: helm
helpless: helpless
hemp: hemp
henrietta: henrietta
herd: herd
hero: heroes
heroine: heroine
heron: herons
hesitate: hesitate,hesitated,hesitating
hesitatingly: hesitatingly
hesitation: hesitation
hew: hewed
hide: hidden
hideous: hideous
highly: highly
highway: highways
hilarious: hilarious
hill: hill,hills
hilly: hilly
himalaya: himalaya
hindoo: hindoo
hint: hints
hip: hip
hiram: hiram
hire: hire
hiss: hissing
historian: historians
historic: historic
history: history
hit: hit,hitting
hitch: hitch
hitherto: hitherto
hoist: hoist,hoisted
hold: held,hold,holding
hole: hole
holland: holland
holy: holiest,holy
homeward: homeward
honest: honest
honesty: honesty
hong: hong
honour: honour,honoured,honours
honourable: honourable
honoured: honoured
hood: hood
hook: hook
hope: hope,hoped,hopes,hoping
hopeful: hopeful
horizon: horizon
horrible: horrible
horribly: horribly
horror: horror
horse: horse,horses
horseback: horseback
horsecar: horsecar
horseman: horsemen
hospitable: hospitable
hospital: hospitals
hostile: hostile
hot: hot
hotel: hotel,hotels
hour: hour,hours
house: house,houses
howdah: howdahs
howl: howl,howling
hubbub: hubbub
huddle: huddled
hudson: hudson
hue: hue
hugo: hugo
hulk: hulk
hull: hull,hulled
hum: hum
human: human
humanity: humanity
humiliate: humiliated
humiliation: humiliation
humour: humour
humph: humph
hunger: hunger
hunt: hunting
hurrah: hurrah,hurrahs
hurriedly: hurriedly
hurry: hurried,hurry
hurt: hurt
husband: husband
hush: hushed
hustle: hustled
hut: hut,huts
hypogea: hypogea
ice: ice
icy: icy
idea: idea,ideas
ideal: ideal
idealise: idealised
identical: identical
identity: identity
idiot: idiot
idiotic: idiotic
ignorant: ignorant
iii: iii
illinois: illinois
illuminate: illuminated
illumine: illumined
illustrated: illustrated
illustrious: illustrious
imaginable: imaginable
imagination: imagination
imagine: imagine,imagined
imitation: imitation
immense: immense
immortal: immortal
immovable: immovable
impart: impart,imparted,imparting
imparted: imparted
impassibility: impassibility
impassible: impassible
impatience: impatience
impatient: impatient
impatiently: impatiently
impede: impeded,impeding
impel: impelled
impenetrable: impenetrable
imperial: imperial
imperil: imperil
impersonation: impersonation
imperturbable: imperturbable
impetus: impetus
implicate: implicated
import: imported
importunate: importunate
impose: imposed,imposing
impossible: impossible
impracticable: impracticable
impress: impressed
imprint: imprint
imprison: imprisoned,imprisoning
imprisonment: imprisonment
improbable: improbable
improvise: improvised
imprudent: imprudent
impunity: impunity
inaccessible: inaccessible
inanimate: inanimate
inaugurate: inaugurated
inauguration: inauguration
incendiary: incendiaries
incessant: incessant
incessantly: incessantly
incident: incident,incidents
incline: inclined
inclined: inclined
include: included,including
inconvenience: inconvenience
increase: increase,increased,increasing
incredulous: incredulous
indefatigably: indefatigably
indemnify: indemnified
independence: independence
independent: independent
india: india
indian: indian,indians
indiana: indiana
indifference: indifference
indignant: indignant
indignation: indignation
indigo: indigo
indispensable: indispensable
indistinctly: indistinctly
individual: individuals
induce: induce,induced
indus: indus
inevitably: inevitably
inexactness: inexactness
infected: infected
infest: infested
influence: influence,influenced
inform: inform,informed
ingenious: ingenious
ingot: ingot
inhabit: inhabit,inhabited
inhabitant: inhabitants
inhale: inhaled,inhaling
injuriously: injuriously
injury: injuries,injury
inn: inn
innocence: innocence
innocent: innocent
inns: inns
innumerable: innumerable
inquire: inquire
inquiry: inquiry
inscribe: inscribed
insect: insects
inseparable: inseparable
insert: inserted
insist: insist,insisted,insisting
insolent: insolent
insolently: insolently
inspect: inspecting
inspection: inspection
inspiration: inspiration
inspire: inspired
install: installed,installing
instance: instance
instant: instant
instantaneous: instantaneous
instantly: instantly
instinct: instinct
instinctively: instinctively
institution: institution,institutions
instruct: instructed
instruction: instruction,instructions
instrument: instrument,instruments
insufficient: insufficient
insult: insulted
insurmountable: insurmountable
insurrection: insurrection
intelligence: intelligence
intelligent: intelligent
intend: intend,intended,intending,intends
intense: intense
intensely: intensely
intensify: intensified
intention: intention
intently: intently
intercept: intercepted
interference: interference
interior: interior
interminable: interminable
international: international
interpret: interpreted
interrupt: interrupt,interrupted,interrupting
interrupted: interrupted
interruption: interruption
interval: interval,intervals
intervention: intervention
interview: interview
intimacy: intimacy
intimate: intimate
intimately: intimately
intoxicate: intoxicated
intoxication: intoxication
intractable: intractable
intrigue: intrigue
intrude: intrude
invade: invaded
invariably: invariably
inveigh: inveigh
inveigle: inveigled
inveterate: inveterate
invisible: invisible
invitation: invitation
invite: invited
involuntary: involuntary
ionic: ionic
iowa: iowa
irish: irish
iron: iron
irregular: irregular
irresistible: irresistible
irresistibly: irresistibly
irretrievable: irretrievable
irrevocably: irrevocably
irrigate: irrigated
irritate: irritating
irritated: irritated
island: island,islands
islands: islands
islet: islets
israel: israel
issue: issue,issued
italian: italian
itinerant: itinerant
itinerary: itinerary
iv: iv
ivory: ivory
ix: ix
jaded: jaded
jagged: jagged
jail: jail
james: james
japan: japan
japanese: japanese
jealousy: jealousy
jean: jean
jeer: jeering
jerk: jerk
jersey: jersey
jet: jet
jetty: jetty
jew: jew
jewel: jewels
jewellery: jewellery
jews: jews
jib: jib
jingle: jingled
joe: joe
john: john
joke: joke,joking
jolly: jolly
jolt: jolted
jordan: jordan
joseph: joseph
jostle: jostled
journal: journal
journey: journey,journeying,journeys
joy: joy,joys
joyful: joyful
joyfully: joyfully
judge: judge
judgment: judgment
judicial: judicial
juggernaut: juggernaut
juggle: juggled
juggler: jugglers
juggling: juggling
jules: jules
jump: jump,jumped,jumping
jumper: jumper
junction: junction
jungle: jungles
junior: junior
junk: junks
justice: justice
justify: justified,justify
justly: justly
kali: kali
kama: kama
kansas: kansas
keel: keel
keen: keen,keenest
kent: kent
key: key
keyhole: keyhole
kidnap: kidnapped
kill: kill,killed
kindly: kindly
kindness: kindness
king: king
kingdom: kingdom
kinswoman: kinswoman
kitchen: kitchens
knave: knave
knee: knees
knife: knife,knives
knit: knit
knock: knock,knocked,knocking
knot: knot,knots
kong: kong
laboriously: laboriously
lac: lac
lace: lace
lack: lack
ladder: ladders
lady: ladies,lady
lake: lake,lakes
lamp: lamp
land: land,landed
landing: landing
landlord: landlord
landmark: landmarks
landscape: landscape
landward: landward
lantern: lanterns
lapse: lapse
laramie: laramie
largeness: largeness
lash: lash,lashes
lashing: lashings
late: late
laugh: laugh,laughed,laughing
laughter: laughter
launch: launched
lavish: lavish
lavishly: lavishly
law: law,laws
lay: laid,lay,laying
lead: leading,led
leaf: leaves
lean: leaned,leaning
leap: leap,leaped,leaping
learn: learn,learned
leave: leave,leaved,leaves,leaving,left
lecture: lecture
left: left
leg: leg,legs
legally: legally
legend: legends
legendary: legendary
legged: legged
legislator: legislators
leisurely: leisurely
lend: lend,lending
leotard: leotard
lessen: lessened
lessening: lessening
letter: letter
level: level,levelled
liability: liability
liberal: liberal
liberate: liberated
liberty: liberty
library: libraries,library
lie: lain,lie,lies,lying
lieutenant: lieutenant,lieutenants
life: life,lives
lift: lift,lifted
light: light,lighted,lighter,lights,lit
lighthouse: lighthouse
lightly: lightly
lightning: lightning
likelihood: likelihood
limb: limbs
limit: limit
limitless: limitless
limpid: limpid
lincoln: lincoln
linen: linen
link: link
lip: lips
liquid: liquid
liquor: liquor
list: list
listen: listen,listened,listening
listener: listener
literature: literature
litter: litters
live: live,lived,lives,living
lively: lively
liverpool: liverpool
load: loaded
loading: loading
loan: loan
lobby: lobby
local: local
locality: localities,locality
lock: lock,locked
locomotion: locomotion
locomotive: locomotive,locomotives
locust: locusts
lodge: lodge,lodged
lofty: lofty
log: log
logical: logical
london: london
londoner: londoner
longing: longing
looker: lookers
loom: loomed,looming
loop: looped
loosen: loosen,loosened
loquacious: loquacious
lord: lord
lose: lose,losing,lost
loss: loss
lot: lot
lotus: lotus
loud: loud
lounge: lounging
love: love
lovely: loveliest
lover: lovers
luck: luck
luckless: luckless
luggage: luggage
lugubrious: lugubrious
luminous: luminous
lump: lumps
lunatic: lunatic
lunch: lunch
lurch: lurch,lurches
lustily: lustily
luxuriant: luxuriant
luxurious: luxurious
lyre: lyre
macao: macao
machine: machine
machinery: machinery
mackintosh: mackintosh
mad: mad
madam: madam
madame: madame
madman: madman
madness: madness
madras: madras
magic: magic
magistrate: magistrate,magistrates
magnificent: magnificent
mahomet: mahomet
maiden: maiden
mail: mail,mails
main: main
maintain: maintain
majestic: majestic
majority: majority
malabar: malabar
malacca: malacca
malays: malays
male: males
malediction: maledictions
mall: mall
manage: manage,managed,managing
management: management
manchester: manchester
mango: mangoes
manifest: manifest,manifested,manifesting
manner: manner
mannered: mannered
manners: manners
mansion: mansion,mansions
mantel: mantel
mantle: mantle
manufacturer: manufacturer
manufacturing: manufacturing
manuscript: manuscript
march: march,marched,marching
mariner: mariner,mariners
mark: mark,marked,marking,marks
market: market
marriage: marriage
marry: married,marry
martyr: martyr
marvel: marvels
marvellous: marvellous
mask: masks
mass: mass,massing
massive: massive
mast: mast,masts
master: master,masters
masterpiece: masterpieces
match: match,matched
material: material
materially: materially
mathematical: mathematical
mathematically: mathematically
matter: matter,mattered
mayor: mayor
meal: meal,meals
measure: measures
meat: meat
mechanic: mechanics
mechanically: mechanically
medicine: medicine
meditate: meditating
meditation: meditation
medium: medium
meet: meet,meeting,met
meeting: meeting
melancholy: melancholy
mell: mell
melodious: melodious
melody: melody
melt: melted,melting
memorable: memorable
memorandum: memoranda,memorandum
memory: memories
menace: menaced
mental: mental
mentally: mentally
mention: mention
merchandise: merchandise
merchant: merchant,merchants
mercury: mercury
mercy: mercy
mere: mere
meridian: meridian,meridians
merry: merry
message: message
messenger: messenger,messengers
met: met
metal: metal
metallic: metallic
meteorologist: meteorologist
method: method,methods
methodical: methodical
methodically: methodically
metropolitan: metropolitan
mew: mew
mexico: mexico
michigan: michigan
midday: midday
middle: middle
midnight: midnight
midst: midst
mighty: mighty
mikado: mikado
mild: mild
mile: mile,miles
military: military
milk: milk
mimosa: mimosa
minaret: minarets
mind: mind,minds
minerva: minerva
mingle: mingle,mingled,mingling
minimum: minimum
minute: minute,minutes
minutely: minutely
miracle: miracle
miraculous: miraculous
misadventure: misadventures
misdemeanour: misdemeanour
miserable: miserable
misery: misery
misfortune: misfortune
misgive: misgiving
misgiving: misgivings
mishap: mishap
missing: missing
mission: mission
missionary: missionary
mississippi: mississippi
missouri: missouri
mist: mist
mistake: mistake,mistaken
mistaken: mistaken
mistrust: mistrust
misty: misty
mitre: mitres
mix: mixed
mixed: mixed
mocha: mocha
mode: modes
model: modelled
moderate: moderate
modern: modern
modest: modest
modesty: modesty
modify: modified
moist: moist
moment: moment,moments
monastery: monasteries
monday: monday
money: money
moneyed: moneyed
mongolia: mongolia
monkey: monkey,monkeys
monsieur: monsieur
monstrous: monstrous
mont: mont
montgomery: montgomery
month: month,months
monument: monument
moon: moon
moonshine: moonshine
moor: moored
mormon: mormon
mormonism: mormonism
mormons: mormons
morning: morning
morrow: morrow
morsel: morsel
mortal: mortal
mortally: mortally
mosaic: mosaic
mosque: mosques
motion: motion,motions
motionless: motionless
motive: motive
motley: motley
mould: mould
mount: mounted,mounting
mountain: mountain,mountains
mountainous: mountainous
mountains: mountains
mountebank: mountebank,mountebanks
mournfully: mournfully
moustache: moustache
mouth: mouth
movable: movable
moveable: moveable
movement: movement,movements
mud: mud
muddy: muddy
multiply: multiplied
multitude: multitude,multitudes
mummy: mummy
murder: murders
murderer: murderer
murmur: murmur,murmured,murmurs
murmuring: murmuring
muscular: muscular
mushroom: mushrooms
music: music
musical: musical
musician: musicians
musket: muskets
muslin: muslin
mutter: muttered,muttering
mutton: mutton
mutual: mutual
muzzle: muzzle
mysterious: mysterious
mystery: mysteries,mystery
mystical: mystical
nagasaki: nagasaki
nail: nail
naked: naked
nakedness: nakedness
nankin: nankin
narcotic: narcotic
narrate: narrated
narrative: narrative
narrow: narrow,narrowed
narrowly: narrowly
nation: nations
nationality: nationalities,nationality
native: native,natives
natural: natural
naturally: naturally
nature: nature
navigator: navigators
neat: neat
nebraska: nebraska
necessity: necessity
neck: neck
needless: needless
negotiable: negotiable
negro: negroes
neighbour: neighbour,neighbouring
neptune: neptune
nerve: nerve
nervous: nervous
nervously: nervously
nest: nests
neutrality: neutrality
nevada: nevada
newcomer: newcomer
newfoundland: newfoundland
news: news
newspaper: newspapers
nicholas: nicholas
nigh: nigh
night: night,nights
nineteen: nineteen
ninth: ninth
nizam: nizam
noble: noble
nod: nodded
noise: noise
noiselessly: noiselessly
noisily: noisily
nominate: nominate
nonsense: nonsense
noon: noon
north: north
northeasterly: northeasterly
northern: northern
northward: northward
northwest: northwest
norway: norway
nose: nose,noses
note: note,notes,noting
notice: notice,noticed,notices
noticeable: noticeable
notify: notify
nourished: nourished
nourishment: nourishment
november: november
nowadays: nowadays
numerous: numerous
nutmeg: nutmeg
oakland: oakland
oath: oath,oaths
obadiah: obadiah
obedience: obedience
obedient: obedient
obey: obey,obeyed
object: object,objected,objects
obligation: obligation
oblige: oblige,obliged,obliging
obscure: obscure
observation: observation
observe: observe,observed,observing
observer: observer
obstacle: obstacle,obstacles
obstinate: obstinate
obstinately: obstinately
obstruct: obstruct
occasion: occasion,occasioned
occasional: occasional
occasionally: occasionally
occupant: occupant,occupants
occupation: occupation
occupy: occupied,occupying
occur: occur,occurred
occurrence: occurrences
ocean: ocean
ochre: ochre
octave: octave
october: october
odd: odd
oddity: oddity
odorous: odorous
odourless: odourless
offence: offence
offend: offended
offensive: offensive
offer: offer,offered,offering
office: office
officer: officer,officers
official: official,officials
ogre: ogre
ohio: ohio
oil: oil
omaha: omaha
omnibus: omnibus,omnibuses
operation: operation,operations
opinion: opinion
opium: opium
opponent: opponent
opportune: opportune
opportunity: opportunity
orbit: orbit
orchestra: orchestra
ordinary: ordinary
oregon: oregon
oriental: oriental
original: original
ornament: ornament,ornamented,ornaments
ornamentation: ornamentation
orphan: orphan
otter: otter
outlaw: outlaws
outlet: outlet
outline: outline,outlines
outraged: outraged
outrageously: outrageously
outright: outright
outspoken: outspoken
outward: outward
overcast: overcast
overcoat: overcoat
overcome: overcome
overflow: overflowing
overhang: overhanging
overhear: overheard
overlook: overlooked
overnight: overnight
overspread: overspread
overtake: overtake,overtaken
overturn: overturned,overturning
overwhelm: overwhelmed
overwhelmed: overwhelmed
owe: owed,owes
owner: owner,owners
oxidise: oxidised
oyster: oyster
pablo: pablo
pace: pace,paces
pacific: pacific
pacing: pacing
pack: pack,packed,packs
package: package,packages
packet: packet
paddle: paddle,paddles
pagoda: pagoda,pagodas
pain: pains
paint: painted
painting: paintings
pair: pair,pairs
palanquin: palanquin,palanquins
palatable: palatable
palatial: palatial
pale: pale
paling: palings
palisade: palisades
pall: pall
pallor: pallor
palm: palm,palms
panorama: panorama
panther: panthers
pantry: pantries
paper: paper,papers
papuan: papuans
papyrus: papyrus
par: par
parade: parade
paradise: paradise
parallel: parallel,parallels
paralytic: paralytic
parbleu: parbleu
pardon: pardon
pardonable: pardonable
paris: paris
parish: parish
parisian: parisian
park: park
parliament: parliament
paroxysm: paroxysm
parsee: parsee
partake: partake,partaken
parterre: parterres
partner: partner,partners
partridge: partridge
party: parties,party
pass: pass,passed,passes,passing
passage: passage
passenger: passenger,passengers
passer: passers
passing: passing
passion: passion,passions
passionate: passionate
passport: passport,passports
passports: passports
pastime: pastime,pastimes
path: path,paths
pathetically: pathetically
patience: patience
patiently: patiently
patrol: patrol
patronage: patronage
pattern: pattern
pavilion: pavilions
pawnees: pawnees
pay: paid,pay,paying
payment: payment
peace: peace
peaceable: peaceable
peacefully: peacefully
peak: peak
pearl: pearls
pebble: pebble
peculiar: peculiar
pecuniary: pecuniary
peer: peering
pelican: pelicans
pelisse: pelisse
pell: pell
pen: pens
pendulum: pendulum
penetrate: penetrated,penetrating
peninsula: peninsula
peninsular: peninsular
pennsylvania: pennsylvania
penny: penny
pensive: pensive
people: peopled
pepper: pepper
perambulate: perambulating
perceive: perceive,perceived,perceiving
percentage: percentage
perceptible: perceptible
perch: perched
perfect: perfect
perfectly: perfectly
perform: performed,performing
performance: performance,performances
performer: performer
perfume: perfume,perfumes
perilous: perilous
period: period
perish: perish
peristyle: peristyles
permanently: permanently
permission: permission
permit: permit,permitted,permitting
pernicious: pernicious
perpendicular: perpendicular
perpetual: perpetual
perplexed: perplexed
persecution: persecutions
persecutor: persecutors
persian: persians
persist: persisted
persistency: persistency
persistent: persistent
persistently: persistently
person: people,person,persons
personage: personage,personages
personal: personal
personally: personally
personify: personified
perspective: perspective
persuade: persuade,persuading
pert: pert
peru: peru
perusal: perusal
pet: pet
petroleum: petroleum
phantom: phantom
phase: phases
philosophically: philosophically
phlegm: phlegm
phlegmatic: phlegmatic
phosphorescent: phosphorescent
photograph: photograph
phrase: phrase,phrases
physical: physical
piano: pianos
pick: pick,picked
pickaroon: pickaroon
picturesque: picturesque
piece: piece,pieces
pier: pier
pierce: pierce,pierced
pigeon: pigeons
pilgrim: pilgrims
pillage: pillage,pillaged
pillaging: pillaging
pillow: pillows
pilot: pilot
pin: pins
pinch: pinch
pine: pines
pioneer: pioneer
pious: pious
pipe: pipe,pipes
pirate: pirate
pistol: pistols
piston: piston
pitch: pitch,pitched,pitches
pitching: pitching
pity: pitied,pity
placard: placard
placid: placid
placidly: placidly
plain: plain,plains
plainly: plainly
plaintively: plaintively
plan: plan,planning,plans
plank: plank,planks
plant: plant,plants
plantation: plantations
plate: plates
platform: platform,platforms
plausible: plausible
play: play,played,playing,plays
player: player,players
playing: playing
pleasant: pleasant
pleased: pleased
plentiful: plentiful
plentifully: plentifully
plenty: plenty
plough: ploughed
plum: plum
plumed: plumed
plunder: plunder
plunge: plunged,plunges,plunging
ply: plied,ply,plying
pocket: pocket,pocketed,pockets
poet: poet
poetical: poetical
pole: pole,poles
police: police
policeman: policeman,policemen
policy: policy
polished: polished
polite: polite
politely: politely
politeness: politeness
political: political
politics: politics
polygamist: polygamists
polygamy: polygamy
polygonal: polygonal
ponderous: ponderous
pony: ponies
poodle: poodles
poop: poop
poor: poor
popular: popular
populate: populated
population: population
porcelain: porcelain
porch: porches
pork: pork
porphyry: porphyry
port: port,ports
porter: porter,porters
portico: portico
portion: portion
portly: portly
portrait: portrait
portuguese: portuguese
position: position
positively: positively
possess: possessed
possession: possession,possessions
possibility: possibilities
post: post
poster: posters
postpone: postpone,postponed
pounce: pounce
pound: pounding,pounds
powdering: powdering
power: power,powers
powerful: powerful
practicable: practicable
practically: practically
practice: practice,practices
practise: practised
prairie: prairie,prairies
preach: preach
preamble: preamble
precaution: precaution,precautions
precede: preceded
precious: precious
precipice: precipices
precipitate: precipitated
precisely: precisely
precision: precision
predecessor: predecessor
predict: predict,predicted
prediction: prediction,predictions
prefer: preferred
premature: premature
prematurely: prematurely
premium: premium
preoccupied: preoccupied
preparation: preparations
prepare: prepared,preparing
prepared: prepared
prescribe: prescribed
presence: presence
presentable: presentable
presentiment: presentiment
presently: presently
preserve: preserve,preserved,preserving
presidency: presidency
president: president
press: press,pressed,pressing
pressure: pressure
presumption: presumptions
pretend: pretend,pretended,pretending
pretension: pretensions
pretext: pretext
pretty: pretty
prevail: prevail
prevent: prevent,preventing
price: price
prickly: prickly
pride: pride,prided
priest: priest,priests
priests: priests
prince: prince,princes
principal: principal
principally: principally
print: printed
prior: prior
prison: prison
prisoner: prisoner,prisoners
private: private
prize: prize,prizes
probability: probabilities
probable: probable
proceed: proceed,proceeded,proceeding
proceeding: proceeding
proceedings: proceedings
process: process
procession: procession,processions
proctor: proctor
procure: procure,procured
prodigal: prodigal
prodigious: prodigious
prodigiously: prodigiously
prodigy: prodigy
produce: produced
product: product,products
profession: profession,professions
professional: professional
professor: professor
proffer: proffered
profile: profile
profit: profit,profiting
profitable: profitable
profoundly: profoundly
programme: programme
progress: progress,progressing
project: project,projects
prolonged: prolonged
promenade: promenade,promenading
promise: promised,promising
promontory: promontory
prompt: prompt
pronounce: pronounce,pronounced,pronouncing
proof: proof
proper: proper
properly: properly
prophecy: prophecies
prophet: prophet,prophets
propitiate: propitiating
propitious: propitious
proposal: proposal
propose: propose,proposed
proposer: proposer
proprietor: proprietor
proselyte: proselytes
prospect: prospect
prosperity: prosperity
prosperously: prosperously
prostrate: prostrate,prostrated
prostration: prostration
protect: protect,protected,protects
protection: protection
protector: protector
protest: protested
protrude: protruding
proudly: proudly
prove: prove,proved,proving
provide: provide
province: province,provinces
provision: provisions
provocation: provocation
prudence: prudence
prudent: prudent
psalm: psalm
pshaw: pshaw
public: public
publish: published
puff: puffing,puffs
pugilistic: pugilistic
pull: pull,pulled
pulp: pulp
pulsation: pulsations
pump: pump
punctual: punctual
punctuality: punctuality
punctually: punctually
punish: punished,punishes
pupil: pupils
purchase: purchase,purchased,purchases,purchasing
pure: pure,purest
purely: purely
purity: purity
purple: purple
purpose: purpose,purposes
purposely: purposely
purse: purse,purses
purser: purser
pursue: pursue,pursued,pursuing
pursuit: pursuit
push: push,pushed,pushing
puzzle: puzzled
puzzled: puzzled
pyramid: pyramid
pyre: pyre
quail: quails
quaint: quaint
quality: qualities,quality
quarrel: quarrel
quarter: quarter,quarters
quay: quay,quays
queen: queen
queer: queer
queerly: queerly
quench: quenching
query: queried
quest: quest
question: question,questioned,questions
quiet: quiet
quietly: quietly
quit: quit,quitted,quitting
quota: quota
quote: quoted
rabbit: rabbit
race: race,races
racehorse: racehorse
racing: racing
radiant: radiant
raft: rafts
rag: rags
rage: rage,raged,rages,raging
ragged: ragged
rail: rail,rails
railing: railing,railings
raillery: raillery
railroad: railroad
railroads: railroads
railway: railway,railways
rain: rain,rains
raise: raised,raising
raja: rajahs
rajah: rajah
ralph: ralph
ranch: ranches
range: range,ranged
rangoon: rangoon
rank: ranks
rap: rap,rapped
rapid: rapid,rapids
rapidity: rapidity
rapidly: rapidly
rare: rare
rarely: rarely
rascal: rascal
rascally: rascally
rash: rash
rashly: rashly
rate: rate
rational: rational
rattle: rattled
ravages: ravages
raven: ravens
ravenously: ravenously
ravish: ravished
ray: rays
reach: reach,reached,reaches,reaching
read: read,reading
reader: reader,readers
readiness: readiness
reading: reading
ready: ready
real: real
realise: realise
reality: reality
reappear: reappear,reappeared
reappearance: reappearance
rear: rear,reared
rearguard: rearguard
reason: reason,reasoned,reasons
reassure: reassure,reassured
rebellion: rebellion
rebuild: rebuild
recall: recall,recalled,recalling
receipt: receipt
receive: receive,received,receives,receiving
reckon: reckon,reckoning
recognise: recognise,recognised,recognising
recommend: recommended,recommending
reconnaissance: reconnaissance
record: record,recording
recount: recounted,recounting
recover: recover,recovered
rectilinear: rectilinear
rectitude: rectitude
red: red
redouble: redoubled
reduce: reduced,reducing
reed: reeds
reef: reef,reefed
refer: referred
reference: references
reflect: reflect,reflected,reflecting
reflection: reflection,reflections
reform: reform
refrain: refrained
refreshingly: refreshingly
refreshment: refreshment
refuge: refuge
refuse: refuse,refused
regain: regain,regained
regard: regard,regarded
regatta: regatta
regent: regent
region: region
register: registering
regret: regret,regretted
regular: regular
regularity: regularity
regularly: regularly
regulate: regulate,regulated
regulation: regulations
regulator: regulator
rehearse: rehearse
reject: reject,rejected
rejoin: rejoin,rejoined,rejoining
relate: relate,relates
relation: relation,relations
relative: relative,relatives
release: release
reliant: reliant
relief: relief
relieved: relieved
religion: religion,religions
religious: religious
religiously: religiously
relit: relit
rely: rely
remain: remain,remained,remaining
remainder: remainder
remains: remains
remark: remark,remarked
remarkable: remarkable
remember: remember,remembered
remind: reminded
reminiscence: reminiscence
remonstrance: remonstrance,remonstrances
remorse: remorse
remorselessly: remorselessly
remount: remounted
remove: remove,removed
render: render,rendering
renew: renew
reno: reno
repair: repair,repaired,repairing,repairs
repast: repast
repeat: repeat,repeated,repeating
repel: repelled
replace: replaced
reply: replied,replies,reply,replying
report: report,reported,reports
repose: repose,reposes,reposing
represent: represent,represented
representation: representations
representative: representative
repress: repress
reproach: reproach
reproduce: reproduced
republican: republican
repugnance: repugnance
repulse: repulsed
reputation: reputation
request: request,requested,requesting
require: required,requires
rescue: rescue,rescued,rescuing
resemblance: resemblance
resemble: resemble,resembled,resembles
resent: resenting
reserve: reserve
residence: residence
resign: resign,resigned
resin: resin
resist: resisted
resistance: resistance
resolution: resolution
resolve: resolved,resolving
resort: resort
resound: resounded
resource: resource,resources
respect: respected,respecting
respectable: respectable
respond: responded,responding
response: response,responses
responsible: responsible
rest: rest,rested,resting
restaurant: restaurant,restaurants
restless: restless
restoration: restoration
restore: restored
restrain: restrained
result: result
resume: resume,resumed,resuming
resuscitate: resuscitated
retain: retain,retained,retaining
retake: retaken
retaliate: retaliating
retard: retard,retarded,retards
retire: retire,retired,retiring
retirement: retirement
retort: retorted
retreat: retreat,retreats
return: return,returned,returning
reveal: revealed
revelation: revelation
reverend: reverend
reverie: reverie,reveries
reverse: reverse,reversed,reversing
revive: revived,reviving
revolt: revolt,revolted
revolve: revolved
revolver: revolver,revolvers
revolving: revolving
reward: reward,rewarded,rewards
rewarding: rewarding
rhapsody: rhapsody
rhubarb: rhubarb
ribbon: ribbon,ribboned
rice: rice
rich: rich,richest
riches: riches
richly: richly
rid: rid
ride: rode
rider: rider
ridge: ridge
rifle: rifles
rig: rigged
rigging: rigging
rightly: rightly
rise: rise,risen,rises,rising,rose
risk: risk,risked,risking
rite: rites
river: river,rivers
road: road,roads
roadstead: roadstead
roaring: roaring
roast: roast
rob: robbing
robber: robber,robbers
robbery: robbery
robe: robe,robes
robed: robed
robust: robust
rock: rock,rocks
rocky: rocky
rod: rod,rods
rogue: rogue,rogues
roll: roll,rolled
rolling: rolling
roof: roofs
root: root
rope: rope
rose: rose
rosin: rosin
rough: rough
roughly: roughly
roughness: roughness
roundabout: roundabout
rounded: rounded
rout: rout
route: route
routine: routine
row: row,rows
rowan: rowan
royal: royal
rub: rubbed
rubber: rubber,rubbers
rubicund: rubicund
rudder: rudder
ruefully: ruefully
ruffian: ruffian,ruffians
ruin: ruin,ruined,ruins
ruinous: ruinous
ruinously: ruinously
rule: rule
ruler: ruler
ruminate: ruminating
rump: rump
rumpled: rumpled
runner: runners
rush: rush,rushed,rushing
rustle: rustled
sabre: sabre,sabres
sacramento: sacramento
sacred: sacred
sacrifice: sacrifice,sacrificed,sacrifices
sacrilege: sacrilege
sad: sad
saddle: saddle
sadness: sadness
safe: safe,safer
safely: safely
safety: safety
sage: sage
sago: sago
sail: sail,sailed,sailing,sails
sailing: sailing
sailor: sailor,sailors
saint: saint
saints: saints
sake: sake
saki: saki
salary: salaries
saloon: saloon
salt: salt
samuel: samuel
san: san
sandal: sandals
sandy: sandy
sash: sashes
satisfaction: satisfaction
satisfactory: satisfactory
satisfied: satisfied
satisfy: satisfied,satisfy
saturday: saturday
sauce: sauce
saucer: saucer
saunders: saunders
saunter: sauntered,sauntering
savage: savage
save: save,saved,saving
saviour: saviour
saxon: saxon,saxons
scale: scale
scalp: scalp
scan: scan,scanned
scanty: scanty
scarce: scarce
scarcely: scarcely
scarecrow: scarecrows
scarf: scarf,scarfs
scarlet: scarlet
scatter: scattered
scene: scene,scenes
scent: scent
science: sciences
sciences: sciences
scientific: scientific
scintillation: scintillations
scorch: scorched
scotch: scotch
scotland: scotland
scoundrel: scoundrels
scour: scouring
scout: scouted
scratch: scratch
scream: screamed
screech: screech
screen: screen,screens
screw: screw
scroll: scroll
scruple: scruples
scrupulously: scrupulously
scrutinise: scrutinised
scud: scudded,scudding
sculptor: sculptor,sculptors
scurvy: scurvy
sea: sea,seas
seaboard: seaboard
seagull: seagull
seal: seal
seaman: seaman
search: search,searched,searching
season: season
seat: seat,seated,seats
secluded: secluded
secret: secret
sect: sect
sectary: sectaries,sectary
secure: secure,secured,secures,securing
sedately: sedately
sedentary: sedentary
seek: seeking,sought
seemingly: seemingly
seize: seize,seized,seizing
seldom: seldom
sell: sell,sold
seller: sellers
send: send,sending
sensation: sensation
sense: sense
senseless: senseless
sentence: sentence
sentiment: sentiment
separate: separate,separated,separates
sepoy: sepoy
september: september
sequel: sequel
serene: serene
serenity: serenity
sergeant: sergeant
series: series
serpent: serpent,serpents
servant: servant
serve: serve,served,serving
service: service,services
serviceable: serviceable
set: set,sets,setting
settle: settle,settled,settles
settled: settled
settling: settling
seventeen: seventeen
seventh: seventh
severe: severe
severely: severely
sew: sewed
sex: sex
shade: shaded
shades: shades
shadow: shadow
shaft: shaft
shake: shake,shaken,shaking,shook
shaky: shaky
shameful: shameful
shanghai: shanghai
shape: shaped
share: share,shared,sharing
sharp: sharp,sharper
shatter: shatter,shattered
shave: shave,shaved
shaving: shaving
shawl: shawl
sheathing: sheathing
sheet: sheet,sheets
shelf: shelf
shelter: sheltered
sherry: sherry
shilling: shilling,shillings
shine: shining
ship: ship,ships
shipwreck: shipwrecks
shirt: shirts
shiva: shiva
shock: shock,shocks
shoe: shoes
shoeless: shoeless
shoot: shoot,shot
shop: shop,shops
shore: shore,shores
short: short,shorter,shortest
shorten: shorten
shortening: shortening
shortly: shortly
shot: shots
shoulder: shoulder,shoulders
shout: shouted,shouts
shower: showered
showman: showman
shrewd: shrewd
shrewdly: shrewdly
shrewdness: shrewdness
shriek: shrieks
shrill: shrill
shrink: shrank
shroud: shrouded
shrub: shrubs
shrug: shrugging
shudder: shudder,shuddered
shuffling: shuffling
shut: shut
shuttlecock: shuttlecocks
sick: sick
sickness: sickness
sided: sided
sidewalk: sidewalk
siege: siege
sierra: sierra
sight: sight,sighted,sights
sign: sign,signed,signs
signal: signal,signalled,signals
signify: signified
silence: silence
silent: silent
silk: silk
silken: silken
silver: silver
simple: simple,simplest
simply: simply
sincerity: sincerity
sing: sang,sing
singapore: singapore
singer: singer
singing: singing
single: single
singular: singular
singularly: singularly
sink: sank
sioux: sioux
sir: sir
sit: sat,sit,sitting
situate: situated
situation: situation
sixpence: sixpence
sixteen: sixteen
sixth: sixth
sixtieth: sixtieth
size: sizes
sized: sized
skeleton: skeleton
skilful: skilful
skilfully: skilfully
skill: skill
skilled: skilled
skim: skimming
skin: skin
skip: skipped,skipping
skirt: skirted,skirting,skirts
sky: skies,sky
slacken: slacken,slackened,slackening
sledge: sledge,sledges
sleek: sleek
sleep: sleep,sleeping,slept
sleeve: sleeve
slender: slender
slice: slice
slide: slid
slight: slight,slightest
slip: slip,slipped,slipping,slips
slipper: slippers
sloop: sloop
slope: slope
slow: slow
slowly: slowly
sluggishness: sluggishness
slumber: slumbered,slumbers
slumberer: slumberers
slumbering: slumbering
sly: sly
smack: smacks
smash: smashed
smear: smeared
smell: smelling
smile: smile,smiled,smiling
smith: smith
smoke: smoke,smoked,smoking
smoker: smoker,smokers
smoking: smoking
smooth: smooth,smoothed
smoothly: smoothly
snail: snail
snake: snakes
snatch: snatch
snore: snores
snow: snow,snowing
snugly: snugly
soak: soaked
sober: sobered
social: social
society: societies,society
soft: soft,softer
softly: softly
soil: soil
sojourn: sojourning
solar: solar
soldier: soldier,soldiers
sole: sole,soles
solely: solely
solemn: solemn
solemnly: solemnly
solid: solid
solidly: solidly
solitary: solitary
solitude: solitude
solomon: solomon
solution: solution
solve: solve,solved
sombre: sombre
sombreros: sombreros
somersault: somersaults
son: son
song: songs
sons: sons
sore: sore
sorely: sorely
sort: sort,sorts
sot: sots
soul: soul,souls
sound: sound,sounded
soup: soup
source: sources
south: south
southerly: southerly
southern: southern
southward: southward
sow: sown
space: space
spacious: spacious
spade: spade,spades
spar: spars
spare: spare
spark: spark
sparrow: sparrows
speak: speak,speaking,speaks,spoke,spoken
special: special
species: species
specific: specific
spectacle: spectacle
spectator: spectators
spectre: spectre
speech: speech
speechless: speechless
speed: sped,speed
speedily: speedily
speedy: speedy
spend: spend,spending,spent
spice: spiced
spiced: spiced
spinning: spinning
spiral: spirals
spirit: spirit,spirits
spiritual: spiritual
spite: spite
splendid: splendid
spoke: spokes
spot: spot,spotted
spouse: spouse
sprawl: sprawling
spray: spray
spread: spread
sprightly: sprightly
spring: spring
spur: spur,spurred,spurs
spy: spy,spying
squabble: squabble
squad: squad
squalid: squalid
squall: squall,squalls
square: square,squares
squarely: squarely
staff: staffs
stage: stage
stagger: staggered,staggering
staggering: staggering
stain: stained
stair: stairs
stairway: stairway
stake: stake,staked
stall: stalls
stammer: stammered
stamp: stamp,stamped
stand: stand,standing,stands,stood
standard: standard
standing: standing
star: star,stars
stare: stared,staring
start: start,started,starting,starts
starting: starting
startled: startled
starve: starved
station: station,stationed,stations
stationary: stationary
statue: statue
stature: stature
stay: stay,stayed,staying
stead: stead
steadily: steadily
steady: steady
steal: stealing,stolen
steam: steam,steamed,steaming
steamboat: steamboats
steamer: steamer,steamers
steamship: steamship
stem: stems
step: step,stepped,steps
sterling: sterling
stern: stern
sternly: sternly
steward: steward
stick: stick,sticks
stiffen: stiffened
stifle: stifled
stimulate: stimulate,stimulated
stipulate: stipulated
stir: stir,stirring
stocking: stockings
stoical: stoical
stoker: stoker,stokers
stoppage: stoppages
store: stored,stores
storm: storm
story: stories,story
stout: stout
straggle: straggling
straight: straight
straightway: straightway
strait: strait,straits
straits: straits
strand: strand
strange: strange
strangely: strangely
stranger: stranger,strangers
strangle: strangle,strangled
strangler: stranglers
strata: strata
straw: straw
stray: strayed
stream: stream,streams
streamer: streamers
street: street,streets
strength: strength
stretch: stretched
strew: strewn
stricken: stricken
strict: strictest
stride: striding
strike: strike,striking,struck
striking: striking
strikingly: strikingly
string: strings
stringed: stringed
stringent: stringent
stringy: stringy
strip: striped
stripe: stripes
strive: striving
stroke: stroke,strokes
stroll: strolling
strong: strong
stronghold: stronghold
struggle: struggle,struggled,struggling
stuart: stuart
study: studied,study,studying
stuff: stuff,stuffed
stun: stunned
stupefaction: stupefaction
stupefied: stupefied
stupefy: stupefied
stupefying: stupefying
stupid: stupid
stupor: stupor
sturdy: sturdy
style: style
subject: subject,subjected,subjects
submerge: submerged
submit: submit,submitted
subordinate: subordinates
subside: subside,subsided
subsidy: subsidy
succeed: succeed,succeeded
success: success
successful: successful
succession: succession
successively: successively
successor: successor
succour: succour
succulent: succulent
sudden: sudden
suddenly: suddenly
suddenness: suddenness
suez: suez
suffer: suffer,suffered,suffering
suffice: suffice,sufficed,suffices
sufficient: sufficient
sugar: sugar
suicide: suicide
suit: suit,suits
suitable: suitable
suitably: suitably
suite: suites
sum: sum,sums
sumatra: sumatra
summer: summer
summit: summits
summon: summoned
sumptuous: sumptuous
sumptuously: sumptuously
sumptuousness: sumptuousness
sun: sun
sunburnt: sunburnt
sunday: sunday
sunrise: sunrise
superb: superb
superfluous: superfluous
superhumanly: superhumanly
superior: superior
superiority: superiority
supper: supper
supple: supple
suppleness: suppleness
supply: supplied,supply
support: supported
suppose: suppose,supposed,supposing
supremacy: supremacy
supreme: supreme
surat: surat
surely: surely
surface: surface
surge: surge,surges
surname: surname
surprise: surprise,surprised
surprised: surprised
surrey: surrey
surround: surrounded
susceptible: susceptible
suspect: suspect,suspected,suspecting
suspend: suspend,suspended
suspense: suspense
suspension: suspension
suspicion: suspicions
suspicious: suspicious
sustain: sustained
suttee: suttee
swallow: swallows
swamp: swamping
swan: swan
swarm: swarm,swarmed,swarming
sway: sway,swayed,swaying
swear: swear,swore
sweden: sweden
sweep: swept
sweet: sweet,sweets
sweetness: sweetness
swell: swelled,swelling
swift: swift
swim: swim
swing: swung
swinging: swinging
swoon: swoon
syenite: syenite
symbolise: symbolise
symmetry: symmetry
sympathetic: sympathetic
sympathy: sympathy
synagogue: synagogues
table: table,tables
taciturn: taciturn
tailor: tailor
talent: talent,talents
talk: talk,talked,talking,talks
talkative: talkative
tall: tall
tam: tam,tams
tambourine: tambourines
tanka: tankas
tap: tapped
tar: tar
tart: tart
task: task
taste: taste,tasted,tastes
tasteful: tasteful
tattered: tattered
tatters: tatters
tavern: tavern,taverns
tax: tax
tea: tea
teach: teach
teakwood: teakwood
tear: tears,tore
telegram: telegrams
telegraph: telegraph,telegraphed
telegraphic: telegraphic
telescope: telescopes
temp: tempest
temperament: temperament
temperature: temperature
tempest: tempest,tempests
tempestuous: tempestuous
temple: temple,temples
tempt: tempted
tenacity: tenacity
tendency: tendency
tender: tender
tent: tents
term: terms
termination: termination
terminus: terminus
terrace: terrace
terrestrial: terrestrial
terrible: terrible
terribly: terribly
terrific: terrific
territory: territories,territory
terror: terror
thankful: thankful
theatre: theatre
theatrical: theatrical
theoretically: theoretically
theory: theory
thereabout: thereabouts
thicket: thicket
thickly: thickly
thief: thief
thinking: thinking
thirst: thirst
thirteen: thirteen
thither: thither
thomas: thomas
thrash: thrashing
thread: thread
threaten: threaten,threatening
threatening: threatening
threshold: threshold
thrifty: thrifty
throat: throat
throb: throbbed
throw: threw,throw,throwing,thrown
thrust: thrusting
thuggee: thuggee
thuggees: thuggees
thump: thumps
thunderstruck: thunderstruck
thursday: thursday
ticket: tickets
tide: tide
tie: tied,ties
tiger: tiger,tigers
tight: tight
tighten: tightened
tightly: tightly
time: time,times
timepiece: timepiece
times: times
timetable: timetables
timid: timid
timidly: timidly
tinge: tinge
tint: tinted
tinted: tinted
tissue: tissue
toast: toast
tobacco: tobacco
toe: toes
toilet: toilet,toilets
tolerate: tolerate
tomb: tomb
tomorrow: tomorrow
ton: ton,tons
tone: tone,tones
tongue: tongue
tonnage: tonnage
tooth: teeth,tooth
topic: topic
torch: torch,torches
torpor: torpor
torrent: torrent,torrents
torture: tortured,tortures
toss: tossed
total: total
totally: totally
totter: totter,tottered
touch: touched
touchhole: touchhole
touching: touching
tour: tour
tourist: tourist
tower: tower,towers
town: town,towns
toy: toy
trace: trace,traced,traces
track: track,tracked,tracks
tracking: tracking
tract: tract,tracts
traction: traction
trade: trade,traded,trades
trading: trading
trail: trails
train: train,trains
traitor: traitor
tranquil: tranquil
tranquillity: tranquillity
tranquilly: tranquilly
transact: transacted
transaction: transactions
transatlantic: transatlantic
transfer: transferred
transform: transformed
transit: transit
translation: translation
translator: translator
transpire: transpired
transport: transport,transporting
transportation: transportation
travel: travel,travelled,travelling
traveling: traveling
traveller: traveller,travellers
travelling: travelling
travels: travels
traverse: traverse,traversed,traverses,traversing
tread: trod
treason: treason
treasure: treasure,treasures
treat: treat,treated
treatment: treatment
treaty: treaty
tree: tree,trees
tremble: trembled,trembling
tress: tresses
trial: trials
triangle: triangle
triangular: triangular
tribe: tribe
tributary: tributaries,tributary
trick: trick,tricks
trickery: trickery
trifle: trifle
trip: trip
triumph: triumph
triumphantly: triumphantly
troop: troop
troops: troops
tropic: tropic
tropical: tropical
trot: trot,trotting
trouble: trouble,troubled
trough: trough
troupe: troupe
trousers: trousers
truck: truck
trudge: trudge
true: true
trump: trumps
trumps: trumps
trunk: trunk,trunks
trust: trust
truth: truth
tube: tubes
tumble: tumbling
tumbled: tumbled
tumultuous: tumultuous
tunic: tunic
tunnel: tunnel,tunnels
turban: turban,turbans
turtle: turtles
twentieth: twentieth
twilight: twilight
twine: twined
twist: twist,twisted
twitching: twitching
tycoon: tycoon
type: type
typhoon: typhoon
tyre: tyres
ugly: ugly
unable: unable
unaccustomed: unaccustomed
unaffected: unaffected
unarmed: unarmed
unattainable: unattainable
unbroken: unbroken
uncertainty: uncertainty
unchain: unchain
unclean: unclean
uncomfortable: uncomfortable
uncommon: uncommon
unconscious: unconscious
unconsciously: unconsciously
uncut: uncut
undecided: undecided
undergo: undergoes
understand: understand,understood
undertake: undertaking
undiminished: undiminished
undoubtedly: undoubtedly
undulation: undulations
uneasy: uneasy
unequal: unequal
unequally: unequally
unexpectedly: unexpectedly
unfavourable: unfavourable
unfold: unfolded
unforeseen: unforeseen
unfortunate: unfortunate
unfulfilled: unfulfilled
unfurl: unfurled
unhappily: unhappily
unharmed: unharmed
unheard: unheard
uniform: uniform
uninhabited: uninhabited
uninterrupted: uninterrupted
union: union
unite: united,unites
united: united
unknown: unknown
unlimited: unlimited
unloading: unloading
unloose: unloosed
unluckily: unluckily
unmask: unmask
unmistakable: unmistakable
unmoved: unmoved
unnaturally: unnaturally
unnecessary: unnecessary
unobserved: unobserved
unoccupied: unoccupied
unpardonable: unpardonable
unperceived: unperceived
unpleasant: unpleasant
unpoetically: unpoetically
unpropitious: unpropitious
unprotected: unprotected
unreasonable: unreasonable
unreliable: unreliable
unrest: unrest
unsafe: unsafe
unscrew: unscrewing
unspread: unspread
unusual: unusual
unvarying: unvarying
unwearying: unwearying
unwieldy: unwieldy
unwilling: unwilling
unwonted: unwonted
unwrinkled: unwrinkled
upper: upper
upright: upright
uranus: uranus
urge: urge,urged
useless: useless
uselessness: uselessness
usual: usual
utah: utah
utter: utter,uttered,uttering
vacancy: vacancy
vacant: vacant
vacation: vacation
vagabond: vagabond
vagrant: vagrant
vaguely: vaguely
vain: vain
vainly: vainly
valet: valet
valley: valley
valuable: valuable
valve: valve,valves
van: vans
vanish: vanished
vanity: vanity
vanquish: vanquished
vari: vari
varied: varied
vary: varied,vary,varying
vast: vast
vault: vault,vaulted
veer: veer,veered,veering
vehicle: vehicle,vehicles
vein: veins
velocity: velocity
venerable: venerable
venerate: venerated
vengeance: vengeance
venture: venture,ventured,venturing
venturesome: venturesome
veranda: verandas
verdant: verdant
verdure: verdure
verge: verge
vermilion: vermilion
vermont: vermont
vessel: vessel,vessels
vest: vest
vex: vexed
vexation: vexation,vexations
viaduct: viaducts
viand: viands
vibrate: vibrated
vice: vices
vicinity: vicinity
vicissitude: vicissitudes
victim: victim,victims
victor: victor
victoria: victoria
victorious: victorious
victory: victory
view: view
vigorous: vigorous
vigorously: vigorously
vii: vii
viii: viii
village: village,villages
villain: villain
viol: viol,viols
violate: violate,violated,violating
violence: violence
violent: violent
violently: violently
violet: violets
violin: violin
visa: visa,visaed
visage: visage
vishnu: vishnu
visible: visible
visit: visit,visited,visits
vitals: vitals
vocal: vocal
vocation: vocation
voice: voice,voices
volley: volley
volubly: volubly
voluntary: voluntary
volunteer: volunteered,volunteers
vomit: vomited
voracious: voracious
vote: vote
voter: voters
voyage: voyage
wager: wager,wagers
waggon: waggons
waist: waist,waists
waistcoat: waistcoat
wait: wait,waited,waiting
waiter: waiters
waiting: waiting
wake: wake,waking,woke
walk: walk,walked,walking,walks
walking: walking
wall: wall,walls
wander: wander,wandered,wandering
wane: wane
war: war
wardrobe: wardrobe,wardrobes
warehouse: warehouse,warehouses
warlike: warlike
warm: warm,warmed
warmly: warmly
warmth: warmth
warn: warn,warned
warped: warped
warrant: warrant
wart: warts
wash: washed
watch: watch,watched,watches,watching
water: water,watered,waters
waterspout: waterspout
wave: wave,waves
waver: wavered
wax: wax
waylay: waylaid,waylay
wayne: wayne
wealth: wealth
wealthy: wealthy
weapon: weapon,weapons
wear: wear,wearing,wore,worn
wearisome: wearisome
weary: weary
weather: weather,weathered
weber: weber
wednesday: wednesday
week: week
weep: weeping,wept
weigh: weigh,weighed,weighing
weight: weight
weird: weird
west: west
western: western
westminster: westminster
westward: westward
wharf: wharf,wharves
wheat: wheat
wheel: wheel,wheeled,wheels
wheelbarrow: wheelbarrow
wheeled: wheeled
whereof: whereof
whereon: whereon
whimsical: whimsical
whirl: whirled,whirling
whirling: whirling
whisker: whiskers
whiskey: whiskey
whisper: whispered
whist: whist
whistle: whistle,whistled,whistles,whistling
white: white
whiteness: whiteness
whiz: whizzed
wholly: wholly
wicked: wicked
wide: wide
widow: widow
wife: wife,wives
wig: wig,wigs
wild: wild
william: william
willingly: willingly
willow: willows
wilson: wilson
win: win,winning
wind: wind,winding,winds,wound
windfall: windfalls
winding: windings
window: window,windows
wine: wine
wing: wings
wink: winking
winnings: winnings
winter: winter
wire: wire,wires
wise: wise
wit: wits
wolf: wolf,wolves
woman: woman,women
wonderful: wonderful
wood: wood,woods
wooden: wooden
word: word
workman: workmen
worm: worm,worms
worry: worries,worry,worrying
worship: worship,worshipped
wort: wort
worth: worth
worthy: worthy
wound: wound,wounded
wounded: wounded
wrap: wrapped
wrath: wrath
wreath: wreaths
wretch: wretch
wretched: wretched
wrinkle: wrinkled
write: written
writhe: writhing
wrong: wrong
wry: wry
wyoming: wyoming
xi: xi
xii: xii
xiii: xiii
xiv: xiv
xix: xix
xvi: xvi
xvii: xvii
xviii: xviii
xx: xx
xxi: xxi
xxii: xxii
xxiii: xxiii
xxiv: xxiv
xxv: xxv
xxx: xxx
yacht: yacht,yachts
yankee: yankee
yard: yard,yards
yearn: yearned
yellow: yellow
yellowish: yellowish
yesterday: yesterday
yield: yield,yielded,yielding
yoking: yoking
yokohama: yokohama
york: york
youth: youth
zeal: zeal
zebus: zebus
zenith: zenith
zephyr: zephyrs
zoroaster: zoroaster
