abide: abide
abolish: abolished
abortion: abortions
absence: absence
absent: absent
absolute: absolute
absolutely: absolutely
absoluteness: absoluteness
absolve: absolved
absorb: absorbed
abstract: abstract,abstracted
abstraction: abstraction,abstractions
absurd: absurd
absurdity: absurdities,absurdity
absurdum: absurdum
abundant: abundant
abuse: abuse,abused
accept: accept,accepted,accepting,accepts
acceptance: acceptance
access: access,accessed
accessible: accessible
accident: accident,accidents
accidental: accidental
accidentally: accidentally
accommodation: accommodation
accompany: accompanied,accompanies,accompanying
accomplish: accomplished,accomplishes
accord: accord,accords
accost: accosted
account: account
accurate: accurate
accurately: accurately
accuse: accuse
accustom: accustomed
accustomed: accustomed
ace: ace
achievement: achievement
acknowledge: acknowledge,acknowledged,acknowledges,acknowledging
acquaint: acquainted
acquaintance: acquaintance
acquainted: acquainted
acquiesce: acquiesce
acquire: acquire,acquired,acquiring
acre: acre,acres
action: action,actions
active: active
activity: activity
actual: actual
acuteness: acuteness
adapt: adapt,adapted
adaptation: adaptation
add: add,adding,adds
addition: addition,additions
additional: additional
address: address,addresses
adequate: adequate
adequately: adequately
adhere: adhere
adjust: adjusted
admiration: admiration
admission: admission,admissions
admit: admit,admits,admitted,admitting
admixture: admixture
adopt: adopt
advance: advance,advanced,advancing
advanced: advanced
advantage: advantage,advantages
adversary: adversaries,adversary
advise: advise,advised
advocate: advocate
affect: affect
affection: affection,affections
affidavit: affidavit
affinity: affinity
affirm: affirm,affirmed,affirming,affirms
afford: afford,afforded,affording,affords
aforesaid: aforesaid
afraid: afraid
afresh: afresh
age: age,ages
aged: aged
agency: agencies
agent: agent,agents
ages: ages
aggregate: aggregates
agora: agora
agree: agree,agreed,agreeing,agrees
agreement: agreement
aid: aid
aim: aim,aims
air: air
ak: ak
akin: akin
alas: alas
algebraical: algebraical
alien: alien
alike: alike
alive: alive
allay: allay
alliance: alliance
allude: alluding
allusion: allusion
ally: allied
almighty: almighty
aloof: aloof
aloud: aloud
alphabet: alphabet
alter: altered
alteration: alteration
alternate: alternate
alternately: alternately
alternative: alternative,alternatives
altogether: altogether
amass: amassed
amaze: amazes
amazed: amazed
ambiguity: ambiguity
ambiguous: ambiguous
ambitious: ambitious
ambush: ambush
amend: amend
amiable: amiable
amiss: amiss
amphitryon: amphitryon
amuse: amuses,amusing
analogous: analogous
analogy: analogies,analogy
analyse: analyse
analysis: analysis
analyze: analyze,analyzed,analyzes,analyzing
ancestor: ancestor,ancestors
ancient: ancient,ancients
anew: anew
angel: angels
angle: angle
angry: angry
anim: anim
animal: animal,animals
animalize: animalized
anoint: anointing
answer: answer,answered,answering,answers
antaeus: antaeus
antagonism: antagonism
antagonist: antagonist
antagonistic: antagonistic
antecedent: antecedent,antecedents
anticipation: anticipation
antiquity: antiquity
antithesis: antithesis
anxiety: anxiety
anxious: anxious
apace: apace
aperture: apertures
apologize: apologizing
apology: apology
apostle: apostles
apparatus: apparatus
apparent: apparent
appeal: appeal,appealed,appeals
appearance: appearance,appearances
append: appended
appendix: appendix
appetite: appetites
applicable: applicable
application: applications
apply: applied,applies,apply
apprehend: apprehend,apprehended,apprehending,apprehends
apprehension: apprehension
approach: approach,approached,approaches,approaching
appropriately: appropriately
approve: approve,approved
approximation: approximation
apt: apt
arbitrary: arbitrary
arche: arche
archer: archer
archive: archive
archon: archon
argue: argue,argued,argues,arguing
argument: argument,arguments
aright: aright
aristides: aristides
aristotelian: aristotelian
aristotle: aristotle
arithmetic: arithmetic
arithmetical: arithmetical
arithmetician: arithmetician
arm: arm,arms
armed: armed
army: army
arouse: arouse
arrange: arrange,arranged,arranges
arrangement: arrangement,arrangements
array: array
arrive: arrive,arrived,arriving
art: art,arts
artemis: artemis
articulate: articulate
ascend: ascending
ascertain: ascertain,ascertained
ascii: ascii
ascribe: ascribed,ascribes
ashamed: ashamed
asleep: asleep
aspect: aspect,aspects
aspiration: aspirations
aspire: aspires,aspiring
assault: assault
assembly: assembly
assent: assent,assenting
assert: assert,asserted,asserting
assertion: assertion
assign: assign,assigned,assigning
assignable: assignable
assimilation: assimilation
assist: assist,assisted,assists
assistance: assistance
association: association,associations
assume: assume,assumed,assumes,assuming
assurance: assurance
assure: assure,assured
assuredly: assuredly
astonishing: astonishing
astronomer: astronomer
astronomy: astronomy
athenian: athenian
athenians: athenians
athens: athens
atom: atoms
atomists: atomists
attach: attach,attached,attaches,attaching
attack: attack,attacking
attain: attain,attained,attaining,attains
attainment: attainment
attempt: attempt,attempted,attempting,attempts
attend: attend,attended,attending,attends
attention: attention
attraction: attraction,attractions
attractiveness: attractiveness
attribute: attribute,attributed,attributes
aught: aught
authenticity: authenticity
author: author,authors
authority: authority
authorship: authorship
auto: auto
aver: aver
aviary: aviaries,aviary
avoid: avoid
avow: avowed
awake: awake
awaken: awaken
awakening: awakening
aware: aware
awful: awful
awkward: awkward
awkwardness: awkwardness
awry: awry
axiom: axiom,axioms
axle: axle
aye: aye
baboon: baboon,baboons
bad: bad,worse
badly: badly
baffle: baffled
bag: bag
ball: ball
ballast: ballast
band: band
banish: banish
banquet: banquets
barbarian: barbarian,barbarians
bare: bare
barren: barren
base: base,based,basing
baseless: baseless
basis: bases,basis
battle: battle
bear: bear,bearing,bears,bore,born
beard: beards
bearded: bearded
bearing: bearing,bearings
beast: beast
beat: beaten
beautiful: beautiful
beauty: beauty
bed: bed
beg: beg,begs
beget: beget
beggarly: beggarly
begotten: begotten
behalf: behalf
behave: behaving
behaviour: behaviour
belief: belief
belong: belong,belonged,belonging,belongs
benighted: benighted
benjamin: benjamin
berkeley: berkeley
beset: beset
betray: betray,betrayed
bid: bade,bid,bidding,bids
bien: bien
binary: binary
bind: binds,bound
bird: bird,birds
birth: birth
bite: bite,biting
bitter: bitter
bitterness: bitterness
black: black
blame: blame,blaming
blend: blended
bless: blessed
blind: blind
blindness: blindness
block: block,blocks
blow: blowing
bluff: bluff
boast: boasts
bodily: bodily
body: bodies,body
bold: bold
bone: bones
book: book,books
bosom: bosoms
bound: bound
boundless: boundless
box: box
boy: boy,boys
brain: brain
brainless: brainless
branch: branch,branches
brat: brats
brave: brave
bravely: bravely
breach: breach
break: break,breaking,broken
breath: breath
breathless: breathless
breed: breeding
brethren: brethren
brick: brick
bright: brightest
bring: bring,bringing,brings,brought
broken: broken
brood: brood
brother: brothers
brotherhood: brotherhood
brute: brutes
build: build
building: building
bulk: bulk
burden: burden,burdens
burly: burly
burst: bursting
bury: buried
business: business
busy: busy
cage: cage,caged
calculate: calculate,calculated
calculation: calculation
calculator: calculator
calm: calm
calmly: calmly
camp: camp
capable: capable
capacity: capacity
capital: capital
capricious: capricious
captandum: captandum
captious: captious
capture: capture,captured
card: card
care: care,cared,caring
careful: careful
carpentering: carpentering
carry: carried,carries,carry,carrying
cast: cast
castigation: castigation
casual: casual
catalogue: catalogue
catch: catch,catches,catching,caught
category: categories,category
cattle: cattle
cease: cease,ceased,ceases
celerity: celerity
censure: censure
centre: centre,centres
century: centuries,century
certainty: certainty
chain: chain,chained
challenge: challenge,challenged
champion: champions
chance: chance
change: change,changed,changing
channel: channel
chaos: chaos
character: character,characters
characterise: characterise
characteristic: characteristic,characteristics
charge: charge,charged,charges,charging
charitable: charitable
charity: charities
charm: charmed
charming: charming
chase: chase
check: check,checks
cheer: cheer
chemical: chemical
chemistry: chemistry
chief: chief
chiefly: chiefly
child: child,children
childbirth: childbirth
childhood: childhood
childishly: childishly
china: china
choice: choice
choose: choose
christ: christ
christian: christian
chronology: chronology
cicero: cicero
circle: circle,circles
circuit: circuit
circumlocution: circumlocution
circumstance: circumstance,circumstances
cite: cite,cited,cites,citing
citizen: citizen
city: cities,city
civilised: civilised
civility: civilities
claim: claim,claiming,claims
class: class,classes
classification: classifications
clay: clay
clearing: clearing
clearness: clearness
cleft: cleft
clement: clements
clepsydra: clepsydra
clever: clever
cleverness: cleverness
cling: cling
cloak: cloak
close: close,closed,closes
closed: closed
closely: closely
closet: closet
closing: closing
clothe: clothed
clothes: clothes
club: clubs
coarse: coarse
coax: coax
cobbler: cobbler
cobbling: cobbling
cock: cock
code: codes
coeval: coeval
coexist: coexist
coexistent: coexistent
coherence: coherence
coincide: coincide,coincides,coinciding
coincident: coincident
coinciding: coinciding
cold: cold
collect: collect
collection: collection
collective: collective
colour: colour,coloured,colours
combatant: combatants
combination: combination,combinations
combine: combine,combined,combines,combining
comedy: comedy
command: command,commanded
commander: commanders
commencement: commencement
commend: commend,commends
commensurable: commensurable
commercial: commercial
commission: commission
commit: committed
common: common
commonly: commonly
commonplace: commonplaces
communicate: communicated,communicating
communication: communications
communion: communion
community: community
companion: companion,companions
companionship: companionship
company: company
compare: compare,compared,compares,comparing
comparison: comparison
compel: compel,compelled,compels
competitor: competitors
compilation: compilation
complacence: complacence
complain: complain,complained
complaint: complaint
complete: complete,completed
completeness: completeness
completion: completion
complex: complex
complexity: complexity
compliance: compliance
complicated: complicated
comply: comply,complying
compose: composed
composer: composer
composition: composition
compound: compound,compounded,compounds
comprehend: comprehend,comprehended
comprehensive: comprehensive
comprehensiveness: comprehensiveness
compress: compressed
comrade: comrade
conceal: conceal,concealed
concede: concedes
conceit: conceit
conceivable: conceivable
conceive: conceive,conceived,conceiving
concept: concept
conception: conception,conceptions
concern: concerned,concerns
concerned: concerned
conclude: concluded
conclusion: conclusion
concomitant: concomitant
concrete: concrete
condescend: condescends
condescending: condescending
condition: condition,conditions
conduce: conduces
conduct: conduct,conducted
confess: confess
confident: confident
confidently: confidently
confine: confined
confirm: confirm,confirmed
confirmation: confirmation
conflict: conflict
conform: conform
confound: confound,confounded
confuse: confuse,confused,confuses
confused: confused
confusing: confusing
confusion: confusion
congenial: congenial
congratulate: congratulated
conjecture: conjecture,conjectures
connatural: connatural
connect: connected
connected: connected
connection: connection
connexion: connexion
conscience: conscience
conscious: conscious
consciousness: consciousness
consent: consent,consents
consequence: consequence,consequences
consequential: consequential
considerable: considerable
consideration: consideration,considerations
consist: consist,consisting,consists
consistency: consistency
consistent: consistent
consistently: consistently
consonant: consonant
consort: consort
constant: constant
constitute: constituting
constitution: constitution
construct: constructed,constructing
construction: construction
contact: contact
contemplate: contemplate,contemplated,contemplates
contemplation: contemplation
contemporary: contemporaries
contempt: contempt
contemptuously: contemptuously
contend: contend,contends
content: content
contented: contented
contents: contents
contingent: contingent
continually: continually
continue: continue,continued,continues,continuing
continuity: continuity
continuous: continuous
continuously: continuously
contract: contract
contradict: contradicted,contradicting
contradiction: contradiction,contradictions
contradictory: contradictory
contrary: contrary
contrast: contrast,contrasted
contribute: contribute
contribution: contributions
control: control
controversial: controversial
controversy: controversies,controversy
convenience: convenience
convenient: convenient
conventional: conventional
conversant: conversant
conversation: conversation
converse: converse,conversing
convert: convert,converted
convey: convey
convict: convict
conviction: conviction
convince: convince,convinced
convinced: convinced
cook: cook
copying: copying
copyright: copyright
cord: cord
corinth: corinth
corinthian: corinthian
corner: corner
corporation: corporation
correct: correct,corrected,correcting
correction: corrections
correctly: correctly
correctness: correctness
correspond: correspond,corresponded
corrupt: corrupt
cosmogony: cosmogony
cost: cost,costs
council: council
counsellor: counsellor
count: count
counterfeit: counterfeits
country: countries,country
courage: courage
courageous: courageous
court: court,courts
cover: covered
cow: cow,cows
coward: cowards
cowherd: cowherd
craftsman: craftsmen
create: create,created,creating
creation: creation,creations
creature: creature,creatures
credit: credit
crime: crimes
criterion: criteria,criterion
critical: critical
criticism: criticism,criticisms
criticize: criticizing
crooked: crooked
crow: crow,crowing
crowded: crowded
crown: crowns
crowning: crowning
cube: cube
cultivate: cultivates
cunning: cunning
cure: cure,cured
current: current
cursory: cursory
curtain: curtain
custom: custom
customary: customary
cut: cut,cutting
cycle: cycle
cynic: cynic,cynics
cynics: cynics
damage: damage
damaged: damaged
damages: damages
danger: danger,dangers
dangerous: dangerous
dark: dark
darkness: darkness
darling: darling
dart: dart,darting
darts: darts
datum: data
david: david
dawn: dawning
day: day,days
daylight: daylight
dead: dead
deaf: deaf
deal: deal,dealing
death: death
decay: decaying
deceive: deceived
deceiver: deceiver
deception: deception
decide: decide,decided
decision: decision
declaim: declaim
declaration: declaration
declare: declare,declared,declares,declaring
decline: declined
decoy: decoy
decree: decrees
deductible: deductible
deed: deed,deeds
deem: deemed,deeming,deems
deep: deep,deeper,deepest
deepen: deepened
deeply: deeply
defeat: defeated
defect: defect,defects
defective: defective
defence: defence
defend: defend,defending
deficiency: deficiency
define: define,defined
definite: definite
definiteness: definiteness
definition: definition,definitions
degenerate: degenerate,degenerated,degenerating
degrade: degraded
degree: degree,degrees
deletion: deletions
delicate: delicate
delight: delight,delights
delighted: delighted
deliver: deliver,delivered,delivers
delivery: delivery
demand: demand
demonstration: demonstration
deny: denied,denies,deny,denying
depart: depart,departed
department: department
departure: departure
depend: depend,depends
dependent: dependent
depict: depicted
deposit: deposited
depression: depression
deprive: deprive,deprived,deprives,depriving
depth: depth
deride: derided
derivative: derivative
derive: derive,derived,derives
descend: descended
descent: descent
description: description,descriptions
desert: desert
deserve: deserve,deserves
design: design
designedly: designedly
desirable: desirable
desire: desire,desires
desirous: desirous
desist: desist
despair: despair
despise: despise,despised,despising
despondency: despondency
destiny: destiny
destroy: destroy,destroyed,destroys
destruction: destruction
destructive: destructive
detach: detach,detached
detailed: detailed
detain: detain,detained,detaining
detector: detector
determination: determination,determinations
determine: determine,determined,determines,determining
develop: developed
developement: developement
development: development
deviate: deviate
device: device
devise: devised
devoid: devoid
devote: devoted
diagram: diagrams
dialectic: dialectic
dialectical: dialectical
dialectician: dialectician
dialogue: dialogue,dialogues
dicast: dicasts
dicastery: dicastery
dice: dice
die: died,dying
difference: difference,differences
difficult: difficult
difficulty: difficulties,difficulty
digestion: digestion
dignified: dignified
digress: digressed,digressing
digression: digression,digressions
dilemma: dilemma
dim: dimmer
diminution: diminution
dimly: dimly
dinner: dinner
dire: dire
direct: direct,directing
direction: direction
director: director
disagree: disagree,disagreed
disappear: disappear,disappeared
disappoint: disappointed
disappointed: disappointed
disaster: disaster
discard: discard,discarded,discards
discern: discern,discerning,discerns
discerning: discerning
discernment: discernment
disciple: disciple,disciples
disclaim: disclaim,disclaims
disclaimer: disclaimer,disclaimers
discomfited: discomfited
disconnected: disconnected
discontented: discontented
discontinue: discontinue
discontinuity: discontinuity
discourage: discourage
discourse: discourse,discoursing
discover: discover,discovered,discovers
discoverer: discoverer
discovery: discoveries,discovery
discriminate: discriminating
discriminating: discriminating
discuss: discussed
discussion: discussion,discussions
disdain: disdain,disdaining
disease: disease,diseases
disengage: disengage,disengaged
disgrace: disgrace
disgraceful: disgraceful
disguise: disguise,disguises
disgust: disgusts
dishearten: disheartened
dishonesty: dishonesty
disinclined: disinclined
disjointed: disjointed
disk: disk
dislike: dislike
dismay: dismayed
disobey: disobey
disorder: disorders
disordered: disordered
disorderly: disorderly
display: display,displayed,displaying
dispose: disposed
disposed: disposed
disprove: disprove,disproved
disputant: disputant
disputation: disputation
dispute: dispute,disputed,disputing
disputer: disputer,disputers
dissatisfied: dissatisfied
dissemble: dissemble
distance: distance
distant: distant
distinct: distinct
distinction: distinction,distinctions
distinctly: distinctly
distinctness: distinctness
distinguish: distinguish,distinguished,distinguishes,distinguishing
distinguishable: distinguishable
distinguished: distinguished
distinguishing: distinguishing
distorted: distorted
distressed: distressed
distribute: distribute,distributed,distributing
distribution: distribution
distributor: distributor
disturb: disturbed,disturbing
diverge: diverges
diverse: diverse
diversion: diversion
diversity: diversity
divert: diverted
divest: divested
divide: divide,divided
divine: divine,divines
division: division,divisions
divorce: divorced
dizzy: dizzied
doctrine: doctrine,doctrines
doer: doer,doers
dog: dog
domain: domain
dominion: dominion
donate: donate
donation: donation,donations
donkey: donkey
donor: donors
door: door,doors
double: double
doubt: doubt,doubted,doubts
doubtless: doubtless
dove: dove,doves
download: downloading
downright: downright
doxa: doxa
drag: drag,dragged,dragging
dramatic: dramatic
draught: draught
draw: draw,drawing,drawn,draws
dream: dream,dreaming,dreams
dreamer: dreamers
drift: drift,drifted
drink: drink
drive: drive,driven,driving
drop: dropped
drown: drown
drug: drugs
dry: dried,dry
dryness: dryness
dull: dull
dulness: dulness
duly: duly
dumb: dumb
dung: dung
duration: duration
dusky: dusky
duty: duty
dwell: dwell,dwelling
dysentery: dysentery
eager: eager
eagerness: eagerness
ear: ear,ears
earnest: earnest
earth: earth
earthly: earthly
easily: easily
east: east
easy: easier,easy
eat: eat
eccentric: eccentric
ecclesia: ecclesia
echo: echo
edifice: edifice
edition: edition,editions
educate: educated
educated: educated
education: education
educational: educational
educator: educator
efface: effaced
effort: effort,efforts
egg: egg,eggs
eighteenth: eighteenth
elder: elders
eleatic: eleatic
elect: elect
electronic: electronic
electronically: electronically
element: element,elements
elementary: elementary
elevate: elevated
elevation: elevation
elicit: elicit,elicited
email: email
embody: embodied
embryo: embryo
embryology: embryology
eminence: eminence
eminent: eminent
emotion: emotion
emphasis: emphasis
employ: employ,employed,employs
employee: employee,employees
employment: employments
empyrean: empyrean
enable: enable,enabled,enables
enact: enacted,enacts
enclosure: enclosure
encode: encoding
encounter: encounter
encourage: encourage,encouraged
endeavour: endeavour,endeavoured,endeavouring
endless: endless
endowment: endowments
endue: endued
endure: endure
enemy: enemy
energetic: energetic
energy: energy
enforce: enforcing
engage: engaged
engaged: engaged
engagement: engagement
english: english
enjoy: enjoy
enlarge: enlarged,enlarges
enlighten: enlightened
enlightened: enlightened
enlightenment: enlightenment
enormous: enormous
enquire: enquire,enquiring
enquiry: enquiry
enslave: enslaved
ensue: ensues
ensure: ensuring
entangle: entangles
entanglement: entanglements
enter: enter,entered,entering
entertain: entertain
enthusiasm: enthusiasm
enthusiast: enthusiasts
enthusiastic: enthusiastic
entire: entire
entirety: entirety
entitle: entitled
entitled: entitled
entity: entity
entreat: entreated
enumerate: enumerate,enumerated
enumeration: enumeration
environment: environment
envy: envy
ephesian: ephesian
ephesians: ephesians
epicurean: epicurean
epicureans: epicureans
episode: episode
equal: equal
equality: equality
equally: equally
equanimity: equanimity
equilateral: equilateral
equipment: equipment
equivalent: equivalent
ergon: ergon
erineum: erineum
eristic: eristic,eristics
eristics: eristics
err: err
erroneous: erroneous
error: error,errors
escape: escape,escaped,escaping
essay: essay
esse: esse
essence: essence
essential: essential
essentially: essentially
est: est
establish: establish,established
esteem: esteems
eternally: eternally
eternity: eternity
ethic: ethics
ethical: ethical
ethics: ethics
etymology: etymologies
euclid: euclid
eulogize: eulogized
eulogy: eulogy
euripides: euripides
europe: europe
evanescent: evanescent
event: event,events
evidence: evidence
evident: evident
evil: evil,evils
evils: evils
exact: exact,exacting
exactness: exactness
exaggerate: exaggerated,exaggerating
examination: examination
examine: examine,examined,examining
exceed: exceeding
exceedingly: exceedingly
excel: excel,excelled
excellent: excellent
excellently: excellently
exception: exception
exceptional: exceptional
excess: excess
exchange: exchange
excite: excited
exclude: exclude,excluded
exclusion: exclusion
exclusive: exclusive
excuse: excuse,excused
executive: executive
exempt: exempt
exercise: exercise,exercised,exercises
exert: exerted
exertion: exertion
exhibit: exhibit,exhibits
exhortation: exhortation
exist: exist,existing,exists
existence: existence
existent: existent
expatiate: expatiate
expect: expect,expected,expecting
expectation: expectation,expectations
expediency: expediency
expedient: expedient
expend: expend
expense: expense,expenses
experience: experience,experienced,experiences,experiencing
experienced: experienced
experiment: experiment
explain: explain,explained,explaining,explains
explanation: explanation,explanations
explicit: explicit
export: exporting
expose: expose,exposed
expound: expounding
express: express,expressed,expresses,expressing
expressible: expressible
expression: expression,expressions
expressive: expressive
expressly: expressly
exquisitely: exquisitely
extend: extend,extended
extension: extension
extent: extent
external: external
extract: extract,extracted
extreme: extreme,extremes
eye: eye,eyes
fable: fable
facility: facility
factor: factor,factors
faculty: faculties,faculty
fade: fades,fading
fail: fail,fails
failure: failure
faint: faint
fair: fair
fairbanks: fairbanks
fairness: fairness
faith: faith
fall: fall,fallen,falling,fell
fallacy: fallacies,fallacy
fallibility: fallibility
falls: falls
false: false
falsehood: falsehood
falsely: falsely
familiar: familiar
familiarize: familiarized
family: family
famous: famous
fanatic: fanatics
fancy: fancied,fancies,fancy,fancying
fangled: fangled
fashion: fashion
fast: fast
fatal: fatal
father: father
fault: fault,faults
favour: favour
favourable: favourable
favourite: favourite
fawn: fawning
fear: fear,fearing,fears
fearful: fearful
feast: feast
feature: features
federal: federal
fee: fee,fees
feeble: feeble,feebler
feebly: feebly
feel: feel,feeling,feels
feeling: feeling,feelings
fellow: fellow,fellows
female: female
fertile: fertile
fertility: fertility
festive: festive
fever: fever
fiction: fiction
field: field
fiftieth: fiftieth
fight: fight,fighting
figment: figment
figure: figure,figures
file: file,files
final: final
finally: finally
financial: financial
finding: finding
fine: fine
finely: finely
finish: finish,finished
firm: firm,firmer
fit: fit,fits
fitness: fitness
fixed: fixed
fixedness: fixedness
flash: flash
flat: flat,flatter
flattery: flatteries,flattery
flavour: flavouring
flaw: flaw
fleeting: fleetings
flock: flock,flocking,flocks
flood: flood
flow: flow,flowing,flows
flower: flower
fluctuation: fluctuation
flux: flux
fly: fly,flying
follow: follow
follower: follower,followers
folly: folly
fond: fond,fonder
food: food
fool: fools
foolish: foolish
foolishly: foolishly
foot: feet,foot
forbid: forbidden
forbidden: forbidden
force: force,forcing
foreign: foreign
foreigner: foreigners
foresee: foresee,foreseeing
forest: forest
forethought: forethought
forget: forget,forgets,forgetting,forgot,forgotten
form: form,formed,forms
format: format,formats
formation: formation
formless: formless
formula: formulas
fortune: fortune
foundation: foundation,foundations
founder: founder
fourth: fourth
fourthly: fourthly
fragment: fragment,fragments
frame: frame,framed
framework: framework
frankness: frankness
fray: fray
freedom: freedom
freely: freely
freeman: freeman
frequency: frequency
frequently: frequently
fresh: fresh
friction: friction
friend: friend,friends
friendly: friendly
friendship: friendship
frightened: frightened
fro: fro
fruit: fruit,fruits
fulfil: fulfil,fulfilled
fun: fun
function: functions
furnish: furnish,furnished,furnishes
future: future
gain: gain,gained,gaining,gains
game: game
gar: gar
garment: garment
garrulity: garrulity
gather: gather,gathered,gathers
genealogist: genealogist
generalization: generalization
generalize: generalized
generate: generate,generated,generates
generation: generation,generations
generous: generous
genius: genius
gentle: gentle,gentler
gentleman: gentleman
gentleness: gentleness
genuine: genuine
genus: genus
geometrical: geometrical
geometrician: geometrician,geometricians
geometry: geometry
germ: germs
german: german
giant: giant,giants
giddy: giddy
gift: gift,gifts
glad: glad
glance: glance
glass: glass
gleam: gleam
glimpse: glimpse,glimpses
globus: globus
glorify: glorified
glorious: glorious
glory: glory
gloss: gloss
goal: goals
god: god,gods
goddess: goddess
godless: godless
gods: gods
golden: golden
goodwill: goodwill
govern: govern
government: government
grace: grace,graces
graceful: graceful
gracious: gracious
gradation: gradations
gradual: gradual
gradually: gradually
graduate: graduated
grammarian: grammarian,grammarians
grammatical: grammatical
grant: grant,granted
grasp: grasp,grasps
grateful: grateful
gratefully: gratefully
graven: graven
greatly: greatly
greece: greece
greek: greek,greeks
gregory: gregory
gritty: gritty
gross: gross
ground: ground
grounds: grounds
grovel: grovelling
grow: grow,growing,grown,grows
grower: grower
grown: grown
growth: growth
guarantee: guaranteed
guardian: guardian,guardians
guess: guess
guest: guest,guests
guide: guide
guilty: guilty
gulf: gulf
gymnasium: gymnasium
habit: habit,habits
habitation: habitation
hairy: hairy
hamper: hamper
hand: hand,handed,hands
handle: handled
handmaid: handmaid,handmaids
handmaiden: handmaidens
hang: hang,hanging
happen: happen,happened
happiness: happiness
happy: happy
harangue: harangue
harbour: harbour
hard: hard,harder
hardihood: hardihood
hardness: hardness
harm: harm
harmless: harmless
harmonious: harmonious
harmony: harmonies,harmony
harp: harp
hart: hart
hastily: hastily
hate: hate
hazard: hazard
head: head,heads
health: health
healthy: healthy
hear: hear,heard,hearing,hears
hearer: hearer,hearers
hearing: hearing
heart: heart
hearth: hearth
heat: heat
heaven: heaven
heavenly: heavenly
heavens: heavens
heavy: heavy
height: height
heir: heir
hellenes: hellenes
helpless: helpless
henceforward: henceforward
heraclitean: heraclitean
heracliteanism: heracliteanism
herculean: herculean
hercules: hercules
herd: herd
hereditary: hereditary
heredity: heredity
hero: hero,heroes
hesiodic: hesiodic
hesitate: hesitate,hesitating
heterodoxy: heterodoxy
hidden: hidden
hierophant: hierophants
highly: highly
hill: hills
hinder: hinder
hint: hint
hissing: hissing
historian: historian
historical: historical
history: histories,history
hit: hit
hitherto: hitherto
hold: held,hold,holding,holds
holder: holder
hole: holes
holiness: holiness
holy: holy
homer: homer
homeric: homeric
homo: homo
honesty: honesty
honey: honey
honour: honour,honours
honourable: honourable
hope: hope,hoped,hopes
hopelessly: hopelessly
horse: horse,horses
horseman: horsemen
hostage: hostages
hot: hot
hour: hour
house: house
hover: hover,hovering,hovers
human: human
humaner: humaner
humble: humble,humbler
hume: hume
humorous: humorous
humour: humour
hunt: hunt
hurry: hurry
husbandman: husbandmen
husbandmen: husbandmen
hymn: hymn
hypothesis: hypotheses,hypothesis
idea: idea,ideas
ideal: ideal,ideals
idealism: idealism
idealist: idealists
ideas: ideas
identical: identical
identification: identification
identify: identified,identifies,identify
identity: identity
idiot: idiot,idiots
idleness: idleness
idol: idol,idols
ignoramus: ignoramuses
ignorance: ignorance
ignorant: ignorant
ignorantly: ignorantly
iii: iii
illogical: illogical
illusion: illusion,illusions
illusive: illusive
illustrate: illustrate,illustrated,illustrating
illustration: illustration,illustrations
image: image,images
imaginary: imaginary
imagination: imagination
imagine: imagine,imagined
imaging: imaging
imbecility: imbecility
imitate: imitated
immeasurably: immeasurably
immense: immense
immortal: immortals
immortality: immortality
immovable: immovable
immutable: immutable
impair: impair,impairs
impart: impart,imparting
imparted: imparted
impede: impede
impenetrable: impenetrable
imperceptible: imperceptible
imperceptibly: imperceptibly
imperfect: imperfect
imperfection: imperfection
imperfectly: imperfectly
impiety: impiety
implant: implanted
implement: implements
imply: implied,implies,imply,implying
impose: imposed,imposes
imposing: imposing
impossibility: impossibilities,impossibility
impossible: impossible
impressed: impressed
impression: impression,impressions
imprint: imprinted
imprison: imprisoned
improve: improve,improved
improvement: improvement
impugn: impugn
impulse: impulse
impure: impure
impurity: impurity
imputation: imputation
inability: inability
inaccurate: inaccurate
inactivity: inactivity
inadequate: inadequate
inanimate: inanimate
inappropriate: inappropriate
inattention: inattention
incantation: incantations
incapable: incapable
inch: inches
incidental: incidental
incline: incline,inclined
inclined: inclined
include: include,included,includes,including
including: including
incommensurable: incommensurable
incomparable: incomparable
incomplete: incomplete
inconceivable: inconceivable
inconsistency: inconsistency
inconsistent: inconsistent
incorrectly: incorrectly
incorrectness: incorrectness
increase: increase,increased,increases,increasing
incredible: incredible
incur: incur
indefinable: indefinable
indefinite: indefinite
indemnify: indemnify
indemnity: indemnity
independence: independence
independent: independent
independently: independently
india: india
indication: indications
indictment: indictment
indifference: indifference
indifferent: indifferent
indifferently: indifferently
indignant: indignant
indirect: indirect
indirectly: indirectly
indispensable: indispensable
indistinct: indistinct
indistinctness: indistinctness
indistinguishable: indistinguishable
individual: individual,individuals
individualism: individualism
individuality: individuality
individually: individually
indivisible: indivisible
indolence: indolence
induce: induced
inductive: inductive
indulge: indulge,indulged
ineffectual: ineffectual
inevitable: inevitable
inevitably: inevitably
inexact: inexact
inexperience: inexperience
inexperienced: inexperienced
inexpressive: inexpressive
infancy: infancy
infant: infant
infatuation: infatuation
infect: infected
infer: infer,inferred
inference: inference,inferences
inferior: inferior
infinite: infinite
infinitesimal: infinitesimal
infinity: infinity
inflict: inflicted
influence: influence,influenced,influences
inform: informed,informing,informs
infringement: infringement
infuse: infuse
ingenious: ingenious
inherit: inherit,inherited
inheritance: inheritance
injustice: injustice
innocence: innocence
innocently: innocently
innumerable: innumerable
inquire: inquire
inquiry: inquiry
inseparable: inseparable
inseparably: inseparably
insert: inserted
insidious: insidious
insight: insight
insist: insist,insists
inspection: inspection
inspiration: inspiration
inspire: inspired,inspires
inspired: inspired
instance: instance,instances
instant: instant,instants
instigate: instigate
instinct: instincts
instinctively: instinctively
instruction: instruction
instructor: instructor
instrument: instrument,instruments
instrumentality: instrumentality
insult: insult
intellect: intellect,intellects
intellectual: intellectual
intelligence: intelligence
intelligent: intelligent
intelligible: intelligible
intend: intended,intending
intense: intense
intension: intension
intensity: intensity
intention: intention
intentionally: intentionally
intercept: intercepts
intercourse: intercourse
interfere: interfere
interior: interior
interlocutory: interlocutory
intermediate: intermediate
intermingle: intermingle,intermingled
intermittent: intermittent
internal: internal
international: international
interpenetrate: interpenetrate
interpose: interpose
interpret: interpret,interpreted
interpretation: interpretation
interpreter: interpreters
interrogate: interrogate,interrogated,interrogating
interrupt: interrupted
intersect: intersected
interval: interval,intervals
intervene: intervened
intimate: intimate
intolerable: intolerable
intoxication: intoxication
introd: introd
introduce: introduce,introduced,introduces
introduction: introduction
introductory: introductory
introspect: introspected,introspecting
intrude: intruding
intuition: intuition,intuitions
intuitive: intuitive
invalidity: invalidity
invent: invented,invents
inversion: inversion
invert: inverting
investigate: investigated,investigating
investigation: investigation,investigations
inveterate: inveterate
invincible: invincible
invisible: invisible
invite: invite,invites
involve: involve,involved,involves,involving
iris: iris
ironical: ironical
ironically: ironically
irony: irony
irrational: irrational
irregular: irregular
irresistible: irresistible
irs: irs
isolate: isolate,isolated
isolation: isolation
issue: issue
isthmus: isthmus
iv: iv
january: january
jest: jest
jesting: jesting
joint: joint
joke: joke
jolt: jolted
jostle: jostled
judge: judge,judged,judges,judging
judging: judging
judgment: judgment,judgments
juror: juror
justice: justice
justify: justified,justifies,justify
justly: justly
kai: kai
kant: kant
kantian: kantian
keen: keen
keener: keener
keeper: keeper
ker: ker
keros: keros
kindness: kindness
kindred: kindred
king: king,kings
knave: knave
knee: knees
knock: knocked,knocking
knowable: knowable
knowledge: knowledge
laboriously: laboriously
labour: labour,labours
lacedaemonian: lacedaemonian
laches: laches
lake: lake
land: landed
landing: landing
landscape: landscape
language: language
langue: langue
largeness: largeness
lasting: lasting
lastly: lastly
latent: latent
laugh: laugh,laughed,laughing,laughs
laughter: laughter
law: law,laws
lawful: lawful
lawyer: lawyer,lawyers
lay: laid,lay,laying
lead: lead,leading,leads,led
leader: leader,leaders
leading: leading
learn: learn,learned,learning,learns,learnt
learning: learning
leave: leave,leaves,leaving,left
left: left
legal: legal
legally: legally
legislation: legislation
leisure: leisure
letter: letter,letters
level: level
liability: liability
liable: liable
liberal: liberal
liberality: liberality
liberty: liberty
library: library
license: license
licensed: licensed
lie: lain,lie,lies,lying
lieu: lieu
life: life,lives
lifelong: lifelong
lift: lift
lifting: lifting
light: light,lighted,lights
lighten: lightening
lightly: lightly
likelihood: likelihoods
likeness: likeness
limit: limit,limited,limiting,limits
limitation: limitation,limitations
limited: limited
limits: limits
lineament: lineaments
linear: linear
link: link,linked,links
lip: lips
list: list
listen: listen,listening,listens
listener: listener
literary: literary
literature: literature
live: live,lived,living
lively: lively
living: living
local: local
locate: located
location: locations
logic: logic
logical: logical
logo: logos
loose: loose
lord: lords
lose: lose,loses,losing,lost
loss: loss
lot: lot
love: love
lover: lover
ludicrous: ludicrous
lyre: lyre
lysimachus: lysimachus
lysis: lysis
machine: machine
mad: mad
madman: madmen
madness: madness
magnificent: magnificent
magnitude: magnitude,magnitudes
maid: maid,maids
maiden: maidens
main: main
maintain: maintain,maintained,maintaining,maintains
maintainer: maintainers
majority: majority
maker: makers
male: male
manhood: manhood
manifest: manifest,manifesting,manifests
mankind: mankind
manner: manner
mannered: mannered
mark: mark,marked,marks
marked: marked
marry: marry,marrying
martyr: martyrs
marvel: marvel
marvellous: marvellous
marvellously: marvellously
mask: mask
mass: mass
master: master,masters
match: match
matchmaker: matchmaker,matchmakers
material: material,materials
materialism: materialism
materialist: materialist,materialists
materialistic: materialistic
materialists: materialists
materializing: materializing
mathematical: mathematical
mathematician: mathematician
mathematics: mathematics
matter: matter,matters
maximum: maximum
meaning: meaning,meanings
measure: measure,measured,measures,measuring
measurement: measurement
mechanical: mechanical
mediaeval: mediaeval
mediate: mediates
medium: medium
meet: meet,meeting,met
meeting: meeting
megara: megara
megarian: megarian
memorabilia: memorabilia
memorable: memorable
memorial: memorial
memory: memory
menial: menial
meno: meno
mental: mental
mention: mention,mentioned,mentioning,mentions
mercenary: mercenary
mercy: mercy
mere: mere
merge: merged
mesh: meshes
messenger: messenger
metaphorically: metaphorically
metaphysic: metaphysic
metaphysical: metaphysical
metaphysician: metaphysician,metaphysicians
metaphysics: metaphysics
method: method,methods
methought: methought
michael: michael
microscope: microscope
middle: middle
midst: midst
midwife: midwife,midwives
midwifery: midwifery
mighty: mighty
milk: milk,milking
mind: mind,minds
minute: minute,minutes
minutely: minutely
mirror: mirror
misery: misery
misplace: misplace,misplaces
misrepresent: misrepresented
missing: missing
mission: mission
mississippi: mississippi
misspell: misspelt
mist: mist
mistake: mistake,mistakes,mistook
mistaken: mistaken
mistaking: mistaking
misunderstand: misunderstood
mix: mixed
mixed: mixed
mixture: mixture
mock: mock
mockery: mockery
mode: mode,modes
model: model
modern: modern,moderns
modest: modest
modesty: modesty
modicum: modicum
modification: modification
modify: modified,modify
moist: moist,moister
moisten: moistened
mollusc: mollusc
moment: moment,moments
momentary: momentary
money: money
monster: monster
monstrous: monstrous
month: months
moral: moral
morning: morning
morrow: morrow
mortal: mortal,mortals
mother: mother
motion: motion,motions
motive: motive
mould: moulded,moulds
mountain: mountain,mountains
mouth: mouth
movement: movement,movements
muddy: muddy
muller: muller
multiply: multiplied,multiplying
multitude: multitude
multitudinous: multitudinous
muscle: muscles
muses: muses
music: music
musical: musical
musician: musician
mutual: mutual
mutually: mutually
myriad: myriads
mysterious: mysterious
mystery: mysteries,mystery
mystic: mystic
myth: myth
mythological: mythological
mythology: mythology
naked: naked
namesake: namesake
naming: naming
narrate: narrated,narrating
narrative: narrative
narrow: narrow,narrowed,narrower
nascent: nascent
nation: nations
natural: natural
naturally: naturally
nature: nature,natures
natured: natured
nearer: nearer
neatly: neatly
necessity: necessity
needlessly: needlessly
negation: negation
negative: negative
neglect: neglected
negligence: negligence
neighbour: neighbour
neighbourhood: neighbourhood
nerve: nerves
nervous: nervous
network: network
neutral: neutral
newly: newly
news: news
newsletter: newsletter
nice: nice
nicely: nicely
night: night
nineteenth: nineteenth
nobility: nobility
noble: noble,noblest
nobly: nobly
noise: noise,noises
noiseless: noiseless
nominalism: nominalism
nonproprietary: nonproprietary
nonsense: nonsense
north: north
nose: nose
notably: notably
note: note,notes
nothingness: nothingness
notice: notice,noticed,notices
noticeable: noticeable
notify: notifies
notion: notion,notions
nought: nought
noun: nouns
novelty: novelty
november: november
numbering: numbering
numerable: numerable
numerical: numerical
numerous: numerous
nun: nun
nurse: nurse
nurture: nurture
obedient: obedient
object: object,objects
objection: objection
objective: objective
obligation: obligation
oblige: obliged
oblong: oblong
obscure: obscured
observable: observable
observation: observation,observations
observe: observe,observed,observes
observer: observer
obsolete: obsolete
obstinate: obstinate
obvious: obvious
occasion: occasion
occasional: occasional
occasionally: occasionally
occupation: occupation
occupy: occupied,occupy
occur: occur,occurred,occurs
occurrence: occurrence
ocean: ocean
oceanus: oceanus
odd: odd
offence: offence
offend: offended
offer: offer,offered,offering,offers
offhand: offhand
office: office,offices
official: official
offspring: offspring
oil: oil
omission: omission
omit: omitting
oneself: oneself
online: online
openly: openly
operation: operation,operations
opine: opining
opinion: opinion,opinions
opponent: opponent,opponents
opportunity: opportunities,opportunity
oppose: oppose,opposed,opposing
opposition: opposition,oppositions
optical: optical
oracle: oracle,oracles
oral: oral
orator: orator,orators
orbit: orbits
ordinance: ordinances
ordinary: ordinary
organ: organ,organs
organic: organic
organically: organically
organize: organized
origin: origin
original: original
originally: originally
origination: origination
originator: originator
orphan: orphan,orphans
os: os
ousia: ousia
outdated: outdated
outer: outer
outline: outline,outlines
outrun: outrun
outset: outset
outward: outward
oven: oven
overflow: overflow
overleap: overleap
overpowering: overpowering
overthrow: overthrow,overthrown
overturn: overturning
overwhelming: overwhelming
owe: owe,owed
owner: owner
ox: ox
pack: packed,packing
pain: pain,pains
painter: painter
palaestra: palaestra
palestra: palestra
palmary: palmary
palpable: palpable
pang: pang,pangs
paper: paper
paperwork: paperwork
parable: parable
paradox: paradoxes
paradoxical: paradoxical
paragraph: paragraph,paragraphs
parallel: parallel
parallelism: parallelism
parent: parent,parents
partake: partake
partaking: partaking
partial: partial
partially: partially
particle: particle
particulars: particulars
partisan: partisans
partly: partly
party: parties,party
pass: pass,passed,passes,passing
passage: passage
passenger: passenger
passing: passing
passion: passion,passions
passive: passive
passivity: passivity
path: path
pathetic: pathetic
patience: patience
patient: patient,patients
patiently: patiently
patron: patron,patrons
pattern: pattern,patterns
pay: paid,pay,paying
payment: payments
peace: peace
peculiar: peculiar
peculiarity: peculiarities,peculiarity
peculium: peculium
pedantic: pedantic
pedigree: pedigree
pen: pen
penalty: penalty
penetrate: penetrate
perceive: perceive,perceived,perceives,perceiving
perceptible: perceptible
perception: perception,perceptions
perch: perched
perchance: perchance
percipi: percipi
percipient: percipient
perfect: perfect,perfected
perfection: perfection
perfectly: perfectly
perform: perform,performed,performing
performance: performances
peril: perils
period: period
periodic: periodic
permanent: permanent
permission: permission
permit: permitted
perpetual: perpetual
perpetually: perpetually
perplex: perplexed
perplexed: perplexed
perplexing: perplexing
perplexity: perplexities,perplexity
person: people,person,persons
personal: personal
personality: personality
personify: personified
persuade: persuade,persuaded,persuading
pervade: pervading
pervert: pervert,perverted
perverted: perverted
pestle: pestle
phaedo: phaedo
phase: phase,phases
phenomena: phenomena
phenomenon: phenomena,phenomenon
philosopher: philosopher,philosophers
philosophical: philosophical
philosophy: philosophies,philosophy
phrase: phrase,phrases
phraseology: phraseology
physical: physical
physician: physician,physicians
physics: physics
physiology: physiology
picture: picture,pictures
piece: piece,pieces
piety: piety
pig: pig,pigs
pigeon: pigeon
pint: pints
pitch: pitch
plain: plain,plainest
plane: plane
plank: planks
plant: plants
plato: plato
platonic: platonic
plausibility: plausibility
play: played,playing,plays
player: player,players
plea: pleas
pleasant: pleasant
pleased: pleased
pleasing: pleasing
pleasure: pleasure,pleasures
plenty: plenty
plural: plural
plurality: plurality
poem: poem,poems
poet: poet,poets
poetical: poetical
poetry: poetry
pole: pole,poles
polemical: polemical
political: political
politician: politicians
politics: politics
poor: poor
pop: pop
popular: popular
porch: porch
portion: portion
position: position
positive: positive
possess: possess,possessed,possesses,possessing
possession: possession
possibility: possibility
post: posted
postscript: postscript
pote: pote
potion: potions
potter: potters
pour: pour,pouring
poverty: poverty
power: power,powers
powerful: powerful
practical: practical
practically: practically
practice: practice
practise: practise,practised
praise: praise,praised,praises,praising
pray: pray
precarious: precarious
precede: preceded,preceding
precedent: precedent
precipice: precipice
precise: precise
precisely: precisely
precision: precision
preconcerted: preconcerted
predecessor: predecessor
predicament: predicament
predicate: predicate,predicated,predicating
predication: predication
prediction: predictions
predominate: predominate
preface: preface,prefaces
prefer: prefer,preferred,prefers
pregnancy: pregnancy
pregnant: pregnant
prejudice: prejudices
premise: premises
preparation: preparation
prepare: prepare
prescribed: prescribed
presently: presently
preserve: preserve,preserved,preserves
preside: presiding
press: press
presumption: presumption
presuppose: presupposing
pretence: pretence
pretend: pretend,pretended,pretending
pretension: pretensions
pretty: pretty
prevail: prevail,prevailed,prevails
prevalent: prevalent
prevent: prevent
previous: previous
pride: pride
primeval: primeval
primitive: primitive
prince: prince
principal: principal
principle: principle,principles
print: print,printed
prior: prior
priori: priori
private: private
privately: privately
privilege: privilege
probability: probabilities,probability
probable: probable
proceed: proceed,proceeding,proceeds
proceeding: proceeding
proceeds: proceeds
process: process,processes
processing: processing
procuress: procuresses
produce: produce,produced,produces,producing
production: production
profess: profess,professed,professes,professing
profession: profession
professional: professional
professor: professor
profit: profit,profits
profoundly: profoundly
profusion: profusion
progenitor: progenitors
progeny: progeny
progress: progress
progressive: progressive
prohibition: prohibition
project: project,projecting
prominent: prominent
prominently: prominently
promise: promise
promising: promising
promote: promoting
promotion: promotion
prone: prone
pronounce: pronounced
proof: proof,proofs
proofread: proofread
propaedeutic: propaedeutic
proper: proper
properly: properly
property: properties,property
prophecy: prophecy
prophesy: prophesied
prophet: prophet
propitious: propitious
proportion: proportion,proportions
proposal: proposal
propose: propose,proposes,proposing
proposition: proposition,propositions
proprietary: proprietary
proprietor: proprietors
prospect: prospect
protagorean: protagorean
protect: protect
protest: protests
prove: prove,proved,proven,proving
proverbial: proverbial
provide: provide,providing
provision: provision,provisions
psychological: psychological
psychology: psychology
public: public
pugnacious: pugnacious
pull: pull
punishment: punishment
punitive: punitive
pupil: pupil,pupils
pure: pure,purest
purely: purely
purity: purity
purport: purport
purpose: purpose
pursue: pursue,pursued,pursuing
pursuit: pursuit,pursuits
push: pushed
pythagorean: pythagorean
quale: quale
qualitative: qualitative
quality: qualities,quality
quantitative: quantitative
quantity: quantity
quarrel: quarrel
question: question,questions
questioner: questioner
quibble: quibble,quibbles
quick: quick,quicker
quickness: quickness
quiescent: quiescent
quietly: quietly
quintessence: quintessence
quit: quit
quiver: quiver
quod: quod
race: race
rage: raging
raise: raise,raised
range: range
rapid: rapid
rapidly: rapidly
rarefy: rarefied
rarely: rarely
rasa: rasa
rashness: rashness
rate: rate
rational: rational
rationale: rationale
rationalize: rationalized
ray: rays
reach: reach,reached,reaches,reaching
reaction: reactions
read: read,reading,reads
readable: readable
reader: readers
readiness: readiness
reading: reading
ready: ready
real: real
realise: realised
reality: realities,reality
realization: realization
realize: realized
reanimate: reanimating
reap: reap
reappear: reappear,reappearing,reappears
rear: reared,rearing
reason: reason,reasoned,reasons
reasonable: reasonable
reasoner: reasoner
reasoning: reasoning,reasonings
reassemble: reassemble
rebel: rebelled
rebuke: rebuked
recall: recall,recalled,recalling,recalls
recapitulate: recapitulating
receipt: receipt
receive: receive,received,receives,receiving
receptacle: receptacle
recipient: recipient
recite: recited
reckon: reckon
recognise: recognised
recognition: recognition
recognize: recognize,recognized,recognizes
recollect: recollect,recollecting
recollection: recollection,recollections
recommend: recommend
reconcilable: reconcilable
reconsider: reconsider
reconstruct: reconstruct,reconstructed
record: recorded
recover: recover
recur: recurring,recurs
recurrence: recurrence
redistribute: redistribute,redistributing
redistributing: redistributing
redistribution: redistribution
reduce: reduce,reduced
reductio: reductio
refer: refer,refers
reference: reference,references
refined: refined
reflect: reflect,reflecting,reflects
reflection: reflection,reflections
reformation: reformation
refund: refund
refusal: refusal
refuse: refuse
refutation: refutation
refute: refute,refuted,refuting
regard: regard,regarded
region: region
register: registered
regular: regular
regulate: regulating
rehabilitate: rehabilitate
reinforce: reinforce,reinforcing
reject: rejected,rejecting,rejects
rejoin: rejoins
rejoinder: rejoinders
relate: relate,relating
relater: relater
relation: relation,relations
relationship: relationship
relative: relative
relativeness: relativeness
relativity: relativity
release: release,released,releasing
relief: relief
religion: religion,religions
religious: religious
relinquish: relinquished
reluctant: reluctant
remain: remain,remained,remaining,remains
remainder: remainder
remains: remains
remark: remark,remarked,remarking,remarks
remarkable: remarkable
remarkably: remarkably
remedial: remedial
remedy: remedies
remember: remember,remembered,remembering,remembers
remind: reminded,reminding,reminds
reminiscence: reminiscence
remove: remove,removed
rename: renamed
render: render,renders
renew: renewed
renovate: renovated
repeat: repeat,repeated,repeating,repeats
repetition: repetition
replace: replace
replacement: replacement
reply: replies,reply,replying
report: report,reported,reports
repose: reposing
represent: represent,represented,represents
representation: representation,representations
reproach: reproach,reproached,reproaches
reproof: reproof
republic: republic
repulse: repulse
reputation: reputation
request: request
require: require,required,requires
requirement: requirement,requirements
rescue: rescue
resemblance: resemblance,resemblances
resemble: resemble
reside: resides,residing
residence: residence
resist: resist
resolution: resolution
resolvable: resolvable
resolve: resolve,resolved
resort: resorted
respect: respect,respecting
respectable: respectable
respects: respects
respondent: respondent
responsibility: responsibility
responsible: responsible
rest: rest,rests
restlessness: restlessness
restore: restored
restriction: restrictions
result: result
resume: resume,resumed,resumes,resuming
retain: retain
retaliation: retaliation
retentive: retentive
retentiveness: retentiveness
retina: retina
retire: retires
retirement: retirement
retort: retort
retrace: retracing
retract: retract
retreat: retreat
return: return,returned,returning,returns
reunite: reunites
reveal: reveal,revealed
revel: revels
reveller: revellers
revenge: revenge
revenue: revenue
reverence: reverence,reverencing
reverse: reverse,reversed
review: review,reviewing
revile: reviled
revisit: revisiting
revive: revives
revolution: revolution
revolve: revolve
reward: rewarded
rhetoric: rhetoric
rhetorician: rhetorician,rhetoricians
rich: rich
richly: richly
rid: rid,ridding
ridicule: ridicule
ridiculous: ridiculous
ridiculously: ridiculously
righteous: righteous
righteousness: righteousness
rightly: rightly
rim: rims
ripen: ripens
rise: rise,rises,rising
river: river
robbery: robbery
rock: rocks
rogue: rogue
roguery: roguery
roll: roll
root: rooted,roots
rotatory: rotatory
rough: rough
royal: royal
royalty: royalties,royalty
rub: rubbed
rudeness: rudeness
rudimentary: rudimentary
rugged: rugged
rule: rule,ruled,rules
ruler: rulers
runner: runner
sacred: sacred
safe: safe
safely: safely
sage: sage,sages
sailor: sailor
sake: sake
saline: saline
salt: salt
salvation: salvation
sameness: sameness
satirical: satirical
satisfaction: satisfaction
satisfactorily: satisfactorily
satisfactory: satisfactory
satisfied: satisfied
satisfy: satisfy
sauce: sauce
savage: savage
save: saves
sayer: sayer
scale: scale
scandal: scandals
scarcely: scarcely
scatter: scattered
scene: scene
scent: scent
sceptic: sceptic
sceptical: sceptical
scepticism: scepticism
scheme: scheme
school: school
science: science,sciences
sciences: sciences
scientific: scientific
scoff: scoff
sea: sea
seal: seal,seals
search: search,searching
seat: seated
secret: secret
sect: sect
secularize: secularized
secure: secure
seed: seed,seeds
seek: seek,seeking,seeks,sought
select: selected
semper: semper
send: send,sending
sensation: sensation,sensations
sensational: sensational
sensationalism: sensationalism
sense: sense
senseless: senseless
sensibly: sensibly
sensual: sensual
sensuality: sensuality
sensuous: sensuous
sentence: sentence
sentiment: sentiment,sentiments
separable: separable
separate: separate,separated,separates
separately: separately
separation: separation
series: series
seriousness: seriousness
servant: servant,servants
service: service
serviceable: serviceable
set: set,sets,setting
settle: settled
seventeen: seventeen
severe: severer
severely: severely
severity: severity
shade: shade
shades: shades
shadow: shadow
shadowy: shadowy
shaggy: shaggy
shake: shake,shaken
shallow: shallow
sham: sham,shams
shame: shame
shameless: shameless
shamelessly: shamelessly
share: share,shared,shares,sharing
sharp: sharp
sheep: sheep
sheepishness: sheepishness
sheer: sheer
shepherd: shepherd
shifting: shifting
shine: shine
ship: ships
shoe: shoe,shoes
shoemaking: shoemaking
shoot: shoot
short: short
shortly: shortly
shrewd: shrewd
shrine: shrine
shut: shut,shuts,shutting
shy: shy
sibilant: sibilant
sick: sick
sickness: sickness
sight: sight,sighted,sights
sign: sign,signs
signification: signification
silence: silence
silent: silent
silently: silently
silenus: silenus
similarity: similarities,similarity
similitude: similitude
simple: simple,simples,simplest
simplest: simplest
simpleton: simpleton
simplicity: simplicity
simply: simply
simultaneous: simultaneous
simultaneously: simultaneously
sincerity: sincerity
sing: sing,sings
singing: singing
single: single
singly: singly
singular: singular
singularity: singularity
sink: sink,sinks,sunk
sir: sir
sit: sit,sitting
situation: situation
size: size,sizes
skill: skill
slatternly: slatternly
slave: slave,slaves
sleep: sleep,sleeping
slight: slight,slightest
slippery: slippery
slough: slough
slow: slow,slower
slowly: slowly
smartly: smartly
smell: smell,smelling
smooth: smooth
smoothly: smoothly
smother: smother
snub: snub
soar: soar
sober: soberer
sociable: sociable
social: social
society: societies,society
socrates: socrates
socratic: socratic
soft: soft
softness: softness
soil: soil,soils
sole: sole
solemn: solemn
solicit: solicit
solicitation: solicitation
solid: solid,solids
solidification: solidification
solidity: solidity
solitary: solitary
solution: solution
solve: solve,solving
son: son
sooner: sooner
soothe: soothe
soph: soph
sophist: sophist
sophistical: sophistical
sophists: sophists
sorely: sorely
sort: sort,sorts
soul: soul,souls
sound: sound,sounds
soundness: soundness
source: source
space: space
spare: spared
spark: spark
sparring: sparring
spartan: spartan
speak: speak,speaking,speaks,spoke,spoken
speaker: speaker,speakers
speaking: speaking
special: special
specially: specially
specific: specific
specimen: specimens
specious: specious
spectator: spectator,spectators
speculation: speculation,speculations
speculative: speculative
speech: speech
speedily: speedily
spell: spell
spend: spent
sphere: sphere
spirit: spirit,spirits
spiritual: spiritual
spite: spite
spoil: spoiled
spontaneity: spontaneity
spontaneous: spontaneous
sport: sport
spot: spot
spread: spread
spring: sprang,spring,springing
spurious: spurious
square: square,squares
squeeze: squeeze,squeezes
stadium: stadium
staff: staff
stage: stage,stages
stake: stake
stammer: stammering
stamp: stamp,stamping
stand: stand,standing,stands,stood
standard: standard
star: stars
starry: starry
start: start
starting: starting
statement: statement,statements
statesman: statesman
stationary: stationary
status: status
stay: stay,stayed
steady: steadier
step: step,steps
stick: stick
stiff: stiff
stiffness: stiffness
stifle: stifle,stifled
stillness: stillness
stimulus: stimulus
stir: stirring
stock: stock
stoic: stoics
stolid: stolid
stone: stone
store: store,stored
storm: storm
story: story
stoutly: stoutly
straight: straight
strain: strain,straining
strait: strait
strange: strange,strangest
strangely: strangely
stranger: stranger
stream: stream,streams
strength: strength
strengthen: strengthen
stress: stress
strict: strict
strictly: strictly
stride: strides
strife: strife
strike: struck
striking: striking
string: string
strip: strip,stripped
stripe: stripes
strong: strong,stronger,strongest
structure: structure
student: student,students
study: studied,studies,study,studying
stuff: stuff
stumble: stumble,stumbling
stunt: stunted
stupid: stupid
stupidity: stupidity
style: style
subject: subject,subjected,subjects
subjective: subjective
subscribe: subscribe
subsequent: subsequent
substance: substance,substances
substitute: substitute,substituted
subtle: subtle
subtlety: subtlety
subtraction: subtraction
succeed: succeed,succeeded,succeeds
success: success
succession: succession
successive: successive
successively: successively
successor: successor,successors
sudden: sudden
suddenly: suddenly
sue: sue
suffer: suffer,suffering
suffering: suffering,sufferings
suffice: suffices
sufficient: sufficient
sufficing: sufficing
suffrage: suffrages
suggestion: suggestion
suicidal: suicidal
suit: suit,suiting
suitable: suitable
sum: sum,summed
summon: summon
sun: sun
superb: superb
superficial: superficial
superfluity: superfluity
superior: superior
supernatural: supernatural
supersede: supersede
supervise: supervise
supple: supple
supplement: supplements
supply: supplied,supplies,supply
support: support,supports
suppose: suppose,supposed,supposes,supposing
supposition: supposition
surely: surely
surface: surface
surprise: surprised
surround: surrounded,surrounding,surrounds
survey: survey,surveyed,surveying
survive: survive,survived
suspect: suspect,suspected
suspicion: suspicion
sustain: sustained
swamp: swamp
swarm: swarming
swear: swear
sweet: sweet
sweetness: sweetness
swift: swift,swifter
swim: swims
swine: swine
swineherd: swineherd
syllable: syllable,syllables
symbol: symbol,symbols
sympathy: sympathy
symposium: symposium
symptom: symptoms
synonymous: synonymous
synthesis: synthesis
synthetical: synthetical
ta: ta
tablet: tablet
tabula: tabula
tadpole: tadpole,tadpoles
tale: tale
talent: talent
talk: talk,talking,talks
tall: tall,taller
task: task
taste: taste
tax: tax,taxes
teach: taught,teach,teaches
teacher: teacher,teachers
teaching: teaching
technical: technical
tedious: tedious
telescope: telescope
temper: temper,tempered,tempers
temperance: temperance
tempt: tempted
tend: tend,tending
tendency: tendencies,tendency
tenderness: tenderness
tenet: tenets
term: term,termed,terms
testimony: testimony
tethys: tethys
theat: theat
theology: theology
theory: theories,theory
theseus: theseus
thesis: thesis
thinker: thinker,thinkers
thinking: thinking
thirdly: thirdly
thither: thither
thoroughbred: thoroughbred
thracian: thracian
threaten: threatens
threshold: threshold
throw: threw,throw,throwing,thrown,throws
thrust: thrust
thy: thy
ti: ti
tie: tied
timaeus: timaeus
time: time,times
timidity: timidity
tired: tired
tiresome: tiresome
tissue: tissues
title: title
ton: ton
tongue: tongue
topic: topic,topics
totality: totality
touch: touch,touches,touching
trace: trace,traced,traces,tracing
track: track
tractable: tractable
trademark: trademark
tradition: tradition
tragedy: tragedy
trail: trail
train: train,trained
training: training
trait: traits
trample: trample,trampled
transcribe: transcribe
transcription: transcription
transfer: transfer,transferred,transfers
transference: transference
transform: transform,transforming
transition: transition
translate: translated
transmit: transmit,transmitted,transmitting
transplacement: transplacement
transpose: transpose
trap: trap
travail: travail
travel: travel
traveller: travellers
treacherous: treacherous
treat: treat,treated,treats
treatment: treatment
tree: tree
trial: trial
trice: trice
trifle: trifle,trifling
trilogy: trilogy
trip: trip,tripping,trips
triumph: triumph
trivial: trivial
trojan: trojan
trouble: trouble,troubles
troublesome: troublesome
truant: truant,truants
true: true,truer,truest
truism: truism,truisms
trust: trust
trustee: trustees
trustworthy: trustworthy
truth: truth,truths
tumble: tumbling
tune: tuned
twist: twist,twists
type: type,types
tyrant: tyrant
ubique: ubique
ugly: ugly
ultimately: ultimately
umbilical: umbilical
unable: unable
unaccompanied: unaccompanied
unacquainted: unacquainted
unanalyzed: unanalyzed
unanswerable: unanswerable
unanswered: unanswered
unassailable: unassailable
unbidden: unbidden
unbounded: unbounded
uncertain: uncertain
uncertainty: uncertainty
unchangeable: unchangeable
unchanged: unchanged
uncompounded: uncompounded
unconnected: unconnected
unconscious: unconscious
unconsciously: unconsciously
unconvinced: unconvinced
uncouth: uncouth
undefined: undefined
undergo: undergoes
underground: underground
understand: understand,understanding,understood
understanding: understanding,understandings
undertake: undertake
undoubtedly: undoubtedly
unearth: unearth
uneducated: uneducated
unenforceability: unenforceability
unequal: unequal
unerring: unerring
unexamined: unexamined
unfairly: unfairly
unfairness: unfairness
unfinished: unfinished
unfold: unfold
unfortunate: unfortunate
unfrequently: unfrequently
ungainly: ungainly
unholy: unholy
uniform: uniform
uninformed: uninformed
uninitiated: uninitiated
unintelligible: unintelligible
unintentionally: unintentionally
union: union,unions
unit: unit,units
unite: united,uniting
united: united
unity: unity
universal: universal,universals
universality: universality
universe: universe
unjust: unjust
unknown: unknown,unknowns
unlawful: unlawful
unlikeness: unlikeness
unlimited: unlimited
unlink: unlink
unlock: unlocks
unmeaning: unmeaning
unmistakably: unmistakably
unmoved: unmoved
unnoted: unnoted
unpleasant: unpleasant
unpretentious: unpretentious
unravel: unravel
unreal: unreal
unresisting: unresisting
unrighteous: unrighteous
unrivalled: unrivalled
unsatisfactory: unsatisfactory
unscientific: unscientific
unseen: unseen
unsettled: unsettled
unsolicited: unsolicited
untenable: untenable
untrained: untrained
untrue: untrue
untutored: untutored
unused: unused
unverified: unverified
unwilling: unwilling
unwittingly: unwittingly
unworthy: unworthy
update: updated
upholder: upholders
upper: upper
uprightness: uprightness
upside: upside
urge: urge,urged,urging
useless: useless
user: user
usher: ushers
ut: ut
utilitarian: utilitarian
utmost: utmost
utter: utter,uttered,uttering,utters
utterance: utterance
utterly: utterly
vacancy: vacancy
vacant: vacant
vacuum: vacuum
vague: vague
vain: vain
vainly: vainly
valiant: valiant
valorous: valorous
vanilla: vanilla
vanity: vanity
variance: variance
variation: variation,variations
variety: varieties,variety
variously: variously
vary: vary,varying
veil: veil,veiled
venerable: venerable
venture: venture
verb: verb,verbs
verbal: verbal
verification: verification
verify: verified,verify
vernacular: vernacular
verse: verse
version: version
vestige: vestiges
vice: vice
victim: victim,victims
victory: victory
view: view,viewed,viewing,views
vine: vine
vinegrower: vinegrower
vintage: vintage
violate: violates,violating
violence: violence
violent: violent
virtue: virtue,virtues
virus: virus
vision: vision,visions
visit: visit
visitor: visitors
visual: visual
voice: voice
void: void
volition: volition
volunteer: volunteer,volunteers
votary: votary
vote: votes
vowel: vowel,vowels
voyage: voyage
vulgar: vulgar
waggon: waggon
wait: wait
wake: wake,waking
walk: walk,walks
wall: wall
wander: wander,wandering,wanders
war: war,warred
warm: warm
warmth: warmth
warped: warped
warranty: warranties,warranty
warrior: warriors
waste: waste,wasting
watch: watch
water: water
wave: wave
waver: wavered
wax: wax
waxen: waxen
wayward: wayward
weak: weak,weaker
wealth: wealth
wealthy: wealthy
wear: wear
weary: weary
weave: weave
week: weeks
weight: weight
west: west
western: western
whatsoever: whatsoever
wheel: wheels
wherefore: wherefore
white: white
whiteness: whiteness
wholly: wholly
wicked: wicked
wide: wide,wider,widest
wife: wives
wild: wild
win: win
wind: wind
window: window,windows
wine: wine
wing: wings
wipe: wiped
wisdom: wisdom
wise: wise,wiser,wisest
wit: wit,wits
withdraw: withdraw,withdrawn,withdraws
witness: witness,witnesses
witted: witted
witty: witty
woman: woman,women
womb: womb
wonderful: wonderful
wonderfully: wonderfully
wood: wood
wooden: wooden
word: word
worker: workers
workings: workings
workman: workman
worship: worship
worth: worth
worthy: worthy
wound: wounded
wrack: wrack
wrestler: wrestlers
wretch: wretch
wretched: wretched
write: write,writes,writing,written,wrote
writer: writer,writers
writing: writing
writings: writings
wrong: wrong
yoke: yoke
youth: youth
youthful: youthful
zeal: zeal
zealous: zealous
