abandon: abandoned
abate: abate,abated,abates
abhor: abhor
abhorrence: abhorrence
abide: abide,abiding
ability: ability
abject: abject
abnegation: abnegation
abnormal: abnormal
abode: abode
abolish: abolished,abolishes
abolition: abolition
abominable: abominable
abominate: abominate,abominates
aborigine: aborigines
abound: abound,abounds
absence: absence
absolute: absolute
absolutely: absolutely
absolution: absolution
absorb: absorb,absorbed,absorbs
abstain: abstain,abstained,abstains
abstainer: abstainer
abstinence: abstinence
abstract: abstract,abstracted,abstracts
abstraction: abstraction,abstractions
absurd: absurd
absurdity: absurdities,absurdity
absurdum: absurdum
abundance: abundance
abundantly: abundantly
abuse: abuse,abusing
academic: academic
accent: accent
accept: accept,accepted,accepting
acceptance: acceptance
access: access,accessed
accessible: accessible
accessory: accessory
accident: accident,accidents
accidental: accidental
accommodate: accommodate,accommodated
accommodation: accommodation,accommodations
accompaniment: accompaniment,accompaniments
accompany: accompanied,accompanies,accompany,accompanying
accomplish: accomplish,accomplished,accomplishing
accomplished: accomplished
accomplishment: accomplishments
accord: accord,accords
account: account,accounted
accrue: accruing
accumulate: accumulate,accumulating
accumulation: accumulation,accumulations
accuracy: accuracy
accurate: accurate
accursed: accursed
accusation: accusation,accusations
accuse: accuse,accused
accuser: accuser
accustom: accustomed,accustoming
accustomed: accustomed
achieve: achieved
achilles: achilles
acknowledge: acknowledge,acknowledged,acknowledges,acknowledging
acorn: acorns
acquaint: acquainted
acquaintance: acquaintance,acquaintances
acquiesce: acquiesced,acquiesces,acquiescing
acquire: acquire,acquired,acquiring
acquirement: acquirement
acquisition: acquisition
acquit: acquit,acquitted
acropolis: acropolis
action: action,actions
active: active
actor: actor,actors
actual: actual
actuate: actuated
acute: acute
adamant: adamant
adamantine: adamantine
adapt: adapt,adapted,adapts
adaptation: adaptation,adaptations
add: add,adding,adds
addition: addition,additions
additional: additional
address: address,addressed,addresses
adequate: adequate
adequately: adequately
adhere: adhere
adherent: adherents
adjust: adjusted,adjusts
administer: administer,administered
administration: administration
admirable: admirable
admiration: admiration
admire: admire,admired,admiring
admirer: admirer,admirers
admission: admission,admissions
admit: admit,admits,admitted,admitting
admixture: admixture
admonition: admonition,admonitions
ado: ado
adopt: adopt,adopting
adulation: adulation
adulteration: adulteration
adultery: adultery
advance: advance,advances,advancing
advanced: advanced
advantage: advantage,advantages
advantageous: advantageous
adversary: adversaries,adversary
adverse: adverse
advice: advice
advise: advise,advised,advises,advising
adviser: advisers
advocate: advocate
aeschylus: aeschylus
aesculapius: aesculapius
aesop: aesop
affair: affair,affairs
affect: affect
affectation: affectation
affection: affection,affections
affectionate: affectionate
affinity: affinities,affinity
affirm: affirm,affirmed,affirming,affirms
afflict: afflicted
affliction: affliction
afford: afford,afforded,affording,affords
aforesaid: aforesaid
afraid: afraid
afterthought: afterthought
agamemnon: agamemnon
age: age,ages
aged: aged
agency: agencies
agent: agent,agents
ages: ages
aggravated: aggravated
aggression: aggression
aggressive: aggressive
agility: agility
agony: agony
agora: agora
agree: agree,agreed,agreeing,agrees
agreeable: agreeable
agreeably: agreeably
agreement: agreement,agreements
agricultural: agricultural
agriculture: agriculture
aid: aid,aided,aids
ailment: ailment
aim: aim,aiming,aims
air: air,airs
airy: airy
ajax: ajax
akin: akin
alarm: alarms
alas: alas
alcibiades: alcibiades
alexandria: alexandria
algebraic: algebraic
alien: alien
alight: alighted
alike: alike
alive: alive
allay: allayed
allege: alleged
allegorical: allegorical
allegory: allegories,allegory
alleviation: alleviation
alliance: alliance,alliances
allot: allotted
allowable: allowable
allowance: allowance
alloy: alloy,alloyed
allude: allude,alluded,alludes,alluding
allurement: allurements
allusion: allusion,allusions
ally: allied,allies,ally
alms: alms
aloft: aloft
aloud: aloud
alpha: alpha
alphabet: alphabet
altar: altar
alter: alter,altered,altering
alteration: alteration
altered: altered
alternate: alternate,alternated,alternating
alternative: alternative,alternatives
altogether: altogether
amateur: amateurs
amatory: amatory
amazed: amazed
amazement: amazement
amazing: amazing
ambassador: ambassadors
ambiguity: ambiguities,ambiguity
ambiguous: ambiguous
ambition: ambition
ambitious: ambitious
amelioration: amelioration
amenable: amenable
amenity: amenities
america: america
american: american
amorous: amorous
amplification: amplifications
amply: amply
amulet: amulet
amuse: amused
amused: amused
amusement: amusement,amusements
amusing: amusing
anachronism: anachronisms
analogous: analogous
analogy: analogies,analogy
analyse: analyse,analysed
analysis: analyses,analysis
analytical: analytical
analyze: analyzed
anapaestic: anapaestic
anarchy: anarchy
ancestor: ancestor,ancestors
ancestral: ancestral
ancient: ancient,ancients
andromache: andromache
anew: anew
angel: angels
anger: anger
angle: angles
angled: angled
angry: angry
animal: animal,animals
animalism: animalism
animate: animate,animated
animation: animation
annihilate: annihilates
annihilation: annihilation
anno: anno
annoyed: annoyed
annual: annual
anoint: anointed
anomaly: anomaly
anon: anon
answer: answer,answered,answering,answers
answering: answering
antagonism: antagonism
antagonist: antagonist,antagonists
antagonistic: antagonistic
antecedent: antecedent,antecedents
anthropology: anthropology
anticipate: anticipate,anticipated,anticipates,anticipating
anticipation: anticipation,anticipations
antidote: antidote
antigone: antigone
antiquarian: antiquarian
antique: antique
antiquity: antiquity
antithesis: antithesis
antwerp: antwerp
anxiety: anxiety
anxious: anxious
anxiously: anxiously
aphoristic: aphoristic
aphrodite: aphrodite
apollo: apollo
apologist: apologist
apology: apology
apostles: apostles
appalling: appalling
apparatus: apparatus
apparel: apparel
apparent: apparent
apparition: apparition,apparitions
appeal: appeal,appealed,appealing,appeals
appearance: appearance,appearances
appease: appeased
append: append,appended
appetite: appetite,appetites
appetitive: appetitive
applaud: applaud,applauded
applause: applause,applauses
applicable: applicable
application: application,applications
apply: applied,applies,apply,applying
appoint: appoint,appointed,appointing
appointed: appointed
appointment: appointment
apportion: apportion
appose: apposing
appreciation: appreciation
apprehend: apprehend,apprehended,apprehending,apprehends
apprehension: apprehension
apprentice: apprentice,apprentices
approach: approach,approaches,approaching
appropriately: appropriately
approval: approval
approve: approve,approved,approves
approver: approver
approximation: approximation
appurtenance: appurtenances
apt: apt
aptitude: aptitude
arbitrarily: arbitrarily
arcadian: arcadian
archelaus: archelaus
archer: archer
architecture: architecture
archive: archive
archon: archon
arena: arena
ares: ares
argos: argos
argue: argue,argued,argues,arguing
argument: argument,arguments
argumentative: argumentative
aright: aright
arion: arion
arist: arist
aristocracy: aristocracies,aristocracy
aristocratic: aristocratic
aristocratical: aristocratical
aristotelian: aristotelian
aristotle: aristotle
arithmetic: arithmetic
arithmetical: arithmetical
arithmetician: arithmetician
arm: arm,armed,arms
armed: armed
armour: armour
army: armies,army
arouse: arouse,aroused,arousing
arrange: arrange,arranged,arranges,arranging
arrangement: arrangement,arrangements
arrant: arrant
array: array,arrayed
arrival: arrival
arrive: arrive,arrived,arrives,arriving
arrogance: arrogance
arrogant: arrogant
arrow: arrows
art: art,arts
artemis: artemis
arthur: arthur
article: article,articles
artificer: artificer,artificers
artificial: artificial
artificially: artificially
artisan: artisan,artisans
artist: artist,artists
artistic: artistic
ascend: ascend,ascended,ascending
ascendant: ascendant
ascent: ascent
ascertain: ascertain,ascertained,ascertaining
ascii: ascii
asclepius: asclepius
ascribe: ascribe,ascribed,ascribes,ascribing
ash: ashes
ashamed: ashamed
asia: asia
asleep: asleep
aspect: aspect,aspects
aspirant: aspirant
aspiration: aspiration,aspirations
aspire: aspire
ass: asses
assail: assailing,assails
assailant: assailant,assailants
assassinate: assassinate,assassinating
assassination: assassination
assault: assault
assemblage: assemblage
assemble: assembled
assembly: assemblies,assembly
assent: assent,assented
assert: assert,asserted,asserting,asserts
assertion: assertion
assign: assign,assigned,assigning,assigns
assimilate: assimilate,assimilated,assimilates,assimilating
assimilation: assimilation
assist: assist,assisted,assisting
assistance: assistance
associate: associate,associates
association: association,associations
assortment: assortment
assume: assume,assumed,assumes,assuming
assumption: assumption,assumptions
assurance: assurance
assure: assure,assured,assuring
assuredly: assuredly
assyria: assyria
assyrian: assyrian
asthmatic: asthmatic
astonish: astonished
astonished: astonished
astonishment: astonishment
astray: astray
astronomer: astronomer,astronomers
astronomical: astronomical
astronomy: astronomy
asunder: asunder
asylum: asylum
atalanta: atalanta
athenian: athenian
athenians: athenians
athens: athens
athlete: athlete,athletes
atlantis: atlantis
atmosphere: atmosphere
atone: atone,atoning
atonement: atonement,atonements
atreus: atreus
atropos: atropos
att: att
attach: attach,attached,attaching
attachment: attachment,attachments
attack: attack,attacked,attacks
attain: attain,attained,attaining,attains
attainable: attainable
attainder: attainder
attainment: attainment,attainments
attainted: attainted
attemper: attemper,attempers
attempt: attempt,attempted,attempting,attempts
attend: attend,attended,attending,attends
attendant: attendant,attendants
attention: attention
attic: attic
attire: attire
attitude: attitude
attract: attract,attracted,attracting,attracts
attracted: attracted
attraction: attraction,attractions
attractive: attractive
attribute: attribute,attributed,attributes,attributing
attribution: attribution
attune: attuning
audacious: audacious
audacity: audacity
audience: audience
audit: audit
auditor: auditors
aught: aught
augustine: augustine
auscultation: auscultation
auspices: auspices
author: author,authors
authorise: authorised
authoritative: authoritative
authority: authorities,authority
authorize: authorized
auxiliary: auxiliaries,auxiliary
avail: avail
avarice: avarice
avaricious: avaricious
aver: aver
average: average
averse: averse
aversion: aversion
avert: avert,averted
avesta: avesta
avoid: avoid,avoided
avoidance: avoidance
await: await,awaiting,awaits
awake: awake,awaking
awaken: awakened,awakens
awakening: awakening
aware: aware
awe: awe
awestricken: awestricken
awful: awful
awhile: awhile
axiom: axioms
axis: axis
aye: aye
background: background
backwardness: backwardness
bacon: bacon
bad: bad,worse,worst
badly: badly,worse
badness: badness
baking: baking
balance: balance,balanced,balances
balanced: balanced
bald: bald
balm: balm
band: band
baneful: baneful
banish: banish,banished,banishes,banishing
banishment: banishment
banquet: banquet
banter: banter
baptise: baptised
barbarian: barbarians
barbarism: barbarism
barbarous: barbarous
barber: barbers
bare: bare,barest
barefoot: barefoot
bark: bark
barley: barley
barren: barren
base: base,based,basest
baseness: baseness
baser: baser
basis: bases,basis
bask: bask
bass: bass
bastard: bastard,bastards
bat: bat,bats
bath: bath,baths
battle: battle,battles,battling
bazaar: bazaar
beak: beak
beam: beams
bean: beans
bear: bear,bearing,bears,bore,born,borne
bearer: bearer,bearers
bearing: bearing
beast: beast,beasts
beat: beat,beaten,beating,beats
beatific: beatific
beauteous: beauteous
beautiful: beautiful
beautify: beautify
beauty: beauties,beauty
bed: bed,beds
bee: bee,bees
beef: beef
befall: befall
beg: beg,begged,begging,begs
begat: begat
beget: beget,begetting,begotten
beggar: beggars
beggarly: beggarly
beggary: beggary
begging: begging
begone: begone
behalf: behalf
behave: behave
behaviour: behaviour
behest: behests
behold: beheld,behold,beholding,beholds
beholder: beholder
belief: belief,beliefs
believer: believer
bellow: bellowing
bellowing: bellowing
belong: belong,belonging,belongs
beloved: beloved
belt: belt
bema: bema
bend: bending
beneath: beneath
benefactor: benefactor,benefactors
beneficence: beneficence
beneficial: beneficial
benefit: benefit,benefited,benefiting,benefits
benevolence: benevolence
benjamin: benjamin
bent: bent
bequeath: bequeath,bequeaths
bequest: bequests
berkeley: berkeley
berry: berries
beseech: beseech,beseeching
beset: beset
besprinkle: besprinkled
bestow: bestow,bestowed
beta: beta
betray: betray,betrayed
beware: beware
bewilder: bewildered
bias: bias
bid: bade,bid,bidden,bidding,bids
bigness: bigness
bile: bile
binary: binary
bind: bind,binding,binds,bound
biographer: biographer
bird: bird,birds
birth: birth,births
bishop: bishop
bishopric: bishopric
bit: bit
bite: bite
bitter: bitter,bitterest
black: black
blacksmith: blacksmith,blacksmiths
blame: blame,blamed,blames,blaming
blameable: blameable
blameless: blameless
blank: blank
blasphemous: blasphemous
blasphemy: blasphemy
blaze: blazes,blazing
bleat: bleat
blemish: blemishes
blend: blend
bless: blessed
blessed: blessed
blessedness: blessedness
blessing: blessing,blessings
blest: blest
blind: blind
blindly: blindly
blindness: blindness
blink: blink,blinking,blinks
bliss: bliss
blood: blood
bloom: bloom,blooming,blooms
blow: blow,blows
blown: blown
blunt: blunted
blurred: blurred
blush: blush,blushing
blustering: blustering
boast: boast,boasting
boaster: boaster
boastful: boastful
boatswain: boatswains
bodily: bodily
body: bodies,body
boil: boil,boiled,boils
bold: bold,bolder
boldly: boldly
bond: bond,bonds
bondmen: bondmen
bone: bones
book: book,books
books: books
boon: boon
boorish: boorish
border: border,borders
borne: borne
borrow: borrow,borrowed,borrows
borrowing: borrowing
bosom: bosom
bound: bound,bounds
boundless: boundless
bow: bow,bowed
bowl: bowl
box: box,boxes
boxer: boxer,boxers
boxing: boxing
boy: boy,boys
brahmin: brahmins
branch: branch,branches
brass: brass
brave: brave,bravest
braver: braver
bravery: bravery
brazen: brazen
breach: breach
bread: bread
break: break,breaking,breaks,broke,broken
breaker: breaker
breast: breast
breath: breath
breathe: breathe
breathing: breathing
breed: bred,breed,breeding,breeds
breeder: breeder
breeding: breeding
breeze: breeze
brethren: brethren
bribe: bribe,bribed,bribes
bribery: bribery
brick: bricks
bride: bride,brides
bridegroom: bridegroom,bridegrooms
bridle: bridle
bright: bright,brighter,brightest
brightness: brightness
brilliant: brilliant
bring: bring,bringing,brings,brought
brink: brink
brittle: brittle
broad: broadest
broil: broils
broken: broken
brother: brother,brothers
brotherhood: brotherhood
browse: browse
bruise: bruised
brutal: brutal
brutality: brutality
brutalize: brutalized
brute: brute,brutes
buffoon: buffoon
buffoonery: buffoonery
build: build,building,builds,built
builder: builder,builders
building: building
bulk: bulk
bull: bulls
bulldog: bulldogs
bully: bullies
bunyan: bunyan
burden: burden
burglar: burglar,burglars
burial: burial
burke: burke
burn: burn,burned,burnt
burning: burning
burst: burst
bury: buried,bury
bushel: bushel
business: business
bustle: bustling
busy: busy
busybody: busybody
butchery: butchery
butt: butt
buyer: buyers
buying: buying
buzz: buzz,buzzing
bye: bye
cadmus: cadmus
caesar: caesar
caitiff: caitiff
cajole: cajole
cake: cakes
calamity: calamities,calamity
calculate: calculate,calculated,calculating
calculation: calculation
calendar: calendar
calling: calling,callings
calm: calm,calmer
cambridge: cambridge
camp: camp
campaign: campaign,campaigning
campanella: campanella
candle: candle
cap: caps
capable: capable
capacity: capacities,capacity
capital: capital
captain: captain
captivate: captivates,captivating
captive: captive,captives
capture: capture
card: card,carding
cardinal: cardinal
care: care,cares,caring
career: career
careful: careful
carefully: carefully
careless: careless
carelessly: carelessly
carelessness: carelessness
caricature: caricatured
carnivorous: carnivorous
carousal: carousals
carpenter: carpenter,carpenters
carpentering: carpentering
carry: carried,carries,carry,carrying
cart: carts
cask: casks
cast: cast,casting,casts
caste: caste
castle: castle,castles
casual: casual
casuistry: casuistry
catalogue: catalogue
catarrh: catarrh
catastrophe: catastrophe
catch: catch,catches,catching,caught
catholic: catholic
cattle: cattle
cautery: cautery
caution: caution
cautious: cautious
cave: cave,caves
cavern: cavern
cease: cease,ceased,ceases
ceaseless: ceaseless
ceiling: ceiling
celebrate: celebrate,celebrated,celebrating
cell: cells
censor: censors
censorship: censorship
censure: censure,censured,censures,censuring
centre: centre
century: centuries,century
cerberus: cerberus
ceremony: ceremonies,ceremony
certainty: certainties,certainty
certify: certifies
cessation: cessation
chafe: chafe,chafes
chain: chain,chained,chains
chair: chair,chairs
chalcedonian: chalcedonian
champion: champion
chance: chance,chanced,chances
change: change,changed,changing
channel: channel
chaos: chaos
chaotic: chaotic
chaplet: chaplets
chapter: chapter
character: character,characters
characteristic: characteristic,characteristics
characteristically: characteristically
characterize: characterize,characterized
charge: charge,charged,charges
chariot: chariot
charitable: charitable
charity: charities
charm: charm,charmed,charms
charmer: charmer
charming: charming
charmingly: charmingly
chase: chase,chased
chasm: chasm,chasms
chasten: chasten,chastened
chastise: chastise,chastises,chastising
chastity: chastity
cheat: cheat
check: check,checks
cheek: cheek
cheer: cheered
cheese: cheese
chemical: chemical
chemistry: chemistry
cherish: cherish,cherished,cherishes
cherisher: cherisher
chestnut: chestnuts
chief: chief,chiefest,chiefs
chiefly: chiefly
child: child,children
childhood: childhood
childish: childish
chimera: chimera
china: china
chine: chines
chirp: chirping
chisel: chisel
choice: choice,choices
choose: choose,chooses,choosing,chose,chosen
chooser: chooser
chord: chords
chorus: chorus,choruses
choruses: choruses
christ: christ
christendom: christendom
christian: christian,christians
christianity: christianity
chronique: chronique
chronological: chronological
chronology: chronology
church: church,churches
churlish: churlish
cicero: cicero
circle: circle,circles
circuit: circuit,circuits
circuitous: circuitous
circule: circule
circumcision: circumcision
circumference: circumference,circumferences
circumstance: circumstance,circumstanced,circumstances
circumvent: circumvent,circumventing
citadel: citadel
citation: citations
cite: citing
citizen: citizen,citizens
citizens: citizens
citizenship: citizenship
city: cities,city
civic: civic
civil: civil
civilisation: civilisation
civility: civilities,civility
civilization: civilization
civilize: civilize,civilizing
civilized: civilized
claim: claim,claimed,claiming,claims
clapping: clapping
class: class,classes
classic: classics
classical: classical
classification: classification
classify: classifying
clause: clause
clean: clean
clearing: clearing
clearness: clearness
clement: clement
clergy: clergy
clever: clever,cleverest
cleverly: cleverly
cleverness: cleverness
climate: climate
clime: clime
cling: cling,clinging,clings
cloak: cloak
close: close,closed
closely: closely
closing: closing
clothe: clothe,clothed
clothes: clothes
clothing: clothing
clotho: clotho
cloud: clouds
clouds: clouds
club: club,clubs
clue: clue
clumsiness: clumsiness
clumsy: clumsy
coarse: coarse,coarser
coarseness: coarseness
coat: coat,coats
cobble: cobbling
cobbler: cobbler,cobblers
cobbling: cobbling
cock: cock
cocytus: cocytus
coddling: coddling
code: codes
coerce: coerces
coextensive: coextensive
cognate: cognate
cognizable: cognizable
coin: coined
coincide: coincide,coincides
coincidence: coincidence,coincidences
cold: cold
coldly: coldly
colleague: colleagues
collect: collecting
collection: collection
collective: collective
collectively: collectively
college: colleges
collet: collet
collocation: collocation
colony: colonies
colour: colour,coloured,colours
colt: colts
column: column
combe: combe
combination: combination,combinations
combine: combine,combined,combines,combining
comedy: comedies,comedy
comeliness: comeliness
comely: comelier
comer: comer
comfort: comfort,comforts
comfortable: comfortable
comforter: comforter
comic: comic
coming: coming
command: command,commanded,commands
commander: commanders
commence: commence,commencing
commencement: commencement
commend: commend
commensurable: commensurable
commensurate: commensurate
commentator: commentators
commerce: commerce
commercial: commercial
commit: commit,committed,committing
commodity: commodities
common: common
commoner: commoner
commonly: commonly
commonplace: commonplace,commonplaces
commonwealth: commonwealth,commonwealths
commotion: commotion
communicate: communicate,communicated,communicates
communication: communication,communications
communion: communion
communism: communism
communist: communists
communistic: communistic
community: communities,community
compact: compact
companion: companion,companions
companionship: companionship
company: company
comparable: comparable
comparative: comparative
comparatively: comparatively
compare: compare,compared,compares,comparing
comparison: comparison,comparisons
compass: compass
compel: compel,compelled,compels
compelled: compelled
compelling: compelling
compensate: compensating
compete: compete
competition: competition
competitor: competitor
compilation: compilation
complain: complain,complaining
complainer: complainers
complaint: complaints
complete: complete,completed
completely: completely
completion: completion
complex: complex
complexion: complexion
complexity: complexity
compliance: compliance
complicate: complicating
complicated: complicated
complication: complications
compliment: compliment
comply: comply,complying
compose: compose,composed
composite: composite
composition: composition,compositions
compound: compound,compounded
comprehend: comprehend,comprehended,comprehending,comprehends
comprehension: comprehension
comprehensive: comprehensive
comprehensiveness: comprehensiveness
compress: compressed
compromise: compromise
compulsion: compulsion
compulsory: compulsory
compunction: compunction
computation: computation
comrade: comrade,comrades
concave: concave
conceal: conceal,concealed,conceals
concealment: concealment
concede: concede
conceit: conceit,conceits
conceited: conceited
conceivable: conceivable
conceive: conceive,conceived,conceives,conceiving
concentrate: concentrated
concentration: concentration
concept: concept
conception: conception,conceptions
concern: concern,concerned,concerns
concerned: concerned
concernment: concernment
conclude: conclude,concluded,concluding
conclusion: conclusion,conclusions
concord: concord
concrete: concrete
concupiscent: concupiscent
condemn: condemn,condemned,condemning
condemnation: condemnation
condense: condensed
condescend: condescend,condescends
condiment: condiments
condition: condition,conditions
conditional: conditional
conduce: conduce,conduces
conducive: conducive
conduct: conduct,conducted,conducting
conductor: conductor
confection: confections
confectionary: confectionary
confectioner: confectioners
confer: confer,conferring,confers
confess: confess
confession: confession
confide: confiding
confidence: confidence
confident: confident
confidently: confidently
confine: confine,confined
confines: confines
confirm: confirmed,confirms
confirmation: confirmation
confiscate: confiscate
confiscation: confiscation
conflict: conflict,conflicting,conflicts
conform: conform,conformed
conformity: conformity
confound: confound,confounded,confounding
confront: confronted
confuse: confuse,confused
confused: confused
confusion: confusion
congenial: congenial
congregate: congregate
conjecture: conjecture
conjoin: conjoined
conjugate: conjugates
conjure: conjure
conjuring: conjuring
connect: connect,connected,connecting,connects
connected: connected
connection: connection,connections
connexion: connexion
connoisseur: connoisseurs
connotation: connotation
conquer: conquer,conquered,conquering
conqueror: conqueror,conquerors
conquest: conquest,conquests
conscience: conscience
conscious: conscious
consciously: consciously
consciousness: consciousness
consecrate: consecrate,consecrated
consent: consent,consented
consequence: consequence,consequences
consequential: consequential
conservative: conservative
considerable: considerable
considerably: considerably
considerate: considerate
consideration: consideration,considerations
consist: consist,consisted,consisting,consists
consistency: consistency
consistent: consistent
consolation: consolation
console: consoled
consonance: consonances
consort: consort,consorts
consorted: consorted
conspicuous: conspicuous
conspiracy: conspiracy
conspire: conspire,conspired,conspiring
constancy: constancy
constant: constant
constantly: constantly
constitute: constitute,constituted,constitutes
constitution: constitution,constitutions
constitutional: constitutional
constrain: constrained,constraining
construct: construct,constructed,constructs
construction: construction,constructions
constructive: constructive
consult: consult,consulting
consume: consume
consummate: consummate
consummation: consummation
consumption: consumption
contact: contact
contamination: contamination
contemn: contemns
contemplate: contemplate,contemplated,contemplates,contemplating
contemplation: contemplation,contemplations
contemporary: contemporaries,contemporary
contempt: contempt
contemptible: contemptible
contemptuous: contemptuous
contend: contending,contends
content: content
contented: contented
contention: contention
contentious: contentious
contentiousness: contentiousness
contents: contents
contest: contest,contests
contingent: contingent
continually: continually
continuance: continuance
continuation: continuation
continue: continue,continued,continues,continuing
continuous: continuous
continuously: continuously
contra: contra
contract: contract,contracted,contracts
contractor: contractors
contradict: contradict,contradicted,contradicting
contradiction: contradiction,contradictions
contradictory: contradictory
contrary: contraries,contrary
contrast: contrast,contrasted,contrasting,contrasts
contribute: contribute,contributed,contributes
contribution: contribution,contributions
contrivance: contrivances
contrive: contrive,contriving
contrived: contrived
control: control,controlled,controls
controlling: controlling
controversial: controversial
controversy: controversy
convenance: convenance
convenience: convenience,conveniences
convenient: convenient
conveniently: conveniently
convent: convent
convention: convention
conventional: conventional
conversation: conversation
converse: converse,conversed,conversing
conversely: conversely
conversion: conversion
convert: convert,converted,converting,converts
convex: convex
convey: convey,conveyed,conveys
convict: convict
conviction: conviction,convictions
convince: convince,convinced,convincing
convinced: convinced
convincing: convincing
convivial: convivial
convulsion: convulsions
convulsively: convulsively
cook: cooks
cookery: cookery
coolness: coolness
cope: cope,coping
copper: copper
copying: copying
copyright: copyright
cordial: cordial
corinth: corinth
corinthian: corinthian
corn: corn
corner: corner,corners
corporate: corporate
corporation: corporation
corpse: corpse
correct: correct,corrected,correcting
correction: correction,corrections
corrective: corrective
correctly: correctly
correlation: correlation
correlative: correlative,correlatives
correspond: correspond,corresponded,corresponds
corrupt: corrupt,corrupted,corrupting,corrupts
corrupting: corrupting
corruption: corruption,corruptions
cost: cost,costs
costly: costly
couch: couches
cough: coughed
council: council
counsel: counsel,counsels
counselling: counselling
counsellor: counsellor,counsellors
count: count,counted,counting
counter: counters
counteract: counteracting
counterbalance: counterbalanced
counterpart: counterpart
countless: countless
country: countries,country
countryman: countrymen
courage: courage
courageous: courageous
courageously: courageously
coursing: coursing
court: court,courts
courteous: courteous
courtesan: courtesans
courtezan: courtezan
courtier: courtier
cousin: cousin
covenant: covenants
cover: cover,covered
covering: covering
covetous: covetous
covetousness: covetousness
coward: coward,cowards
cowardice: cowardice
cowardly: cowardly
cp: cp
craft: craft,crafts
craftsman: craftsmen
crafty: crafty
cram: cram
crave: crave
creak: creaking
create: create,created,creates,creating
creation: creation,creations
creative: creative
creator: creator
creature: creature,creatures
creches: creches
credibility: credibility
credible: credible
credit: credit
creditable: creditable
creed: creed
creep: creep,crept
crest: crest
cretan: cretan
crete: crete
cretic: cretic
crew: crew
crime: crime,crimes
criminal: criminal,criminals
crisis: crises,crisis
criterion: criterion
critic: critics
critical: critical
criticise: criticise,criticised
criticism: criticism,criticisms
cromwell: cromwell
cronus: cronus
crooked: crooked
crookedness: crookedness
cross: cross
crotchet: crotchets
crow: crow
crowd: crowd,crowded,crowding
crowded: crowded
crown: crown,crowned,crowns
crowning: crowning
croydon: croydon
crucify: crucified
crude: crude,crudest
cruel: cruel
cruelty: cruelty
crush: crushed
cube: cube,cubed,cubes,cubing
cubed: cubed
cubit: cubits
cultivate: cultivated,cultivates,cultivating
cultivation: cultivation
culture: culture
cunning: cunning
cup: cup,cups
cure: cure,cured,cures
curiosity: curiosity
curious: curious
curiously: curiously
current: current
curriculum: curriculum
currier: curriers
curse: curse,cursed
cursed: cursed
cursing: cursing
curtail: curtail
cushion: cushioned
custom: custom,customs
customary: customary
cut: cut,cutting
cutpurse: cutpurses
cycle: cycle,cycles
cyclical: cyclical
cylinder: cylinder
cynic: cynic
cynics: cynics
dactylic: dactylic
daedalus: daedalus
dagger: dagger
daily: daily
dainty: dainties,dainty
dally: dally
damage: damage,damaged
damaged: damaged
damages: damages
damaging: damaging
damnation: damnation
damon: damon
damsel: damsel
dance: dance,danced,dances
dancer: dancers
danger: danger,dangers
dangerous: dangerous
dante: dante
daring: daring
dark: dark,darker
darken: darkened
darkly: darkly
darkness: darkness
darter: darter
dash: dash
datum: data
daughter: daughter,daughters
david: david
dawn: dawn,dawned
day: day,days
daylight: daylight
dazzle: dazzled
dead: dead
deaf: deaf
deal: deal,dealing
dealing: dealing
dealings: dealings
death: death,deaths
debate: debated
debt: debt,debts
debtor: debtors
decay: decay
deceit: deceit
deceitful: deceitful
deceive: deceive,deceived,deceives,deceiving
deceiver: deceiver
decency: decency
deception: deception
decide: decide,decided,decides
decision: decision
decisive: decisive
deck: decked
declaration: declaration
declare: declare,declared,declares,declaring
decline: decline,declined,declines,declining
decomposition: decomposition
decrease: decreased,decreasing
dedicate: dedicate,dedicated
dedication: dedication
deductible: deductible
deduction: deduction
deed: deed,deeds
deem: deem,deemed,deeming,deems
deep: deep,deeper
deepen: deepen
deeply: deeply
defeat: defeat,defeated,defeats
defect: defect,defects
defective: defective
defence: defence
defend: defend,defending
defendant: defendant
defender: defenders
defer: defer,deferred
deficiency: deficiencies,deficiency
deficient: deficient
defile: defiled
define: define,defined,defines,defining
definite: definite
definiteness: definiteness
definition: definition,definitions
deform: deformed
deformity: deformity
defraud: defraud,defrauded
defy: defy
degeneracy: degeneracy
degenerate: degenerate,degenerated,degenerates
degradation: degradation
degrade: degrade,degraded
degraded: degraded
degrading: degrading
degree: degree,degrees
dei: dei
deify: deify
deign: deign
deity: deities,deity
delay: delayed
deletion: deletions
deliberate: deliberate
deliberately: deliberately
delicacy: delicacies,delicacy
delicate: delicate
delight: delight,delighted,delighting,delights
delighted: delighted
delightful: delightful
delineate: delineate,delineated
delineation: delineation
deliver: deliver,delivered,delivering
delphian: delphian
delude: deluded,deluding
deluge: deluge,deluged,deluges
delusion: delusion
demagogue: demagogues
demand: demand,demanded,demanding,demands
demigod: demigods
democracy: democracies,democracy
democrat: democrat,democrats
democratic: democratic
democratical: democratical
demolish: demolished
demonic: demonic
demonstrate: demonstrate,demonstrated
demonstration: demonstration
demonstrative: demonstrative
den: den
denaturalized: denaturalized
denial: denial
denote: denote,denoted
denounce: denounced,denounces
deny: denied,denies,deny,denying
depart: depart,departed,departing,departs
department: department,departments
departure: departure
depend: depend,depended,depends
dependent: dependent
depict: depict,depicted
deportment: deportment
deposit: deposit,deposited
depraved: depraved
depreciate: depreciate,depreciated,depreciates,depreciating
depress: depress
depressing: depressing
deprivation: deprivation
deprive: deprive,deprived,deprives,depriving
depth: depth
derange: deranged
deride: derided
derivative: derivative
derive: derive,derived,derives,deriving
descartes: descartes
descend: descend,descended,descending,descends
descendant: descendant,descendants
descent: descent
description: description,descriptions
descriptive: descriptive
desert: desert,deserted,deserting
deserted: deserted
deserter: deserters
deserve: deserve,deserved
deservedly: deservedly
deserving: deserving
desideratum: desideratum
design: design,designed,designs
designate: designate,designated,designates
designation: designation
desirable: desirable
desirableness: desirableness
desire: desire,desired,desires,desiring
desirous: desirous
desolate: desolate
despair: despair
despise: despise,despised,despises,despising
despiser: despiser
despoil: despoil,despoiled,despoiling
despotism: despotism
dessert: dessert
destination: destination
destine: destined
destiny: destinies,destiny
destitute: destitute
destroy: destroy,destroyed,destroying,destroys
destroyer: destroyers
destruction: destruction,destructions
destructive: destructive
detach: detach
detain: detain,detained,detaining
detect: detect,detected
detective: detective
deter: deterred
deteriorate: deteriorate,deteriorated,deteriorates
deterioration: deterioration
determination: determination
determine: determine,determined,determines,determining
determined: determined
detest: detest
detestable: detestable
detestation: detestation
detract: detract
detraction: detraction
devastate: devastate
devastation: devastation
develop: develop,developed,developing
develope: develope,developes
developed: developed
development: development,developments
deviation: deviation
device: device,devices
devilish: devilish
devise: devise,devised,devising
devoid: devoid
devote: devote,devoted,devotes
devoted: devoted
devotion: devotion
devour: devour
dexterity: dexterity
dialectic: dialectic
dialectical: dialectical
dialectician: dialectician
dialogue: dialogue,dialogues
diameter: diameter,diameters
diamond: diamonds
dicast: dicast
dice: dice
dictate: dictate
didymus: didymus
die: die,died,dies,dying
diet: diet
dietetics: dietetics
dieting: dieting
difference: difference,differences
difficult: difficult
difficultly: difficultly
difficulty: difficulties,difficulty
diffuse: diffused
dig: dig
digit: digits
dignity: dignities,dignity
digress: digressed
digression: digression,digressions
dilate: dilate
diligent: diligent
diligently: diligently
dim: dimmed,dimmer
dimension: dimension,dimensions
diminish: diminish,diminished,diminishing
dimly: dimly
din: dinning
dine: dine
diner: diner
dining: dining
dinner: dinners
dionysiac: dionysiac
dire: dire
direct: direct,directed,directs
direction: direction,directions
directness: directness
director: director
dirt: dirt
disabuse: disabused
disagree: disagree,disagreeing
disagreeable: disagreeable
disagreement: disagreement
disappear: disappear,disappeared
disappearance: disappearance
disappointed: disappointed
disappointing: disappointing
disappointment: disappointment
disapprover: disapprover
disarm: disarmed
disarrange: disarrange
disaster: disaster
disbelief: disbelief
disbelieve: disbelieve
discard: discard,discarded
discern: discern,discerned,discerning,discerns
discernible: discernible
discernment: discernment
disciple: disciple,disciples
discipline: discipline,disciplined
disclaim: disclaim
disclaimer: disclaimer,disclaimers
discompose: discomposed
discontent: discontent,discontents
discontented: discontented
discontinue: discontinue
discord: discord
discordant: discordant
discountenance: discountenanced
discouraging: discouraging
discourse: discourse,discoursed,discourses
discourtesy: discourtesy
discover: discover,discovered,discovering
discovery: discoveries,discovery
discredit: discredit
discreditable: discreditable
discrepancy: discrepancies
discretion: discretion
discuss: discuss,discussed,discussing
discussion: discussion,discussions
disdain: disdain
disease: disease,diseases
diseased: diseased
disenchant: disenchanted
disengage: disengaged,disengaging
disentangle: disentangle
disfigured: disfigured
disgrace: disgrace
disgraceful: disgraceful
disguise: disguise,disguised,disguises
disgusted: disgusted
dish: dish
dishonest: dishonest
dishonestly: dishonestly
dishonesty: dishonesty
dishonour: dishonour,dishonoured
dishonourable: dishonourable
dishonoured: dishonoured
disinclined: disinclined
disinterested: disinterested
disinterestedness: disinterestedness
disk: disk
dislike: dislike,disliked,dislikes
dismiss: dismissed
disobedience: disobedience
disobey: disobey,disobeying
disorder: disorder,disordered,disorders
disordered: disordered
disorderly: disorderly
disorganized: disorganized
disparate: disparate
dispel: dispelled
dispensation: dispensation
dispense: dispensed,dispensing
dispenser: dispenser
disperse: dispersed
display: display,displayed,displaying
displease: displease
disposal: disposal
dispose: disposed
disposed: disposed
disposition: disposition,dispositions
disproportion: disproportion
disproportionate: disproportionate
disproportionately: disproportionately
disprove: disprove,disproved
disproven: disproven
dispute: dispute,disputed,disputes,disputing
disqualify: disqualified
disregard: disregard,disregarded,disregarding
disrepute: disrepute
dissatisfaction: dissatisfaction,dissatisfactions
dissatisfied: dissatisfied
dissect: dissect
dissension: dissension
dissent: dissent
dissident: dissident
dissimilar: dissimilar
dissimilarity: dissimilarity
dissimilate: dissimilating
dissipation: dissipation
dissolute: dissolute
dissolution: dissolution
dissolve: dissolve,dissolved,dissolves
distaff: distaff
distance: distance,distances
distant: distant
distinct: distinct
distinction: distinction,distinctions
distinctive: distinctive
distinctly: distinctly
distinctness: distinctness
distinguish: distinguish,distinguished,distinguishes,distinguishing
distinguishable: distinguishable
distinguished: distinguished
distorted: distorted
distract: distracted,distracts
distracted: distracted
distracting: distracting
distraction: distraction,distractions
distress: distress
distribute: distribute,distributed,distributing
distribution: distribution
distributor: distributor
disturb: disturb
disturbance: disturbances
disturbing: disturbing
disuse: disuse
dithyramb: dithyramb
diver: divers
divergence: divergence
diverse: diverse
diversion: diversion
diversity: diversities,diversity
divert: divert,diverted
divest: divested
divide: divide,divided,divides,dividing
divided: divided
divination: divinations
divine: divine,diviner
divinely: divinely
diviner: diviner
divinity: divinity
division: division,divisions
divisor: divisors
doctor: doctor,doctors
doctoring: doctoring
doctrinaire: doctrinaire
doctrine: doctrine,doctrines
document: documents
doer: doer,doers
dog: dog,dogs
dogmatic: dogmatic
doings: doings
dolphin: dolphin
domain: domain
domestic: domestic
dominican: dominican
dominion: dominion
dominus: dominus
donate: donate
donation: donation,donations
donor: donors
doom: doom
door: door,doors
dorian: dorian
dormant: dormant
dose: dose
doth: doth
double: double,doubled,doubles
doubt: doubt,doubted,doubting,doubts
doubtless: doubtless
downfall: downfall
download: downloading
downright: downright
drag: drag,dragged,dragging
draggle: draggling
drama: drama,dramas
dramas: dramas
dramatic: dramatic
dramatize: dramatize
drapery: drapery
draught: draught,draughts
draw: draw,drawing,drawn,draws,drew
drawing: drawing
drawl: drawling
dread: dread,dreaded
dreadful: dreadful
dream: dream,dreamed,dreaming,dreams
dreamer: dreamer,dreamers
dregs: dregs
dress: dress,dresses,dressing
dresser: dresser
dressing: dressing
drink: drank,drink,drinking,drinks,drunk
drinker: drinker
drinking: drinking
drive: drive,driven,drives,driving
drivel: drivelling
dronage: dronage
drone: drone,drones
drop: drop,dropped,drops
dropping: dropping
dross: dross
drought: drought
drown: drown
drug: drug,drugs
drunk: drunk
drunkard: drunkards
drunken: drunken
drunkenness: drunkenness
dry: dried,dry,drying
dualism: dualism
dublin: dublin
dull: dull,duller
dullness: dullness
dulness: dulness
duly: duly
dumb: dumb
dunce: dunces
durance: durance
duration: duration
dust: dust
dusty: dusty
duty: duties,duty
dwell: dwell,dwelling,dwells,dwelt
dweller: dwellers
dwelling: dwelling,dwellings
dwindle: dwindle
dye: dye,dyed
dyeing: dyeing
dyer: dyers
dynamics: dynamics
dynasties: dynasties
eager: eager
eagerly: eagerly
eagerness: eagerness
eagle: eagle
ear: ear,ears
earnest: earnest
earnestly: earnestly
earnestness: earnestness
earth: earth
earthborn: earthborn
earthly: earthly
earthquake: earthquake,earthquakes
ease: ease
easily: easily
east: east
eastern: eastern
easy: easier,easiest,easy
eat: ate,eat,eaten,eating,eats
eater: eaters
eating: eating
eccentricity: eccentricity
ecclesiastic: ecclesiastic,ecclesiastics
ecclesiastical: ecclesiastical
echo: echo
ecliptic: ecliptic
economic: economic
economy: economies,economy
ecstasy: ecstasy
edge: edge,edges
edification: edification
edition: edition,editions
educate: educate,educated,educating
education: education,educations
educational: educational
educator: educator,educators
efface: effaced
effeminacy: effeminacy
effeminate: effeminate
efficient: efficient
effluence: effluence
effort: effort,efforts
egg: eggs
ego: ego
egotistical: egotistical
egypt: egypt
egyptian: egyptian,egyptians
eighth: eighth
elaborate: elaborated
elapse: elapsed
elastic: elastic
elasticity: elasticity
elder: elder,elders
eleatic: eleatic
elect: elect,elected
electronic: electronic
electronically: electronically
elegiac: elegiac
element: element,elements
elementary: elementary
elenchi: elenchi
eleusinian: eleusinian
elevate: elevate,elevated,elevating
elevation: elevation
elicit: elicit,elicited,elicits
eliminate: eliminate,eliminated
eliot: eliot
eloquent: eloquent
eloquently: eloquently
emaciated: emaciated
email: email
emancipate: emancipated
emancipation: emancipation
embassy: embassies,embassy
embellish: embellished
emblazon: emblazoned
embodiment: embodiment
embody: embodied,embodies
embrace: embrace,embraced,embraces,embracing
embroider: embroidered
embroiderer: embroiderer
embroidery: embroidery
embryo: embryo
emerge: emerge
emetic: emetic
emigration: emigration
eminent: eminent
emotion: emotion,emotions
emotional: emotional
emphatically: emphatically
empire: empire,empires
empiric: empirics
employ: employ,employed,employing,employs
employee: employee,employees
employment: employment,employments
emulate: emulating
emulous: emulous
enable: enable,enabled,enables
enact: enact,enacted,enacting
enactment: enactment,enactments
enamour: enamoured
encamp: encamp,encamped
enchant: enchant
enchanted: enchanted
enchanter: enchanter,enchanters
enchantment: enchantment,enchantments
enclose: enclosed
enclosure: enclosure
encode: encoding
encomium: encomiums
encourage: encourage,encouraged,encourages,encouraging
encouragement: encouragement
endanger: endanger
endear: endeared
endearment: endearment
endeavour: endeavour,endeavouring
endless: endless
endowment: endowments
endurable: endurable
endurance: endurance
endure: endure,endured,endures,enduring
enemy: enemies,enemy
energetically: energetically
energy: energies,energy
enervate: enervating
enervated: enervated
enfeeble: enfeebles,enfeebling
enforce: enforce,enforced
enforced: enforced
enfranchisement: enfranchisement
engage: engage,engaged,engaging
engender: engender,engendered
england: england
english: english
engrossing: engrossing
enigmatical: enigmatical
enjoin: enjoin,enjoins
enjoy: enjoy,enjoying,enjoys
enjoyment: enjoyment,enjoyments
enlarge: enlarge,enlarged
enlargement: enlargement
enlighten: enlighten,enlightened
enlightened: enlightened
enlightenment: enlightenment
enlist: enlist,enlisting
enmity: enmity
ennoble: ennoble,ennobled
ennobling: ennobling
enormity: enormity
enormous: enormous
enquire: enquire,enquiring
enquirer: enquirer
enquiry: enquiries,enquiry
enrol: enrol,enrolled
enslave: enslave,enslaved
ensue: ensued
ensure: ensured,ensuring
entail: entail
entanglement: entanglements
enter: enter,entered,entering,enters
enterprise: enterprises
entertain: entertain,entertained,entertaining,entertains
entertained: entertained
entertainer: entertainer
entertainment: entertainment,entertainments
enthrone: enthroned
enthusiasm: enthusiasm
enthusiast: enthusiasts
enthusiastic: enthusiastic
enthusiastically: enthusiastically
entire: entire
entitle: entitle
entity: entity
entrails: entrails
entrance: entrance
entreat: entreat,entreated
entreaty: entreaties,entreaty
entrust: entrust,entrusted
entwine: entwine
enumerate: enumerate,enumerated,enumerating
enunciate: enunciated
envious: envious
environment: environment
envy: envy
ep: ep
epeus: epeus
epic: epic
epicure: epicure
epicureans: epicureans
epidemic: epidemic
epilogue: epilogue
episode: episode
epistles: epistles
epithet: epithet
epitome: epitome
epoch: epoch
equable: equable
equal: equal,equalled,equals
equality: equality
equalize: equalize
equalling: equalling
equally: equally
equanimity: equanimity
equator: equator
equestrian: equestrian
equilibrium: equilibrium
equip: equipped
equipment: equipment
equivalent: equivalent
eradicate: eradicate,eradicated
erase: erase
erect: erect
eriphyle: eriphyle
eristic: eristic
err: err,erring,errs
errant: errant
erroneous: erroneous
erroneously: erroneously
error: error,errors
escape: escape,escaped,escaping
espousal: espousals
espouse: espoused
essence: essence,essences
essential: essential
essentially: essentially
establish: establish,established
establishment: establishment
estate: estate,estates
esteem: esteem,esteemed,esteeming
esteemed: esteemed
estimate: estimate,estimated,estimating
estimation: estimation
estranged: estranged
eternal: eternal
eternity: eternity
eth: eth
ethic: ethics
ethical: ethical
ethics: ethics
eulogist: eulogists
eumolpus: eumolpus
eunuch: eunuch
euphemism: euphemism
euphemistic: euphemistic
euripides: euripides
euripus: euripus
europe: europe
european: european,europeans
evacuation: evacuation
evade: evading
evasion: evasion
evening: evening
event: event,events
everlasting: everlasting
everlastingly: everlastingly
evidence: evidence,evidencing
evident: evident
evidently: evidently
evil: evil,evils
evoke: evokes
evolution: evolution
exact: exact,exacted
exaction: exactions
exactness: exactness
exaggerate: exaggerated,exaggerates,exaggerating
exaggerated: exaggerated
exaggeration: exaggeration
exalt: exalt,exalted,exalting
examination: examination
examine: examine,examined,examining
exceed: exceed,exceeded,exceeding,exceeds
excellence: excellence,excellences
excellent: excellent
excellently: excellently
exception: exception,exceptions
exceptional: exceptional
excess: excess
excessive: excessive
exchange: exchange,exchanged
excitable: excitable
excite: excite,excited,excites
excited: excited
excitement: excitement
exciting: exciting
exclaim: exclaiming
exclude: exclude,excluded,excluding
exclusion: exclusion
exclusive: exclusive
exclusively: exclusively
exclusiveness: exclusiveness
excusable: excusable
excuse: excuse,excused
execute: execute,executed,executing
execution: execution
executioner: executioner
exempt: exempt
exercise: exercise,exercised,exercises,exercising
exert: exert,exerted
exertion: exertion
exhaust: exhausted
exhausted: exhausted
exhibit: exhibit,exhibited,exhibiting,exhibits
exhibition: exhibition
exhort: exhorting
exile: exile,exiled,exiles,exiling
exist: exist,existed,existing,exists
existence: existence,existences
existent: existent
exodus: exodus
exordium: exordium
exotic: exotic
expand: expand
expanse: expanse
expansion: expansion
expatiate: expatiates
expect: expect,expected,expecting,expects
expectation: expectation
expediency: expediency
expedient: expedient
expedite: expedite
expedition: expedition,expeditions
expel: expel,expelled,expelling
expend: expend
expenditure: expenditure
expense: expense,expenses
expensive: expensive
experience: experience,experienced,experiences,experiencing
experienced: experienced
experiment: experiment,experimenting
expert: expert
expiate: expiate
expiation: expiations
explain: explain,explained,explaining,explains
explanation: explanation,explanations
explicit: explicit
exploit: exploits
export: exporting,exports
exporter: exporters
expose: expose,exposed
exposition: exposition
exposure: exposure
express: express,expressed,expresses,expressing
expressible: expressible
expression: expression,expressions
expressive: expressive
expressly: expressly
expulsion: expulsion
expunge: expunge
exquisite: exquisite
exquisiteness: exquisiteness
extant: extant
extend: extend,extended,extending,extends
extension: extension
extent: extent
exterior: exterior
external: external
extinct: extinct
extinguish: extinguish,extinguished,extinguishing
extirpation: extirpation
extol: extol,extolled
extract: extract,extracting,extracts
extraneous: extraneous
extraordinary: extraordinary
extravagance: extravagance,extravagances
extravagant: extravagant
extreme: extreme,extremes
extremely: extremely
extremity: extremity
eye: eye,eyes
eyed: eyed
eyesight: eyesight
eyewitness: eyewitness
fable: fable
fabric: fabric
fabulous: fabulous
facetious: facetious
facetiously: facetiously
facilitate: facilitate
facility: facilities,facility
faction: faction,factions
factor: factors
faculty: faculties,faculty
fade: fade,fades,fading
fail: fail,failed,failing,fails
failure: failure
fain: fain
faint: faint,fainter,faints
faintly: faintly
fair: fair,fairer,fairest
faire: faire
faith: faith
faithful: faithful
faithless: faithless
fall: fall,fallen,falling,falls,fell
fallacious: fallacious
fallacy: fallacy
fallen: fallen
fallibility: fallibility
falls: falls
false: false
falsehood: falsehood,falsehoods
falsely: falsely
falter: falter,faltering
fame: fame
familiar: familiar,familiars
familiarity: familiarity
familiarize: familiarize,familiarized
familiarly: familiarly
family: families,family
famous: famous
fanciful: fanciful
fancy: fancied,fancier,fancies,fancy,fancying
fangled: fangled
fantastic: fantastic
fare: fare
farmer: farmer
farth: farthest
fascinate: fascinated
fascination: fascination
fashion: fashion,fashioned,fashioning,fashions
fashioned: fashioned
fast: fast
fasten: fasten,fastened,fastens
fastidious: fastidious
fastness: fastness
fat: fat
fatal: fatal
fate: fate,fated,fates
fates: fates
father: father,fathers
fatherland: fatherland
fatherly: fatherly
fatted: fatted
fatten: fatten,fattens
fault: fault,faults
faultless: faultless
faulty: faulty
faust: faust
favor: favor
favorite: favorite
favour: favour,favours
favourable: favourable
favoured: favoured
favourite: favourite
fawn: fawns
fear: fear,feared,fearing,fears
fearful: fearful
fearless: fearless
feasible: feasible
feast: feast,feasts
feasting: feasting
feat: feat,feats
feather: feather,feathers
feature: feature,features
featureless: featureless
fecundity: fecundity
federal: federal
federation: federation
fee: fee,fees
feeble: feeble,feebler
feed: fed,feed,feeding,feeds
feeder: feeder
feeding: feeding
feel: feel,feeling,feels
feeling: feeling,feelings
feign: feigning
feigned: feigned
felicitate: felicitate
fellow: fellow,fellows
fellowship: fellowship
female: female,females
feminine: feminine
ferocity: ferocity
fertile: fertile
fertility: fertility
fervour: fervour
festering: festering
festival: festival,festivals
festive: festive
fetch: fetched
fetter: fetters
feudal: feudal
fever: fever
fiction: fiction,fictions
fictitious: fictitious
field: fields
fierce: fierce,fiercer
fierceness: fierceness
fiery: fiery
fig: figs
fight: fight,fighting,fights,fought
fighter: fighter
fighting: fighting,fightings
figment: figment
figurative: figurative
figure: figure,figures,figuring
file: file,files
filial: filial
filling: filling
film: film
final: final
finally: finally
finance: finance
financial: financial
fine: fine,finer,finest
finger: finger,fingers
finish: finish,finished
finished: finished
finite: finite
fireside: fireside
firm: firm
firmly: firmly
firmness: firmness
fish: fish
fit: fit,fits,fitted,fitting
fitful: fitful
fitly: fitly
fitness: fitness
fixed: fixed
fixedness: fixedness
flag: flag
flame: flames
flash: flashing
flat: flat,flatter
flatter: flattered,flatters
flatterer: flatterer,flatterers
flattery: flatteries,flattery
flatulence: flatulence
flaw: flaw
flay: flayed
flee: fled,flee,flees
fleece: fleeces
fleet: fleet
fleeting: fleeting
flesh: flesh
flinch: flinch
flit: flitting
float: float,floating,floats
flock: flock,flocking,flocks
flood: flood
flour: flour
flourish: flourishes
flout: flouted
flow: flow,flowing,flows
flower: flower
fluctuation: fluctuation,fluctuations
fluently: fluently
flute: flute,flutes
flutter: flutter
flux: flux
fly: flew,flies,flown,fly,flying
foam: foam
fold: fold,folds
folk: folk
follow: follow
follower: follower,followers
folly: follies,folly
fond: fond
fondly: fondly
fondness: fondness
food: food
fool: fool,fools
foolish: foolish
foolishly: foolishly
foot: feet,foot
footing: footing
footpad: footpads
footstep: footsteps
forbid: forbade,forbid,forbidden,forbidding,forbids
forbidden: forbidden
force: force,forced,forces,forcing
forced: forced
forcibly: forcibly
fore: fore
foreboding: forebodings
foreign: foreign
foreigner: foreigner
foresee: foresaw,foresee,foreseen
foreshadow: foreshadowed
foresight: foresight
foretaste: foretaste
forfeit: forfeited
forget: forget,forgets,forgetting,forgot,forgotten
forgetful: forgetful
forgetfulness: forgetfulness
forgive: forgive,forgiving
forgiveness: forgiveness
form: form,formed,forming,forms
format: format,formats
formation: formation
formidable: formidable
formula: formula,formulae
forsake: forsake,forsaken
forthwith: forthwith
fortify: fortify
fortress: fortress
fortunate: fortunate
fortune: fortune,fortunes
forwardness: forwardness
foster: foster,fostering
foul: foul,foulest
foundation: foundation,foundations
founder: founder,foundering,founders
foundling: foundling,foundlings
fourteen: fourteen
fourth: fourth,fourths
fourthly: fourthly
fox: fox
fraction: fraction,fractions
fragment: fragment,fragments
fragmentary: fragmentary
frame: frame,framed,framing
framework: framework
frankly: frankly
frankness: frankness
fraternity: fraternity
fraud: fraud,frauds
fray: fray
freedom: freedom
freely: freely
freeman: freeman,freemen
french: french
frenzy: frenzy
frequent: frequent
frequently: frequently
fresh: fresh
fretted: fretted
friar: friar
friction: friction
friend: friend,friends
friendless: friendless
friendly: friendly
friends: friends
friendship: friendship,friendships
frighten: frightened
frog: frogs
frontispiece: frontispiece
fruit: fruit,fruits
fruition: fruition
fruitless: fruitless
fulfil: fulfil,fulfilled,fulfilling
fulfiller: fulfiller
fulfilment: fulfilment
fulness: fulness
function: function,functions
fundamental: fundamental
funeral: funeral
funnel: funnel
furious: furious
furnace: furnace
furnish: furnish,furnished,furnishes
furniture: furniture
furtherance: furtherance
fury: fury
fusion: fusion
fuss: fuss
future: future
gadfly: gadfly
gaiety: gaiety
gain: gain,gained,gaining,gains
gainer: gainer,gainers
gainful: gainful
game: game,games
gamma: gamma
gang: gang
gap: gaps
gape: gapes
gardener: gardener
garland: garland,garlands
garment: garments
garnish: garnished
garrulity: garrulity
gate: gate,gates
gather: gather,gathered,gathering,gathers
gathering: gathering
gauntlet: gauntlet
gaze: gaze,gazed,gazing
gazer: gazer,gazers
gear: gear
gender: gender
genealogy: genealogies
generalization: generalization
generate: generate,generated
generation: generation,generations
generous: generous
genesis: genesis
genius: genius
gentile: gentile
gentle: gentle,gentlest
gentleman: gentleman,gentlemen
gentleness: gentleness
gentler: gentler
gently: gently
gentry: gentry
genuine: genuine
geometer: geometer
geometrical: geometrical
geometrician: geometrician,geometricians
geometry: geometry
germ: germ,germs
german: german,germans
gerousia: gerousia
gesture: gesture
ghost: ghost,ghosts
ghostly: ghostly
giant: giant,giants
gibber: gibber
giddiness: giddiness
gift: gift,gifted,gifts
gifted: gifted
gigantic: gigantic
giles: giles
gird: girt
girder: girders
girl: girl
giver: giver
glad: glad
gladly: gladly
gladness: gladness
glance: glance,glancing
glare: glare
glaucus: glaucus
glimpse: glimpse,glimpses
globe: globe
glorious: glorious
gloriously: gloriously
glory: glories,glory
gluttony: gluttony
goad: goaded,goads
goal: goal,goals
goat: goats
god: god,gods
goddess: goddess,goddesses
godless: godless
godlike: godlike
godly: godly
gods: gods
goethe: goethe
gold: gold
golden: golden
goodly: goodly
goodness: goodness
gorge: gorged
gorgeousness: gorgeousness
gospel: gospel
gospels: gospels
goths: goths
govern: govern,governed,governing,governs
governess: governesses
governing: governing
government: government,governments
governor: governor,governors
grace: grace,graced,graces
graceful: graceful
gracious: gracious
gradation: gradation,gradations
grade: grades
gradual: gradual
gradually: gradually
grain: grain,grains
grammar: grammar
grammarian: grammarian
grand: grand,grander
grandchild: grandchildren
grandfather: grandfather,grandfathers
grandly: grandly
grandmother: grandmothers
grant: grant,granted,granting
grasp: grasp
grate: grated
grateful: grateful
gratefully: gratefully
gratification: gratification
gratify: gratified,gratify,gratifying
gratitude: gratitude
grave: grave,graver,graves,gravest
graven: graven
gravity: gravity
greatly: greatly
greatness: greatness
grecian: grecian
greece: greece
greedy: greedy
greek: greek,greeks
greet: greet,greets
grey: grey
grief: grief
grieve: grieved
grievous: grievous
grim: grim
groaning: groaning
gross: gross
grossly: grossly
grote: grote
ground: ground
grounds: grounds
groundwork: groundwork
grovel: grovels
grow: grow,growing,grown,grows
grown: grown
growth: growth
grudge: grudge
grunt: grunts
guard: guard,guarding,guards
guardian: guardian,guardians
guardianship: guardianship
guess: guess,guessed,guesses
guest: guests
guidance: guidance
guide: guide,guided,guiding
guild: guild
guilt: guilt
guilty: guilty
gyges: gyges
gymnasia: gymnasia
gymnasium: gymnasium
gymnastic: gymnastic
gymnastics: gymnastics
habit: habit,habits
habitable: habitable
habitation: habitation,habitations
habituate: habituated,habituates
hades: hades
hail: hail
hair: hair
hairy: hairy
hall: halls
halloo: halloo
halt: halt,halted
halting: halting
hand: hand,handed,handing,hands
handed: handed
handicraft: handicraft,handicrafts
handle: handle
handmaid: handmaids
handmaiden: handmaiden
handsome: handsome
hang: hangs,hung
happen: happen,happened,happening
happily: happily
happiness: happiness
happy: happier,happiest,happy
haranguing: haranguing
harass: harass
harbour: harbour,harbouring,harbours
hard: hard,harder
harden: hardened
hardness: hardness
hardship: hardship,hardships
harlot: harlot
harlotry: harlotries
harm: harm,harmed,harming
harmless: harmless
harmonic: harmonics
harmonical: harmonical
harmonious: harmonious
harmoniously: harmoniously
harmonise: harmonise,harmonised
harmonist: harmonist
harmonize: harmonize,harmonized,harmonizes,harmonizing
harmony: harmonies,harmony
harp: harp
harsh: harsh,harshest
harshness: harshness
hart: hart
harvest: harvest
hast: hast
hasten: hastening
hastiness: hastiness
hasty: hasty
hatch: hatched
hate: hate,hated,hates,hating
hateful: hateful
hater: hater,haters
hatred: hatred,hatreds
hazard: hazard,hazarding
head: head,headed,heads
headache: headache
headforemost: headforemost
heal: heal,healing,heals
healer: healer
healing: healing
health: health
healthy: healthiest,healthy
heap: heap
hear: hear,heard,hearing,hears
hearer: hearer,hearers
hearing: hearing
heart: heart,hearts
heartily: heartily
heat: heat
heathen: heathen
heating: heating
heaven: heaven,heavens
heavenly: heavenly
heavens: heavens
heavy: heavier,heaviest,heavy
hebrew: hebrew
hector: hector
heed: heed,heeded
hegelian: hegelian
height: height
heighten: heightened
heinous: heinous
heir: heir
helen: helen
hellene: hellene,hellenes
hellenes: hellenes
hellenic: hellenic
hellespont: hellespont
helm: helm
helmet: helmet
helmsman: helmsmen
helots: helots
helper: helper,helpers
helpless: helpless
helplessness: helplessness
henceforward: henceforward
henry: henry
hephaestus: hephaestus
heraclitean: heraclitean
herald: herald
herb: herb,herbs
herculean: herculean
herd: herd
herdsman: herdsmen
hereditary: hereditary
heredity: heredity
heretofore: heretofore
hero: hero,heroes
heroic: heroic
heroine: heroines
hesitate: hesitate,hesitated,hesitating
hesitation: hesitation
heyday: heyday
hidden: hidden
hide: hidden,hides
highly: highly
hill: hill,hills
hinder: hindered,hindering
hindrance: hindrance
hint: hint,hinted,hinting,hints
hire: hire,hired
hireling: hireling,hirelings
hiss: hisses
historian: historian,historians
historical: historical
historically: historically
history: history
hit: hit,hits
hitherto: hitherto
hive: hive
hoard: hoard
hold: held,hold,holding,holds
holder: holder
hole: hole,holes
holiday: holiday
holiness: holiness
hollow: hollow
holy: holy
homage: homage
homely: homely
homer: homer
homeric: homeric
homicide: homicide
honest: honest
honester: honester
honestly: honestly
honesty: honesty
honey: honey
honeycomb: honeycomb
honeyed: honeyed
honour: honour,honoured,honouring,honours
honourable: honourable
honoured: honoured
hoof: hoofs
hook: hook
hooked: hooked
hope: hope,hoped,hopes,hoping
hopeless: hopeless
hoplite: hoplite
horizon: horizon
horn: horns
hornet: hornet
horrible: horrible
horribly: horribly
horrid: horrid
horrify: horrified
horror: horror,horrors
horse: horse,horses
horseback: horseback
horseman: horseman,horsemen
horsemanship: horsemanship
hospital: hospital
hospitality: hospitality
host: host
hostile: hostile
hot: hot
hound: hound,hounds
hour: hour,hours
house: house,housed,houses
household: household
householder: householders
housekeeper: housekeeper,housekeepers
housekeeping: housekeeping
hover: hovered
howl: howl,howling
hue: hue
hug: hug
huge: huge
hulking: hulking
hull: hull
human: human
humane: humane
humanity: humanity
humanize: humanize,humanized,humanizing
humble: humble,humbled
humbly: humbly
humorous: humorous
humorously: humorously
humour: humour,humours
hunger: hunger,hungers
hungering: hungering
hungry: hungry
hunt: hunt,hunting
hunter: hunters
hunting: hunting
huntsman: huntsmen
hurry: hurried,hurries,hurry
hurt: hurt,hurts
hurtful: hurtful
husband: husband
husbandman: husbandman,husbandmen
husbandmen: husbandmen
husbandry: husbandry
hut: hut
hydra: hydra
hymeneal: hymeneal,hymeneals
hymn: hymn,hymning,hymns
hymning: hymning
hyperbolical: hyperbolical
hypotenuse: hypotenuse
hypothesis: hypotheses,hypothesis
hypothetical: hypothetical
iambic: iambic
ida: ida
idea: idea,ideas
ideal: ideal,ideals
idealism: idealism
idealist: idealist
idealize: idealize
idealized: idealized
identical: identical
identification: identification
identify: identified,identifies,identify
identity: identity
idiocy: idiocy
idiot: idiot
idle: idle,idling
idleness: idleness
idolatry: idolatry
ignoble: ignoble
ignominiously: ignominiously
ignorance: ignorance
ignorant: ignorant
iii: iii
iliad: iliad
illegal: illegal
illiberality: illiberality
illness: illness,illnesses
illusion: illusion,illusions
illusive: illusive
illusory: illusory
illustrate: illustrate,illustrated,illustrates
illustration: illustration,illustrations
illustrious: illustrious
image: image,images
imagery: imagery
imaginary: imaginary
imagination: imagination
imaginative: imaginative
imagine: imagine,imagined,imagines,imagining
imagining: imaginings
imbecile: imbecile
imbue: imbued
imitate: imitate,imitated,imitates,imitating
imitation: imitation,imitations
imitative: imitative
imitator: imitator,imitators
immeasurable: immeasurable
immeasurably: immeasurably
immense: immense
immensity: immensity
immerse: immersed
immoral: immoral
immorality: immorality
immortal: immortal,immortals
immortality: immortality
immovable: immovable
immutable: immutable
immutably: immutably
impair: impair,impairs
impale: impaled
impart: impart,imparted,imparting,imparts
impartial: impartial
impartially: impartially
impatience: impatience
impatient: impatient
impatiently: impatiently
impeachment: impeachments
impediment: impediment,impediments
impel: impelled
impending: impending
imperatively: imperatively
imperceptibly: imperceptibly
imperfect: imperfect
imperfection: imperfection,imperfections
imperfectly: imperfectly
imperialism: imperialism
imperishable: imperishable
impersonal: impersonal
impertinence: impertinences
impetuous: impetuous
impetuousness: impetuousness
impiety: impiety
impious: impious
implant: implant,implanted,implanting,implants
implement: implement,implements
implore: implore
imply: implied,implies,imply,implying
import: import,imported,imports
importer: importers
importunity: importunity
impose: impose,imposed,imposes
imposition: imposition,impositions
impossibility: impossibility
impossible: impossible
impossibly: impossibly
impostor: impostor
impoverish: impoverished
impracticability: impracticability
impracticable: impracticable
impregnable: impregnable
impress: impress,impresses
impressed: impressed
impressible: impressible
impression: impression,impressions
improper: improper
impropriety: impropriety
improve: improve,improved,improves,improving
improved: improved
improvement: improvement,improvements
improvidence: improvidence
impudence: impudence
impulse: impulse,impulses
impure: impure
impurity: impurities
imputation: imputations
impute: impute
inability: inability
inaccuracy: inaccuracy
inaccurate: inaccurate
inaccurately: inaccurately
inachus: inachus
inadequate: inadequate
inanimate: inanimate
inappropriateness: inappropriateness
inarticulate: inarticulate
incantation: incantations
incapable: incapable
incense: incense
incentive: incentive,incentives
incest: incest
incestuous: incestuous
incident: incidents
incidental: incidental
incidentally: incidentally
incite: incited
inclination: inclination
incline: incline,inclined,inclines
inclined: inclined
include: include,included,includes,including
including: including
income: income
incommensurable: incommensurable
incompatibility: incompatibilities
incompatible: incompatible
incomplete: incomplete
inconceivable: inconceivable
incongruity: incongruity
inconsistency: inconsistencies,inconsistency
inconsistent: inconsistent
incontinent: incontinent
inconvenient: inconvenient
incorporate: incorporate
increase: increase,increases,increasing
incredulous: incredulous
increment: increments
incrust: incrusted
incrustation: incrustations
inculcate: inculcates
incur: incur,incurred,incurring
incurable: incurable
indebt: indebted
indebted: indebted
indecency: indecency
indefinable: indefinable
indefinite: indefinite
indelible: indelible
indelibly: indelibly
indemnify: indemnify
indemnity: indemnity
independence: independence
independent: independent
independently: independently
indestructible: indestructible
india: india
indication: indications
indictment: indictment
indies: indies
indifference: indifference
indifferent: indifferent
indifferently: indifferently
indignant: indignant
indignantly: indignantly
indignation: indignation
indirect: indirect
indirectly: indirectly
indiscreet: indiscreet
indiscriminate: indiscriminate
indispensable: indispensable
indissolubly: indissolubly
indistinct: indistinct
indistinguishable: indistinguishable
individual: individual,individuals
individualism: individualism
individuality: individuality
individually: individually
indivisible: indivisible
indolence: indolence
indolent: indolent
indomitable: indomitable
indoors: indoors
induce: induced,induces
inducement: inducement
induction: induction
inductive: inductive
indulge: indulge,indulged,indulges,indulging
indulgence: indulgence,indulgences
industrial: industrial
industrious: industrious
industry: industry
inequality: inequality
inert: inert
inevitable: inevitable
inevitably: inevitably
inexact: inexact
inexcusable: inexcusable
inexhaustible: inexhaustible
inexperience: inexperience
inexperienced: inexperienced
inextinguishable: inextinguishable
inextricably: inextricably
infallible: infallible
infallibly: infallibly
infamy: infamy
infancy: infancy
infant: infant,infants
infatuate: infatuated
infatuation: infatuation
infect: infect,infected,infecting
infection: infection
infer: infer,inferred,inferring
inference: inference,inferences
inferior: inferior,inferiors
inferiority: inferiority
infinite: infinite
infinitely: infinitely
infinity: infinity
infirmity: infirmity
inflammatory: inflammatory
inflict: inflict,inflicted
influence: influence,influenced,influences
influential: influential
inform: inform,informed,informing,informs
informer: informer,informers
infringement: infringement
infuriate: infuriated
infuse: infused
infusion: infusion
ingenious: ingenious
ingeniously: ingeniously
ingenuity: ingenuity
ingenuous: ingenuous
inhabit: inhabited
inhabitant: inhabitant,inhabitants
inharmonious: inharmonious
inherent: inherent
inherit: inherited
inheritance: inheritance
inhuman: inhuman
inimical: inimical
iniquity: iniquities,iniquity
initiate: initiated
initiation: initiation
injure: injure,injured,injuring
injured: injured
injurious: injurious
injuriously: injuriously
injury: injuries,injury
injustice: injustice
inmost: inmost
innate: innate
innermost: innermost
innocence: innocence
innocent: innocent
innovation: innovation
innovator: innovators
innumerable: innumerable
inquire: inquire,inquires,inquiring
inquiry: inquiry
inquisition: inquisition
insane: insane
insanity: insanity
insatiable: insatiable
inscribe: inscribe
insensible: insensible
insensibly: insensibly
inseparable: inseparable
inseparably: inseparably
insert: insert
insidiously: insidiously
insight: insight
insinuate: insinuates
insist: insist,insisted,insisting,insists
insolence: insolence
insomuch: insomuch
inspect: inspect,inspecting
inspiration: inspiration
inspire: inspire,inspired,inspires
inspired: inspired
inspiring: inspiring
instance: instance,instances
instant: instant,instants
instantaneous: instantaneous
instantly: instantly
instigate: instigated
instinct: instinct,instincts
institute: instituted
institution: institution,institutions
instruct: instruct,instructed
instruction: instruction,instructions
instructor: instructor,instructors
instrument: instrument,instruments
insubordination: insubordination
insult: insult,insulted,insults
insultingly: insultingly
insurrection: insurrection,insurrections
intact: intact
integrate: integrate
intellect: intellect
intellectual: intellectual
intellectually: intellectually
intelligence: intelligence,intelligences
intelligent: intelligent
intelligible: intelligible
intelligibly: intelligibly
intemperance: intemperance
intemperate: intemperate
intend: intend,intended,intending,intends
intensely: intensely
intensify: intensified
intention: intention,intentions
intentional: intentional
intentionally: intentionally
interchange: interchange
intercourse: intercourse
interdict: interdict,interdicted
interfere: interfere,interfered,interfering
interference: interference
interior: interior
interlocutor: interlocutors
intermediate: intermediate,intermediates
interminable: interminable
internal: internal
international: international
interpose: interposed,interposes,interposing
interpret: interpret,interpreted,interpreting
interpretation: interpretation
interpreter: interpreter
interrogate: interrogate
interrogation: interrogation
interrogative: interrogative
interrupt: interrupt,interrupted,interrupts
interruption: interruptions
intersperse: interspersed
interval: interval,intervals
interweave: interweave
interwoven: interwoven
intimate: intimate,intimated,intimates,intimating
intimation: intimation,intimations
intimidation: intimidation
intolerable: intolerable
intolerant: intolerant
intoxicate: intoxicated
intoxication: intoxication
intractable: intractable
intrepid: intrepid
intrigue: intrigues
introd: introd
introduce: introduce,introduced,introduces,introducing
introduction: introduction
introductions: introductions
introductory: introductory
intruder: intruder
intuition: intuition
intuitively: intuitively
inure: inured
invade: invades
invader: invaders
invalid: invalid,invalids
invalidism: invalidism
invalidity: invalidity
invaluable: invaluable
invariable: invariable
invasion: invasion
invent: invent,invented,inventing,invents
inventive: inventive
inventor: inventor,inventors
inverse: inverse
inversion: inversion
invest: invested,invests
investigate: investigate,investigated,investigating
investigation: investigation
inveterate: inveterate
invincible: invincible
inviolable: inviolable
invisible: invisible
invitation: invitation
invite: invite,invited,invites,inviting
invocation: invocations
invoke: invoked
involuntarily: involuntarily
involuntariness: involuntariness
involuntary: involuntary
involution: involution
involve: involve,involved,involves,involving
invulnerable: invulnerable
inwardly: inwardly
inwards: inwards
ion: ion
ionian: ionian
irascible: irascible
ireland: ireland
iron: iron
ironical: ironical
ironically: ironically
irony: irony
irrational: irrational,irrationals
irregular: irregular
irregularity: irregularity
irremediable: irremediable
irresistible: irresistible
irrespective: irrespective
irreversible: irreversible
irrevocably: irrevocably
irritability: irritability
irritable: irritable
irritated: irritated
irs: irs
island: island,islands
islands: islands
isolate: isolate,isolated
isolation: isolation
israelite: israelite
issue: issue,issuing
italy: italy
ithaca: ithaca
iv: iv
ivory: ivory
ix: ix
janus: janus
japan: japan
jaunty: jaunty
jealous: jealous
jealousy: jealousy
jean: jean
jest: jest,jests
jester: jester
jesus: jesus
jewish: jewish
jews: jews
john: john
johnson: johnson
joint: joint
joke: joke,jokes
journey: journey,journeyed
joy: joy,joys
judge: judge,judged,judges,judging
judgement: judgement
judging: judging
judgment: judgment,judgments
judicious: judicious
juggler: juggler
jump: jumped
jupiter: jupiter
jury: juries
justest: justest
justice: justice
justified: justified
justify: justified,justifying
justly: justly
juxtaposition: juxtapositions
kant: kant
keen: keen,keener
keener: keener
keenly: keenly
keenness: keenness
keeper: keeper,keepers
ken: ken
key: key
kick: kick
kill: kill,killing,kills
kindly: kindlier,kindly
kindness: kindness
kindred: kindred
king: king,kings
kingdom: kingdom,kingdoms
kinsfolk: kinsfolk
kinsman: kinsman,kinsmen
kiss: kiss,kissed
knavish: knavish
knead: kneading
knee: knees
kneel: kneel
knife: knife
knight: knight
knock: knock,knocking
knower: knower
knowledge: knowledge
laborious: laborious
labour: labour,labouring,labours
labourer: labourers
labouring: labouring
lacedaemonian: lacedaemonian
lacerate: lacerating
laches: laches
lachesis: lachesis
lack: lacking
ladder: ladder
laissez: laissez
lake: lake
lame: lame
lameness: lameness
lament: lament,lamenting,laments
lamentation: lamentation,lamentations
land: land,landed,lands
landscape: landscape
language: language
lank: lank
lap: lapped
laputa: laputa
lard: larding
largeness: largeness
lasting: lasting
lastly: lastly
late: late
latent: latent
latin: latin
laugh: laugh,laughed,laughing,laughs
laughable: laughable
laughter: laughter
law: law,laws
lawful: lawful
lawgiver: lawgiver
lawless: lawless
lawlessly: lawlessly
lawlessness: lawlessness
laws: laws
lawsuit: lawsuits
lawyer: lawyer,lawyers
laxity: laxity
lay: laid,lay,laying,lays
layman: layman
laziness: laziness
lazy: lazy
lead: lead,leading,leads,led
leaden: leaden
leader: leader,leaders
leaf: leaves
league: league,leagued
leaky: leaky
lean: lean,leaning
leap: leap
lear: lear
learn: learn,learned,learning,learns,learnt
learning: learning
leather: leather
leave: leave,leaves,leaving,left
lecture: lecture,lectures
left: left
leg: legs
legal: legal
legally: legally
legend: legend,legends
legged: legged
legislate: legislate
legislating: legislating
legislation: legislation
legislative: legislative
legislator: legislator,legislators
legislature: legislature
legitimate: legitimate
leisure: leisure
lend: lend
lengthen: lengthen
lessen: lessened
lesson: lesson,lessons
letter: letter,letters
level: level
lewis: lewis
lex: lex
liability: liability
liable: liable
libation: libations
liberal: liberal
liberality: liberality
liberate: liberated,liberating
liberated: liberated
libertinism: libertinism
liberty: liberty
library: library
licence: licence
license: license,licensed
licensed: licensed
licentious: licentious
licentiousness: licentiousness
licinian: licinian
lie: lie,lies,lying
lieu: lieu
life: life,lives
lifelike: lifelike
lifetime: lifetime
lift: lift,lifted,lifting
light: light,lighted,lighter,lights
lighted: lighted
lighten: lighten,lightens
lightly: lightly
lightning: lightning
liken: liken,likens
likeness: likeness
likest: likest
limb: limb,limbs
limit: limit,limited,limits
limitation: limitation,limitations
limited: limited
lineage: lineage
lineament: lineaments
linen: linen
linger: linger,lingering
link: link,linked,links
lion: lion
lip: lips
list: list
listen: listen,listened,listening,listens
listener: listener
literal: literal
literally: literally
literary: literary
literature: literature
litigant: litigant
litigation: litigation
litigiousness: litigiousness
live: live,lived,lives,living
lived: lived
livelihood: livelihood
liveliness: liveliness
lively: lively
living: living
lo: lo
loaf: loaves
local: local
locate: located
location: locations
locomotion: locomotion
lofty: loftier,lofty
logic: logic
logical: logical
logician: logician,logicians
loiter: loiter
longing: longing,longings
looker: lookers
loose: loose
loosen: loosening
lord: lord,lords
lordly: lordly
lordship: lordships
lose: lose,loses,losing,lost
loser: loser
loss: loss,losses
lot: lot,lots
loth: loth
lotophagi: lotophagi
lotus: lotus
loud: loud
loudly: loudly
love: love,loved,loves,loving
lovely: loveliest
lover: lover,lovers
loving: loving
loyal: loyal
loyalty: loyalty
lucid: lucid
lucidity: lucidity
luck: luck
lucre: lucre
ludicrous: ludicrous
ludicrously: ludicrously
luke: luke
luminous: luminous
lunatic: lunatic
lust: lust,lusting,lusts
lustful: lustful
luxurious: luxurious
luxury: luxuries,luxury
lydia: lydia
lydian: lydian
lye: lye,lyes
lyre: lyre,lyres
lyric: lyric
lyrical: lyrical
lysimachus: lysimachus
machine: machine
machinery: machinery
mad: mad,madder,maddest
madman: madman,madmen
madmen: madmen
madness: madness
magazine: magazines
magic: magic
magician: magician,magicians
magistrate: magistrates
magna: magna
magnanimous: magnanimous
magnificence: magnificence
magnificent: magnificent
magnificently: magnificently
magnify: magnified,magnify,magnifying
magnitude: magnitude
mahometan: mahometan
maiden: maiden
maim: maimed
maimed: maimed
main: main
maintain: maintain,maintained,maintaining,maintains
maintainer: maintainer,maintainers
maintenance: maintenance
majority: majority
maker: maker,makers
maladministration: maladministration
malady: malady
male: male,males
malefactor: malefactors
malice: malice
malignity: malignity
manage: manage,managed
management: management
manager: manager
manhood: manhood
manifest: manifest,manifested
manifestly: manifestly
manifold: manifold
manipulate: manipulated
mankind: mankind
manliness: manliness
manly: manlier,manly
manner: manner
manners: manners
manoeuvre: manoeuvre
mansion: mansion,mansions
manual: manual
manufacture: manufacture,manufactured,manufactures
manufacturer: manufacturer
manus: manus
map: map
mar: marred,marring
marathon: marathon
march: march,marched
marching: marching
marionette: marionette
mark: mark,marked,marks
marked: marked
market: market,markets
marriage: marriage,marriages
marry: married,marries,marry,marrying
marrying: marrying
mars: mars
marsh: marsh
martial: martial
martyr: martyr
marvel: marvel,marvels
marvellous: marvellous
masculine: masculine
mask: mask
mass: mass,masses
master: master,mastering,masters
mastery: mastery
mat: mat
match: match
mate: mate
material: material,materials
maternal: maternal
maternity: maternity
mathematical: mathematical
mathematician: mathematician
mathematics: mathematics
mating: mating
matrimony: matrimony
matter: matter,matters
mattock: mattock
mature: mature,matured
maturer: maturer
maxim: maxim,maxims
maximum: maximum
maze: mazes
meadow: meadow
meagre: meagre
meagreness: meagreness
meal: meal,meals
meaning: meaning
meanness: meanness,meannesses
measure: measure,measures,measuring
measurement: measurement
measuring: measuring
meat: meat,meats
mechanic: mechanic
mechanical: mechanical
meddle: meddle
meddlesomeness: meddlesomeness
meddling: meddling
mediaeval: mediaeval
medical: medical
medicine: medicine,medicines
meditate: meditated,meditating
meditation: meditation
medium: medium
meed: meed
meet: meet,meeting,meets,met
meeting: meeting,meetings
megara: megara
melancholy: melancholy
melody: melodies,melody
melt: melt,melted
mem: mem
memorabilia: memorabilia
memorial: memorial,memorials
memory: memories,memory
mend: mend,mending
mendicant: mendicant
menelaus: menelaus
mental: mental
mention: mention,mentioned,mentioning,mentions
mephistopheles: mephistopheles
mercenary: mercenaries,mercenary
merchandise: merchandise
merchant: merchants
merchantability: merchantability
mercury: mercury
mercy: mercy
mere: mere
merit: merit,merits
merriment: merriment
mess: mess
message: message
messenger: messenger,messengers
messiah: messiah
met: met
metal: metal
metamorphose: metamorphose
metaph: metaph
metaphor: metaphor
metaphorical: metaphorical
metaphorically: metaphorically
metaphysic: metaphysic
metaphysical: metaphysical
metaphysician: metaphysicians
metaphysics: metaphysics
metempsychosis: metempsychosis
method: method,methods
metic: metic
metre: metre,metres
metrical: metrical
michael: michael
mid: mid
midas: midas
middle: middle
midst: midst
midway: midway
mightily: mightily
mighty: mightier,mightiest,mighty
migrate: migrated
mildew: mildew
mile: miles
milesian: milesian
military: military
milk: milk
milky: milky
millennial: millennial
milton: milton
mimetic: mimetic
mince: minced
mind: mind,minds
minded: minded
mingle: mingle,mingled,mingles,mingling
minister: minister,ministering,ministers
minor: minor
minute: minute,minutes,minutest
minutely: minutely
miracle: miracle,miracles
miraculous: miraculous
mire: mire
mirror: mirror
misanthrope: misanthrope
misapply: misapplied
misapprehend: misapprehend,misapprehended
misbehave: misbehaving
misbehaviour: misbehaviour
mischief: mischief
mischievous: mischievous
miser: miser,misers
miserable: miserable
miserably: miserably
miserly: miserly
misery: miseries,misery
misfortune: misfortune,misfortunes
misgiving: misgivings
mislead: misled
misrepresent: misrepresent,misrepresented
misrepresentation: misrepresentations
mission: mission
missionary: missionary
mississippi: mississippi
misstatement: misstatements
mist: mist,mists
mistake: mistake,mistakes
mistaken: mistaken
mistress: mistress,mistresses
mistrust: mistrust,mistrusted
misunderstanding: misunderstanding
mitigate: mitigate
mix: mixed,mixing
mixed: mixed
mixture: mixture
mob: mob,mobs
mock: mock
mockery: mockery
mode: mode,modes
model: model,models
moderate: moderate,moderating
moderately: moderately
moderation: moderation
modern: modern,moderns
modest: modest
modesty: modesty
modification: modification
modify: modified,modify
moisture: moisture
moment: moment,moments
monarch: monarch
monarchical: monarchical
monarchy: monarchy
monastery: monasteries
monastic: monastic
monasticism: monasticism
money: money,moneys
moneymake: moneymaking
moneymaking: moneymaking
monitor: monitor
monkey: monkey
monogamist: monogamists
monopoly: monopoly
monotony: monotony
monster: monster,monsters
monstrous: monstrous
month: month,months
monthly: monthly
monument: monument,monuments
mood: mood,moods
moon: moon
moral: moral,morals
moralist: moralist,moralists
morality: morality
moralize: moralize
moralizing: moralizing
morgenstern: morgenstern
morning: morning
morose: morose
mortal: mortal,mortals
mortality: mortality
moses: moses
mosque: mosques
mother: mother,mothers
motherland: motherland
motion: motion,motions
motive: motive,motives
motley: motley
mould: mould,moulded,moulds
mount: mount,mounted,mounting
mourning: mourning
mouth: mouth,mouths
movement: movement,movements
multiform: multiform
multiplication: multiplication
multiplicity: multiplicity
multiply: multiplied,multiply,multiplying
multitude: multitude
multitudinous: multitudinous
murder: murder,murdered,murders
murderer: murderer,murderers
murmur: murmur
musaeus: musaeus
muscle: muscles
muscular: muscular
muse: muse
muses: muses
museum: museum
music: music
musica: musica
musical: musical
musician: musician,musicians
muster: muster
mutability: mutability
mute: mute
mutineer: mutineers
mutinous: mutinous
mutiny: mutiny
mutual: mutual
myriad: myriads
myrrh: myrrh
myrtle: myrtle
mysterious: mysterious
mystery: mysteries,mystery
mystic: mystic
mystical: mystical
mystify: mystify
myth: myth,myths
mythic: mythic
mythical: mythical
mythological: mythological
mythology: mythology
mythus: mythus
naked: naked
nakedness: nakedness
nameless: nameless
nap: napping
napoleon: napoleon
narcotic: narcotic
narrate: narrate,narrated,narrating
narration: narration
narrative: narrative,narratives
narrator: narrator,narrators
narrow: narrow,narrower
narrowness: narrowness
nation: nation,nations
national: national
native: native
natural: natural
naturally: naturally
nature: nature,natures
naught: naught
navel: navel
navigation: navigation
navigator: navigators
nearer: nearer
neatherd: neatherd,neatherds
necessaries: necessaries
necessitate: necessitate,necessitating
necessity: necessities,necessity
neck: neck,necks
necklace: necklace,necklaces
needful: needful
negation: negation
negative: negative,negatives
negatively: negatively
negativeness: negativeness
neglect: neglect,neglected,neglecting,neglects
negligence: negligence
neigh: neighing
neighborhood: neighborhood
neighbour: neighbour,neighbours
nemesis: nemesis
nerve: nerve,nerves
nerving: nerving
nervous: nervous
nest: nest,nests
network: network
neuter: neuter
neutral: neutral
newfangled: newfangled
newly: newly
news: news
newsletter: newsletter
newton: newton
nice: nice
nickname: nickname
nicomachean: nicomachean
night: night,nights
nightingale: nightingale
nightly: nightly
ninth: ninth
niobe: niobe
nobility: nobility
noble: noble,nobler,noblest
nobleman: noblemen
nobleness: nobleness
nobly: nobly
nocturnal: nocturnal
nod: nod,nodding
noise: noise
noisy: noisy
nolo: nolo
nomenclature: nomenclature
nominal: nominal
nominally: nominally
nonproprietary: nonproprietary
nonsense: nonsense
north: north
northern: northern
nose: nose,noses
nosed: nosed
nostrum: nostrum,nostrums
notably: notably
note: note,notes
notice: notice,noticed
noticeable: noticeable
notify: notifies
notion: notion,notions
notoriously: notoriously
notre: notre
nought: nought
nourish: nourish,nourishes,nourishing
nourishment: nourishment
novelist: novelists
novelty: novelty
novitiate: novitiate
noxious: noxious
numbering: numbering
numberless: numberless
numerical: numerical
numerous: numerous
nuptials: nuptials
nurse: nurse,nurses,nursing
nursery: nursery
nursing: nursing
nurture: nurture,nurtured,nurturing
nurturer: nurturers
nutriment: nutriment
oak: oak,oaks
oarsman: oarsmen
oath: oath,oaths
obedience: obedience
obedient: obedient
obediently: obediently
obey: obey,obeyed,obeying
object: object,objected,objects
objection: objection,objections
objectionable: objectionable
objective: objective
objectively: objectively
objector: objector
obligation: obligation
obligatory: obligatory
oblige: oblige,obliged
obliquely: obliquely
obliterate: obliterate
oblong: oblong
obnoxious: obnoxious
obscene: obscene
obscure: obscure
obscurity: obscurities,obscurity
observance: observance
observation: observation
observe: observe,observed,observes,observing
obsolete: obsolete
obstinate: obstinate
obvious: obvious
occasion: occasion,occasions
occasional: occasional
occasionally: occasionally
occupation: occupation,occupations
occupy: occupied,occupy
occur: occur,occurred,occurring,occurs
occurrence: occurrence
ocean: ocean
october: october
odd: odd
ode: ode
odour: odour
odysseus: odysseus
odyssey: odyssey
offence: offence,offences
offender: offender,offenders
offer: offer,offered,offering,offers
offering: offering,offerings
office: office,offices
officer: officer,officers
official: official
offspring: offspring
oft: oft
oftener: oftener
olden: olden
oligarch: oligarch,oligarchs
oligarchical: oligarchical
oligarchy: oligarchies,oligarchy
olive: olives
olympian: olympian
olympic: olympic
omission: omission,omissions
omit: omit,omitting
omnipotent: omnipotent
online: online
onward: onward
openly: openly
operation: operation,operations
ophthalmia: ophthalmia
opine: opine,opines
opinion: opinion,opinions
opponent: opponent,opponents
opportunity: opportunities,opportunity
oppose: oppose,opposed,opposes,opposing
opposed: opposed
opposition: opposition,oppositions
oppress: oppressed
oppression: oppression
optimist: optimist
ora: ora
oracle: oracle,oracles
oracular: oracular
oration: oration
orator: orator
orb: orb
orbit: orbits
ordain: ordain,ordained,ordains
orderly: orderly
ordinarily: ordinarily
ordinary: ordinary
organ: organ,organs
organic: organic
organisation: organisation
organization: organization
organize: organized
organized: organized
organon: organon
oriental: oriental
origin: origin
original: original
originality: originality
originally: originally
originate: originate,originated,originates
originator: originator
ornament: ornament,ornaments
ornamental: ornamental
orphan: orphan
orpheus: orpheus
orphic: orphic
orrery: orrery
orthodox: orthodox
oscillate: oscillates
outbreak: outbreaks
outdated: outdated
outer: outer
outermost: outermost
outlandish: outlandish
outline: outline,outlines
outrage: outrage
outrageous: outrageous
outward: outward
outwards: outwards
outweigh: outweigh
overboard: overboard
overcome: overcome,overcoming
overdo: overdone
overgrown: overgrown
overhang: overhangs
overlap: overlap
overlook: overlook,overlooked
overmaster: overmasters
overpass: overpast
overpower: overpowered,overpowers
overpowering: overpowering
overtake: overtake,overtaken
overthrow: overthrow,overthrown
overthrower: overthrower
overturn: overturn
overween: overweening
overwhelm: overwhelmed
overwhelming: overwhelming
owe: owe,owed,owes
owner: owner,owners
oxen: oxen
oyster: oyster
pace: pace
pacify: pacified,pacify,pacifying
pacing: pacing
pad: pads
paeonic: paeonic
pagan: pagan
paganism: paganism
pain: pain,pains
pained: pained
painful: painful
painfully: painfully
painless: painless
paint: paint,painted,painting,paints
painter: painter,painters
painting: painting,paintings
pair: pair,paired,pairing,pairs
palace: palace
palaestra: palaestra
pale: pale
paleness: paleness
palm: palm,palms
palpable: palpable
paltry: paltry
pamper: pampered
pan: pan,pans
pancake: pancakes
pancratiast: pancratiast
pandarus: pandarus
panegyrist: panegyrists
pang: pang,pangs
panharmonic: panharmonic
panic: panic
panting: panting
pantomimic: pantomimic
papacy: papacy
paper: paper
paperwork: paperwork
parable: parable
parade: parades
paradise: paradise
paradox: paradox,paradoxes
paradoxical: paradoxical
paragraph: paragraph,paragraphs
parallel: parallel,paralleled,parallels
paralytic: paralytic
paramount: paramount
paraphrase: paraphrase
pardon: pardon,pardoned
pare: pared
parent: parent,parents
parental: parental
paris: paris
parley: parley
parliament: parliament
parody: parodying
parricide: parricide,parricides
partake: partake,partakes
partaker: partakers
parthenon: parthenon
partial: partial
partially: partially
participate: participate,participates
participation: participation
particulars: particulars
partisan: partisan
partition: partition
partly: partly
partner: partner,partners
partnership: partnership,partnerships
party: parties,party
pass: pass,passed,passes,passing
passage: passage,passages
passenger: passengers
passer: passers
passion: passion,passions
passionate: passionate
passive: passive
pasture: pasture
patch: patch,patches
path: path,paths
pathos: pathos
patience: patience
patient: patient,patients
patriarch: patriarch
patriarchal: patriarchal
patrimony: patrimony
patriotism: patriotism
patroclus: patroclus
patronage: patronage
pattern: pattern,patterns
paul: paul
pauper: pauper,paupers
pause: pause
pay: paid,pay,paying,pays
paymaster: paymasters
payment: payment,payments
pea: peas
peace: peace
peaceful: peaceful
peacefulness: peacefulness
peacock: peacocks
peak: peak
pearl: pearls
peasant: peasants
pebbly: pebbly
peculiar: peculiar
peculiarity: peculiarities,peculiarity
peculiarly: peculiarly
pedant: pedants
peep: peep
peer: peers
peg: pegs
peleus: peleus
pelops: pelops
pen: pen,pent
penalty: penalties,penalty
pence: pence
penetrate: penetrate,penetrated,penetrates
penetration: penetration
penurious: penurious
people: peoples
peradventure: peradventure
perceive: perceive,perceived,perceives,perceiving
perception: perception,perceptions
perchance: perchance
percipient: percipient
peremptorily: peremptorily
peremptory: peremptory
perfect: perfect,perfected,perfecting
perfectibility: perfectibility
perfection: perfection
perfectly: perfectly
perform: perform,performed,performing,performs
performance: performance,performances
performer: performer
perfume: perfumes
pericles: pericles
peril: peril,perils
perilous: perilous
period: period,periods
periodic: periodic
perish: perish,perished,perishes,perishing
perishing: perishing
perjury: perjury
permanence: permanence
permanent: permanent
permeate: permeated,permeates
permission: permission
permit: permit,permitted
permutation: permutations
perpendicular: perpendicular
perpetrate: perpetrate,perpetrated,perpetrating
perpetrator: perpetrators
perpetual: perpetual
perpetually: perpetually
perplex: perplexed
perplexed: perplexed
perplexing: perplexing
perplexity: perplexities,perplexity
persecute: persecuted
persecutor: persecutor
persephone: persephone
persevere: persevere,perseveres
persia: persia
persian: persian,persians
persist: persisting
persistency: persistency
person: people,person,persons
personage: personage,personages
personal: personal
personality: personality
personate: personate
personification: personification
personify: personified,personify
perspiration: perspiration
persuade: persuade,persuaded,persuading
persuasion: persuasion
persuasive: persuasive
perturb: perturbing
pervade: pervaded,pervades
perverse: perverse
perversion: perversion,perversions
pervert: perverted,perverting
peter: peter
petty: petty
phaedo: phaedo
phalaris: phalaris
phantom: phantom
phase: phase
phenomena: phenomena
phenomenon: phenomena,phenomenon
phil: phil
philanthrope: philanthrope
philol: philol
philosopher: philosopher,philosophers
philosophic: philosophic
philosophical: philosophical
philosophy: philosophy
phlegm: phlegm
phoebus: phoebus
phoenician: phoenician
phoenicians: phoenicians
phoenix: phoenix
phrase: phrase,phrases
phraseology: phraseology
phrygian: phrygian
physic: physic
physical: physical
physically: physically
physician: physician,physicians
physiologist: physiologist
physiology: physiology
pick: pick
pickpocket: pickpocket
picture: picture,pictured,pictures
piece: piece,pieces
piecemeal: piecemeal
pierce: pierced,pierces,piercing
piety: piety
pig: pig,pigs
pile: pile
pilgrim: pilgrims
pilgrimage: pilgrimage,pilgrimages
pilot: pilot,pilots
pious: pious
pipe: pipe,pipes
pitch: pitch,pitching
pitiable: pitiable
pitiful: pitiful
pity: pitied,pity,pitying
plague: plague,plagues
plain: plain
plainly: plainly
plainness: plainness
plaintiff: plaintiff
plan: plan,plans
plane: plane,planes
planet: planets
plant: plant,planted,plants
plastic: plastic
platform: platform
platitude: platitudes
plato: plato
platonic: platonic
plausibility: plausibility
play: play,played,playing,plays
player: player,players
playful: playful
plead: plead
pleader: pleaders
pleasant: pleasant,pleasanter,pleasantest
pleasantly: pleasantly
pleasantry: pleasantry
pleased: pleased
pleasing: pleasing
pleasure: pleasure,pleasures
plectrum: plectrum
plentiful: plentiful
plentifully: plentifully
plenty: plenty
pliable: pliable
pliancy: pliancy
plot: plot,plots,plotted,plotting
plough: plough
pluck: plucking
plunder: plunder
plunge: plunged
plural: plural
plurality: plurality
plutarch: plutarch
pluto: pluto
poem: poem,poems
poesy: poesy
poet: poet,poets
poetical: poetical
poetry: poetry
poison: poison
pol: pol
pole: pole
polemical: polemical
police: police
policy: policy
polis: polis
polish: polish
polished: polished
polit: polit
polite: polite
politeness: politeness
politic: politic
political: political
politician: politician,politicians
politics: politics
polity: polity
pollute: pollute
pollution: pollution
polygamist: polygamist
polygamy: polygamy
polyphonous: polyphonous
pomp: pomp
pompous: pompous
pool: pool
poor: poor,poorest
popular: popular
population: population
portion: portion,portions
portionless: portionless
portrait: portrait,portraits
portuguese: portuguese
poseidon: poseidon
position: position,positions
positive: positive
positively: positively
positiveness: positiveness
possess: possess,possessed,possesses,possessing
possession: possession,possessions
possessor: possessor,possessors
posset: posset
possibility: possibilities,possibility
post: posted,posts
posterior: posterior
posteriori: posteriori
posterity: posterity
pot: pots
potent: potent
potently: potently
potter: potter,potters
pottery: pottery
pour: pour,poured,pouring,pours
poverty: poverty
power: power,powers
powerful: powerful
powerless: powerless
practicability: practicability
practicable: practicable
practical: practical
practically: practically
practice: practice,practices
practise: practise,practised,practises,practising
practitioner: practitioner
praise: praise,praised,praises,praising
praiseworthy: praiseworthy
pramnian: pramnian
prater: prater
prattler: prattlers
pray: pray,prayed,praying
prayer: prayer,prayers
preach: preaches
preacher: preachers
preamble: preamble
precarious: precarious
precaution: precautions
precede: precede,preceded,precedes,preceding
precedence: precedence
precept: precept,precepts
precious: precious
precipitate: precipitated
precise: precise
precisely: precisely
precision: precision
predecessor: predecessors
predicament: predicament,predicaments
predicate: predicated
predication: predication
predict: predict
preface: prefaces
prefer: prefer,preferred,preferring,prefers
preferable: preferable
preference: preference
pregnant: pregnant
prejudice: prejudice,prejudices
preliminary: preliminary
prelude: prelude
prematurely: prematurely
premise: premised,premises
preparation: preparation
prepare: prepare,prepared,prepares,preparing
prepared: prepared
prescribe: prescribe,prescribed,prescribes,prescribing
prescribed: prescribed
prescription: prescriptions
presence: presence
presentiment: presentiment
presently: presently
preservation: preservation
preservative: preservative
preserve: preserve,preserved,preserves,preserving
preside: preside,presided,presides,presiding
press: pressing
pressure: pressure
presume: presume,presumed
presuppose: presuppose
pretence: pretence
pretend: pretend,pretended,pretending,pretends
pretender: pretenders
pretension: pretension
pretext: pretext
pretty: pretty
prevail: prevail,prevailed,prevailing,prevails
prevalence: prevalence
prevalent: prevalent
prevent: prevent,prevented,preventing,prevents
prevention: prevention
preventive: preventive
previous: previous
prey: prey,preying
priam: priam
price: price
pride: pride
priest: priest,priests
priestess: priestess,priestesses
prima: prima
primary: primary
prime: prime
primitive: primitive
prince: prince,princes
principal: principal,principals
principality: principalities
principally: principally
principle: principle,principles
print: print,printed
prior: prior
priori: priori
prison: prison,prisons
prisoner: prisoner,prisoners
prithee: prithee
private: private
privately: privately
privilege: privilege,privileges
prize: prize,prizes
probability: probabilities,probability
probable: probable
probation: probation
probe: probe
proc: proc
proceed: proceed,proceeded,proceeding,proceeds
proceeding: proceeding
proceedings: proceedings
proceeds: proceeds
process: process,processes
processing: processing
procession: procession
proclaim: proclaim,proclaimed,proclaiming,proclaims
proclamation: proclamation
procreation: procreation
procure: procure,procured,procuring
prodigal: prodigal
produce: produce,produced,produces,producing
producer: producers
product: product,products
production: production,productions
profane: profane
profess: profess,professed,professes,professing
profession: profession,professions
professional: professional
professor: professor,professors
profit: profit,profited,profits
profitable: profitable
profound: profound,profounder
profoundly: profoundly
progenitor: progenitors
progeny: progeny
programme: programme
progress: progress,progressing
progression: progression
prohibit: prohibit,prohibited,prohibits
prohibition: prohibition
prohibitory: prohibitory
project: project,projecting
prolixity: prolixity
prolong: prolonged
prominent: prominent
prominently: prominently
promiscuous: promiscuous
promise: promise,promised,promises,promising
promising: promising
promote: promoted,promoting
promotion: promotion
prone: prone
pronounce: pronounce,pronounces
proof: proof,proofs
proofread: proofread
proper: proper
properly: properly
property: properties,property
prophecy: prophecy
prophet: prophet,prophets
prophetic: prophetic
propitiate: propitiate,propitiated
proportion: proportion,proportioned,proportions
proportional: proportional
proposal: proposal,proposals
propose: propose,proposed,proposes,proposing
proposition: proposition,propositions
propound: propound
proprietary: proprietary
propriety: propriety
prosaic: prosaic
proscribe: proscribing
prose: prose
prosecute: prosecute,prosecuted
prosecution: prosecutions
prosper: prosper
prosperity: prosperity
prostitute: prostitute
prostitution: prostitution
prostrate: prostrated
protect: protect,protected,protects
protection: protection
protector: protector,protectors
protest: protest,protesting
protestant: protestant
proteus: proteus
protract: protracted
proudly: proudly
prove: prove,proved,proven,proves,proving
proverb: proverb,proverbs
proverbial: proverbial
provide: provide,providing
providence: providence
providentially: providentially
province: province
provision: provision,provisions
provisional: provisional
provisionally: provisionally
provocation: provocation
provoke: provoke,provoking
prow: prow
prowess: prowess
prowl: prowl
prudence: prudence
prudent: prudent
pruning: pruning
psalmist: psalmists
psychology: psychology
public: public
publication: publication
publish: published
puffing: puffing
pugnacious: pugnacious
pugnaciously: pugnaciously
pull: pull,pulling,pulls
pulley: pulleys
pulpit: pulpit
pulse: pulse
punish: punish,punished,punishes
punishment: punishment,punishments
punitive: punitive
punning: punning
puny: puny
pupil: pupil,pupils
puppet: puppets
puppy: puppies,puppy
purchase: purchase
purchaser: purchaser,purchasers
pure: pure,purer,purest
purely: purely
purgation: purgation
purgatory: purgatory
purge: purge,purged,purges,purging
purification: purification
purify: purified,purifying
puritan: puritan
purity: purity
purple: purple
purport: purport
purpose: purpose,purposes
purse: purse,purses
pursue: pursue,pursued,pursues,pursuing
pursuit: pursuit,pursuits
purveyor: purveyor
push: push,pushes
puzzle: puzzle,puzzled,puzzling
puzzled: puzzled
pyre: pyre
pythagoras: pythagoras
pythagorean: pythagorean
pythagoreanism: pythagoreanism
pythagoreans: pythagoreans
pythian: pythian
quaint: quaint
quaintly: quaintly
qualification: qualification
qualified: qualified
qualify: qualified
quality: qualities,quality
quantitative: quantitative
quantity: quantities,quantity
quarrel: quarrel,quarrelled,quarrelling,quarrels
quarrelling: quarrelling
quarry: quarry
quarter: quarter,quartered,quarters
queen: queen
quell: quelled
querist: querist
query: queries
question: question,questioned,questioning,questions
questionable: questionable
questioning: questioning
qui: qui
quick: quick,quicker,quickest
quicken: quicken,quickened,quickens
quickness: quickness
quiet: quiet
quietly: quietly
quietus: quietus
quip: quips
quiver: quiver
quotation: quotations
quote: quoted,quotes,quoting
rabble: rabble
race: race,races
rack: rack,racked
radiant: radiant
rage: rage,raging
raid: raid
rail: railing
rain: rain
rainbow: rainbow
raise: raise,raised,raises,raising
raiser: raiser
raising: raising
rampart: rampart
ramus: ramus
random: random
range: range
rank: rank,ranked,ranks
ransom: ransom
rape: rape
raphael: raphael
rapid: rapid
rapidity: rapidity
rapture: rapture,raptures
rapturous: rapturous
rare: rare
rarely: rarely
rasa: rasa
rascality: rascalities
rase: rase
rate: rate
ratify: ratifying
ratio: ratio,ratios
rational: rational
rationally: rationally
raven: ravens
ravenous: ravenous
ravish: ravish,ravished
reach: reach,reached,reaches,reaching
react: react
reaction: reaction,reactions
reactionary: reactionary
read: read,reading
readable: readable
reader: reader,readers
readiness: readiness
reading: reading
ready: ready
real: real
realise: realised
reality: realities,reality
realization: realization
realize: realize,realized
realm: realm,realms
reap: reap,reaped
reappear: reappear,reappeared,reappearing,reappears
rear: rear,reared
reascend: reascend,reascended
reason: reason,reasoned,reasons
reasonable: reasonable
reasonableness: reasonableness
reasoner: reasoners
reasoning: reasoning
reassertion: reassertion
reassume: reassumes
rebel: rebel,rebelling
rebellion: rebellion
rebellious: rebellious
rebuild: rebuilt
rebuke: rebuke,rebuked,rebuking
recall: recall,recalled,recalls
recapitulate: recapitulate
recapitulation: recapitulation
receipt: receipt
receive: receive,received,receives,receiving
receiver: receiver,receivers
recess: recesses
recital: recitals
recitation: recitation
recite: recited,recites,reciting
reciter: reciters
reckless: reckless
recklessness: recklessness
reckon: reckoned,reckoning
recline: reclining
recognise: recognise,recognised
recognition: recognition
recognize: recognize,recognized,recognizes
recollect: recollect
recollection: recollection
recommend: recommends
recompense: recompensed,recompenses
reconcile: reconciled
reconcilement: reconcilement,reconcilements
reconciliation: reconciliation
reconstruct: reconstructed
record: record,recorded,records
recount: recounting
recourse: recourse
recover: recover,recovered
recoverable: recoverable
recovery: recovery
recreation: recreation
rector: rector
recur: recurring,recurs
recurrence: recurrence
red: red
reddish: reddish
redeem: redeem
redistribute: redistribute,redistributing
redistributing: redistributing
redistribution: redistribution
redouble: redoubles
reduce: reduce,reduced,reduces
reductio: reductio
reed: reeds
reef: reef
refer: refer,referred,referring,refers
reference: reference,references
refine: refine
refined: refined
refinement: refinement,refinements
refiner: refiner
refining: refining
reflect: reflect,reflected,reflecting,reflects
reflection: reflection,reflections
reflex: reflex
reform: reform,reforms
reformation: reformation
reformer: reformer,reformers
refractory: refractory
refrain: refrain
refreshment: refreshments
refuge: refuge
refund: refund
refusal: refusal
refuse: refuse,refused,refuses,refusing
refutation: refutation
refute: refute,refuted,refuting
regard: regard,regarded
regardlessness: regardlessness
regenerate: regenerating
regime: regime
regimen: regimen
region: region,regions
register: registered
regret: regret,regrets
regular: regular
regularity: regularity
regularly: regularly
regulate: regulate,regulated,regulating
regulation: regulation,regulations
rehearse: rehearsing
reign: reign,reigns
reillumine: reillumine
rein: reins
reject: reject,rejected,rejecting,rejects
rejection: rejection
rejoice: rejoice,rejoiced,rejoices,rejoicing
rejoin: rejoin,rejoined
relate: relate,relates,relating
relation: relation,relations
relationship: relationship
relative: relative,relatives
relax: relax
relaxation: relaxation
relaxed: relaxed
release: release,released
relic: relic
relief: reliefs
relieve: relieve
relight: relighted
religion: religion,religions
religious: religious
relish: relish
reluctance: reluctance
reluctant: reluctant
reluctantly: reluctantly
rely: rely
remain: remain,remained,remaining,remains
remainder: remainder
remains: remains
remark: remark,remarked,remarking,remarks
remarkable: remarkable
remarkably: remarkably
rembrandt: rembrandt
remedy: remedies,remedy
remember: remember,remembered,remembering,remembers
remembrance: remembrance
remind: remind,reminded,reminding,reminds
reminiscence: reminiscence
remnant: remnant
remorse: remorse
remorselessly: remorselessly
remote: remote,remoter
remove: remove,removed,removing
remuneration: remuneration
renaissance: renaissance
rename: renamed
render: render,rendered,rendering,renders
renew: renew
renounce: renounce,renounced,renounces
renown: renown
renowned: renowned
repair: repair
repast: repast
repay: repaid,repay
repayment: repayment
repeat: repeat,repeated,repeating,repeats
repel: repel
repent: repented
repertory: repertory
replace: replace,replaced
replacement: replacement
reply: replied,replies,reply,replying
report: report,reported,reports
repose: repose
repository: repositories
represent: represent,represented,representing,represents
representation: representation,representations
representative: representative,representatives
repress: repress,repressed,represses
reproach: reproach,reproached,reproaches,reproaching
reproachful: reproachful
reprobation: reprobation
reproduce: reproduce
reprove: reprove
reprover: reprovers
republic: republic,republics
republica: republica
republicanism: republicanism
repudiate: repudiating
repugnance: repugnance
repulsion: repulsion
reputation: reputation,reputations
repute: reputed
reputed: reputed
request: request,requested,requesting,requests
require: require,required,requires,requiring
requirement: requirement,requirements
rescue: rescue
resemblance: resemblance,resemblances
resemble: resemble,resembled,resembles,resembling
resent: resent
resentment: resentment
reserve: reserve,reserving
reside: reside,resides
residue: residue,residues
resignation: resignation
resist: resist,resisted,resisting,resists
resistance: resistance
resolution: resolution
resolvable: resolvable
resolve: resolve,resolved
resort: resort
resound: resounds
resource: resources
respect: respect,respecting
respectability: respectability
respectable: respectable
respectful: respectful
respective: respective
respects: respects
respondent: respondent,respondents
response: response
responsibility: responsibility
responsible: responsible
responsive: responsive
rest: rest,rested,resting,rests
restatement: restatement
restless: restless
restorative: restorative
restore: restore,restored,restores,restoring
restrain: restrain,restrained
restraint: restraint
restrict: restricted,restricting
restriction: restrictions
result: result
resume: resumed,resumes,resuming
resurrection: resurrection
retail: retail
retailer: retailer,retailers
retain: retain,retained,retaining,retains
retainer: retainers
retaliate: retaliate,retaliated
retaliation: retaliation
retentive: retentive
reticence: reticence
reticent: reticent
retire: retire,retired,retires,retiring
retirement: retirement
retort: retort
retrace: retrace,retraced
retract: retract
retribution: retribution
return: return,returned,returning,returns
reunite: reunites
reveal: reveal,revealed,revealing,reveals
revelation: revelation,revelations
revelling: revellings
revelry: revelries,revelry
revenge: revenged
revengeful: revengeful
revenue: revenue,revenues
revere: revered
reverence: reverence,reverenced
reverend: reverend
reverential: reverential
reverently: reverently
reverse: reverse,reversed
revert: revert,reverted,reverts
review: review,reviewed
revile: revile,reviles
revival: revival
revive: revive,reviving
revolt: revolted,revolts
revolting: revolting
revolution: revolution,revolutions
revolutionize: revolutionized
revolve: revolves,revolving
revolving: revolving
reward: reward,rewarded,rewards
rhapsodist: rhapsodist,rhapsodists
rhet: rhet
rhetoric: rhetoric
rhetorical: rhetorical
rhetorician: rhetorician,rhetoricians
rhythm: rhythm,rhythms
rhythmical: rhythmical
ribbon: ribbon
rich: rich,richer,richest
riches: riches
rid: rid
riddle: riddle,riddles
ride: ride,riding
ridicule: ridicule,ridiculed,ridicules
ridiculous: ridiculous
ridiculously: ridiculously
riding: riding
rife: rife
righteous: righteous
righteousness: righteousness
rightful: rightful
rightly: rightly
rigidly: rigidly
rim: rim,rims
riotous: riotous
ripe: ripe
riper: riper
rise: rise,rises,rising
risible: risible
risk: risk,risks
rite: rite,rites
ritual: ritual
rival: rival,rivals
river: river,rivers
road: road
roar: roar,roared
roast: roast
rob: rob,robbing,robs
robber: robbers
robe: robe,robes
robust: robust
rock: rock,rocks
rogue: rogue,rogues
roguery: rogueries
roll: roll,rolling
rolling: rolling
roman: roman,romans
romance: romance
romanized: romanized
rome: rome
roof: roof
root: root,roots
rope: rope
roses: roses
rot: rot
rotation: rotations
rough: rough,rougher
rounded: rounded
rouse: roused,rouses
rousseau: rousseau
rout: rout
routine: routine
royal: royal
royalty: royalties,royalty
rub: rub,rubbed,rubbing
rude: rude
rudely: rudely
rudiment: rudiments
rugged: rugged
ruin: ruin,ruined,ruins
ruinous: ruinous
rule: rule,ruled,rules,ruling
ruler: ruler,rulers
ruling: ruling
rumour: rumour
runner: runner,runners
rush: rush,rushed,rushes,rushing
russia: russia
rust: rust
rustic: rustic
sacred: sacred
sacredness: sacredness
sacrifice: sacrifice,sacrificed,sacrifices,sacrificing
sacrilege: sacrilege
sad: sad,saddest
sadly: sadly
safe: safe,safer
safeguard: safeguard
safely: safely
safety: safety
sagacity: sagacity
sage: sage,sages
sail: sailing,sails
sailing: sailing
sailor: sailor,sailors
saint: saint,saints
saith: saith
sake: sake,sakes
salamis: salamis
sale: sale
salesman: salesmen
salt: salt
salutary: salutary
salute: salute,saluted,salutes
salvation: salvation
sameness: sameness
sample: samples
sanctify: sanctifying
sanction: sanction,sanctioned,sanctioning
sanctuary: sanctuary
sanguine: sanguine
sanitary: sanitary
sapless: sapless
sarpedon: sarpedon
satellite: satellites
satiety: satiety
satire: satire
satirical: satirical
satirize: satirized,satirizing
satisfaction: satisfaction,satisfactions
satisfactorily: satisfactorily
satisfactory: satisfactory
satisfied: satisfied
satisfy: satisfied,satisfies,satisfy,satisfying
saturn: saturn
sauce: sauces
savage: savage
save: save,saved,saves,saving
saving: saving
savings: savings
saviour: saviour,saviours
sawn: sawn
scale: scale,scales
scamander: scamander
scandalous: scandalous
scarcely: scarcely
scare: scaring
scatter: scattered
scattered: scattered
scene: scene
scent: scent,scents
sceptical: sceptical
scepticism: scepticism
scheme: scheme,schemes
scholar: scholars
scholastic: scholastic
school: school,schooled,schools
schoolmaster: schoolmaster,schoolmasters
science: science,sciences
scientific: scientific
scimitar: scimitar
scold: scold,scolding
scolding: scolding
scoop: scooped
scorch: scorching
score: score
scorn: scorn
scourge: scourged,scourges
scrap: scraps
scrape: scrape
screen: screen
scripture: scripture,scriptures
scriptures: scriptures
scruple: scruple
sculptor: sculptor,sculptors
sculpture: sculpture
scylla: scylla
scythian: scythian
sea: sea
seal: seal
seaman: seaman
seamy: seamy
search: search,searching
season: season,seasons
seasoning: seasoning
seat: seat,seated,seats
seaweed: seaweed
secondary: secondary
secret: secret,secrets
secretly: secretly
sect: sect,sects
secure: secure,secured
securely: securely
sedition: sedition
seditious: seditious
seduce: seduced
seducer: seducers
seduction: seductions
seed: seed,seeds
seek: seek,seeking,seeks,sought
seeker: seeker
seemingly: seemingly
seer: seer
segment: segments
seize: seize,seized,seizes,seizing
seldom: seldom
select: select,selected,selecting
selection: selection
selfishness: selfishness
sell: sell,selling,sells,sold
seller: sellers
selling: selling
semblance: semblance
semicircle: semicircle
send: send,sending,sends
sensation: sensation
sense: sense
senseless: senseless
sensibility: sensibility
sensitive: sensitive
sensual: sensual
sensuality: sensuality
sentence: sentence,sentenced,sentences
sentiment: sentiment,sentiments
sentimentalism: sentimentalism
sentinel: sentinels
separable: separable
separate: separate,separated,separates,separating
separately: separately
separation: separation
september: september
sepulture: sepulture
sequel: sequel
sequence: sequence
serf: serf,serfs
series: series
serio: serio
seriousness: seriousness
sermon: sermon
serpent: serpent
servant: servant,servants
serve: serve,served,serves
service: service,services
serviceable: serviceable
servile: servile
servility: servility
serving: serving
servitude: servitude
sesqui: sesqui
set: set,sets,setting
settle: settle,settled,settling
settled: settled
seventeen: seventeen
seventh: seventh
sever: severed
severally: severally
severe: severe,severer
severest: severest
severity: severity
sex: sex,sexes
shabby: shabby
shade: shade
shades: shades
shadow: shadow,shadows
shadowy: shadowy
shaft: shaft,shafts
shake: shaken,shakes,shaking
shakespeare: shakespeare
sham: sham
shame: shame
shameful: shameful
shape: shape,shaped,shapes
share: share,shared,shares,sharing
sharer: sharers
sharp: sharp
sharpen: sharpening
sharply: sharply
shave: shave
sheep: sheep
sheer: sheer
shelter: shelter
shepherd: shepherd,shepherds
shield: shield
shine: shine,shines,shining,shone
ship: ship,ships
shipboard: shipboard
shipwreck: shipwreck
shipwright: shipwright
shoe: shod,shoes
shoemake: shoemaking
shoemaker: shoemaker,shoemakers
shoemaking: shoemaking
shoot: shoot,shooting,shot
shop: shop
shopkeeper: shopkeeper,shopkeepers
shore: shore,shores
short: short,shorter
shorten: shortened
shortly: shortly
shortness: shortness
shoulder: shoulder,shoulders
shouting: shouting
shower: shower
showy: showy
shred: shreds
shrewd: shrewd
shrewdly: shrewdly
shrilling: shrilling
shrink: shrank,shrink
shroud: shrouded
shudder: shudder
shuffle: shuffle
shut: shut
sic: sic
sicilian: sicilian
sicily: sicily
sick: sick
sickly: sicklied,sickly
sickness: sickness
sided: sided
siege: siege
sieve: sieve
sight: sight,sights
sighted: sighted
sign: sign,signs
significance: significance
silence: silence,silenced
silent: silent
silently: silently
silenus: silenus
silliness: silliness
silver: silver
similarity: similarities,similarity
simile: simile
similitude: similitude
simple: simple,simpler,simplest
simpleton: simpleton,simpletons
simplicity: simplicity
simply: simply
simultaneous: simultaneous
sin: sin,sinned,sinning,sins
sinew: sinews
sing: sang,sing,singing,sung
singer: singers
singing: singing
single: single
singly: singly
singular: singular
sink: sink,sunk
sinner: sinners
sir: sir,sirs
sire: sires
siren: siren,sirens
sirens: sirens
sister: sister,sisters
sit: sat,sit,sits,sitting
situate: situated
situation: situation,situations
sixteenth: sixteenth
sixth: sixth
size: size,sizes
sketch: sketch
skilful: skilful
skill: skill
skilled: skilled
skin: skin
skip: skips
skulk: skulk,skulking
sky: sky
slander: slander
slaughter: slaughtered,slaughtering
slave: slave,slaves,slaving
slavery: slavery
slavish: slavish
slay: slain,slays
slaying: slaying
sleep: sleep,sleeping
sleepy: sleepy
sleet: sleet
slender: slender
slenderly: slenderly
slew: slew
slice: slice
slight: slight,slighting,slights
slily: slily
slink: slinking,slinks
slip: slip
slippery: slippery
slough: slough
slow: slow,slower
slowly: slowly
slowness: slowness
slumber: slumbering
sly: sly
smallness: smallness
smell: smell
smile: smiles,smiling
smite: smiting,smote
smith: smiths
smoke: smoke
smooth: smooth,smoothing
smother: smother
snake: snake
snatch: snatch,snatches
sneer: sneered
snivel: snivel
snub: snub
soap: soap
soar: soar
sober: sober
sobriety: sobriety
social: social
socialism: socialism
society: societies,society
socrates: socrates
socratic: socratic
soda: soda
sofa: sofas
soft: soft,softer
soften: softened,softening
softening: softening
softness: softness
soil: soil
soldier: soldier,soldiers
solely: solely
solemn: solemn
solemnly: solemnly
solicit: solicit
solicitation: solicitation
solid: solid,solids
solitary: solitary
solitude: solitude
solomon: solomon
solon: solon
solution: solution
solve: solved
solvent: solvents
son: son,sons
song: song,songs
sons: sons
soothe: soothe,soothed,soothing
soothing: soothing
sooty: sooty
soph: soph
sophism: sophisms
sophist: sophist,sophists
sophistical: sophistical
sophists: sophists
sophocles: sophocles
sordid: sordid
sore: sore
sorrow: sorrow,sorrowing,sorrows
sorrowful: sorrowful
sort: sort,sorts
soul: soul,souls
sound: sound,sounding,sounds
source: source
sovereign: sovereign
sow: sown
space: space
span: span
spangle: spangled
spangled: spangled
spare: spare
spark: spark,sparks
sparta: sparta
spartan: spartan,spartans
speak: speak,speaking,speaks,spoke,spoken
speaker: speaker,speakers
speaking: speaking
spear: spear
special: special
specially: specially
species: species
specimen: specimens
specious: specious
spectacle: spectacle
spectator: spectator,spectators
speculation: speculation,speculations
speculative: speculative
speculator: speculators
speech: speech,speeches
speed: speed
speedily: speedily
speedy: speedy
spell: spell
spend: spend,spending,spends,spent
spending: spending
spendthrift: spendthrift,spendthrifts
sphere: sphere,spheres
spin: spin,spun
spindle: spindle
spirit: spirit,spirits
spirited: spirited
spiritual: spiritual
spite: spite
splendid: splendid
splendour: splendour
spoil: spoil,spoiled,spoiling,spoils,spoilt
spoiled: spoiled
spoilt: spoilt
spoke: spoke
spontaneously: spontaneously
sport: sport,sports
spot: spot
spread: spread
spring: spring,springs,sprung
sprinkle: sprinkled
spurious: spurious
squalid: squalid
square: square,squared,squares,squaring
squared: squared
squaring: squaring
squeezable: squeezable
squeeze: squeezed
staff: staff
stag: stag,stags
stage: stage,stages
stain: stain,stained
stake: stake
staleness: staleness
stalk: stalks
stamp: stamp
stand: stand,standing,stands,stood
standard: standard
star: star,stars
starry: starry
start: start,started,starting,starts
starting: starting
startle: startles
starvation: starvation
starve: starve,starving
stately: stately
statement: statement,statements
statesman: statesman,statesmen
station: station
stationary: stationary
statuary: statuary
statue: statue,statues
stature: stature
status: status
stay: stay
stead: stead
steadfast: steadfast
steadily: steadily
steadiness: steadiness
steady: steady
steal: steal,stealing,steals
stealer: stealers
stealth: stealth
steed: steeds
steel: steel
steep: steep
steer: steer
steerer: steerer
steering: steering
stem: stem
step: step,steps
sterility: sterility
stern: stern
sterner: sterner
sternly: sternly
steward: steward
stick: sticking,sticks
stimulant: stimulants
stimulate: stimulate,stimulated,stimulating
stimulus: stimulus
sting: sting,stings
stinger: stingers
stingless: stingless
stir: stir,stirred,stirring,stirs
stock: stock,stocked
stoic: stoic,stoics
stoical: stoical
stoics: stoics
stolid: stolid
stone: stone,stones
stoop: stooped,stooping
store: store,stored,stores
storm: storm
story: stories,story
stout: stout
stoutly: stoutly
straight: straight
straightway: straightway
strain: strain,strained,straining,strains
strait: strait
straiten: straitened
strange: strange
strangely: strangely
strangeness: strangeness
stranger: stranger,strangers
stratagem: stratagem,stratagems
straw: straw
stream: stream,streaming
street: streets
strength: strength
strengthen: strengthen,strengthening,strengthens
strengthening: strengthening
strenuously: strenuously
stretch: stretching
strew: strewn
stricken: stricken
strict: strict,stricter,strictest
strictly: strictly
strictness: strictness
strife: strife
strike: strike,strikes,striking,struck
striking: striking
string: string,strings
stringed: stringed
strip: strip,stripped
strive: strive,striving
strong: strong,stronger,strongest
structure: structure
struggle: struggle,struggled,struggles,struggling
student: student,students
study: studied,studies,study,studying
stuff: stuff
stumble: stumble,stumbled
stupid: stupid
stupidity: stupidity
sturdy: sturdy
style: style,styled,styles
styx: styx
subdivide: subdivide,subdivided
subdivision: subdivision,subdivisions
subdue: subdue,subdued,subdues,subduing
subject: subject,subjected,subjects
subjection: subjection
subjective: subjective
subjectively: subjectively
subjectiveness: subjectiveness
sublime: sublime
sublimity: sublimity
submission: submission
submit: submit
subordinate: subordinate,subordinates
subscribe: subscribe
substance: substance,substances
substantial: substantial
substitute: substitute,substituted
subtend: subtending
subtle: subtle
subtlety: subtleties
subtract: subtracting
subversive: subversive
succeed: succeed,succeeded,succeeding,succeeds
success: success,successes
succession: succession
successive: successive
successively: successively
successor: successor,successors
succour: succoured
suck: sucked
suckle: suckle
suckling: suckling
sudden: sudden
suddenly: suddenly
sue: sue
suffer: suffer,suffered,suffering,suffers
sufferer: sufferer,sufferers
suffering: suffering,sufferings
suffice: suffice,sufficing
sufficient: sufficient
sufficing: sufficing
suffrage: suffrage
suggestion: suggestion
suggestive: suggestive
suicidal: suicidal
suit: suit,suited,suits
suitable: suitable
suited: suited
suitor: suitor,suitors
sullenness: sullenness
sum: sum,summed,sums
summer: summer
summit: summit
summons: summons
sun: sun,suns
sunburnt: sunburnt
sundry: sundry
sunken: sunken
suns: suns
sunshine: sunshine
super: super
supercilious: supercilious
superficial: superficial
superfluity: superfluity
superfluous: superfluous
superhuman: superhuman
superintend: superintend
superintendence: superintendence
superintendent: superintendent
superior: superior,superiors
superiority: superiority
superlative: superlatives
supernatural: supernatural
supersede: superseded
superstition: superstition
superstitious: superstitious
supper: supper
supplement: supplemented
supplementary: supplementary
supplicate: supplicating
supply: supplied,supplies,supply,supplying
support: support,supported,supporting,supports
supporter: supporter,supporters
suppose: suppose,supposed,supposes,supposing
supposition: supposition,suppositions
supposititious: supposititious
suppress: suppress,suppressed
supremacy: supremacy
supreme: supreme
supremely: supremely
surely: surely
surface: surface,surfaces
surfeit: surfeited
surmount: surmounting
surpass: surpassed,surpasses
surplus: surplus
surprise: surprise
surprised: surprised
surprising: surprising
surprize: surprized
surrender: surrender
surrey: surrey
surround: surround,surrounded,surrounding
surroundings: surroundings
survey: survey
survival: survival
survive: survive,surviving
suspect: suspect,suspected
suspend: suspended
suspicion: suspicion,suspicions
suspicious: suspicious
suspiciousness: suspiciousness
sustain: sustained,sustaining,sustains
sustenance: sustenance
swaddle: swaddle
swallow: swallowed,swallows
swamp: swamp
swan: swan
swarm: swarm
swathe: swathe
sway: sway
sweep: swept
sweet: sweet,sweets
sweetly: sweetly
sweetness: sweetness
swell: swell,swelling
swift: swift,swifter,swiftest
swiftness: swiftness
swim: swim
swimming: swimming
swindler: swindlers
swinish: swinish
sword: sword
syllable: syllables
syllogism: syllogism
symbol: symbol,symbols
symbolical: symbolical
symbolism: symbolism
symbolize: symbolized
symmetry: symmetry
sympathetic: sympathetic
sympathise: sympathise,sympathising
sympathize: sympathize,sympathizes
sympathy: sympathies,sympathy
symphony: symphony
symposium: symposium
synonymous: synonymous
synthesis: synthesis
synthetical: synthetical
syracusan: syracusan
table: table,tables
tablet: tablet
tabula: tabula
tactic: tactics
taint: taint
tale: tale,tales
talent: talent
talk: talk,talked,talking,talks
tall: tall,taller
tame: tame,tamed,taming
tangible: tangible
tangled: tangled
tarry: tarried
tartarean: tartarean
task: task,tasks
taste: taste,tasted,tastes,tasting
tavern: taverns
tax: tax,taxes
taxation: taxation
teach: taught,teach,teaches,teaching
teacher: teacher,teachers
teaching: teaching
tear: tear,tearing,tears
tease: tease
technical: technical
tedious: tedious
teem: teems
telamon: telamon
teller: teller,tellers
telling: telling
temper: temper,tempered,tempers
temperament: temperament
temperance: temperance
temperate: temperate
temperately: temperately
temple: temple,temples
temporal: temporal
temporary: temporary
tempt: tempt,tempted
temptation: temptation,temptations
tenacity: tenacity
tend: tend,tended,tending
tendency: tendencies,tendency
tender: tender
tenfold: tenfold
tennyson: tennyson
tenor: tenor
tent: tents
tentative: tentative
tenth: tenth,tenths
tenure: tenure
term: term,termed,terms
terrible: terrible
territory: territory
terror: terror,terrors
testament: testament
testify: testifies
testimony: testimony
tetrachord: tetrachord
texture: texture
thamyras: thamyras
theatre: theatre
theatrical: theatrical
theatricals: theatricals
theatrocracy: theatrocracy
theban: theban
thee: thee
theft: theft
theme: theme
themis: themis
theologian: theologians
theological: theological
theology: theology
theorist: theorists
theory: theories,theory
thersites: thersites
theseus: theseus
thesis: theses,thesis
thetis: thetis
thicket: thicket
thickly: thickly
thickness: thickness
thief: thief,thieves
thieving: thieving
thine: thine
thinker: thinker,thinkers
thinking: thinking
thinness: thinness
thirdly: thirdly
thirst: thirst,thirsting,thirsts
thirsty: thirsty
thither: thither
thomas: thomas
thorn: thorns
thorny: thorny
thoughtless: thoughtless
thracian: thracian
thread: thread,threads
threaten: threatened
threshold: threshold
thrice: thrice
thrive: thriving
throat: throat,throats
throne: throne,thrones
throng: throng
throw: threw,throw,throwing,thrown,throws
thrust: thrust,thrusts
thunder: thunder
thunderbolt: thunderbolt
thunderstorm: thunderstorm,thunderstorms
thy: thy
tiara: tiara
tide: tide,tides
tie: tie,ties
tight: tighter
tightening: tightening
tillage: tillage
tim: tim
timaeus: timaeus
timber: timber
time: time,times
timid: timid
timocracy: timocracy
timocratic: timocratic
timocratical: timocratical
tinker: tinker
tire: tire
tiresias: tiresias
tiresome: tiresome
tirewomen: tirewomen
title: title,titles
toil: toil,toiling,toils
toiling: toiling
toilsome: toilsome
token: token
tolerable: tolerable
tolerably: tolerably
tolerant: tolerant
tolerate: tolerate,tolerated
toleration: toleration
toll: tolls
tomb: tomb
tone: tone,toned,tones
tongue: tongue
tool: tools
tooth: teeth
topple: toppling
torch: torch,torches
torment: torment,tormented,torments
torpid: torpid
torrent: torrent,torrents
torture: torture,tortured,tortures,torturing
toss: tossing
tossing: tossing
touch: touch,touched,touches,touching
touching: touching
touchingly: touchingly
tower: tower,towering
town: town
township: township
trace: trace,traced,traces,tracing
track: track
tractable: tractable
trade: trade,trades
trademark: trademark
trader: trader,traders
tradesman: tradesmen
tradesmen: tradesmen
tradition: tradition,traditions
traditional: traditional
tragedian: tragedian,tragedians
tragedians: tragedians
tragedy: tragedies,tragedy
tragic: tragic
trail: trail
train: train,trained,training
trainer: trainer
training: training
trait: trait,traits
trammel: trammels
trample: trample,trampled
trampled: trampled
transaction: transaction
transcend: transcending
transcribe: transcribe
transcription: transcription
transfer: transferred
transform: transform,transformed,transforming
transformation: transformations
transgress: transgressed,transgresses
transgression: transgression,transgressions
transience: transience
transient: transient
transition: transition
transitional: transitional
translate: translated,translating
translation: translation
translator: translator
transmigration: transmigration
transplant: transplanted
transposition: transposition
trappings: trappings
travail: travail
travel: travel
traveller: traveller,travellers
treacherous: treacherous
treachery: treacheries,treachery
treason: treason
treasure: treasures
treasury: treasuries,treasury
treat: treat,treated,treating,treats
treatise: treatise,treatises
treatment: treatment
treaty: treaties,treaty
treble: trebled
tree: tree,trees
tremble: trembles,trembling
tremendous: tremendous
trial: trial,trials
triangle: triangle
tribe: tribe,tribes
tribunal: tribunal
tribute: tribute
trick: trick,tricks
trifle: trifles
trifling: trifling
trinity: trinity
trireme: trireme
triumph: triumph
triumphing: triumphing
trochaic: trochaic
trojan: trojan
troops: troops
trouble: trouble,troubles,troubling
troubled: troubled
troublesome: troublesome
troy: troy
true: true,truer,truest
trumpet: trumpets
trust: trust,trusted,trusting,trusts
trusted: trusted
trustee: trustee
trustworthy: trustworthy
trusty: trusty
truth: truth,truths
truthfulness: truthfulness
tumble: tumbling
tumult: tumult
tuner: tuner
turner: turner
tutor: tutor,tutors
twelfth: twelfth
twentieth: twentieth
twilight: twilight
twin: twin
twist: twisting,twists
twofold: twofold
type: type,types
tyrannical: tyrannical
tyrannize: tyrannized,tyrannizes,tyrannizing
tyranny: tyrannies,tyranny
tyrant: tyrant,tyrants
ugliness: ugliness
ugly: ugly
ulcerous: ulcerous
ultimate: ultimate
ultimately: ultimately
umpire: umpire
unabated: unabated
unable: unable
unaccustomed: unaccustomed
unadulterated: unadulterated
unaffected: unaffected
unalterable: unalterable
unaltered: unaltered
unanimous: unanimous
unanswerable: unanswerable
unanswered: unanswered
unattainable: unattainable
unattractive: unattractive
unavoidable: unavoidable
unavoidably: unavoidably
unbecoming: unbecoming
unbeliever: unbelievers
unbelieving: unbelieving
uncertain: uncertain
uncertainty: uncertainty
uncertified: uncertified
unchangeable: unchangeable
unchangeableness: unchangeableness
uncivilized: uncivilized
uncle: uncle,uncles
uncommon: uncommon
unconnected: unconnected
unconquerable: unconquerable
unconscious: unconscious
unconsciously: unconsciously
unconsciousness: unconsciousness
unconsecrated: unconsecrated
uncontrolled: uncontrolled
unconvinced: unconvinced
uncover: uncovered
uncritical: uncritical
undazzle: undazzled
undazzled: undazzled
undecided: undecided
undefended: undefended
undefiled: undefiled
underfoot: underfoot
undergo: undergoes,undergoing,underwent
underground: underground
undermine: undermined
understand: understand,understanding,understands,understood
understanding: understanding
undertake: undertake
undertone: undertone
undeservedly: undeservedly
undesirable: undesirable
undetected: undetected
undetermined: undetermined
undistinguished: undistinguished
undivided: undivided
undoubtedly: undoubtedly
uneducated: uneducated
unenforceability: unenforceability
unenlightened: unenlightened
unenlightenment: unenlightenment
unequal: unequal,unequals
unerring: unerring
unexamined: unexamined
unexplained: unexplained
unexplored: unexplored
unfair: unfair
unfamiliar: unfamiliar
unfavourable: unfavourable
unfinished: unfinished
unfit: unfit
unfitted: unfitted
unfortunate: unfortunate
unfrequently: unfrequently
ungifted: ungifted
ungraceful: ungraceful
ungrateful: ungrateful
unguarded: unguarded
unhappily: unhappily
unhappiness: unhappiness
unhappy: unhappy
unhealthy: unhealthy
unheard: unheard
unhesitatingly: unhesitatingly
unholy: unholy
uniform: uniform
uniformity: uniformities,uniformity
unimpaired: unimpaired
unimportant: unimportant
uninformed: uninformed
uninstructed: uninstructed
unintelligible: unintelligible
unintentionally: unintentionally
uninterruptedly: uninterruptedly
uninvited: uninvited
uninviting: uninviting
union: union,unions
unique: unique
unit: unit,units
unite: unite,united,uniting
united: united
unity: unity
universal: universal,universals
universality: universality
universally: universally
universe: universe
university: university
unjust: unjust
unjustly: unjustly
unknown: unknown
unlawful: unlawful
unlearn: unlearn
unlimited: unlimited
unlink: unlink
unmanliness: unmanliness
unmanly: unmanly
unmarried: unmarried
unmeaning: unmeaning
unmerciful: unmerciful
unmindful: unmindful
unmindfulness: unmindfulness
unmingled: unmingled
unmistakable: unmistakable
unmixed: unmixed
unmusical: unmusical
unnatural: unnatural
unnaturally: unnaturally
unnecessary: unnecessary
unnoticed: unnoticed
unobserved: unobserved
unpatriotic: unpatriotic
unperceived: unperceived
unphilosophical: unphilosophical
unpleasantly: unpleasantly
unpoetical: unpoetical
unpopular: unpopular
unpopularity: unpopularity
unpractised: unpractised
unprincipled: unprincipled
unprocurable: unprocurable
unprofitable: unprofitable
unpropitious: unpropitious
unprotected: unprotected
unproven: unproven
unprovided: unprovided
unpunished: unpunished
unquestionably: unquestionably
unreal: unreal
unreality: unreality
unrealized: unrealized
unreasonable: unreasonable
unreasoning: unreasoning
unreformed: unreformed
unrefuted: unrefuted
unrighteous: unrighteous
unrighteousness: unrighteousness
unripe: unripe
unruly: unruly
unsatisfactory: unsatisfactory
unscathed: unscathed
unscrupulous: unscrupulous
unseasonable: unseasonable
unseemliness: unseemliness
unseemly: unseemly
unseen: unseen
unsettled: unsettled
unsettling: unsettling
unsightly: unsightly
unskilful: unskilful
unskilled: unskilled
unsociable: unsociable
unsolicited: unsolicited
unspeakable: unspeakable
unsubstantial: unsubstantial
unsuitable: unsuitable
unsung: unsung
untainted: untainted
untameable: untameable
untenable: untenable
untouched: untouched
untrue: untrue
untrustworthy: untrustworthy
untruth: untruth
untruthful: untruthful
unusual: unusual
unusually: unusually
unvarying: unvarying
unwarlike: unwarlike
unwearied: unwearied
unwell: unwell
unwilling: unwilling
unwillingly: unwillingly
unwillingness: unwillingness
unwise: unwise
unworthiness: unworthiness
unworthy: unworthy
unwritten: unwritten
update: updated
uphill: uphill
uplift: uplifted
upper: upper
uppermost: uppermost
uproar: uproar
upset: upset
upsetting: upsetting
upside: upside
upward: upward
uranus: uranus
urge: urged,urges,urging
useless: useless
uselessness: uselessness
user: user
usual: usual
usurer: usurer
ut: ut
utilitarian: utilitarian
utilitarianism: utilitarianism
utility: utility
utmost: utmost
utopia: utopia
utopian: utopians
utopias: utopias
utter: utter,uttered,uttering,utters
utterance: utterance
utterly: utterly
uttermost: uttermost
vacancy: vacancy
vacant: vacant
vague: vague,vaguest
vagueness: vagueness
vain: vain
vainly: vainly
valetudinarian: valetudinarian
valiant: valiant
valiantly: valiantly
valley: valley
valour: valour
valuable: valuable
valuation: valuation
vanilla: vanilla
vanish: vanish,vanished,vanishes
vanity: vanities,vanity
vanquish: vanquished
variable: variable
variableness: variableness
variance: variance
variation: variation,variations
variety: varieties,variety
variously: variously
vary: vary,varying
vassal: vassal
vast: vast
vastly: vastly
vaunt: vaunting
vegetable: vegetable,vegetables
vehemence: vehemence
vehement: vehement
vehicle: vehicle,vehicles
veil: veil,veiled,veils
vein: vein,veins
vengeance: vengeance
venture: venture
venus: venus
verbal: verbal
verbally: verbally
verdure: verdure
verification: verification
verify: verified
verily: verily
verisimilitude: verisimilitude
vernacular: vernacular
verse: verse,verses
verses: verses
version: version
vespucci: vespucci
vessel: vessel,vessels
vest: vesting
vestibule: vestibule
vestige: vestiges
veteran: veterans
vibrate: vibrates
vibration: vibrations
vicar: vicar
vice: vice,vices
vicious: vicious
viciousness: viciousness
victim: victim,victims
victor: victor,victors
victorious: victorious
victory: victory
view: view,viewed,viewing,views
viewing: viewing
vigorously: vigorously
vigour: vigour
vii: vii
viii: viii
vile: vile,vilest
village: village
villain: villain,villains
villainy: villainies
vine: vine
violate: violate,violates
violation: violation
violator: violator
violence: violence
violent: violent
violently: violently
virtue: virtue,virtues
virtuous: virtuous
virus: virus
visage: visage
visibility: visibility
visible: visible
vision: vision,visions
visionary: visionaries,visionary
visit: visit
vital: vital
vitiate: vitiate
vivid: vivid
vividly: vividly
vocation: vocation
voice: voice,voices
void: void
volcano: volcanoes
voluntarily: voluntarily
voluntariness: voluntariness
voluntary: voluntary
volunteer: volunteer,volunteers
voluptuous: voluptuous
votary: votaries,votary
vouchsafe: vouchsafe
vow: vow
voyage: voyage,voyages
voyaging: voyaging
vulgar: vulgar
vulgarity: vulgarity
waft: wafting
wage: waging
wail: wailing
wait: wait,waiting,waits
waive: waive
wake: waked,waking
wakeful: wakeful
walk: walk,walked,walking,walks
wall: wall,walls
wallow: wallowing
wander: wander,wandering,wanders
wane: waning
waning: waning
wanton: wanton
wantonness: wantonness
war: war,wars
warble: warbling
ward: ward,wards
warfare: warfare
warlike: warlike
warm: warm,warmed
warmth: warmth
warn: warned
warp: warp
warped: warped
warranty: warranties,warranty
warrior: warrior,warriors
wash: wash,washed,washes,washing
washing: washing
wasp: wasps
wast: wast
waste: waste,wasted,wastes,wasting
watch: watch,watched,watching
watchdog: watchdogs
watchfulness: watchfulness
watchman: watchman
watchword: watchwords
water: water,watering,waters
wave: wave,waves
waver: waver,wavers
wax: wax,waxes,waxing
waxen: waxen
wayfarer: wayfarer
wayward: wayward
weak: weak,weaker,weakest
weaken: weaken,weakened,weakening
weakly: weaklier,weakly
weakness: weakness,weaknesses
wealth: wealth
wealthy: wealthy
weapon: weapon,weapons
wear: wear,wearing,wears,worn
wearisome: wearisome
weary: wearied,weary
weave: weaving
weaver: weaver,weavers
weaving: weaving
weber: weber
wedding: weddings
weed: weeds
weep: weeping,wept
weigh: weigh,weighed,weighing
weight: weight,weights
welfare: welfare
wellbeing: wellbeing
wellnigh: wellnigh
wench: wenching
west: west
western: western
wet: wet
whatsoever: whatsoever
wheat: wheat
wheel: wheel,wheels
wherefore: wherefore
whine: whining
whisper: whisper,whispering,whispers
whit: whit
white: white,whitest
whiteness: whiteness
wholesale: wholesale
wholesome: wholesome
wholly: wholly
whorl: whorl,whorls
wicked: wicked,wickedest
wickedness: wickedness
wide: wide,widest
widen: widen
widespread: widespread
wife: wife,wives
wild: wild
wilderness: wilderness
wildness: wildness
willingly: willingly
willingness: willingness
wily: wily
win: win,winning,wins
wind: wind,winding,winds
wine: wine,wines
wing: wing,wings
winged: winged
winter: winter
wipe: wipes
wiry: wiry
wisdom: wisdom
wise: wise,wiser,wisest
wisely: wisely
wisp: wisp
wit: wit,wits
witchcraft: witchcraft
witchery: witchery
withdraw: withdraw,withdrawing,withdrawn
withered: withered
withstand: withstanding
withy: withy
witness: witness,witnessed,witnesses
wittily: wittily
wizard: wizard
woe: woe
wolf: wolf,wolves
woman: woman,women
womanhood: womanhood
womanishness: womanishness
womankind: womankind
womanly: womanly
womb: womb
wonderful: wonderful
wonderfully: wonderfully
wood: wood
wooden: wooden
woof: woof
wool: wool
word: word
worker: worker,workers
workings: workings
workman: workman,workmen
workmanship: workmanship
workwoman: workwoman
worn: worn
worry: worry
worship: worship,worshipped,worships
worshipper: worshippers
worth: worth
worthless: worthless
worthy: worthy
wound: wound,wounded,wounds
wounded: wounded
wrap: wrapped
wrath: wrath
wrest: wrested
wrestler: wrestler
wretch: wretches
wretched: wretched,wretchedest
wriggle: wriggle
wrinkle: wrinkled,wrinkles
wrist: wrist
write: write,writes,writing,written
writer: writer,writers
writing: writing
writings: writings
wrong: wrong,wronged,wronging,wrongs
wrongly: wrongly
wroth: wroth
wry: wried
xii: xii
yawn: yawn
yea: yea
yearn: yearns
yellow: yellower
yelp: yelping
yesterday: yesterday
yew: yew
yield: yield,yielding
yoke: yoke
youngster: youngsters
youth: youth,youths
youthful: youthful
zeal: zeal
zend: zend
zeus: zeus
zoroaster: zoroaster
