abandon: abandon,abandoned
abide: abide,abiding
ability: ability
ablaze: ablaze
abode: abode
abound: abounded,abounding
abreast: abreast
abrupt: abrupt
abruptly: abruptly
absence: absence
absent: absent,absented
absently: absently
absolute: absolute
absolutely: absolutely
absorb: absorbed
absurd: absurd
abundance: abundance
abuse: abuse
abusive: abusive
abyss: abysses
acadian: acadian
accede: acceded
accent: accent
accept: accept,accepted,accepting
acceptable: acceptable
access: access,accessed
accessible: accessible
accident: accident
accidentally: accidentally
accompaniment: accompaniment,accompaniments
accompany: accompanied,accompany,accompanying
accomplish: accomplish,accomplished,accomplishing
accomplishment: accomplishment
accord: accord
accouchement: accouchements
account: account
accusation: accusation
accustom: accustomed
accustomed: accustomed
ache: ache,ached
achievement: achievement
acknowledge: acknowledge
acknowledgment: acknowledgment
acme: acme
acquaint: acquainted
acquaintance: acquaintance,acquaintances
acquiesce: acquiesced
acquiescence: acquiescence
acquire: acquired
acre: acres
acting: acting
action: action,actions
active: active
actual: actual
acute: acute
add: add,adding
addition: addition,additions
additional: additional
address: address,addressed,addresses,addressing
adequate: adequate
adieu: adieu
adjoin: adjoined
adjoining: adjoining
adjust: adjust,adjusted,adjusting
administer: administer,administered
admiration: admiration
admire: admired,admiring
admission: admission
admit: admit,admitted
adorable: adorable
adoration: adoration
adore: adore,adored,adores,adoring
advance: advance,advanced,advances,advancing
advanced: advanced
advancement: advancement
advantage: advantage
adventure: adventure
advice: advice
advise: advise,advised
advisedly: advisedly
afar: afar
affair: affair,affairs
affection: affection,affections
affectionate: affectionate
affectionately: affectionately
affliction: affliction
afford: afford,afforded
afraid: afraid
afresh: afresh
afternoon: afternoon,afternoons
afterward: afterward
age: age,ages
aged: aged
agent: agent
agility: agility
agin: agin
agitate: agitates
agitated: agitated
agitation: agitation
agonize: agonized
agonizing: agonizing
agony: agony
agree: agree,agreed
agreeable: agreeable
agreement: agreement
ail: ailed,ails
aim: aims
aimlessly: aimlessly
air: air
ajar: ajar
akimbo: akimbo
alacrity: alacrity
alarm: alarmed
album: album
alien: alien
alike: alike
aline: aline
alive: alive
allay: allay
allegiance: allegiance
allez: allez
allurement: allurements
alluring: alluring
almighty: almighty
almond: almonds
aloud: aloud
alphonse: alphonse
altar: altar
alter: altered
alteration: alteration,alterations
altercation: altercation
alternate: alternate
altogether: altogether
amazement: amazement
amber: amber
ambition: ambition,ambitions
amble: ambled
america: america
american: american
ami: ami
amiable: amiable
amicable: amicable
amie: amie
amiss: amiss
ample: ample
amuse: amuse,amused
amused: amused
amusement: amusement
amusing: amusing
anchorage: anchorage
anecdote: anecdote,anecdotes
anew: anew
angel: angel,angels
angelus: angelus
anger: angered
angle: angles
angostura: angostura
angrily: angrily
angry: angry
anguish: anguish
animal: animal,animals
animalism: animalism
animated: animated
animation: animation
ankle: ankle,ankles
annihilation: annihilation
announcement: announcement
annoyance: annoyance
annoyed: annoyed
annoying: annoying
anomaly: anomaly
answer: answer,answered,answering,answers
antagonist: antagonists
antagonistic: antagonistic
antagonize: antagonize
antecedent: antecedents
anticipate: anticipating
anticipation: anticipation
anxiety: anxiety
anxious: anxious
anxiously: anxiously
apartment: apartment,apartments
apiece: apiece
apologize: apologized
apology: apologies,apology
apostrophe: apostrophe
appal: appalled
appalling: appalling
apparent: apparent
apparition: apparition
appeal: appeal,appealing
appealing: appealing
appearance: appearance,appearances
appease: appease,appeased
appetite: appetite
applause: applause
apple: apples
applicable: applicable
apply: applied,apply
appointment: appointments
appreciable: appreciable
appreciation: appreciation
apprehend: apprehend,apprehended
apprehension: apprehension
apprise: apprised
approach: approach,approached,approaching
approval: approval
apron: apron
apt: apt
aptitude: aptitude
arbitrary: arbitrary
architect: architect
archive: archive
ardent: ardent
ardently: ardently
ardor: ardor
argument: argument,arguments
aria: aria
arm: arm,arms
army: army
arouse: arouse,aroused,arousing
arrange: arranged,arranging
arrangement: arrangements
array: array
arrest: arrested
arrival: arrival
arrive: arrived
art: art
artificial: artificial
artificially: artificially
artisan: artisans
artist: artist
artistic: artistic
ascend: ascended
ascendancy: ascendancy
ascent: ascent
ascertain: ascertain
ascii: ascii
ash: ashes
ashamed: ashamed
asleep: asleep
aspect: aspect
assail: assailed,assailing
assent: assented
assert: asserted,asserting
assertive: assertive
assist: assist,assisted,assisting
assistance: assistance
assistant: assistants
associate: associate,associating
assort: assorting
assume: assume,assumed,assumes
assurance: assurance
assure: assure,assured
astir: astir
astonish: astonish,astonished
astonished: astonished
astonishment: astonishment
asunder: asunder
atelier: atelier
atmosphere: atmosphere
atone: atone
atonement: atonement
attach: attached
attachment: attachment
attempt: attempt,attempted,attempting
attend: attend,attended
attendant: attendant
attention: attention,attentions
attentive: attentive
attentively: attentively
attire: attire,attired
attitude: attitude,attitudes
attract: attract,attracted
attraction: attraction
attractive: attractive
attractiveness: attractiveness
attribute: attributed
august: august
aunt: aunt,aunts
author: author
authority: authority
autumn: autumn
avalanche: avalanche
avenue: avenue
aversion: aversion
avert: averted
avoid: avoided,avoiding
avoidance: avoidance
await: awaited,awaiting
awake: awake,awakes,awoke
awaken: awaken,awakened,awakens
awakening: awakening
aware: aware
awe: awe
awful: awful
awhile: awhile
awkward: awkward
awning: awning
ax: ax
babe: babes
baby: babies,baby
bad: bad,worse
bade: bade
bag: bag
bah: bah
bait: bait
baking: baking
bald: bald
balk: balk
ball: ball
bamboo: bamboo
band: band,bands
bandana: bandana
baneful: baneful
bang: bang
banister: banister
bank: bank,banks
banquette: banquette
banter: banter,bantered,bantering
baptism: baptism
bar: bar,bars
bare: bare,barest
barefooted: barefooted
bargain: bargain,bargains
bark: barking,barks
barrier: barrier
base: based
baseball: baseball
basin: basin
basket: basket
bat: bat,bats
batch: batch
bath: bath,bathed
bathe: bathe
bather: bathers
bathing: bathing
batter: battered
battle: battles
batture: batture
bavarian: bavarian
bay: bay
bayou: bayou
beach: beach
bead: bead,beads
beam: beamed
bear: bear,bearing,bore,born,borne
beard: beard
bearing: bearing
beat: beat,beaten,beating
beating: beating
beautiful: beautiful
beauty: beauty
bed: bed,beds
bedlam: bedlam
bedroom: bedroom
bedtime: bedtime
bee: bees
beer: beer
beethoven: beethoven
befall: befell
beg: beg,begged,begging
beggar: beggars
begone: begone
begrime: begrimed
behold: beholding
belief: belief
bell: bell,bells
belle: belle
bellow: bellowing
belly: bellied
belong: belong,belonged,belonging,belongs
belongings: belongings
beloved: beloved
belt: belt
bench: bench
bend: bend,bending,bent
beneath: beneath
benediction: benediction
beneficent: beneficent
benefit: benefit
bent: bent
bequeath: bequeathed
besiege: besieging
betray: betrayed,betraying
bewilder: bewilder,bewildered,bewildering
bewilderment: bewilderment
bib: bib
bible: bible
bid: bade,bid
bien: bien
billiards: billiards
billow: billows
biloxi: biloxi
binary: binary
bind: binding,bound
bird: bird,birds
birth: birth
birthday: birthday
birthright: birthright
biscuit: biscuit
bit: bit,bits
bite: bit,bite,biting
biting: biting
bitter: bitter
black: black,blacks
blade: blades
blagueur: blagueur
blame: blame
blanch: blanched
blanche: blanche
blank: blank
blaze: blaze,blazed,blazing
blend: blends
blessed: blessed
blessing: blessing
blind: blind,blinded
blindly: blindly
blink: blinking
bliss: bliss
block: block,blocks
blonde: blonde
blood: blood
bloodshot: bloodshot
blossom: blossom,blossoms
blotch: blotched,blotches,blotching
blotter: blotter
blow: blew,blow,blowing,blown
blue: blue
blunder: blunder,blundering,blunders
blunt: blunt
blur: blur
blurt: blurted
blush: blush
bluster: blustering
board: board,boarded
boast: boast,boasted
boat: boat
bob: bob
bodice: bodice
body: bodies,body
boil: boiling
boldly: boldly
bon: bon
bonbon: bonbon,bonbons
bond: bond,bonds
bonfire: bonfire
bonne: bonne
bonnet: bonnet,bonnets
book: book,books
bookshelf: bookshelf
boot: boot,boots
border: border,bordered
bore: bores
bosom: bosom
boss: boss
bother: bother,bothered,bothering
bottle: bottle
bough: bough
bouillon: bouillon
bounty: bounty
bourgeois: bourgeois
bout: bout,bouts
bow: bow,bowed,bowing
box: box
boy: boy,boys
boyish: boyish
brace: bracing
braid: braid
brain: brain
branch: branch,branches
brand: brand
brandy: brandy
brass: brass
brave: brave,braving
brazen: brazen
breach: breach
bread: bread
breadth: breadth
break: break,breaking,broke,broken
breakfast: breakfast
breast: breast
breastwork: breastworks
breath: breath
breathe: breathed,breathing
breathing: breathing
breathless: breathless
breeze: breeze,breezes
brew: brewed,brewing
brick: brick
bridal: bridal
bridge: bridges
bright: bright,brightest
brighten: brightening
brightness: brightness
brilliant: brilliant
brilliantly: brilliantly
brim: brimming
bring: bring,bringing,brought
broad: broad
broil: broiled
broken: broken
broker: broker
brokerage: brokerage
bronze: bronze
brood: brood,brooded
broom: broom
brother: brother
brow: brow,browed,brows
brown: brown
browsing: browsing
bruise: bruised
brune: brune
brush: brush,brushed,brushes,brushing
brutality: brutality
brute: brute
bucket: bucket
buffalo: buffalo
buffet: buffet
buggy: buggy
build: build,built
building: building,buildings
bulge: bulged
bulky: bulky
bumpy: bumpy
bunch: bunch
bundle: bundle
bungling: bungling
buoy: buoy
buoyant: buoyant
burden: burden
bureau: bureau
burn: burn,burned,burning,burnt
burst: bursting
bury: buried,bury,burying
busily: busily
business: business
bust: bust
bustle: bustled,bustling
busy: busied,busy
butcher: butcher
butter: butter
button: button,buttoned,buttons
buzz: buzzing
bye: bye
bygone: bygone
cabin: cabin,cabins
cable: cable
cabriolet: cabriolet
cage: cage
cake: cake,cakes
calculate: calculate,calculated,calculating
calculation: calculation
caliber: caliber
caller: callers
calmly: calmly
camaraderie: camaraderie
camomile: camomile
camp: camp
canal: canal
candelabra: candelabra
candidly: candidly
candle: candle,candles
candor: candor
candy: candy
cane: cane
cannon: cannon
canopy: canopy
canvas: canvas
cap: cap,caps
capability: capability
cape: cape
caprice: caprice
capricious: capricious
captivate: captivated,captivating
car: car,cars
carafe: carafe
card: card,cards
care: care,cared,cares,caring
career: career
careful: careful
carefully: carefully
carefulness: carefulness
careless: careless
carelessness: carelessness
caress: caress,caressed,caresses,caressing
caressing: caressing
carpet: carpet,carpets
carriage: carriage,carriages
carry: carried,carry,carrying
cast: cast,casting
casting: casting
casual: casual
cat: cat
catch: catch,caught
cathedral: cathedral
catholic: catholic
cattle: cattle
caution: caution
cautiously: cautiously
cavalry: cavalry
cavern: cavern
cayenne: cayenne
ce: ce
cease: cease,ceased,ceasing
ceiling: ceiling
celestine: celestine
cello: cello
cent: cents
center: center,centered
central: central
centre: centre
ceremony: ceremony
chain: chain,chained,chains
chair: chair,chairs
chamber: chamber
champagne: champagne
chance: chance,chances
change: change,changed,changing
channel: channels
chaos: chaos
chaotic: chaotic
character: character
characteristic: characteristic
charge: charge,charged,charges
charitable: charitable
charity: charities,charity
charles: charles
charm: charm,charmed,charms
charming: charming
chasm: chasm
chastity: chastity
chat: chatted,chatting
chatter: chattering
chatty: chatty
cheap: cheap
check: check,checked,checking,checks
checkered: checkered
checkers: checkers
cheek: cheek,cheeks
cheerful: cheerful
cheerfully: cheerfully
cheerfulness: cheerfulness
cheerless: cheerless
cheese: cheese
cherish: cherish,cherished
cherry: cherries
chess: chess
chest: chest
chicken: chicken,chickens
chide: chiding
chiefly: chiefly
child: child,children
childhood: childhood
childish: childish
childishly: childishly
chill: chill,chills
chilled: chilled
chilly: chilly
chime: chiming
chimney: chimney,chimneys
chin: chin
chip: chips
chloroform: chloroform
chocolate: chocolate,chocolates
choice: choice
choir: choir
choke: choking
choose: choose,chose
chop: chop
chopin: chopin
choppy: choppy
chord: chords
chubby: chubby
church: church
cicatrice: cicatrice
cigar: cigar,cigars
cigarette: cigarette,cigarettes
circle: circle,circled,circling
circlet: circlet
circumstance: circumstances
cistern: cistern
city: cities,city
claim: claim,claiming
clammy: clammy
clamor: clamor,clamored
clamoring: clamoring
clang: clanged
claret: claret
clash: clashes,clashing
clasp: clasping
clasped: clasped
class: class
classic: classic,classics
clatter: clatter,clattering
clean: clean
clearheadedness: clearheadedness
clematis: clematis
clementine: clementine
clergyman: clergyman
clerk: clerk,clerks
clever: clever
cleverly: cleverly
cleverness: cleverness
climax: climax
climb: climb,climbed,climbing
cling: clinging,clings,clung
cloak: cloak
close: close,closed,closer,closing
closely: closely
closet: closet
cloth: cloth
clothe: clad
clothes: clothes
clothing: clothing
cloud: clouds
cloudy: cloudy
clown: clown
club: club,clubs
cluck: cluck,clucking
clump: clumps
clumsily: clumsily
clung: clung
cluster: cluster,clusters
clutch: clutch,clutching
coachman: coachman
coal: coals
coarse: coarse
coat: coat,coats
cochon: cochon
cocktail: cocktail
coddle: coddle
code: codes
coerce: coerced
coercion: coercion
coffee: coffee
coil: coil,coiled,coiling
coin: coin
cold: cold
coldly: coldly
coldness: coldness
collar: collar
collect: collected
collection: collection
collectively: collectively
college: college
cologne: cologne
colonel: colonel
color: color,colored,coloring,colors
colored: colored
coloring: coloring
colorless: colorless
column: column,columns
comb: comb,combing
comedian: comedian
comedy: comedy
comfort: comfort,comforted
comfortable: comfortable
comfortably: comfortably
comic: comic
comical: comical
coming: coming
command: command,commanded,commanding
comment: comment,comments
commercial: commercial
commiseration: commiseration
commit: committed
commodious: commodious
common: common
commonplace: commonplace
commotion: commotion
community: community
companion: companion,companions
companionable: companionable
company: company
comparatively: comparatively
compare: compare
compartment: compartment,compartments
compass: compass
compel: compelled
compelling: compelling
compensation: compensation
compilation: compilation
complacency: complacency
complain: complained
complainingly: complainingly
complete: complete,completed,completing
completely: completely
complexion: complexion
compliance: compliance
compliment: compliments
comply: comply,complying
compose: composed,composing
composer: composer
composure: composure
comprehend: comprehend,comprehending
comprehension: comprehension
compress: compressed
comprise: comprised
compulsion: compulsion
compunction: compunction
conceal: conceal
conceive: conceived
concept: concept
conception: conception
concern: concern,concerned,concerns
concert: concerts
conclude: concluded
conclusion: conclusion
concoct: concocting
condemn: condemning
condition: condition,conditions
conduct: conduct,conducted
confectioner: confectioner
confederate: confederate
confidence: confidence,confidences
confidential: confidential
confidently: confidently
confidingly: confidingly
confine: confining
confirm: confirm,confirmed
confirmation: confirmation
confirmatory: confirmatory
conflicting: conflicting
conform: conforms
confront: confronted
confused: confused
confusing: confusing
confusion: confusion
congenial: congenial
congratulate: congratulated,congratulating
connect: connected
connection: connection
conquer: conquered
conqueror: conquerors
conscious: conscious
consciously: consciously
consciousness: consciousness
consecutive: consecutive
consent: consent,consented
consequence: consequence,consequences
consequential: consequential
considerable: considerable
consideration: consideration
consign: consigned
consist: consist,consisted,consisting
consolation: consolations
consoling: consoling
conspicuous: conspicuous
constant: constant
constantly: constantly
consternation: consternation
constitute: constituted
constitutional: constitutional
construction: construction
consul: consul
consult: consult
consultation: consultation
consume: consumed,consuming
contact: contact
contagion: contagion
contagious: contagious
contemplate: contemplated,contemplating
contemplation: contemplation
contemporary: contemporaries
contemptuous: contemptuous
contend: contended
content: content
contented: contented
contentment: contentment
contents: contents
continue: continue,continued
continuously: continuously
contortion: contortion,contortions
contract: contract
contradict: contradict
contradictory: contradictory
contrary: contrary
contrast: contrast
contribution: contributions
contrive: contriving
control: control,controls
controversy: controversies
convenances: convenances
convenience: convenience,conveniences
conventional: conventional
conversation: conversation
converse: conversing
convert: convert
convey: convey,conveyed
conviction: conviction
convince: convince,convinced
convinced: convinced
convincing: convincing
convulsion: convulsions
convulsively: convulsively
cook: cook,cooked,cooks
cookbook: cookbook
cooking: cooking
cool: cool,cooler
cope: cope
copper: copper
copying: copying
copyright: copyright
coquet: coquetted
coquetry: coquetry
corbeille: corbeille
cord: cord
corinthian: corinthian
corn: corn
corner: corner
corporation: corporation
correspondent: correspondent
corridor: corridor
corrupt: corrupt
cost: cost,costs
cot: cot
cottage: cottage,cottages
cotton: cotton
cottonade: cottonade
cottonwood: cottonwood
couch: couch
count: count,counted,counting,counts
countenance: countenance
counter: counter
country: countries,country
coup: coup
couple: couple
courage: courage
courageous: courageous
court: court
courteous: courteous
courtesy: courtesy
cousin: cousins
cover: cover,covered
covered: covered
cow: cows
coward: coward
cowl: cowl
cozy: cozy
crab: crabs
cracker: cracker,crackers
cradle: cradle,cradles
cramp: cramp,cramped
crash: crash
cravat: cravat
crave: craved
craving: cravings
crazy: crazy
cream: cream
creamy: creamy
create: create,created,creating
creation: creation
creature: creature,creatures
credit: credit
creditable: creditable
creep: creep,creeping,crept
creole: creole
creoles: creoles
crescent: crescent
cress: cress
crest: crests
crime: crime
criminal: criminal
crimped: crimped
crimson: crimson
crinkle: crinkled
crisp: crisp
critical: critical
critically: critically
criticise: criticised
croquet: croquet
cross: cross,crossed,crossing
crossing: crossings
crowd: crowd,crowded
cruel: cruel
cruelly: cruelly
cruelty: cruelty
cruet: cruet
crumb: crumbs
crumple: crumpled
crunch: crunching
crush: crush,crushed,crushing
crusty: crusty
crying: crying
crystal: crystal
cuff: cuff
cultivate: cultivating
cumbersome: cumbersome
cup: cup
cur: cur
curiosity: curiosity
curious: curious
curl: curled,curls
current: current,currents
curse: cursed
curtain: curtain,curtains
curve: curve,curves
curved: curved
cushion: cushion,cushioned,cushions
custom: custom
cut: cut,cutting
cynical: cynical
dab: dabbed
dabble: dabbled,dabbling
dada: dada
daily: daily
dainty: dainty
damage: damage
damaged: damaged
damages: damages
damask: damask
dame: dame
damp: damp
damsel: damsel
dance: dance,danced
dancing: dancing
danger: danger
dangerous: dangerous
dangle: dangling
dante: dante
daring: daring
dark: dark,darker,darkest
darkness: darkness
darky: darkies,darky
darning: darning
dart: darted
dash: dash
dat: dat
datum: data
daughter: daughter,daughters
dauphine: dauphine
david: david
dawn: dawn
day: day,days
daylight: daylight
daze: dazed
dazzling: dazzling
dead: dead
deaden: deadened
deadly: deadly
deafening: deafening
deal: deal,dealing,dealt
dealer: dealer
dealings: dealings
death: death
debar: debar
deceive: deceive,deceived,deceiving
december: december
decent: decent
decide: decided
decipher: decipher
declare: declare,declared
decline: declined
decorate: decorate
decoration: decorations
decoy: decoy
decree: decrees
dedicate: dedicated
deductible: deductible
deem: deem
deep: deep,deeper
deepen: deepened
deeply: deeply
deer: deer
defect: defect,defects
defective: defective
defend: defend,defending
defer: deferred
defiance: defiance
deficiency: deficiencies
define: define
deformity: deformity
deft: deft
defy: defies
degree: degree,degrees
deletion: deletions
deliberately: deliberately
deliberation: deliberation
delicacy: delicacies,delicacy
delicate: delicate
delicately: delicately
delicious: delicious
delight: delight
delighted: delighted
delightful: delightful
delirium: delirium
deliver: delivered
demand: demand,demanded,demanding
demented: demented
demure: demure
demurely: demurely
denial: denial
deny: denied,deny
depart: departed
department: department
departure: departure
depend: depended,depends
deplore: deplored
deposit: deposited
deprecatory: deprecatory
depress: depressed
depressed: depressed
deprive: deprived
depth: depth
depths: depths
derivative: derivative
derive: derive,derived
descend: descend,descended,descending
description: description
desert: deserted
deserted: deserted
deserve: deserve,deserved,deserving
deserving: deserving
design: design,designed,designing
desire: desire,desired,desiring
desirous: desirous
desk: desk
desolate: desolate
despair: despair
despairing: despairing
despairingly: despairingly
desperately: desperately
despondency: despondency
despondent: despondent
destine: destined
destroy: destroy
desultory: desultory
detach: detach
detachment: detachment
detain: detain
detect: detect,detected
determination: determination
determine: determine,determined
detest: detested
detract: detract
deuce: deuced
devil: devil,devils
devilishly: devilishly
devise: devise
devoid: devoid
devolve: devolved
devote: devote
devoted: devoted
devotion: devotion
devotions: devotions
devour: devour
dew: dew
dewy: dewy
diadem: diadem
diagonally: diagonally
diamond: diamonds
dickens: dickens
die: die,died,dying
difference: difference
difficult: difficult
difficulty: difficulty
diffident: diffident
dig: dig,digging
dignified: dignified
dignity: dignity
dilution: dilution
dim: dim
diminutive: diminutive
dimly: dimly
din: din
dine: dine,dined
dingy: dingy
dining: dining
dinner: dinner,dinners
dip: dip,dipped
direct: direct,directed
direction: direction,directions
directory: directory
disabled: disabled
disagreeable: disagreeable
disagreeably: disagreeably
disappear: disappear,disappeared
disappointed: disappointed
disapproval: disapproval
disapprove: disapproved
disapproving: disapproving
disapprovingly: disapprovingly
disarm: disarming
disband: disband
disbanding: disbanding
discard: discarded
discern: discern
discernible: discernible
discernment: discernment
disciplined: disciplined
disclaim: disclaim
disclaimer: disclaimer,disclaimers
disclosure: disclosures
discomfort: discomfort
discontinue: discontinue
discord: discords
discordant: discordant
discourage: discourage
discouragement: discouragement
discouraging: discouraging
discourtesy: discourtesy
discover: discover,discovered
discreditable: discreditable
discriminating: discriminating
discrimination: discrimination
discuss: discuss,discussed
disembark: disembarking
disfigured: disfigured
disguise: disguising
disgust: disgust
dish: dishes
dishearten: disheartened
disheartened: disheartened
disinclined: disinclined
disk: disk
dislike: dislike
dislodge: dislodging
dismantle: dismantled
dismay: dismay
dismiss: dismissed
disorder: disorder
dispel: dispelling
dispense: dispensed
display: display,displayed,displaying
dispose: dispose,disposing
disposition: disposition
dispute: dispute
disquieting: disquieting
disregard: disregard
dissemble: dissembled
dissent: dissenting
dissipation: dissipation
dissolution: dissolution
dissuade: dissuaded
distance: distance
distant: distant
distinct: distinct
distinction: distinction,distinctions
distinguish: distinguish,distinguished
distinguished: distinguished
distorted: distorted
distress: distress
distribute: distribute,distributed,distributing
distribution: distribution
distributor: distributor
disturb: disturb,disturbed,disturbing
disturbance: disturbance
disturbing: disturbing
disuse: disuse
diverse: diverse
diversify: diversified
diversion: diversion
divide: divided
divine: divine
doctor: doctor
document: documents
dog: dog,dogs
doggie: doggie
dogskin: dogskin
dollar: dollar,dollars
domain: domain
domestic: domestic
dominate: dominated
donate: donate
donation: donation,donations
donor: donors
door: door,doors
dormer: dormer
double: double,doubled
doubt: doubt,doubted
doubtless: doubtless
download: downloading
downward: downward
dozen: dozen
draft: drafts
drag: drag,dragged,dragging
draggingly: draggingly
drain: drained,draining
dramatic: dramatic
dramatically: dramatically
drape: draped
drapery: draperies,drapery
draw: draw,drawing,drawn,drew
drawer: drawer,drawers
drawing: drawing
drawl: drawl
dread: dread
dreadful: dreadful
dream: dream,dreamed,dreaming,dreams,dreamt
dreamy: dreamy
dreary: dreary
dress: dress,dressed,dressing
dressed: dressed
dresser: dresser
dressing: dressing
driblet: driblets
drift: drift,drifting
drink: drank,drink,drinking,drinks
drip: dripping
dripping: dripping
drive: drive,driven,drives,driving,drove
droll: droll
droop: droop
drop: drop,dropped,dropping
droplight: droplight
drown: drowned
drowsily: drowsily
drowsiness: drowsiness
drowsy: drowsy
drug: drug
drum: drummed
drunk: drunk
dry: dried,dry,drying
dual: dual
dud: duds
duel: duel
duet: duet
dull: dull,dulled
dumb: dumb
dupe: dupe
dusk: dusk
dusky: dusky
dust: dust
duster: duster
duty: duties,duty
dwarf: dwarfed
dwell: dwell,dwelling,dwelt
dwelt: dwelt
eager: eager
eagerly: eagerly
eagerness: eagerness
ear: ear,ears
earn: earn
earnest: earnest
earnestness: earnestness
earth: earth
earthling: earthling
earthly: earthly
ease: ease
easily: easily
east: east
easy: easier,easy
eat: ate,eat,eaten,eating
eaves: eaves
echo: echo,echoed
economy: economies
ecstasy: ecstasy
edge: edge
edition: edition,editions
editorial: editorials
edmond: edmond
edna: edna
educational: educational
ef: ef
efface: efface
effectually: effectually
effort: effort,efforts
effrontery: effrontery
effulgence: effulgence
effusive: effusive
eiderdown: eiderdown
eighteen: eighteen
eighth: eighth
ejaculate: ejaculated
ejaculatory: ejaculatory
elaborate: elaborate
elbow: elbow
eleanor: eleanor
elect: elect
electronic: electronic
electronically: electronically
element: element
elevate: elevated
elevated: elevated
elevation: elevation
elevator: elevator
elle: elle
ellen: ellen
elude: elude,eluded
elusive: elusive
email: email
embarrass: embarrassed
embarrassed: embarrassed
embarrassment: embarrassment
ember: embers
embodiment: embodiment
embrace: embrace
embroider: embroider,embroidered
embroidery: embroideries
emerge: emerge,emerged
emergency: emergency
emerson: emerson
emit: emitted
emotion: emotion,emotions
emphasis: emphasis
emphasize: emphasized,emphasizing
emphatic: emphatic
empire: empire
employ: employ,employed
employee: employee,employees
employment: employment
en: en
enable: enabled,enables,enabling
enact: enacted
enamor: enamored
enchantment: enchantment
encircle: encircled,encircling
enclose: enclose,enclosing
enclosure: enclosure
encode: encoding
encounter: encounter,encountered
encouragement: encouragement
encumber: encumbered
encumbrance: encumbrance
endearingly: endearingly
endearment: endearments
endeavor: endeavor,endeavored,endeavoring
enemy: enemy
energetic: energetic
energetically: energetically
energy: energy
enfeeble: enfeebled
enfold: enfolding
enframe: enframed
engage: engage,engaged,engaging
engaged: engaged
engagement: engagement
engaging: engaging
english: english
enjoy: enjoyed
enjoyment: enjoyment
enlightenment: enlightenment
enliven: enliven,enlivened
ennui: ennui
enormously: enormously
enrapture: enraptured
enrich: enriching
enrol: enrolled
ensconce: ensconced
ensure: ensuring
enter: enter,entered,entering
entertain: entertain,entertained,entertaining
entertaining: entertaining
entertainment: entertainment,entertainments
enthral: enthralled
enthusiasm: enthusiasm
entire: entire
entitle: entitled
entity: entity
entourage: entourage
entrance: entrance
entrancing: entrancing
entre: entre
entreat: entreat,entreated
entreatingly: entreatingly
entreaty: entreaties,entreaty
entry: entry
envelop: enveloped
envelope: envelope
enviable: enviable
environment: environment
envy: envy
episode: episode
equal: equal
equally: equally
equipment: equipment
erect: erect
error: errors
escape: escape,escaped,escaping
escort: escort,escorted
eskimo: eskimo
esplanade: esplanade
espousal: espousal
espouse: espoused
esprit: esprit
essay: essays
essential: essential
est: est
establish: established
estate: estate
esteem: esteem,esteemed
eternal: eternal
eternity: eternity
ether: ether
evasive: evasive
evasiveness: evasiveness
evening: evening,evenings
event: event,events
everlasting: everlasting
evident: evident
evidently: evidently
evil: evil
evince: evinced
evoke: evoking
exacting: exacting
exaggerate: exaggerated
exaggerated: exaggerated
exalt: exalted
examine: examine,examined,examining
exceedingly: exceedingly
excellent: excellent
exception: exception
exceptional: exceptional
excess: excess
excessive: excessive
exchange: exchange,exchanged,exchanges,exchanging
excite: excited
excited: excited
excitement: excitement
exciting: exciting
exclaim: exclaimed,exclaiming
exclamation: exclamation
exclusion: exclusion
exclusive: exclusive
excuse: excuse,excused,excuses
execute: executing
exempt: exempt
exercise: exercise
exhaust: exhausted
exhausted: exhausted
exhaustion: exhaustion
exhibit: exhibit,exhibited
exist: exist,existed,existing,exists
existence: existence
expanse: expanse
expansion: expansion
expect: expect,expected
expectancy: expectancy
expedient: expedients
expend: expend
expense: expense,expenses
experience: experience,experienced,experiences
experienced: experienced
expert: expert
explain: explain,explained
explanation: explanation
explosion: explosion
export: exporting
expose: exposed
express: express,expressed,expressing
expression: expression,expressions
expressive: expressive
exquisite: exquisite
extend: extended,extending
extended: extended
extent: extent
exterior: exterior
external: external
extra: extra
extraneous: extraneous
extraordinary: extraordinary
extravagant: extravagant
extravagantly: extravagantly
extreme: extreme
extremely: extremely
exuberance: exuberance
exultation: exultation
eye: eye,eyes
eyebrow: eyebrows
eyed: eyed
eyeglass: eyeglasses
eyelid: eyelids
fabricate: fabricated
faced: faced
facility: facility
faculty: faculties,faculty
fade: faded,fading
fail: failed,failing
faint: faint,faintest
faintly: faintly
faintness: faintness
fair: fair
faire: faire
fairy: fairies
faith: faith
fall: fall,fallen,falling,fell
false: false
fame: fame
familiar: familiar
familiarity: familiarity
familiarly: familiarly
family: families,family
fan: fan,fanned,fanning
fancy: fancied,fancies,fancy
fantastic: fantastic
faraway: faraway
farceur: farceur
farewell: farewell
farm: farm,farming
fashion: fashion,fashioned
fashionable: fashionable
fashioned: fashioned
fast: fast
fasten: fasten,fastened
fastening: fastening
fastidious: fastidious
fat: fat
fate: fate
father: father,fathers
fathom: fathom
fatigue: fatigue,fatiguing
faultless: faultless
faut: faut
favor: favor,favored
favorite: favorite
fawn: fawn
fear: fear,feared
feast: feast
feather: feather,feathers
feathered: feathered
feature: feature,features
february: february
federal: federal
fee: fee,fees
feebly: feebly
feed: fed,feed
feel: feel,feeling
feeling: feeling,feelings
feline: feline
fellow: fellow,fellows
fellowship: fellowship
feminine: feminine
fence: fence
ferry: ferry
festoon: festoons
fever: fever
feverish: feverish
fiber: fiber
fictitious: fictitious
fidelity: fidelity
field: field,fields
fierce: fierce,fiercer
fight: fight,fighting
figure: figure,figured,figures
file: file,filed,files
filial: filial
filmy: filmy
filter: filtered
finally: finally
financial: financial
financier: financier
fine: fine,finest
finger: finger,fingers
fingertip: fingertips
finish: finish,finished,finishing
firelight: firelight
fireplace: fireplace
firm: firm
firmly: firmly
fish: fish,fishing
fist: fist,fists
fistful: fistful
fit: fit,fitted
fitness: fitness
fitting: fitting
fixed: fixed
fixture: fixtures
flag: flagged,flagging
flaky: flaky
flame: flame,flamed,flames,flaming
flaming: flaming
flank: flanked
flannel: flannel
flap: flap,flapped,flapping
flare: flare
flash: flash
flask: flask
flatter: flattered
flattering: flattering
flesh: flesh
flight: flight,flights
fling: flinging,flung
flippancy: flippancy
float: floated
flock: flocked
floor: floor,floors
flooring: flooring
flourish: flourished,flourishes
flower: flower,flowers
fluffiness: fluffiness
fluffy: fluffy
flurry: flurried
flush: flush,flushed
flute: flute,fluted
fluted: fluted
flutter: fluttered,fluttering
fluty: fluty
fly: flew,fly
foam: foam
foamy: foamy
fold: folded,folds
foliage: foliage
folk: folk
follow: follow
folly: folly
fond: fond
fondly: fondly
food: food
fool: fool
foolish: foolish
foot: feet,foot
footpath: footpath
footstep: footsteps
forage: foraged
forbid: forbidden,forbids
forbidden: forbidden
force: force,forced,forces,forcing
forcibly: forcibly
foreboding: foreboding
forego: foregoing
foregoing: foregoing
forehead: forehead
foreign: foreign
foremost: foremost
foresee: foreseeing
forest: forests
forethought: forethought
forge: forging
forget: forget,forgetting,forgot,forgotten
forgetfulness: forgetfulness
forgive: forgive
fork: fork
form: form,formed,forms
formality: formality
format: format,formats
fort: fort
forthwith: forthwith
fortnight: fortnight
fortunate: fortunate
fortunately: fortunately
fortune: fortune
foundation: foundation
fountain: fountain
fourteen: fourteen
fourth: fourth
fowl: fowl
fragrant: fragrant
frame: frame,framed,framing
france: france
francisco: francisco
frank: frank
frankly: frankly
frankness: frankness
freckle: freckles
freedom: freedom
freely: freely
freeze: frozen
french: french
frenchy: frenchy
frenzied: frenzied
frequency: frequency
frequent: frequent
frequently: frequently
fresco: frescoing
fresh: fresh
freshly: freshly
fret: fret
fretful: fretful
friend: friend,friends
friendly: friendly
friendship: friendship
fright: fright
frighten: frightens
frightened: frightened
frightfully: frightfully
fro: fro
frost: frosted
froth: froth
frown: frowned,frowns
fruit: fruit,fruits
fruitless: fruitless
fry: fry
fulfillment: fulfillment
fume: fumes,fuming
fun: fun
function: function
fund: fund
fur: fur
furnish: furnish,furnished
furnishings: furnishings
furniture: furniture
fusion: fusion
fuss: fuss
futile: futile
futility: futility
future: future,futures
gaily: gaily
gain: gained,gaining
gait: gait
gaiter: gaiter
gal: gal
gallantly: gallantly
gallery: galleries,gallery
gallop: gallop
game: game,games
gangrene: gangrene
gape: gaped,gaping
garb: garb
garden: garden,gardens
garland: garland
garment: garment,garments
garnet: garnet
gasoline: gasoline
gate: gate
gateway: gateway
gather: gather,gathered,gathering
gathering: gathering
gaudy: gaudy
gaunt: gaunt
gauntlet: gauntlets
gauze: gauze
gay: gay
gayly: gayly
gaze: gaze,gazed,gazes,gazing
gelding: geldings
gem: gem,gems
generate: generate
generation: generations
generous: generous
generously: generously
geneva: geneva
gentle: gentle
gentleman: gentleman,gentlemen
gently: gently
genuine: genuine
genuineness: genuineness
geranium: geranium
germ: germs
gesture: gesture,gestures
ghost: ghost
giant: giant
giddy: giddy
gift: gift,gifts
girl: girl,girls
girlhood: girlhood
git: git
glad: glad
glamour: glamour
glance: glance,glanced,glances,glancing
glare: glare,glaring
glass: glass,glasses
gleam: gleam,gleamed,gleaming
glibly: glibly
glide: glide,glided
glimmer: glimmer
glimpse: glimpse,glimpses
glint: glint
glisten: glisten,glistened,glistening
glitter: glittered,glittering
gloom: gloom
glory: glory
glossy: glossy
glove: glove,gloves
gloved: gloved
glow: glow,glowed
glowing: glowing
goal: goals
goblet: goblets
god: god,gods
gold: gold
golden: golden
goodly: goodly
goodness: goodness
gorgeous: gorgeous
gospel: gospel
gossip: gossip
gothic: gothic
govern: govern
gown: gown,gowns
grace: grace,graced
graceful: graceful
gracious: gracious
gradually: gradually
grand: grand
grande: grande
grandfather: grandfather
grandmother: grandmother
grant: granted
grape: grapes
grasp: grasp,grasped,grasping
grass: grass,grasses
grassy: grassy
grateful: grateful
gratefully: gratefully
gratification: gratification
gratified: gratified
gratify: gratified
gratifying: gratifying
grave: grave
gravel: gravel
graven: graven
gray: gray
graze: grazing
greatly: greatly
greedily: greedily
greedy: greedy
green: green
greet: greeted,greeting
greeting: greeting
griffe: griffe
grime: grime
grimy: grimy
grocer: grocer
grocery: groceries,grocery
gros: gros
gross: gross
grotesque: grotesque
grotesquely: grotesquely
ground: ground
grounds: grounds
grove: grove
grow: grew,grow,growing,grown,grows
grown: grown
growth: growth
grumble: grumbled,grumbling
grunt: grunted
gruyere: gruyere
guard: guard
guerre: guerre
guess: guess
guest: guest,guests
guide: guide,guiding
guile: guile
guileless: guileless
gulf: gulf
gun: gun
gusty: gusty
ha: ha
habit: habit,habits
habitable: habitable
habitual: habitual
habitually: habitually
haggard: haggard
hair: hair
haired: haired
hall: hall,halls
hallway: hallway
halt: halted
hammer: hammer,hammering
hammock: hammock
hand: hand,handed,handing,hands
handful: handful
handiwork: handiwork
handkerchief: handkerchief
handle: handle,handled,handling
handling: handling
handsome: handsome
handsomer: handsomer
handwriting: handwriting
hang: hang,hanged,hanging,hangs,hung
happen: happen,happened,happening
happily: happily
happiness: happiness
happy: happier,happy
harass: harassed
harbor: harbor,harbored
hard: hard,harder
hardwood: hardwood
hardy: hardy
harm: harm
harmless: harmless
harmonious: harmonious
harmony: harmony
harrowing: harrowing
hart: hart
haste: haste
hasten: hastened
hastily: hastily
hat: hat,hats
hate: hate,hated
hatless: hatless
haul: haul,hauling
haunt: haunt,haunted
hazily: hazily
head: head,heads
headed: headed
headlong: headlong
heal: healing
health: health
healthfully: healthfully
healthy: healthy
hear: hear,heard,hearing
heart: heart,hearts
hearted: hearted
hearth: hearth
heat: heat,heating
heated: heated
heaven: heaven
heavily: heavily
heavy: heavy
hectic: hectic
hedge: hedge,hedges
heed: heed
heel: heel,heels
height: height
helpful: helpful
helpless: helpless
hem: hem
herb: herbs
hereditary: hereditary
heretofore: heretofore
heroics: heroics
heroine: heroine
hesitate: hesitating
hey: hey
hidden: hidden
hide: hidden,hide
hideous: hideous
hiding: hiding
highly: highly
hilarious: hilarious
hill: hill,hills
hint: hinting
hitherto: hitherto
hoard: hoarded
hobble: hobbled
hoe: hoe
hoist: hoisted
hold: held,hold,holding,holds
holder: holder
hole: holes
holiday: holiday
holy: holy
homelike: homelike
homely: homely
homemade: homemade
homeward: homeward
honor: honor
hood: hood
hoodoo: hoodoo
hoof: hoofs
hoopskirt: hoopskirt
hoot: hooted
hooting: hooting
hope: hope,hoped,hoping
hopeless: hopeless
hopelessness: hopelessness
horizon: horizon
horizontal: horizontal
horse: horse,horses
hosiery: hosiery
hospitality: hospitality
hostess: hostess
hot: hot
hotel: hotel
hotly: hotly
hour: hour,hours
houri: houris
house: house,houses
household: household
housekeeping: housekeeping
housetops: housetops
housewifely: housewifely
hover: hovering
huge: huge
hugh: hugh
hum: hum,hummed,humming
human: human
humanity: humanity
humble: humbler
humor: humor
humored: humored
hungry: hungry
hunt: hunted
hunter: hunter
hurl: hurled
hurried: hurried
hurry: hurried,hurry,hurrying
hurt: hurt
husband: husband,husbands
hush: hush,hushed
hut: hut
hysterical: hysterical
hysterically: hysterically
ice: ice
icebox: icebox
idea: idea,ideas
identification: identification
identify: identified,identify
idiosyncrasy: idiosyncrasies
idiotic: idiotic
idle: idle
idleness: idleness
idly: idly
idol: idol
idolize: idolized
ignorance: ignorance
ignore: ignore
iii: iii
illness: illness
illumination: illumination
illusion: illusions
image: image
imaginary: imaginary
imagination: imagination
imagine: imagined
imitate: imitate
imitation: imitation
immaculately: immaculately
immense: immense
immensely: immensely
immutability: immutability
immutable: immutable
imp: imps
impair: impaired
impart: imparting
impassioned: impassioned
impatience: impatience
impatiently: impatiently
impel: impel,impelled
imperative: imperative
imperceptible: imperceptible
imperceptibly: imperceptibly
imperfect: imperfect
imperfectly: imperfectly
imperil: imperiling
imperious: imperious
impertinent: impertinent
imperturbed: imperturbed
impervious: impervious
impetuosity: impetuosity
impetuous: impetuous
impetuously: impetuously
implicitly: implicitly
implore: imploring
imply: implied
import: import
impose: impose,imposed,imposing
impossible: impossible
impress: impress,impressed,impressing
impression: impression,impressions
impressive: impressive
impressively: impressively
imprint: imprint
impromptu: impromptu
improve: improved,improving
improvement: improvement
improvisation: improvisation
imprudent: imprudent
impudence: impudence
impulse: impulse,impulses
impulsive: impulsive
impulsively: impulsively
inaccurate: inaccurate
inattention: inattention
inborn: inborn
incalculable: incalculable
incessantly: incessantly
inch: inch
incident: incident,incidents
incidental: incidental
incipiently: incipiently
inclination: inclination
incline: inclined
inclined: inclined
inclose: inclosed
include: include,included,includes,including
including: including
incoherence: incoherence
incoherency: incoherency
incomparable: incomparable
incomplete: incomplete
incomprehensible: incomprehensible
inconsiderable: inconsiderable
inconsolable: inconsolable
increase: increased,increasing
incredibly: incredibly
indecision: indecision
indefinitely: indefinitely
indemnify: indemnify
indemnity: indemnity
indenture: indenture
independence: independence
independent: independent
indescribable: indescribable
indifference: indifference
indifferent: indifferent
indifferently: indifferently
indignant: indignant
indirect: indirect
indirectly: indirectly
indiscriminate: indiscriminating
indiscriminately: indiscriminately
indispose: indisposed
individual: individual,individuals
individuality: individuality
indoor: indoors
induce: induce,induced
indulge: indulged,indulging
indulgence: indulgence
indulgent: indulgent
ineffectual: ineffectual
inestimable: inestimable
inevitable: inevitable
infant: infant,infants
infatuation: infatuation
infidelity: infidelity
inflame: inflamed
influence: influence,influences
inform: inform,informed
infringement: infringement
infuse: infusing
infusion: infusion
ingenuous: ingenuous
ingredient: ingredients
inhale: inhaled
injury: injury
injustice: injustice
innocent: innocent
inoffensive: inoffensive
inquire: inquired
inquiry: inquiry
inquisitive: inquisitive
inroad: inroads
insane: insane
insect: insects
insensibly: insensibly
insidious: insidious
insignificant: insignificant
insist: insisted
insistent: insistent
insolent: insolent
inspect: inspect,inspecting
inspiration: inspiration
inspire: inspiring
inspired: inspired
inspiring: inspiring
instability: instability
install: installing
instance: instance,instances
instant: instant
instantly: instantly
instep: insteps
instigation: instigation
instinct: instinct
instinctively: instinctively
institution: institutions
instruct: instructed
instruction: instructions
instrument: instrument
insult: insulting
insulting: insulting
insure: insure
insurmountable: insurmountable
intact: intact
intangible: intangible
integrity: integrity
intellectual: intellectual
intelligent: intelligent
intend: intend,intended,intending
intense: intense
intensely: intensely
intensity: intensity
intent: intent
intention: intention,intentions
intentionally: intentionally
intercourse: intercourse
interfere: interfere,interfering
interior: interior
interlude: interlude
internal: internal
international: international
interpose: interpose
interpret: interpreted
interrupt: interrupt,interrupted,interrupting
interrupted: interrupted
interruption: interruption,interruptions
intertwine: intertwined
interval: interval,intervals
intervene: intervening
interview: interview
interweave: interwoven
intimacy: intimacy
intimate: intimate
intimately: intimately
intimation: intimation
intoxicant: intoxicant
intoxicate: intoxicated
intoxicated: intoxicated
intoxication: intoxication
introduce: introduced,introducing
intrude: intruding
intrusion: intrusion
intuitively: intuitively
inutility: inutility
invade: invade,invaded
invalidity: invalidity
invent: invent,invented
invest: invested
investigate: investigate,investigating
investigation: investigation
investment: investment
invigorate: invigorated,invigorating
invitation: invitation
invite: invite,invited,inviting
inwardly: inwardly
iota: iota
ire: ire
iron: iron
irrelevantly: irrelevantly
irresolute: irresolute
irresponsibility: irresponsibility
irritable: irritable
irritably: irritably
irritation: irritation
irs: irs
island: island,islands
islands: islands
isle: isle
isolde: isolde
issue: issue
italian: italian
iv: iv
ix: ix
jack: jack
jacqueline: jacqueline
jaded: jaded
jagged: jagged
jalouse: jalouse
james: james
janet: janet
jar: jarred,jars
jasper: jasper
jealous: jealous
jealousy: jealousy
jeer: jeered
jelly: jelly
jessamine: jessamine
jest: jest
jockey: jockey
joe: joe
joint: joints
journalist: journalist
journey: journey,journeys
jovial: jovial
joy: joy
joyous: joyous
judge: judge,judging
judgment: judgment
judicious: judicious
judith: judith
jules: jules
justice: justice
justification: justification
justify: justify
kate: kate
keel: keel
keen: keen,keenest
keenly: keenly
kentucky: kentucky
kerchief: kerchief
key: key
kick: kick
kid: kid
kill: kill,killed
kilt: kilts
kindle: kindled
kindly: kindly
kindness: kindness
kiss: kiss,kissed,kisses,kissing
kitchen: kitchen
kittenish: kittenish
knee: knee,knees
kneel: knelt
knife: knife
knob: knob
knock: knock,knocked
knot: knot,knotted
knowledge: knowledge
labor: labor,labored
laborious: laborious
lace: lace,laces
lack: lack,lacked
lacking: lacking
ladder: ladder
lady: ladies,lady
lait: lait
lake: lake
lame: lame
lament: lamenting
lamentable: lamentable
lamp: lamp,lamps
lamplight: lamplight
land: land
landing: landings
lane: lane,lanes
language: language
languid: languid
languish: languishing
languor: languor
languorous: languorous
lap: lap
larder: larder
lash: lashing
late: late
lateen: lateen
latent: latent
laugh: laugh,laughed,laughing,laughs
laughingly: laughingly
laughter: laughter
laundry: laundry
laurel: laurel,laurels
lavender: lavender
law: law,laws
lawn: lawn
lawyer: lawyers
lay: laid,lay,laying
layette: layette
lazily: lazily
lazy: lazy
lead: lead,leading,led
leaf: leaf,leaves
leafy: leafy
lean: lean,leaned,leaning
leap: leaps
learn: learn,learned
leave: leave,leaving,left
leaved: leaved
left: left
leg: leg,legs
legal: legal
legally: legally
legend: legends
legitimate: legitimate
leisurely: leisurely
lemon: lemon
lend: lend,lending,lent
lengthen: lengthened
lenient: lenient
les: les
lessen: lessen
lesson: lesson,lessons
letter: letter,letters
letterhead: letterheads
level: level
liability: liability
liable: liable
library: library
license: license
licensed: licensed
lid: lid
lie: lain,lie,lied,lies,lying
lieu: lieu
life: life,lives
lifelike: lifelike
lifetime: lifetime
lift: lift,lifted,lifting
light: light,lighted,lightest,lighting,lights,lit
lighted: lighted
lighten: lighten
lightly: lightly
likeness: likeness
lilac: lilac
limb: limbs
limit: limit,limited
limitation: limitation
limited: limited
limp: limp,limps
linen: linen
linger: linger,lingered,lingering
link: link,linked,links
lip: lip,lips
liqueur: liqueur
liquid: liquid
liquor: liquor
list: list
listen: listen,listened,listening
listless: listless
listlessly: listlessly
literally: literally
literary: literary
live: live,lived,lives,living
livelong: livelong
lively: lively
living: living
lizard: lizards
load: load
loaf: loaf
loath: loath
locate: located
location: locations
lock: lock,locked,locking
locked: locked
locket: locket
lodge: lodge,lodged
lodger: lodgers
lofty: lofty
log: log
logic: logic
loiter: loitered
lonely: lonely
longing: longing
loose: loose
loosely: loosely
loosen: loosen,loosened,loosening
lore: lore
lorgnette: lorgnette,lorgnettes
lose: lose,losing,lost
loss: loss
lost: lost
lot: lot
louisiana: louisiana
lounge: lounge,lounges
lovable: lovable
love: love,loved,loves,loving
lover: lover,lovers
loving: loving
loyalty: loyalty
luckily: luckily
lugger: lugger
lull: lull,lulling,lulls
lullaby: lullaby
lump: lumps
lumpy: lumpy
lunch: lunch,lunching
luncheon: luncheon
luscious: luscious
luxuriant: luxuriant
luxurious: luxurious
luxury: luxury
machine: machine
mackintosh: mackintosh
mad: mad
madame: madame
maddening: maddening
mademoiselle: mademoiselle
madonna: madonna
mag: mag
magazine: magazine,magazines
magician: magician
magnet: magnet
magnetic: magnetic
magnificent: magnificent
magnolia: magnolias
mahogany: mahogany
maid: maid,maids
mail: mail
main: main
maintain: maintain,maintained,maintaining
majestic: majestic
majestically: majestically
majesty: majesty
mal: mal
malicious: malicious
maliciously: maliciously
mamma: mamma
mammy: mammy
manage: manage,managed,manages
management: management
manager: manager
mandolin: mandolin,mandolins
maneuver: maneuver
mania: mania
manifestation: manifestation
manifestly: manifestly
manner: manner
manners: manners
mansion: mansion
mantel: mantel
mantelpiece: mantelpiece
mantle: mantle,mantling
manufacture: manufacture
marble: marble
march: march
margaret: margaret
mark: mark,marked
market: market,markets
marriage: marriage,marriages
married: married
marron: marron
marry: married,marry
marvel: marvel,marveled,marvels
marvelous: marvelous
marvelously: marvelously
masquerade: masquerade
mass: mass
massive: massive
mast: masts
master: master,mastered
masterful: masterful
match: match,matched
material: material,materials
matinee: matinee
matins: matins
matronly: matronly
matted: matted
matter: matter,mattered,matters
matting: matting
mattress: mattress
maximum: maximum
maze: maze,mazes
meadow: meadow
meager: meager
meal: meal,meals
meaning: meaning
measure: measured
meat: meat
mechanical: mechanical
mechanically: mechanically
medicine: medicine
meditation: meditations
meditative: meditative
meditatively: meditatively
medium: medium
meet: meet,meeting,met
meeting: meeting
melancholy: melancholy
mellow: mellow
melodious: melodious
melt: melt,melted,melting
melting: melting
memory: memories,memory
menacing: menacing
mend: mended,mending
mending: mending
mental: mental
mentally: mentally
mention: mention,mentioned
menu: menu
mercantile: mercantile
merchantability: merchantability
mercy: mercy
mere: mere,merest
merge: merging
merry: merry
mesh: meshes
mess: mess
message: message
messmate: messmate
met: mets
metal: metals
method: method,methods
mettle: mettle
mexican: mexican,mexicans
mexico: mexico
michael: michael
midday: midday
middle: middle
midnight: midnight
midst: midst
mild: mild
mile: mile
military: military
milk: milk
mincing: mincing
mind: mind
minded: minded
mingle: mingled
miniature: miniatures
minister: ministering
minor: minor
minute: minute,minutes
miracle: miracles
mirror: mirror
mirth: mirth
mis: mis
misadventure: misadventure
mischief: mischief
mischievous: mischievous
mischievously: mischievously
miserable: miserable
misery: misery
misinterpret: misinterpreted
mislay: mislaid
mislead: mislead,misled
misleading: misleading
mission: mission
mississippi: mississippi
mist: mist
mistake: mistake
mistaken: mistaken
mistress: mistress
misty: misty
misunderstanding: misunderstanding
mite: mite
mix: mix
mixture: mixture
moan: moan,moaned
mock: mocking
model: model
modeling: modeling
modern: modern
modest: modest
modification: modification
modify: modified
moi: moi
moisture: moisture
mold: molded
mole: mole
moment: moment,moments
mon: mon
monday: monday
money: money
monotonous: monotonous
monsieur: monsieur
monster: monster,monsters
month: month,months
mood: mood,moods
moody: moody
moon: moon
moonlight: moonlight
moonlit: moonlit
mope: moping
moral: moral
morbid: morbid
morning: morning,mornings
morrow: morrow
morsel: morsel
mortal: mortal
mortimer: mortimer
mosquito: mosquito,mosquitoes
moss: moss
mother: mother,mothers
motherless: motherless
motion: motion,motioned
motionless: motionless
motive: motive,motives
mount: mount,mounted,mounting
mournful: mournful
mouth: mouth,mouths
movable: movable
movement: movement,movements
mover: movers
muddle: muddled
muddy: muddy
muffled: muffled
mulatto: mulatto,mulattoes
mulberry: mulberry
mule: mules
mullet: mullets
multitude: multitude
multitudinous: multitudinous
mumbling: mumbling
munch: munched
murky: murky
murmur: murmur,murmured,murmuring
murmuring: murmuring
muscle: muscles
muse: mused
music: music
musical: musical
musicale: musicale,musicales
musician: musician,musicians
musket: musket
musky: musky
muslin: muslin,muslins
mustache: mustache
mustard: mustard
mute: mute
mutter: muttered
muzzle: muzzle
myriad: myriad
myrtle: myrtle
mystery: mystery
mystic: mystic
nagging: nagging
nail: nailing,nails
naive: naive
nake: nake
naked: naked
nameless: nameless
nape: nape
napoleon: napoleon
narcotic: narcotic
narrow: narrow,narrowing
narrowly: narrowly
native: native
natural: natural
naturally: naturally
nature: nature
naughty: naughty
nearer: nearer
nearness: nearness
neat: neat
neatly: neatly
necessity: necessity
neck: neck
ned: ned
needle: needle
needless: needless
needlessly: needlessly
needlework: needlework
neglect: neglect,neglected
negligence: negligence
negotiate: negotiated
negro: negro,negroes
neighbor: neighbor,neighbors
neighborhood: neighborhood
neighboring: neighboring
nerve: nerved
nervous: nervous
nervously: nervously
nest: nested
nestle: nestled
nether: nether
network: network
neutral: neutral
newcomer: newcomer
newly: newly
news: news
newsletter: newsletter
newspaper: newspaper,newspapers
nice: nice
nicety: nicety
nick: nick
night: night,nights
nightfall: nightfall
nightgown: nightgown
nineteen: nineteen
nip: nipping
noble: noble
nod: nodding
noise: noise
noised: noised
noiselessly: noiselessly
nom: nom
noncommittal: noncommittal
nonplused: nonplused
nonproprietary: nonproprietary
nonsense: nonsense
noon: noon
north: north
nose: nose
nostril: nostrils
note: note,notes
notice: notice,noticed,noticing
notify: notifies
notion: notion
nougat: nougat
november: november
numb: numb
numerous: numerous
nun: nun
nurse: nurse,nursed,nurses
nutriment: nutriment
oak: oak,oaks
oar: oar
oath: oaths
obedience: obedience
obediently: obediently
object: object,objected,objecting
obligation: obligations
oblige: obliged
oblivious: oblivious
obnoxious: obnoxious
obscure: obscure
obscurity: obscurity
observant: observant
observation: observation
observe: observe,observed,observing
observer: observer
obsession: obsession
obsolete: obsolete
obstacle: obstacles
obstruct: obstructed
obvious: obvious
occasion: occasion,occasions
occasional: occasional
occasionally: occasionally
occupancy: occupancy
occupation: occupation
occupy: occupied,occupy,occupying
occur: occur,occurred
occurrence: occurrence
ocean: ocean
october: october
odd: odd
odor: odor,odors
offend: offended
offense: offense
offensive: offensive
offer: offer,offered,offering,offers
office: office,offices
officer: officer
official: official
oftener: oftener
oleander: oleanders
omelet: omelet
ominous: ominous
online: online
openly: openly
opera: opera
opinion: opinion
opportunity: opportunities,opportunity
opposition: opposition
oppression: oppression
orange: orange
orchestra: orchestra
ordinary: ordinary
organism: organism
organize: organized
organized: organized
oriental: oriental
origin: origin
original: original
originator: originator
orleans: orleans
ornament: ornaments
oui: oui
outburst: outburst,outbursts
outdated: outdated
outer: outer
outfit: outfit
outing: outing
outline: outlines
outspoken: outspoken
outward: outward
overburdened: overburdened
overcome: overcame,overcome
overestimate: overestimating
overflow: overflowing
overhead: overhead
overpower: overpowered,overpowering
overpowering: overpowering
overshoe: overshoes
overspread: overspread
overtake: overtake,overtaken,overtaking,overtook
overture: overture
overturn: overturned
overwhelming: overwhelming
overwork: overwork
owe: owed
owl: owl,owls
owner: owner,owners
ox: ox
pace: pace,paces
pacify: pacified
pacing: pacing
pack: pack,packed,packing
packer: packers
pad: pad
padded: padded
paddle: paddled
paddock: paddock
pail: pail
pain: pain
pained: pained
paint: paint,painted,paints
painter: painter
painting: painting,paintings
pair: pair,pairs
pale: pale
paler: paler
palette: palette
pall: pall
palm: palm,palms
palmetto: palmetto
palpitant: palpitant
palpitate: palpitating
pan: pans
pandemonium: pandemonium
pang: pang
pant: panted
pantheon: pantheon
panties: panties
panting: panting
papa: papa
paper: paper,papers
paperwork: paperwork
par: par
paragraph: paragraph,paragraphs
paralyzed: paralyzed
paraphernalia: paraphernalia
parasol: parasol
parbleu: parbleu
parcel: parcel
parched: parched
pardon: pardon
paris: paris
parish: parish
parisian: parisian
parlor: parlor
parrot: parrot
partake: partake,partaking
parterre: parterre
partially: partially
particle: particle
partly: partly
party: party
pas: pas
pass: pass,passed,passing
passably: passably
passage: passage
passion: passion,passions
passionately: passionately
pastime: pastime
pasture: pasture,pastured
pat: patted
patch: patch,patching
pate: pate
path: path
pathetic: pathetic
pathos: pathos
pathway: pathway
patience: patience
patient: patient
patois: patois
patter: patter
pattern: pattern,patterns
pauline: pauline
pause: pauses
pave: paved
pavement: pavement
pay: paid,pay,paying
payment: payments
peace: peace
peaceful: peaceful
peacefully: peacefully
peacock: peacock
peanut: peanuts
peasant: peasant
pecan: pecan,pecans
peculiar: peculiar
peep: peeped
peeping: peeping
peg: peg
peignoir: peignoir
pen: pen
pencil: pencil
penetrate: penetrate,penetrated,penetrating
penetration: penetration
pension: pension
pepper: pepper
perambulate: perambulated
perambulation: perambulations
percale: percale
perceive: perceive,perceived
perch: perched
perfect: perfect
perfectly: perfectly
perform: perform,performed,performing
performance: performances
perfume: perfume,perfumes
perfumed: perfumed
perilous: perilous
period: period,periods
periodic: periodic
perish: perish,perished
permanent: permanent
permission: permission
permit: permit,permitted,permitting
perpetual: perpetual
persist: persisted
persistence: persistence
persistently: persistently
person: people,person,persons
personal: personal
personality: personalities,personality
personally: personally
pertain: pertaining
perturb: perturbed
pessimistic: pessimistic
petite: petite
petticoat: petticoats
phantom: phantom
phase: phase
philippe: philippe
philomel: philomel
philosophic: philosophic
photograph: photograph,photographs
phrase: phrase
physical: physical
physician: physician
physique: physique
pianist: pianist
piano: piano
picayune: picayunes
pick: pick,picked,picking
picture: picture,pictured,pictures
picturesque: picturesque
piece: piece,pieces
pied: pied
pierce: piercing
pig: pig,pigs
pigeon: pigeon
pile: pile,piled
pillar: pillar,pillars
pillow: pillow,pillows
pin: pin,pinned,pins
pinch: pinch,pinched
pinched: pinched
pine: pines
pink: pink,pinks
piquant: piquant
pique: piqued
pirate: pirate
pirogue: pirogue
pistol: pistol
pitch: pitch
piteously: piteously
pitiful: pitiful
pittance: pittance
pity: pity
placard: placard
plain: plain
plainly: plainly
plaintive: plaintive
plait: plaited
plan: plan,planning,plans
plank: planks
plant: plants
plantation: plantation,plantations
planter: planter
plate: plate
platter: platters
play: play,played,playing
player: player,players
playful: playful
playing: playing
plead: pleaded
pleasant: pleasant,pleasanter
pleasantly: pleasantly
pleasantry: pleasantry
pleased: pleased
pleasing: pleasing
pleasurable: pleasurable
pleasure: pleasure
plenty: plenty
plot: plot
plow: plowed
pluck: plucked,plucking
plumb: plumb
plume: plumed,plumes
plump: plump
plunge: plunge,plunged
ply: plied
po: po
pocket: pocket,pockets
poet: poet
poetry: poetry
poignancy: poignancy
poignant: poignant
poise: poise
poke: poked,poking
polished: polished
political: political
politics: politics
pompano: pompano
pompously: pompously
ponderous: ponderous
pool: pool,pools
poor: poor
popular: popular
porch: porch
pore: pored,pores
portal: portal,portals
porte: porte
portend: portend
portico: portico
portion: portioned,portions
portly: portly
portrait: portrait,portraits
pose: pose,posed,poses,posing
position: position
positively: positively
possess: possess,possessed,possesses,possessing
possession: possession,possessions
possessor: possessor
possibility: possibilities,possibility
possum: possum
post: post,posted
poster: poster
postpone: postponed
postscript: postscript
pot: pot,pots
pouch: pouch,pouches
pour: poured
pout: pouted
powder: powder
power: power,powers
powerful: powerful
practical: practical
practically: practically
practice: practice,practiced
prairie: prairie
praise: praise
prayer: prayer,prayers
prearrangement: prearrangement
precinct: precincts
precious: precious
precisely: precisely
precision: precision
predict: predicted
predominant: predominant
predominate: predominating
prefer: preferred
pregnant: pregnant
prejudice: prejudice,prejudices
preliminary: preliminary
prelude: prelude
premeditation: premeditation
preparation: preparations
prepare: prepare,prepared,preparing
prepared: prepared
preposterous: preposterous
presbyterian: presbyterian
presbyterianism: presbyterianism
presence: presence
presently: presently
preserve: preserve
preside: presided
presidential: presidential
press: pressed,pressing
pressure: pressure
pretend: pretended
pretension: pretensions
pretentious: pretentious
pretext: pretext,pretexts
pretty: prettier,prettiest,pretty
prevail: prevail,prevailed,prevailing
prevent: prevent
previous: previous
prey: prey
price: price,priced
priceless: priceless
prick: pricking
priest: priest,priests
princess: princess
print: print,printed
prison: prison
private: private
privately: privately
privation: privation
privilege: privilege,privileges
proceed: proceed,proceeded
process: process
processing: processing
procession: procession
procure: procure,procured
produce: produce,produced
production: production
professor: professor
profit: profiting,profits
profitable: profitable
profound: profound
profusion: profusion
programme: programme
progress: progress
prohibition: prohibition
project: project
prolific: prolific
prominently: prominently
promise: promise,promised,promises,promising
promising: promising
promote: promoting
promotion: promotion
prompt: prompted
promptness: promptness
prone: prone
pronounce: pronounced
pronounced: pronounced
proofread: proofread
propensity: propensity
proper: proper
properly: properly
property: property
prophet: prophet
proportion: proportion
propose: proposed
proprietary: proprietary
proprietor: proprietor
prospect: prospect
prospects: prospects
prosperous: prosperous
prostrate: prostrate,prostrating
protect: protect,protected,protecting
protest: protest,protested,protests
protrude: protruded
proudly: proudly
prove: prove,proved
provide: provide,providing
providence: providence
provision: provision,provisions
provoke: provoked
prowl: prowling
prudery: prudery
prunella: prunella
pry: prying
psychologist: psychologist
public: public
puff: puff,puffed,puffs
pull: pull,pulled
pulse: pulses
pungent: pungent
punish: punished
punitive: punitive
purchase: purchase,purchasing
pure: pure
purely: purely
purpose: purpose
purposely: purposely
purse: purse
pursue: pursue,pursued,pursuing
pursuer: pursuers
push: pushed,pushing
puzzle: puzzled
pyre: pyre
quadroon: quadroon
quaff: quaffed
quaint: quaint
qualify: qualifies
quality: quality
quantity: quantity
quarrel: quarrel,quarreled
quarter: quarter,quarters
quaver: quaver
queen: queens
queenly: queenly
queer: queer
quest: quest
question: question,questioned,questions
questioner: questioner
questioning: questioning
quick: quick,quicker
quicken: quickened
quiet: quiet,quieted,quieter
quietly: quietly
quit: quit,quitted,quitting
quiver: quivering
quizzical: quizzical
race: race,races
racing: racing
radiance: radiance
radiant: radiant
rail: rail
railway: railway
rain: rain
rainy: rainy
raise: raised
raisin: raisins
rally: rallied
random: random
range: range,ranged
rank: rank,ranks
rap: rap,rapped
rapid: rapid
rapidity: rapidity
rapt: rapt
rapture: rapture
rare: rare
rarely: rarely
rash: rash
rate: rate
rattle: rattled
rave: raved
ravishing: ravishing
raw: raw
ray: ray,rays
reach: reach,reached,reaching
read: read,reading
readable: readable
reader: reader
reading: reading
readjust: readjusting
ready: ready
real: real
reality: realities,reality
realization: realization
realize: realize,realized,realizes,realizing
realm: realm,realms
rear: rear
rearrange: rearranged
reason: reason,reasons
reasonable: reasonable
reasoning: reasoning
reassure: reassure
rebellion: rebellion
rebuild: rebuild
rebuke: rebuke
recall: recalled,recalling
recapitulate: recapitulated
receipt: receipt
receive: receive,received,receiving
reception: reception
receptive: receptive
recitation: recitation,recitations
reckless: reckless
reclaim: reclaim
recline: reclined,reclining
recognition: recognition
recognize: recognize,recognized
recollection: recollection,recollections
recommend: recommended,recommending
reconcile: reconcile,reconciling
recover: recovering
red: red
redistribute: redistribute,redistributing
redistributing: redistributing
redistribution: redistribution
redouble: redoubling
reduce: reduced
reed: reed,reeds
reel: reeled,reeling
reenter: reentered
reference: references
reflect: reflected,reflects
reflection: reflection
refrain: refrain
refresh: refreshed
refreshing: refreshing
refreshment: refreshment
refuge: refuge
refund: refund
refusal: refusal
refuse: refuse,refused
regain: regain,regained
regal: regal
regard: regard,regarded
region: region,regions
register: registered
regret: regret,regrets,regretted,regretting
regular: regular
regulate: regulated,regulating
reiterate: reiterated
rejoice: rejoice
relate: relate,relating
relation: relations
relax: relax
relaxation: relaxation
release: release
relent: relent
reliable: reliable
relic: relic,relics
relief: relief
relieve: relieving
religion: religion
religious: religious
religiously: religiously
relinquish: relinquish
relish: relish
remain: remain,remained,remaining
remainder: remainder
remark: remark,remarked,remarks
remarkably: remarkably
remedy: remedies
remember: remember,remembered,remembering
remembering: remembering
remind: reminded
reminder: reminder
reminiscent: reminiscent
remittent: remittent
remnant: remnant
remodeling: remodeling
remonstrance: remonstrance
remonstrate: remonstrate
remorse: remorse
remove: remove,removed,removing
rename: renamed
render: rendered
rendezvous: rendezvous
renew: renewed
rent: rent
repair: repairing
repast: repast
repeat: repeated,repeating
repel: repelled
replace: replace,replaced
replacement: replacement
reply: replied,replies,reply
report: report,reported,reports
repose: repose
representation: representations
repression: repression
reproach: reproach,reproached
reproachful: reproachful
reprove: reproves
repulse: repulse,repulsed
repulsive: repulsive
reputation: reputation
request: request,requested
require: require,required,requiring
requirement: requirements
resemblance: resemblance
resemble: resembled,resembling
resent: resented
resentment: resentment
reserve: reserve
residence: residence
resign: resigned
resignation: resignation
resist: resisted
resistance: resistance
resistant: resistant
resolutely: resolutely
resolve: resolve,resolved
resounding: resounding
resource: resources
respect: respect
respectable: respectable
respectful: respectful
respectfully: respectfully
respects: respects
resplendent: resplendent
respond: responded
response: response
responsibility: responsibilities,responsibility
responsible: responsible
responsive: responsive
rest: rest,rested,resting
restaurant: restaurant
restful: restful
restfulness: restfulness
restless: restless
restlessly: restlessly
restore: restored
restrain: restrain
restriction: restrictions
result: result
resume: resume,resumed
retain: retain,retained
retire: retire,retired
retired: retired
retort: retorted
retrace: retrace
retreat: retreat
retrospection: retrospection
return: return,returned,returning,returns
reveal: reveal,revealed,revealing
revel: reveling
revelation: revelation
revengeful: revengeful
revenue: revenue
reverie: reverie
reverse: reverses
review: review
revive: revived,reviving
revoir: revoir
revolt: revolt
revolving: revolving
reward: rewarding
rhapsodic: rhapsodic
rhine: rhine
rhythm: rhythm
ribbon: ribbon,ribbons
rich: rich
richness: richness
rid: rid
ride: ride,riding,rode
ridiculous: ridiculous
ridiculously: ridiculously
rifle: rifle
rightly: rightly
rigid: rigid
ripe: ripe
ripple: ripple
rise: rise,risen,rises,rising,rose
river: river
rivet: riveted
road: road,roads
roadside: roadside
roam: roamed
roar: roar,roaring
roast: roast
rob: robbed
robe: robes
robert: robert
robust: robust
rock: rock
rockaway: rockaway
rocker: rocker
rocking: rocking
role: role
roll: roll,rolled,rolling
romance: romance
roof: roof,roofed
rope: rope,ropes
rose: rose,roses
rough: rough
roun: roun
rounded: rounded
row: row,rows
royal: royal
royalty: royalties,royalty
rub: rubbed,rubbing
rubber: rubber
ruddy: ruddy
rude: rude
rudeness: rudeness
ruffle: ruffle,ruffles
rug: rug,rugs
rugged: rugged
ruin: ruin,ruined,ruins
rule: rule,rules
rumble: rumbled
rummage: rummaged
running: running
rush: rush
rusty: rusty
ruthless: ruthless
saber: saber
sacrifice: sacrifice
sad: sad
saddle: saddle
sadly: sadly
safe: safe
safely: safely
sage: sage
sail: sail,sailing,sails
sailor: sailor
sake: sake
saliva: saliva
sally: sally
salon: salon
salt: salt,salts
salve: salve
samaritan: samaritans
sanctify: sanctified
sand: sand,sanded,sands
sandal: sandals
sandy: sandy
sane: sane
sapphire: sapphires
sardonically: sardonically
satan: satan
satin: satin
satiny: satiny
satisfaction: satisfaction
satisfactorily: satisfactorily
satisfactory: satisfactory
satisfied: satisfied
satisfy: satisfied,satisfy,satisfying
saturday: saturday
saucer: saucer
saucy: saucy
savage: savage
save: save,saved,saving
saviour: saviour
scald: scalding
scale: scale
scamp: scamp
scamper: scampered
scan: scanned
scandal: scandal
scantling: scantling
scar: scar
scarcely: scarcely
scarf: scarf,scarfs
scatter: scatter,scattered
scene: scene,scenes
scent: scent
scented: scented
scheme: scheme
school: school
scintillant: scintillant
scissors: scissors
scold: scolded,scolding
scoop: scoop
scorch: scorched
scorched: scorched
scour: scoured
scowl: scowled
scramble: scramble
scrap: scrap,scraps
scrape: scraping
scratch: scratch,scratching
scrawl: scrawl,scrawled
scream: screamed
scribble: scribbled
scrub: scrub
scrupulously: scrupulously
sea: sea
search: search,searching
searchingly: searchingly
seashore: seashore
season: season,seasoned,seasons
seat: seat,seated,seating,seats
seating: seating
seaward: seaward
secret: secret,secrets
secretary: secretary
secure: secure,secured,securing
securely: securely
security: securities,security
seductive: seductive
seek: seek,seeking,seeks,sought
seemingly: seemingly
seigneur: seigneur
seize: seized,seizing
seldom: seldom
select: select,selected,selecting
selection: selection,selections
selfish: selfish
selfishness: selfishness
sell: sell,selling,sold
semblance: semblance
sence: sence
send: send,sending,sends
sensation: sensation,sensations
sense: sense
senseless: senseless
sensitive: sensitive
sensitively: sensitively
sensuality: sensuality
sensuous: sensuous
sensuousness: sensuousness
sentence: sentence
sentiment: sentiment
sentimental: sentimental
sentimentally: sentimentally
separate: separate
seriocomic: seriocomic
serpent: serpent,serpents
servant: servant,servants
serve: served,serves,serving
service: service,services
set: set,setting
settle: settled,settling
severe: severe
severity: severity
sew: sew,sewed
sewing: sewing
sex: sex
sha: sha
shabbiness: shabbiness
shabby: shabby
shade: shade
shades: shades
shadow: shadow,shadowed,shadows
shadowy: shadowy
shaggy: shaggy
shake: shake,shaken,shakes,shaking,shook
shallow: shallow
shame: shame
shape: shape,shaped,shapes
shapely: shapely
share: share,shared,sharing
sharp: sharp
sharply: sharply
sharpshoot: sharpshooting
shatter: shatter,shattering
shave: shaved
shawl: shawl
sheen: sheen
sheeny: sheeny
sheet: sheets
shelter: shelter
shield: shielded
shift: shifted
shimmer: shimmer
shine: shines,shining,shone
shingle: shingle
ship: ships
shirt: shirt
shirting: shirting
shiver: shivering
shock: shock,shocked,shocks
shod: shod
shoe: shoe,shoes
shoot: shot
shop: shop
shopping: shopping
shore: shore,shores
short: short
shortcoming: shortcomings
shot: shot
shoulder: shoulder,shoulders
shout: shout,shouted,shouting
shove: shoving
shower: showered,showering
shred: shreds
shriek: shrieked,shrieks
shrill: shrill
shrimp: shrimps
shrug: shrug,shrugged
shudder: shuddered
shuffling: shuffling
shut: shut,shuts,shutting
shutter: shutters
shy: shy
sick: sick
sicken: sickens
sidewalk: sidewalks
sidewise: sidewise
sidle: sidling
sigh: sigh,sighed,sighs
sight: sight
sign: sign
signal: signaled
significance: significance
silence: silence
silent: silent
silently: silently
silk: silk
silken: silken
silky: silky
sill: sill
silver: silver
simple: simple
simplicity: simplicity
simply: simply
simultaneously: simultaneously
sin: sin,sins
sincerity: sincerity
sing: sang,sing,singing,sung
single: single
singly: singly
sinister: sinister
sink: sank,sink,sinking,sunk
sip: sipped,sipping
sir: sir
sister: sister,sisters
sisterly: sisterly
sit: sat,sit,sits,sitting
situate: situated
situation: situation
size: size
sizzle: sizzle,sizzled
sketch: sketch,sketches,sketching
skilful: skilful
skill: skill
skin: skin
skirmishing: skirmishing
skirt: skirt,skirted,skirting,skirts
sky: sky
slacken: slackened
slam: slamming
slant: slanting
slap: slaps
slash: slashing
slave: slaves
slavery: slavery
sleek: sleek
sleep: sleep,sleeping,sleeps,slept
sleepless: sleepless
sleepy: sleepy
sleeve: sleeve,sleeves
slender: slender
slice: slice,slices
slight: slight,slightest
slim: slim
slime: slime
slimy: slimy
slip: slip,slipped
slipper: slippers
slippered: slippered
slope: slope,sloping
slow: slow
slowly: slowly
sluggish: sluggish
slumber: slumbers
slumbering: slumbering
sly: sly
smash: smashed
smell: smell,smelled,smelling
smile: smile,smiled,smiles,smiling
smite: smote
smoke: smoke,smoked,smoking
smolder: smoldering
smooth: smooth,smoothed,smoothing
smoothly: smoothly
smoulder: smouldered,smouldering
smudge: smudge
snack: snack
snail: snail
snake: snakes
snap: snapped
snappy: snappy
snatch: snatched
sneer: sneered
sniffle: sniffled
snow: snow
snub: snub
snuggery: snuggery
snuggle: snuggled
soar: soar
sob: sobbed,sobbing,sobs
sociably: sociably
social: social
society: society
sofa: sofa
soft: soft,softest
soften: softened,softening
softly: softly
softness: softness
soil: soiled
soiled: soiled
sojourn: sojourn
soldier: soldier
sole: sole
solely: solely
solemn: solemn
solicit: solicit
solicitation: solicitation
solicitous: solicitous
solicitously: solicitously
solicitude: solicitude
solid: solid
solitary: solitary
solitude: solitude
solution: solution
somber: somber
sombre: sombre
someway: someway
son: son
song: song,songs
songster: songsters
sonorous: sonorous
soot: soot
soothe: soothed,soothing
soothing: soothing
soothingly: soothingly
sort: sort
soul: soul,souls
soulful: soulful
sound: sound,sounded,sounding,sounds
soundly: soundly
soup: soup
source: source
south: south
southern: southern
space: space
span: span
spanish: spanish
spare: spare,sparing
spark: spark
sparkle: sparkle,sparkled
sparkling: sparkling
spasm: spasm
spasmodic: spasmodic
speak: speak,speaking,speaks,spoke,spoken
special: special
specimen: specimen
speck: specks
spectacle: spectacle
spectacles: spectacles
speculate: speculated,speculating
speculation: speculation,speculations
speech: speech
speechless: speechless
speed: speeding
spell: spell
spend: spend,spending,spent
sphere: sphere,spheres
spiced: spiced
spill: spilled
spin: spun
spinal: spinal
spirit: spirit,spirits
spiritual: spiritual
splash: splash,splashed,splashing
splendid: splendid
splendor: splendor
spoil: spoiled,spoiling
spoken: spoken
spoon: spoon
sporadic: sporadic
sport: sporting,sports
spot: spot,spots
spotless: spotless
spray: spray,sprays
spread: spread
spring: sprang,spring,springing,sprung
springy: springy
sprinkle: sprinkled
spur: spurs
sputter: sputtered
squander: squander
square: square
squat: squat,squatted
squint: squinting
squirrel: squirrel
stab: stabbed,stabbing
stable: stables
staff: staff
stage: stage
stagger: staggered
staggering: staggering
stain: stained
stair: stairs
stairway: stairway
stake: staked,stakes
stalk: stalks
stall: stall
stammer: stammered
stamp: stamped
stan: stan
stand: stand,standing,stands,stood
standard: standard
standing: standing
star: stars
starched: starched
stare: stare,stared
start: start,started,starting,starts
startled: startled
startling: startling
starvation: starvation
stately: stately
statement: statements
statesman: statesman
statuesque: statuesque
statuette: statuette
status: status
stay: stay,stayed,staying
steadily: steadily
steady: steadied,steady
steal: stealing,stole,stolen
stealthy: stealthy
steam: steaming
steamer: steamer,steamers
steep: steep
step: step,stepped,stepping,steps
stepladder: stepladder
stereotyped: stereotyped
stick: stick,sticking,sticks,stuck
sticking: sticking
stiff: stiff
stiffness: stiffness
stifle: stifling
stifling: stifling
stigma: stigma
stillness: stillness
sting: sting,stinging
stinging: stinging
stir: stir,stirred,stirring
stock: stock,stocks
stocking: stockings
stockings: stockings
stolen: stolen
stomach: stomach,stomachs
stone: stone
stool: stool
stoop: stooped
store: store,stored
story: stories,story
storytelling: storytelling
stout: stout
stove: stove
straight: straight
straighten: straighten,straightened
strain: strain,strained,strains
strand: strands
strange: strange
straw: straw
stray: stray,strayed
stream: stream,streams
streaming: streaming
street: street,streets
strength: strength
strenuous: strenuous
stretch: stretch,stretched,stretching
strict: strict
strictly: strictly
stride: stride,strides,strode
strike: strike,strikes,striking,struck
strikingly: strikingly
strip: strip,strips
strive: strive,striving,strove
stroke: stroke,stroked,strokes,stroking
stroll: strolled,strolling,strolls
strong: strong,stronger
structure: structure
struggle: struggle,struggles,struggling
stub: stub
stubble: stubble
stubborn: stubborn
stuccoed: stuccoed
study: studied,studies,study
stuff: stuffed
stuffy: stuffy
stumble: stumble,stumbled,stumbling
stun: stunned
stunned: stunned
stunning: stunning
stupid: stupid
stupor: stupor
sturdy: sturdy
stylish: stylish
subject: subject,subjected
submission: submission
submissively: submissively
submissiveness: submissiveness
submit: submit,submitted
subscribe: subscribe
subsequent: subsequent
subservience: subservience
subsist: subsisted
substance: substance
subterfuge: subterfuges
subtle: subtle
suburb: suburbs
succeed: succeed,succeeded
success: success,successes
successful: successful
sudden: sudden
suddenly: suddenly
suddenness: suddenness
suds: suds
suffer: suffer,suffered,suffering
suffering: suffering,sufferings
sufficient: sufficient
suffuse: suffused
sugar: sugar
suggestion: suggestion,suggestions
suit: suit,suited
suitable: suitable
suitably: suitably
suited: suited
sullen: sullen
sullenly: sullenly
sum: sum
summer: summer,summers
summon: summoned
summons: summons
sumptuous: sumptuous
sun: sun
sunday: sunday
sundry: sundry
sunlight: sunlight
sunny: sunny
sunshade: sunshade
supercilious: supercilious
superior: superior
superstitious: superstitious
supervision: supervision
supper: supper
supple: supple
supplication: supplication
supply: supplied,supply,supplying
support: support,supported,supporting
suppose: suppose,supposed
surely: surely
sureness: sureness
surf: surf
surface: surface
surprise: surprise,surprised,surprises
surprised: surprised
surround: surrounded
surroundings: surroundings
survey: surveyed,surveying
survive: survive,survived
susceptibility: susceptibility
susceptible: susceptible
susie: susie
suspect: suspect,suspected
suspend: suspended
suspense: suspense
suspicion: suspicion
sustain: sustained
sustaining: sustaining
swallow: swallowed
swamp: swamp
sward: sward
swarm: swarm
sway: swayed,swaying
swear: swore
sweat: sweat
sweep: sweep,sweeping,swept
sweeping: sweeping
sweet: sweet
sweetheart: sweetheart
swell: swelled
swift: swift
swiftly: swiftly
swim: swam,swim,swum
swimmer: swimmer
swimming: swimming
swing: swing,swung
sycamore: sycamore
syllable: syllable
symbol: symbols
symmetrical: symmetrical
sympathy: sympathy
symphony: symphony
symptom: symptoms
synonymous: synonymous
syrup: syrups
systematic: systematic
table: table,tables
tabouret: tabouret
tacit: tacit
tact: tact
tactless: tactless
taint: taint
tale: tale
talent: talent
talk: talk,talked,talking
talkative: talkative
talking: talking
tall: tall,tallest
tamale: tamales
tan: tan
tangle: tangle
tangled: tangled
tap: tapped
taper: taper
tardy: tardy
task: task
taste: taste,tasted,tastes
tasteful: tasteful
tasty: tasty
tattered: tattered
taut: taut
tax: tax,taxes
tea: tea
teaching: teachings
tear: tearing,tears,tore,torn
teens: teens
temerity: temerity
temper: temper,tempered
temperament: temperament
tempest: tempest
temple: temple,temples
temporary: temporary
tempt: tempt,tempted
temptation: temptation
tempting: tempting
tender: tender
tenderloin: tenderloin
tenderly: tenderly
tenderness: tenderness
tenfold: tenfold
tenor: tenor
tent: tent
tenth: tenth
term: term,terms
terre: terre
terrible: terrible
terribly: terribly
terrifying: terrifying
terror: terror,terrors
texan: texans
texture: texture
thankful: thankful
theatre: theatre
theme: theme
thereon: thereon
thimble: thimble
thinking: thinking
thorn: thorn
thoroughfare: thoroughfares
thoughtful: thoughtful
thoughtfulness: thoughtfulness
thoughtlessness: thoughtlessness
thrash: thrash,thrashed,thrashing
thread: thread,threaded
threaten: threatened,threatening
threshold: threshold
thrilled: thrilled
throat: throat
throb: throbbed
throne: throne
throw: threw,throw,throwing,thrown
thrust: thrust
thursday: thursday
thwart: thwart
tiara: tiara
tie: tied
tien: tiens
tight: tight
tightly: tightly
tights: tights
tignon: tignon
tile: tiles
time: time,times
timely: timely
tin: tin
tinge: tinged
tinker: tinkering
tint: tint,tints
tiny: tiny
tiptoe: tiptoes
tire: tire,tires
tired: tired
tiresome: tiresome
tisane: tisane
title: title
tobacco: tobacco
toddle: toddling
toddy: toddies,toddy
toe: toes
toilet: toilet
tone: tone,toned,tones
tongue: tongue
tonic: tonic
tool: tool,tools
tooth: teeth
toothsome: toothsome
topic: topics
topmost: topmost
torch: torch
torment: tormented
torpid: torpid
torrent: torrent
torrid: torrid
tortuous: tortuous
torture: torture
toss: tossed
tot: tots
tots: tots
totter: tottered,tottering
touch: touch,touched,touching
tough: tough
towel: towels
tower: towering
town: town
trace: trace
track: track
trade: trade
trademark: trademark
tradesman: tradesmen
trading: trading
tradition: tradition,traditions
tragedian: tragedian
tragedy: tragedy
trail: trail,trailing
train: train
training: training
trait: traits
tramp: tramp,tramping
trample: trample
transcendently: transcendently
transcribe: transcribe
transcription: transcription
transform: transformed
transformation: transformation
transport: transported
travel: travel
traverse: traversed
tray: tray
treacherous: treacherous
tread: tread
treadle: treadle
treadmill: treadmill
treasure: treasure,treasures
treat: treat
treatment: treatment
treble: treble
tree: tree,trees
trellis: trellis
tremble: trembled,trembling
tremor: tremor
trial: trial
trick: tricks
trickle: trickled
trifle: trifle,trifles
trim: trim,trimmed
trimming: trimming,trimmings
trip: trip,tripping
triumphant: triumphant
trivial: trivial
troop: troop
trot: trot,trots
trouble: trouble,troubled
troubled: troubled
troublesome: troublesome
troubling: troubling
trousers: trousers
trudge: trudging
true: true
trump: trumped
trumpet: trumpet
trunk: trunk,trunks
trust: trust,trusted
truth: truth
tu: tu
tub: tub,tubs
tuck: tucking
tuesday: tuesday
tuesdays: tuesdays
tulle: tulle
tumble: tumble,tumbling
tumult: tumult
tune: tune,tuning
turbaned: turbaned
turbulent: turbulent
turf: turf
turmoil: turmoil
twin: twins
twine: twined
twinkle: twinkled
twirl: twirled,twirling
twist: twisted
twisted: twisted
twitch: twitch
type: type,types
ugly: ugly
ultimate: ultimate
umbrella: umbrella
unable: unable
unacceptable: unacceptable
unaccountable: unaccountable
unaccustomed: unaccustomed
unaffected: unaffected
unaided: unaided
unamiable: unamiable
unanointed: unanointed
unapproachable: unapproachable
unattainable: unattainable
unattractive: unattractive
unavoidable: unavoidable
unaware: unaware
unbalanced: unbalanced
unbounded: unbounded
unbroken: unbroken
uncalled: uncalled
uncanny: uncanny
unceremoniously: unceremoniously
uncertain: uncertain
uncertainly: uncertainly
unchanged: unchanged
unclasp: unclasped
uncle: uncle
uncomfortable: uncomfortable
uncommon: uncommon
uncomprehending: uncomprehending
unconciliated: unconciliated
unconscious: unconscious
unconsciously: unconsciously
unconvincing: unconvincing
uncover: uncovered
undercurrent: undercurrents
undergo: undergoing,undergone
understand: understand,understood
understanding: understanding
undertone: undertone
underwear: underwear
undignified: undignified
undiluted: undiluted
undisturbed: undisturbed
undress: undressed
undressed: undressed
undue: undue
undulate: undulating
undusted: undusted
uneasy: uneasy
unenforceability: unenforceability
unessential: unessential
uneven: uneven
uneventful: uneventful
unexpected: unexpected
unexpectedly: unexpectedly
unfamiliar: unfamiliar
unfasten: unfastened
unfit: unfit
unflinching: unflinching
unflinchingly: unflinchingly
unfold: unfold,unfolded,unfolding,unfolds
unfortunate: unfortunate
unfriendly: unfriendly
unfulfilled: unfulfilled
ungenerous: ungenerous
ungovernable: ungovernable
ungraceful: ungraceful
ungrateful: ungrateful
unguided: unguided
unhappy: unhappy
unheard: unheard
unheeded: unheeded
unheedingly: unheedingly
unhook: unhooking
uniform: uniform,uniforms
unimpressionable: unimpressionable
uninterested: uninterested
uninteresting: uninteresting
union: union
unite: united
united: united
universally: universally
universe: universe
unjustly: unjustly
unkind: unkind
unknown: unknown
unlatched: unlatched
unlimited: unlimited
unlink: unlink
unlock: unlocked,unlocking
unlooked: unlooked
unmanageable: unmanageable
unmarried: unmarried
unmistakable: unmistakable
unmolested: unmolested
unmoved: unmoved
unnatural: unnatural
unnecessary: unnecessary
unnoticed: unnoticed
unnumbered: unnumbered
unoccupied: unoccupied
unpin: unpinning
unpleasant: unpleasant
unpleasantness: unpleasantness
unpopular: unpopular
unpresentable: unpresentable
unpretentious: unpretentious
unprofessional: unprofessional
unprotected: unprotected
unqualified: unqualified
unreal: unreal
unreality: unreality
unreasonable: unreasonable
unresponsive: unresponsive
unrest: unrest
unscrupulous: unscrupulous
unsolicited: unsolicited
unsought: unsought
unspeakably: unspeakably
unsteady: unsteady
unthinking: unthinking
unthinkingly: unthinkingly
untold: untold
untouched: untouched
untrained: untrained
unusual: unusual
unusually: unusually
unwilling: unwilling
unwise: unwise
unwomanly: unwomanly
unwonted: unwonted
unworthy: unworthy
upbraid: upbraiding
update: updated
uplift: uplifted
uplifted: uplifted
upper: upper
upset: upset
upside: upside
upstairs: upstairs
upward: upward
urge: urged,urging
usage: usage
useless: useless
user: user
usher: ushered
usual: usual
ut: ut
utilize: utilized
utmost: utmost
utter: utter,uttered,uttering
utterance: utterances
utterly: utterly
vacant: vacant
vacantly: vacantly
vacation: vacation
vague: vague
vaguely: vaguely
vain: vain
valuable: valuable
valueless: valueless
vanilla: vanilla
vanish: vanished,vanishing
variety: variety
vase: vase
vast: vast
vastly: vastly
vegetable: vegetable,vegetables
vehemently: vehemently
vehicle: vehicle
veil: veil
vein: veins
velvet: velvet
velvety: velvety
vender: vender
venom: venom
venture: venture,ventured,ventures
venus: venus
vera: vera
veranda: veranda
veritable: veritable
verse: verse
version: version
vertical: vertical
vespers: vespers
vessel: vessel
vest: vest
vibrant: vibrant
victor: victor
view: view,viewed,viewing
vigor: vigor
vii: vii
viii: viii
vile: vile
village: village
vine: vine,vines
vinegar: vinegar
vingt: vingt
violate: violates
violence: violence
violent: violent
violet: violets
violin: violin
virgin: virgin
virtue: virtue
virus: virus
visage: visage
visible: visible
vision: vision,visions
visit: visit,visited,visiting,visits
visitor: visitor,visitors
vital: vital
vivacious: vivacious
vivid: vivid
vividly: vividly
vixen: vixen
voice: voice,voiced,voices,voicing
void: void
volition: volition
volley: volley
volubility: volubility
volume: volumes
volunteer: volunteer,volunteers
voluptuous: voluptuous
vouchsafe: vouchsafe
vow: vows
vulture: vultures
waco: waco
waddle: waddled,waddling
wade: wading
wagon: wagon
wail: wailed,wailing
waist: waist,waists
wait: wait,waited,waiting
waiter: waiter,waiters
wake: wake,waking
wakeful: wakeful
wakefulness: wakefulness
walk: walk,walked,walking,walks
wall: wall,walls
waltz: waltz
wand: wand
wander: wander,wandered,wandering
wane: waning
war: war
warble: warbled
wares: wares
warm: warm,warmed
warming: warming
warmly: warmly
warmth: warmth
warn: warned
warning: warning
warranty: warranties,warranty
wash: wash,washed,washing
waste: wasting
watch: watch,watched,watching
water: water,waters
wave: waved,waves,waving
wavelet: wavelets
wax: wax
waxen: waxen
wayside: wayside
weaken: weakening
weakling: weaklings
wealth: wealth
wear: wear,wearing,wore,worn
weary: weary
weather: weather
weave: weave,weaving
weazen: weazened
wedding: wedding
weed: weeding,weeds
week: week,weeks
weekday: weekday
weep: weep,weeping,wept
weigh: weighed
weight: weight
welfare: welfare
west: west
western: western
wet: wet
wharf: wharf
whatsoever: whatsoever
whiff: whiff
whimsical: whimsical
whip: whip,whipped
whirl: whirling
whisper: whisper,whispered,whispering,whispers
whistle: whistle,whistling
white: white,whiter
whithersoever: whithersoever
wholly: wholly
wicked: wicked
wicker: wicker
wide: wide,widest
widen: widen
widespread: widespread
widow: widow
wife: wife,wives
wiggle: wiggled
wild: wild
wilderness: wilderness
wiles: wiles
willingly: willingly
willingness: willingness
willow: willow,willows
wind: wind,winds,wound
window: window,windows
wine: wine,wines
wing: wing,winging,wings
wink: winked
winter: winter
wipe: wipe,wiped,wiping
wiry: wiry
wisdom: wisdom
wise: wise,wiser
witchery: witchery
withdraw: withdraw,withdrawn,withdrew
withhold: withholding
witness: witness,witnessed
witticism: witticisms
wizard: wizard
woman: woman,women
womanly: womanly
wonderfully: wonderfully
wondrous: wondrous
wood: wood,woods
wooden: wooden
word: word
wordy: wordy
workbasket: workbasket
workman: workmen
workmanship: workmanship
worldly: worldly
worm: worms
worn: worn
worried: worried
worship: worshiped,worships
worth: worth
worthless: worthless
worthy: worthy
wound: wound,wounded
wrap: wrap,wrapped
wrapper: wrapper
wrapping: wrapping
wrench: wrench
wriggle: wriggling
wrist: wrist,wristed,wrists
wristband: wristbands
write: write,writes,writing,written,wrote
writhe: writhe,writhed,writhing
writing: writing
xi: xi
xii: xii
xiii: xiii
xiv: xiv
xix: xix
xvi: xvi
xvii: xvii
xviii: xviii
xx: xx
xxi: xxi
xxii: xxii
xxiii: xxiii
xxiv: xxiv
xxv: xxv
xxx: xxx
yair: yair
yard: yard,yards
yawn: yawned
yearning: yearnings
yellow: yellow
yellowish: yellowish
yesterday: yesterday
yield: yield,yielded,yielding
york: york
youngster: youngster,youngsters
youth: youth
youthful: youthful
