abandon: abandoned
abashed: abashed
abatement: abatement
abdicate: abdicated
abhorrent: abhorrent
abide: abide,abiding
ability: ability
aboard: aboard
abomination: abominations
abound: abound
abreast: abreast
abruptness: abruptness
absence: absence
absent: absent
absolute: absolute
absolutely: absolutely
absorb: absorbing,absorbs
abstract: abstract
abstraction: abstractions
abundance: abundance
abuse: abused,abusing
academical: academical
academy: academy
accent: accent
accentuate: accentuated
accept: accept,accepted,accepting
acceptance: acceptance
accepted: accepted
access: access,accessed
accessible: accessible
accession: accession
accident: accident
accidental: accidental
accidentally: accidentally
accompany: accompanied,accompany,accompanying
accomplishment: accomplishment,accomplishments
account: account
accumulate: accumulated
accurate: accurate
accurately: accurately
accustom: accustomed
ache: ached
achieve: achieved
achievement: achievements
acknowledge: acknowledging
acknowledgment: acknowledgment
acquaint: acquainted
acquaintance: acquaintance,acquaintances
acquiesce: acquiesce
acquiescence: acquiescence
acquire: acquired,acquiring
acquirement: acquirements
acquisition: acquisitions
acquist: acquist
acre: acres
acting: acting
action: action,actions
active: active
activity: activities,activity
actor: actor,actors
actress: actress
actual: actual
acute: acute
adam: adam
adamant: adamant
adapt: adapted
add: add,adding,adds
addition: addition,additions
additional: additional
address: address,addressed,addresses
adhere: adhering
adherent: adherents
adjoining: adjoining
adjuration: adjurations
admirable: admirable
admirably: admirably
admiral: admiral,admirals
admiralty: admiralty
admiration: admiration
admire: admire,admired,admiring
admirer: admirer,admirers
admission: admission
admit: admit
admonition: admonitions
adore: adored
adorn: adorn
advance: advanced
advantage: advantage,advantages
adventure: adventure,adventures
adventurer: adventurers
adversary: adversaries,adversary
advertisement: advertisement
advice: advice
advisable: advisable
advise: advise,advised
adviser: adviser
advocate: advocate
affair: affair,affairs
affairs: affairs
affect: affect
affection: affection,affections
affectionate: affectionate
affliction: affliction
afford: afford
afloat: afloat
afraid: afraid
afresh: afresh
africa: africa
african: african
aft: aft
afternoon: afternoon
afterpiece: afterpiece
agamemnon: agamemnon
age: age
aged: aged
agency: agency
agent: agent
aggressive: aggressive
agitation: agitation
agonising: agonising
agony: agonies,agony
agree: agree,agreed
agreeable: agreeable
agreement: agreement
aground: aground
aid: aid,aiding
aide: aide
aim: aim,aims
air: air
airy: airy
ak: ak
alarm: alarm
alarming: alarming
alarmingly: alarmingly
alas: alas
albanian: albanians
albert: albert
alert: alert
alexander: alexander
alexandria: alexandria
alfred: alfred
algebra: algebra
algiers: algiers
alice: alice
alike: alike
alive: alive
allege: allege
alleviate: alleviated
alleviation: alleviations
allied: allied
allowance: allowance
ally: allies
alnaschar: alnaschar
aloof: aloof
aloud: aloud
alp: alp
alps: alps
alt: alt
alteration: alteration,alterations
alternate: alternate
alternation: alternations
altogether: altogether
amateur: amateur
amaze: amazed
amazed: amazed
amazingly: amazingly
ambiguity: ambiguity
ambition: ambition
ambitious: ambitious
amend: amending
america: america
american: american,americans
ami: ami
amiability: amiability
amiable: amiable
amis: amis
amply: amply
amuse: amuse,amused
amusement: amusement
amusing: amusing
amusingly: amusingly
analogous: analogous
anatomical: anatomical
anchor: anchor,anchored
ancient: ancient
anderson: anderson
anger: anger
angry: angry
anguished: anguished
animal: animal,animals
animals: animals
anna: anna
anne: anne
annie: annie
annoyance: annoyance
annoyed: annoyed
annoying: annoying
annual: annual,annuals
annually: annually
answer: answer,answered,answering,answers
answerable: answerable
answering: answering
antagonistic: antagonistic
anticipation: anticipations
antiquarian: antiquarian
antique: antique
antithesis: antithesis
antony: antony
anvil: anvil
anxiety: anxiety
anxious: anxious
anxiously: anxiously
ap: ap
apathetically: apathetically
aphasic: aphasic
apology: apologies,apology
apotheosis: apotheosis
appalling: appalling
apparatus: apparatus
apparent: apparent
appeal: appeal
appearance: appearance,appearances
appendix: appendix
appetite: appetite
apple: apple,apples
appliance: appliance,appliances
applicable: applicable
application: application,applications
apply: applied,apply
appoint: appoint,appointed
appointment: appointment
appreciation: appreciation,appreciations
apprehension: apprehension
apprentice: apprentice
apprenticeship: apprenticeship
approach: approach,approached,approaches
approval: approval
approve: approve,approved,approves
approximation: approximation
april: april
apt: apt
aptitude: aptitude
aptly: aptly
aquarium: aquarium
arab: arab,arabs
arbor: arbor
arcadia: arcadia
arch: arch
archaic: archaic
archbishop: archbishop
arched: arched
archer: archer
archibald: archibald
archipelago: archipelago
architect: architect,architects
architectural: architectural
architecture: architecture
archive: archive
ardent: ardent
ardour: ardour
argue: argue
argument: argument,arguments
arid: arid
arithmetic: arithmetic
arm: arm,armed,arms
armchair: armchair
armed: armed
armistice: armistice
armour: armour
armstrong: armstrong
army: army
aromatic: aromatic
arrange: arrange,arranged
arrangement: arrangement,arrangements
arrant: arrant
array: array
arrest: arrest
arrival: arrival
arrive: arrive,arrived
arrow: arrow
art: art,arts
artery: arteries
article: article,articles
articulate: articulate
artifice: artifice
artificial: artificial
artillery: artillery
artisan: artisan
artist: artist,artists
artistic: artistic
artless: artless
arts: arts
ascent: ascent
ascertain: ascertain,ascertaining
ascetic: ascetic
ascii: ascii
ashamed: ashamed
ashore: ashore
askance: askance
asleep: asleep
aspect: aspect
aspiration: aspirations
aspire: aspire
assist: assist,assisted,assisting,assists
assistance: assistance
assistant: assistant
association: association,associations
associations: associations
assortment: assortment
assume: assume
assure: assure,assured,assuring
astern: astern
astonish: astonished
astonishment: astonishment
astray: astray
astute: astute
atheist: atheist
atheistic: atheistic
atlantic: atlantic
atlas: atlas
atmosphere: atmosphere
atom: atoms
attach: attached
attack: attack
attain: attained
attainable: attainable
attainment: attainment
attempt: attempt,attempted
attend: attend,attended,attending
attendance: attendance
attention: attention
attentive: attentive
attest: attest
attitude: attitude
attorney: attorney
attract: attracted,attracting
attraction: attraction,attractions
attractive: attractive
audience: audience
aught: aught
aunt: aunt
auspices: auspices
austin: austin
author: author,authors
authority: authorities,authority
autumn: autumn
aux: aux
avenue: avenue
average: averages
avion: avions
avoid: avoid,avoided
avoir: avoir
avow: avowed
await: await,awaited
awake: awoke
award: awarded
aware: aware
awe: awe
awful: awful
awkward: awkward
awning: awning,awnings
axle: axle
ay: ay
azure: azure
baby: baby
background: background
bad: bad,worse,worst
badger: badger
badly: badly
badness: badness
bag: bag
baggage: baggage
baggy: baggy
bailiwick: bailiwick
baked: baked
bale: baling
ball: ball
ballad: ballads
ballot: ballot
baltic: baltic
band: band,bands
banded: banded
bang: bangs
bank: bank,banks
bankruptcy: bankruptcy
banquet: banquet
banter: banter,bantered
bar: bar
barbadoes: barbadoes
barbarian: barbarian,barbarians
barbaric: barbaric
barbarity: barbarity
bare: bare
bared: bared
barely: barely
barn: barn
baron: baron
baronetcy: baronetcy
barque: barque
barracks: barracks
barrel: barrel
barren: barren
barricade: barricade,barricaded,barricades
barrier: barrier
bas: bas
base: base,based
bashibazouk: bashibazouk
basis: basis
basket: baskets
bass: bass
bastard: bastard
bastille: bastille
bastion: bastions
bat: bat
bath: bath,bathed
battalion: battalions
batter: battering
battery: batteries
battle: battle
battlements: battlements
baxter: baxter
bay: bay
bazaar: bazaar
bea: bea
beach: beach
bear: bear,bearing,bears,bore,born,borne
bearded: bearded
bearer: bearer
bearing: bearing
beat: beat,beating
beau: beau
beaucoup: beaucoup
beautiful: beautiful
beauty: beauty
beaux: beaux
bed: bed,beds
bede: bede
bedford: bedford
beef: beef
beer: beer
befall: befell
beg: beg,begged
beggary: beggary
beguile: beguiled
behave: behave,behaved
behaviour: behaviour
behold: beheld,behold,beholding
belch: belch
belie: belied
belief: belief,beliefs
belittle: belittle
bell: bell,bells
belle: belle
belong: belong,belonged,belonging
beloved: beloved
belt: belt,belts
bend: bend,bent
beneath: beneath
benefactor: benefactor
benefit: benefit,benefiting
bent: bent
bernard: bernard
bernie: bernie
berth: berth,berths
bestial: bestial
bethlehem: bethlehem
betray: betrayed
betroth: betrothed
betrothal: betrothal
bewilder: bewildered,bewildering
bible: bible,bibles
bibliography: bibliography
bid: bid
bien: bien
billy: billy
binary: binary
bind: bind,bound
biographer: biographer
biography: biographies,biography
bird: birds
birkenhead: birkenhead
birth: birth
birthday: birthday
bishop: bishop,bishops
bishops: bishops
bit: bit,bits
bitter: bitter
bitterly: bitterly
bitterness: bitterness
black: black
blacker: blacker
blackguard: blackguard
blackness: blackness
blair: blair
blame: blame,blamed,blaming
blameless: blameless
blank: blank
blaze: blazed
blend: blended
bless: bless,blessed
blessed: blessed
blind: blind
blindly: blindly
blindness: blindness
bliss: bliss
blister: blisters
block: block,blocked,blocks
blockade: blockade
blood: blood
bloodless: bloodless
bloodshed: bloodshed
bloody: bloody
bloom: blooming
blouse: blouse
blow: blew,blow,blowing,blown,blows
blue: blue
bluff: bluff
blunder: blundering
blunderer: blunderer
board: board
boarding: boarding
boast: boast
boat: boat,boating,boats
bob: bobbing,bobs
bobadil: bobadil
boccaccio: boccaccio
body: body
boiler: boiler,boilers
bold: bold
bolivar: bolivar
bolt: bolted
bombardment: bombardment
bon: bon
bona: bona
bond: bond,bonded,bonds
bone: bone,bones
bonne: bonne
bonnie: bonnie
book: book,books
border: border
bore: bore
borecole: borecole
borough: borough
borrow: borrow,borrowed
bosom: bosom
boulevard: boulevard
boulevards: boulevards
bound: bounding
boundary: boundaries
boundless: boundless
bouquet: bouquet,bouquets
bout: bouts
bow: bow,bowed,bows
bowsprit: bowsprit
box: box,boxed,boxes
boy: boy,boys
boyish: boyish
boyishly: boyishly
boyishness: boyishness
brace: braces,bracing
bracket: brackets
bradford: bradford
brain: brain
brained: brained
brake: brake
branch: branch,branches
brandish: brandishing
brass: brass
brave: brave,braves
bravely: bravely
bravery: bravery
breach: breach
bread: bread
break: break,breaking,breaks,broke,broken
breakage: breakages
breakfast: breakfast
breathe: breathed,breathes,breathing
breathing: breathing
breech: breeched
breeched: breeched
breeches: breeches
breed: bred,breeding
breeze: breeze,breezes
brest: brest
briars: briars
bribe: bribing
bricklaying: bricklaying
bride: bride
bridegroom: bridegroom
bridge: bridge
bridges: bridges
brig: brigs
brigantine: brigantine
bright: bright,brighter
brighten: brightened
brightly: brightly
brightness: brightness
brilliance: brilliance
brilliant: brilliant
brilliantly: brilliantly
bring: bring,bringing,brings,brought
brisk: brisk
bristle: bristled
britannica: britannica
british: british
broach: broach,broached
broad: broad,broadest
broil: broiling
broken: broken
bronze: bronze
brook: brook
broom: broom
brother: brother,brothers
brown: brown
browse: browse
brunswick: brunswick
brush: brushed
brushwood: brushwood
brutal: brutal
brutality: brutality
brute: brute
bubble: bubble,bubbles
bud: budded
buff: buff
build: build,building,built
builder: builder,builders
building: building,buildings
bulb: bulb
bulge: bulged
bulk: bulk
bullet: bullet
bully: bullying
bump: bump
bumptious: bumptious
bunker: bunkers
bunyan: bunyan
buoy: buoy,buoyed,buoying,buoys
buoyant: buoyant
burdon: burdon
burgh: burgh
burglar: burglar
burke: burke
burly: burly
burn: burn,burning,burns
burnish: burnished
burnt: burnt
burrow: burrow
burst: burst,bursting
burthen: burthened
bury: buried
bush: bushes
business: business
bust: bust
bustle: bustle,bustles
busy: busied,busy
butter: butter
butterfly: butterflies
button: button
buzz: buzzed
bye: bye
byron: byron
cab: cab
cabbage: cabbage
cabin: cabin
cable: cable,cables
cage: cage
cajole: cajoling
calamity: calamities
calculate: calculate,calculated
calculation: calculation,calculations
californian: californian
calm: calm,calmer
cambrian: cambrian
cambridge: cambridge
camilla: camilla
campaign: campaign
campbell: campbell
candid: candid
candle: candle,candles
candour: candour
cane: canes
cannon: cannon,cannons
cannonade: cannonade,cannonades
canoe: canoe
cantor: cantor
canvass: canvass,canvassed,canvassing
cap: cap,capped,capping,caps
capacity: capacity
cape: cape,capes
capital: capital
capitally: capitally
capite: capite
capitol: capitol
capitulation: capitulation
capo: capo
captain: captain
captiousness: captiousness
captive: captive
capture: captured
car: car
card: card
cardigan: cardigan
cardinal: cardinal
care: care,cared
career: career
careful: careful
carefully: carefully
careless: careless
careworn: careworn
cargo: cargo
caricatured: caricatured
caroline: caroline
carpenter: carpenter
carpentry: carpentry
carriage: carriage,carriages
carrot: carrots
carry: carried,carries,carry,carrying
cart: cart
carter: carter
cartoon: cartoons
cartridge: cartridges
cast: cast,casts
castaway: castaways
castigator: castigator
castle: castle,castles
castor: castor
cat: cat
catch: catching,caught
catholics: catholics
cattle: cattle
cauldron: cauldron
causa: causa
cavalier: cavalier
cavalry: cavalry
cave: cave,caves
ce: ce
cease: cease,ceased
cecil: cecil
celebration: celebration
censure: censure
cent: cent
central: central
centre: centre
century: centuries,century
certainty: certainty
certificate: certificate,certificates
chafe: chafed,chafing
chaff: chaff
chain: chain
chair: chair
chalk: chalk
chamber: chamber
chamoix: chamois
champagne: champagne
chance: chance,chanced,chances
chancel: chancel
chancery: chancery
change: change,changed
changed: changed
channel: channel
chant: chanting
chap: chap,chaps
chapeau: chapeau
chapter: chapter
character: character,characters
characteristic: characteristic
characteristically: characteristically
charade: charades
charge: charge,charged,charges
charitable: charitable
charity: charities,charity
charles: charles
charm: charm,charms
charming: charming
chart: chart
chase: chase
chatter: chattering
chaucer: chaucer
cheap: cheap,cheaper
cheaply: cheaply
check: check,checking,checks
cheer: cheer,cheers
cheerful: cheerful
cheerfulness: cheerfulness
cheery: cheery
cheltenham: cheltenham
chemin: chemin
cheque: cheque
chequered: chequered
cherish: cherish,cherished
chest: chest
chestnut: chestnuts
chez: chez
chia: chia
chick: chicks
chief: chief
chiefly: chiefly
child: child,children
childhood: childhood
childish: childish
chill: chill,chilling
chiltern: chiltern
chimerical: chimerical
chip: chip
chirurgical: chirurgical
chisel: chisel
chivalrous: chivalrous
chivalry: chivalry
choice: choice
choke: choked
cholera: cholera
choose: choose,chooses,chose,chosen
choosing: choosing
chose: chose,choses
choses: choses
christ: christ
christendom: christendom
christian: christian,christians
christine: christine
christmas: christmas
chronicle: chronicle
chronicler: chronicler
church: church,churches
cicero: cicero
cigar: cigars
circle: circle,circled
circumstance: circumstance,circumstances
cistern: cisterns
cistus: cistus
citadel: citadel
citizen: citizen,citizens
city: cities,city
civil: civil
civilisation: civilisation
civilly: civilly
claim: claim,claimed,claiming
clamber: clamber,clambering
clara: clara
clarionet: clarionet
clark: clark
clasp: clasp
class: class,classes
classic: classics
classmate: classmate
clay: clay
clean: clean
cleanliness: cleanliness
clearness: clearness
cleopatra: cleopatra
clergy: clergy
clerk: clerk,clerks
clever: clever
client: clients
cliff: cliffs
climate: climate
cling: cling
clique: clique
clog: clogs
close: close,closed
closely: closely
cloth: cloth
clothe: clothed
clothes: clothes
cloths: cloths
cloud: clouds
cloudy: cloudy
club: club
clump: clumps
clumsily: clumsily
clumsy: clumsy
clutch: clutch
coach: coach,coaches
coal: coal,coaled,coaling,coals
coarse: coarse
coast: coast,coasting
coastguard: coastguard
coastline: coastline
coat: coat,coats
coating: coating
cob: cob
cock: cock,cocking,cocks
cocky: cocky
cocoa: cocoa
code: code,codes
coffee: coffee
coil: coil,coiled,coils
coin: coins
coincidence: coincidence
cold: cold,colder
coldly: coldly
coldness: coldness
colin: colin
collaboration: collaboration
collapse: collapsed
colleague: colleague,colleagues
collect: collect,collecting
collected: collected
collection: collection
college: college
colleges: colleges
collier: colliers
colonel: colonel
colour: colour,coloured,colours
coloured: coloured
column: columns
combat: combat
combative: combative
combination: combination
combine: combine
combustible: combustibles
comedy: comedy
comfort: comfort
comfortable: comfortable
comfortably: comfortably
comicality: comicality
coming: comings
command: command,commanded,commanding,commands
commander: commander
commanding: commanding
commandment: commandments
comme: comme
commemorate: commemorating
commence: commenced
commend: commend
comment: comment,commented
commentary: commentary
commerce: commerce
commercial: commercial
commission: commission
commissioner: commissioner
commit: committed
committed: committed
committee: committee
common: common
commonly: commonly
commotion: commotion
communicate: communicated
communication: communication
communion: communion
community: community
companion: companion,companions
company: company
comparable: comparable
comparative: comparative
comparatively: comparatively
compare: compare,compared
compartment: compartment
compatible: compatible
compensate: compensate
competence: competence
competency: competency
compilation: compilation
complain: complain,complaining
complaint: complaint
complement: complement
complete: complete,completed
completely: completely
complexion: complexions
compliance: compliance
complicated: complicated
complication: complication
compliment: compliment,compliments
comply: comply,complying
compose: composed,composing
compound: compound
comprehensive: comprehensive
compress: compressed
comprise: comprise
compromise: compromised
comrade: comrades
conceal: conceal
concealment: concealment
conceit: conceit
conceive: conceive,conceived,conceiving
concept: concept
conception: conception
concern: concern
concert: concert
conciliatory: conciliatory
conclude: concluded,concludes
conclusion: conclusion
concrete: concrete
condemn: condemn,condemned
condensation: condensation
condition: condition,conditions
conduct: conduct
conductor: conductor
confession: confession
confidence: confidence,confidences
confidential: confidential
confine: confined
confirm: confirmed
confirmation: confirmation
conflict: conflicting
conform: conforming
conformer: conformers
conformity: conformity
confound: confound,confounded
confused: confused
confusion: confusion
congenial: congenial
congress: congress
congreve: congreve
connect: connected
connection: connection
connoisseur: connoisseur
connu: connu
conquer: conquer,conquered
conqueror: conqueror
conscience: conscience
conscious: conscious
consciousness: consciousness
consecration: consecration
consent: consent
consequence: consequence
consequential: consequential
considerable: considerable
consideration: consideration,considerations
consist: consisted,consisting,consists
consistent: consistent
consolation: consolation
console: console
consort: consort
conspicuously: conspicuously
conspiracy: conspiracy
constable: constable
constant: constant
constantly: constantly
constitute: constituting
constitution: constitution
constrain: constrain,constrained
construction: construction
constructive: constructive
consul: consul,consuls
consult: consulted,consulting
consultation: consultation
consulting: consulting
consume: consumed
contact: contact,contacts
contaminate: contaminated
contaminated: contaminated
contamination: contamination
contemned: contemned
contemner: contemner
contemplate: contemplated,contemplates
contemplation: contemplation
contemporary: contemporaries,contemporary
contempt: contempt
content: content
contentedly: contentedly
contentment: contentment
contents: contents
continental: continental
continual: continual
continually: continually
continuation: continuation
continue: continue,continued,continues,continuing
continuer: continuer
contract: contract
contradictory: contradictory
contrary: contrary
contrast: contrast,contrasting,contrasts
contribute: contribute,contributed
contribution: contributions
contrivance: contrivance
contrive: contrive
contrived: contrived
convenience: convenience
convenient: convenient
convent: convent
conventional: conventional
conversation: conversation,conversations
converse: conversing
convert: convert
convey: conveyed,conveying,conveys
convince: convinced,convincing
convinced: convinced
convulsion: convulsion
coo: coo
cook: cook,cooked,cooking,cooks
cookery: cookery
cool: cool
coop: coops
copper: copper
coppery: coppery
copying: copying
copyright: copyright
coral: coral,corals
coriolanus: coriolanus
cork: cork
cornelia: cornelia
corner: corner
cornet: cornet
corporation: corporation
correct: correct,corrected,correcting
correction: correction
correctly: correctly
corrector: corrector
correspond: correspond,corresponded,corresponds
correspondence: correspondence
correspondent: correspondent
corrupt: corrupt
corruption: corruption
cory: cory
cost: cost,costs
costume: costumed,costumes
costumer: costumer
coterie: coterie,coteries
cottage: cottage
cotton: cotton
cough: cough
council: council
counsel: counsel,counselled
count: count,counted
countenance: countenance
country: countries,country
county: county
couple: couple,coupled
courage: courage
court: court,courted
courteous: courteous
courtesy: courtesy
courtly: courtly
courtship: courtship
cousin: cousin
cove: cove
covenant: covenant
cover: covered
covering: covering
covet: coveted
cow: cow
coward: coward
cowardly: cowardly
cradle: cradle
craft: craft
crag: crags
cram: cram
crane: crane
crank: crank
crash: crash
craze: craze
crazy: crazy
create: create,created,creating
creation: creation,creations
creature: creature,creatures
credit: credit,credited
creditably: creditably
creed: creed
creep: crept
crest: crest
crete: crete
crevice: crevices
crew: crew
crib: cribs
cricket: cricket
crimean: crimean
crisis: crisis
critic: critic
critical: critical
criticism: criticism
croon: crooning
croquet: croquet
cross: cross,crossed,crossing
crossing: crossing
crouch: crouching
crow: crowing
crowd: crowd,crowds
crowded: crowded
crown: crown,crowned
crowning: crowning
crucial: crucial
crude: crude
cruel: cruel
cruelly: cruelly
cruelty: cruelties,cruelty
cruise: cruise,cruises,cruising
crush: crushed,crushing
cub: cubs
cuban: cuban
culprit: culprits
cultivate: cultivated
cumberland: cumberland
cup: cups
cupidity: cupidity
cur: cur,curs
cure: cure,cured
curiosity: curiosity
curiously: curiously
curlew: curlews
curling: curling
current: current
curriculum: curriculum
curtain: curtain
custom: custom
customary: customary
custos: custos
cut: cut,cutting
cutter: cutter
cutting: cuttings
cyrus: cyrus
cythera: cythera
da: da
dabble: dabble
daguerreotype: daguerreotype
daily: daily
dainty: dainty
daisy: daisies
damage: damage
damaged: damaged
damages: damages
dame: dame
damp: damp
damsel: damsel
dance: dance,danced,dances,dancing
dancing: dancing
danger: danger
dangerous: dangerous
dangle: dangling
dark: dark,darker
darken: darken
darkness: darkness
darling: darling
darts: darts
darwin: darwin
datum: data
daughter: daughter,daughters
dauntlessly: dauntlessly
david: david
dawn: dawn
day: day,days
daybreak: daybreak
daylight: daylight
dead: dead
deadly: deadly
deaf: deaf
deal: deal,dealt
dealings: dealings
dean: dean
death: death,deaths
debility: debility
debt: debt,debts
decalogue: decalogue
decay: decay
decayed: decayed
deceive: deceived
deceiver: deceiver
december: december
decent: decent
decide: decide,decided,deciding
decidedly: decidedly
decisive: decisive
deck: deck,decks
declaration: declaration
declare: declare,declared
decline: declining
decorator: decorator
decoy: decoyed
decree: decree
dedicate: dedicated
deduce: deduce
deductible: deductible
deduction: deductions
deep: deep,deeper
deepen: deepen
deeply: deeply
deer: deer
defeat: defeat
defect: defect,defects
defective: defective
defence: defence
defend: defend,defended
deficiency: deficiency
deficit: deficit
define: defined
definite: definite
definition: definition
deform: deformed
degree: degree,degrees
deification: deification
deign: deigned
dejection: dejection
delay: delay,delayed
delete: deleted
deletion: deletions
deliberate: deliberate
delicacy: delicacy
delicate: delicate
delight: delight,delighted,delighting,delights
delighted: delighted
delightedly: delightedly
delightful: delightful
deliver: deliver,delivered
deliverance: deliverance
demand: demand,demanded
demander: demander
demeanour: demeanour
demolish: demolish
demonstrate: demonstrate,demonstrated
demonstrative: demonstrative
denis: denis
deny: denied,deny
depart: depart
department: department
departure: departure
depend: depended,depends
depict: depicts
deplore: deplored
deposit: deposit
depress: depressing
deprive: deprived
depth: depth
depths: depths
deputy: deputy
derivative: derivative
derive: derive,derived
derogation: derogation
des: des
descend: descended
descendant: descendant,descendants
descent: descent
description: description,descriptions
descriptive: descriptive
desdemona: desdemona
desert: desert
deserted: deserted
deserve: deserve,deserves
design: design,designed
designate: designates
desirable: desirable
desire: desire,desired,desires
desisted: desisted
desolation: desolation,desolations
despair: despair
despatch: despatch
desperate: desperate
desperately: desperately
desperation: desperation
despise: despised
destine: destined
destiny: destiny
destitute: destitute
destitution: destitution
destroy: destroy
detach: detach
detachment: detachment
detain: detained
detect: detecting
deterioration: deterioration
determination: determination
determine: determine,determined
detestable: detestable
deux: deux
develop: developed
device: device
devil: devil
devote: devote,devoted
devoted: devoted
devotedly: devotedly
devotion: devotion
devotions: devotions
di: dis
diagram: diagram,diagrams
diagrammatically: diagrammatically
dialect: dialect
dialogue: dialogue
diameter: diameter
diary: diaries,diary
dickens: dickens
dictate: dictates
dictation: dictation
dictionary: dictionaries
didactic: didactic
die: die,died,dying
dielectric: dielectric
difference: difference,differences
difficult: difficult
difficulties: difficulties
difficulty: difficulties,difficulty
diffidence: diffidence
dig: dig
digger: diggers
dignified: dignified
dignity: dignity
dim: dim
diminish: diminish,diminishing
diminutive: diminutive
dine: dine,dined,dines
dingy: dingy
dining: dining
dinner: dinner,dinners
dint: dint
dip: dipped,dipping
diphtheria: diphtheria
dire: dire
direct: direct,directed,directing
direction: direction,directions
director: director
dirt: dirt
dirty: dirtier,dirty
dis: dis
disable: disabled
disadvantage: disadvantage
disappear: disappeared
disappoint: disappoint,disappointed
disappointed: disappointed
disappointing: disappointing
disappointment: disappointment,disappointments
disastrous: disastrous
discard: discarded
discern: discern
discernment: discernment
discharge: discharge,discharged,discharges,discharging
disciple: disciple
disciplinarian: disciplinarian
discipline: discipline
disclaim: disclaim
disclaimer: disclaimer,disclaimers
discomfited: discomfited
discontent: discontented
discontentment: discontentment
discontinue: discontinue
discordant: discordant
discourage: discourage
discourse: discourse
discover: discover,discovered
discovery: discovery
discreet: discreet
discretion: discretion
discrimination: discrimination
discuss: discuss,discussed
discussion: discussion,discussions
disease: disease,diseases
disengage: disengage
disgrace: disgrace,disgraced
disgraceful: disgraceful
disgust: disgust
dish: dish
dishonesty: dishonesty
disinterestedness: disinterestedness
disk: disk
dislike: disliked,dislikes
dismay: dismay
dismiss: dismissed
disobey: disobey
display: display,displayed,displaying
displease: displeased
dispose: disposed
disposition: disposition
disputant: disputant,disputants
disputation: disputation
disputatious: disputatious
disputatiousness: disputatiousness
dispute: dispute
dissatisfied: dissatisfied
disseminate: disseminating
dissension: dissensions
dissimulation: dissimulation
dissolve: dissolved
dissuasive: dissuasive
distance: distance
distant: distant
distasted: distasted
distasteful: distasteful
distinction: distinction,distinctions
distinguish: distinguish,distinguished
distinguished: distinguished
distinguishedly: distinguishedly
distracted: distracted
distress: distress
distressed: distressed
distribute: distribute,distributed,distributing
distribution: distribution
distributor: distributor
district: district,districts
disturb: disturb,disturbed
disturbance: disturbance
dit: dit
diversion: diversion
divide: dividing
divided: divided
divorce: divorced
dock: dock,docks
dockside: dockside
doctor: doctor
doctrine: doctrine
document: document
dog: dog,dogs
dogger: dogger
dogma: dogma,dogmas
dogmatist: dogmatist
dollar: dollars
domain: domain
dome: dome
domestic: domestic
domination: domination
donate: donate
donation: donation,donations
donna: donna
donne: donne
donor: donors
doodah: doodah
doom: doomed
door: door,doors
doric: doric
dose: dose
dot: dot
double: double,doubling
doubt: doubt,doubts
doubtless: doubtless
douglas: douglas
dove: doves
download: downloading
doze: dozing
dozen: dozen,dozens
draft: draft,drafts
drag: dragging,drags
dragoon: dragoons
drain: drain,drains
drainage: drainage
drama: drama
dramatic: dramatic
drape: draped
drastic: drastic
draught: draught
draughtsman: draughtsman
draw: draw,drawing,drawn,drew
drawer: drawers
drawing: drawing,drawings
dreadful: dreadful
dream: dreamed,dreams
dreary: dreary
dredge: dredge
dredging: dredging
drench: drenched
dress: dress,dressed,dresses
dressed: dressed
drift: drift
drink: drank,drink
drinking: drinking
dripping: dripping
drive: driven,driving,drove
droit: droit
droll: drollest
drollery: drollery
drolly: drolly
droop: droop
drop: drop,dropped
drudge: drudge
drudgery: drudgery
drum: drum,drums
drunk: drunk
drunken: drunken
dry: dry
du: du
dublin: dublin
duchess: duchess
duck: ducking,ducks
duke: duke
dulcinea: dulcinea
dull: dull,dulled
dulness: dulness
dumas: dumas
dumb: dumb
duncan: duncan
dunce: dunce,dunces
dundee: dundee
dung: dung
dura: dura
durability: durability
durable: durable
dust: dust
dusty: dusty
duty: duties,duty
dwarf: dwarf
dwell: dwell,dwelling,dwelt
dweller: dwellers
dwelling: dwelling,dwellings
dying: dying
dynamics: dynamics
dynes: dynes
eager: eager
eagerly: eagerly
eagerness: eagerness
eagle: eagles
ear: ear,ears
earlier: earlier
earn: earned
earnest: earnest
earnestness: earnestness
earth: earth
earthenware: earthenware
earthly: earthly
earthquake: earthquake
ease: ease
easily: easily
east: east
eastern: eastern
easy: easier,easy
eat: eat,eaten
eater: eaters
eccentricity: eccentricity
echo: echo
economical: economical
economy: economy
ecstasy: ecstasy
edge: edge,edges
edinburgh: edinburgh
edison: edison
edit: edited
edition: edition,editions
editor: editor
editorial: editorial
edmond: edmond
educate: educate,educated
education: education
educational: educational
edward: edward
effective: effective
efficiency: efficiency
effort: effort,efforts
egg: egg,eggs
egoism: egoism
eighteen: eighteen
eighth: eighth
elbow: elbow
eld: eldest
elder: elders
elect: elect
electric: electric
electrical: electrical
electrician: electrician,electricians
electricity: electricity
electromagnetism: electromagnetism
electronic: electronic
electronically: electronically
electrostatic: electrostatics
electrostatical: electrostatical
elegance: elegance
elegant: elegant
element: element,elements
elementary: elementary
elephant: elephant
elevation: elevation
eligible: eligible
eliot: eliot
eliza: eliza
elizabeth: elizabeth
elle: elle
elocution: elocution
eloquence: eloquence
eloquent: eloquent
elusive: elusive
email: email
emanate: emanated
emancipation: emancipation
embark: embarked
embarrassed: embarrassed
embarrassment: embarrassments
embrace: embraced
eminent: eminent
emotion: emotion
emotional: emotional
emperor: emperor
empirical: empirical
employ: employed
employee: employee,employees
employment: employment
en: en
enable: enable,enabled,enables
enamel: enamel
enamour: enamoured
encampment: encampment
enchanted: enchanted
enchanting: enchanting
encode: encoding
encore: encore
encounter: encountered
encourage: encouraged
encumber: encumbered
endeavour: endeavour,endeavoured
endless: endless
endow: endow,endowed
endure: endure,enduring
enemy: enemy
energy: energy
enfield: enfield
enforce: enforced,enforcing
engage: engage,engaged
engagement: engagement,engagements
engaging: engaging
engine: engine,engines
engineer: engineer,engineering,engineers
engineering: engineering
england: england
english: english
englishman: englishmen
engrain: engrained
engraving: engraving
enjoy: enjoy,enjoyed,enjoying
enjoyment: enjoyment
enlighten: enlightened
enlist: enlist
enormous: enormous
enquiring: enquiring
enquiry: enquiry
enrich: enriched
enrol: enrolled
ensemble: ensemble
ensue: ensue,ensuing
ensure: ensure,ensuring
entendre: entendre
enter: enter,entered,entering
enterprise: enterprise
entertain: entertained
entertaining: entertaining
entertainment: entertainment
enthusiasm: enthusiasm
enthusiastic: enthusiastic
entire: entire
entitle: entitled
entity: entity
entrance: entrance
envelope: envelope
epic: epic
epidemic: epidemic
epilogue: epilogue
episode: episode
epoch: epoch
equal: equal,equalled,equals
equally: equally
equipment: equipment
ere: ere
erect: erected
err: erring
erratic: erratic
error: error,errors
escape: escape,escaped,escaping
escort: escorting
essay: essay,essays
essence: essence
essential: essential
essentially: essentially
est: est
establish: establish,established
estate: estate
esteem: esteem
estimate: estimate,estimated
estrange: estranged
eternal: eternal
ethereal: ethereal
ethic: ethics
etiquette: etiquette
eu: eu
euclid: euclid
europe: europe
evening: evening,evenings
event: event,events
eventful: eventful
eventless: eventless
evergreen: evergreens
everyday: everyday
evidence: evidence
evident: evident
evidently: evidently
evil: evil,evils
evolution: evolutions
ewing: ewing
exaggerate: exaggerate,exaggerating
examination: examination,examinations
examine: examined,examines,examining
examiner: examiners
exasperated: exasperated
exceedingly: exceedingly
excel: excel,excelled
excellence: excellence
excellent: excellent
excellently: excellently
exception: exception
exceptional: exceptional
exceptionally: exceptionally
excessive: excessive
exchange: exchange
excited: excited
excitement: excitement
exciting: exciting
exclude: excluded
exclusion: exclusion
exclusively: exclusively
excursion: excursion,excursions
excuse: excuse
executive: executive
exempt: exempt
exercise: exercise,exercised,exercises
exertion: exertion
exhibit: exhibit
exigency: exigency
exile: exile,exiles
exist: exist,existed,existing,exists
existence: existence
expand: expanded
expect: expect,expected
expectant: expectant
expectation: expectation
expedition: expedition
expend: expend
expenditure: expenditure
expense: expense,expenses
expensive: expensive
experience: experience,experienced
experiment: experiment,experimented,experiments
experimental: experimental
expert: expert,experts
explain: explain,explained
explanation: explanation
explore: explore
export: exporting
expose: exposed
exposition: exposition
exposure: exposure
expound: expound,expounded
express: express,expressed,expresses,expressing
expression: expression,expressions
expurgate: expurgated
exquisite: exquisite
extend: extend,extended
extent: extent
external: external
externe: externes
extort: extort
extract: extracting,extracts
extraordinary: extraordinary
extravagance: extravagances
extravagant: extravagant
extreme: extreme,extremes
extremely: extremely
extremity: extremities
exuberant: exuberant
eye: eye,eyes
eyesight: eyesight
fable: fables
facile: facile
facility: facility
factory: factory
faculty: faculties
fad: fad
fade: fade,faded,fading
fail: fail,failed,failing
failing: failings
failure: failure,failures
faint: faint
faintly: faintly
fair: fair
fairbanks: fairbanks
faire: faire
fairy: fairy
fait: fait
faith: faith
faithful: faithful
fall: fall,fallen,falling,falls,fell
fallacious: fallacious
false: false,falsest
fame: fame
familiar: familiar
famille: famille
family: families,family
famine: famine
famous: famous
fan: fan
fancy: fancied,fancy
fantastic: fantastic
faraday: faraday
farce: farce
fare: fared
farm: farm
farmer: farmer
farming: farming
farrago: farrago
fashion: fashion,fashions
fashioned: fashioned
fast: fast,faster
fastidious: fastidious
fastness: fastnesses
fat: fat
fatal: fatal
fate: fate
father: father,fathers
fathom: fathoms
fault: fault,faults
faulty: faulty
faut: faut
favour: favour,favoured
favourable: favourable
favourably: favourably
favourite: favourite
fear: fear,feared,fearing
feast: feast
feat: feat
feature: feature,features
february: february
fecundity: fecundity
federal: federal
fee: fee,fees
feeble: feeble
feel: feel,feels
feeling: feeling,feelings
feign: feign
fellow: fellow,fellows
feminine: feminine
ferment: ferments
fertile: fertile
fertility: fertility
fervent: fervent
fester: fester
fetch: fetch,fetched
fever: fever
feverish: feverish
fez: fez,fezzes
fibre: fibre
fiddle: fiddle
field: field
fierce: fierce
fiercely: fiercely
fiery: fiery
fig: fig
fight: fight,fighting,fought
fighting: fighting
figment: figments
figure: figure,figured,figures
fil: fils
file: file,files
filial: filial
fils: fils
filth: filth
final: final
finally: finally
finances: finances
financial: financial
fine: fine,finest
finely: finely
finesse: finesse
finger: finger,fingers
finish: finish,finished,finishing
finished: finished
firing: firing
firm: firm
firmament: firmament
firmness: firmness
fish: fish
fisher: fishers
fishing: fishing
fishy: fishy
fit: fit,fits,fitted,fitting
fitness: fitness
fitting: fittings
flag: flag,flags
flagship: flagship
flame: flames
flamingo: flamingoes
flank: flanked
flap: flapping
flash: flashed,flashes
flat: flat
flatter: flatters
flattery: flattery
flavour: flavour
fleet: fleet
flick: flick,flicks
flicker: flicker
flight: flight
fling: flung
float: floated
flog: flogged
flogging: floggings
floor: floor,floors
flourish: flourish
flow: flow
flower: flower,flowers
fly: flew,flown,fly,flying
fog: fog
fold: folds
folk: folk
follow: follow
fond: fond
fondateur: fondateur
food: food
fool: fool,fools
foolishly: foolishly
foot: feet,foot
footing: footing
footnotes: footnotes
forbid: forbade
force: force,forced,forces,forcing
forcible: forcible
fore: fore
forecastle: forecastle
foreign: foreign
foreigner: foreigner,foreigners
foreman: foreman
foresee: foreseen
forest: forest
forge: forged,forges
forget: forget,forgotten
forgetful: forgetful
forgive: forgive,forgiven
fork: forks
form: form,formed,forming,forms
formal: formal
formally: formally
format: format,formats
formation: formation
formative: formative
forme: forme
formidable: formidable
formula: formula
formulate: formulated
fort: fort,forts
forte: forte,fortes
forthcoming: forthcoming
forthwith: forthwith
fortitude: fortitude
fortnight: fortnight
fortress: fortress
fortunate: fortunate
fortune: fortune
forwardness: forwardness
fossil: fossil,fossils
foster: fostering
foul: foul
foundation: foundation,foundations
founder: founder
fourth: fourth
fowl: fowl,fowls
fowling: fowling
fox: fox
fragile: fragile
fragment: fragments
frail: frail
frame: frame,framed
framework: framework
france: france
frank: frank
frankfort: frankfort
frankness: frankness
frau: frau
fraud: fraud
freak: freak
frederick: frederick
freedom: freedom,freedoms
freely: freely
french: french
frenchman: frenchman,frenchmen
frenchmen: frenchmen
frenchwoman: frenchwoman
frenzy: frenzy
frequent: frequent
frequently: frequently
frere: frere
fresh: fresh
freshen: freshened,freshening
fret: fret,fretting
friar: friar
friday: friday
friend: friend,friends
friendly: friendly
friendship: friendship,friendships
frigate: frigates
fright: fright
frighten: frighten,frightened
frightened: frightened
fro: fro
frugality: frugality
fruit: fruit,fruits
fruition: fruition
frustrate: frustrated
fry: fried
fulfil: fulfil
fume: fume,fumes
fun: fun
function: functions
fund: fund,funds
fundamental: fundamental
funnel: funnels
furbish: furbished
furious: furious
furiously: furiously
furnish: furnish
furtherance: furtherance
fury: fury
fussy: fussy
fusty: fusty
fut: fut
futile: futile
future: future
gabble: gabbling
gaelic: gaelic
gaiety: gaiety
gain: gain,gained
gale: gale
gallant: gallant
gallantly: gallantly
gallantry: gallantry
gallery: gallery
galley: galley,galleys
gallop: gallop,galloping
gallows: gallows
game: game
gar: gar
garden: garden,gardens
gardener: gardener
gardening: gardening
garibaldi: garibaldi
garland: garland
gas: gas
gate: gate,gates
gather: gather,gathered,gathering
gaul: gaul
gauss: gauss
gay: gay
gear: gear
gem: gems
gen: gens
genealogical: genealogical
genealogist: genealogist
genealogy: genealogy
generation: generation,generations
generic: generic
generous: generous
generously: generously
geneva: geneva
genial: genial
genius: genius
genoa: genoa
genoese: genoese
gentle: gentle
gentleman: gentleman,gentlemen
gentleness: gentleness
gently: gently
genuine: genuine
geometrical: geometrical
geometry: geometry
george: george
germ: germ,germs
german: german,germans
germany: germany
gesture: gesture
ghent: ghent
giant: giants
giddy: giddy
gift: gift,gifts
gig: gig
giggle: giggle
gillie: gillie
gipsy: gipsy
gird: gird
girdle: girdles
girl: girl,girls
girlish: girlish
girls: girls
girth: girths
glad: glad
gladly: gladly
gladness: gladness
glance: glance
glaring: glaring
glasgow: glasgow
glass: glass
gleam: gleam,gleaming
glean: glean
glib: glib
glimpse: glimpses
glisten: glistening
glitter: glittering
globe: globes
gloomy: gloomy
glorious: glorious
glory: glory
glow: glowing
glowing: glowing
goal: goal,goals
goat: goat,goats
god: god
goddam: goddam
goddess: goddesses
godwin: godwin
gold: gold
golden: golden
golf: golf
golfer: golfer
goodness: goodness
gordon: gordon
gossip: gossip
govern: govern
government: government
gowan: gowans
gowans: gowans
grace: grace,graces
graceful: graceful
gradual: gradual
gradually: gradually
graduation: graduation
graft: grafting
grand: grand
grandchild: grandchildren
granddaughter: granddaughter
grandeur: grandeur
grandfather: grandfather
grandmother: grandmother
grandniece: grandniece
grandson: grandson
grant: grant,granted
graphic: graphic
graphically: graphically
grapnel: grapnel,grapnels
grapple: grapple,grappled,grappling
grappling: grappling
grasp: grasp,grasped
grass: grass
grasshopper: grasshoppers
grateful: grateful
gratefully: gratefully
gratification: gratification,gratifications
gratitude: gratitude
grave: grave
gravely: gravely
gray: gray
grazie: grazie
greatcoat: greatcoat
greatly: greatly
greatness: greatness
grecian: grecian
greece: greece
greed: greed
greek: greek,greeks
green: green
greenwich: greenwich
gregory: gregory
grey: grey
grief: grief
griffon: griffon
grilling: grilling
grimly: grimly
grin: grin
grind: grind,grinding
griselda: griselda
groan: groan,groaning,groans
groom: groom
grooved: grooved
grope: groping
gross: gross
ground: ground
groundless: groundless
grounds: grounds
grow: grew,grow,growing,grown,grows
grown: grown
growth: growth
grub: grubbing
grudge: grudge
grunt: grunt
guano: guano
guarantee: guarantee
guard: guard,guarded,guards
guardian: guardians
guards: guards
guess: guess
guest: guest,guests
guide: guide,guiding
guild: guild
guilt: guilt
guiltless: guiltless
guilty: guilty
guinea: guinea
gull: gull
gully: gullies
gulp: gulped
gummy: gummy
gun: gun,guns
gunner: gunner
gunshot: gunshot
gunsmith: gunsmiths
gust: gusts
gusto: gusto
gut: gut
gutta: gutta
gutter: gutter
gymnastic: gymnastic
habit: habit
habitually: habitually
habitudes: habitudes
hail: hail
hailes: hailes
hair: hair
haired: haired
hall: hall
ham: ham
hamilton: hamilton
hamlet: hamlet
hand: hand,handed,hands
handed: handed
handicraft: handicraft
handle: handle
handsome: handsome
handsomer: handsomer
handy: handy
hang: hang,hanging,hangs,hung
happen: happen,happened
happily: happily
happiness: happiness
happy: happier,happiest,happy
harass: harassed
harbour: harbour,harbours
hard: hard,harder,hardest
harden: hardened
hardship: hardships
hardy: hardy
harm: harm
harmful: harmful
harmless: harmless
harmony: harmony
harness: harnessed
harp: harp
harrowing: harrowing
harry: harry
harsh: harsh
harshly: harshly
hart: hart
hartshorn: hartshorn
hasty: hasty
hat: hat
hatch: hatches
hatchway: hatchway
hate: hate,hated
hateful: hateful
hatred: hatred
haul: hauled,hauling
hauling: hauling
haunt: haunt,haunted
haute: haute
havoc: havoc
hawk: hawk,hawks
hawser: hawser
hay: hay
hazard: hazard
head: head,heads
headland: headland
headless: headless
headlong: headlong
health: health
healthful: healthful
healthy: healthy
heap: heaps
hear: hear,heard,hearing,hears
hearer: hearer
hearing: hearing
hearkening: hearkening
heart: heart,hearts
hearted: hearted
heartily: heartily
hearty: heartiest,hearty
heat: heat
heather: heather
heaven: heaven
heavenly: heavenly
heavily: heavily
heaving: heaving
heavy: heavy
hebrew: hebrew
hedge: hedges
hedgerow: hedgerows
heed: heed
heel: heels
height: height
heir: heir
heirless: heirless
helena: helena
helper: helper
helpful: helpful
helpless: helpless
hempseed: hempseed
henrietta: henrietta
henry: henry
herald: herald
herd: herds
herdsman: herdsmen
hereditary: hereditary
heresy: heresy
hero: hero,heroes
heroic: heroic
heroism: heroism
heron: herons
herr: herr
hesitate: hesitate,hesitated,hesitates
hesitation: hesitation
hew: hewn
hide: hidden
hideous: hideous
highland: highland
highlanders: highlanders
highlands: highlands
highly: highly
highness: highness
hill: hill,hills
hint: hint,hints
hire: hired
historic: historic
history: histories,history
hit: hit
hitch: hitches
hitherto: hitherto
ho: ho
hobby: hobbies
hold: held,hold,holding,holds
holder: holder
hole: hole,holes
holiday: holiday,holidays
homesick: homesick
honest: honest
honestly: honestly
honesty: honesty
honeymoon: honeymoon
honour: honour,honoured,honours
honourable: honourable
hook: hook,hooked,hooks
hooked: hooked
hooper: hooper
hope: hope,hoped,hopes,hoping
hopeless: hopeless
hopelessly: hopelessly
horace: horace
horizon: horizon
horrid: horrid
horror: horror,horrors
horse: horse,horses
horsehair: horsehair
horsewhip: horsewhipped
hospital: hospital
hospitality: hospitality
host: host,hosts
hot: hot
hotel: hotel
hour: hour,hours
hourly: hourly
house: house,houses
household: household
householder: householder
houses: houses
hovel: hovels
hover: hover,hovered,hovering
hug: hugged,hugging
huge: huge
hulk: hulk
hullo: hullo
hum: hum,humming
human: human
humanity: humanity
humble: humble
humbly: humbly
humility: humility
humorous: humorous
humorously: humorously
humour: humour
hundredth: hundredth
hungry: hungry
hunt: hunt,hunted,hunting
hunter: hunter
hurl: hurled
hurly: hurly
hurrah: hurrah,hurrahs
hurrahing: hurrahing
hurriedly: hurriedly
hurry: hurry
hurt: hurt,hurting
husband: husband
hut: hut
hymn: hymn
hypothetical: hypothetical
iago: iago
idea: idea,ideas
ideal: ideal
identification: identification
identify: identify
idiotic: idiotic
idle: idle
idleness: idleness
idly: idly
ignorance: ignorance
ignorant: ignorant
iii: iii
illness: illness
illuminate: illuminate
illumination: illumination
illusion: illusion,illusions
illustrate: illustrate,illustrated,illustrates
image: image
imagination: imagination,imaginations
imagine: imagine,imagined
imbecility: imbecility
imbed: imbedded
imbibe: imbibed
imitate: imitated
imitation: imitation
immense: immense
immerse: immersed
immigration: immigration
immortalise: immortalised
impatient: impatient
impending: impending
imperfect: imperfect
imperfection: imperfection
imperial: imperial
imperious: imperious
impersonal: impersonal
impertinent: impertinent
imperturbable: imperturbable
impetuous: impetuous
imply: implied
impolicy: impolicy
import: import
impose: imposed,imposing
imposing: imposing
impossible: impossible
impotent: impotent
impress: impressed,impresses
impressive: impressive
imprisonment: imprisonment
improve: improve,improved,improving
improvement: improvement,improvements
improvise: improvised
imprudent: imprudent
imprudently: imprudently
impudent: impudent
impudently: impudently
inaccurate: inaccurate
inaction: inaction
inactive: inactive
inarticulate: inarticulate
inaugurate: inaugurated
inboard: inboard
incapacity: incapacity
incessant: incessant
inch: inch,inches
incident: incident,incidents
incidental: incidental
incipient: incipient
inclination: inclination
incline: inclined
include: include,included,includes,including
including: including
income: income
incompetent: incompetent
incomplete: incomplete
incongruously: incongruously
inconspicuous: inconspicuous
increase: increased,increasing
incredible: incredible
incrustation: incrustation
inculcate: inculcated
incur: incurred
indecorum: indecorum
indefatigable: indefatigable
indefinable: indefinable
indemnify: indemnify
indemnity: indemnity
independence: independence
india: india
indian: indian
indies: indies
indifference: indifference
indifferent: indifferent
indifferently: indifferently
indignant: indignant
indignantly: indignantly
indignation: indignation
indirect: indirect
indirectly: indirectly
indite: inditing
inditing: inditing
individual: individual,individuals
indomitable: indomitable
indubitable: indubitable
induce: induced
inductive: inductive
indulge: indulged
indulgence: indulgence
indulgent: indulgent
indulgently: indulgently
ineffectual: ineffectual
inert: inert
inertia: inertia
inevitable: inevitable
inexhaustible: inexhaustible
inexorable: inexorable
inexpressible: inexpressible
inexpressive: inexpressive
inextinguishable: inextinguishable
infernal: infernal
infernally: infernally
infinite: infinite
infinitesimal: infinitesimal
infirmary: infirmary
infirmity: infirmities,infirmity
inflict: inflicted
influence: influence
influential: influential
inform: informed
informed: informed
infraction: infraction
infringement: infringement
ingenious: ingenious
ingenuity: ingenuity
inglorious: inglorious
inhabit: inhabited
inhabitant: inhabitants
inherent: inherent
inherit: inherited
inheritance: inheritance
inhuman: inhuman
inimitable: inimitable
initial: initial
injurious: injurious
injury: injury
injustice: injustice
inkling: inkling
inn: inn
innate: innate
innocence: innocence
innocent: innocent
innocuously: innocuously
innumerable: innumerable
inquire: inquire
inquiry: inquiries
insane: insane
insect: insects
insensible: insensible
inseparable: inseparable
insist: insist
insoluble: insoluble
insomuch: insomuch
inspect: inspect,inspected
inspection: inspection
inspector: inspector,inspectors
inspire: inspire,inspired
inspirit: inspiriting
instance: instance,instanced,instances
instant: instant,instants
instantly: instantly
instinct: instinct
instinctively: instinctively
institution: institution,institutions
instruction: instruction,instructions
instructive: instructive
instrument: instrument,instruments
insubordinate: insubordinate
insulate: insulating
insulation: insulation
insulator: insulators
insult: insult,insulted,insults
insurgent: insurgents
insurrection: insurrection
intellect: intellect
intellectual: intellectual
intelligence: intelligence
intelligent: intelligent
intend: intended,intends
intendente: intendente
intense: intense
intensity: intensity
intent: intent
intention: intention,intentions
interchangeable: interchangeable
interfere: interfere
interference: interference
intermarry: intermarrying
intermission: intermission
intermix: intermixed
internal: internal
international: international
interpret: interpreted
interpreter: interpreter
interrupt: interrupt
intersection: intersections
interval: intervals
intervene: intervened
interview: interview
intimacy: intimacy
intimate: intimate
intonation: intonation
intricacy: intricacies
introduce: introduce,introduced
introduction: introduction,introductions
intuition: intuition
invalidity: invalidity
invent: inventing
inventive: inventive
inventor: inventor
inventory: inventories
investigate: investigating
investigation: investigation
investment: investment
invidious: invidious
invincibly: invincibly
inviter: inviter
invoke: invoke
involve: involved
invulnerable: invulnerable
ionian: ionian
irish: irish
irksome: irksome
iron: iron
irredeemably: irredeemably
irregular: irregular
irrepressible: irrepressible
irresponsible: irresponsible
irritating: irritating
irritation: irritations
irs: irs
isaiah: isaiah
island: island,islands
islands: islands
isle: isles
islet: islet
iso: iso
isolate: isolated
israel: israel
issue: issue,issued
italian: italian,italians
italy: italy
item: item
iv: iv
jack: jack
jacket: jacket
jackson: jackson
jade: jade
jagged: jagged
jam: jam,jamming
jamaica: jamaica
james: james
january: january
japan: japan
japanese: japanese
jargon: jargon
jaunt: jaunt
jealous: jealous
jedburgh: jedburgh
jeer: jeer
jehu: jehu
jenkin: jenkin
jerk: jerk
jest: jest
jesting: jesting
job: job
jocular: jocular
john: john
johnnie: johnnie
johnny: johnny
johnson: johnson
joint: joint,joints
jointure: jointures
joke: joke,jokes
jolly: jolly
jolting: jolting
joseph: joseph
jour: jour
journal: journal
journalism: journalism
journey: journeys
jours: jours
jovial: jovial
joy: joy
joyful: joyful
joyous: joyous
jubilant: jubilant
judge: judge,judged,judging
judges: judges
judging: judging
judgment: judgment
judicious: judicious
jug: jugs
july: july
jumble: jumbling
jump: jumped
june: june
jury: jury
justice: justice
justification: justification
justify: justified,justifies,justify
keats: keats
keel: keel
keen: keen
keener: keener
keeper: keeper
keeping: keeping
keith: keith
kenneth: kenneth
kent: kent
kentish: kentish
key: key
khartoum: khartoum
kick: kicked
kill: kill,killed,killing
kilt: kilts
kindly: kindlier,kindly
kindness: kindness
kinematic: kinematic
king: king
kings: kings
kingston: kingston
kink: kink,kinks
kinks: kinks
kinsfolk: kinsfolk
kinship: kinship
kinsman: kinsman
kiss: kiss,kissed
kitchen: kitchen
knack: knack
knee: knees
knife: knife,knives
knock: knocked
knot: knot
knowledge: knowledge
laboratory: laboratory
laborious: laborious
laboriously: laboriously
labour: labour,labours
lack: lack,lacking
lad: lad,lads
ladder: ladder
laden: laden
lady: ladies,lady
lagoon: lagoons
laid: laid
lake: lake
lame: lame
lament: lament,lamented
lamp: lamp,lamps
lancashire: lancashire
land: land,landed,landing
landing: landing
lane: lane,lanes
language: language,languages
languish: languished
lantern: lanterns
lapse: lapses
lash: lash
lastly: lastly
late: late
lateen: lateen
lathe: lathe
latimer: latimer
latin: latin
laugh: laugh,laughed,laughing,laughs
laughter: laughter
launch: launch,launched
law: law,laws
laws: laws
lawyer: lawyers
lay: laid,lay,laying
layer: layer
lazily: lazily
lazy: lazy
le: le
lead: lead,leading,led
leader: leaders
leaf: leaves
leakage: leakage
leaky: leaky
lean: leaned,leaning
leaning: leaning
leap: leaped
leapt: leapt
learn: learn,learned,learning
learner: learner
lease: lease
leather: leather
leave: leave,leaves,leaving,left
lecture: lecture,lectures
lecturer: lecturer
lectures: lectures
ledge: ledges
lee: lee
leech: leeches
leet: leet
leeward: leeward
leeway: leeway
left: left
leg: legs
legal: legal
legally: legally
legend: legend,legends
leggings: leggings
legion: legion
legitimate: legitimate
leisure: leisure
lend: lent
lengthy: lengthy
leonardo: leonardo
les: les
leslie: leslie
lessen: lessen
lesson: lesson,lessons
letter: letter,lettered,letters
levantine: levantine
level: level,levelled,levels
lever: lever
levity: levities
lewis: lewis
liability: liability
liable: liable
liar: liar
liberal: liberal,liberals
liberty: liberty
library: library
license: license
licensed: licensed
lick: licking
lie: lie,lies,lying
liens: liens
lieu: lieu
lieutenant: lieutenant
life: life,lives
lifelong: lifelong
lifetime: lifetime
lift: lift,lifted,lifting,lifts
lifting: lifting
light: light,lighted,lighter,lights
lighten: lightens
lighter: lighters
lighthouse: lighthouse
lightly: lightly
lightness: lightness
likelihood: likelihood
likes: likes
lime: lime
limit: limit,limited,limits
limitation: limitation
limited: limited
linen: linen
linger: lingers
link: linked,links
lion: lion
lip: lips
list: list
listen: listen,listened,listens
listener: listener
literary: literary
literature: literature
litter: litter
live: live,lived,lives,living
lived: lived
livelihood: livelihood
lively: lively
liverpool: liverpool
living: living
lo: lo
load: load,loaded
local: local
locate: located
location: locations
loch: loch
lock: lock
locomotion: locomotion
locomotive: locomotives
locust: locusts
lodge: lodge
lodgings: lodgings
loft: loft
logic: logic
london: london
lonely: lonely
longing: longing
looker: looker
loop: loop
loose: loose
loosely: loosely
loosen: loosened
lord: lord
lordly: lordly
lords: lords
lose: lose,losing,lost
loser: loser
loss: loss
lot: lot,lots
loud: loud,louder
louis: louis
lounge: lounge,lounging
lovable: lovable
love: love,loved,loving
lovely: lovelier,lovely
lover: lover,lovers
loving: loving
loyalty: loyalty
luck: luck
luckily: luckily
lucretius: lucretius
lucy: lucy
lui: lui
lump: lump,lumps
lumpkin: lumpkin
lunch: lunch,lunched
luncheon: luncheon
luther: luther
luxury: luxuries,luxury
macbeth: macbeth
machine: machine,machines
machinery: machinery
mad: mad
madam: madam
madame: madame
madeira: madeira
madeleine: madeleine
madonna: madonna
madrigal: madrigal
maggie: maggie
magic: magic
magistrate: magistrate
magnanimity: magnanimity
magnate: magnates
magnetism: magnetism
magnificent: magnificent
mahomet: mahomet
maid: maid,maids
maiden: maidens
mail: mail
main: main,mains
maintain: maintaining
maire: maire
majesty: majesty
major: major
maker: maker
mal: mal
malaria: malaria
malcolm: malcolm
malevolent: malevolent
malice: malice
malicious: malicious
maltese: maltese
mamma: mamma
manage: manage,managed,managing
manager: manager
manchester: manchester
manfully: manfully
mango: mangoes
manhood: manhood
manifold: manifold
mankind: mankind
manlike: manlike
manly: manly
manner: manner
mannered: mannered
manners: manners
manor: manor
mansion: mansions
manufacture: manufacture,manufactured
manuscript: manuscript
marble: marble
march: march,marched,marching
marine: marine
marines: marines
mark: mark,marked,marks
marked: marked
markedly: markedly
market: market
marmalade: marmalade
marquis: marquis
marriage: marriage,marriages
married: married
marry: married,marry
marseillaise: marseillaise
marsh: marsh,marshes
marshal: marshal
martin: martin
marvel: marvel,marvelled,marvelling
mary: mary
mask: masking
mass: mass
massacre: massacre
mast: mast,masts
master: master,mastered,masters
mastic: mastic
mat: mats
match: match
mate: mate,mates
material: material
materially: materially
mathematical: mathematical
mathematics: mathematics
matin: matin
matter: matter,matters
mature: maturing
maturity: maturity
mawkish: mawkish
maximum: maximum
maxwell: maxwell
mayor: mayor
meagre: meagre
meal: meal
meaning: meaning
measure: measure,measured,measures
measurement: measurement,measurements
meat: meat
mechanical: mechanical
mechanism: mechanism
medal: medal,medals
medical: medical
medicine: medicine
medico: medico
mediterranean: mediterranean
medium: medium
meet: meet,meets,met
meeting: meeting,meetings
melancholy: melancholy
mell: mell
melodious: melodious
melt: melted
membership: membership
memoir: memoir
memory: memories,memory
mend: mend,mended
mental: mental
mention: mention,mentioned,mentioning,mentions
merchant: merchant,merchants
merchantability: merchantability
merchantman: merchantman
mercifully: mercifully
mercy: mercy
mere: mere
merit: merit,merited
meritorious: meritorious
meritoriously: meritoriously
merrily: merrily
merry: merry
mes: mes
mess: mess
message: message,messages
metal: metal
metallic: metallic
metaphysics: metaphysics
method: method,methods
methods: methods
metre: metre
metropolis: metropolis
metropolitan: metropolitan
mettle: mettle
mexican: mexican
michael: michael
microfarad: microfarad
mid: mid
midday: midday
middle: middle
middling: middling
midi: midi
midnight: midnight
midshipman: midshipman
midst: midst
mighty: mighty
mild: mild,milder
mildness: mildness
mile: mile,miles
milk: milk
miller: millers
mills: mills
milo: milo
mimetic: mimetic
mimic: mimic
minaret: minarets
mind: mind,minds
minded: minded
mindedly: mindedly
mingle: mingled,mingling
minister: minister
ministers: ministers
ministration: ministrations
minority: minority
minotaur: minotaur
mint: mint
minute: minute,minutes
mirage: mirage
mirror: mirror,mirrors
mirthful: mirthful
mis: mis
misbehave: misbehaved
mischief: mischief
misconceive: misconceived
misconception: misconception
misconduct: misconduct
misconstrue: misconstrued
misery: miseries,misery
misfortune: misfortune,misfortunes
mishap: mishap
misrate: misrated
mission: mission
mississippi: mississippi
mist: mist
mistake: mistake
mistaken: mistaken
mister: mister
mistress: mistress
mistrust: mistrusted
mitigate: mitigate
mix: mixed
mixed: mixed
mixing: mixing
mixture: mixture,mixtures
mob: mob
mode: mode
model: model
moderate: moderate,moderating
modern: modern
modest: modest
modesty: modesty
modification: modification
modify: modified
moi: moi
moist: moist
mole: mole
moleskin: moleskin
moment: moment,moments
momentary: momentary
momentous: momentous
mon: mon
monastery: monastery
monday: monday
monde: monde
money: money
monger: monger
monk: monks
monsieur: monsieur
monstrous: monstrous
month: month,months
montreal: montreal
monument: monuments
mood: mood
moonlight: moonlight
moor: moor,moored,moors
moral: moral,morals
morale: morale
morality: morality
morning: morning
morrow: morrow
mortal: mortal
mortally: mortally
mortification: mortification
mortified: mortified
mosque: mosque,mosques
mother: mother,mothers
motion: motion
motive: motive
motto: motto
mouldering: mouldering
mount: mounted
mountain: mountain,mountains
mountaineer: mountaineer,mountaineers
mourn: mourned
mournfully: mournfully
mouth: mouth
movement: movement,movements
mud: mud
muddy: muddy
muff: muff
mule: mules
multiply: multiply
multitude: multitudes
mumchance: mumchance
municipal: municipal
murder: murder
murderous: murderous
murray: murray
muscular: muscular
muse: muse
museum: museum
music: music
musket: muskets
musketry: musketry
mustard: mustard
muster: mustered
mutandis: mutandis
mute: mute
mutual: mutual
myrtle: myrtle
mysterious: mysterious
mystery: mystery
mystic: mystic
mysticism: mysticism
nail: nail,nailed
nameless: nameless
napoleon: napoleon
narration: narration
narrative: narrative
narrow: narrow
narrowness: narrowness
nation: nation
national: national
native: native,natives
natural: natural
naturally: naturally
nature: nature,natures
natured: natured
naught: naught
nautical: nautical
nautically: nautically
naval: naval
navigation: navigation
navy: navy
nearer: nearer
necessity: necessity
needful: needful
needless: needless
negative: negatived
neglect: neglect,neglected
negligence: negligence
negro: negroes
neighbour: neighbour,neighbouring,neighbours
neighbourhood: neighbourhood
nephew: nephew,nephews
nervous: nervous
network: network
newcastle: newcastle
newfoundland: newfoundland
newport: newport
news: news
newsletter: newsletter
newspaper: newspaper,newspapers
nibble: nibble
nicaragua: nicaragua
nice: nice,nicest
niece: niece
night: night,nights
nightfall: nightfall
nightingale: nightingales
ninth: ninth
nipper: nipper
nitrogenous: nitrogenous
noble: noble,nobler,noblest
nobly: nobly
noise: noise
noisy: noisy
nonce: nonce
nondescript: nondescript
nonentity: nonentity
nonproprietary: nonproprietary
noon: noon
noose: noose,nooses
north: north
northern: northern
nose: nose
nostril: nostril
notable: notable
notably: notably
note: note,notes,noting
notice: notice,noticed
notify: notifies
notion: notion,notions
notorious: notorious
notre: notre
nous: nous
nouveau: nouveau
nouvelle: nouvelle
november: november
nucleus: nucleus
numberless: numberless
numerous: numerous
nurse: nurse,nurses
nursery: nurseries,nursery
nut: nut,nuts
oar: oar,oars
oath: oath
obedience: obedience
object: object,objects
objection: objections
obligation: obligation,obligations
oblige: obliged
obnoxious: obnoxious
obscure: obscure
obscurely: obscurely
obscurity: obscurity
observance: observance
observation: observation
observe: observe,observing
observer: observer
obsolete: obsolete
obstacle: obstacles
obstinacy: obstinacy
obstinate: obstinate
obstruction: obstructions
obtainable: obtainable
obtrusive: obtrusive
obvious: obvious
occasion: occasion,occasions
occasional: occasional
occupation: occupation,occupations
occupy: occupied,occupies
occur: occur,occurred,occurs
occurrence: occurrence
october: october
odd: odd
odds: odds
odour: odour
odyssean: odyssean
odysseus: odysseus
odyssey: odyssey
offensive: offensive
offer: offered,offers
office: office,offices
officer: officer,officers
official: official,officials
ohm: ohm
oho: oho
oil: oil
oilskin: oilskins
oily: oily
oleander: oleander
olympian: olympian
ominous: ominous
omission: omissions
omit: omit
omnibus: omnibuses
onerous: onerous
oneself: oneself
onion: onion
online: online
onward: onward
opera: opera
operation: operation,operations
opinion: opinion,opinions
opinionated: opinionated
opportunity: opportunities,opportunity
oppress: oppressing
optimism: optimism
optimist: optimist,optimists
optimistic: optimistic
oral: oral
orange: oranges
oration: oration
orchestra: orchestra
ordinary: ordinary
organise: organised
organize: organized
original: original
originally: originally
originator: originator,originators
orleans: orleans
ornament: ornament,ornaments
othello: othello
outdated: outdated
outer: outer
outfit: outfit
outgrow: outgrew,outgrown
outing: outing
outlay: outlay
outline: outline
outpost: outpost
outrage: outrage
outright: outright
outshine: outshone
outsider: outsider
outspoken: outspoken
outstrip: outstrip
outward: outward
overcome: overcame,overcome
overcrowded: overcrowded
overflow: overflowed
overland: overland
overlap: overlap
overpower: overpowered
overtake: overtaken
overtax: overtaxed
overturn: overturned
owe: owe,owed
owl: owl,owls
owlishly: owlishly
owner: owner,owners
oxen: oxen
pace: pace,paced,paces
pack: packed
pain: pain,pains
painful: painful
painfully: painfully
painless: painless
paint: paint,painted,painting
pair: pair
palace: palace,palaces
pale: pale
paler: paler
palette: palette
paling: palings
palm: palm,palms
palpable: palpable
palsy: palsy
palter: palter
pamphlet: pamphlet
pandemonium: pandemonium
pang: pangs
panic: panic
panting: panting
papa: papa
paper: paper,papers
paperwork: paperwork
par: par
parachute: parachutes
paradise: paradise
paradox: paradox
paragraph: paragraph,paragraphs
parallel: parallel
paramount: paramount
parasite: parasites
parcel: parcels
pardon: pardon
parent: parent,parents
parental: parental
paris: paris
parliament: parliament
parlour: parlour
parole: parole
parson: parson
partial: partial
partiality: partialities,partiality
partially: partially
particularity: particularity
particulars: particulars
partie: partie
partly: partly
partner: partner
partnership: partnership
partook: partook
partridge: partridges
party: parties,party
pas: pas
pass: pass,passed,passes,passing
passage: passage,passages
passe: passe
passenger: passenger,passengers
passer: passer
passing: passing
passion: passion,passions
passionate: passionate
passport: passports
pasta: pasta
paste: paste
pastime: pastime
pat: pat,patted
patch: patch,patches
patent: patent,patents
paternal: paternal
path: path
pathetic: pathetic
pathos: pathos
patience: patience
patient: patient,patients
patiently: patiently
patois: patois
patron: patron
pattern: pattern
paul: paul
pause: pause,pausing
pave: paving
pavement: pavement
pay: paid,pay,paying,pays
payment: payment,payments
paysage: paysage
peace: peace
peacock: peacock
peasant: peasant,peasants
pecker: pecker
pecuniary: pecuniary
pedantic: pedantic
pedigree: pedigree
peel: peels
peg: peg
pell: pell
pelt: pelted
pen: pen
penalty: penalty
pencil: pencil
pendant: pendant
penetrate: penetrate
pennant: pennants
penny: penny
perceive: perceive,perceived
percha: percha
perching: perching
perennial: perennial
perfect: perfect
perfection: perfection
perfectly: perfectly
perfervid: perfervid
perforce: perforce
perform: perform,performed,performing
performance: performance,performances
peril: peril
perilous: perilous
period: period
periodic: periodic
permanent: permanent
permanently: permanently
permission: permission
permit: permitted
perpetual: perpetual
perpetually: perpetually
perplexity: perplexities,perplexity
perseverance: perseverance
persevere: persevered,persevering
persist: persisted
person: people,person,persons
personal: personal
personally: personally
pessimism: pessimism
pet: petted
petit: petits
petites: petites
petty: petty
petulance: petulance
petulant: petulant
philip: philip
philippe: philippe
philosopher: philosopher
philosophic: philosophic
philosophical: philosophical
philosophy: philosophy
phonograph: phonograph,phonographs
phosphorescent: phosphorescent
phrase: phrase,phrased
physical: physical
physician: physician
physicians: physicians
physics: physics
pianist: pianist
piano: piano
pick: pick,picked,picking
picture: picture,pictured,pictures
picturesque: picturesque
piece: piece,pieces
piedmontese: piedmontese
pier: pier
pierce: pierced
pierre: pierre
piety: piety
pig: pigs
pigeon: pigeons
pile: piles
pilot: pilot
pinch: pinch,pinches
pinion: pinion
pink: pink
pinnacle: pinnacle
pioneer: pioneer
pious: pious
piously: piously
pipe: pipe,pipes
pirate: pirates
pistol: pistols
piston: piston
pitch: pitch,pitched,pitches
pitching: pitching
pity: pity
pivot: pivot
plain: plain
plainly: plainly
plainness: plainness
plan: plan,plans
plank: planks
plant: plant,planted,plants
plaster: plaster
plate: plate,plates
platform: platform
plato: plato
play: play,played,playing,plays
player: player
playmate: playmate
playroom: playroom
plea: plea
pleading: pleadings
pleasant: pleasant,pleasanter
pleasantly: pleasantly
pleasantry: pleasantry
pleased: pleased
pleasure: pleasure,pleasures
plenty: plenty
plot: plot
plough: ploughs
pluck: pluck,plucked
plumber: plumber,plumbers
plumed: plumed
plunder: plundering
plunge: plunge,plunging
plural: plural
plymouth: plymouth
pocket: pocket
poem: poem,poems
poet: poet,poets
poetic: poetic
poetry: poetry
poison: poison
poisonous: poisonous
poke: pokes
police: police
polite: polite,politest
politeness: politeness
politics: politics
polly: polly
polypi: polypi
pond: pond,ponds
ponder: pondered,pondering
pony: pony
pool: pool,pools
poor: poor,poorer
pop: popped
populace: populace
popular: popular
popularity: popularity
population: population
populous: populous
porcupine: porcupine
porpoise: porpoises
port: port
porta: porta
porte: porte
portion: portion,portions
portland: portland
portrait: portrait,portraits
portugal: portugal
pose: posed
position: position
positively: positively
possess: possess,possessed
possession: possession
possibility: possibility
post: post,posted,posts
posterity: posterity
pot: pot,potted
potato: potato,potatoes
poultice: poultice
poultry: poultry
pound: pound,pounds
pour: pour
poverty: poverty
powder: powder
power: power,powers
powerful: powerful
practical: practical
practically: practically
practice: practice,practiced
practise: practise,practised
praise: praise,praised,praising
prance: pranced
pray: pray,prayed
prayer: prayer
preacher: preacher
precaution: precautions
precede: preceding
precious: precious
precipice: precipice
precise: precise
precisely: precisely
precision: precision
precocious: precocious
precocity: precocity
preface: preface,prefaced
prefer: prefer,preferred
preference: preference,preferences
prefix: prefixed
prejudice: prejudice,prejudiced
preliminary: preliminary
premise: premise,premises
premonitory: premonitory
preparation: preparation,preparations
prepare: prepare,prepared,preparing
prepared: prepared
prepossession: prepossessions
preposterous: preposterous
prescribe: prescribed
presence: presence
presentation: presentation
presently: presently
presentment: presentment
preserve: preserve,preserved
presidency: presidency
president: president,presidents
press: press,pressed,pressing
pressure: pressure
presumption: presumption
pretence: pretence
pretension: pretensions
prettify: prettified
prettily: prettily
pretty: pretty
prevent: prevent,prevented,preventing
prevention: prevention
previous: previous
prey: prey
price: price
prickly: prickly
pride: pride
priest: priest
prima: prima
primitive: primitive
prince: prince,princes
principal: principal
principally: principally
principle: principle,principles
print: print,printed
prisoner: prisoner
private: private
privateer: privateers
privately: privately
privilege: privilege,privileges
prize: prize,prizes
prizeman: prizeman
prizes: prizes
probable: probable
problematical: problematical
proceed: proceed,proceeded,proceeding,proceeds
proceeding: proceeding
proceedings: proceedings
process: process,processed
processing: processing
procession: procession,processions
proclaim: proclaim
procrustean: procrustean
procure: procured
produce: produce,produced
product: product
production: production
profess: professed,professes
profession: profession
professional: professional,professionals
professor: professor,professors
professors: professors
proficiency: proficiency
profit: profit,profiting,profits
profound: profound
programme: programme
progress: progress
progressively: progressively
prohibition: prohibition
project: project,projected,projects
prolific: prolific
prolongation: prolongation
prolonged: prolonged
prominently: prominently
promise: promise,promised,promises
promising: promising
promote: promote,promoted,promoting
promotion: promotion
prompter: prompter
prong: prongs
pronounced: pronounced
proof: proof
proofread: proofread
proper: proper
properly: properly
property: properties,property
prophecy: prophecy
prophet: prophet,prophets
prophetic: prophetic
proportion: proportion,proportions
propose: proposed,proposing
proposition: proposition,propositions
proprietary: proprietary
proprietor: proprietor
propriety: propriety
proscribe: proscribed
prose: prose
prospect: prospect
prospects: prospects
prospectus: prospectus
prosper: prospered
prostration: prostration
protect: protect,protected,protecting
protection: protection
protector: protectors
protestant: protestant,protestants
prove: prove,proved,proves,proving
proverbial: proverbial
provide: provide,providing
providence: providence
province: province
provincial: provincial
provision: provision,provisions
provisional: provisional
provisionally: provisionally
provoke: provoked
provoking: provoking
prudence: prudence
prudent: prudent
prudently: prudently
psalms: psalms
public: public
publication: publication
publicly: publicly
publish: publish,published
publisher: publishers
publishing: publishing
puddle: puddles
puffing: puffing
pugnacity: pugnacity
pull: pull,pulled,pulling
pulley: pulley,pulleys
pump: pumps
punctilio: punctilio
punctilious: punctilious
punctual: punctual
punctuation: punctuation
punish: punished
punitive: punitive
pupil: pupil,pupils
purchase: purchase,purchased
pure: pure,purest
purely: purely
puritan: puritan
purple: purple
purpose: purpose,purposes
purse: purse
purser: purser
pursue: pursuing
pursuit: pursuit,pursuits
push: pushed
puzzle: puzzle,puzzled
quack: quacking
quaint: quaint
qualified: qualified
qualify: qualifying
quality: qualities,quality
quantitative: quantitative
quantity: quantities,quantity
quarantine: quarantine
quarrel: quarrel
quarter: quarter,quarters
quarto: quarto
quasi: quasi
queen: queen
queer: queer
quell: quelled
quench: quenched
quest: quest
question: question,questioned,questions
qui: qui
quick: quick
quidnunc: quidnuncs
quiet: quiet,quieter,quieting
quietly: quietly
quinine: quinine
quinzaine: quinzaine
quixote: quixote
quote: quote,quoted,quoting
quoth: quoth
race: race,races
rachel: rachel
racily: racily
radiantly: radiantly
raffish: raffish
raffle: raffle
rag: rag
rage: rage
raggedest: raggedest
railway: railway,railways
rain: rain
rainbow: rainbow,rainbows
rainy: rainy
raise: raise,raised,raising
rally: rallying
ramble: ramble
rambling: rambling
rampart: rampart,ramparts
rancid: rancid
random: random
range: range
rank: rank,ranks
raphael: raphael
rapid: rapid
rapidity: rapidity
rapidly: rapidly
rapport: rapports
rare: rare,rarer,rarest
rarely: rarely
rascal: rascal,rascals
rasp: rasping
rate: rate
rattle: rattle,rattling
ravages: ravages
raving: raving
raw: raw
ray: rays
reach: reach,reached,reaching
reaction: reaction
read: read,reading,reads
readable: readable
reader: reader,readers
readiness: readiness
reading: reading
ready: ready
real: real
realisation: realisation
realise: realised
reappearance: reappearance
reappearing: reappearing
rear: rear
reason: reason,reasons
reasonable: reasonable
reasoning: reasoning
rebel: rebels
rebellion: rebellion
recall: recall,recalled,recalls
recede: receded
receipt: receipt,receipts
receive: receive,received,receiving
receiver: receiver
recipient: recipients
reciprocal: reciprocal
recitation: recitation
recite: recite
reckless: reckless
reckon: reckoned
recognise: recognise,recognised,recognising
recollect: recollect,recollects
recommence: recommenced
recommend: recommend,recommended
recommendation: recommendations
reconcile: reconciled
reconciliation: reconciliation
reconnaissances: reconnaissances
record: record
recover: recover,recovered
recovery: recovery
recreation: recreation
rector: rector
recur: recurring
red: red
redistribute: redistribute,redistributing
redistributing: redistributing
redistribution: redistribution
reduce: reduced
reef: reef
reel: reel,reels
refer: refer,referred
reference: reference,references
refine: refined
refinement: refinement,refinements
reflect: reflect,reflected
reflection: reflections
reform: reform
refractory: refractory
refrain: refrained
refreshment: refreshments
refuge: refuge
refugee: refugees
refund: refund
refusal: refusal
refuse: refuse,refused,refuses
regain: regained
regale: regaled
regard: regard,regarded
regiment: regiment
register: registered
regret: regret
regretfully: regretfully
regular: regular
regularly: regularly
regulate: regulated,regulating
regulation: regulations
rehearsal: rehearsal
reign: reign
rein: rein
reject: rejected
rejoice: rejoice,rejoiced
relation: relation,relations
relationship: relationship
relative: relatives
relax: relax
release: release
relic: relics
relief: relief,reliefs
relieve: relieve,relieved
religieuses: religieuses
religion: religion
religious: religious
relish: relish
rely: rely
remain: remain,remained,remaining,remains
remainder: remainder
remains: remains
remark: remark,remarked,remarks
remarkable: remarkable
remarkably: remarkably
remedy: remedies,remedy
remember: remember,remembered
remind: remind,reminding
reminiscence: reminiscences
remorseful: remorseful
removal: removal
remove: remove,removed
rename: renamed
rencontre: rencontres
rend: rending
render: render,rendered
renew: renewed
renovated: renovated
reopening: reopening
repair: repair,repairs
repay: repay
repeat: repeat,repeated,repeating,repeats
repent: repent
replace: replace
replacement: replacement
reply: replied,reply
report: report,reported,reports
repose: repose,reposed
represent: represent,represented
representation: representation,representations
representative: representative
repression: repression
reprint: reprinted
reproach: reproach,reproaches
reproduce: reproduce
reproof: reproof
republic: republic
republican: republican,republicans
republish: republished
reputably: reputably
reputation: reputation
repute: repute
request: request
require: require,required
requirement: requirements
rescue: rescue
resemblance: resemblance
resent: resented
reserve: reserve,reserving
resident: resident,residents
resign: resigned
resignation: resignation
resistance: resistance
resolute: resolute
resolution: resolution
resolve: resolved
resource: resource
respect: respect
respectability: respectability
respectable: respectable
respecter: respecter
respects: respects
respite: respite
respond: responded
responsibility: responsibility
rest: rest,rests
restoration: restoration
restore: restore,restored
restrain: restrain,restraining
restraint: restraint
restriction: restrictions
result: result
resume: resume,resumed
retain: retained,retaining,retains
retint: retint
retire: retire,retired
retirement: retirement
retour: retour
retractation: retractation
return: return,returned,returning,returns
revel: revelling
revenue: revenue
reverend: reverend
reverse: reversed
revert: revert
review: review,reviewing
revisit: revisit
revive: revived
revolter: revolters
revolution: revolution,revolutions
revolutionary: revolutionary
revolve: revolves
revolver: revolvers
reward: reward
rheumatism: rheumatism
rhyme: rhymes
ribbon: ribbons
rich: rich
ride: ridden,ride,riding,rode
riding: riding
rig: rigged
rigger: riggers
rigging: rigging
rightly: rightly
rigid: rigid
rio: rio
ripe: ripe
ripen: ripen,ripening
ripple: rippled
rise: rise,risen,rises,rising,rose
risk: risk,risks
rival: rivals
rivalry: rivalry
river: river
riveter: riveters
road: road,roads
roadstead: roadstead
roar: roar,roaring
roast: roasts
rob: robbed
robe: robes
robert: robert
robust: robust
rock: rock,rocks
rocky: rocky
rod: rod
rodney: rodney
rogue: rogues
roll: rolled,rolling,rolls
roller: roller,rollers
roman: roman
romance: romance
romantic: romantic
rome: rome
romeo: romeo
romney: romney
romping: romping
roof: roof,roofs
root: root,roots
rope: rope,ropes
rose: rose,roses
rough: rough,roughest
roughly: roughly
roughness: roughness
rouse: roused
row: row,rowed
royal: royal
royally: royally
royalty: royalties,royalty
rude: rude
rue: rue
rues: rues
ruffle: ruffled
rug: rugs
rugged: rugged
ruin: ruin,ruined,ruins
rule: rule,ruled,rules,ruling
rummage: rummaged
rumour: rumour,rumoured
runt: runt
rush: rush,rushed,rushing
rust: rust,rusted
rustic: rustic
rusty: rusty
rye: rye
sabre: sabres
sack: sacked
sacred: sacred
sacrifice: sacrifice,sacrifices
sad: sad
saddle: saddle
saddler: saddler
safe: safe
safely: safely
safety: safety
sage: sage
sail: sail,sailed,sails
sailing: sailing
sailor: sailor,sailors
saint: saint
sake: sake
salaried: salaried
salary: salary
sally: sallied
salmon: salmon
salon: salon
saloon: saloon
salt: salt
salute: saluted
samuel: samuel
san: san,sans
sanction: sanction
sand: sand
sandbank: sandbank
sandwich: sandwich
sandy: sandy
sanitary: sanitary
sanitation: sanitation
santo: santo
sardinia: sardinia
satellite: satellites
satisfaction: satisfaction,satisfactions
satisfactorily: satisfactorily
satisfactory: satisfactory
satisfy: satisfied,satisfy
saturday: saturday
savage: savage
save: save,saved,saving
savile: savile
savings: savings
sawdust: sawdust
scale: scale,scales
scanty: scanty
scarce: scarce
scarcely: scarcely
scarlet: scarlet
scart: scarts
scatter: scattered
scattered: scattered
scene: scene,scenes
scenery: scenery
scent: scent,scented
scepticism: scepticism
scheme: scheme,schemes,scheming
scholar: scholar
scholarly: scholarly
scholastic: scholastic
school: school,schooling
schoolboy: schoolboy,schoolboys
schoolfellow: schoolfellows
schoolmate: schoolmates
sciatica: sciatica
science: science,sciences
scientific: scientific
scirocco: scirocco
scoff: scoff
scoot: scoot
scope: scope
score: score
scotch: scotch
scotland: scotland
scots: scots
scott: scott
scramble: scramble
scratch: scratched
scream: scream
screw: screw
scribble: scribbled,scribbling
scurvy: scurvy
scuttle: scuttle
sea: sea,seas
seaman: seaman
search: search,searching
seaside: seaside
seat: seat,seated
seaward: seaward,seawards
seaweed: seaweeds
seconde: seconde
secret: secret,secrets
secretary: secretary
secretaryship: secretaryship
secure: secure,secured,securing
seduce: seduced
sedulous: sedulous
seek: seeking,sought
seeker: seeker
seemingly: seemingly
seize: seized
select: selected
selection: selection
selfish: selfish
selfsame: selfsame
sell: sell,sold
sellar: sellar
senatus: senatus
send: send,sending,sends
senior: senior,seniors
sense: sense
sensitively: sensitively
sentence: sentence
sentiment: sentiment,sentiments
sentinel: sentinels
separate: separate,separated
separation: separation,separations
september: september
septic: septic
serai: serais
serais: serais
sergeant: sergeant
series: series
sermon: sermon,sermons
serrai: serrai
servant: servant,servants
serve: serve,served,serving
service: service,services
session: session
set: set,sets,setting
setting: setting
settle: settle,settled
seventeen: seventeen
seventh: seventh
severe: severe
sewage: sewage
sewer: sewer
sewerage: sewerage
sex: sex
sextant: sextant
shade: shade
shades: shades
shadow: shadow
shake: shaking,shook
shakespeare: shakespeare
shaking: shaking
shallow: shallow,shallowest
shame: shame
shape: shape
shapeless: shapeless
share: share,shared,shares,sharing
sharer: sharer
sharp: sharp
sharpen: sharpened
sharply: sharply
shear: shorn
sheave: sheave
sheep: sheep
sheepish: sheepish
sheepskin: sheepskin
sheer: sheer
sheerness: sheerness
sheet: sheet,sheets
shellac: shellac
shelley: shelley
shelter: shelter
sherbet: sherbet
shield: shield
shift: shifted
shilling: shilling,shillings
shine: shine,shining,shone
ship: ship,ships
shipway: shipway
shipwright: shipwrights
shirt: shirts
shiver: shivering
shoal: shoals
shock: shock,shocked
shocked: shocked
shocking: shocking
shoe: shoes
shoot: shoot,shot
shooting: shooting
shop: shop,shops
shopboy: shopboys
shopkeeper: shopkeepers
shore: shore,shores
short: short
shortly: shortly
shot: shot
shoulder: shoulder,shouldering,shoulders
shout: shouting,shouts
shrew: shrew
shrewd: shrewd
shrewdly: shrewdly
shrink: shrank
shroud: shroud
shrub: shrubs
shudder: shudder
shut: shut
shy: shy
sic: sic
sick: sick
sickening: sickening
sicklier: sicklier
sickly: sickly
sickness: sickness
sideways: sideways
siesta: siesta
sigh: sighed
sight: sight,sights
sighted: sighted
sign: sign,signed,signing,signs
signal: signal,signalled,signals
signalling: signalling
signature: signature,signatures
significance: significance
signify: signify
signor: signor
silence: silenced
silent: silent
silk: silk
silly: silly
silver: silver
similarity: similarity
simple: simple
simplicity: simplicity
simply: simply
sin: sin
sincerely: sincerely
sing: sang,sing,singing
singing: singing
single: single,singled
singular: singular
singularly: singularly
sink: sunk
sir: sir
sire: sires
sister: sister,sisters
sit: sat,sit,sitting
sitter: sitter
sitting: sittings
situation: situation,situations
sixteen: sixteen
sixteenth: sixteenth
size: size
sized: sized
skating: skating
skein: skein
sketch: sketch,sketched,sketches,sketching
skilful: skilful
skilfully: skilfully
skill: skill
skilled: skilled
skin: skin
skip: skips
skipper: skipper
skirt: skirts
skulk: skulk,skulked,skulking
sky: skies,sky
slack: slack,slacking
slacker: slacker
slate: slate
slave: slave,slaves
slaver: slavers
slay: slain
sleep: sleep,sleeping,slept
sleeper: sleeper
sleeve: sleeves
sleight: sleight
slender: slender
slide: sliding
slight: slight
slim: slim
sling: slung
slip: slip,slipped,slipping,slips
slipshod: slipshod
slope: sloping
slovenliness: slovenliness
slow: slow
slowly: slowly
sluggard: sluggard
slur: slur
slush: slush
smack: smack
smallness: smallness
smash: smash
smatterer: smatterer
smell: smell,smelling,smelt
smile: smile,smiles,smiling
smith: smith
smoke: smoke,smoked
smoking: smoking
smoothness: smoothness
smoulder: smouldering
smuggle: smuggled
smuggler: smuggler
snake: snake
snap: snapped,snapping
sniff: sniffing
snooze: snoozed
snow: snow
snowy: snowy
snug: snug
soap: soap
soar: soaring
sob: sob
social: social
society: societies,society
socrates: socrates
soft: soft,softer
soften: softened
softness: softness
soil: soil
soir: soir
solace: solace
soldier: soldier,soldiers
solemnly: solemnly
solicit: solicit
solicitation: solicitation
solicitude: solicitude
solid: solid
solitary: solitary
solitude: solitude
solve: solve
son: son,sons
song: song,songs
sons: sons
sooth: sooth
sophist: sophist
sophocles: sophocles
sophy: sophy
sore: sore
sorrow: sorrow
sorrowing: sorrowing
sort: sort,sorts
soul: soul
sound: sound,sounded,sounding,sounds
sounding: soundings
soundly: soundly
source: source,sources
sous: sous
souse: souse
south: south
souvenir: souvenir
sow: sowing
space: space,spaces
spade: spade
spanish: spanish
spar: spar
spare: spare,sparing
spark: spark
sparkling: sparkling
speak: speak,speaking,speaks,spoke,spoken
speaker: speaker
special: special
specially: specially
specific: specific
specimen: specimen,specimens
spectacular: spectacular
spectator: spectator
specula: specula
speculation: speculation,speculations
speculative: speculative
speech: speech
speechmaking: speechmaking
speed: speed
speedily: speedily
spell: spelled
spend: spend,spending,spent
spending: spending
sphere: sphere
spice: spice
spicy: spicy
spike: spike
spin: spun
spindle: spindle
spindrift: spindrift
spirit: spirit,spirits
spirited: spirited
spiritless: spiritless
spiritual: spiritual
spirituelle: spirituelle
spite: spite
splendid: splendid
splendidly: splendidly
splice: splice,spliced,splicing
splicing: splicing
spoil: spoil
sport: sport,sports
spot: spot
sprawl: sprawling
spray: sprays
spread: spread,spreading
spring: sprang,spring,springing,springs,sprung
sprinkling: sprinkling
spunyarn: spunyarn
spur: spurs
spy: spied
squabble: squabble
squadron: squadron,squadrons
squally: squally
squander: squandered
square: square
squat: squat
squint: squints
squire: squire
stable: stable
stack: stack
staff: staff
stag: stag
stage: stage,stages
stagnant: stagnant
stagnation: stagnation
staid: staid
stair: stairs
stalk: stalk
stall: stalls
stamp: stamp
stand: stand,standing,stands,stood
standard: standard,standards
standards: standards
staple: staple
star: stars
stare: staring
start: start,started,starting,starts
startle: startled
startled: startled
stately: stately
statement: statement,statements
station: station
statistics: statistics
statue: statues
stature: stature
status: status
staunchly: staunchly
stave: staves
stay: stay,stayed,staying
stead: stead
steadily: steadily
steadiness: steadiness
steady: steady
steal: steal,stealing,stolen
stealth: stealth
stealthy: stealthy
steam: steam,steaming,steams
steamboat: steamboat
steamer: steamer
steel: steel
steep: steep
steer: steer,steered
steering: steering
step: step,steps
stephen: stephen
sterility: sterility
sterling: sterling
stern: stern
sternness: sternness
steward: steward,stewards
stick: stick,sticking,sticks,stuck
stiff: stiff
stifle: stifle
stimulate: stimulating
stint: stinted
stir: stir,stirred,stirring
stirring: stirring
stock: stock,stocked
stoic: stoic
stoical: stoical
stoicism: stoicism
stoker: stoker
stolid: stolid
stomach: stomach,stomachs
stone: stone,stones
stoop: stooped
stoppage: stoppage
store: store,stored,stores
storey: storeys
storied: storied
storm: storm
story: stories,story
stout: stout
stoutly: stoutly
stove: stove
straight: straight
strain: strain,strained,strains
strange: strange,strangest
strangely: strangely
stranger: stranger,strangers
strangle: strangled
strap: strap,strapping
strategic: strategic
stray: stray,strayed
stream: stream
street: street,streets
strength: strength
strenuous: strenuous
stretch: stretch,stretched
stricken: stricken
strict: strict
strictly: strictly
strike: strike,struck
string: strings
stringent: stringent
stripe: stripes
stroke: stroke,strokes
strong: strong,stronger,strongest
struggle: struggle,struggles,struggling
stubborn: stubborn
student: student,students
studious: studious
study: studies,study,studying
stuff: stuff
stultified: stultified
stumble: stumble
sturdy: sturdy
style: style
styrian: styrian
subaltern: subaltern
subject: subject,subjected,subjects
submarine: submarine
submit: submitted
subordinate: subordinate
subscribe: subscribe
subscriber: subscribers
subscription: subscription
subsequent: subsequent
substance: substance,substances
substitution: substitution
subtlety: subtleties
suburb: suburb
succeed: succeed,succeeded,succeeding,succeeds
success: success
successful: successful
successive: successive
sucker: suckers
sudden: sudden
suddenly: suddenly
suffer: suffer,suffered,suffers
sufferer: sufferer
suffering: suffering,sufferings
suffice: suffice
sufficient: sufficient
suggestion: suggestion,suggestions
suggestive: suggestive
suit: suit,suits
suitable: suitable
suite: suite
sulphur: sulphur
sum: sum
summer: summer
summit: summit
summons: summons
sun: sun
sunday: sunday
sundays: sundays
sunlight: sunlight
sunny: sunny
sunrise: sunrise
sunset: sunset
sunshine: sunshine
superficial: superficial
superior: superior,superiors
superiority: superiorities
superlatively: superlatively
supersede: superseded
supervision: supervision
supper: supper
supply: supplied,supply
support: support,supported
suppose: suppose,supposed,supposing
suppress: suppress
surely: surely
surface: surface
surge: surging
surgeons: surgeons
surprise: surprise
surprised: surprised
surround: surrounded,surrounds
surroundings: surroundings
survey: survey,surveying
survival: survival,survivals
survive: survive,survived,survives,surviving
susan: susan
suspect: suspect,suspected
suspend: suspending
suspense: suspense
suspicion: suspicion
sussex: sussex
sustain: sustained,sustains
sustained: sustained
sustenance: sustenance
swamp: swamp,swamped
swear: swear,swearing,swears
swearing: swearing
sweat: sweat
sweep: swept
sweet: sweeter
sweeten: sweetened
sweetheart: sweetheart
sweetness: sweetness
swell: swell
swift: swift
swim: swam,swim
swimmer: swimmer
swindle: swindle
swing: swing
switzerland: switzerland
sword: sword,swords
symbol: symbol
symbolical: symbolical
sympathise: sympathise
sympathy: sympathies,sympathy
symptom: symptoms
synonymous: synonymous
systematic: systematic
systematically: systematically
table: table,tables
tableau: tableau
tacitly: tacitly
tact: tact
tail: tail,tails
tailor: tailor,tailoring,tailors
taint: taint
tait: tait
tale: tale
talent: talent,talents
talented: talented
talk: talk,talked,talking,talks
tall: tall
tame: tame,taming
tan: tanned
tandem: tandem
tangle: tangle,tangles
tank: tanks
tar: tar
tarry: tarry
tart: tart
task: task
taskmaster: taskmaster
taste: taste,tasted,tastes
taut: taut
tax: tax,taxes
taylor: taylor
tea: tea
teach: taught,teach,teaches,teaching
teacher: teacher,teachers
teaching: teaching
tear: tear,tearing,tears,torn
technical: technical
teem: teem,teeming
teethe: teething
telegram: telegram,telegrams
telegraph: telegraph,telegraphed
telegraphic: telegraphic
telegraphing: telegraphing
telegraphist: telegraphists
telegraphy: telegraphy
telescope: telescope
telpherage: telpherage
temp: temps
temper: temper,tempered
tempered: tempered
tempest: tempest
temporal: temporal
temporarily: temporarily
tempt: tempted
tenable: tenable
tenant: tenant,tenants
tend: tended
tender: tender
tenderness: tenderness
tenement: tenement,tenements
tenor: tenor
tense: tense
tension: tension
tent: tent
tentative: tentative
tenth: tenth
term: term,terms
terrace: terrace,terraces
terrible: terrible
terribly: terribly
terrier: terrier
terror: terror,terrors
testify: testify
testimony: testimony
testing: testing,testings
testy: testy
texture: texture
thankful: thankful
thatch: thatched
theatre: theatre,theatres
theatricals: theatricals
theme: theme
thenceforth: thenceforth
thenceforward: thenceforward
theophilus: theophilus
theory: theories,theory
thermometer: thermometer
thicken: thickened
thief: thief
thinking: thinking
thirst: thirst
thirteen: thirteen
thistle: thistles
thomas: thomas
thomsonian: thomsonian
thorny: thorny
thoroughness: thoroughness
thoughtful: thoughtful
thrash: thrashed
thread: threads
threat: threat
threaten: threatened,threatening
threepence: threepence
thresh: thresh
threshing: threshing
threshold: threshold
thrice: thrice
thrift: thrift
thriftless: thriftless
thrill: thrill
thrilling: thrilling
thro: thro
throw: threw,throw,throwing,thrown,throws
thrust: thrust
thunder: thunder,thundering
thwart: thwart,thwarted
thyme: thyme
ticket: ticketed,tickets
tide: tide
tideway: tideway
tidy: tidied
tie: tie,tied
tight: tight
tighten: tighten,tightening
time: time,times
times: times
timid: timid
tin: tin
tind: tind
tinfoil: tinfoil
tinker: tinkering
tinkle: tinkled
tint: tints
tipsy: tipsy
tired: tired
tiresome: tiresome
title: title
toast: toast
tobacco: tobacco
toby: toby
toe: toes
toil: toil,toiled
tolerable: tolerable
tolerably: tolerably
tolerant: tolerant
tolerate: tolerate
toleration: toleration
tom: tom
tomblike: tomblike
ton: ton,tons
tone: tone,tones
tongue: tongue,tongues
tonight: tonight
tony: tony
tool: tools
tooth: teeth
toothache: toothache
topic: topics
topics: topics
torch: torches
toro: toro
tortoise: tortoises
tory: tory
toss: toss,tossed,tosses,tossing
tossing: tossing
touch: touch,touched,touches
touching: touching
touchstone: touchstone
tour: tour,tours
tout: tout
tow: towed
tower: tower
town: town,towns
toy: toy
trace: trace,traced,tracing
tract: tract
trade: trade,traded
trademark: trademark
tradesman: tradesmen
tradition: tradition
traditional: traditional
tragedy: tragedy
tragic: tragic
train: train,trained
training: training
trait: trait,traits
trample: trampled
tranquillity: tranquillity
transaction: transactions
transcribe: transcribe,transcribed
transcription: transcription
transformation: transformation
tranship: transhipped
translation: translation,translations
transmigratory: transmigratory
transmission: transmission
transmit: transmitted
transport: transported
trapped: trapped
traveller: travellers
travels: travels
treacherous: treacherous
treachery: treachery
tread: tread,trod
treasure: treasure,treasures
treat: treat,treated
treatise: treatise
treatment: treatment
tree: trees
tremble: trembled,trembling
tremendous: tremendous
trenchancy: trenchancy
trenchant: trenchant
trenchantly: trenchantly
trepidation: trepidation
trespass: trespasses
trial: trial,trials
tribe: tribes
tributary: tributary
trick: tricks
tricolour: tricolour
trifle: trifle,trifles
trifling: trifling
trip: trip,tripped
triplet: triplet
triumph: triumph,triumphs
triumphant: triumphant
trivets: trivets
troilus: troilus
trois: trois
troop: troop
trooper: trooper,troopers
troops: troops
trophy: trophy
trot: trots
trouble: trouble,troubles
troubled: troubled
trousers: trousers
truck: trucks
true: true
trust: trust,trusting
trustfully: trustfully
truth: truth,truths
truthfulness: truthfulness
tu: tu
tub: tub
tube: tube
tubing: tubing
tuesday: tuesday
tuft: tufts
tug: tug
tumultuous: tumultuous
tune: tune
turban: turbaned,turbans
turbulent: turbulent
turf: turfed
turkish: turkish
turks: turks
turner: turner
turnip: turnips
turtle: turtle
tutoiement: tutoiement
tutor: tutor
tutoyer: tutoyer
twelfth: twelfth
twill: twill
twine: twined
twist: twisted
twisted: twisted
twofold: twofold
twopenny: twopenny
type: types
typhoid: typhoid
typical: typical
tyrant: tyrant
ubiquity: ubiquity
ugh: ugh
ugly: ugly
ultimate: ultimate
ultimately: ultimately
unable: unable
unaccountable: unaccountable
unaffectedly: unaffectedly
unaided: unaided
unalloyed: unalloyed
unalterable: unalterable
unannounced: unannounced
unapproachable: unapproachable
unattended: unattended
unavoidable: unavoidable
unbroken: unbroken
unceasing: unceasing
uncertain: uncertain
uncertainty: uncertainties,uncertainty
unchanged: unchanged
unchristian: unchristian
uncle: uncle
unclouded: unclouded
uncommon: uncommon
uncommonly: uncommonly
uncongenial: uncongenial
unconscious: unconscious
unconsciously: unconsciously
unconventional: unconventional
unconvinced: unconvinced
uncountable: uncountable
underlie: underlay
understand: understand,understood
understanding: understanding
undertake: undertaken,undertaking,undertook
undertaking: undertakings
undiscerned: undiscerned
undisturbed: undisturbed
undoubtedly: undoubtedly
unenforceability: unenforceability
unequal: unequal
unexpected: unexpected
unfailing: unfailing
unfair: unfair
unfit: unfit
unflagging: unflagging
unfold: unfolding,unfolds
unfortunate: unfortunate
unhappily: unhappily
unhappy: unhappy
unhealthy: unhealthy
unheard: unheard
unhurt: unhurt
uniform: uniform
unimpaired: unimpaired
uninjured: uninjured
unintellectual: unintellectual
union: union
unit: unit,units
unite: united
united: united
universally: universally
universe: universe
university: universities,university
unjustly: unjustly
unkind: unkind
unkindly: unkindly
unknown: unknown
unlettered: unlettered
unlink: unlink
unlucky: unlucky
unmannered: unmannered
unmannerly: unmannerly
unmarried: unmarried
unmoved: unmoved
unnatural: unnatural
unobserved: unobserved
unobtainable: unobtainable
unpaid: unpaid
unpleasant: unpleasant
unpractical: unpractical
unpretentiously: unpretentiously
unpunctuated: unpunctuated
unquestionably: unquestionably
unquiet: unquiet
unravel: unravel
unrest: unrest
unsanitary: unsanitary
unsatisfactory: unsatisfactory
unsavoury: unsavoury
unscientific: unscientific
unselfish: unselfish
unshaken: unshaken
unship: unship
unshipped: unshipped
unsolicited: unsolicited
unspeakable: unspeakable
unsuccessful: unsuccessful
unsuitable: unsuitable
untame: untamed
untethered: untethered
untrained: untrained
untried: untried
unusual: unusual
unweariable: unweariable
unwearied: unwearied
unwell: unwell
update: updated
uphill: uphill
upper: upper
upright: upright
uproarious: uproarious
upward: upward
urbanity: urbanity
urchin: urchins
uriah: uriah
useless: useless
user: user,users
usher: usher
usual: usual
ut: ut
utensil: utensils
utmost: utmost
utter: utter,uttered
utterance: utterance
utterly: utterly
vacancy: vacancy
vacuo: vacuo
vagabond: vagabonds
vagrant: vagrant
vague: vague
vain: vain
vainly: vainly
valencia: valencia
valley: valley,valleys
valour: valour
valuable: valuable,valuables
vanilla: vanilla
vanish: vanish
vanity: vanities,vanity
vanquish: vanquished
variation: variation,variations
variety: variety
vary: varied,varying
vast: vast
vastly: vastly
vegetable: vegetable
vegetation: vegetation
veil: veil
vein: vein,veins
vendor: vendors
venetian: venetian
vengeance: vengeance
ventilate: ventilate,ventilated
ventilated: ventilated
ventilation: ventilation
venture: venture,ventured
verbena: verbenas
verdure: verdure
verge: verge
vernon: vernon
verse: verse,verses
version: version
vertical: vertical
vertu: vertu
vessel: vessel,vessels
vexation: vexation
vicar: vicar
vicarage: vicarage
vicious: vicious
victim: victims
victor: victor
victory: victory
vie: vie,vied
view: view,viewed,viewing,views
vigorously: vigorously
vigour: vigour
vii: vii
village: village,villages
ville: ville
vincent: vincent
vint: vint
violate: violates
violence: violence
violent: violent
violently: violently
violin: violin
virile: virile
virtue: virtue,virtues
virus: virus
vis: vis
visible: visible
visibly: visibly
vision: vision,visions
visionary: visionary
visit: visit,visited,visits
visite: visite
visitor: visitor,visitors
vista: vistas
vitality: vitality
vivacity: vivacity
vivant: vivant
vive: vive
vivid: vivid
vividly: vividly
vizier: vizier
vocalisation: vocalisations
vociferate: vociferating
voice: voice,voices
voiced: voiced
void: void
volcano: volcano
volley: volley
voltaire: voltaire
volume: volume,volumes
voluntary: voluntary
volunteer: volunteer,volunteered,volunteers
vote: voted
vow: vow,vowed,vowing
vowel: vowel
voyage: voyage,voyages
voyages: voyages
vulgarity: vulgarity
wages: wages
wait: wait,waiting
wake: wake,woke
waken: wakened
wales: wales
walk: walk,walked,walking,walks
wall: wall,walls
wander: wander,wandering
wantonly: wantonly
wantonness: wantonness
war: war,wars
ward: ward
warehouse: warehouse,warehouses
warfare: warfare
warm: warm,warmer
warmly: warmly
warning: warning
warrant: warrant
warranty: warranties,warranty
wash: washed,washing
waste: waste,wasted
watch: watch,watched,watches,watching
watchfulness: watchfulness
water: water,watering,waters
watering: watering
watt: watt
wave: wave,waves
wax: waxed
wayfarer: wayfarers
weak: weak,weaker
weaken: weaken
weakness: weakness,weaknesses
wealth: wealth
weapon: weapons
wear: wear,wearing,wore,worn
weariness: weariness
weary: weary
weather: weather
weave: weave,weaving,woven
weber: weber
wedding: wedding
wednesday: wednesday
weed: weeds
week: week,weeks
weep: weep,weeping
weigh: weigh,weighed,weighs
weight: weight
weird: weird
welsh: welsh
west: west
westward: westward
wet: wet,wetted,wetter
whatsoever: whatsoever
wheatstone: wheatstone
wheel: wheel
whereon: whereon
whiggish: whiggish
whip: whip,whips
whirr: whirr
whiskey: whiskey
whist: whist
whistle: whistle,whistles
whistler: whistler,whistlers
white: white
whiten: whiten
wholesome: wholesome
wholly: wholly
wide: wide,wider,widest
widow: widow
wife: wife,wives
wig: wig,wigging,wigs
wild: wild
wildest: wildest
wildly: wildly
wilfully: wilfully
william: william
williams: williams
willingly: willingly
winch: winch
wind: wind,winding,winds,wound
windmill: windmills
window: window,windows
windsor: windsor
windward: windward
windy: windy
wine: wine
wing: wings
wingless: wingless
wink: winking
winter: winter
wire: wire,wires
wiremen: wiremen
wiry: wiry
wisdom: wisdom
wise: wise
wisely: wisely
wisher: wishers
wit: wit
witch: witches
withdraw: withdrawn
withhold: withheld
witness: witness
witticism: witticism
witty: witty
woe: woe
woman: woman,women
womanly: womanly
wonderful: wonderful
wonderfully: wonderfully
wonted: wonted
wood: wood
woody: woody
worcester: worcester
word: word,worded
worker: worker
workman: workman,workmen
worms: worms
worn: worn
worship: worship
worth: worth
worthless: worthless
worthy: worthier,worthy
wound: wound,wounded
wrangle: wrangle,wrangles
wrap: wrapped,wraps
wrapping: wrappings
wreck: wreck
wretched: wretched
wriggle: wriggling
write: write,writes,writing,written,wrote
writer: writer,writers
writing: writing
wrong: wrong
yacht: yacht,yachts
yard: yards
yarn: yarn
yearly: yearly
yellow: yellow
yelp: yelp
yeoman: yeoman
yeomanry: yeomanry
yesterday: yesterday
yield: yield
york: york
yorkshire: yorkshire
youth: youth
youthful: youthful
youthfully: youthfully
youthfulness: youthfulness
zeal: zeal
zealot: zealots
zealous: zealous
zither: zither
zouave: zouave
