abandon: abandoned
abhorrence: abhorrence
abide: abide
ability: abilities
abject: abject
abominable: abominable
abomination: abomination
aborigine: aborigines
abraham: abraham
absalom: absalom
absent: absent
absolute: absolute
absolutely: absolutely
absolution: absolution
absolve: absolved
absurd: absurd
absurdity: absurdity
abuse: abuse
abyss: abyss
academy: academy
accent: accents
accept: accept,accepted,accepting
acceptance: acceptance
access: access,accessed
accessible: accessible
accident: accidents
accompany: accompanied,accompany,accompanying
accomplishment: accomplishment
accord: accorded
accost: accosted
account: account
accuse: accused
accustom: accustom,accustomed
ace: ace
achates: achates
acid: acid
acknowledge: acknowledge,acknowledged
acquaint: acquaint,acquainted
acquaintance: acquaintance
acquire: acquire
acre: acres
action: action
active: active
actor: actor,actors
actress: actress
actual: actual
adam: adam
add: add
addition: addition,additions
additional: additional
address: address,addressed,addresses
adherent: adherents
adieu: adieu
administration: administration
admirable: admirable
admirably: admirably
admiral: admiral
admire: admire
admit: admit
admittance: admittance
adore: adore
adorn: adorned
advance: advance,advanced
advanced: advanced
advantage: advantage,advantages
adventure: adventure,adventures
adventurer: adventurers
adversary: adversary
advice: advice
advise: advise,advised
affair: affair,affairs
affect: affect
affiance: affianced
affirm: affirm,affirmed
afflict: afflicted
afford: afford
afraid: afraid
afresh: afresh
africa: africa
afternoon: afternoon
aga: aga
age: age,ages
aged: aged
agent: agent
aghast: aghast
agility: agility
agitate: agitated
agree: agree,agreed,agrees
agreeable: agreeable
agreeably: agreeably
agreement: agreement
aim: aim,aimed
air: air
ak: ak
alarm: alarm,alarmed
alas: alas
alcalde: alcalde
alert: alert
alexandria: alexandria
algiers: algiers
alight: alighted
alive: alive
allowance: allowance
ally: allied
almoner: almoner
alms: alms
aloud: aloud
altar: altar
alter: altering
alteration: alteration
alternate: alternate
altogether: altogether
amass: amassed
amazed: amazed
amazement: amazement
amazing: amazing
ambassador: ambassador
ambitious: ambitious
amend: amended,amends
america: america
american: american
amorously: amorously
ample: ample
amplification: amplifications
amsterdam: amsterdam
amuse: amuse,amused
amusement: amusement
amusing: amusing
anabaptist: anabaptist
anachronism: anachronism
anatole: anatole
anchor: anchor
ancient: ancient,ancients
andalusian: andalusian
andrew: andrew
anemone: anemones
anger: anger
angry: angry
anguish: anguish
animal: animal,animals
anoint: anoint
answer: answer,answered,answers
antechamber: antechamber
anthony: anthony
antiquity: antiquity
anxiety: anxiety
apartment: apartment,apartments
apostrophe: apostrophes
appearance: appearance
appease: appeased
applaud: applauded
apple: apples
applicable: applicable
apply: applied,apply
appoint: appointed
apprehend: apprehend
approach: approach,approached,approaches,approaching
approbation: approbation
approve: approved
arabia: arabia
arabic: arabic
arbour: arbour
arch: arch
archdeacon: archdeacon
arched: arched
archive: archive
argumentative: argumentative
arithmetic: arithmetic
arm: arm,armed,arms
armoury: armoury
army: armies,army
arrange: arranged
arras: arras
array: array
arrest: arrested,arresting
arrival: arrival
arrive: arrived
arrow: arrows
art: art,arts
arts: arts
ascanius: ascanius
ascend: ascend
ascertain: ascertained
ascii: ascii
ash: ashes
asia: asia
askew: askew
asleep: asleep
assail: assailed
assailant: assailant
assassin: assassins
assassinate: assassinate,assassinated
assemble: assembled,assembling
assembly: assembly
assert: assert,asserted
assist: assist
assistance: assistance
assume: assumed
assumption: assumption
assure: assured,assuring
astonish: astonished
astonished: astonished
astonishment: astonishment
atlantic: atlantic
atlas: atlas
atocha: atocha
atonement: atonement
atrabilious: atrabilious
attach: attached
attack: attack,attacked
attempt: attempt,attempted,attempting
attend: attend
attendant: attendant,attendants
attention: attention,attentions
attentively: attentively
attractive: attractive
audience: audience
auguste: auguste
auricula: auriculas
author: author
auto: auto
avail: avail
avenger: avenger
aversion: aversion
avert: avert
avow: avowed
await: await,awaited,awaits
awake: awake,awaking
award: awarded
aware: aware
awkwardly: awkwardly
awry: awry
ay: ay
babylon: babylon
backside: backside
bacon: bacon
bad: bad,worse,worst
badly: badly
bag: bag
bagatelle: bagatelle
baggage: baggage
balearic: balearic
ball: ball,balls
balsam: balsam
bandage: bandaged
banish: banished
banishment: banishment
bank: bank,banks
banker: banker
bankrupt: bankrupts
barbarian: barbarian,barbarians
barbarous: barbarous
barber: barber
bare: bare
bargain: bargain
bark: bark
barn: barn
baron: baron,barons
baroness: baroness,baronesses
barony: barony
barrelled: barrelled
barren: barren
barrier: barrier
bartholomew: bartholomew
base: based
bastard: bastard
bath: bath,bathed,bathing
bathe: bathe
bathing: bathing
baton: baton
battle: battle,battles
bay: bay
bayonet: bayonet,bayonets
bear: bear,bears,bore,born,borne
beard: beards
bearer: bearer
beat: beat,beaten
beautiful: beautiful
beautifully: beautifully
beauty: beauties,beauty
beaux: beaux
beckon: beckoned
bed: bed
beer: beer
befall: befallen,befell
beg: beg,begged,begging
beggar: beggar,beggars
begone: begone
behave: behaved
behaviour: behaviour
behead: beheaded
behold: beheld,behold,beholding,beholds
belief: belief
belly: belly
belong: belong,belonged,belonging
beloved: beloved
bench: bench
beneath: beneath
benedictine: benedictine
benefactor: benefactor
benefit: benefit
benumb: benumbed
beseech: beseech
besiege: besieged
bestow: bestow
betray: betray
bewilder: bewildered
bid: bade,bid
binary: binary
bind: bound
biped: biped
bird: bird,birds
birth: birth
biscayner: biscayner
bit: bit
bitch: bitch
bite: biting
black: black,blacks
bleared: bleared
bleeding: bleeding
bless: bless,blessed
bliss: bliss
blood: blood
bloody: bloody
blot: blots
blow: blew,blow,blows
blue: blue
blues: blues
blurb: blurb
blush: blushed
board: board,boarded
boasting: boasting
boat: boat,boats
body: bodies,body
boil: boil,boiled
bold: bold
boldness: boldness
bombastic: bombastic
bon: bon
boni: boni
book: book,books
bookkeeper: bookkeeper
bookseller: bookseller,booksellers
booty: booty
bordeaux: bordeaux
border: bordered
bored: bored
borrow: borrowing
bosom: bosom
bottle: bottle,bottles
boudoir: boudoir
bouffe: bouffe
bouilli: bouilli
bound: bounded
bouquet: bouquet
bourgeois: bourgeois
bow: bow,bows
bower: bower
box: box,boxed
boy: boy,boys
boyard: boyard,boyards
bracket: brackets
brain: brain,brains
brat: brats
brave: brave
bravely: bravely
breach: breach
bread: bread
breadth: breadth
break: break,broke,broken
breakfast: breakfast
breast: breasts
breath: breath
breathe: breathing
breathlessly: breathlessly
brethren: brethren
bridle: bridled,bridles
brigand: brigands
bright: bright
brilliant: brilliant,brilliants
brilliantly: brilliantly
bring: bring,bringing,brings,brought
broadside: broadside
brocade: brocades
brocaded: brocaded
broil: broils
broken: broken
broth: broths
brother: brother
brotherhood: brotherhood
brown: brown
brush: brush
brutal: brutal
brute: brute
brutish: brutish
buenos: buenos
build: built
bulgarian: bulgarian,bulgarians
bull: bull
burden: burden,burdens
burial: burial
burn: burn,burnt
burning: burning
burst: burst
bury: buried,bury
bush: bushes
business: business
busybody: busybodies
butchery: butchery
buttock: buttock,buttocks
cabal: cabal
cabin: cabin
cadence: cadence
cadi: cadi
cadis: cadis
calamity: calamities
calculate: calculate,calculated
calm: calmer
calmness: calmness
calumniator: calumniators
camel: camel
camp: camp
canada: canada
canal: canals
candidate: candidates
candide: candide
candy: candied
cane: cane,canes
cannon: cannon,cannons
cannonade: cannonading
canoe: canoe
canticle: canticles
cap: cap
capable: capable
cape: cape
capital: capital
captain: captain
captivity: captivity
carara: carara
card: card,cards
care: care
caress: caress,caressed,caressing
caricature: caricatures
carlo: carlo
carnage: carnage
carnival: carnival
carousal: carousals
carpenter: carpenter
carrara: carrara
carriage: carriages
carrier: carriers
carry: carried,carry,carrying
cartoon: cartoons
cast: cast,casting
castle: castle,castles
casually: casually
catastrophe: catastrophe
catch: catch,caught
catherine: catherine
cauldron: cauldron
cavalry: cavalry
caviare: caviare
cayenne: cayenne
cease: cease,ceased,ceasing
ceiling: ceilings
celebrate: celebrate,celebrating
cemetery: cemetery
cent: cent
centaur: centaurs
century: centuries,century
ceremony: ceremonies,ceremony
chain: chained
chair: chair
chaise: chaise
chamber: chamber
chance: chance
change: change,changed,changing
chaos: chaos
chap: chap
chapel: chapel
chaplain: chaplain
chapman: chapmen
chapter: chapter
character: character
characteristic: characteristics
charge: charge,charged,charges
charitable: charitable
charity: charities,charity
charles: charles
charm: charmed,charms
charming: charming
chase: chased
chat: chatted
che: che
cheap: cheap
cheat: cheat,cheats
check: check,checks
cheek: cheek,cheeks
cheer: cheer
chicken: chicken
chief: chief
chiefly: chiefly
child: child,children
chimerical: chimerical
chin: chin
china: china
chinese: chinese
chocolate: chocolate
choice: choice
choir: choir
choke: choking
choler: choler
choleric: choleric
choose: choose,chose
christ: christ
christen: christened
christian: christian,christians
christianity: christianity
christopher: christopher
chuck: chuck
church: church,churches
cicero: cicero
cinder: cinders
cinnamon: cinnamon
circumcision: circumcision
circumscribe: circumscribe
circumspection: circumspection
circumstance: circumstance,circumstances
citron: citrons
city: cities,city
civil: civil
civilised: civilised
civility: civilities
civilly: civilly
claim: claim
clasped: clasped
claw: claws
clay: clay
clean: cleaned
cleave: cleaves
clemency: clemency
clever: clever
cliff: cliffs
climate: climates
cling: cling
close: close,closed
closely: closely
cloth: cloth
clothes: clothes
cloud: clouds
clove: cloves
club: clubs
coach: coach
coarse: coarse
coast: coast,coasted,coasts
coat: coat
cochineal: cochineal
cocoa: cocoa
cocoanut: cocoanuts
code: codes
coffee: coffee
coin: coined,coins
cold: cold
collection: collection,collections
college: college
colonel: colonel
colonnade: colonnade
colony: colonies
colored: colored
colour: colour,colours
coloured: coloured
columbus: columbus
column: columns
combine: combined
comely: comely
comer: comers
comfort: comfort
comfortably: comfortably
comic: comic
command: command,commanded,commands
commandant: commandant
commence: commenced
commend: commended,commending
comment: commenting
commentary: commentary
commentator: commentator
commerce: commerce
commercial: commercial
commiseration: commiseration
commission: commission
commit: commit,committed
common: common
commonplace: commonplaces
communicate: communicated
communicative: communicative
companion: companions
company: company
comparison: comparison
compass: compasses
compassion: compassion
compel: compelled
compilation: compilation
complain: complain,complained
complaisant: complaisant
complete: complete
complexion: complexion
compliance: compliance
complicated: complicated
compliment: compliments
comply: comply,complying
compose: composed
compress: compressed
comrade: comrade,comrades
comte: comte
concatenate: concatenated
concatenation: concatenation
conceal: conceal,concealed
conceive: conceive,conceived
concept: concept
concerned: concerned
concert: concert
conciseness: conciseness
conclude: conclude,concluded
conclusion: conclusion
concord: concord
concrete: concrete
concussion: concussion
condemn: condemned
condescending: condescending
condition: condition
condor: condor
conduct: conduct,conducted
confess: confess,confessed
confessor: confessor
confidence: confidence
confine: confine,confined
confines: confines
confirm: confirm,confirmed
confirmation: confirmation
confound: confound
confused: confused
confusion: confusion
conquer: conquer
conqueror: conquerors
conscience: conscience
consent: consent
consequence: consequence,consequences
consequential: consequential
considerable: considerable
consideration: consideration
consistent: consistent
consolation: consolations
console: consoled,consoles,consoling
constant: constant
constantinople: constantinople
consternation: consternation
constitute: constitute,constituted
construct: construct
consult: consult,consulted
consume: consumed
consummate: consummate
contact: contact
contagion: contagion
contaminate: contaminates
contemplation: contemplation
contemporary: contemporaries
contempt: contempt
content: content
contents: contents
continent: continent
contingent: contingent
continual: continual
continually: continually
continue: continue,continued,continuing
continuous: continuous
contour: contour
contract: contract,contracting
contradiction: contradictions
contrary: contrary
contrast: contrast
contribution: contributions
contrive: contrive
contrived: contrived
control: control
controversy: controversy
convalescence: convalescence
convenience: convenience
convent: convent
conversation: conversation
converse: conversed
convert: convert,converted
convey: convey,conveyed,conveying
convict: convicted,convicting
convince: convince,convinced
convincing: convincing
convulsion: convulsions
cook: cook
cooking: cooking
cool: cool
coolly: coolly
coolness: coolness
copying: copying
copyright: copyright
coquetry: coquetries
cord: cord,cords
corner: corner
cornered: cornered
corporation: corporation
correct: corrected
correction: correction
corrector: corrector
corrupt: corrupt
corrupted: corrupted
corsair: corsair,corsairs
cost: cost,costs
couch: couched
cough: cough
counsel: counsel
counsellor: counsellor
count: counted
countenance: countenance
countess: countess
country: countries,country
courage: courage
courser: coursers
court: court,courts
courtesan: courtesans
cousin: cousins
cover: covered
covert: covert
cradle: cradle
crawl: crawled
create: created,creating
creation: creation
creature: creature,creatures
credit: credit
creditor: creditors
creep: creep
crew: crew
crime: crime,crimes
cringe: cringe
critic: critic,critics
critical: critical
criticise: criticising
criticism: criticism
crop: crops
cross: cross
crow: crows
crowd: crowd,crowds
crown: crown,crowns
crucial: crucial
crucifix: crucifix
cruel: cruel
cruelly: cruelly
cruelty: cruelties
crush: crushed
crust: crust
crystal: crystal
cudgel: cudgel
cultivate: cultivate,cultivated
cunning: cunning
curate: curate
cure: cure,cured
curiosity: curiosities,curiosity
curious: curious
curiously: curiously
current: current
curse: curse,cursed,cursing
cursed: cursed
curtain: curtain,curtains
cushion: cushions
custom: custom,customs
customary: customary
customer: customers
cut: cut
cyprus: cyprus
da: da
daily: daily
damage: damage
damaged: damaged
damages: damages
dame: dame
damp: damp
damsel: damsels
dance: dance
danger: danger
dangerous: dangerous
danube: danube
darius: darius
dark: dark
darken: darkened
dart: darted
darts: darts
dash: dash,dashed
datum: data
daughter: daughter,daughters
day: day,days
daylight: daylight
dead: dead
deal: deal,deals
dearly: dearly
death: death
debauchee: debauchees
decay: decayed
deceive: deceived
december: december
decently: decently
decide: decide,decided
decisive: decisive
deck: deck
declare: declare,declared
dedicate: dedicated
deductible: deductible
deem: deems
deep: deep
deeply: deeply
defect: defect,defects
defective: defective
defence: defence
defend: defend,defended
defender: defender
deform: deformed
deformation: deformation
deformity: deformity
degree: degree
deign: deign,deigning
deity: deity
delay: delay
deletion: deletions
delicacy: delicacy
delicious: delicious
delight: delight,delights
delighted: delighted
delightful: delightful
deliver: deliver,delivered,delivering
deliverance: deliverance
deliverer: deliverer
demand: demand
demolish: demolish,demolished
demon: demon
demoniac: demoniac
demonstrable: demonstrable
demonstrate: demonstrate,demonstrated
denounce: denounced
deny: denied
depart: depart
departure: departure
depend: depends
depravity: depravity
depredation: depredation
depressed: depressed
deprive: deprived,deprives
depute: deputed
derivative: derivative
derive: derive,derived
dervish: dervish
des: des
descend: descend,descends
description: description
descry: descried
desert: desert
deserve: deserve,deserved
design: design,designed
desirable: desirable
desire: desire,desired
desirous: desirous
despair: despair,despaired
despatch: despatched
desperate: desperate
desperately: desperately
despise: despise,despised
destiny: destiny
destitute: destitute
destroy: destroy,destroyed
destroyer: destroyer
destruction: destruction
destructive: destructive
det: detest
detach: detach
detain: detain
determinate: determinate
determine: determine,determined
detestable: detestable
dethrone: dethroned
deux: deux
deviate: deviate
devil: devil,devils
devotee: devotee,devotees
devour: devour,devoured,devours
dey: dey
diable: diable
diabolical: diabolical
dialogue: dialogue
diameter: diameter
diamond: diamond,diamonds
die: die,died,dying
difference: difference
difficult: difficult
difficulty: difficulty
digger: digger
dignity: dignities,dignity
dine: dine
dining: dining
dinner: dinner
direct: direct,directed
direction: direction,directions
director: director
dirt: dirt
dirty: dirtiest,dirty
disagreeable: disagreeable
disappear: disappeared
disarm: disarmed
disaster: disasters
disastrous: disastrous
disciple: disciple
discipline: disciplined
disclaim: disclaim
disclaimer: disclaimer,disclaimers
disconcerted: disconcerted
disconsolate: disconsolate
discontented: discontented
discontinue: discontinue
discord: discord
discourse: discourse
discover: discover,discovered
discretion: discretion
discuss: discussed,discusses
disdain: disdain
disease: disease
diseased: diseased
disembowel: disembowelled
disengage: disengaged
disfigure: disfigures
disfigured: disfigured
disgrace: disgrace
disgust: disgust,disgusts
disgusted: disgusted
dish: dish,dishes
disk: disk
dismal: dismal
dismayed: dismayed
dispense: dispensed
display: display,displayed,displaying
displease: displease
disposed: disposed
disposition: disposition
dispute: dispute,disputed,disputing
disrespectful: disrespectful
dissatisfied: dissatisfied
dissect: dissect,dissected,dissecting
dissertation: dissertations
dissipate: dissipated
dissolve: dissolve
distance: distance,distances
distaste: distaste
distemper: distemper
distinct: distinct
distinction: distinctions
distinguish: distinguished
distort: distorted
distract: distracted,distracting
distress: distress
distressed: distressed
distribute: distribute,distributed,distributing
distribution: distribution
distributor: distributor
diversion: diversions
divert: divert
divide: divided
divine: divine
divinity: divinity
docile: docile
doctor: doctor,doctors
doctrine: doctrine
document: document
dog: dog,dogs
doge: doge
domain: domain
domestic: domestic,domestics
dominican: dominican
dominion: dominions
domitian: domitian
donate: donate
donation: donation,donations
donor: donors
doom: doomed
door: door,doors
dorado: dorado
dormitory: dormitory
dost: dost
double: double,doubled
doubt: doubt,doubted,doubts
doubtless: doubtless
download: downloading
dozen: dozen
drag: drag,dragged
drama: dramas
dramatic: dramatic
drapery: draperies
draw: draw,drawn,drew
drawer: drawers
dreadful: dreadful
dream: dream,dreamed,dreaming,dreams
dress: dressed,dressing
drink: drank,drink
drive: driven,drove
droll: droll
drop: drop,dropped,dropping,drops
drown: drowned,drowning
drubbing: drubbing
drum: drums
drunk: drunk
drunkard: drunkards
dry: dry
du: du
duck: duck
dung: dung
dungeon: dungeon
dunghill: dunghill
durst: durst
dust: dust
dutch: dutch
duty: duty
dwell: dwell,dwelt
eager: eager
eagerness: eagerness
ear: ear,ears
eared: eared
earn: earn,earned,earning
earnestly: earnestly
earth: earth
earthquake: earthquake,earthquakes
ease: ease
easily: easily
easy: easy
eat: ate,eat,eaten,eating
ecclesiastical: ecclesiastical
eclipse: eclipsed
ecstasy: ecstasy
eden: eden
edge: edges
edifice: edifices
edition: edition,editions
editor: editor
educate: educated
education: education
educational: educational
edward: edward
effectual: effectual
effendis: effendis
effort: effort,efforts
effrontery: effrontery
egypt: egypt
eighteenth: eighteenth
eighth: eighth
el: el
ela: ela
elder: elder
elect: elect,elected
electronic: electronic
electronically: electronically
elegant: elegant
elizabeth: elizabeth
elope: elope
eloquence: eloquence
email: email
embark: embark,embarked
embarkation: embarkation
embrace: embrace,embraced,embracing
embroidery: embroidery
embrown: embrowned
emerald: emeralds
emergency: emergency
emollient: emollients
emotion: emotion
emperor: emperor
empire: empire
employ: employed
employee: employee,employees
employment: employment
enable: enabled
enclose: enclosing
encode: encoding
encompass: encompassed
encourage: encourage
encrust: encrusted
endnote: endnotes
endow: endowed
endure: endured
enemy: enemies,enemy
energetic: energetic
engage: engaged
engaging: engaging
engineer: engineers
england: england
english: english
englishman: englishman,englishmen
enjoy: enjoy,enjoyed
enmity: enmity
enormous: enormous
enrich: enriched
ensure: ensuring
enter: enter,entered
entertain: entertain,entertains
entertaining: entertaining
entertainment: entertainment,entertainments
entity: entity
entrap: entrapping
envious: envious
envy: envy
equal: equal,equalling
equally: equally
equipment: equipment
equivalent: equivalent
error: errors
escape: escape,escaped,escaping
essay: essaying
establish: established
estate: estate
esteem: esteem,esteemed
estimable: estimable
estimate: estimate
eternal: eternal
etiquette: etiquette
eunuch: eunuch,eunuchs
europe: europe
european: european,europeans
evening: evening
event: event,events
evident: evident
evidently: evidently
evil: evil,evils
examine: examine,examining
exceedingly: exceedingly
excellency: excellency
excellent: excellent
excess: excess
exclusion: exclusion
excommunicate: excommunicated
excuse: excuse
execrate: execrate
execute: executed,executing
execution: execution
executioner: executioner
executive: executive
exempt: exempt
exercise: exercise,exercises
exhausted: exhausted
exhort: exhorting
exile: exile,exiled,exiles
exist: existed,exists
existence: existence
exorcise: exorcise
expect: expect,expected
expedition: expedition
expel: expelled
expend: expend
expense: expense,expenses
experience: experience,experienced
experiment: experiments
experimental: experimental
explain: explain,explained
explanation: explanation
export: exporting
expose: expose,exposed
express: express,expressed
expression: expression
expulsion: expulsion
exquisite: exquisite
extensive: extensive
extent: extent
exterminate: exterminate
extort: extorted
extortion: extortions
extraordinary: extraordinary
extravagance: extravagances
extreme: extreme
extremely: extremely
extremity: extremities,extremity
eye: eye,eyes
eyebrow: eyebrow,eyebrows
eyed: eyed
eyelid: eyelids
eyewitness: eyewitness
fabulous: fabulous
facility: facility
faction: faction
fail: fail,failed,failing,fails
faint: fainted
fair: fair
fairbanks: fairbanks
faith: faith,faiths
faithful: faithful
faithfully: faithfully
fall: fall,fallen,falling,falls,fell
false: false
falter: faltering
familiar: familiar
family: families,family
famine: famine
famished: famished
famous: famous
fanatic: fanatic,fanatics
fancy: fancied,fancy
fare: fare,fared
farm: farm
faro: faro
farthing: farthing
fashion: fashion
fashionable: fashionable
fast: fast
fat: fat
fatal: fatal
fatality: fatality
fate: fate
father: father,fathers
fatigue: fatigue
fatigued: fatigued
faubourg: faubourg
fault: fault,faults
faun: fauns
favour: favour,favouring,favours
favourite: favourite
fawn: fawning
fear: fear,feared
feast: feast
feasting: feasting
feather: feathers
feature: features
federal: federal
fee: fee,fees
feeble: feeble
feed: fed
feel: feel
feeling: feelings
fellow: fellow,fellows
fernando: fernando
fetch: fetch,fetched
fetich: fetiches
fetter: fettered
fever: fever
fidelity: fidelity
field: field,fields
fife: fifes
fig: fig
fight: fight,fights,fought
figure: figure,figures
filbert: filbert
file: file,files
filth: filth
final: final
financial: financial
financier: financiers
fine: fine,finest,fining
finger: finger,fingers
finish: finish,finished
firearm: firearms
firm: firm
firmly: firmly
fit: fit,fits
fitness: fitness
fitting: fitting
flake: flakes
flame: flames
flat: flat
flatter: flattered
flavour: flavour
flee: fled,flee
fleet: fleet
fleetness: fleetness
flesh: flesh
flexible: flexible
flight: flight
fling: flung
flint: flint
floor: floor
florin: florins
flourish: flourish
flow: flowing
flower: flower
flowery: flowery
flurry: flurried
flutter: fluttered
fly: flew,fly,flying
foam: foamed
foible: foible
follow: follow
follower: followers
folly: follies,folly
fond: fond,fonder
food: food
fool: fools
foolish: foolish
foot: feet,foot
footing: footing
footman: footman
footnote: footnote,footnotes
force: force,forced
foreigner: foreigner,foreigners
foremost: foremost
foresee: foresaw
forget: forget,forgotten
forgiveness: forgiveness
form: form,formed
format: format,formats
fort: fort
fortune: fortune,fortunes
foundation: foundation
founder: foundered
fountain: fountain,fountains
fourteen: fourteen
fourth: fourth,fourths
fox: fox
fragrancy: fragrancy
franc: francs
france: france
freedom: freedom
freely: freely
freight: freight
french: french
frenchman: frenchman
frenchmen: frenchmen
frequently: frequently
fresh: fresh
fretful: fretful
freudian: freudian
friar: friar
friend: friend,friends
friendship: friendship
fright: fright
frightful: frightful
frightfully: frightfully
frontier: frontiers
froth: frothed
fruit: fruit,fruits
fun: fun
furnish: furnished
furrow: furrows
fury: fury
fusil: fusil
future: future
gabriel: gabriel
gaiety: gaiety
gaily: gaily
gain: gain,gained,gains
galilean: galilean
gallant: gallant
gallery: gallery
galley: galley,galleys
gallop: gallop
game: game
gaol: gaol
gape: gaped
garden: garden,gardens
gardener: gardener
garment: garment
garnish: garnished
garter: garter
gate: gate
gather: gather,gathered
gauntlet: gauntlet
gay: gay,gayest
gayer: gayer
geld: geld
genealogical: genealogical
genealogist: genealogist
genealogy: genealogy
generality: generality
generation: generation,generations
generosity: generosity
generous: generous
genesis: genesis
genius: genius
gentle: gentle
gentleman: gentleman,gentlemen
gentleness: gentleness
gentry: gentry
germain: germain
german: german,germans
germany: germany
gift: gift
gilded: gilded
girl: girl,girls
glad: glad
glance: glance
glass: glass
glister: glister
glitter: glittering
globe: globe
gloomy: gloomy
glory: glory
glutton: gluttons
goal: goals
goblet: goblets
god: god,gods
godmother: godmother
gold: gold
gondola: gondola
gondolier: gondolier,gondoliers
goodness: goodness
govern: govern,governed
government: government,governments
governor: governor
gown: gown
grace: grace,graces
graceful: graceful
gracious: gracious
grand: grand
grandeur: grandeur
grandfather: grandfather
grant: grant,granted
gratefully: gratefully
gratitude: gratitude
grave: grave
gravely: gravely
greatly: greatly
greek: greek,greeks
green: green
gregory: gregory
grey: grey
grief: grief,griefs
grieve: grieved
groom: grooms
gross: gross
ground: ground
grow: grew,grow,grown,grows
guard: guard,guarded,guards
guess: guessed
guest: guests
guide: guide
guinea: guinea
gulliver: gulliver
gun: gun
ha: ha
habit: habit,habited
habitable: habitable
hadst: hadst
hague: hague
hair: hair
hall: hall
ham: ham
hamlet: hamlet
hand: hand,hands
handkerchief: handkerchief
handsome: handsome
hang: hanged,hanging,hung
hanger: hanger
hannibal: hannibal
happen: happen,happened
happily: happily
happiness: happiness
happy: happier,happiest,happy
harangue: haranguing
harbour: harbour
hard: hard
hardship: hardship
harm: harm
harmless: harmless
harmony: harmony
harsh: harsh
hart: hart
hast: hast
hasty: hasty
hatchet: hatchets
hate: hate,hates
hatred: hatred
haul: hauled
hautboy: hautboys
hawk: hawks
head: head,heading,heads
headforemost: headforemost
headland: headlands
heal: healed
health: health
heap: heap,heaps
hear: hear,heard,hearing
hearing: hearing
hearse: hearse
heart: heart,hearts
heat: heat,heated
heaven: heaven,heavens
heavily: heavily
heavy: heavy
hebrew: hebrew
hedge: hedge
height: height
helen: helen
hem: hem
hemisphere: hemisphere
hen: hens
henry: henry
henrys: henrys
hereditary: hereditary
hereof: hereof
heretic: heretic
hero: hero,heroes
heroic: heroic
hesitate: hesitate
hew: hewn
hideous: hideous
highness: highness,highnesses
highroad: highroads
highway: highway
hill: hill
hilt: hilt
hinder: hinder,hinders
hire: hired,hiring
hireling: hirelings
hispaniola: hispaniola
hiss: hissed
history: history
hit: hit
hitherto: hitherto
hoist: hoist,hoisted
hold: held,hold,holding,holds
holder: holder
holland: holland
holy: holy
homage: homage
homer: homer
honest: honest
honor: honor
honour: honour,honoured,honours
hope: hope,hoped,hopes
horace: horace
horizon: horizons
horrible: horrible
horribly: horribly
horrid: horrid
horror: horror,horrors
horse: horse,horses
horseback: horseback
hospitable: hospitable
hospital: hospital
hostelry: hostelries
hostess: hostess
hot: hot
hotel: hotel
hound: hounds
hour: hour,hours
house: house,houses
hug: hugging
huge: huge
hum: humming
human: human
humane: humane
humanity: humanity
humble: humble
humbly: humbly
humour: humour,humours
hunger: hunger
hungry: hungry
huntsman: huntsmen
hurry: hurried
hurt: hurts
husband: husband,husbands
hyacinth: hyacinths
hyphenate: hyphenated
hypocrite: hypocrites
ichoglan: ichoglan
idea: idea,ideas
identification: identification
identify: identify
idiot: idiots
idle: idle
idolatry: idolatry
idyll: idylls
ignatius: ignatius
ignominious: ignominious
ignorance: ignorance
ignorant: ignorant
iii: iii
illness: illness
illusion: illusion
illustrious: illustrious
imaginable: imaginable
imagination: imagination
imagine: imagine,imagined,imagining
iman: iman
imbue: imbued
imitation: imitation
imitator: imitator
immemorial: immemorial
immense: immense
impale: impaled
impart: impart
impatient: impatient
imperfect: imperfect
imperious: imperious
impertinence: impertinence
impertinent: impertinent
imply: implied
impose: imposed
impossible: impossible
impressed: impressed
imprison: imprisoned
improve: improved
imprudently: imprudently
impudence: impudence
impulse: impulse
inaccessible: inaccessible
inaccurate: inaccurate
inappropriate: inappropriate
incas: incas
incense: incensed
incessantly: incessantly
inch: inches
incidental: incidental
incision: incision
incline: inclined
inclined: inclined
include: include,included,includes,including
including: including
incommode: incommoded
incompatibility: incompatibilities
incomplete: incomplete
inconceivable: inconceivable
increase: increase,increased,increasing
incur: incurred
indelicate: indelicate
indemnify: indemnify
indemnity: indemnity
indian: indians
indies: indies
indifference: indifference
indifferently: indifferently
indignation: indignation
indirect: indirect
indirectly: indirectly
indispensable: indispensable
individual: individual
induce: induced
inept: inept
inexpressible: inexpressible
infallible: infallible
infantry: infantry
infect: infected
infest: infested
infidelity: infidelity
infinitely: infinitely
infirm: infirm
inflexible: inflexible
inform: inform,informed
infringement: infringement
ingenious: ingenious
ingenuous: ingenuous
ingrate: ingrates
ingredient: ingredient
inhabit: inhabit,inhabited
inhabitant: inhabitants
inhuman: inhuman
inhumanity: inhumanity
injury: injuries
injustice: injustice
inn: inn,inns
innate: innate
innocence: innocence
innocent: innocent
innocently: innocently
inquietude: inquietude
inquire: inquire,inquired
inquisition: inquisition
inquisitive: inquisitive
inquisitor: inquisitor,inquisitors
inquisitors: inquisitors
insensibility: insensibility
insinuate: insinuate,insinuating
insipid: insipid
insist: insisted
insolence: insolence
insolent: insolent
inspiration: inspiration
inspire: inspire,inspired,inspires
instance: instance,instances
instant: instant
instantaneous: instantaneous
instantly: instantly
institution: institutions
instruct: instructed
instrument: instrument,instruments
insult: insults
intellectual: intellectual
intelligence: intelligence
intend: intended
inter: interred
interchangeably: interchangeably
interment: interment
internal: internal
international: international
interpret: interpreted
interpretation: interpretation
interpreter: interpreter
interrogate: interrogating
interrupt: interrupted
intersect: intersected
intimate: intimate,intimated
intimidate: intimidate,intimidated
intolerable: intolerable
intrepid: intrepid
introduce: introduce,introduced
introduction: introduction
inundate: inundated
invalidity: invalidity
inventiveness: inventiveness
inviolable: inviolable
invitation: invitation
invite: invite,invited
ionian: ionian
iron: irons
irony: irony
irs: irs
island: island,islands
iso: iso
israel: israel
israelite: israelite
issachar: issachar
issue: issued
italian: italian
italy: italy
iv: iv
ivan: ivan
ivory: ivory
ix: ix
jail: jail
james: james
jane: jane
janissary: janissary
jansenist: jansenist
japan: japan
japanese: japanese
jargon: jargon
jealous: jealous
jealousy: jealousies,jealousy
jean: jean
jehu: jehu
jeroboam: jeroboam
jest: jest
jesting: jesting
jesuit: jesuit,jesuits
jesuits: jesuits
jew: jew
jewel: jewels
jeweller: jeweller
jewish: jewish
jews: jews
joiner: joiner
joke: joke,joking
joseph: joseph
journal: journal,journals
journey: journey,journeying
joy: joy
judge: judge,judged,judges,judging
judgment: judgment
jump: jump
june: june
justice: justice
justly: justly
kick: kick,kicked,kicks
kill: kill,killed,killing
king: king,kings
kingdom: kingdom
kiss: kiss,kissed
knapsack: knapsack
knave: knave
knavery: knavery
knee: knees
kneel: kneel,kneeling
knight: knight
knights: knights
knock: knocked
labour: labour
lackey: lackey
laden: laden
lady: ladies,lady
lake: lake
lament: lamenting
lamentation: lamentations
land: land,landed
landlady: landlady
landlord: landlord
language: language
languish: languish
laputa: laputa
lard: larded
lash: lashes
late: late
latin: latin
latinus: latinus
laudable: laudable
laugh: laugh,laughed,laughing,laughs
laughter: laughter
lavinia: lavinia
lavish: lavish
law: law,laws
lawsuit: lawsuits
lawyer: lawyer
lay: laid,lay,laying
le: le
lead: lead,leads,led
leaf: leaf
league: league,leagues
lean: leaned
learn: learn,learned,learnt
learning: learning
leave: leave,leaving,left
left: left
leg: leg,legs
legal: legal
legally: legally
legend: legend
leipzig: leipzig
lemon: lemons
leopold: leopold
lesson: lesson,lessons
lethargic: lethargic
letter: letter,letters
letting: letting
levantine: levantine
levy: levies
leyden: leyden
liability: liability
liable: liable
liar: liars
liberty: liberty
library: library
license: license
licensed: licensed
lick: lick
lie: lie,lied,lies
lieu: lieu
lieutenancy: lieutenancy
lieutenant: lieutenant
life: life,lives
lifetime: lifetime
lift: lifted
light: light,lighting
lightly: lightly
lightness: lightness
likeness: likeness
liking: liking
lima: lima
limb: limbs
limit: limited
limitation: limitation
limited: limited
linen: linen
link: linked,links
lion: lions
lip: lips
liqueur: liqueurs
liquor: liquors
lisbon: lisbon
list: list
listen: listened,listening
literary: literary
literature: literature
live: live,lived,lives,living
livelihood: livelihood
lively: lively
living: living
livre: livres
llama: llama
locate: located
location: locations
lodge: lodged
loftily: loftily
lofty: lofty
lombard: lombard
london: london
lonely: lonely
loose: loose
lord: lord,lords
lose: lose,losing,lost
loss: loss
lot: lot
loud: loud
loudly: loudly
louis: louis
love: love,loved,loves,loving
lover: lover,lovers
lovingly: lovingly
lucifer: lucifer
lucky: lucky
lull: lull
lurk: lurking
lust: lust
lustre: lustre
lynx: lynx
lyric: lyric
macaroni: macaroni
machine: machine
mad: mad
madam: madam
madame: madame
mademoiselle: mademoiselle
madhouse: madhouse
madness: madness
madrid: madrid
magistrate: magistrate
magnificence: magnificence
magnificent: magnificent
magnificently: magnificently
mahmoud: mahmoud
mahomet: mahomet
maid: maid,maids
mail: mail
main: main
maintain: maintain,maintained,maintaining
maize: maize
majestic: majestic
majesty: majesties,majesty
malice: malice
malicious: malicious
malignancy: malignancy
malignant: malignant
malta: malta
manes: manes
mangled: mangled
mania: mania
mankind: mankind
manner: manner
manners: manners
manufacture: manufacture
marble: marble
march: march,marched,marching
marchioness: marchioness
mark: mark,marked,marks
market: market
marriage: marriage
marry: married,marry,marrying
marseilles: marseilles
martin: martin
marvellous: marvellous
marvellously: marvellously
mary: mary
masquerade: masquerade
mass: mass
massa: massa
massacre: massacre,massacred
mast: mast,masts
master: master
masterpiece: masterpiece
matapan: matapan
match: match,matched
materia: materia
material: materials
mathematician: mathematicians
mathematics: mathematics
matter: matter,matters
max: max
maxim: maxims
maximum: maximum
mead: mead
meadow: meadow
meanness: meanness
medal: medals
meddle: meddle
medici: medici
mediterranean: mediterranean
medium: medium
meekness: meekness
meet: meet,meets,met
melancholy: melancholy
memoirs: memoirs
memorial: memorial
memory: memory
mention: mention,mentioned,mentioning
mercantile: mercantile
merchant: merchant
mercy: mercy
merit: merit
messiah: messiah
metaphysician: metaphysician,metaphysicians
metaphysics: metaphysics
method: method,methods
michael: michael
middle: middle
midnight: midnight
midst: midst
mile: mile,miles
militarism: militarism
military: military
milk: milk
milo: milo
milton: milton
mind: mind,minds
minded: minded
minister: minister
minute: minute,minutes
miracle: miracle
miscellaneous: miscellaneous
miser: misers
miserable: miserable
miserably: miserably
miserere: miserere
misery: miseries,misery
misfortune: misfortune,misfortunes
misgivings: misgivings
mislead: misleading
misplace: misplaced
mission: mission
mississippi: mississippi
mist: mists
mistake: mistake
mistaken: mistaken
mistress: mistress
mitre: mitre,mitres
mixture: mixtures
mocha: mocha
mock: mocked
mockery: mockery
mockingly: mockingly
modern: modern,moderns
moderns: moderns
modest: modest
modestly: modestly
modesty: modesty
modification: modification
modify: modified
mogul: mogul
moiety: moiety
moisten: moistened
molinist: molinist
moment: moment,moments
monarch: monarch,monarchs
monastery: monastery
monday: monday
money: money
mongrel: mongrel
monk: monk,monks
monkey: monkeys
monkeys: monkeys
monotony: monotony
monsieur: monsieur
monster: monster,monsters
montepulciano: montepulciano
month: month,months
monument: monument
moor: moor
moorish: moorish
moral: moral,morals
morass: morass
morena: morena
morning: morning
morocco: morocco
morrow: morrow
mortal: mortal,mortals
mortis: mortis
moscow: moscow
moses: moses
mosque: mosque
moss: moss
mother: mother,mothers
motive: motive
mots: mots
mount: mount
mountain: mountains
mournful: mournful
mouse: mice
mouth: mouth
mufti: mufti
mulatto: mulattoes
muley: muley
multitude: multitude
murder: murder
murderer: murderers
muscle: muscles
muse: musing
music: music
musician: musician,musicians
musket: muskets
musketeer: musketeers
mussulman: mussulman
muster: mustering
mynheer: mynheer
nail: nails
naked: naked
nape: nape
naples: naples
narrative: narrative
nation: nation,nations
native: native
natural: natural
naturally: naturally
nature: nature
natured: natured
navel: navel
neapolitan: neapolitan
neat: neat,neatest
neatly: neatly
necessity: necessity
neck: neck
negligence: negligence
negro: negro,negroes
neighborhood: neighborhood
neighbour: neighbour,neighbouring
neighbourhood: neighbourhood
nephew: nephew
nerve: nerves
network: network
newcomer: newcomers
news: news
newsletter: newsletter
niche: niche
nicholas: nicholas
night: night
nineteenth: nineteenth
nobility: nobility
noble: noble,nobler
nobleman: nobleman
nobly: nobly
nod: nod
noise: noise
nonproprietary: nonproprietary
nonsense: nonsense
norman: norman
normandy: normandy
north: north
northern: northern
nose: nose,noses
notable: notable
note: note,notes
notice: notice,noticed
notify: notified,notifies
notion: notion
notoriously: notoriously
notre: notre
nourish: nourish
nouvelle: nouvelle
november: november
novice: novice
numerous: numerous
nuptials: nuptials
nurse: nursed
nut: nuts
oar: oar,oars
oarsman: oarsmen
oath: oath
oats: oats
obeisance: obeisance
obey: obeyed
object: object,objects
objection: objections
obligation: obligations
oblige: obliged,obliging
obscure: obscure
observe: observe,observed,observing
obsolete: obsolete
obstruct: obstructed
obvious: obvious
occasion: occasion,occasioned
occupation: occupation
occupy: occupied
occur: occur,occurs
odd: odd
odour: odour
offer: offer,offered,offers
office: office,offices
officer: officer,officers
official: official
officious: officious
oil: oil
ointment: ointment
online: online
opera: opera,operas
operation: operation
opinion: opinion
opportunity: opportunities,opportunity
oppose: oppose,opposed
oppress: oppressed
optimism: optimism
optimist: optimists
oracle: oracle
orange: orange,oranges
orator: orator
ordain: ordained
organize: organized
origin: origin
original: original
originally: originally
originator: originator
ornament: ornament,ornamented
outcry: outcries
outdated: outdated
outskirts: outskirts
overboard: overboard
overpower: overpowered
overspread: overspread
overtake: overtake,overtaken
overwhelm: overwhelmed
overwhelmed: overwhelmed
owe: owed
owner: owner
pace: paces
pacifism: pacifism
pack: pack
pain: pain
pained: pained
paint: paint,painted
painter: painter
pair: pair
palace: palace
pale: paled
pallor: pallor
palpitate: palpitating
paltry: paltry
palus: palus
pamphlet: pamphlets
pamphleteer: pamphleteer
pangloss: pangloss
paper: paper
paperwork: paperwork
parade: parade
paradise: paradise
paragraph: paragraph,paragraphs
paraguay: paraguay
paraguayan: paraguayan,paraguayans
pardon: pardon
parent: parents
parenthetically: parenthetically
paris: paris
parisian: parisian
park: park
parliament: parliament
parody: parody
parricide: parricide
parrot: parrots
parson: parson
particulars: particulars
partridge: partridges
party: party
pashas: pashas
pass: pass,passed,passing
passable: passable
passage: passage,passages
passenger: passenger,passengers
passion: passion,passions
pastry: pastries,pastry
paternoster: paternosters
pathetic: pathetic
patient: patient
patiently: patiently
pave: paved
pavement: pavements
pay: paid,pay,paying
payable: payable
payment: payment,payments
peace: peace
pearl: pearl
pebble: pebbles
pedlar: pedlar
peel: peel
peevish: peevish
pen: pen,pens
penetrate: penetrated
pensive: pensive
perceive: perceive,perceived,perceiving
perfect: perfect
perfectly: perfectly
perform: perform,performed,performing
performance: performance,performances
perfumed: perfumed
perigord: perigord
perilous: perilous
period: period
periodic: periodic
periodical: periodical
perish: perish,perished
perishable: perishable
permanent: permanent
permission: permission
permit: permit,permits,permitted,permitting
perpetually: perpetually
persecute: persecuted
perseus: perseus
persian: persian,persians
person: people,person,persons
personage: personage
personality: personality
persuade: persuaded
peru: peru
peruvian: peruvian
pest: pest
pestilence: pestilence
peter: peter
petit: petit
petrified: petrified
petticoat: petticoat
phenomenon: phenomenon
philip: philip
philosopher: philosopher,philosophers
philosophic: philosophic
philosophical: philosophical
philosophise: philosophising
philosophy: philosophy
phrase: phrase
physic: physic
physical: physical
physician: physicians
physics: physics
piastre: piastres
piazza: piazza
pick: pick,picked,picking
pickpocket: pickpockets
picture: picture,pictures
piece: piece,pieces
pierce: pierced
pig: pig
pigeon: pigeons
pigmy: pigmy
pigs: pigs
pike: pike
pillage: pillage
pin: pins
pinch: pinched
pine: pine
pious: pious
pipe: pipes
pique: pique,piqued
pirate: pirate,pirates
piratical: piratical
pistachio: pistachio
pistole: pistoles
pity: pitied,pity,pitying
pizzle: pizzle
plagiarize: plagiarizing
plague: plague
plain: plain
plainly: plainly
plank: plank
plant: planted
plaster: plaster
plastic: plastic
plato: plato
play: play,played,playing,plays
player: player
plaything: playthings
plead: pleads
pleasant: pleasant
pleasantry: pleasantries
pleased: pleased
pleasure: pleasure,pleasures
plentiful: plentiful
plenum: plenum
plight: plight
plot: plot
pluck: plucked
plump: plump
plunder: plunder
plunge: plunge,plunged
ply: ply
pocket: pocket
pococurante: pococurante
poem: poem
poet: poet,poets
pointedly: pointedly
poisonous: poisonous
poke: poking
poland: poland
pole: pole
polite: polite,politest
politely: politely
politeness: politeness
political: political
politics: politics
pomatum: pomatum
pomp: pomp
pompey: pompey
poniard: poniard
poor: poor
pope: pope
pork: pork
port: port
portal: portal
porte: porte
porto: porto
portrait: portrait
portugal: portugal
portuguese: portuguese
positive: positive
possess: possess,possessed,possesses,possessing
possession: possession
possibility: possibility
post: posted
posterior: posteriors
posthumous: posthumous
pot: pot
pound: pounds
pounder: pounders
pour: pour,poured
poverty: poverty
power: power
powerful: powerful
practically: practically
practice: practice
pragmatist: pragmatist
praise: praise,praised
pray: pray,prayed
prayer: prayers
preach: preached
preacher: preacher,preachers
preceptor: preceptor
precious: precious
precipice: precipices
precipitate: precipitated
precipitately: precipitately
predecessor: predecessors
prefer: prefer
preferable: preferable
preference: preference
prelate: prelate
prepare: prepare,prepared,preparing
presence: presence
presentation: presentation
preserve: preserve,preserved,preserves
preserver: preserver
press: press,pressed
presume: presume
presumptuous: presumptuous
pretend: pretend,pretended,pretending
pretender: pretender
pretty: prettier,pretty
prevail: prevail,prevailed
prevent: prevent,prevented
previous: previous
price: price,prices
pride: pride,prides
priest: priest,priests
prince: prince,princes
princess: princess
principal: principal
principle: principles
print: print,printed
prior: prior
priori: priori
prison: prison,prisons
prisoner: prisoner,prisoners
private: private
privilege: privilege
prize: prize
probable: probable
procedure: procedure
proceed: proceed
processing: processing
procession: procession
proclaim: proclaiming
procure: procure
prodigally: prodigally
prodigious: prodigious
prodigiously: prodigiously
prodigy: prodigy
produce: produce,produced,produces,producing
production: production
productive: productive
profession: profession
professor: professor
profit: profit,profited,profits
profound: profound,profoundest
profoundly: profoundly
progress: progress
prohibition: prohibition
project: project
prominently: prominently
promise: promise,promised,promising
promote: promoting
promotion: promotion
pronounce: pronounced
proof: proof
proofread: proofread
proofreading: proofreading
propagandist: propagandist
proper: proper
properly: properly
property: property
propontis: propontis
proposal: proposal,proposals
propose: proposed
proprietary: proprietary
prose: prose
prosecute: prosecuted
prospect: prospect
prostrate: prostrating
protect: protect
protection: protection
protest: protesting
prove: prove,proved,proving
provide: provide,providing
providence: providence
province: province,provinces
provincial: provincial
provision: provision,provisions
provoke: provoke
prudence: prudence
prudent: prudent
public: public
publication: publication
publicly: publicly
publish: published
publisher: publishers
publishers: publishers
publishing: publishing
pull: pulled,pulling
punish: punished,punishing
punishment: punishment
punitive: punitive
punt: punting
punter: punters
pupil: pupil,pupils
purchase: purchase,purchased
pure: pure,purest
purity: purity
purl: purling
purpose: purpose
pursue: pursuing
pursuit: pursuit
push: push
puzzle: puzzle,puzzled
pyrrhus: pyrrhus
quaking: quaking
quality: quality
quarrel: quarrel,quarrelled,quarrels
quarter: quarter,quartered,quarters
quartering: quarterings
quaver: quavering
queen: queen,queens
queens: queens
question: question,questions
qui: qui
quick: quick,quicker
quit: quit,quitted
quoit: quoits
rabble: rabble
rage: rage,raging
ragout: ragouts
rain: rained
raise: raised,raises,raising
raker: rakers
ramble: rambling
rammer: rammer
rank: rank,ranks
ransom: ransom,ransomed
ranunculus: ranunculus
rapaciousness: rapaciousness
rape: rape
raphael: raphael
rapid: rapid
rapidity: rapidity
rapier: rapier
rapture: raptures
rare: rare
rarity: rarity
rascal: rascal
rashly: rashly
rational: rational
ravings: ravings
ravish: ravish,ravished,ravishing
reach: reach,reached,reaching
read: read,reading
readable: readable
reader: reader,readers
reading: reading
ready: ready
real: real
realise: realise
reap: reap
reason: reason,reasoned,reasons
reasonable: reasonable
reasoning: reasoning,reasonings
recall: recalled
receipt: receipt
receive: receive,received,receiving
reception: reception
reckon: reckon,reckoned
reckoning: reckoning
recoil: recoiled
recollect: recollecting
recommend: recommend
reconcile: reconciled
record: record
recount: recounting
recover: recover,recovered,recovering
recovery: recovery
recreation: recreation
red: red
redden: reddened
reddish: reddish
redemption: redemption
redistribute: redistribute,redistributing
redistributing: redistributing
redistribution: redistribution
redouble: redoubled
reduce: reduced
reek: reeking
refasten: refastened
refer: referred
reference: reference,references
reflect: reflect,reflected
reflection: reflections
refrain: refrain
refresh: refreshed
refreshment: refreshment,refreshments
refund: refund
refuse: refuse,refused
regain: regained
regard: regard,regarded
regiment: regiment
regimented: regimented
register: registered
regret: regretted
regular: regular
regulate: regulating
reign: reigned
reject: reject,rejecting
rejection: rejection
rejoice: rejoiced
relate: relate,relating
relation: relations
relative: relatives
release: release
relief: relief
relieve: relieving
religion: religion,religions
religious: religious
relinquish: relinquish
remain: remain,remained,remaining,remains
remark: remarking,remarks
remedy: remedies,remedy
remember: remember,remembering,remembers
remind: remind,reminded
remorse: remorse
remove: remove,removed
rename: renamed
rend: rending
render: render
rendezvous: rendezvous
renegade: renegades
renounce: renounce,renounced
rent: rent
reopen: reopened
repair: repair,repaired
repast: repast
repeat: repeat,repeated,repeats
repel: repel
repentance: repentance
repetition: repetition
replace: replace
replacement: replacement
reply: replied
report: report,reported,reports
repose: repose
represent: represent,represented,representing,represents
representation: representations
representative: representative
reprint: reprint
reproach: reproached
republican: republican
republish: republish
reputation: reputation
request: request
require: require,required
requirement: requirements
rescue: rescued
resemblance: resemblance
resemble: resemble,resembled
reside: resides
resign: resign,resigned
resist: resisted
resolution: resolution
resolve: resolve,resolved
resource: resources
respect: respect,respects
respectful: respectful
respectfully: respectfully
respond: responded
rest: rest
restriction: restrictions
resume: resumed,resuming
retain: retained
retaliate: retaliated
retire: retired
retract: retract
return: return,returned,returning,returns
reveal: reveals
revenge: revenge,revenged
revenue: revenue
reverence: reverence
reverend: reverend
reverse: reverse,reversed
review: review
revolt: revolt
revolution: revolutions
rhymed: rhymed
rhythm: rhythm
ribbon: ribbons
rich: rich,richer,richest
richard: richard
riches: riches
richly: richly
ride: ride,riding
ridicule: ridicule
ridiculous: ridiculous
ridiculously: ridiculously
riga: riga
rill: rills
rip: rip,ripped
rise: rise,rose
rite: rites
rival: rival
river: river,rivers
rivulet: rivulet,rivulets
road: road,roads
roast: roast
roasted: roasted
rob: rob,robbed
robber: robber,robbers
robe: robe,robes
rock: rock,rocks
rogue: rogue
roguish: roguish
roll: rolled
rolling: rolling
romance: romance,romances
rome: rome
roof: roofs
rook: rooks
rose: roses
rot: rot,rotting
rotterdam: rotterdam
rough: rough
roughly: roughly
rounded: rounded
rouse: roused
rousseau: rousseau
route: route
rove: roving
row: row,rowed
rowing: rowing
royal: royal
royalty: royalties,royalty
rub: rubbed
rubbish: rubbish
ruby: rubies
rue: rue
ruffian: ruffians
rugged: rugged
ruin: ruin,ruins
rule: rules
ruminant: ruminant
rummage: rummaged
rump: rump
russia: russia
russian: russians
rusty: rusty
sabbath: sabbath
sacrament: sacrament
sacristan: sacristan
sad: sad
sadden: saddened
saddle: saddled,saddles
sadly: sadly
safely: safely
safety: safety
sage: sage,sages
sail: sail,sailed,sailing
sailor: sailor,sailors
sake: sake
sale: sale
sallee: sallee
salt: salt
salute: saluted
san: san
sanction: sanction
sand: sand
sarmatian: sarmatian
satiated: satiated
satire: satire
satirical: satirical
satirist: satirist
satisfied: satisfied
satisfy: satisfied
saturday: saturday
satyrs: satyrs
savage: savages
savages: savages
save: save,saved,saving
saviour: saviour
scab: scabs
scale: scales
scandal: scandal
scandalous: scandalous
scarce: scarce
scarcely: scarcely
scarp: scarped
scatter: scattered
scene: scene,scenes
scholar: scholar
school: school
schoolmaster: schoolmaster
science: sciences
sciences: sciences
scimitar: scimitar
scintillation: scintillation
score: score
scoundrel: scoundrel,scoundrels
scour: scour,scours
scourge: scourge
scrape: scrape,scrapes
scratch: scratched
scream: scream,screamed
screen: screen
scribble: scribbling
scribe: scribe
scruple: scruple
scullion: scullion
sea: sea,seas
seaman: seaman
search: search
seat: seat,seated
secret: secret
secretary: secretaries
secure: secure,secured
seduce: seduce,seduced
seek: seek,seeks
seize: seized,seizes
select: selecting
sell: sell,sold
selling: selling
senator: senator
send: send,sending,sends
seneca: seneca
senor: senor
sense: sense
sensibility: sensibility
sentence: sentence
sentry: sentry
senza: senza
separate: separate
separation: separation
sepulture: sepulture
sequence: sequence
sequin: sequins
seraglio: seraglio
serene: serene
sergeant: sergeant
series: series
sermon: sermon,sermons
serpent: serpent,serpents
servant: servant,servants
serve: serve,served,serves,serving
service: service,services
servitude: servitude
set: set,setting
settle: settled
seventeen: seventeen
severe: severe
severely: severely
sew: sewed
sex: sex,sexes
shadow: shadows
shalt: shalt
shape: shape,shaped
share: share,shared,sharing
sheep: sheep
sheet: sheets
shelf: shelves
shelter: shelter,sheltered
sherbet: sherbet
shift: shift
shine: shines,shining
ship: ship,ships
shipwreck: shipwreck
shirt: shirts
shock: shocks
shocked: shocked
shocking: shocking
shoot: shoot,shot
shop: shop
shore: shore,shores
short: short,shorter,shortest
shot: shot
shoulder: shoulders
shout: shouted
shrewd: shrewd
shrewdly: shrewdly
shriek: shrieked
shudder: shuddered
shut: shut
siamese: siamese
sick: sick
siege: siege,sieges
sierra: sierra
sieur: sieur
sigh: sighed,sighs
sight: sight,sights
sign: signs
signalling: signalling
signify: signifies,signify,signifying
signor: signor
silence: silence
silhouette: silhouettes
silly: silly
silver: silver
simple: simple
simplicity: simplicity
sin: sin
sing: sang,sing,singing,sung
singer: singer
singing: singing
single: single
singular: singular
sink: sank,sinking
sir: sir
sire: sire
sister: sister
sit: sat,sit,sitting
situate: situated
situation: situation,situations
sixteen: sixteen
sixth: sixth
skin: skin
skipper: skipper
sky: sky
slander: slander
slash: slashed
slaughter: slaughter,slaughtered
slave: slave,slaves
slavery: slavery
slay: slain,slay
slaying: slaying
sleep: sleep,slept
sleeve: sleeve
slew: slew
slight: slight
slip: slip
slow: slow
smell: smelling
smile: smile,smiled,smiling
smooth: smooth
smyrna: smyrna
snake: snakes
snatch: snatches
snow: snow
snuff: snuff
sob: sobbing
sober: sober
sociable: sociable
social: social
society: society
socinian: socinian
sofa: sofa
soft: soft
softly: softly
soldier: soldier,soldiers
sole: soles
solemn: solemn
solicit: solicit
solicitation: solicitation
solid: solid
son: son,sons
song: songs
sonnet: sonnets
soot: soot
soporific: soporific
sorcerer: sorcerers
sore: sores
sorrow: sorrow,sorrows
sorrowfully: sorrowfully
sort: sort,sorts
soul: soul,souls
sound: sound,sounds
soup: soup
source: source
south: south
sovereign: sovereign,sovereigns
spain: spain
spaniard: spaniard
spaniards: spaniards
spanish: spanish
spare: spared
sparkle: sparkled,sparkling
sparkling: sparkling
speak: speak,speaking,spoke,spoken
speaker: speaker
speaking: speaking
special: special
specie: specie
species: species
specific: specific
spectacle: spectacle
spectacles: spectacles
spectator: spectator
spectre: spectre
speech: speech
speed: speed
spelling: spellings
spelt: spelt
spend: spend,spending,spends,spent
spin: spin
spirit: spirit,spirits
spit: spit,spits,spitted,spitting
spite: spite
splendid: splendid
spoil: spoiled,spoils
spoke: spoke
spontoon: spontoon
spot: spot
sprawl: sprawling
spread: spread
spring: spring,sprung
sprinkle: sprinkled
spruce: spruce
spur: spurs
spy: spying
squander: squandered
square: square,squares
stab: stab,stabbed
stable: stable,stables
staff: staff
stage: stage
stagger: stagger
staircase: staircase
stake: stake,stakes
stalk: stalked
stand: stand,stood
star: stars
stare: stared
stark: stark
stars: stars
start: start,started,starting
starve: starve,starving
stateliness: stateliness
statement: statements
statue: statues
status: status
stay: stay,stayed
steal: steals,stole,stolen
stealthy: stealthier
steep: steep
step: step,stepped
sterling: sterling
stick: stuck
stir: stirred
stock: stock
stocking: stockings
stomach: stomach,stomachs
stone: stone,stones
stones: stones
store: stored,stores
storm: storm
story: stories,story
straight: straight
straightway: straightway
straits: straits
strange: strange
stranger: stranger,strangers
strangle: strangled
straw: straw
stray: strayed
stream: stream
street: street,streets
strength: strength
strengthen: strengthened
stretch: stretch,stretched
strew: strewed
strict: strict
strike: struck
strip: stripped
stroke: strokes
strong: strong
structure: structure
struggle: struggled
strut: strutting
stuart: stuart
study: study
stuff: stuffed,stuffs
stupefied: stupefied
stupidity: stupidity
style: style
subject: subject,subjects
sublime: sublime
subordinate: subordinate
subscribe: subscribe
subsequently: subsequently
subservient: subservient
subsist: subsisted
substance: substance
substitute: substituted
subtilis: subtilis
suburb: suburb
succeed: succeeded,succeeds
success: success
successive: successive
succour: succoured
suddenly: suddenly
suffer: suffer,suffered
sufficient: sufficient
sugar: sugar
suit: suit
sulphur: sulphur
sultan: sultan
summer: summer
summit: summit
sun: sun
sunday: sunday
superior: superior
superiority: superiority
supper: supper,suppers
supplant: supplanted
supply: supplies,supply
support: support,supported,supporting
suppose: supposed
sur: sur
surely: surely
surface: surface
surgeon: surgeon,surgeons
surinam: surinam
surpass: surpassed
surprise: surprise,surprised
surprised: surprised
surprising: surprising
surrender: surrender
surround: surround,surrounded
survey: survey
survive: survive
suspect: suspected
suspend: suspend
suspicion: suspicion
sustain: sustained
swallow: swallowed
swam: swam
swamp: swamp
swear: swear,swearing,swore,sworn
sweat: sweated
swede: swede
sweep: swept
sweet: sweet
sweetheart: sweethearts
swell: swelled
swift: swift
swim: swimming
swoon: swooning
swoop: swooped
sword: sword
sympathise: sympathised
sympathy: sympathy
synonymous: synonymous
syracuse: syracuse
table: table
tack: tacked
tail: tails
tale: tale,tales
talent: talent
talk: talk,talking
tall: tall
tapestry: tapestry
tartars: tartars
taste: taste,tasted
tattered: tattered
tawny: tawnies
tax: tax,taxes
te: te
teach: taught,teach,teaches
teaching: teaching
team: team
tear: tear,tears,torn
temp: temps
tempered: tempered
tempest: tempest
tempt: tempted
temptation: temptations
tender: tender,tenderest
tenderly: tenderly
term: terms
terrestrial: terrestrial
terrible: terrible
terrified: terrified
territory: territories
terror: terrors
testimony: testimony
thanksgiving: thanksgiving
theatre: theatre
thee: thee
theodore: theodore
theology: theology
thief: thieves
thither: thither
thomas: thomas
thousandth: thousandth
thread: thread
threaten: threatened
throat: throat
throne: throne
throw: threw,throw,throwing,thrown,throws
thrust: thrust
thunder: thunder
thunderclap: thunderclap
thy: thy
tie: tied
tiger: tigers
time: time,times
timid: timid
tired: tired
tiresome: tiresome
title: title,titles
toad: toad
toil: toiled
tolerable: tolerable
tone: tone
tongue: tongue,tongues
tooth: teeth,tooth
torment: tormented,torments
total: total
touch: touch,touched,touching
tour: tour
towel: towels
town: town
trace: traced
track: track
tractable: tractable
trade: trade,traded,trading
trademark: trademark
tragedy: tragedies,tragedy
train: train
traitor: traitors
trample: trample,trampled
transact: transacted,transacting
transcribe: transcribe
transcriber: transcriber
transcription: transcription
transform: transforms
translate: translated
translator: translator
transport: transport,transported,transports
transylvanian: transylvanian
travel: travel,travelled,travelling
traveller: travellers
travellers: travellers
travels: travels
traverse: traverse,traversed
treasure: treasure
treat: treat,treated
treatise: treatise
treatment: treatment
treaty: treaty
tree: tree,trees
trellis: trellises
tremble: tremble,trembled,trembling
trial: trials
tribe: tribe,tribes
trick: trick
trifle: trifle
trifling: trifling
trinity: trinity
trip: tripped
tripoli: tripoli
triumph: triumph
troops: troops
trouble: trouble,troubles
troublesome: troublesome
troy: troy
truant: truants
true: true
trumpet: trumpets
trust: trust
truth: truth
truthfully: truthfully
tuck: tucked
tucuman: tucuman
tug: tugging
tulip: tulips
tumble: tumbled
tunis: tunis
turk: turk
turkey: turkey
turkish: turkish
turks: turks
twentieth: twentieth
twinkling: twinkling
type: types
typographical: typographical
tyranny: tyranny
tyrant: tyrant
tyrolese: tyrolese
ugly: uglier,ugliest,ugly
unadulterated: unadulterated
unavoidable: unavoidable
uncivil: uncivil
unconcerned: unconcerned
uncover: uncovered
undergo: undergone,underwent
understand: understand,understands,understood
understanding: understanding
undertake: undertake
undress: undress,undressing
uneasiness: uneasiness
unenforceability: unenforceability
unfaithful: unfaithful
unfamiliar: unfamiliar
unfeathered: unfeathered
unfortunate: unfortunate
ungrateful: ungrateful
unhappy: unhappiest,unhappy
unhesitatingly: unhesitatingly
uniform: uniform
uninteresting: uninteresting
unitarian: unitarians
united: united
universal: universal
universe: universe
university: university
unjust: unjust
unknown: unknown
unlink: unlink
unluckily: unluckily
unmercifully: unmercifully
unmistakable: unmistakable
unnecessary: unnecessary
unpitying: unpitying
unsolicited: unsolicited
unsupportable: unsupportable
untie: untied
update: updated
upright: upright
urban: urban
usage: usages
useless: useless
user: user
usual: usual
ut: ut
utmost: utmost
utrecht: utrecht
utter: utter,uttered
vaguely: vaguely
vainly: vainly
valet: valet,valets
valuable: valuable
vanilla: vanilla
vanity: vanity
variety: variety
vast: vast
vastly: vastly
vault: vaulted
vegetable: vegetables
vehemence: vehemence
veil: veil
vein: veins
venereal: venereal
venetian: venetian
venice: venice
venture: venture,ventured
venus: venus
verily: verily
vermilion: vermilion
verse: verse,verses
version: version,versions
vessel: vessel,vessels
vex: vexed
vexation: vexation
vicarious: vicarious
vice: vice
vicissitude: vicissitudes
victim: victim,victims
victorious: victorious
victory: victory
vie: vie
view: viewed,viewing
vigorous: vigorous
vii: vii
viii: viii
village: village
villain: villain
villainy: villainy
vinegar: vinegar
vineyard: vineyard
violate: violated,violates,violating
violence: violence
violent: violent
virgil: virgil
virgin: virgin
virtue: virtue
virtuoso: virtuoso
virus: virus
visibly: visibly
visit: visit
vitriol: vitriol
vivacity: vivacity
vizier: vizier,viziers
voice: voice
void: void
volcano: volcano
voltaire: voltaire
volume: volumes
voluntarily: voluntarily
voluntary: voluntary
volunteer: volunteer,volunteers
vow: vow
voyage: voyage,voyages
vulture: vulture
wager: wager
wages: wages
waggoner: waggoners
wait: wait,waited,waiting
waiter: waiters
walk: walk,walked,walking,walks
wall: walls
wallet: wallet
walter: walter
wander: wander
wanderer: wanderers
war: war,wars
warm: warm,warmed
warranty: warranties,warranty
wary: wary
wash: wash,washed,washes,washing
watch: watch,watched,watching
water: water
wax: waxed
weak: weak
weakness: weakness
weapon: weapon
wear: wears,wore,worn
weariness: weariness
wearisome: wearisome
weary: weary
weather: weather
weave: woven
wednesday: wednesday
week: week,weeks
weep: weep,weeping,weeps,wept
weigh: weigh,weighed
wench: wench
west: west
westphalia: westphalia
westphalian: westphalian
wet: wet
whatsoever: whatsoever
wheel: wheel
wherewithal: wherewithal
whimsical: whimsical
whip: whipped
whipping: whipping
whirl: whirled
whirlwind: whirlwinds
whisper: whispered
whistle: whistling
white: white,whiter
whites: whites
wicked: wicked
wide: wide,widest
widen: widened
wife: wife,wives
wild: wild
william: william
willingly: willingly
wind: wind,winds
window: window,windows
wine: wine
wise: wise
wit: wit,wits
witch: witches
wither: withered
witness: witness,witnessed
witty: witty
wolf: wolves
woman: woman,women
wonderful: wonderful
wonderfully: wonderfully
wood: wood
wooden: wooden
wool: wool
word: word
worship: worship
worth: worth
worthy: worthy
wound: wound,wounded,wounds
wretch: wretch,wretches
wretched: wretched
wrinkle: wrinkled
write: write,writes,writing,written,wrote
writer: writer,writers
writing: writing
writings: writings
wrong: wrong
xi: xi
xii: xii
xiii: xiii
xiv: xiv
xix: xix
xvi: xvi
xvii: xvii
xviii: xviii
xx: xx
xxi: xxi
xxii: xxii
xxiii: xxiii
xxiv: xxiv
xxv: xxv
xxx: xxx
yard: yards
yellow: yellow
yesterday: yesterday
york: york
youth: youth
zeal: zeal
