abandon: abandoned
abbess: abbess
abbey: abbey,abbeys
abbreviated: abbreviated
aberdeen: aberdeen
abeyance: abeyance
abhor: abhor
abhorrence: abhorrence
abide: abide,abides,abiding
abject: abject
abjure: abjuring
abjured: abjured
abnormally: abnormally
abode: abode
abominable: abominable
abominably: abominably
abomination: abominations
aboon: aboon
abound: abounding
abraham: abraham
abridgment: abridgments
abruptly: abruptly
absence: absence
absent: absent
absolute: absolute
absolutely: absolutely
absorb: absorbed,absorbing
abstain: abstained
absurd: absurd
abundant: abundant
abuse: abused
abysm: abysm
abyss: abyss
academic: academic
academy: academy
accent: accent,accents
accept: accept,accepted,accepting,accepts
acceptable: acceptable
acceptance: acceptance
access: access,accessed
accessibility: accessibility
accessible: accessible
accident: accident
accidental: accidental
accidentally: accidentally
accompany: accompanied,accompanies
accomplish: accomplish,accomplished,accomplishing
accomplished: accomplished
accost: accosts
account: account,accounted,accounts
accuracy: accuracy
accurate: accurate
accusation: accusation
accuse: accused
accustom: accustomed
accustomed: accustomed
achaean: achaean
achieve: achieved
achievement: achievements
achilles: achilles
acknowledge: acknowledge
acquaint: acquainted
acquaintance: acquaintance
acquiesce: acquiesced
acquiescence: acquiescence
acquire: acquire,acquired,acquiring
acquit: acquitted
acre: acres
acrimoniously: acrimoniously
action: action,actions
actium: actium
active: active
actor: actors
actress: actress
actual: actual
acute: acute
acutely: acutely
adam: adam
adapt: adapted,adapting
add: add,adds
addison: addison
addition: addition,additions
additional: additional
address: address,addressed,addresses,addressing
addrest: addrest
adeline: adeline
adequate: adequate
adieu: adieu
adjective: adjectives
adjoining: adjoining
administer: administered
admirable: admirable
admiral: admirals
admiration: admiration
admire: admire,admired,admiring
admirer: admirer,admirers
admit: admit,admits,admitted
adolphus: adolphus
adopt: adopt,adopting,adopts
adoption: adoption
adorable: adorable
adore: adored,adores
adorer: adorer
adorn: adorned
adown: adown
adroit: adroit
adsum: adsum
advance: advance,advanced
advanced: advanced
advantage: advantage
adventure: adventure,adventures
adventurer: adventurer,adventurers
adventures: adventures
adventurous: adventurous
advertise: advertised
advertisement: advertisement
advice: advice
advise: advises,advising
advocate: advocate
aeolic: aeolic
afar: afar
affable: affable
affair: affair,affairs
affect: affect
affectation: affectation
affection: affection,affections
affectionate: affectionate
affinity: affinity
affix: affixed
afflict: afflicted
affliction: affliction
afford: afforded
afghan: afghan
afore: afore
afraid: afraid
afresh: afresh
africa: africa
african: african
afternoon: afternoon
agatha: agatha
age: age,ages
aged: aged
ageless: ageless
agent: agent,agents
ages: ages
aggrieved: aggrieved
aghast: aghast
agile: agile
agitate: agitated
agitated: agitated
agitation: agitation
agnes: agnes
agnosticism: agnosticism
agone: agone
agony: agonies,agony
agree: agree,agreed
agreeable: agreeable
agreement: agreement
aid: aid,aided
ail: ailed
aim: aim
air: air,aired
airy: airy
ajax: ajax
ak: ak
akin: akin
alan: alan
alarm: alarm
alas: alas
albany: albany
alcibiades: alcibiades
alder: alder
ale: ale
alert: alert
alexander: alexander
alexandrine: alexandrine
alfred: alfred
alias: alias
alice: alice
alien: alien
alight: alighted
alike: alike
alive: alive
allan: allan
allege: alleged,alleges
allegorical: allegorical
allegory: allegories,allegory
allen: allen
alley: alleys
alliance: alliance
alluring: alluring
alluvial: alluvial
ally: allied,allies,ally
alms: alms
aloud: aloud
altar: altar
alter: altered
alteration: alteration
altered: altered
alternate: alternate
alternately: alternately
altogether: altogether
amain: amain
amass: amasses
amateur: amateur,amateurs
amazed: amazed
amazement: amazement
amazing: amazing
amber: amber
ambiguity: ambiguity
ambition: ambition,ambitions
ambitious: ambitious
ambrose: ambrose
amelia: amelia
america: america
american: american,americans
americanism: americanism
amiable: amiable
amidmost: amidmost
amorous: amorous
amours: amours
amphitryon: amphitryon
ample: ample
amplify: amplifying
amply: amply
amuse: amuse,amused
amusement: amusements
amusing: amusing
anachronism: anachronism
anacreontic: anacreontic
analogy: analogies,analogy
analyse: analyse,analysing
analysis: analyses,analysis
analyst: analyst
anapaestic: anapaestic
anarchist: anarchist
ancestor: ancestor,ancestors
ancestral: ancestral
ancient: ancient,ancients
andrew: andrew
andvari: andvari
anecdotage: anecdotage
anecdote: anecdote,anecdotes
angel: angel
angelica: angelica
anger: anger
angler: angler,anglers
angling: angling
anglo: anglo
angrily: angrily
angry: angry
anigh: anigh
animal: animal
animate: animate
animosity: animosity
ann: ann
anne: anne
annette: annette
anniversary: anniversary
annotate: annotated
announcement: announcements
annoy: annoyed
annoyed: annoyed
annoying: annoying
anodyne: anodyne
anon: anon
ans: ans
answer: answer,answered,answers
antecedent: antecedents
anthem: anthem
anthropology: anthropology
anticipate: anticipated,anticipates
anticipation: anticipation,anticipations
antique: antiques
antiquity: antiquity
antony: antony
anxiety: anxiety
anxious: anxious
anxiously: anxiously
apartment: apartment
ape: ape
apennines: apennines
aperture: apertures
aphrodite: aphrodite
apiece: apiece
apocrypha: apocrypha
apollo: apollo
apologue: apologue
apology: apology
apostrophe: apostrophe
apothecary: apothecaries,apothecary
apotheosis: apotheosis
apparel: apparel
apparent: apparent
apparition: apparition,apparitions
apparitions: apparitions
appeal: appeal,appealed,appealing,appeals
appearance: appearance
appetite: appetite
applaud: applauded
applause: applause
apple: apple,apples
applicable: applicable
application: application
apply: applied,apply
appoint: appointed
appreciation: appreciation
appreciative: appreciative
apprehend: apprehend
apprehension: apprehension
apprentice: apprenticed
approach: approach,approached
approve: approved,approves
april: april
apt: apt
arabian: arabian
arbiter: arbiter
arbour: arbour
arch: arch
archaic: archaic
archaistic: archaistic
archbishop: archbishop
archibald: archibald
architect: architect
archive: archive
arcturus: arcturus
ardent: ardent
ardour: ardour
argive: argive
argos: argos
argue: argue,argued
argument: arguments
argumentative: argumentative
argus: argus
arid: arid
aright: aright
aristocrat: aristocrat
aristotle: aristotle
arm: arm,arming,arms
armed: armed
armour: armour
armoury: armoury
army: army
arnold: arnold
arrange: arrange,arranged
arrangement: arrangement
arras: arras
array: array,arrayed
arrest: arrest,arrested
arrival: arrival
arrive: arrive,arrived,arriving
arrow: arrow,arrows
art: art,arts
arthur: arthur
arthurian: arthurian
article: article,articles
articles: articles
artificial: artificial
artist: artist,artists
artistic: artistic
arundo: arundo
ascent: ascent
ascertain: ascertain
ascertainment: ascertainment
ascetic: ascetic
ascii: ascii
ash: ashes
ashamed: ashamed
ashen: ashen
asia: asia
asiatic: asiatic
asleep: asleep
asp: asp
aspect: aspect,aspects
aspire: aspire,aspired
ass: ass
assail: assailed
assassin: assassin
assassination: assassination
assault: assault,assaults
assemblage: assemblage
assemble: assemble
assert: asserted,asserts
assist: assisted
assistance: assistance
assistant: assistant
associate: associate
association: associations
assortment: assortment
assume: assume,assumed
assure: assure
assuredly: assuredly
assyrian: assyrian
astonish: astonish,astonished,astonishes
astonished: astonished
astonishing: astonishing
astonishingly: astonishingly
astonishment: astonishment
astrologers: astrologers
asylum: asylum
atalanta: atalanta
atelier: atelier
atheism: atheism
atheist: atheist,atheists
atheists: atheists
athena: athena
athenians: athenians
athlete: athlete
athletic: athletic
atlantic: atlantic
atli: atli
atmosphere: atmosphere
atom: atom,atoms
atone: atoned
atrocious: atrocious
att: att
attach: attach,attached
attachment: attachment
attack: attack,attacked,attacks
attain: attained
attempt: attempt,attempted,attempting,attempts
attend: attended,attending
attendant: attendants
attention: attention
attentive: attentive
attentively: attentively
attic: attic
attitude: attitude,attitudes
attract: attracted,attracts
attraction: attraction
attractive: attractive
attribute: attributed
audaciously: audaciously
audacity: audacity
audible: audible
audience: audience
aught: aught
august: august
augustine: augustine
auld: auld
aunt: aunt,aunts
aurelia: aurelia
aurelius: aurelius
ausonian: ausonian
austere: austere
austin: austin
auteur: auteur
authentic: authentic
authenticity: authenticity
author: author,authors
authority: authorities,authority
autobiographical: autobiographical
autobiography: autobiography
autograph: autograph
autumn: autumn
avail: avail
avarice: avarice
avenge: avenge
aver: aver,avers
aversion: aversion,aversions
avocation: avocations
avoid: avoid,avoided,avoiding
avow: avowing
avowed: avowed
await: awaited
awake: awake,awoke
awaken: awaken,awakened,awakens
award: awarded
aware: aware
awful: awful
awfulness: awfulness
awkward: awkward
awkwardly: awkwardly
aye: aye
aztecs: aztecs
azure: azure
babe: babes
baby: babies,baby
bacchae: bacchae
bachelor: bachelors
background: background
bacon: bacon
bad: bad,worse,worst
baffle: baffled
bag: bag
baggage: baggage
bait: bait
bald: bald
ball: ball,balls
ballad: ballad,ballads
ballads: ballads
balmy: balmy
ban: ban
band: band,banded
bandit: bandit,bandits
banditti: banditti
bane: bane
baneful: baneful
banish: banished
bank: bank,banks
banner: banner,banners
banquet: banquet
bar: bar
barbarian: barbarian,barbarians
barbaric: barbaric
barbarous: barbarous
barber: barber
bard: bard
barde: barde
bare: bare
bargain: bargain
barge: barge
bark: bark
barn: barn
baron: baron
baronet: baronet
barricade: barricades
barrier: barriers
barry: barry
base: base,based,basest
bashfulness: bashfulness
basket: basket
basset: basset
baste: bastes
bat: bat
batch: batch
bath: bath
battering: battering
battle: battle,battles
battledore: battledore
battlements: battlements
bavius: bavius
bawbee: bawbee
baxter: baxter
bay: bay
beach: beach
beam: beam
bear: bear,bears,bore,born,borne
bearded: bearded
bearer: bearers
bearing: bearing
beast: beast
beastly: beastly
beat: beat,beaten,beating,beats
beating: beating
beatrice: beatrice
beautiful: beautiful
beautifully: beautifully
beauty: beauties,beauty
beckon: beckoned
bed: bed,beds
bedabble: bedabbled
bedroom: bedroom,bedrooms
bedside: bedside
bedstead: bedstead
bee: bee
beef: beef
beer: beer
befall: befall,befell
befit: befit
befriend: befriend,befriended
beg: beg,begged
beget: begat
beggar: beggar
beginner: beginner
beguile: beguiled
behave: behave,behaved,behaves
behaviour: behaviour
behold: beheld,behold,beholding
beholder: beholder
beleaguered: beleaguered
belief: belief,beliefs
believer: believer,believers
belike: belike
bell: bell
belle: belle,belles
bells: bells
belong: belonged,belonging,belongs
beloved: beloved
ben: ben
bend: bent
beneath: beneath
benefactor: benefactor
beneficent: beneficent
benefit: benefits
benevolence: benevolence
benevolent: benevolent
bent: bent
bequeath: bequeath,bequeathed
bereave: bereaved
berkeley: berkeley
berry: berry
bescribbled: bescribbled
beset: beset
bestow: bestowed
betake: betook
betroth: betrothed
betrothed: betrothed
betters: betters
betty: betty
betwixt: betwixt
beverage: beverage
bewilder: bewildered
bewray: bewray
bias: bias
bible: bible
bibliophile: bibliophile
bickering: bickering
bid: bade,bid,bidden,bids
bide: bide
bien: bien
bier: bier
bilk: bilk,bilking
billiards: billiards
billow: billows
binary: binary
bind: bound
binder: binders
binding: binding
biographer: biographer
biography: biography
birch: birch
bird: bird,birds
birth: birth
birthmark: birthmarks
bishop: bishop,bishops
bit: bits
bitter: bitter
bitterly: bitterly
bizarrerie: bizarrerie
black: black,blackest
blackberry: blackberry
blackie: blackie
blacksmith: blacksmith
blackwood: blackwood
blair: blair
blame: blame,blamed
blameless: blameless
blanch: blanched
blank: blank
blanket: blankets
blas: blas
blasphemy: blasphemy
blast: blasted
bleat: bleat
bleeding: bleeding
blemish: blemishes
blend: blend
blended: blended
bless: blessed
blessed: blessed
blessing: blessing
blest: blest
blight: blighted
blind: blind,blinded
blindly: blindly
blindness: blindness
bliss: bliss
blithe: blithe
blithest: blithest
blood: blood
bloom: bloom,blooming
blossom: blossom,blossomed,blossoming
blossoming: blossoming
blot: blotted
blow: blow,blowing,blown,blows
blue: blue
blues: blues
blunder: blunder
blunt: blunt
blur: blur
blush: blush
board: board,boards
boarder: boarders
boarding: boarding
boast: boast,boasts
boat: boat,boating,boats
bob: bob
bodied: bodied
bodily: bodily
body: bodies,body
bogie: bogies
bohemia: bohemia
boiler: boilers
bold: bold
boldly: boldly
boldness: boldness
bolt: bolts
bom: bom
bombard: bombards
bon: bon
bone: bone,bones
bones: bones
bonny: bonny
booing: booing
book: book,books
bookish: bookish
booklet: booklets
books: books
bookseller: booksellers
boot: boots
booth: booth
booty: booty
border: border
bore: bore,bores
borel: borel
borrow: borrow,borrowed,borrowing,borrows
bosom: bosom
boston: boston
bostonian: bostonian
botany: botany
bottle: bottle
bottled: bottled
bouge: bouge
bough: bough,boughs
bound: bounds
bout: bout
bow: bow,bowed,bowing
bower: bower
bowl: bowl
bowling: bowling
bowlings: bowlings
bowman: bowman
box: box
boxing: boxing
boy: boy,boys
boyhood: boyhood
boyish: boyish
boys: boys
brace: brace
brae: braes
brahmin: brahmin
brain: brain
bramble: bramble
branch: branch
brandy: brandy
brass: brass
brave: brave
bravely: bravely
bravery: bravery
brawling: brawling
brazen: brazen
breach: breach
bread: bread
breadth: breadth
break: break,breaking,broke,broken
breakfast: breakfast
breast: breast,breasts
breasted: breasted
breath: breath
breathe: breathed,breathes
breathing: breathing
breathless: breathless
breck: breck
breed: bred,breed
breeding: breeding
breeze: breeze,breezes
brethren: brethren
breton: breton
brevity: brevity
bribe: bribing
brick: brick
bridal: bridal
bride: bride
bridegroom: bridegroom
bridge: bridge
bridges: bridges
brig: brig
brigand: brigand
bright: bright,brightest
brighten: brighten
brilliance: brilliance
brilliancy: brilliancy
brilliant: brilliant
brim: brimmed
brimstone: brimstone
bring: bring,bringing,brings,brought
brisk: brisk
britain: britain
british: british
briton: briton
broad: broad
broken: broken
brood: brood,brooded,brooding
brooding: brooding
brook: brook
brother: brother,brothers
brotherhood: brotherhood
brotherly: brotherly
brothers: brothers
brougham: brougham
brow: brow,brows
brown: brown
brownies: brownies
browning: browning
bruce: bruce
brushwood: brushwood
brutal: brutal
brutality: brutality
brutus: brutus
brynhild: brynhild
buchanan: buchanan
buddha: buddha
build: building,built
building: building,buildings
bulk: bulk
bulky: bulky
bull: bull
bullet: bullet,bullets
bullock: bullock
bully: bullied,bullies,bully,bullying
bullying: bullying
bump: bump,bumped
bumpkin: bumpkin
bun: bun
bunch: bunches
bundle: bundle
bunker: bunker
bunyan: bunyan
burden: burden,burdened
burgher: burgher
burglar: burglar
burial: burial
burlesque: burlesqued
burley: burley
burly: burly
burn: burn,burned,burning,burnt
burning: burning
burns: burns
burnside: burnside,burnsides
burnt: burnt
burst: bursts
burthen: burthen,burthens
burton: burton
bury: buried,bury
bush: bush
business: business
bustle: bustle
busy: busy
butcher: butcher
bute: bute
butler: butler
bye: bye
byron: byron
cabin: cabin
cabman: cabmen
cabotin: cabotin
cad: cad
cadet: cadet,cadets
cadwallader: cadwallader
caesura: caesura
cairn: cairn
cairns: cairns
cake: cake,cakes
calamity: calamity
calculate: calculate,calculated
caledonia: caledonia
caledonian: caledonian
calef: calef
calling: calling
calm: calm
calvinism: calvinism
calvinistic: calvinistic
calvinists: calvinists
calydon: calydon
calypso: calypso
cam: cam
cambridge: cambridge
cameo: cameos
cameronian: cameronian
cameronians: cameronians
camp: camp,camps
campbell: campbell
campo: campo
candide: candide
candle: candle,candles
candlestick: candlesticks
cannibal: cannibals
canoe: canoe
canon: canon,canons
canty: canty
cap: cap
capable: capable
capital: capital
capricious: capricious
captain: captain
captious: captious
captivate: captivated
captive: captive
capture: capture
card: card,cards
care: care,cared,cares
career: career
carefully: carefully
careless: careless
caricature: caricature,caricatured,caricatures
carle: carle
carnal: carnal
carol: carol
carpenter: carpenter
carriage: carriage
carry: carried,carries,carry,carrying
casement: casement
cassandra: cassandra
cast: cast,casting
castaway: castaway
caste: caste
castigate: castigated
casting: casting
castle: castle,castles
castles: castles
casual: casual
casually: casually
casualness: casualness
casuistry: casuistry
cat: cat,cats
catacomb: catacombs
catacombs: catacombs
catch: catch,catching,caught
catechism: catechism
category: categories,category
cathedral: cathedral
catherine: catherine
catholic: catholic
catholicism: catholicism
catholics: catholics
causa: causa
causality: causality
causeless: causeless
causerie: causerie
caustic: caustic
caution: caution
cavaliers: cavaliers
cave: cave,caves
cavern: cavern
ce: ce
cease: cease,ceased
ceaselessness: ceaselessness
ceiling: ceiling,ceilings
celebrate: celebrate,celebrated
celebrated: celebrated
celerity: celerity
celestial: celestial
cell: cells
cellar: cellar
celt: celt
celtic: celtic
celts: celts
censor: censor,censors
censure: censure,censured,censures,censuring
central: central
centre: centre
century: century
cerecloth: cerecloth
certainty: certainty
cervantes: cervantes
chaff: chaff,chaffed
chagrin: chagrin
chain: chain
chair: chair,chairs
chalk: chalk,chalked
challenge: challenge,challenges
chamber: chamber,chambers
chambers: chambers
champion: champions
chance: chance,chanced,chances
change: change,changed,changing
changeful: changeful
changeless: changeless
changing: changing
channel: channel,channels
chanson: chansons
chap: chap
chapel: chapels
chaperon: chaperon
chaplain: chaplain
chaplet: chaplet
chapter: chapter,chapters
character: character,characters
characteristic: characteristic,characteristics
charge: charge,charged,charges
chariot: chariot
charitable: charitable
charity: charities,charity
charlatan: charlatan
charles: charles
charlie: charlie
charlotte: charlotte
charm: charm,charmed,charms
charming: charming
charms: charms
charon: charon
charter: charter
chase: chase,chasing
chasm: chasm
chaste: chaste
chastity: chastity
chateau: chateau
chatter: chatter
chaucer: chaucer
chaucerian: chaucerian
cheap: cheap
check: check,checks
cheek: cheek,cheeks
cheer: cheer
cheerful: cheerful
cheese: cheese,cheeses
chemistry: chemistry
cheque: cheque
chess: chess
chest: chest
cheviots: cheviots
chief: chief
chiefly: chiefly
child: child,children
childe: childe
childhood: childhood
childish: childish
chill: chill
chilly: chilly
chime: chime
chimera: chimera,chimeras
chimney: chimney
china: china
chinese: chinese
chirp: chirped
chirrup: chirrup
chivalrous: chivalrous
choice: choice
choir: choir
choke: choked
cholera: cholera
choleric: choleric
choose: choose,chose,chosen
choosing: choosing
chord: chords
choristry: choristry
christ: christ
christabel: christabel
christendom: christendom
christian: christian
christmas: christmas
christopher: christopher
chronicle: chronicle,chronicled
chronicler: chronicler
chronologist: chronologists
church: church
churchyard: churchyard,churchyards
cicala: cicalas
cicero: cicero
cigarette: cigarette,cigarettes
cincture: cincture
circe: circe
circle: circle
circulate: circulating
circumstance: circumstance,circumstances
citation: citations
cite: cited,cites
citizen: citizen,citizens
city: cities,city
civil: civil
civilisation: civilisation
civilised: civilised
civility: civility
claim: claim,claimed
clan: clan
clannish: clannish
clap: clapped
clara: clara
clarinda: clarinda
clarissa: clarissa
clash: clash
class: class,classed,classes
classic: classic,classics
classical: classical
clatter: clattering
clean: clean
clef: clef
cleopatra: cleopatra
clergy: clergy
clergyman: clergyman,clergymen
clerical: clerical
clerk: clerk
clever: clever,cleverest
cleverly: cleverly
clifford: clifford
climate: climate
climb: climb,climbed,climbs
clinch: clinched
cling: clinging,clung
clinker: clinker
clique: cliques
clive: clive
cloak: cloak
clog: clog
cloister: cloister
close: close,closed
closed: closed
closely: closely
closeness: closeness
closet: closet
cloth: cloth,cloths
clothe: clad,clothed
clothes: clothes
cloud: cloud,clouds
clough: clough
cloven: cloven
clown: clown
club: club,clubs
clung: clung
clyde: clyde
coach: coach,coaches
coaching: coaching
coachman: coachman
coagulate: coagulate
coal: coal
coarse: coarse
coast: coast
coat: coat,coats
cobwebby: cobwebby
cock: cock
cockney: cockney
cockspur: cockspur
cocoon: cocoon
code: codes
coeval: coevals
coffer: coffer
coffin: coffin
coherent: coherent
coil: coils
coincide: coincides
coincidence: coincidence,coincidences
cold: cold
coldly: coldly
collaboration: collaboration
collect: collected,collecting
collection: collection
collective: collective
collector: collector,collectors
college: college
collins: collins
colombo: colombo
colonel: colonel,colonels
colonial: colonial
colour: colour,coloured,colours
columned: columned
combat: combat,combats
combination: combination,combinations
combine: combine,combining
comedy: comedies,comedy
comer: comer
comfort: comfort,comforted
comfortable: comfortable
comic: comic
command: commands
commandment: commandment
commemorate: commemorates
commence: commence,commenced,commences
comment: comment
commentaries: commentaries
commentary: commentaries,commentary
commentator: commentator,commentators
commerce: commerce
commercial: commercial
commission: commission
commit: commit,committed
common: common
commonly: commonly
commonplace: commonplace
communicate: communicated
community: community
companion: companion,companions
companionship: companionship
company: companies,company
compare: compare,compared
comparison: comparison
compass: compass
compassion: compassion
compel: compel,compelled
compensate: compensate
compete: compete,competed
competent: competent
competition: competition,competitions
competitor: competitor
compilation: compilation,compilations
compile: compiling
complain: complain,complaining,complains
complete: complete
complex: complex
complexion: complexion
compliance: compliance
complicated: complicated
compliment: compliment,compliments
comply: comply,complying
compose: compose,composed,composes,composing
composition: composition,compositions
compound: compound
comprehend: comprehended
compress: compressed
compulsory: compulsory
conceal: conceal,concealed
conceit: conceit
conceited: conceited
conceivably: conceivably
conceive: conceive,conceived,conceives
concentrate: concentrated
concentrated: concentrated
concept: concept
conception: conception,conceptions
concern: concern,concerned
concerned: concerned
conclude: concluded
conclusion: conclusion
concord: concord
concubine: concubine,concubines
condemn: condemned
condescend: condescend,condescends
condition: condition,conditions
conduct: conduct,conducted
confer: conferred
confess: confess,confessed
confession: confession,confessions
confessions: confessions
confessor: confessor
confidante: confidante
confidence: confidence
confine: confined
confirm: confirm,confirmed
confirmation: confirmation
conflict: conflict
confused: confused
confusedly: confusedly
confusion: confusion
confute: confutes
congenial: congenial
congregation: congregation
congreve: congreve
conjecture: conjecture,conjectured
conjuration: conjuration
connect: connected,connects
connection: connection,connections
conquer: conquered
conquest: conquest,conquests
conscience: conscience
conscientious: conscientious
conscientiously: conscientiously
conscious: conscious
consciously: consciously
consciousness: consciousness
consent: consented
consequence: consequence,consequences
consequent: consequent
consequential: consequential
conservative: conservatives
considerable: considerable
consideration: consideration
consign: consigned
consist: consisted
consistent: consistent
consolation: consolation,consolations
console: console,consoled,consoling
consort: consort,consorted
conspicuous: conspicuous
conspicuously: conspicuously
conspiracy: conspiracies
constable: constable
constancy: constancy
constant: constant
constantly: constantly
constituent: constituents
constitute: constituted
constitution: constitution,constitutions
constitutional: constitutional
constrain: constrained
construct: construct,constructed
construction: construction
consulship: consulship
consult: consult,consulted
consulting: consulting
contact: contact
conte: conte,contes
contemplate: contemplate,contemplated,contemplating
contemplation: contemplation
contemporary: contemporaries,contemporary
contempt: contempt
contemptible: contemptible
contemptuous: contemptuous
contend: contending
content: content
contented: contented
contents: contents
contest: contested
continency: continency
continent: continent
continually: continually
continue: continue,continued
contract: contract
contrary: contrary
contrast: contrast,contrasted
contribute: contribute
contribution: contributions
contributor: contributors
contrite: contrite
control: control
controversy: controversy
convenience: convenience
convenient: convenient
convent: convent
convention: conventions
conventional: conventional
conventionally: conventionally
converge: converge
conversation: conversation,conversations
converse: converse
conversion: conversion
convert: convert,converted
converted: converted
convey: convey,conveyed,conveys
convince: convinced,convincing
convinced: convinced
convivial: convivial
convoy: convoy
convulsion: convulsions
cook: cook
cope: cope
copious: copious
copiously: copiously
copper: copper
copying: copying
copyright: copyright
cord: cord,cords
corinth: corinth
corkscrew: corkscrews
corn: corn
cornelius: cornelius
corner: corner
cornered: cornered
cornwall: cornwall
corporation: corporation
corpse: corpse
corpus: corpus
correct: correct,corrected
correctly: correctly
correctness: correctness
correspond: corresponded
correspondence: correspondence
correspondent: correspondent
corridor: corridors
corrie: corrie
corrupt: corrupt,corrupted
corruption: corruption
corse: corse
corsican: corsican
corydon: corydon
cosmopolitan: cosmopolitan
cost: cost,costs
costume: costume,costumes
cottage: cottage
cotton: cotton
council: councils
counsel: counsel,counsels
count: count
countenance: countenance
counteract: counteracts
counterpart: counterpart
countless: countless
country: countries,country
countryman: countrymen
couple: couple
couplet: couplet,couplets
courage: courage
courageous: courageous
courser: courser
court: court
courteous: courteous
courteously: courteously
courtesy: courtesy
courtezan: courtezan
courtier: courtier
courts: courts
courtship: courtship
cousin: cousin,cousins
cove: cove
covenanter: covenanter
covent: covent
cover: cover,covered,covering,covers
covering: covering
covetous: covetous
cow: cow,cows
coward: coward,cowards
cowardice: cowardice
cowardly: cowardly
cower: cowering
cowper: cowper
crab: crab
crack: crack
cradle: cradle
craft: craft,crafts
crag: crag
cramp: cramp
crash: crash
crawler: crawlers
create: created,creating
creation: creation,creations
creature: creature,creatures
credit: credit,credited
credulous: credulous
creed: creed,creeds
creeper: creepers
creepy: creepiest,creepy
cressida: cressida
crest: crest,crests
crew: crew
crib: crib,cribs
cricket: cricket
crime: crime,crimes
crimea: crimea
crimson: crimson,crimsons
critic: critic,critics
critical: critical
criticise: criticise,criticised,criticising
criticism: criticism,criticisms
crocodile: crocodile
croon: croon
cross: cross,crossed,crosses,crossing
crossbones: crossbones
crossing: crossing
crouch: crouching
crow: crow,crowed,crows
crowd: crowd,crowding
crown: crown
crucial: crucial
crude: crude
cruel: cruel
cruelly: cruelly
cruelty: cruelties,cruelty
crumble: crumbled,crumbling
crusade: crusades
crusader: crusader
crusades: crusades
crust: crust
crusty: crusty
crux: crux
crystal: crystal
cuff: cuff,cuffing
culinary: culinary
culpable: culpable
cult: cult
cultivate: cultivated
cultivator: cultivator
culture: culture,cultured
cumberland: cumberland
cunning: cunning
cup: cup,cups
cur: cur
curate: curate
cure: cured
curiosity: curiosities,curiosity
curious: curious
curiously: curiously
curl: curl,curled
current: current
curse: curse,curses
curtain: curtain,curtains
cushie: cushie
custom: custom,customs
customary: customary
cut: cut,cutting
cycle: cycle
cynical: cynical
cypress: cypress
cypselus: cypselus
dagger: dagger
daily: daily
dainty: dainty
dally: dallied
damage: damage
damaged: damaged
damages: damages
dames: dames
damn: damn
damnably: damnably
damned: damned
damp: damp
damsel: damsel
dance: dance,danced
dandy: dandy
danger: danger,dangers
dangerous: dangerous
dank: dank
dante: dante
darius: darius
dark: dark
darken: darkened
darkle: darkling
darkness: darkness
dart: darted
darts: darts
darwin: darwin
dastard: dastard,dastards
dateless: dateless
datum: data
daub: daubed,daubs
daughter: daughter,daughters
david: david
dawn: dawn,dawned,dawning
day: day,days
daylight: daylight
days: days
dazzle: dazzled
dazzling: dazzling
dead: dead
deadly: deadly
deadness: deadness
deaf: deaf
deal: deal,dealing,dealt
dealer: dealer
dearness: dearness
death: death,deaths
deathless: deathless
debate: debated,debating
debauchee: debauchee
debt: debt
decasyllabic: decasyllabic
decayed: decayed
decease: decease
deceive: deceive,deceived,deceiving
decency: decency
decide: decide,decided
decidedly: decidedly
decision: decision
declaration: declaration
declare: declare,declared,declares
decline: decline,declined,declining
decorative: decorative
decry: decried
dedicate: dedicated
dedication: dedication
dedicatory: dedicatory
deductible: deductible
dee: dee
deed: deed,deeds
deem: deem
deep: deep,deepest
deeply: deeply
deer: deer
defeat: defeat,defeated
defect: defect,defects
defective: defective
defence: defence
defend: defend,defending,defends
defer: deferred,deferring
deficiency: deficiencies,deficiency
deficient: deficient
definite: definite
deform: deformed
deft: deft
defunct: defunct
defy: defied
degrade: degraded
degraded: degraded
degrading: degrading
degree: degree,degrees
deign: deign
delay: delayed
deletion: deletions
delia: delia
deliberate: deliberate
deliberately: deliberately
delicacy: delicacy
delicate: delicate
delight: delight,delighted,delights
delighted: delighted
delightful: delightful
delightfully: delightfully
delineator: delineator
delirious: delirious
delirium: delirium
deliver: delivered
della: della
delta: delta
demand: demand,demanded
demean: demeaned
democracy: democracy
democratic: democratic
demon: demon,demons
demonology: demonology
demonstrable: demonstrable
den: den,dens
denial: denial
denounce: denounced,denounces
deny: denied,deny,denying
depart: depart,departed,departs
department: department
departure: departure
depend: depended,depends
dependant: dependants
deplorable: deplorable
deposit: deposit,deposited
depravers: depravers
depravity: depravity
depress: depressed
depressing: depressing
depression: depression
depth: depth
derby: derby
derision: derision
derivative: derivative
derive: derive,derived,derives
des: des
descend: descended,descends
descendant: descendant
description: description,descriptions
descriptive: descriptive
desecration: desecration
desert: desert,deserted,deserts
deserted: deserted
deserve: deserve,deserved,deserves
deserved: deserved
design: designed,designs
designer: designer
desirable: desirable
desire: desire,desired,desires
desolate: desolate
despair: despair
despairing: despairing
despatch: despatch
desperate: desperate
desperation: desperation
despise: despise,despised,despising
destine: destined
destiny: destiny
destitute: destitute
destroy: destroy,destroyed
destroyer: destroyers
destruction: destruction
desultory: desultory
detach: detach,detached
detect: detected,detects
detection: detection
detective: detective,detectives
determination: determination
determine: determine
determined: determined
detest: detested
detestable: detestable
detestation: detestation
dethrone: dethroned
develop: develop,developed
development: development
device: devices
devil: devil,devils
devils: devils
devise: devised,devising
devoid: devoid
devote: devoted
devotee: devotee,devotees
devotion: devotion
devotions: devotions
devour: devoured
devout: devout
dew: dew,dews
dewberry: dewberry
dewdrop: dewdrops
dewy: dewy
dexterous: dexterous
di: di
diabolise: diabolised
dialect: dialects
dialogue: dialogues
diamond: diamond,diamonds
dian: dian
dick: dick
dickens: dickens
dictionary: dictionary
didactic: didactic
dido: dido
die: die,died,dies,dying
difference: difference
differentia: differentia
difficult: difficult
difficulty: difficulties,difficulty
diffuse: diffuse
diffusion: diffusion
dig: dug
digest: digested
dignified: dignified
digression: digression
dilate: dilating
diligence: diligence
diligently: diligently
dim: dim
diminished: diminished
dimly: dimly
dine: dine,dined,dining
dinmont: dinmont
dinner: dinner,dinners
dint: dint
dip: dipped,dips
direct: direct,directed
direction: direction
director: director
dirge: dirge
dirt: dirt
dirty: dirtiest,dirty
dis: dis
disagreeable: disagreeable
disappear: disappear,disappeared,disappearing,disappears
disappoint: disappointed
disappointed: disappointed
disappointing: disappointing
disappointment: disappointment,disappointments
disapproval: disapproval
disaster: disaster
disastrous: disastrous
disbelief: disbelief
discard: discarded
discern: discerned
discharge: discharged
disciple: disciple,disciples
discipline: discipline
disclaim: disclaim
disclaimer: disclaimer,disclaimers
disclose: disclosed
discomfiture: discomfiture
disconcerting: disconcerting
disconnected: disconnected
discontented: discontented
discontinue: discontinue
discount: discount
discourse: discourses,discoursing
discover: discover,discovered,discovers
discoverer: discoverers
discovery: discoveries,discovery
discreet: discreet
discreetly: discreetly
discrepant: discrepant
discretion: discretion
discuss: discuss,discussed,discussing
discussion: discussion,discussions
disdain: disdained
disease: disease,diseases
disenchant: disenchant,disenchanted,disenchanting
disenchantment: disenchantment
disengage: disengaged
disgrace: disgrace
disguise: disguise,disguised
disgust: disgust
disgusting: disgusting
dish: dished
dishonour: dishonour
disinclined: disinclined
disintegrate: disintegrated
disinter: disinterred
disinterested: disinterested
disk: disk
dislike: dislike,disliked
dismiss: dismissed
disparagingly: disparagingly
dispassionately: dispassionately
dispiriting: dispiriting
display: display,displayed,displaying
disport: disports
dispose: dispose,disposed
disposition: disposition
dispraise: dispraised
disprove: disproves
dispute: dispute,disputes
disquiet: disquiet
disquisition: disquisitions
dissent: dissenting
dissipation: dissipation
dissolute: dissolute
distance: distance
distant: distant
distaste: distaste
distasteful: distasteful
distinct: distinct
distinction: distinction,distinctions
distinctly: distinctly
distinguish: distinguish
distinguishable: distinguishable
distinguished: distinguished
distract: distract
distraction: distractions
distraught: distraught
distress: distress,distressed,distresses
distribute: distribute,distributed,distributing
distribution: distribution
distributor: distributor
distrust: distrust
disturb: disturbed
disturbance: disturbance,disturbances
ditch: ditch
ditty: ditties,ditty
diverse: diverse
diversion: diversions
divert: diverted,diverting,diverts
divest: divested
divide: divide,divided,divides
divine: divine,divined
divinity: divinity
division: division
divulge: divulge
djinn: djinn
dobbin: dobbin
dobson: dobson
doctor: doctor,doctors
doctrinal: doctrinal
doctrine: doctrine
documentary: documentary
doe: doe
dog: dog,dogged,dogs
dogcart: dogcart
dogged: dogged
doggerel: doggerel
doggy: doggy
doings: doings
domain: domain
domestic: domestic
domesticated: domesticated
dominate: dominates
dominique: dominique
donate: donate
donation: donation,donations
donkey: donkey
donor: donors
doom: doom,doomed,dooms
doon: doon
door: door,doors
dormitory: dormitory
dose: doses
dost: dost
dotard: dotards
dote: doted
doth: doth
double: double,doubled,doubles
doubly: doubly
doubt: doubt,doubted
doubtless: doubtless
douglas: douglas
dour: dour
dowie: dowie
download: downloading
downward: downward
doyle: doyle
dozen: dozen
draft: drafted
drag: dragged,dragging,drags
draggle: draggled
dragon: dragon,dragons
drain: drain
drama: drama
dramatic: dramatic
dramatist: dramatist
draught: draught
drave: drave
draw: draw,drawing,drawn,draws,drew
drawing: drawing,drawings
dread: dread,dreaded
dreaded: dreaded
dreadful: dreadful
dream: dream,dreamed,dreaming,dreams
dreamland: dreamland
dreams: dreams
dreamy: dreamy
dreary: dreary
dress: dress,dressed
drift: drift
drink: drank,drinking
drive: drive,driven,drives,driving,drove
drop: drop,dropped,dropping,drops
dropt: dropt
drought: drought
drown: drown,drowned
drug: drug
drummer: drummer
drunk: drunk
dry: dried,dry
dryness: dryness
du: du
dual: dual
dublin: dublin
duc: duc
duck: duck
dudgeon: dudgeon
duel: duel,duels
duke: duke
dull: dull,duller
dulness: dulness
dumas: dumas
dump: dumped
dumpy: dumpy
dunce: dunce
dung: dung
dungeon: dungeon,dungeons
dust: dust
dusty: dusty
dutch: dutch
duty: duty
dwarf: dwarf,dwarfs
dwell: dwell,dwelling,dwells,dwelt
dweller: dweller,dwellers
dwelling: dwellings
dye: dyes
dyed: dyed
eager: eager
eagerly: eagerly
eagerness: eagerness
eagle: eagle
ear: ear,ears
eared: eared
earl: earl
earls: earls
earnest: earnest
earnestly: earnestly
earth: earth
earthly: earthly
earthquake: earthquake
ease: ease
easily: easily
east: east
easy: easy
eat: eat,eaten,eating,eats
eaters: eaters
eating: eating
ebb: ebb
eccentric: eccentric
eccentricity: eccentricities
ecclesiastical: ecclesiastical
echidna: echidna
echo: echo,echoes
echoes: echoes
eclipse: eclipse
eclogues: eclogues
economical: economical
economist: economist
economy: economies,economy
ecstasy: ecstasies
ecstatic: ecstatic
eddy: eddying
edgar: edgar
edge: edges
edify: edifying
edifying: edifying
edinburgh: edinburgh
edit: edited,editing
edition: edition,editions
editor: editor
educate: educated
education: education
educational: educational
edward: edward
edwards: edwards
edwin: edwin
effectual: effectual
effigy: effigies
effort: effort,efforts
egg: egg,eggs
ego: ego
egoism: egoism
egotism: egotism
egypt: egypt
egyptian: egyptian,egyptians
eidolon: eidolon
eighteen: eighteen
eighteenth: eighteenth
elbow: elbow
elder: elder,elders
elderly: elderly
elders: elders
elect: elect,elected
election: election
electronic: electronic
electronically: electronically
elegant: elegant
elegy: elegy
element: element,elements
elementary: elementary
elevation: elevation
eligible: eligible
elizabeth: elizabeth
elope: elopes
eloquence: eloquence
elucidation: elucidation
elysian: elysian
elysium: elysium
elzevir: elzevir
email: email
emancipated: emancipated
embassy: embassy
embattled: embattled
embittered: embittered
embrace: embrace,embracing
embroider: embroidering
emerald: emerald
emerson: emerson
emilia: emilia
emily: emily
eminence: eminence
emotion: emotion,emotions
emperor: emperor
empire: empire
employ: employed
employee: employee,employees
employment: employment
enable: enabled,enables
enamelled: enamelled
enamoured: enamoured
encampment: encampment
encaustic: encaustic
enchant: enchant,enchanted
enchanted: enchanted
enchanter: enchanter
enchanting: enchanting
enchantment: enchantment
enchantress: enchantress
encode: encoding
encounter: encounter,encountered,encounters
encourage: encourage,encouraged,encourages
encouragement: encouragement
endeavour: endeavour
endless: endless
endure: endure,endured,endures,enduring
enduring: enduring
enemy: enemies,enemy
engage: engaged,engaging
engine: engines
england: england
englander: englander
englanders: englanders
english: english
englishman: englishman
englishmen: englishmen
engrave: engraved
engrossing: engrossing
enigma: enigma
enjoy: enjoy,enjoyed,enjoying,enjoys
enjoyable: enjoyable
enjoyment: enjoyment,enjoyments
enlarged: enlarged
enlighten: enlighten,enlightened
ennoble: ennobled
enormous: enormous
enrich: enriched
enrol: enrolled
ensue: ensue,ensues
ensure: ensuring
entangle: entangled
enter: enter,entered,enters
enterprise: enterprise
enterprising: enterprising
entertain: entertain,entertained,entertains
entertaining: entertaining
entertainment: entertainment
enthusiasm: enthusiasm
enthusiastic: enthusiastic
entitle: entitled
entity: entity
entrance: entrance
entreat: entreat
entrench: entrenched
envious: envious
environment: environment
envisage: envisage
envy: envied,envy
epic: epic,epics
epicurean: epicurean
epigonus: epigoni
epigrammatic: epigrammatic
epileptic: epileptic
episcopal: episcopal
episode: episode
epistle: epistle,epistles
epithalamium: epithalamium
epoch: epoch
equability: equability
equable: equable
equal: equal
equally: equally
equestrian: equestrian
equipage: equipage
equipment: equipment
era: era
ere: ere
erect: erect,erected
erie: erie
eriphyle: eriphyle
ermine: ermine
err: err,erred
errant: errant
erroneous: erroneous
erroneously: erroneously
error: errors
erudite: erudite
erudition: erudition
escape: escape,escaped,escapes
esoteric: esoteric
essay: essay,essays
essayist: essayist
essays: essays
essence: essence
essential: essential
essentially: essentially
establish: establish,established,establishing
estate: estate
estimate: estimate,estimates
estrange: estranged
estuary: estuary
etcher: etcher
etching: etchings
eternal: eternal
eternally: eternally
eternity: eternity
ethel: ethel
ethereal: ethereal
ethics: ethics
etna: etna
eton: eton
euripides: euripides
europe: europe
european: european,europeans
eva: eva
evade: evaded
evangelical: evangelical
eve: eve
evelina: evelina
evening: evening
event: event,events
everlasting: everlasting
evidence: evidence
evident: evident
evil: evil,evils
evince: evinced
evolution: evolution
evolve: evolved
exact: exact
exaggerate: exaggerate,exaggerated,exaggerates
exaggerated: exaggerated
examination: examination,examinations
examine: examine,examining
examiner: examiners
exceedingly: exceedingly
excel: excel,excelled,excels
excellence: excellence,excellences
excellent: excellent
excellently: excellently
exception: exception
exchange: exchange,exchanged
excite: excited,excites
excited: excited
excitement: excitement
exciting: exciting
exclaim: exclaimed,exclaiming,exclaims
exclamation: exclamation
exclude: excluded,excluding
exclusion: exclusion
exclusively: exclusively
excursion: excursions
excusably: excusably
excuse: excuse
execrable: execrable
execute: executed
executive: executive
exemplary: exemplary
exempt: exempt
exercise: exercise,exercises
exhibition: exhibition
exile: exile,exiled
exist: exist,existed,existing,exists
existence: existence
expansion: expansion
expect: expect,expected,expects
expectation: expectation
expedient: expedient
expedition: expedition,expeditions
expel: expelled
expend: expend,expended
expense: expense,expenses
expensive: expensive
experience: experience,experienced,experiences
experiment: experiment,experiments
explain: explain,explained,explaining,explains
explanation: explanation,explanations
explicitly: explicitly
exploit: exploits
explore: explore,explores
explorer: explorer
explosion: explosions
exponent: exponent
export: exporting
expose: exposed,exposes
express: express,expressed
expression: expression,expressions
exquisite: exquisite
extant: extant
extent: extent
extinct: extinct
extinction: extinction
extinguish: extinguished
extract: extract,extracts
extraordinary: extraordinary
extravagant: extravagant
extreme: extreme,extremes
extremely: extremely
eye: eye,eyes
eyed: eyed
eyen: eyen
eyre: eyre
fable: fables
fabled: fabled
fabulous: fabulous
faced: faced
facile: facile
facility: facility
faculty: faculty
fade: fade,faded,fading
faery: faery
fafnir: fafnir
fag: fag
faggot: faggots
fail: fail,failed,failing,fails
failure: failure,failures
fain: fain
faint: faint,fainted,fainter
faintly: faintly
fair: fair,fairest,fairs
fairbanks: fairbanks
fairy: fairies,fairy
fairyland: fairyland
faith: faith
faithful: faithful
faithlessness: faithlessness
falcon: falcons
fall: fall,fallen,falling,falls,fell
fallow: fallow
false: false
falter: faltered,falters
fame: fame
familiar: familiar
family: families,family
famous: famous
fanatic: fanatic
fanciful: fanciful
fancy: fancied,fancies,fancy
fantastic: fantastic
fantastically: fantastically
fantasy: fantasies,fantasy
farce: farce
fare: fare
farewell: farewell
farm: farm
farmer: farmer
farmhouse: farmhouse
farouche: farouche
fascinate: fascinated
fascination: fascination
fashion: fashion,fashioned
fashionable: fashionable
fashioning: fashioning
fast: fast,faster
fat: fat
fatal: fatal
fate: fate
father: father,fathers
fathom: fathom
fatigue: fatigue
fault: fault,faults
faultless: faultless
faun: faun
faust: faust
favour: favour,favoured,favours
favourable: favourable
favourably: favourably
favourite: favourite
fawn: fawn
fear: fear,feared,fears
fearful: fearful
feast: feast
feat: feat,feats
feature: feature,features
february: february
federal: federal
fee: fee,fees
feeble: feeble
feed: fed,feed,feeds
feeder: feeders
feel: feel,feeling,feels
feeling: feeling,feelings
fell: felled
fellow: fellow,fellows
felon: felons
female: female
ferocious: ferocious
ferret: ferret
ferrier: ferrier
fertile: fertile
fetch: fetch,fetched,fetches
fetish: fetish
feud: feud
feudal: feudal
fever: fevered
feverish: feverish
fiction: fiction
field: field,fielding,fields
fielding: fielding
fiend: fiend,fiends
fiendish: fiendish
fierce: fierce
fiery: fiery
fifteenth: fifteenth
fiftieth: fiftieth
fig: figs
fight: fight,fighting,fights,fought
fighter: fighters
fighting: fighting
figure: figure,figures
file: file,filed,files
filial: filial
fillip: fillip
final: final
finally: finally
finances: finances
financial: financial
finding: finding
fine: fine,finer,finest
finger: finger,fingered,fingers
finish: finish,finished
fireball: fireballs
firebrand: firebrand
firelight: firelight
firmly: firmly
firth: firths
fish: fish,fishes
fisher: fisher,fishers
fishing: fishing
fist: fist
fisticuffs: fisticuffs
fit: fit,fits,fitted
fitness: fitness
fitz: fitz
flag: flag
flagrant: flagrant
flame: flame,flames
flanders: flanders
flash: flash,flashed,flashes
flat: flat
flaubert: flaubert
flay: flay
flee: fled,flee,flees
fleet: fleet
fleeting: fleeting
fleming: fleming
flesh: flesh
flicker: flicker,flickering
flight: flight
fling: flung
flippancy: flippancy
flippant: flippant
flitter: flitter
float: float,floated,floating
flock: flock,flocks
flog: flogging
flood: flood,flooded,floods
floods: floods
floor: floor
florence: florence
flourish: flourished
flow: flow,flowed,flowing
flower: flower,flowered,flowers
fluency: fluency
flush: flushed,flushing
flute: flutes
flutter: flutter
fly: flew,fly,flying
flying: flying
foam: foam,foamed,foaming
foe: foe,foes
foemen: foemen
fog: fogs
foil: foil
fold: fold,folded
folk: folk
folklore: folklore
follow: follow
follower: follower
folly: follies
fond: fond
fondly: fondly
fondness: fondness
food: food
foolish: foolish
foot: feet,foot
football: football
footman: footman
footnote: footnotes
footstep: footstep,footsteps
foray: foray
forbid: forbade,forbid,forbidden
force: force,forced,forces,forcing
ford: ford,fording
forebear: forebears
foreboding: foreboding
forecast: forecast
forefather: forefathers
forehead: forehead,foreheads
foreign: foreign
foreigner: foreigner
foremost: foremost
forest: forest,forests
forewent: forewent
forfeit: forfeit
forge: forge
forget: forget,forgot,forgotten
forgetful: forgetful
forgetfulness: forgetfulness
forgive: forgave,forgive,forgiven,forgives,forgiving
forgiveness: forgiveness
fork: fork,forked,forks
form: form,formed,forms
formally: formally
format: format,formats
formidable: formidable
formless: formless
forsake: forsaken,forsook
fortunate: fortunate
fortunately: fortunately
fortune: fortune,fortunes
fortunes: fortunes
foster: foster,fostered
foul: foul
foundation: foundation
founder: founder
fountain: fountain
fountainhead: fountainheads
fourteenth: fourteenth
fourth: fourth
fowl: fowl
fox: fox
fragment: fragment,fragments
fragmentary: fragmentary
fragrance: fragrance
fragrant: fragrant
frame: frame
france: france
frank: frank,frankest
frankly: frankly
frederick: frederick
freedom: freedom
freely: freely
freethinking: freethinking
freeze: frozen
french: french
frenchman: frenchman
frenzied: frenzied
frequent: frequent
frequently: frequently
fresh: fresh,fresher
freshman: freshman
freshness: freshness
friar: friar
friend: friend,friends
friendless: friendless
friendly: friendly
friendship: friendship,friendships
frieze: frieze
frigate: frigates
frighten: frighten
frightened: frightened
fringe: fringed
frivolous: frivolous
fro: fro
frontier: frontier
frontispiece: frontispiece
frozen: frozen
frugal: frugal
frugality: frugality
fruit: fruit,fruits
frutilla: frutilla
fugitive: fugitive
fulfil: fulfilled
fulness: fulness
fume: fumes
fun: fun
funeral: funeral
funny: funny
furious: furious
furnish: furnish,furnished
furniture: furniture
furrow: furrow
fury: fury
fustian: fustian
futile: futile
futility: futility
future: future
gable: gables
gaiety: gaiety
gain: gain,gained,gains
gainst: gainst
gaiter: gaiters
gaius: gaius
galahad: galahad
gale: gale
gallant: gallant
gallantly: gallantly
gallery: galleries
gallipot: gallipots
galloway: galloway
gamaliel: gamaliel
gambling: gambling
gambol: gambols
gambrel: gambrel
game: game,games
gaoler: gaolers
gap: gap,gaps
garden: garden,gardens
gardener: gardener
garret: garret
garrick: garrick
gas: gas
gate: gate,gates
gates: gates
gateway: gateway
gather: gather,gathered
gathering: gathering
gaul: gaul
gaun: gaun
gawain: gawain
gay: gay
gaze: gaze,gazed,gazing
gem: gems
genealogy: genealogies
generality: generality
generation: generation,generations
generosity: generosity
generous: generous
genesis: genesis
geneva: geneva
genial: genial
geniality: geniality
genially: genially
genius: genius,geniuses
genteel: genteel
gentiles: gentiles
gentle: gentle
gentleman: gentleman,gentlemen
gently: gently
gentrice: gentrice
gentry: gentry
genuine: genuine
george: george
geraldine: geraldine
germ: germ
german: german,germans
germinal: germinal
gesture: gesture
ghastly: ghastly
ghazi: ghazi
ghent: ghent
ghost: ghost,ghosts
ghostly: ghostly
ghoul: ghoul
giant: giant
giaour: giaour
gift: gift,gifts
gifted: gifted
gil: gil
gilbert: gilbert
gilded: gilded
giles: giles
gillie: gillie
gipsies: gipsies
girl: girl
girlish: girlish
girlishly: girlishly
giver: giver
glad: glad
gladden: gladdened
glade: glade,glades
gladiatorial: gladiatorial
gladly: gladly
gladness: gladness
glaive: glaives
glam: glam
glance: glance,glances
glare: glare,glared
glasgow: glasgow
glass: glass
glaze: glazed
gleaner: gleaner
gleek: gleek
glen: glens
glengarry: glengarry
glide: glide,glided
glimpse: glimpse,glimpses
glisten: glistens
glitter: glitter,glittered
gloom: gloom
gloomy: gloomy
glorious: glorious
gloriously: gloriously
glory: gloried,glories,glory
glove: gloves
goad: goading
goal: goal,goals
god: god,gods
goddess: goddess,goddesses
goddesses: goddesses
godfather: godfather
godhead: godhead
godless: godless
gods: gods
goethe: goethe
gold: gold
golden: golden
goldsmith: goldsmith
golf: golf
goodly: goodly
goodness: goodness
goody: goody
gordon: gordon
gore: gore
gorgeous: gorgeous
goring: goring
gospel: gospel
gossip: gossip,gossiped,gossiping
goth: goths
gothic: gothic
gout: gout,gouts
gouty: gouty
govern: govern
governor: governor
gowl: gowl
gown: gowns
graal: graal
grace: grace
graceful: graceful
gracious: gracious
graham: graham
grain: grain
grammar: grammar,grammars
grammatical: grammatical
grand: grand
grandfather: grandfather
grandmother: grandmother,grandmothers
grandsire: grandsire
grandson: grandsons
grant: granted
grape: grape,grapes
grasp: grasp
grass: grass
grate: grate
grateful: grateful
gratefully: gratefully
gratified: gratified
gratitude: gratitude
grave: grave,graves
gravely: gravely
gravity: gravity
gray: gray
greasy: greasiest,greasy
greatly: greatly
greatness: greatness
greaves: greaves
grecian: grecians
greece: greece
greed: greed
greedy: greedy
greek: greek,greeks
green: green
greet: greeted
greeting: greeting
gregory: gregory
grided: grided
grief: grief
grieve: grieve,grieved
grievous: grievous
grim: grim
grind: grind
grisons: grisons
groan: groan,groans
groaning: groaning
gross: gross
grotesque: grotesque,grotesques
ground: ground
groundwork: groundwork
grow: grew,grow,growing,grown,grows
grown: grown
growth: growth
grudge: grudge
gruesome: gruesome
grumble: grumbled
guard: guarded
guardian: guardian
guess: guess,guessed
guest: guest,guests
guide: guide,guided,guides
guilt: guilt
guiltless: guiltless
guilty: guilty
guinea: guinea
guineas: guineas
guinevere: guinevere
guise: guise
gulf: gulf
gun: gun
gunnar: gunnar
gust: gusts
guy: guy
gypsy: gypsy
ha: ha
habit: habit,habits
habitation: habitation
habitual: habitual
hack: hacks
hackneyed: hackneyed
haggard: haggard
hail: hail
hair: hair
halidome: halidome
hall: hall
hallucination: hallucination
hamlet: hamlet
hammer: hammer
hamper: hampered
hand: hand,handed,hands
handed: handed
handful: handfuls
handle: handle,handled
handling: handling
handsome: handsome
handsomely: handsomely
hang: hanged,hanging,hung
hanker: hanker
hankering: hankering
hanoverian: hanoverian
hap: hap
hapless: hapless
happen: happen,happened
happily: happily
happiness: happiness
happy: happier,happiest,happy
harangue: harangues
harbour: harbour
hard: hard
harden: hardened,hardening
hardiness: hardiness
hardy: hardy
harlot: harlot
harm: harm
harmless: harmless
harmonious: harmonious
harmony: harmony
harold: harold
harp: harp
harper: harper
harrowing: harrowing
harry: harry
harsh: harsh
harshly: harshly
hart: hart
harvard: harvard
harvest: harvest
haste: haste
hasten: hasten,hastened
hasty: hasty
hat: hat,hats
hatch: hatches
hatchway: hatchway
hate: hated,hates,hating
hath: hath
hatred: hatred
haughty: haughty
haunt: haunt,haunted,haunting,haunts
haunted: haunted
haunter: haunter
haunting: haunting
haut: haut
hawser: hawser
hawthorne: hawthorne
haystack: haystack
hazard: hazard,hazarded
hazel: hazel
head: head,heads
headmaster: headmaster
headrig: headrig
heal: healed
healing: healing
health: health
healthy: healthy
heap: heaps
hear: hear,heard,hearing,hears
hearer: hearer
hearing: hearing
hearse: hearse
heart: heart,hearts
hearted: hearted
heartless: heartless
hearty: hearty
heat: heat
heathen: heathen
heather: heather
heaven: heaven,heavens
heavenly: heavenly
heaving: heaving
heavy: heavy
hectic: hectic
hector: hector
heed: heed
heep: heep
hegelian: hegelian
height: height,heights
heighten: heightens
heir: heir,heirs
heiress: heiress,heiresses
helen: helen
helena: helena
hellenic: hellenic
helm: helm
helpfulness: helpfulness
helpless: helpless
henceforth: henceforth
henry: henry
hera: hera
herald: herald,heralds
herb: herb
herd: herding
hereditary: hereditary
heredity: heredity
hereon: hereon
heretic: heretic
heritage: heritage
hermes: hermes
hermione: hermione
hermit: hermit,hermits
hermitage: hermitage
hero: hero,heroes
heroic: heroic
heroine: heroine,heroines
heroism: heroism
hesitate: hesitate,hesitated,hesitates
hesperides: hesperides
hester: hester
hexameter: hexameter
hiawatha: hiawatha
hidden: hidden
hide: hidden,hide,hiding
hideous: hideous
hideously: hideously
hideousness: hideousness
hiding: hiding
highland: highland
highlander: highlander
highlanders: highlanders
highlands: highlands
highly: highly
highway: highways
highwayman: highwayman
hilda: hilda
hill: hill,hills
hillside: hillside
hilly: hilly
hinder: hindered
hint: hint,hinting
hippo: hippo
hippolytus: hippolytus
hire: hire,hired
historian: historian
historic: historic
historical: historical
historically: historically
history: history
hit: hit
hitherto: hitherto
ho: ho
hoard: hoard
hobbledehoyhood: hobbledehoyhood
hogg: hogg,hoggs
hogni: hogni
hold: held,hold,holding,holds
holder: holder
hole: hole
holiday: holiday,holidays
hollow: hollow
holmes: holmes
holy: holy
homer: homer
homeric: homeric
honest: honest
honestly: honestly
honesty: honesty
honey: honey
honour: honour,honours
honourable: honourable
honourably: honourably
hook: hooks
hope: hope,hoped,hopes,hoping
hopeless: hopeless
horace: horace
horae: horae
horatius: horatius
horizon: horizon
horn: horn
horrible: horrible
horribly: horribly
horrid: horrid
horror: horror,horrors
horse: horse,horses
horseman: horseman,horsemen
hospital: hospital,hospitals
hospitality: hospitality
hospitaller: hospitaller
hospitium: hospitium
hoss: hoss
host: host
hostess: hostess
hostile: hostile
hot: hot
hotel: hotel
hound: hounds
hour: hour,hours
house: house,houses
houseful: houseful
houses: houses
hover: hover,hovers
howl: howling
huddle: huddled
hue: hue,hues
huge: huge
hugo: hugo
hullo: hullo
hum: hum
human: human
humane: humane
humanity: humanity
humanly: humanly
humble: humble,humbled
hume: hume
humiliation: humiliation
humility: humility
humorist: humorist
humorists: humorists
humorous: humorous
humour: humour,humours
humoured: humoured
humourist: humourist
humphrey: humphrey
hung: hung
hungry: hungry
hunt: hunt,hunted
hunter: hunter
hurl: hurling
hurriedly: hurriedly
hurry: hurry,hurrying
hurst: hurst
hurt: hurt,hurts
husband: husband
hush: hush
hussar: hussar
hyde: hyde
hydrostatic: hydrostatics
hydrostatics: hydrostatics
hylas: hylas
hymn: hymn
hypnotism: hypnotism
hypocrisy: hypocrisy
hypothesis: hypothesis
hysteric: hysterics
iceland: iceland
icelandic: icelandic
icy: icy
idea: idea,ideas
ideal: ideal,ideals
ideally: ideally
identical: identical
identification: identification
identify: identify
identity: identity
idiom: idiom
idiot: idiot
idle: idle
idleness: idleness
idler: idler
idyllic: idyllic
ignoble: ignoble
ignorance: ignorance
ignorant: ignorant
iii: iii
iliad: iliad
ilian: ilian
ilium: ilium
illness: illness
illustrate: illustrate,illustrated,illustrates
illustration: illustration,illustrations
illustrative: illustrative
image: image,images
imagination: imagination
imaginative: imaginative
imagine: imagine,imagined
imbed: imbedded
imitate: imitate,imitated
imitation: imitation,imitations
imitator: imitators
immaculately: immaculately
immense: immense
immerse: immersed
immoral: immoral
immortal: immortal
immortality: immortality
immortally: immortally
immortals: immortals
immure: immured
impact: impact
impale: impale
impalpable: impalpable
impeachment: impeachment
impeccable: impeccable
impel: impelled
impending: impending
imperfect: imperfect
imperfection: imperfections
imperial: imperial
imperious: imperious
imperishable: imperishable
impersonally: impersonally
impertinently: impertinently
impetuous: impetuous
implacable: implacable
implore: implored,imploring
imply: implied
impose: impose,imposed,imposing
imposition: impositions
impossibility: impossibility
impossible: impossible
impostor: impostor
imposture: imposture
impress: impressed,impresses
impressed: impressed
impressible: impressible
impression: impression,impressions
imprison: imprisoned
improbable: improbable
improve: improve,improved,improving
improvement: improvement
improviser: improviser
imprudent: imprudent
inaccurate: inaccurate
inaccurately: inaccurately
inadequate: inadequate
inanimate: inanimate
inappeasable: inappeasable
inartistic: inartistic
inattentive: inattentive
inborn: inborn
incalculable: incalculable
incapable: incapable
incarnation: incarnation
inch: inch
incident: incident,incidents
incidental: incidental
inclination: inclinations
incline: incline
inclined: inclined
include: include,included,includes,including
including: including
income: income
incommunicable: incommunicable
incomparable: incomparable
incompetence: incompetence
incomplete: incomplete
inconceivably: inconceivably
incongruity: incongruity
inconsistency: inconsistency
inconsistent: inconsistent
inconspicuous: inconspicuous
inconvenience: inconvenience
inconvenient: inconvenient
incorrigible: incorrigible
increase: increase,increased,increasing
incredible: incredible
incredulity: incredulity
incrust: incrusted
incurious: incurious
indebt: indebted
indecently: indecently
indemnify: indemnify
indemnity: indemnity
independence: independence
independent: independent
indian: indian,indians
indies: indies
indifference: indifference
indifferent: indifferent
indignation: indignation
indirect: indirect
indirectly: indirectly
indiscreet: indiscreet
indite: indited
individual: individual
indolence: indolence
indulge: indulge,indulges
industrialism: industrialism
industrious: industrious
industry: industry
ineffably: ineffably
ineffaceable: ineffaceable
ineffectual: ineffectual
inevitable: inevitable
inevitably: inevitably
inexhaustible: inexhaustible
infamous: infamous
infamy: infamy
infancy: infancy
infant: infant,infants
infantile: infantile
infatuation: infatuation
infer: inferred
inferior: inferior
infernal: infernal
infinite: infinite
infinitely: infinitely
infirmary: infirmary
infirmity: infirmity
inflame: inflamed
inflict: inflict
influence: influence,influenced,influences
inform: inform,informed,informing,informs
informed: informed
informer: informer
infrequently: infrequently
infringe: infringing
infringement: infringement
ingenious: ingenious
ingeniously: ingeniously
ingenuity: ingenuity
ingles: ingles
ingratiate: ingratiate
inherit: inherit,inherited,inherits
inheritance: inheritance
inhospitable: inhospitable
inimitable: inimitable
iniquity: iniquities,iniquity
initiate: initiated
injudiciously: injudiciously
injury: injury
ink: ink
inland: inland
inn: inn
innate: innate
innerly: innerly
innocence: innocence
innocent: innocent
innocently: innocently
inns: inns
innumerable: innumerable
inoffensive: inoffensive
inquire: inquire,inquiring
inquirers: inquirers
inquisition: inquisition
inquisitiveness: inquisitiveness
insane: insane
insensible: insensible
insensibly: insensibly
inseparable: inseparable
inseparably: inseparably
insight: insight
insinuate: insinuating
insist: insist,insisted,insisting,insists
insolence: insolence
inspection: inspection
inspire: inspire,inspired,inspires,inspiring
instance: instance,instances
instant: instant
instantly: instantly
instinct: instinct,instincts
instinctively: instinctively
institution: institution,institutions
instruct: instructed
instructive: instructive
instrument: instrument,instruments
insult: insulted
insulting: insulting
insuperable: insuperable
intellect: intellects
intellectual: intellectual
intelligence: intelligence
intelligible: intelligible
intemperance: intemperance
intend: intend,intended
intense: intense
intensely: intensely
intent: intent
intention: intention
intercourse: intercourse
interfere: interfere,interfered
internal: internal
international: international
interpolation: interpolations
interpret: interpret,interpreted
interpretation: interpretations
interrupt: interrupted
intersect: intersect
intertwist: intertwisted
interval: interval,intervals
intimate: intimate,intimates
intimately: intimately
intolerable: intolerable
intoxication: intoxication
intrepid: intrepid
intrigue: intrigue,intrigues
introduce: introduce,introduced,introducing
introduction: introduction
intruder: intruder
inure: inured
invalid: invalid,invalids
invalidity: invalidity
invariably: invariably
invent: invented
inventor: inventor
inverness: inverness
invert: inverted
investigate: investigated
investigator: investigators
invincibly: invincibly
invisible: invisible
invitation: invitation
invite: invited
involve: involving
ionian: ionian
ireland: ireland
irish: irish
iron: iron
irony: irony
irregular: irregular
irreligion: irreligion
irresistible: irresistible
irresistibly: irresistibly
irrigate: irrigate
irritable: irritable
irritated: irritated
irritating: irritating
irritation: irritation
irs: irs
irving: irving
isaac: isaac
isabella: isabella
island: island
islands: islands
isle: isle,isles
isles: isles
ism: isms
iso: iso
israel: israel
issue: issue,issued
italian: italian,italians
italy: italy
iv: iv
ivory: ivory
ix: ix
jacob: jacob
jacobite: jacobite
jamaica: jamaica
james: james
jane: jane
janet: janet
jangle: jangling
japan: japan
jason: jason
jaw: jaws
jealous: jealous
jealousy: jealousy
jeffrey: jeffrey
jekyll: jekyll
jenkin: jenkin
jenny: jenny
jericho: jericho
jerusalem: jerusalem
jesus: jesus
jettatura: jettatura
jeu: jeu
jeunesse: jeunesse
jew: jew
jewel: jewels
jewish: jewish
joe: joe
john: john
johnson: johnson
joint: joint
joke: joke,jokes
jolly: jolly
jonathan: jonathan
jones: jones
jos: jos
joseph: joseph
joshua: joshua
jot: jotted
journal: journal,journals
journey: journey,journeys
joy: joy,joys
joyous: joyous
joyously: joyously
juan: juan
judge: judge,judges,judging
judgment: judgment
judicial: judicial
judicious: judicious
judiciously: judiciously
juice: juice
julia: julia
juliet: juliet
julio: julio
julius: julius
july: july
june: june
junior: junior,juniors
jurisconsult: jurisconsult
jury: jury
justice: justice
justification: justification
justify: justified,justify
justly: justly
juvenal: juvenal
keats: keats
keen: keen
keenly: keenly
keeper: keeper
keeping: keeping
kelt: kelts
ken: ken
kenny: kenny
kent: kent
kick: kick,kicked
kidnap: kidnap,kidnapped
kill: kill,killed
kilt: kilt
kin: kin
kindle: kindled
kindly: kindly
kindness: kindness
kindred: kindred
king: king,kings
kingdom: kingdom
kingly: kingly
kinless: kinless
kinsman: kinsman
kirk: kirk
kirkyard: kirkyard
kiss: kiss,kissed
kitchen: kitchen,kitchens
kitten: kitten
knack: knack
kneel: kneeling,knelt
knife: knife,knives
knight: knight
knightly: knightly
knot: knot,knots
knowledge: knowledge
laborious: laborious
labour: labour,labouring,labours
lack: lack,lacked
lacustrine: lacustrine
lad: lad
ladder: ladder
lading: lading
lady: ladies,lady
ladyship: ladyship
lair: lair
laird: laird,lairds
lake: lake
lamb: lamb
lambert: lambert
lame: lame
lament: lamented
lamp: lamp,lamps
lampoon: lampooning
land: land,landed,lands
landscape: landscape,landscapes
lane: lanes
lang: lang
language: language,languages
languish: languished
languor: languor
larrikin: larrikin
lash: lashed
lasher: lasher
lass: lass
lassie: lassie
lasso: lassoed
late: late
latin: latin
latitude: latitude
latro: latro
laugh: laugh,laughed,laughing,laughs
laughable: laughable
laughter: laughter
launch: launch,launched
laura: laura
laureate: laureate
laurel: laurel,laurels
laurentian: laurentian
laverock: laverock
law: law,laws
lawless: lawless
lawlessness: lawlessness
lawn: lawn
lawyer: lawyer
lay: laid,lay,laying,lays
layer: layers
lays: lays
lazily: lazily
laziness: laziness,lazinesses
lazy: lazy
le: le
lead: lead,leading,leads,led
leader: leader
leaf: leaf,leaves
leafy: leafy
league: leagues
leaky: leaky
lean: leaned,leaning
leap: leaped,leapt
learn: learn,learned,learning,learns
learning: learning
leather: leather
leave: leave,leaves,leaving,left
leavings: leavings
lecture: lecture,lectured,lectures
leda: leda
leech: leech
legal: legal
legally: legally
lege: lege
legend: legend,legends
legendary: legendary
leghorn: leghorn
legitimate: legitimate
legitimist: legitimist
leisure: leisure
leisurely: leisurely
lend: lend,lends
leo: leo
leonard: leonard
les: les
lesbia: lesbia
leslie: leslie
lesson: lesson,lessons
letter: letter,letters
letters: letters
level: level,levelled
leven: leven
lever: lever
levirate: levirate
lewis: lewis
liability: liability
liable: liable
liar: liars
libel: libel,libelled
liberal: liberal
liberality: liberality
libertine: libertine
libertinism: libertinism
liberty: liberty
library: library
libretto: libretto
license: license
licensed: licensed
licentious: licentious
lick: lick
lid: lid
lie: lain,lie,lied,lies,lying
liest: liest
lieu: lieu
lieutenant: lieutenant
life: life,lives
lifeless: lifeless
lift: lifted,lifts
light: light,lighted,lighter,lights,lit
lighten: lighten
lightly: lightly
lightness: lightness
lightning: lightning
lightsome: lightsome
liken: likened
likeness: likeness
liking: liking,likings
lily: lily
limb: limbs
limit: limited,limits
limitation: limitation,limitations
limited: limited
limitless: limitless
limpet: limpet,limpets
lindsay: lindsay
lineage: lineage
linger: linger
linguist: linguist
link: linked,links
lion: lion,lions
lip: lips
liquid: liquid
list: lists
listen: listen,listened,listening,listens
listener: listener
literal: literal
literally: literally
literary: literary
literati: literati
literature: literature
live: live,lived,lives,living
lived: lived
liveliness: liveliness
lively: lively
liver: liver
living: living
lo: lo
load: loaded
loaden: loaden
loathe: loathed
loathsome: loathsome
lobby: lobby
loblolly: loblolly
lobster: lobster,lobsters
local: local
locate: located
location: locations
loch: loch
lock: locked,locking,locks
locus: loci
lodge: lodge,lodged,lodges
lodging: lodging
lodgings: lodgings
lofty: lofty
log: logs
logic: logic
loitering: loitering
london: london
lone: lone
lonely: lonely
longing: longing
loom: loom
loon: loons
loose: loose,loosed
loosen: loosen
lop: lopped
lord: lord
lore: lore
lorenzo: lorenzo
lose: lose,losing,lost
loss: loss
lost: lost
lot: lot,lots
lothario: lothario
lotus: lotus
louis: louis
love: love,loved,loves,loving
loveliness: loveliness
lovely: lovelier,lovely
lover: lover,lovers
lovesome: lovesome
loving: loving
lowell: lowell
lowland: lowland
lowly: lowly
lowness: lowness
loyal: loyal
loyalty: loyalty
luc: luc
lucian: lucian
lucid: lucid
luck: luck
luckily: luckily
luckless: luckless
lucky: luckier,lucky
lucrative: lucrative
lucretius: lucretius
lucy: lucy
ludicrous: ludicrous
lug: lugged
lull: lull,lulled
lump: lumps
lunacy: lunacy
luncheon: luncheon
lung: lungs
lure: lure
lurid: lurid
lust: lust
luxury: luxury
lx: lx
lycanthrope: lycanthrope
lydia: lydia
lyndon: lyndon
lyonnesse: lyonnesse
lyre: lyre
lyric: lyric,lyrics
macbeth: macbeth
macduff: macduff
machine: machine
machinery: machinery
mad: mad
madam: madam
madame: madame
madeira: madeira
madness: madness
magazine: magazine,magazines
maggot: maggots
magic: magic
magical: magical
magically: magically
magician: magician
magnanimous: magnanimous
magnificent: magnificent
magus: magus
maid: maid,maids
maiden: maiden,maidens
mail: mail
main: main
maine: maine
maintain: maintained,maintaining,maintains
maintenance: maintenance
majestically: majestically
majesty: majesty
major: major
maker: makers
malachi: malachi
malady: maladies,malady
malice: malice
malison: malisons
mamma: mamma
manage: manage,managed
manager: manager,managers
manfully: manfully
maniac: maniacs
manifest: manifest
manifestly: manifestly
mankind: mankind
manly: manly
manner: manner
manners: manners
mannish: mannish
manse: manse
mansion: mansion
mantle: mantle
mantled: mantled
mantuan: mantuan
manufacture: manufactured
manuscript: manuscript,manuscripts
manx: manx
map: mapped
mar: mar
marble: marble
march: march,marched
marchesa: marchesa
marchese: marchese
marchioness: marchioness
margaret: margaret
margin: margin,margins
maria: maria
mariner: mariner
mariners: mariners
marion: marion
maritimal: maritimal
marjorie: marjorie
mark: mark,marked,marking,marks
marked: marked
market: market
marquis: marquis
marriage: marriage,marriages
married: married
marry: married,marries,marry,marrying
marsh: marsh
marshal: marshal
marshall: marshall
marshalsea: marshalsea
martin: martin
marvel: marvel,marvelled,marvels
marvellous: marvellous
mary: mary
mask: mask,masked
mason: mason
mass: mass
massachusetts: massachusetts
massacre: massacre
massy: massy
master: master,mastered,masters
masterless: masterless
masterly: masterly
masterpiece: masterpiece,masterpieces
mastodon: mastodon
match: match,matched,matches
mate: mate
material: material,materials
maternal: maternal
mathematics: mathematics
mather: mather
matrimony: matrimony
matron: matrons
matter: matter,matters
matthew: matthew
mattress: mattress
mature: mature,maturing
matutinal: matutinal
maupassant: maupassant
maux: maux
mawkish: mawkish
max: max
maximum: maximum
meadow: meadow,meadows
meadows: meadows
meagre: meagre
meal: meal
meaning: meaning
meanly: meanly
meanness: meanness
measles: measles
measurable: measurable
measure: measure,measured,measures
meat: meat
mechanic: mechanic
mechanical: mechanical
medea: medea
medical: medical
medici: medici
medium: medium
medley: medley
meerschaum: meerschaum
meet: meet,meeting,meets,met
meeting: meeting,meetings
melancholy: melancholy
meleager: meleager
mellow: mellowed
melodious: melodious
melodramatic: melodramatic
melody: melody
melt: melts
memnon: memnon
memoir: memoir
memoirs: memoirs
memorial: memorial
memory: memories,memory
mend: mend,mended
menelaus: menelaus
mental: mental
mention: mention,mentioned,mentioning,mentions
merchandise: merchandise
merchant: merchant,merchants
merchants: merchants
mere: mere,meres
merit: merit,merits
meritorious: meritorious
merry: merry
mesmerism: mesmerism
messenger: messenger
metamorphose: metamorphosed
metaphor: metaphor,metaphors
metaphysician: metaphysician,metaphysicians
metaphysics: metaphysics
method: method,methods
methodism: methodism
methought: methought
metre: metre
micawber: micawber
michael: michael
middle: middle
midge: midge
midnight: midnight
midshipman: midshipman
midst: midst
midsummer: midsummer
mightily: mightily
mightiness: mightiness
mighty: mighty
milan: milan
mild: mild,milder
mildly: mildly
mile: mile,miles
milk: milk
millet: millet
milo: milo
milton: milton
mind: mind,minded,minds
minded: minded
mindful: mindful
mingle: mingle,mingling
miniature: miniature
minister: minister,ministers
ministerialist: ministerialist
minnehaha: minnehaha
minor: minor
minority: minority
minstrel: minstrel,minstrels
minstrelsy: minstrelsy
minute: minutes,minutest
minutely: minutely
miracle: miracle,miracles
miraculous: miraculous
miraculously: miraculously
miranda: miranda
miriam: miriam
mirror: mirror
mirth: mirth
mirthful: mirthful
mis: mis
misanthrope: misanthrope
miscellaneous: miscellaneous
mischance: mischance
mischief: mischief
mischievous: mischievous
misconduct: misconducted
miscreant: miscreant,miscreants
misdeed: misdeeds
miserable: miserable
misery: misery
misfortune: misfortune,misfortunes
mishap: mishaps
misjudge: misjudged
mislead: misled
mismanagement: mismanagement
misshapen: misshapen
mission: mission
missionary: missionary
mississippi: mississippi
mist: mist
mistake: mistake,mistakes
mistaken: mistaken
mistress: mistress
mitchell: mitchell
mitre: mitre
mix: mixed
mixed: mixed
moan: moaning,moans
moat: moat
mob: mob
mock: mock,mocked,mocking
mockery: mockery
model: model,modelled
modern: modern
modest: modest
modification: modification
modify: modified,modify
modish: modish
mohr: mohr
moliminous: moliminous
mollify: mollified
moment: moment,moments
momentary: momentary
monarch: monarch
monarchy: monarchy
money: money
monger: mongers
mongrel: mongrel
monica: monica
monimia: monimia
monitor: monitor
monitorial: monitorial
monk: monk
monologue: monologues
monsieur: monsieur
monster: monsters
monstrous: monstrous
monte: monte
month: month,months
monthly: monthly
mood: mood,moods
moody: moody
moon: moon
moonlight: moonlight
moonlit: moonlit
moonshine: moonshine
moor: moor,moors
moore: moore
moorland: moorlands
moral: moral,morals
moralise: moralised,moralising
moralist: moralist
morality: morality
morass: morasses
morgan: morgan
morgue: morgue
morn: morn
morning: morning,mornings
morocco: morocco
morris: morris
morrow: morrow
mort: mort
mortal: mortal,mortals
mortality: mortality
mortar: mortar
mortification: mortification
mossy: mossy
mother: mother,mothers
motherhood: motherhood
motherless: motherless
motif: motif
motive: motive,motives
motley: motley
motte: motte
motto: motto
mou: mou
moulder: mouldering
mouldering: mouldering
mound: mound
mount: mounted
mountain: mountain,mountains
mourn: mourn
mouse: mouse
mouth: mouth
mouthed: mouthed
mouthpiece: mouthpieces
movement: movement,movements
mss: mss
muckle: muckle
muddy: muddy
multitude: multitude
mummery: mummery
mundane: mundane
mungo: mungo
murder: murder,murdered,murders
murderer: murderer
murderous: murderous
murmur: murmur,murmured,murmurs
murmuring: murmuring
murray: murray
muscovite: muscovite
muse: muse,mused,muses
muses: muses
museum: museum
music: music
musical: musical
musically: musically
musketeers: musketeers
muslin: muslin
mussel: mussels
muster: muster
mutter: mutter
myriad: myriad,myriads
mysteries: mysteries
mysterious: mysterious
mysteriously: mysteriously
mystery: mysteries,mystery
mystic: mystic
mystical: mystical
mystifications: mystifications
myth: myth,myths
mythical: mythical
nail: nails
naked: naked
namby: namby
naomi: naomi
naples: naples
napoleon: napoleon
narcotic: narcotic
narrate: narrate,narrated
narrative: narrative,narratives
narrator: narrator
narrow: narrow,narrower
narrowness: narrowness
nathaniel: nathaniel
national: national
native: native,natives
natural: natural
naturally: naturally
nature: nature,natures
natured: natured
nauseous: nauseous
nautical: nautical
nautilus: nautilus
naval: naval
navy: navy
neapolitan: neapolitan
nearer: nearer
nearness: nearness
neat: neat
neath: neath
nebuchadnezzar: nebuchadnezzar
necessity: necessity
neck: neck
necromantic: necromantic
needful: needful
nefarious: nefarious
neglect: neglect,neglected,neglecting
negligence: negligence
negro: negroes
neighbour: neighbour,neighbouring,neighbours
neighbourhood: neighbourhood
neil: neil
nelly: nelly
nemesis: nemesis
nephew: nephew
nereid: nereid
nereids: nereids
nerval: nerval
nervous: nervous
nest: nest,nested
nestor: nestor
network: network
neutral: neutral
newark: newark
newcome: newcome
news: news
newsletter: newsletter
newspaper: newspaper,newspapers
nice: nicest
nicety: niceties
nicher: nicher
nick: nick
nicolette: nicolette
niece: niece
nigel: nigel
nigh: nigh
night: night,nights
nightmare: nightmare
nights: nights
nihilist: nihilist
nimble: nimble
nineteen: nineteen
nineteenth: nineteenth
ninth: ninth
nobility: nobility
noble: noble
nobleman: nobleman,noblemen
nobly: nobly
nocturnal: nocturnal
nod: nodding
noire: noire
noise: noise
noisome: noisome
nonproprietary: nonproprietary
nonsense: nonsense
noonday: noonday
normal: normal
north: north
northern: northern
northman: northman
nose: nose
noster: noster
notable: notable
note: note,notes
notebook: notebook
noteworthy: noteworthy
notice: notice
notify: notifies
notion: notion,notions
notoriety: notoriety
nought: nought
nourishment: nourishment
nous: nous
nova: nova
novelette: novelettes
novelist: novelist,novelists
novels: novels
novelty: novelty
november: november
nowadays: nowadays
nowise: nowise
nucleus: nucleus
nuisance: nuisances
numerous: numerous
nun: nun
nunnery: nunnery
nurse: nurses
nursery: nursery
nursing: nursing
nymphs: nymphs
oak: oak,oaks
oakwood: oakwood
oath: oath,oaths
oats: oats
obedience: obedience
obedient: obedient
obey: obeyed
obi: obi
obituary: obituary
object: object,objects
objection: objections
objective: objective
oblige: oblige,obliged,obliging
obscure: obscure
observation: observations
observe: observe,observed,observes,observing
observer: observer
obsolescent: obsolescent
obsolete: obsolete
obstinate: obstinate
obvious: obvious
occasion: occasion,occasioned,occasions
occasional: occasional
occasionally: occasionally
occult: occult
occupation: occupation
occupy: occupied,occupy
occur: occur,occurred,occurs
occurrence: occurrence,occurrences
ocean: ocean
oceanic: oceanic
october: october
odd: odd,oddest
oddly: oddly
ode: ode
odes: odes
odin: odin
odious: odious
odysseus: odysseus
odyssey: odyssey
offence: offence
offended: offended
offensively: offensively
offer: offered,offers
office: office
officer: officer
official: official,officials
oft: oft
oligarchy: oligarchy
oliphant: oliphant
oliver: oliver
olympia: olympia
olympian: olympians
omar: omar
omit: omit
oneself: oneself
online: online
onrush: onrush
ope: ope
openly: openly
opera: opera
opinion: opinion,opinions
opium: opium
opponent: opponent,opponents
opportunity: opportunities,opportunity
oppose: opposed
oppress: oppressing
oppressed: oppressed
oppression: oppression
optimistic: optimistic
oracle: oracles
oral: oral
orally: orally
oration: oration,orations
orator: orator,orators
orbilius: orbilius
orchard: orchard,orchards
ordinary: ordinary
organize: organized
orient: orient
oriental: oriental
origin: origin,origins
original: original,originals
originality: originality
originally: originally
originator: originator
orion: orion
orphan: orphan,orphans
orthodox: orthodox
orthodoxy: orthodoxy
ortolan: ortolans
ostia: ostia
otter: otter
ounce: ounce
outcast: outcast
outdated: outdated
outgrow: outgrown
outlast: outlast
outlaw: outlawed
outline: outline,outlines
outraged: outraged
outsider: outsider
outstretched: outstretched
outward: outward
outworn: outworn
oval: oval
overbearingly: overbearingly
overborne: overborne
overcome: overcome
overdo: overdone
overdone: overdone
overdrawn: overdrawn
overflow: overflowing
overladen: overladen
overlook: overlook
overspread: overspread
overweening: overweening
overwhelming: overwhelming
ow: ower
owe: owe,owed,owes
owl: owls
owner: owner
oxford: oxford
oyster: oyster
pace: pace
pacify: pacified
pack: pack
pactolus: pactolus
padding: padding
pagan: pagan
pagans: pagans
pageant: pageant
pain: pain,pains
pained: pained
painful: painful
paint: paint,painted
painter: painter,painters
painting: painting,paintings
pair: pair
palace: palace
palaver: palavers
pale: pale,paled
paleness: paleness
palinode: palinode
pallid: pallid
palm: palm
palter: paltered
pamela: pamela
pamphlet: pamphlet,pamphlets
pan: pans
panic: panic
panorama: panorama
pans: pans
pant: panted
pantheon: pantheon
panting: panting
pap: pap
papa: papa
papal: papal
paper: paper,papers
paperwork: paperwork
paps: paps
par: par
parable: parable
paradise: paradise,paradises
paradox: paradox,paradoxes
paradoxical: paradoxical
paragraph: paragraph,paragraphs
parallel: parallel
paraphrase: paraphrase
parcel: parcel
pardon: pardon,pardoned
pardonable: pardonable
parent: parent,parents
parental: parental
paris: paris
parish: parish
parishioner: parishioners
parisian: parisian
park: park
parliament: parliament
parnassus: parnassus
parody: parodied,parodies,parody
parrot: parrot
parsley: parsley
partaker: partaker
partaking: partaking
parterre: parterres
parthian: parthian
partial: partial
particulars: particulars
partly: partly
partner: partner
partnership: partnership
partridge: partridge
party: parties,party
pass: pass,passed,passes,passing
passage: passage,passages
passing: passing
passion: passion,passions
passionate: passionate
paste: paste
pastiche: pastiche
pastoral: pastoral
pasture: pastures
patch: patches
patched: patched
patent: patent
pater: pater
paternal: paternal
path: path,paths
pathos: pathos
pathway: pathway
patience: patience
patient: patient,patients
patiently: patiently
patriarch: patriarch
patriot: patriot
patriotic: patriotic
patriotism: patriotism
patron: patron,patrons
patronage: patronage
pattern: patterns
patty: patty
paul: paul
pause: pause,paused
pave: paved,paving
pay: paid,pay,paying
payment: payments
peace: peace
peaceful: peaceful
peacefully: peacefully
peacemaker: peacemakers
peak: peaks
pear: pear,pears
pearl: pearl,pearls
pearls: pearls
peasant: peasant,peasants
pecksniff: pecksniff
peculiar: peculiar
peculiarity: peculiarities,peculiarity
peculiarly: peculiarly
pecuniary: pecuniary
pedagogue: pedagogue
pedant: pedant
pedantic: pedantic
pedestrian: pedestrian
pedlar: pedlar
peer: peer,peers
peerless: peerless
peevish: peevish
peitho: peitho
pelt: pelts
pen: pen,penned,penning
penal: penal
penalty: penalty
penance: penance
pencil: pencil
pencilled: pencilled
pendant: pendant
penelope: penelope
penetrate: penetrate,penetrated
penitence: penitence
penitent: penitent,penitents
penniless: penniless
penny: penny
penultimate: penultimate
penurious: penurious
people: peopled,peoples
pepper: pepper
perceive: perceive,perceiving
perchance: perchance
percy: percy
peregrine: peregrine
perfect: perfect
perfection: perfection
perfectly: perfectly
perform: perform,performed,performing
performance: performance,performances
perfume: perfume
pericles: pericles
peril: perils
perilous: perilous
period: period
periodic: periodic
periodical: periodical,periodicals
periphrastic: periphrastic
perish: perished
perishable: perishable
periwig: periwig
permanent: permanent
permission: permission
permit: permit,permitted,permitting
perpetual: perpetual
perpetually: perpetually
perplex: perplex,perplexed
persecute: persecute,persecuted
persecution: persecution
persevere: persevere,persevered
persistent: persistent
person: people,person,persons
personage: personages
personal: personal
personality: personalities,personality
personally: personally
personation: personation
persuade: persuade
persuasion: persuasion
persuasive: persuasive
peru: peru
perusal: perusal,perusals
peruse: peruse,perused,perusing
perverse: perverse
pervert: perverted
pessimist: pessimist
pessimistic: pessimistic
pet: pet
peter: peter
petition: petitions
petulant: petulant
pew: pews
phaedo: phaedo
phantasm: phantasm,phantasms
phantasy: phantasy
phantom: phantom
phase: phase
phenomena: phenomena
phenomenon: phenomenon
philip: philip
philoctetes: philoctetes
philologist: philologist,philologists
philosopher: philosopher,philosophers
philosophic: philosophic
philosophy: philosophy
phoebe: phoebe
photograph: photograph,photographs
photographer: photographer
photographic: photographic
phrase: phrase
phrygian: phrygian
physic: physic
physical: physical
physically: physically
physician: physician
physicist: physicists
piano: piano
pick: pick,picked,picking
pickle: pickle
pickwick: pickwick
pictorial: pictorial
picture: picture,pictures
picturesque: picturesque
piece: piece,pieces
pied: pied
pier: piers
piety: piety
pike: pike
pile: piled,piles
pilgrim: pilgrim,pilgrims
pilgrimage: pilgrimage
pillage: pillaged
pillared: pillared
pinch: pinched
pine: pined
pink: pinks
pinnock: pinnock
pion: pion
pious: pious
pipe: pipe
piper: piper
pipes: pipes
pistol: pistol
pitch: pitch,pitched
piteous: piteous
pithy: pithy
pitiable: pitiable
pitifulness: pitifulness
pitiless: pitiless
pity: pitied,pity
placid: placid
plagiarise: plagiarised
plagiarist: plagiarist
plague: plague
plaid: plaid,plaids
plain: plain
plainly: plainly
plan: plan
planet: planet
plant: planting
planting: planting
plaster: plaster
plate: plate,plates
platform: platforms
plato: plato
platonic: platonic
plausible: plausible
play: play,played,playing,plays
playfellow: playfellows
playfully: playfully
playground: playground
playing: playing
playtime: playtime
playwright: playwrights
plead: pleaded
pleasant: pleasant,pleasanter
pleasantry: pleasantry
pleased: pleased
pleasing: pleasing
pleasure: pleasure,pleasures
pledge: pledge
pleiad: pleiad
plenty: plenty
plot: plot,plotted
ploughboy: ploughboy
pluck: pluck,plucked
plume: plume,plumes
plunder: plunder
plunge: plunge,plunged,plunging
poacher: poacher
pocket: pocket
poe: poe
poem: poem,poems
poems: poems
poet: poet,poets
poetaster: poetasters
poetic: poetic
poetical: poetical
poetry: poetry
poignant: poignant
pointless: pointless
poison: poison,poisoned
poland: poland
pole: pole,poles
police: police
policeman: policemen
policy: policy
polished: polished
polite: polite
political: political
politician: politicians
politics: politics
polity: polities
pollock: pollock
pollute: pollute,polluted
polynesian: polynesian
polytheism: polytheism
pomegranates: pomegranates
pomp: pomp
pompadour: pompadour
pompey: pompey
pond: pond
ponder: ponder
ponderous: ponderous
poniard: poniard
pons: pons
pont: pont
pontus: pontus
pony: pony
pool: pool,pools
poor: poor
pop: popped
pope: pope
popish: popish
popjoy: popjoy
poplar: poplar
popular: popular
popularity: popularity
populate: populate
portable: portable
portal: portal,portals
portent: portents
portfolio: portfolio
portion: portion
portmanteau: portmanteau
portrait: portrait,portraits
portray: portrayed
pose: posed,poses
position: position
positive: positive
positivist: positivist
possess: possess,possessed,possesses,possessing
possession: possession
possibility: possibility
post: post,posted,posts
postpone: postponed
pot: pot
potboy: potboy
potent: potent
potion: potion
pounce: pounce
pound: pounds
pour: pour,pouring
poussin: poussin
poverty: poverty
power: power,powers
powerful: powerful
powerfully: powerfully
practicable: practicable
practical: practical
practically: practically
practice: practice
practise: practise,practised
praepostor: praepostor
praise: praise,praised,praises
prank: pranks
pray: pray,prayed,praying
prayer: prayer,prayers
preach: preach
preacher: preacher
precaution: precautions
precede: preceded
precious: precious
precisely: precisely
precocious: precocious
prediction: prediction
preface: preface,prefaces
prefer: prefer,preferred,preferring
preferable: preferable
preference: preference
prejudice: prejudice,prejudices
preliminary: preliminary
prelude: prelude,preludes
premature: premature
prematurely: prematurely
premise: premises
premonitory: premonitory
prepare: prepare,prepares
prepared: prepared
presbyterian: presbyterian
presbyters: presbyters
prescription: prescriptions
presence: presence
presentation: presentation
presently: presently
presentment: presentment
preserve: preserve,preserved
preside: presiding
press: press,pressed
pressman: pressmen
presume: presume
pretend: pretend
pretender: pretender
pretension: pretensions
pretentious: pretentious
prettily: prettily
pretty: prettier,pretty
prevail: prevailed
prevent: prevent,preventing
previous: previous
prey: prey
priam: priam
price: price
prick: pricked
pride: pride
priest: priest
prime: prime
primeval: primeval
primitive: primitive
prince: prince,princes
princes: princes
princess: princess
principal: principal
principle: principles
print: print,printed
printer: printers
prior: prior
prismatic: prismatic
prison: prison,prisons
prisoner: prisoner,prisoners
private: private
privilege: privilege
prize: prize,prizes
probable: probable
proceed: proceeded
proceedings: proceedings
process: process,processes
processing: processing
procession: procession
proclaim: proclaiming,proclaims
procure: procure,procured,procuring
prodigious: prodigious
prodigy: prodigies
produce: produce,produced
product: product
production: production
profane: profane
profess: professes,professing
professedly: professedly
profession: profession
professional: professional
professor: professor,professors
profit: profit,profits
profitable: profitable
profligacy: profligacy
profligate: profligates
profoundly: profoundly
profusely: profusely
profusion: profusion
progress: progress
prohibition: prohibition
project: project,projects
prolix: prolix
prolong: prolonged
prominent: prominent
prominently: prominently
promise: promise,promised,promises
promote: promoting
promotion: promotion
prone: prone
pronounce: pronounced
pronouncing: pronouncing
proof: proof,proofs
proofread: proofread
proper: proper
properly: properly
property: property
prophecy: prophecies,prophecy
prophetic: prophetic
proportion: proportion,proportions
proprietary: proprietary
proprietor: proprietors
prose: prose
prosecute: prosecuted
prospect: prospect
prosperous: prosperous
prostrate: prostrate
protect: protect
protest: protest
protestant: protestant,protestants
prototype: prototype
protozoa: protozoa
prouder: prouder
proudly: proudly
prove: prove,proved,proves,proving
provender: provender
proverb: proverb
proverbial: proverbial
proverbially: proverbially
provide: provide,providing
providence: providence
provider: provider
province: province
provincial: provincial
provision: provision,provisions
provocative: provocative
provokingly: provokingly
provost: provost
prowl: prowled,prowling
prudent: prudent
prudently: prudently
prudery: prudery
psalms: psalms
psychical: psychical
psychological: psychological
psychology: psychology
public: public
publication: publication
publish: publish,published,publishing
publisher: publisher,publishers
puerile: puerile
puff: puffed
pug: pug
puir: puir
pull: pull,pulled
pulsation: pulsations
pun: puns
punch: punch
punctual: punctual
punish: punish,punished
punishment: punishment,punishments
punitive: punitive
pupil: pupil,pupils
puppet: puppets
purchase: purchase
purchaser: purchaser
pure: pure,purest
purely: purely
purgatory: purgatory
purge: purged
purist: purist
puritan: puritan
puritanic: puritanic
puritanism: puritanism
puritans: puritans
purity: purity
purple: purple
purpose: purpose,purposes
purposely: purposely
purse: purse,purses
pursue: pursue,pursued,pursues
pursuit: pursuit
push: push
puss: puss
puzzle: puzzle,puzzles
puzzled: puzzled
puzzling: puzzling
pyramid: pyramid
pyre: pyre
quae: quae
quaedam: quaedam
quaint: quaint
quakers: quakers
qualify: qualifies
quality: qualities,quality
quantity: quantities
quarrel: quarrel,quarrelled,quarrelling
quarter: quarter,quarters
quarto: quarto,quartos
quartz: quartz
queen: queen
queer: queer
queerly: queerly
quest: quest
question: question,questions
quetzalcoatl: quetzalcoatl
quick: quick,quicker
quicken: quickens
quidam: quidam
quiet: quiet
quill: quill
quintus: quintus
quit: quitted
quixote: quixote
quo: quo
quotation: quotation,quotations
quote: quote,quoted
quoth: quoth
rab: rab
race: race
racing: racing
rack: racks
radiancy: radiancy
radiant: radiant
rage: rage,raging
raid: raid,raids
rail: railing
railway: railway
raiment: raiment
rain: rain,raining
rainy: rainy
raise: raise,raised,raises,raising
raising: raisings
rake: rake,rakes
ralph: ralph
ram: rams
rambling: rambling
rampier: rampier
rancorous: rancorous
rancour: rancour
random: random
range: range
rank: rank,ranked,ranks
rap: rapped
rapid: rapid
rapidly: rapidly
rapture: rapture
rare: rare,rarest
rarely: rarely
rarity: rarities
rash: rash
rat: rat
rattle: rattle
ravage: ravaged
raven: raven
raw: raw
ray: ray
reach: reach,reached,reaching
reaction: reaction
read: read,reading,reads
readable: readable
reader: reader,readers
readiness: readiness
reading: reading,readings
ready: ready
real: real
realise: realised,realising
realism: realism
realistic: realistic
realm: realm
reap: reap,reaped,reaps
rear: reared
reason: reason,reasons
reasonable: reasonable
reasoning: reasoning
rebecca: rebecca
rebel: rebels
rebellion: rebellions
rebuke: rebuke
recalcitrant: recalcitrant
recall: recall,recalls
recapture: recapture
recede: recede
receipt: receipt
receive: receive,received,receiving
recess: recesses
recklessness: recklessness
reckon: reckon
reclaim: reclaimed
recognisable: recognisable
recognise: recognise,recognised,recognising
recognition: recognition
recollect: recollect
recollection: recollection,recollections
recollections: recollections
recommend: recommend,recommended,recommends
recommendation: recommendation
reconcile: reconcile,reconciled
reconciliation: reconciliation
record: record,recorded,records
recover: recover,recovered
recut: recut
red: red
redeem: redeem
redeeming: redeeming
redemption: redemption
rediscover: rediscovered
redistribute: redistribute,redistributing
redistributing: redistributing
redistribution: redistribution
reduce: reduced,reducing
reduction: reduction
reed: reed
reel: reel,reels
reeve: reeve
refer: referring
reference: references
refit: refitting
reflect: reflect,reflected
reflection: reflection,reflections
reflective: reflective
refluent: refluent
reform: reformed,reforms
reformation: reformation
refund: refund
refusal: refusal
refuse: refused,refusing
refute: refuting
regard: regard,regarded
regicide: regicide
regiment: regiment
regin: regin
reginald: reginald
region: region,regions
register: register,registered
regna: regna
regret: regret,regrets,regretted
regular: regular
regulate: regulating
reid: reid
reign: reign,reigned,reigning
rein: reins
reiver: reivers
reject: rejected,rejecting
rejoice: rejoiced
rejoin: rejoin
relapse: relapse
relation: relation,relations
relative: relative,relatives
release: release,released
relent: relented
relentlessly: relentlessly
relic: relic,relics
relieve: relieve
religio: religio
religion: religion,religions
religiosity: religiosity
religious: religious
reluctance: reluctance
reluctant: reluctant
reluctantly: reluctantly
remain: remain,remained,remaining,remains
remainder: remainder
remains: remains
remark: remark,remarked,remarks
remarkable: remarkable
remedy: remedies,remedy
remember: remember,remembered,remembers
remind: remind,reminded,reminds
reminiscence: reminiscence,reminiscences
reminiscences: reminiscences
remonstrance: remonstrance
remonstrate: remonstrate
remorse: remorse,remorses
remorseless: remorseless
remote: remote
remove: remove,removed
remunerative: remunerative
renaissance: renaissance
rename: renamed
rend: rending
render: rendered
rendering: rendering
renew: renewed
renown: renown
renowned: renowned
rent: rents
repass: repass
repeat: repeat,repeated,repeating
repel: repelled
repent: repent
repentance: repentance
repetition: repetitions
replace: replace
replacement: replacement
replete: replete
reply: replied,reply
report: reported,reporting,reports
reporter: reporter,reporters
reposeful: reposeful
reposing: reposing
represent: represent,represented,representing,represents
representation: representation,representations
reproach: reproach,reproaches
reproduce: reproduce,reproduced
reproof: reproof
reptile: reptile
republish: republished
repugnant: repugnant
reputable: reputable
reputation: reputation,reputations
repute: repute
request: request,requests
require: require,required
requirement: requirements
rescue: rescue,rescued,rescues
researcher: researcher
resemblance: resemblance
resemble: resemble,resembled,resembles,resembling
resent: resent
resentment: resentment
reserve: reserve
reset: reset
reside: reside,resided
resist: resists
resolution: resolutions
resolve: resolve,resolved
resound: resounded
resource: resource,resources
respect: respect
respectability: respectability
respectable: respectable
respectfully: respectfully
respects: respects
respond: respond
responsible: responsible
rest: rest,rested,resting
restless: restless
restoration: restoration
restore: restored
restriction: restrictions
result: result
retain: retains
retainer: retainers
retaliation: retaliations
retell: retell,retelling,retold
retention: retention
retire: retire,retired
retreat: retreat,retreating,retreats
retribution: retribution
return: return,returned,returning,returns
reveal: reveal,revealed,reveals
revel: revelled
revelation: revelation,revelations
revenge: revenge
revengeful: revengeful
revenue: revenue
reverberation: reverberations
reverence: reverence
reverend: reverend
reverie: reverie
reverse: reverse
revert: reverted
review: review,reviewing,reviews
reviewer: reviewer,reviewers
revival: revival
revive: revive,revived
revolution: revolution
reward: reward
rhetoric: rhetoric
rhetorician: rhetorician
rhodes: rhodes
rhyme: rhyme,rhymed,rhymes,rhyming
rhymer: rhymer
rib: rib
rich: rich,richer,richest
richard: richard
richardson: richardson
richly: richly
richmond: richmond
richness: richness
rickety: rickety
rid: rid
riddle: riddle
ride: ride,riding,rode
ridge: ridge
ridiculous: ridiculous
riding: riding
rifle: rifle,rifles
rift: rifted
righteousness: righteousness
rightful: rightful
rightward: rightward
rill: rill
rinaldo: rinaldo
riotous: riotous
ripen: ripen,ripened
rise: rise,risen,rises,rising,rose
rising: rising,risings
risk: risk
ritual: ritual
rival: rival,rivals
rivalry: rivalry
river: river,rivers
riviera: riviera
road: road
roar: roar,roared,roaring
roasted: roasted
rob: rob,robbed,robbing
robber: robber,robbers
robbery: robbery
robe: robe
robert: robert
robin: robin
robinson: robinson
robust: robust
robustly: robustly
rochester: rochester
rock: rock
rocky: rocky
rod: rod,rods
roderick: roderick
roe: roe
roger: roger
rogue: rogue
roisterer: roisterers
roland: roland
roll: roll,rolled,rolling
roman: roman,romans
romance: romance,romances
romancer: romancer,romancers
romantic: romantic
romanticism: romanticism
romanticist: romanticist
rome: rome
romeo: romeo
roof: roof,roofed,roofs
roofless: roofless
rook: rooks
roost: roost
rope: rope,ropes
rosa: rosa
rosamond: rosamond
rosary: rosary
rose: rose
rot: rotting
rote: rote
rotten: rotten
rough: rough,roughing
roughness: roughness
rounded: rounded
rouse: rouse,roused
rousseau: rousseau
rovers: rovers
row: row,rowed
rowena: rowena
roy: roy
royal: royal
royalty: royalties,royalty
rubaiyat: rubaiyat
ruddily: ruddily
ruddiness: ruddiness
ruddy: ruddy
rude: rude
rudiment: rudiments
rue: rue
ruff: ruff
ruffian: ruffian,ruffians
ruffle: ruffling
rug: rugs
rugby: rugby
rugged: rugged
ruin: ruin,ruined
ruinous: ruinous
rule: rule,rules
rum: rum
rummage: rummaging
rumour: rumour
runaway: runaway
rural: rural
rush: rush,rushed,rushing
ruskin: ruskin
russian: russian
rustic: rustic
rusty: rusty
rye: rye
sabbath: sabbath
sabbatical: sabbatical
sable: sable
sackcloth: sackcloth
sacred: sacred
sacrifice: sacrifice,sacrifices
sad: sad
sadden: saddened
sadly: sadly
safe: safe
safely: safely
saga: saga,sagas
sagacious: sagacious
sagamen: sagamen
sage: sage
sagely: sagely
sahara: sahara
sail: sail,sailed,sailing,sails
sailing: sailing
sailor: sailor,sailors
saint: saint
sainte: sainte
saith: saith
sake: sake
salem: salem
salmon: salmon
salt: salt
salutary: salutary
salvation: salvation
salvator: salvator
sam: sam
samoa: samoa
samoan: samoans
sample: sample
samuel: samuel
sancho: sancho
sanctification: sanctification
sanctity: sanctity
sand: sand,sands
sandstone: sandstone
sane: sane
sappho: sappho
sarcasm: sarcasms
sarcastic: sarcastic
sarpedon: sarpedon
satan: satan
sate: sated
satire: satire,satires
satirist: satirist
satisfaction: satisfaction
satisfactory: satisfactory
satisfied: satisfied
satisfy: satisfied,satisfy
saucer: saucer
savage: savage,savages
savagery: savagery
save: save,saved
savour: savour,savouring
savoy: savoy
sawdust: sawdust
sawyer: sawyer
saxon: saxon
scaean: scaean
scaffolding: scaffoldings
scale: scale
scan: scan
scandal: scandal
scant: scant
scantiness: scantiness
scanty: scanty
scar: scar
scarce: scarce
scarcely: scarcely
scarlet: scarlet
scatter: scatter,scattered,scattering
scene: scene,scenes
scenery: scenery
scenical: scenical
scent: scent
sceptical: sceptical
scepticism: scepticism
scheme: scheme,schemes
scholar: scholar,scholars
scholarship: scholarship
school: school,schools
schoolboy: schoolboy,schoolboys
schoolfellow: schoolfellows
schoolmaster: schoolmaster,schoolmasters
science: science,sciences
scold: scolded
scone: scones
score: score,scores
scot: scot
scotch: scotch
scotchmen: scotchmen
scotland: scotland
scots: scots
scotsmen: scotsmen
scott: scott
scottish: scottish
scoundrel: scoundrel
scoundrelism: scoundrelism
scourge: scourge
scowl: scowled,scowling
scramble: scrambled
scraper: scraper
scratch: scratched
scream: screaming
scribe: scribes
scrimp: scrimp
scriptures: scriptures
scroll: scroll
scrooge: scrooge
scruple: scruples
scrupulous: scrupulous
sculpin: sculpin
sculpture: sculpture
scurrility: scurrility
scurrilous: scurrilous
scuttle: scuttled
sea: sea,seas
seafaring: seafaring
seal: seal,sealed
seamy: seamy
search: search
season: season,seasons
seat: seat,seated
seceder: seceder,seceders
seceders: seceders
secession: secession
secluded: secluded
secret: secret,secrets
secretly: secretly
sect: sect
secure: secure
security: security
sedge: sedges
seed: seed,seeds
seek: seek,seeking,seeks,sought
seeker: seekers
seer: seer
seize: seized
seldom: seldom
select: select,selected,selecting
selection: selection
selfishness: selfishness
sell: sell,selling,sells
sellar: sellar
semblance: semblance
seminary: seminary
semita: semita
send: send,sending,sends
senior: senior
sensation: sensation,sensations
sense: sense
senseless: senseless
sensibly: sensibly
sensitive: sensitive
sentence: sentence
sentiment: sentiment
sentimental: sentimental
sentimentally: sentimentally
separate: separate,separated
separately: separately
sept: sept
september: september
sepulchre: sepulchre
sera: sera
seraph: seraph
sere: sere
serene: serene
serenely: serenely
serener: serener
serial: serial
serially: serially
series: series
seriousness: seriousness
sermon: sermon,sermons
serpent: serpent
servant: servant,servants
serve: served
service: service
serviceable: serviceable
servius: servius
set: set,sets,setting
setting: setting
settle: settle,settled,settling
settlement: settlement
seventeen: seventeen
seventh: seventh
sever: severed
severe: severe
severest: severest
sex: sex
shabby: shabby
shade: shade,shaded
shadow: shadow,shadows
shadows: shadows
shadowy: shadowy
shady: shady
shaft: shaft,shafts
shake: shake,shaken,shaking,shook
shakespeare: shakespeare
shakespearian: shakespearian
shame: shame
shameful: shameful
shameless: shameless
shape: shape,shaped,shapes
share: share,shared,sharing
shark: sharks
sharp: sharp,sharpest
sharpen: sharpened
sharper: sharpers
sharply: sharply
shatter: shattered
shawl: shawls
shaws: shaws
shay: shay
shearing: shearing
shears: shears
sheep: sheep
sheet: sheets
shelf: shelves
shelley: shelley
shelter: shelter
shepherd: shepherd
sheriff: sheriff
sherlock: sherlock
shield: shield,shielding
shift: shift
shilling: shilling
shin: shins
shine: shines,shining
ship: ship,ships
shipwrecked: shipwrecked
shirra: shirra
shirt: shirt
shiver: shivering
shocked: shocked
shod: shod
shoe: shoe
shoot: shot
shooting: shooting
shop: shop
shopkeeper: shopkeeper
shore: shore,shores
short: short,shorter
shortly: shortly
shot: shot
shoulder: shoulder,shoulders
shout: shout,shouted
shovel: shovel,shovelling
shower: shower
shred: shred,shreds
shrewd: shrewd
shriek: shriek
shrine: shrine
shrink: shrank,shrinking
shudder: shudder,shuddered
shuddering: shuddering
shun: shun,shunned
shut: shut
shy: shy
siberia: siberia
sicilian: sicilian
sicily: sicily
sick: sick
sickening: sickening
sickle: sickle
sickly: sickly
sickness: sickness
sidney: sidney
sidonian: sidonian
siege: siege
sigh: sigh,sighed
sight: sight,sights
sighted: sighted
sightedness: sightedness
sightless: sightless
sign: signing,signs
signet: signet
significance: significance
sigurd: sigurd
sikes: sikes
silence: silence,silenced
silent: silent
silken: silken
silly: silly
silver: silver
silvery: silvery
simple: simple
simplicity: simplicity
simply: simply
sin: sin,sins
sincerely: sincerely
sine: sine
sing: sang,sing,sings,sung
singer: singer,singers
singing: singing
single: single
singular: singular
singularly: singularly
sink: sinking
sip: sip,sipped,sipping
sir: sir
sire: sire
sirloin: sirloin
sister: sister,sisters
sit: sat,sit,sits,sitting
sitting: sittings
situate: situated
situation: situation,situations
sixpenny: sixpenny
sixteen: sixteen
sixteenth: sixteenth
sixth: sixth
size: size
skeleton: skeleton
skene: skene
sketch: sketch,sketches
skill: skill
skip: skipped
skull: skull,skulls
sky: skies,sky
slacken: slackened
slang: slang
slap: slapped,slapping
slaty: slaty
slaughter: slaughtered
slave: slave,slaves
slaver: slaver
slay: slain,slay
slayer: slayer
slaying: slaying
sleep: sleep,sleeping,sleeps,slept
sleeve: sleeve
slender: slender
slew: slew
slice: slice
slight: slight
slimness: slimness
slip: slip,slipping
slipper: slippers
slow: slow
slowly: slowly
sluggish: sluggish
slumber: slumber
smart: smart
smell: smell,smells
smile: smile,smiled,smiles,smiling
smite: smite,smites,smitten,smote
smith: smith,smiths
smitten: smitten
smoke: smoke,smoking
smoking: smoking
smooth: smooth
smote: smote
smouldering: smouldering
snake: snake
snap: snap
snapper: snapper
snare: snare
snarleyyow: snarleyyow
snatch: snatched
sneak: sneak
sneer: sneer,sneered
snow: snow,snows
soap: soap
soar: soaring
sob: sob
social: social
socialism: socialism
socialist: socialist,socialists
society: societies,society
sock: sock
socrates: socrates
sofa: sofa
soft: soft
soften: softened
softly: softly
soil: soil,soiled
soiled: soiled
sojourn: sojourn
soldier: soldier,soldiers
sole: sole
solely: solely
solemn: solemn
solemnly: solemnly
solicit: solicit
solicitation: solicitation
solicitor: solicitor,solicitors
solid: solid
solitary: solitary
solitude: solitude
solve: solve
somerset: somerset
somniferous: somniferous
son: son,sons
sonata: sonata
song: song,songs
sonnet: sonnet,sonnets
sonneteer: sonneteer
sonorous: sonorous
sooth: sooth
soothe: soothing
sophia: sophia
sophocles: sophocles
sorcery: sorcery
sordid: sordid
sorel: sorel
sorrow: sorrow,sorrowing,sorrows
sort: sort,sorts
soubrette: soubrette
soul: soul,souls
souled: souled
sound: sound,sounder,sounds
sour: sour
source: source,sources
south: south
southern: southern
souvenir: souvenir
sow: sow,sown,sows
space: space
spade: spade
span: span
spare: spare
sparing: sparing
sparta: sparta
spartan: spartans
spasmodic: spasmodic
spate: spate
speak: spake,speak,speaking,speaks,spoke,spoken
spear: spear
special: special
specially: specially
species: species
specific: specific
specimen: specimen
spectacle: spectacle
spectacles: spectacles
spectator: spectator,spectators
spectre: spectre
speculate: speculate
speculation: speculation,speculations
speech: speech
speed: sped,speed
spell: spell,spells
spelling: spelling
spend: spent
sphere: sphere
spill: spilled
spin: spin,spun
spirit: spirit,spirits
spirited: spirited
spiritual: spiritual
spiritualistic: spiritualistic
spiritually: spiritually
spit: spitted
spite: spite
splendid: splendid
spoke: spoke
spontaneous: spontaneous
sport: sport
sporting: sporting
sportive: sportive
sportsman: sportsman
sportsmanlike: sportsmanlike
spot: spot,spots
spotless: spotless
spouse: spouse
spread: spread,spreading
spring: spring,springing
springtide: springtide
spur: spurred
spurn: spurning
spy: spied,spies,spy,spying
spying: spying
squadron: squadron
squalid: squalid
square: square
squatters: squatters
squeamish: squeamish
squire: squire,squires
stab: stabbed
stable: stable
staff: staff
stag: stag
stage: stage,staged,stages
stagger: staggered
staggered: staggered
stain: stain,stained,stains
stainless: stainless
stair: stair,stairs
staircase: staircase
stake: stake
stale: stale
stalk: stalk,stalked
stamp: stamp
stand: stand,standing,stands,stood
standard: standard
standing: standing
stanley: stanley
star: star,stars
stare: staring
start: start,started
startle: startled
startled: startled
starvation: starvation
starve: starved,starving
stately: stately
statement: statements
station: station
stationer: stationer
statue: statue
status: status
staunch: staunch
stay: stay
steadfast: steadfast
steadily: steadily
steady: steady
steal: stolen
steam: steam
steel: steel
steele: steele
stella: stella
step: step,steps
stepdaughter: stepdaughter
stephen: stephen
stereoscopic: stereoscopic
sterling: sterling
stern: stern
stewart: stewart
stick: stick,stuck
stiffen: stiffen
stifle: stifle
sting: sting,stung
stingy: stingy
stink: stink
stir: stir,stirred,stirring,stirs
stirling: stirling
stirring: stirring
stock: stock
stoic: stoic
stoical: stoical
stoicism: stoicism
stone: stone,stones
stones: stones
stony: stony
stool: stools
stoop: stooped,stooping,stoops
store: store,stored
storey: storey
storm: storms
stormy: stormy
story: stories,story
stout: stout,stoutest
straggler: stragglers
straight: straight
straightway: straightway
strain: strain,straining
strait: strait
strand: stranded
strange: strange
strangely: strangely
strangeness: strangeness
stranger: stranger,strangers
strap: strap
strath: strath
stratum: stratum
straw: straw
stray: stray,strays
streak: streak
stream: stream,streams
streams: streams
street: street,streets
strength: strength
strengthen: strengthened
strenuous: strenuous
strenuously: strenuously
stress: stress
stretch: stretched
stricken: stricken
strict: strict
strictly: strictly
stride: stride
strife: strife
strike: strike,strikes,striking,struck
striking: striking
string: string,strings
strive: strive
stroke: stroke
stroller: strollers
strong: strong,strongest
struggle: struggled,struggles,struggling
strung: strung
stuart: stuart
student: student,students
studies: studies
study: studied,studies,study,studying
stuff: stuff
stunningly: stunningly
stupid: stupid
stupidly: stupidly
sturdy: sturdy
style: style,styled
styx: styx
subdue: subdued,subdues
subdued: subdued
subject: subject,subjected,subjects
subjection: subjection
subjective: subjective
sublime: sublime
subordinate: subordinate
subscribe: subscribe
subscription: subscription,subscriptions
subsoil: subsoil
substance: substance
substantial: substantial
substitute: substitute,substituted
substratum: substratum
subtle: subtle
subtlety: subtlety
subversive: subversive
succeed: succeed,succeeded,succeeds
success: success,successes
successful: successful
succession: succession
successively: successively
successor: successor,successors
succour: succour
suck: sucked,sucking
sudden: sudden
suddenly: suddenly
suffer: suffer,suffered
suffering: suffering,sufferings
suffice: suffice,suffices
sufficient: sufficient
suggestion: suggestion,suggestions
suit: suit,suits
suitable: suitable
suite: suite
sullen: sullen
sultan: sultan
sum: sum,sums
summer: summer
sun: sun,suns
sunbeam: sunbeams
sunday: sunday
sundays: sundays
sunder: sunders
sunny: sunny
sunset: sunset
sunshine: sunshine
supercilious: supercilious
supererogation: supererogation
superficial: superficial
superfluity: superfluities
superfluous: superfluous
superintend: superintended
superior: superior
supernal: supernal
supernatural: supernatural
supernaturally: supernaturally
superstition: superstition
superstitious: superstitious
supper: supper,suppers
supple: supple
supplication: supplication
supply: supplied,supply
support: support,supported,supporting
supporter: supporter
suppose: suppose,supposed,supposes,supposing
suppress: suppressed
sur: sur
surefooted: surefooted
surely: surely
surface: surface
surfeiting: surfeiting
surge: surge
surgeon: surgeon
surgical: surgical
surprise: surprise,surprised,surprises
surprised: surprised
surprising: surprising
surround: surrounded,surrounds
surveillance: surveillance
survival: survival
survive: survive,survived
suspect: suspect,suspected
suspend: suspended
sustain: sustaining
sutler: sutler
swagger: swaggering
swain: swains
swallow: swallows
swamp: swamp
swan: swan,swans
swear: swear,swearing
sweat: sweated
sweating: sweating
sweep: sweep,sweeps
sweet: sweet,sweetest
sweetness: sweetness
swell: swell,swollen
swift: swift
swim: swam,swim,swims
swinburnian: swinburnian
swindle: swindling
swindler: swindler
swing: swing
swollen: swollen
swoop: swooping
sword: sword,swords
sydney: sydney
sympathetic: sympathetic
sympathise: sympathising
sympathy: sympathies,sympathy
synod: synod
synonymous: synonymous
synthesis: synthesis
syracusan: syracusan
syrian: syrian
tabella: tabella
tabitha: tabitha
table: table
tableland: tableland
tablet: tablets
taboo: taboo
tacitly: tacitly
tack: tacking
tackle: tackle,tackling
tail: tail,tailed,tails
tailor: tailors
taker: taker
tale: tale,tales
talent: talent,talents
talk: talk,talked,talking,talks
tall: tall
tam: tam
tame: tame,tamed
tangle: tangled
tanner: tanner
tantalising: tantalising
tapestried: tapestried
tapestry: tapestries,tapestry
tardy: tardy
tarquin: tarquin
tarry: tarried
tart: tart
tartarus: tartarus
task: task
taste: taste,tastes
tatler: tatler
tavern: tavern
tax: tax,taxes
tay: tay
taylor: taylor
tea: tea
teach: taught,teach,teaching
teacher: teacher,teachers
teaching: teaching
teacup: teacups
team: team
tear: tear,tears,torn
tedious: tedious
telegraphy: telegraphy
telemachus: telemachus
telepathy: telepathy
telescope: telescope
teller: teller,tellers
telling: telling
temper: temper,tempered
temperament: temperament
temperate: temperate
tempest: tempest
tempestuous: tempestuous
temple: temple
tempora: tempora
tempt: tempt,tempted
temptation: temptation,temptations
tempter: tempter
tenant: tenanted
tend: tend,tended
tendency: tendencies,tendency
tender: tender
tenderly: tenderly
tenderness: tenderness
tennis: tennis
tennyson: tennyson
tenor: tenors
tent: tent
term: term,terms
terminology: terminology
terrace: terrace
terrible: terrible
terribly: terribly
terrier: terrier
terrific: terrific
terrify: terrified,terrify
terror: terror,terrors
terse: terser
testament: testament
teste: teste
testimony: testimony
thanklessness: thanklessness
theatrical: theatrical
thee: thee
theme: theme
theodore: theodore
theologian: theologian
theological: theological
theology: theology
theory: theories,theory
thereabout: thereabouts
therefrom: therefrom
theresa: theresa
therewith: therewith
theseus: theseus
thicket: thicket
thief: thief,thieves
thine: thine
thinking: thinking
thirst: thirst
thirteen: thirteen
thirtieth: thirtieth
thither: thither
thomas: thomas
thompson: thompson
thoughtful: thoughtful
thoughtfulness: thoughtfulness
thoughtless: thoughtless
thrash: thrashed
thrawn: thrawn
thread: thread,threads
threat: threat
threaten: threaten,threatened
threshold: threshold
thrice: thrice
thrill: thrilled
thrilling: thrilling
thro: thro
throat: throat
throne: throne
throw: threw,throw,throwing,thrown,throws
thrush: thrush
thrust: thrust
thunder: thunder,thundering
thunderstorm: thunderstorm
thwart: thwarted
thy: thy
tiber: tiber
tick: ticking
ticket: ticket
tickle: tickled,tickles
tide: tide,tides
tiding: tidings
tie: tie,tying
tigris: tigris
tilting: tilting
tim: tim
timber: timbers
time: time,times
times: times
timid: timid
timidly: timidly
tin: tin
tinted: tinted
tiny: tiniest,tiny
tipper: tipper
tiptoe: tiptoe
tithonus: tithonus
title: title
titmarsh: titmarsh
titus: titus
toady: toady
toast: toast
tobias: tobias
toby: toby
tod: tod
toga: toga
toil: toil,toils
token: tokens
tolerance: tolerance
tolerant: tolerant
toleration: toleration
tom: tom
tomb: tomb
tombstone: tombstone
tome: tome
tone: tone
tongue: tongue
tongued: tongued
tonsure: tonsure
tool: tool,tooled
tooth: teeth
topic: topic,topics
topless: topless
topsy: topsy
torch: torch
torment: torment,tormenting,torments
tormentor: tormentor,tormentors
torrent: torrents
tortoiseshell: tortoiseshell
torture: torture,tortures
torve: torve
tory: tory
toss: toss,tossed,tossing
total: total
totally: totally
totter: tottering
touch: touch,touched,touching
touching: touching
tour: tour
tourist: tourist
tournament: tournament
towardly: towardly
tower: tower,towers
town: town,towns
toy: toys
trace: trace,traced,traces
track: tracked,tracks
tract: tracts
trade: trade
trademark: trademark
trading: trading
tradition: tradition,traditions
traditional: traditional
tragedy: tragedies,tragedy
tragic: tragic
tragical: tragical
trail: trailing
train: train,trained,trains
training: training
trammel: trammels
tramp: tramping
tranquillity: tranquillity
transcendental: transcendental
transcribe: transcribe,transcribed
transcript: transcripts
transcription: transcription
transfer: transferred,transfers
transform: transform
transformation: transformation
translate: translated,translating
translation: translation,translations
translator: translator,translators
translators: translators
transport: transport,transports
trapdoor: trapdoor
trash: trash
travel: travelled,travelling
traveller: travellers
travels: travels
treasure: treasure,treasured,treasures
treasured: treasured
treat: treat,treated,treating,treats
treatise: treatise,treatises
treatment: treatment
treble: treble,trebles
tree: tree,trees
tremble: trembled,trembling
trial: trial
tribe: tribe
tribunal: tribunals
trick: trick,tricks
tricycle: tricycle
trifle: trifle,trifling
trifling: trifling
triolet: triolets
triple: triple
trite: trite
triumph: triumph
trivial: trivial
trod: trod
trodden: trodden
troilus: troilus
trojan: trojan,trojans
trotty: trotty
trouble: trouble,troubles
trough: trough
trout: trout
troy: troy
truce: truce
truculence: truculence
truculency: truculency
trudge: trudged
true: true
truism: truism
trump: trump
trunnion: trunnion
trunnions: trunnions
trust: trusted,trusts
truth: truth
truthful: truthful
tryst: tryst
tudor: tudor
tug: tugged
tumultuous: tumultuous
tune: tune
tunefully: tunefully
turk: turk
turner: turner
turret: turret
tutor: tutor
twain: twain
tweed: tweed
twilight: twilight
twin: twinned
twine: twined
twist: twisted
type: type,types
typical: typical
tyrannical: tyrannical
tyranny: tyranny
tyro: tyro
tyrolese: tyrolese
ultimate: ultimate
umbrella: umbrella,umbrellas
unable: unable
unacademic: unacademic
unacquired: unacquired
unacted: unacted
unadventurous: unadventurous
unaffectedly: unaffectedly
unalloyed: unalloyed
unasked: unasked
unassuming: unassuming
unattainable: unattainable
unawares: unawares
unbound: unbound
unbridged: unbridged
unbroken: unbroken
unceasingly: unceasingly
uncertain: uncertain
uncertainty: uncertainty
uncle: uncle
uncleanness: uncleanness
unclouded: unclouded
uncomfortable: uncomfortable
uncommon: uncommon
uncommonly: uncommonly
unconscious: unconscious
unconsciously: unconsciously
unconventional: unconventional
uncorrect: uncorrect
uncut: uncut
undeniably: undeniably
undergo: underwent
undergraduate: undergraduate,undergraduates
undergraduateship: undergraduateship
understand: understand,understanding,understands,understood
undesirable: undesirable
undoubted: undoubted
undulating: undulating
uneducated: uneducated
unenforceability: unenforceability
unequalled: unequalled
unexpected: unexpected
unexpectedly: unexpectedly
unexplained: unexplained
unextinguished: unextinguished
unfailing: unfailing
unfamiliar: unfamiliar
unfavourable: unfavourable
unfeeling: unfeeling
unfinished: unfinished
unflagging: unflagging
unfold: unfolded,unfolding
unforgettable: unforgettable
unforgotten: unforgotten
unfortunate: unfortunate
unfrequently: unfrequently
unfulfilled: unfulfilled
ungallant: ungallant
ungentlemanlike: ungentlemanlike
ungentlemanly: ungentlemanly
ungilt: ungilt
ungrateful: ungrateful
unhappy: unhappy
unharmed: unharmed
unheard: unheard
unhistorical: unhistorical
unholy: unholy
uniform: uniform
unimpeached: unimpeached
unimportant: unimportant
uninhabited: uninhabited
uninteresting: uninteresting
union: union
unique: unique
unite: united
united: united
universal: universal
universally: universally
university: universities,university
unjustly: unjustly
unkind: unkind
unknowing: unknowing
unknown: unknown
unlawful: unlawful
unlearned: unlearned
unlink: unlink
unlock: unlocks
unluckily: unluckily
unlucky: unlucky
unmarketable: unmarketable
unmatched: unmatched
unmeaning: unmeaning
unmoved: unmoved
unnamable: unnamable
unnamed: unnamed
unnatural: unnatural
unparalleled: unparalleled
unpleasant: unpleasant
unpopular: unpopular
unprecedented: unprecedented
unprejudiced: unprejudiced
unpromising: unpromising
unpublished: unpublished
unquenchable: unquenchable
unquestionable: unquestionable
unquestioning: unquestioning
unquoted: unquoted
unreal: unreal
unreasonable: unreasonable
unreasoning: unreasoning
unregrettable: unregrettable
unriddled: unriddled
unrivalled: unrivalled
unroll: unrolling
unrolling: unrolling
unsated: unsated
unsatisfied: unsatisfied
unsatisfying: unsatisfying
unscrupulous: unscrupulous
unseen: unseen
unselfish: unselfish
unselfishness: unselfishness
unsent: unsent
unserviceable: unserviceable
unskilled: unskilled
unsmirched: unsmirched
unsolicited: unsolicited
unsolved: unsolved
unsophisticated: unsophisticated
unsought: unsought
unsparing: unsparing
unspeakable: unspeakable
unsportsmanlike: unsportsmanlike
unsuccessful: unsuccessful
unsullied: unsullied
unsummoned: unsummoned
unsuspected: unsuspected
untaught: untaught
untenanted: untenanted
untilled: untilled
untouched: untouched
unusual: unusual
unusually: unusually
unutterably: unutterably
unuttered: unuttered
unversed: unversed
unvexed: unvexed
unvisited: unvisited
unwearied: unwearied
unwholesome: unwholesome
unwonted: unwonted
unworthy: unworthy
unwritten: unwritten
unwrung: unwrung
update: updated
upper: upper
uprear: upreared
uprose: uprose
upset: upset
upward: upward
urbanity: urbanity
urge: urged,urges,urging
uriah: uriah
usage: usage
useless: useless
user: user
usher: usher,ushers
usual: usual
usurper: usurper
ut: ut
uther: uther
utmost: utmost
utter: utter,uttered,uttering
utterly: utterly
vacant: vacant
vacation: vacation,vacations
vacuous: vacuous
vague: vague
vaguely: vaguely
vain: vain
vainly: vainly
vale: vale
valet: valet
valiant: valiant
valley: valley
valuable: valuable
vampire: vampire
vandal: vandal
vane: vane
vanilla: vanilla
vanish: vanished
vanity: vanity
vanquish: vanquished
variance: variance
variety: varieties,variety
variously: variously
varnish: varnished
varnished: varnished
vary: vary
vase: vase,vases
vassal: vassals
vast: vast
vastly: vastly
vault: vault,vaulted
veer: veering
veil: veil
vein: vein,veins
velvet: velvet
vendor: vendors
venetian: venetian
vengeance: vengeance
vengeful: vengeful
venner: venner
vent: vented
venture: venture,ventured
venus: venus
vera: vera
verb: verbs
verbal: verbal
verbose: verbose
verdict: verdicts
veridical: veridical
verily: verily
vermin: vermin
vernon: vernon
veronese: veronese
verse: verse,verses
verses: verses
versifier: versifiers
versify: versifying
version: version,versions
vesper: vesper
vest: vest
veteran: veteran
vex: vexed
vexatious: vexatious
vexing: vexing
vibrate: vibrate
vice: vice,vices
vicinity: vicinity
vicious: vicious
vicomte: vicomte
victim: victim,victims
victor: victor,victors
victorious: victorious
victory: victories,victory
view: view,viewed,viewing,views
viewless: viewless
vigil: vigil
vigorous: vigorous
vigorously: vigorously
vigour: vigour
vii: vii
viii: viii
vile: vile
villa: villa
village: village,villages
villain: villain
vindictive: vindictive
vine: vine
vineyard: vineyard
vinland: vinland
violate: violates
violence: violence
violent: violent
violet: violet
virelai: virelais
virgil: virgil
virgilian: virgilian
virgin: virgin
virginal: virginal
virtue: virtue,virtues
virtuous: virtuous
virtuously: virtuously
virus: virus
visible: visible
vision: vision,visions
visionary: visionary
visit: visit,visited,visits
visitor: visitor,visitors
vita: vita
vitality: vitality
vivacious: vivacious
vivacity: vivacity
vivid: vivid
vividly: vividly
vividness: vividness
vocation: vocation
vogue: vogue
voice: voice,voiced,voices
void: void
voltaire: voltaire
volume: volume,volumes
voluntary: voluntary
volunteer: volunteer,volunteers
vow: vow
voyage: voyage
voyager: voyager
vulgar: vulgar
wade: wade
waggoner: waggoner
wail: wail,wailed
waist: waist
wait: wait,waiting
wake: wake,waking
wakeful: wakeful
waken: waken,wakened
walk: walk,walked,walking,walks
walker: walker
wall: wall,walls
walter: walter
waltz: waltzing
wan: wan
wand: wands
wander: wander,wandered,wandering,wanders
wanderer: wanderer,wanderers
wandering: wandering
wantonness: wantonness
war: war,wars
ward: ward
warden: warden
warm: warm,warmed
warmly: warmly
warn: warn,warned
warning: warning
warp: warp
warranty: warranties,warranty
warrior: warrior
wash: washed,washing
washington: washington
waste: waste,wasted
wasteful: wasteful
watch: watch,watched,watches,watching
watcher: watcher
watchful: watchful
watching: watching
water: water,waters
waterloo: waterloo
watts: watts
wave: wave,waves
waver: waver
wavy: wavy
waxen: waxen
weak: weak,weaker,weakest
weakness: weakness
wealth: wealth
wealthy: wealthy
wean: wean
wear: wear,wearing,wore,worn
weariness: weariness
weary: wearied,weary
weather: weather
weave: weave,weaving,wove,woven
weaver: weaver
weaving: weaving
wedding: wedding
wednesday: wednesday
wee: wee
weed: weed,weeds
week: week,weeks
weekly: weekly
ween: ween
weep: weep,weeping,weeps,wept
weeping: weeping
weigh: weigh,weighed
weight: weight
weir: weir
weird: weird
weirdly: weirdly
weller: weller
welshman: welshman
wend: wend,wended
wendell: wendell
wesley: wesley
wesleyan: wesleyan
west: west
western: western
westminster: westminster
wet: wet
whatsoever: whatsoever
wheedle: wheedling
wheel: wheels
wherefore: wherefore
whereof: whereof
whereon: whereon
wheresoever: wheresoever
whereto: whereto
whetted: whetted
whig: whig
whirl: whirl,whirling
whisper: whisper,whispers
whist: whist
whistle: whistled,whistles,whistling
white: white,whitest
wholeness: wholeness
wholesome: wholesome
wholly: wholly
whomsoever: whomsoever
wicked: wicked
wicket: wicket,wickets
wide: wide,wider,widest
widow: widow,widowed
wife: wife,wives
wig: wig
wild: wild
wilderness: wilderness
wildly: wildly
wiles: wiles
wilful: wilful
william: william
williams: williams
willie: willie
willingly: willingly
wilson: wilson
win: win,winning
winchester: winchester
wind: wind,winding,winds,wound
window: window,windows
winds: winds
windward: windward
windy: windy
wine: wine
wing: wing,wings
wings: wings
winifred: winifred
winkle: winkle
winningly: winningly
winter: winter,winters
wisdom: wisdom
wise: wise,wiser,wisest
wisely: wisely
wisher: wisher
wistful: wistful
wit: wit,wits
witch: witch,witches
witchcraft: witchcraft
witchery: witchery
witham: witham
withdraw: withdraw,withdrawn,withdrew
witheringly: witheringly
withers: withers
withhold: withholding
witness: witness
wizard: wizard,wizards
woe: woe,woes
woman: woman,women
womb: womb
women: women
wonderful: wonderful
wonderfully: wonderfully
wondrous: wondrous
woo: wooing
wood: wood,woods
woodcut: woodcut
wooden: wooden
wooer: wooer
wooers: wooers
word: word
wordy: wordy
worker: workers
worldly: worldly
worm: worms
worms: worms
wormy: wormy
worship: worship,worshipped
worshipper: worshipper,worshippers
worth: worth
worthy: worthies,worthy
wound: wound,wounded
wounded: wounded
wounding: wounding
wrack: wrack
wraith: wraith,wraiths
wrath: wrath
wreck: wreck
wrecker: wrecker
wrestle: wrestled
wretched: wretched
wriggle: wriggled
wring: wrung
wrinkle: wrinkles
wrist: wrist
write: write,writes,writing,written,wrote
writer: writer,writers
writhe: writhed,writhing
writing: writing
writings: writings
wrong: wrong,wronged,wrongs
xi: xi
xii: xii
xiii: xiii
xiv: xiv
xvi: xvi
xvii: xvii
yacht: yacht
yard: yards
yarrow: yarrow
yea: yea
yearning: yearning
yell: yells
yellow: yellow
yeoman: yeoman
yesterday: yesterday
ygerne: ygerne
yield: yielding
yore: yore
york: york
youth: youth,youths
zeal: zeal
zeus: zeus
zigzag: zigzag
zulus: zulus
